gain_loss,pathogenicity,chr,start,end,size,genes_in_proximity,number_of_genes_in_proximity
-1,1,1,14874,7527302,7512428,57470;388588;1677;85452;83858;6146;5590;127262;728661;199990;23463;9636;100287898;79501;8510;64856;26155;81399;140625;55229;8764;65220;339456;261734;375790;388581;90326;148398;401934;80835;55735;57449;643965;51150;8784;2782;9651;1855;9731;27237;57801;387509;26038;126789;81669;29101;6497;339453;643988;7161;126792;8718;388591;83715;219293;163688;84808;11332;388585;63976;54626;6339;11079;80772;55052;254173;148479;79258;984;54587;8514;5192;54973;339448;84069;9903;54998;9906;148870;116983;339451;390992;55966;3104;7293;118424;728642;127281;2563;55210;54991;83756;142678;441869;79707;23261;729759;1953;79906;49856,100
-1,1,1,14874,8845386,8830512,57470;388588;1677;85452;83858;6146;5590;127262;728661;199990;23463;9636;100287898;79501;8510;64856;26155;81399;140625;55229;10911;54206;8764;65220;339456;261734;375790;388581;90326;148398;401934;80835;55735;57449;643965;51150;8784;2782;9651;1855;9731;27237;57801;3604;387509;8863;26038;126789;81669;29101;6497;339453;643988;7161;126792;8718;388591;83715;219293;163688;84808;11332;11315;388585;63976;54626;6339;11079;80772;50651;55052;254173;148479;79258;984;54587;8514;5192;54973;339448;84069;9903;54998;9906;148870;116983;339451;390992;55966;3104;7293;118424;728642;127281;2563;55210;54991;9341;473;83756;142678;441869;79707;23261;729759;1953;79906;49856,108
1,1,1,19225,4401691,4382466,57470;388588;1677;85452;83858;5590;127262;728661;199990;9636;100287898;79501;8510;64856;26155;81399;140625;55229;8764;65220;339456;375790;388581;148398;401934;643965;51150;8784;2782;9651;1855;9731;27237;57801;126789;81669;29101;6497;339453;643988;7161;126792;219293;163688;84808;388585;63976;6339;11079;80772;55052;254173;79258;984;54587;5192;54973;84069;339448;54998;9906;148870;116983;339451;7293;118424;728642;127281;2563;55210;54991;83756;142678;441869;729759;1953;79906;49856,78
-1,-1,1,228697,649718,421021,729759;81399,2
-1,-1,1,348740,640954,292214,729759;81399,2
-1,-1,1,421308,678822,257514,81399,1
-1,-1,1,421308,678822,257514,81399,1
-1,1,1,564424,3582058,3017634,85452;83858;5590;127262;728661;199990;9636;100287898;8510;64856;26155;81399;140625;55229;8764;65220;339456;375790;388581;148398;401934;643965;51150;8784;2782;9651;1855;27237;57801;126789;81669;29101;339453;6497;643988;7161;126792;219293;163688;84808;388585;63976;6339;55052;254173;80772;11079;79258;984;54587;5192;54973;84069;54998;9906;116983;339451;7293;118424;728642;2563;127281;55210;54991;83756;142678;441869;1953;79906;49856,70
-1,-1,1,564435,649748,85313,81399,1
-1,1,1,697794,2567838,1870044,85452;83858;126789;5590;81669;728661;29101;199990;339453;6497;643988;9636;126792;219293;8510;163688;84808;64856;26155;388585;55229;6339;55052;254173;80772;65220;339456;11079;8764;375790;79258;984;388581;54587;54973;84069;148398;5192;401934;54998;9906;116983;339451;643965;51150;7293;118424;728642;2563;127281;8784;55210;2782;54991;1855;9651;83756;142678;441869;57801;79906,61
-1,1,1,714078,4958499,4244421,57470;388588;85452;1677;83858;5590;127262;728661;199990;9636;100287898;8510;64856;26155;140625;55229;8764;65220;339456;375790;388581;148398;401934;643965;51150;8784;2782;9651;1855;9731;27237;57801;126789;81669;29101;339453;6497;643988;7161;126792;219293;163688;84808;388585;63976;6339;55052;254173;80772;11079;79258;984;54587;5192;54973;84069;339448;54998;9906;148870;116983;339451;55966;7293;118424;728642;2563;127281;55210;54991;83756;142678;441869;1953;79906;49856,76
-1,1,1,714144,2867436,2153292,85452;83858;126789;5590;81669;728661;29101;199990;339453;6497;643988;9636;100287898;126792;219293;8510;163688;84808;64856;26155;388585;55229;6339;55052;254173;80772;65220;339456;11079;8764;375790;79258;984;388581;54587;54973;84069;148398;5192;401934;54998;9906;116983;339451;643965;51150;7293;118424;728642;2563;127281;8784;55210;2782;54991;1855;9651;83756;142678;441869;57801;79906,62
-1,1,1,757093,2394455,1637362,85452;83858;126789;5590;81669;728661;29101;199990;339453;6497;643988;9636;126792;219293;8510;163688;84808;64856;26155;6339;55052;254173;80772;65220;339456;11079;375790;984;388581;54587;54973;84069;148398;5192;401934;54998;9906;116983;339451;643965;51150;7293;118424;728642;2563;8784;55210;2782;54991;1855;83756;142678;441869;57801;79906,55
-1,1,1,757093,2499074,1741981,85452;83858;126789;5590;81669;728661;29101;199990;339453;6497;643988;9636;126792;219293;8510;163688;84808;64856;26155;388585;55229;6339;55052;254173;80772;65220;339456;11079;8764;375790;984;388581;54587;54973;84069;148398;5192;401934;54998;9906;116983;339451;643965;51150;7293;118424;728642;2563;8784;55210;2782;54991;1855;9651;83756;142678;441869;57801;79906,59
-1,1,1,757093,2567832,1810739,85452;83858;126789;5590;81669;728661;29101;199990;339453;6497;643988;9636;126792;219293;8510;163688;84808;64856;26155;388585;55229;6339;55052;254173;80772;65220;339456;11079;8764;375790;79258;984;388581;54587;54973;84069;148398;5192;401934;54998;9906;116983;339451;643965;51150;7293;118424;728642;2563;127281;8784;55210;2782;54991;1855;9651;83756;142678;441869;57801;79906,61
-1,1,1,757093,2892687,2135594,85452;83858;126789;5590;81669;728661;29101;199990;339453;6497;643988;9636;100287898;126792;219293;8510;163688;84808;64856;26155;388585;55229;6339;55052;254173;80772;65220;339456;11079;8764;375790;79258;984;388581;54587;54973;84069;148398;5192;401934;54998;9906;116983;339451;643965;51150;7293;118424;728642;2563;127281;8784;55210;2782;54991;1855;9651;83756;142678;441869;57801;79906,62
-1,1,1,757093,3354772,2597679,85452;83858;5590;728661;199990;9636;100287898;8510;64856;26155;140625;55229;8764;65220;339456;375790;388581;148398;401934;643965;51150;8784;2782;9651;1855;57801;126789;81669;29101;339453;6497;643988;126792;219293;163688;84808;388585;63976;6339;55052;254173;80772;11079;79258;984;54587;5192;54973;84069;54998;9906;116983;339451;7293;118424;728642;2563;127281;55210;54991;83756;142678;441869;79906,64
-1,1,1,757093,3486455,2729362,85452;83858;5590;728661;199990;9636;100287898;8510;64856;26155;140625;55229;8764;65220;339456;375790;388581;148398;401934;643965;51150;8784;2782;9651;1855;27237;57801;126789;81669;29101;339453;6497;643988;126792;219293;163688;84808;388585;63976;6339;55052;254173;80772;11079;79258;984;54587;5192;54973;84069;54998;9906;116983;339451;7293;118424;728642;2563;127281;55210;54991;83756;142678;441869;1953;79906,66
-1,1,1,757093,4285145,3528052,57470;388588;85452;1677;83858;5590;127262;728661;199990;9636;100287898;8510;64856;26155;140625;55229;8764;65220;339456;375790;388581;148398;401934;643965;51150;8784;2782;9651;1855;9731;27237;57801;126789;81669;29101;339453;6497;643988;7161;126792;219293;163688;84808;388585;63976;6339;55052;254173;80772;11079;79258;984;54587;5192;54973;84069;339448;54998;9906;148870;116983;339451;7293;118424;728642;2563;127281;55210;54991;83756;142678;441869;1953;79906;49856,75
-1,1,1,757093,5160050,4402957,57470;388588;85452;1677;83858;5590;127262;728661;199990;9636;100287898;8510;64856;26155;140625;55229;8764;65220;339456;375790;388581;148398;401934;643965;51150;8784;2782;9651;1855;9731;27237;57801;126789;81669;29101;339453;6497;643988;7161;126792;219293;163688;84808;388585;63976;6339;55052;254173;80772;11079;79258;984;54587;5192;54973;84069;339448;54998;9906;148870;116983;339451;55966;7293;118424;728642;2563;127281;55210;54991;83756;142678;441869;1953;79906;49856,76
-1,1,1,757093,5299703,4542610,57470;388588;85452;1677;83858;5590;127262;728661;199990;9636;100287898;8510;64856;26155;140625;55229;8764;65220;339456;375790;388581;148398;401934;643965;51150;8784;2782;9651;1855;9731;27237;57801;126789;81669;29101;339453;6497;643988;7161;126792;219293;163688;84808;388585;63976;6339;55052;254173;80772;11079;79258;984;54587;5192;54973;84069;339448;54998;9906;148870;116983;339451;55966;7293;118424;728642;2563;127281;55210;54991;83756;142678;441869;1953;79906;49856,76
-1,1,1,757093,5540323,4783230,57470;388588;85452;1677;83858;5590;127262;728661;199990;9636;100287898;8510;64856;26155;140625;55229;8764;65220;339456;375790;388581;148398;401934;643965;51150;8784;2782;9651;1855;9731;27237;57801;126789;81669;29101;339453;6497;643988;7161;126792;219293;163688;84808;388585;63976;6339;55052;254173;80772;11079;79258;984;54587;5192;54973;84069;339448;54998;9906;148870;116983;339451;55966;7293;118424;728642;2563;127281;55210;54991;83756;142678;441869;1953;79906;49856,76
-1,1,1,757093,7060898,6303805,57470;388588;1677;85452;83858;6146;5590;127262;728661;199990;23463;9636;100287898;8510;64856;26155;140625;55229;8764;65220;339456;261734;375790;388581;90326;148398;401934;80835;55735;57449;643965;51150;8784;2782;9651;1855;9731;27237;57801;387509;26038;126789;81669;29101;6497;339453;643988;7161;126792;8718;388591;83715;219293;163688;84808;11332;388585;63976;54626;6339;11079;80772;55052;254173;148479;79258;984;54587;8514;5192;54973;339448;84069;9903;54998;9906;148870;116983;339451;390992;55966;3104;7293;118424;728642;127281;2563;55210;54991;83756;142678;441869;79707;23261;1953;79906;49856,97
-1,1,1,779727,2558913,1779186,85452;83858;126789;5590;81669;728661;29101;199990;339453;6497;643988;9636;126792;219293;8510;163688;84808;64856;26155;388585;55229;6339;55052;254173;80772;65220;339456;11079;8764;375790;79258;984;388581;54587;54973;84069;148398;5192;401934;54998;9906;116983;339451;643965;51150;7293;118424;728642;2563;127281;8784;55210;2782;54991;1855;9651;83756;142678;441869;57801;79906,61
-1,1,1,779727,2558913,1779186,85452;83858;126789;5590;81669;728661;29101;199990;339453;6497;643988;9636;126792;219293;8510;163688;84808;64856;26155;388585;55229;6339;55052;254173;80772;65220;339456;11079;8764;375790;79258;984;388581;54587;54973;84069;148398;5192;401934;54998;9906;116983;339451;643965;51150;7293;118424;728642;2563;127281;8784;55210;2782;54991;1855;9651;83756;142678;441869;57801;79906,61
-1,1,1,779727,4458182,3678455,57470;388588;85452;1677;83858;5590;127262;728661;199990;9636;100287898;8510;64856;26155;140625;55229;8764;65220;339456;375790;388581;148398;401934;643965;51150;8784;2782;9651;1855;9731;27237;57801;126789;81669;29101;339453;6497;643988;7161;126792;219293;163688;84808;388585;63976;6339;55052;254173;80772;11079;79258;984;54587;5192;54973;84069;339448;54998;9906;148870;116983;339451;7293;118424;728642;2563;127281;55210;54991;83756;142678;441869;1953;79906;49856,75
-1,1,1,779727,6976647,6196920,57470;388588;1677;85452;83858;6146;5590;127262;728661;199990;23463;9636;100287898;8510;64856;26155;140625;55229;8764;65220;339456;261734;375790;388581;90326;148398;401934;80835;55735;57449;643965;51150;8784;2782;9651;1855;9731;27237;57801;387509;26038;126789;81669;29101;6497;339453;643988;7161;126792;8718;388591;83715;219293;163688;84808;11332;388585;63976;54626;6339;11079;80772;55052;254173;148479;79258;984;54587;8514;5192;54973;339448;84069;9903;54998;9906;148870;116983;339451;390992;55966;3104;7293;118424;728642;127281;2563;55210;54991;83756;142678;441869;79707;23261;1953;79906;49856,97
-1,1,1,779727,7930605,7150878,57470;388588;1677;85452;83858;6146;5590;127262;728661;199990;23463;9636;100287898;8510;64856;26155;140625;55229;10911;8764;65220;339456;261734;375790;388581;90326;148398;401934;80835;55735;57449;643965;51150;8784;2782;9651;1855;9731;27237;57801;387509;8863;26038;126789;81669;29101;6497;339453;643988;7161;126792;8718;388591;83715;219293;163688;84808;11332;388585;63976;54626;6339;11079;80772;55052;254173;148479;79258;984;54587;8514;5192;54973;339448;84069;9903;54998;9906;148870;116983;339451;390992;55966;3104;7293;118424;728642;127281;2563;55210;54991;9341;83756;142678;441869;79707;23261;1953;79906;49856,100
-1,1,1,779727,8231974,7452247,57470;388588;1677;85452;83858;6146;5590;127262;728661;199990;23463;9636;100287898;8510;64856;26155;140625;55229;10911;54206;8764;65220;339456;261734;375790;388581;90326;148398;401934;80835;55735;57449;643965;51150;8784;2782;9651;1855;9731;27237;57801;3604;387509;8863;26038;126789;81669;29101;6497;339453;643988;7161;126792;8718;388591;83715;219293;163688;84808;11332;11315;388585;63976;54626;6339;11079;80772;55052;254173;148479;79258;984;54587;8514;5192;54973;339448;84069;9903;54998;9906;148870;116983;339451;390992;55966;3104;7293;118424;728642;127281;2563;55210;54991;9341;83756;142678;441869;79707;23261;1953;79906;49856,103
-1,1,1,779727,12530188,11750461,10277;100526739;1677;83858;6146;5590;728661;57540;23463;9636;8510;64856;765;26155;140625;26232;6518;54206;8764;65220;339456;261734;375790;388581;148398;9563;80835;57449;80045;643965;5195;60672;2023;5351;2782;9651;1855;84328;57801;23435;387509;26038;81669;6497;643988;7161;22883;126792;8718;388591;11315;63976;10459;6339;11079;80772;50651;26270;148479;79258;8514;339448;9903;9927;148345;118424;55210;54991;473;142678;441869;79707;2475;49856;57470;388588;85452;56998;127262;199990;93611;4878;100287898;10747;80176;1676;378708;55229;10911;90326;7133;943;401934;55735;54897;284498;51150;8784;9731;1185;27237;6723;23095;10218;29914;155184;4524;5394;3604;8863;84275;126789;199953;29101;374946;1325;339453;83715;219293;163688;5226;84808;55187;11332;388585;54626;55052;254173;57085;984;54587;5192;54973;84069;4879;54998;9906;148870;116983;339451;390992;55966;3104;7293;728642;127281;2563;64802;116362;9341;83756;23261;90231;1953;79906;5293,156
1,-1,1,779733,846621,66888,,0
-1,1,1,779733,2352355,1572622,85452;83858;126789;5590;81669;728661;29101;199990;339453;6497;643988;9636;126792;219293;8510;163688;84808;64856;26155;6339;55052;254173;80772;65220;339456;11079;375790;984;388581;54587;54973;84069;148398;5192;401934;54998;9906;116983;339451;643965;51150;7293;118424;728642;2563;8784;55210;2782;54991;1855;83756;142678;441869;57801;79906,55
-1,1,1,779733,3070473,2290740,85452;83858;5590;728661;199990;9636;100287898;8510;64856;26155;140625;55229;8764;65220;339456;375790;388581;148398;401934;643965;51150;8784;2782;9651;1855;57801;126789;81669;29101;339453;6497;643988;126792;219293;163688;84808;388585;63976;6339;55052;254173;80772;11079;79258;984;54587;5192;54973;84069;54998;9906;116983;339451;7293;118424;728642;2563;127281;55210;54991;83756;142678;441869;79906,64
-1,1,1,779733,3404441,2624708,85452;83858;5590;728661;199990;9636;100287898;8510;64856;26155;140625;55229;8764;65220;339456;375790;388581;148398;401934;643965;51150;8784;2782;9651;1855;27237;57801;126789;81669;29101;339453;6497;643988;126792;219293;163688;84808;388585;63976;6339;55052;254173;80772;11079;79258;984;54587;5192;54973;84069;54998;9906;116983;339451;7293;118424;728642;2563;127281;55210;54991;83756;142678;441869;79906,65
1,1,1,779733,5887252,5107519,57470;388588;85452;1677;83858;5590;127262;728661;199990;9636;100287898;8510;64856;26155;140625;55229;8764;65220;339456;375790;388581;148398;401934;643965;51150;8784;2782;9651;1855;9731;27237;57801;126789;81669;29101;339453;6497;643988;7161;126792;219293;163688;84808;388585;63976;6339;55052;254173;80772;11079;79258;984;54587;5192;54973;84069;339448;54998;9906;148870;116983;339451;55966;7293;118424;728642;2563;127281;55210;54991;83756;142678;441869;1953;79906;49856,76
-1,1,1,779733,6537534,5757801,57470;388588;1677;85452;83858;6146;5590;127262;728661;199990;23463;9636;100287898;8510;64856;26155;140625;55229;8764;65220;339456;261734;375790;388581;148398;401934;57449;643965;51150;8784;2782;9651;1855;9731;27237;57801;387509;26038;126789;81669;29101;6497;339453;643988;7161;126792;8718;388591;83715;219293;163688;84808;11332;388585;63976;54626;6339;11079;80772;55052;254173;79258;984;54587;8514;5192;54973;339448;84069;54998;9906;148870;116983;339451;390992;55966;7293;118424;728642;127281;2563;55210;54991;83756;142678;441869;1953;79906;49856,89
1,-1,1,794625,846707,52082,,0
1,-1,1,803989,866414,62425,148398,1
-1,1,1,809759,5033321,4223562,57470;388588;85452;1677;83858;5590;127262;728661;199990;9636;100287898;8510;64856;26155;140625;55229;8764;65220;339456;375790;388581;148398;401934;643965;51150;8784;2782;9651;1855;9731;27237;57801;126789;81669;29101;339453;6497;643988;7161;126792;219293;163688;84808;388585;63976;6339;55052;254173;80772;11079;79258;984;54587;5192;54973;84069;339448;54998;9906;148870;116983;339451;55966;7293;118424;728642;2563;127281;55210;54991;83756;142678;441869;1953;79906;49856,76
-1,1,1,834101,7871366,7037265,57470;388588;1677;85452;83858;6146;5590;127262;728661;199990;23463;9636;100287898;8510;64856;26155;140625;55229;8764;65220;339456;261734;375790;388581;90326;148398;401934;80835;55735;57449;643965;51150;8784;2782;9651;1855;9731;27237;57801;387509;8863;26038;126789;81669;29101;6497;339453;643988;7161;126792;8718;388591;83715;219293;163688;84808;11332;388585;63976;54626;6339;11079;80772;55052;254173;148479;79258;984;54587;8514;5192;54973;339448;84069;9903;54998;9906;148870;116983;339451;390992;55966;3104;7293;118424;728642;127281;2563;55210;54991;9341;83756;142678;441869;79707;23261;1953;79906;49856,99
-1,1,1,837491,9616363,8778872,57470;388588;1677;85452;83858;6146;5590;127262;728661;199990;23463;9636;100287898;80176;8510;64856;765;26155;140625;55229;6518;54206;8764;10911;65220;339456;261734;375790;388581;90326;148398;9563;401934;80835;55735;57449;80045;643965;51150;2023;8784;2782;9651;1855;9731;27237;57801;155184;3604;387509;8863;26038;84275;126789;81669;29101;6497;339453;643988;7161;126792;8718;388591;83715;219293;163688;84808;11332;11315;388585;63976;54626;6339;11079;80772;50651;55052;254173;148479;79258;984;54587;8514;5192;54973;339448;84069;9903;54998;9906;148870;116983;339451;390992;55966;3104;7293;118424;728642;127281;2563;55210;54991;9341;473;83756;142678;441869;79707;23261;1953;79906;49856,113
1,-1,1,839450,867543,28093,148398,1
-1,-1,1,839450,913631,74181,339451;84808;84069;148398;26155,5
-1,1,1,846680,2879954,2033274,85452;83858;126789;5590;81669;728661;29101;199990;339453;6497;643988;9636;100287898;126792;219293;8510;163688;84808;64856;26155;388585;55229;6339;55052;254173;80772;65220;339456;11079;8764;375790;79258;984;388581;54587;54973;84069;148398;5192;401934;54998;9906;116983;339451;643965;51150;7293;118424;728642;2563;127281;8784;55210;2782;54991;1855;9651;83756;142678;441869;57801;79906,62
-1,1,1,846680,3404423,2557743,85452;83858;5590;728661;199990;9636;100287898;8510;64856;26155;140625;55229;8764;65220;339456;375790;388581;148398;401934;643965;51150;8784;2782;9651;1855;27237;57801;126789;81669;29101;339453;6497;643988;126792;219293;163688;84808;388585;63976;6339;55052;254173;80772;11079;79258;984;54587;5192;54973;84069;54998;9906;116983;339451;7293;118424;728642;2563;127281;55210;54991;83756;142678;441869;79906,65
1,1,1,846680,3531051,2684371,85452;83858;5590;728661;199990;9636;100287898;8510;64856;26155;140625;55229;8764;65220;339456;375790;388581;148398;401934;643965;51150;8784;2782;9651;1855;27237;57801;126789;81669;29101;339453;6497;643988;126792;219293;163688;84808;388585;63976;6339;55052;254173;80772;11079;79258;984;54587;5192;54973;84069;54998;9906;116983;339451;7293;118424;728642;2563;127281;55210;54991;83756;142678;441869;1953;79906,66
1,1,1,846680,3531051,2684371,85452;83858;5590;728661;199990;9636;100287898;8510;64856;26155;140625;55229;8764;65220;339456;375790;388581;148398;401934;643965;51150;8784;2782;9651;1855;27237;57801;126789;81669;29101;339453;6497;643988;126792;219293;163688;84808;388585;63976;6339;55052;254173;80772;11079;79258;984;54587;5192;54973;84069;54998;9906;116983;339451;7293;118424;728642;2563;127281;55210;54991;83756;142678;441869;1953;79906,66
-1,1,1,846680,4087427,3240747,57470;388588;85452;1677;83858;5590;127262;728661;199990;9636;100287898;8510;64856;26155;140625;55229;8764;65220;339456;375790;388581;148398;401934;643965;51150;8784;2782;9651;1855;9731;27237;57801;126789;81669;29101;339453;6497;643988;7161;126792;219293;163688;84808;388585;63976;6339;55052;254173;80772;11079;79258;984;54587;5192;54973;84069;339448;54998;9906;148870;116983;339451;7293;118424;728642;2563;127281;55210;54991;83756;142678;441869;1953;79906;49856,75
-1,1,1,846680,9389984,8543304,57470;388588;1677;85452;83858;6146;5590;127262;728661;199990;23463;9636;100287898;80176;8510;64856;765;26155;140625;55229;6518;54206;8764;10911;65220;339456;261734;375790;388581;90326;148398;9563;401934;80835;55735;57449;80045;643965;51150;2023;8784;2782;9651;1855;9731;27237;57801;155184;3604;387509;8863;26038;126789;81669;29101;6497;339453;643988;7161;126792;8718;388591;83715;219293;163688;84808;11332;11315;388585;63976;54626;6339;11079;80772;50651;55052;254173;148479;79258;984;54587;8514;5192;54973;339448;84069;9903;54998;9906;148870;116983;339451;390992;55966;3104;7293;118424;728642;127281;2563;55210;54991;9341;473;83756;142678;441869;79707;23261;1953;79906;49856,112
-1,1,1,849466,1549149,699683,83858;126789;81669;29101;339453;643988;9636;126792;219293;84808;64856;26155;6339;55052;254173;80772;375790;388581;54587;54973;84069;148398;401934;54998;116983;339451;643965;51150;7293;118424;8784;55210;54991;1855;83756;441869;57801,37
-1,1,1,849466,2330338,1480872,85452;83858;126789;5590;81669;728661;29101;199990;339453;6497;643988;9636;126792;219293;8510;163688;84808;64856;26155;6339;55052;254173;80772;65220;339456;11079;375790;984;388581;54587;54973;84069;148398;401934;54998;9906;116983;339451;643965;51150;7293;118424;728642;2563;8784;55210;2782;54991;1855;83756;142678;441869;57801;79906,54
-1,1,1,849466,2397177,1547711,85452;83858;126789;5590;81669;728661;29101;199990;339453;6497;643988;9636;126792;219293;8510;163688;84808;64856;26155;6339;55052;254173;80772;65220;339456;11079;375790;984;388581;54587;54973;84069;148398;5192;401934;54998;9906;116983;339451;643965;51150;7293;118424;728642;2563;8784;55210;2782;54991;1855;83756;142678;441869;57801;79906,55
-1,1,1,849466,2554275,1704809,85452;83858;126789;5590;81669;728661;29101;199990;339453;6497;643988;9636;126792;219293;8510;163688;84808;64856;26155;388585;55229;6339;55052;254173;80772;65220;339456;11079;8764;375790;79258;984;388581;54587;54973;84069;148398;5192;401934;54998;9906;116983;339451;643965;51150;7293;118424;728642;2563;127281;8784;55210;2782;54991;1855;9651;83756;142678;441869;57801;79906,61
-1,1,1,849466,2607016,1757550,85452;83858;126789;5590;81669;728661;29101;199990;339453;6497;643988;9636;100287898;126792;219293;8510;163688;84808;64856;26155;388585;55229;6339;55052;254173;80772;65220;339456;11079;8764;375790;79258;984;388581;54587;54973;84069;148398;5192;401934;54998;9906;116983;339451;643965;51150;7293;118424;728642;2563;127281;8784;55210;2782;54991;1855;9651;83756;142678;441869;57801;79906,62
-1,1,1,849466,2748837,1899371,85452;83858;126789;5590;81669;728661;29101;199990;339453;6497;643988;9636;100287898;126792;219293;8510;163688;84808;64856;26155;388585;55229;6339;55052;254173;80772;65220;339456;11079;8764;375790;79258;984;388581;54587;54973;84069;148398;5192;401934;54998;9906;116983;339451;643965;51150;7293;118424;728642;2563;127281;8784;55210;2782;54991;1855;9651;83756;142678;441869;57801;79906,62
-1,1,1,849466,3222027,2372561,85452;83858;5590;728661;199990;9636;100287898;8510;64856;26155;140625;55229;8764;65220;339456;375790;388581;148398;401934;643965;51150;8784;2782;9651;1855;57801;126789;81669;29101;339453;6497;643988;126792;219293;163688;84808;388585;63976;6339;55052;254173;80772;11079;79258;984;54587;5192;54973;84069;54998;9906;116983;339451;7293;118424;728642;2563;127281;55210;54991;83756;142678;441869;79906,64
1,1,1,849466,3396845,2547379,85452;83858;5590;728661;199990;9636;100287898;8510;64856;26155;140625;55229;8764;65220;339456;375790;388581;148398;401934;643965;51150;8784;2782;9651;1855;27237;57801;126789;81669;29101;339453;6497;643988;126792;219293;163688;84808;388585;63976;6339;55052;254173;80772;11079;79258;984;54587;5192;54973;84069;54998;9906;116983;339451;7293;118424;728642;2563;127281;55210;54991;83756;142678;441869;79906,65
-1,1,1,849466,3503606,2654140,85452;83858;5590;728661;199990;9636;100287898;8510;64856;26155;140625;55229;8764;65220;339456;375790;388581;148398;401934;643965;51150;8784;2782;9651;1855;27237;57801;126789;81669;29101;339453;6497;643988;126792;219293;163688;84808;388585;63976;6339;55052;254173;80772;11079;79258;984;54587;5192;54973;84069;54998;9906;116983;339451;7293;118424;728642;2563;127281;55210;54991;83756;142678;441869;1953;79906,66
-1,1,1,849466,4048535,3199069,57470;388588;85452;1677;83858;5590;127262;728661;199990;9636;100287898;8510;64856;26155;140625;55229;8764;65220;339456;375790;388581;148398;401934;643965;51150;8784;2782;9651;1855;9731;27237;57801;126789;81669;29101;339453;6497;643988;7161;126792;219293;163688;84808;388585;63976;6339;55052;254173;80772;11079;79258;984;54587;5192;54973;84069;339448;54998;9906;148870;116983;339451;7293;118424;728642;2563;127281;55210;54991;83756;142678;441869;1953;79906;49856,75
-1,1,1,849466,4099471,3250005,57470;388588;85452;1677;83858;5590;127262;728661;199990;9636;100287898;8510;64856;26155;140625;55229;8764;65220;339456;375790;388581;148398;401934;643965;51150;8784;2782;9651;1855;9731;27237;57801;126789;81669;29101;339453;6497;643988;7161;126792;219293;163688;84808;388585;63976;6339;55052;254173;80772;11079;79258;984;54587;5192;54973;84069;339448;54998;9906;148870;116983;339451;7293;118424;728642;2563;127281;55210;54991;83756;142678;441869;1953;79906;49856,75
-1,1,1,849466,5318552,4469086,57470;388588;85452;1677;83858;5590;127262;728661;199990;9636;100287898;8510;64856;26155;140625;55229;8764;65220;339456;375790;388581;148398;401934;643965;51150;8784;2782;9651;1855;9731;27237;57801;126789;81669;29101;339453;6497;643988;7161;126792;219293;163688;84808;388585;63976;6339;55052;254173;80772;11079;79258;984;54587;5192;54973;84069;339448;54998;9906;148870;116983;339451;55966;7293;118424;728642;2563;127281;55210;54991;83756;142678;441869;1953;79906;49856,76
-1,1,1,849466,5352492,4503026,57470;388588;85452;1677;83858;5590;127262;728661;199990;9636;100287898;8510;64856;26155;140625;55229;8764;65220;339456;375790;388581;148398;401934;643965;51150;8784;2782;9651;1855;9731;27237;57801;126789;81669;29101;339453;6497;643988;7161;126792;219293;163688;84808;388585;63976;6339;55052;254173;80772;11079;79258;984;54587;5192;54973;84069;339448;54998;9906;148870;116983;339451;55966;7293;118424;728642;2563;127281;55210;54991;83756;142678;441869;1953;79906;49856,76
-1,1,1,849466,5707515,4858049,57470;388588;85452;1677;83858;5590;127262;728661;199990;9636;100287898;8510;64856;26155;140625;55229;8764;65220;339456;375790;388581;148398;401934;643965;51150;8784;2782;9651;1855;9731;27237;57801;126789;81669;29101;339453;6497;643988;7161;126792;219293;163688;84808;388585;63976;6339;55052;254173;80772;11079;79258;984;54587;5192;54973;84069;339448;54998;9906;148870;116983;339451;55966;7293;118424;728642;2563;127281;55210;54991;83756;142678;441869;1953;79906;49856,76
-1,1,1,849466,6374209,5524743,57470;388588;1677;85452;83858;6146;5590;127262;728661;199990;23463;9636;100287898;8510;64856;26155;140625;55229;8764;65220;339456;261734;375790;388581;148398;401934;643965;51150;8784;2782;9651;1855;9731;27237;57801;387509;26038;126789;81669;29101;6497;339453;643988;7161;126792;219293;388591;163688;84808;11332;388585;63976;6339;11079;80772;55052;254173;79258;984;54587;8514;5192;54973;339448;84069;54998;9906;148870;116983;339451;390992;55966;7293;118424;728642;127281;2563;55210;54991;83756;142678;441869;1953;79906;49856,85
-1,1,1,849466,6505278,5655812,57470;388588;1677;85452;83858;6146;5590;127262;728661;199990;23463;9636;100287898;8510;64856;26155;140625;55229;8764;65220;339456;261734;375790;388581;148398;401934;643965;51150;8784;2782;9651;1855;9731;27237;57801;387509;26038;126789;81669;29101;6497;339453;643988;7161;126792;83715;388591;219293;163688;84808;11332;388585;63976;54626;6339;11079;80772;55052;254173;79258;984;54587;8514;5192;54973;339448;84069;54998;9906;148870;116983;339451;390992;55966;7293;118424;728642;127281;2563;55210;54991;83756;142678;441869;1953;79906;49856,87
-1,1,1,849466,6566086,5716620,57470;388588;1677;85452;83858;6146;5590;127262;728661;199990;23463;9636;100287898;8510;64856;26155;140625;55229;8764;65220;339456;261734;375790;388581;148398;401934;57449;643965;51150;8784;2782;9651;1855;9731;27237;57801;387509;26038;126789;81669;29101;6497;339453;643988;7161;126792;8718;388591;83715;219293;163688;84808;11332;388585;63976;54626;6339;11079;80772;55052;254173;79258;984;54587;8514;5192;54973;339448;84069;54998;9906;148870;116983;339451;390992;55966;7293;118424;728642;127281;2563;55210;54991;83756;142678;441869;1953;79906;49856,89
-1,1,1,849466,7300178,6450712,57470;388588;1677;85452;83858;6146;5590;127262;728661;199990;23463;9636;100287898;8510;64856;26155;140625;55229;8764;65220;339456;261734;375790;388581;90326;148398;401934;80835;55735;57449;643965;51150;8784;2782;9651;1855;9731;27237;57801;387509;26038;126789;81669;29101;6497;339453;643988;7161;126792;8718;388591;83715;219293;163688;84808;11332;388585;63976;54626;6339;11079;80772;55052;254173;148479;79258;984;54587;8514;5192;54973;339448;84069;9903;54998;9906;148870;116983;339451;390992;55966;3104;7293;118424;728642;127281;2563;55210;54991;83756;142678;441869;79707;23261;1953;79906;49856,97
-1,1,1,849466,7637060,6787594,57470;388588;1677;85452;83858;6146;5590;127262;728661;199990;23463;9636;100287898;8510;64856;26155;140625;55229;8764;65220;339456;261734;375790;388581;90326;148398;401934;80835;55735;57449;643965;51150;8784;2782;9651;1855;9731;27237;57801;387509;26038;126789;81669;29101;6497;339453;643988;7161;126792;8718;388591;83715;219293;163688;84808;11332;388585;63976;54626;6339;11079;80772;55052;254173;148479;79258;984;54587;8514;5192;54973;339448;84069;9903;54998;9906;148870;116983;339451;390992;55966;3104;7293;118424;728642;127281;2563;55210;54991;83756;142678;441869;79707;23261;1953;79906;49856,97
-1,1,1,849466,8901938,8052472,57470;388588;1677;85452;83858;6146;5590;127262;728661;199990;23463;9636;100287898;8510;64856;26155;140625;55229;10911;54206;8764;65220;339456;261734;375790;388581;90326;148398;401934;80835;55735;57449;643965;51150;8784;2782;9651;1855;9731;27237;57801;3604;387509;8863;26038;126789;81669;29101;6497;339453;643988;7161;126792;8718;388591;83715;219293;163688;84808;11332;11315;388585;63976;54626;6339;11079;80772;50651;55052;254173;148479;79258;984;54587;8514;5192;54973;339448;84069;9903;54998;9906;148870;116983;339451;390992;55966;3104;7293;118424;728642;127281;2563;55210;54991;9341;473;83756;142678;441869;79707;23261;1953;79906;49856,105
-1,1,1,849466,9627180,8777714,57470;388588;1677;85452;83858;6146;5590;127262;728661;199990;23463;9636;100287898;80176;8510;64856;765;26155;140625;55229;6518;54206;8764;10911;65220;339456;261734;375790;388581;90326;148398;9563;401934;80835;55735;57449;80045;643965;51150;2023;8784;2782;9651;1855;9731;27237;57801;155184;3604;387509;8863;26038;84275;126789;81669;29101;6497;339453;643988;7161;126792;8718;388591;83715;219293;163688;84808;11332;11315;388585;63976;54626;6339;11079;80772;50651;55052;254173;148479;79258;984;54587;8514;5192;54973;339448;84069;9903;54998;9906;148870;116983;339451;390992;55966;3104;7293;118424;728642;127281;2563;55210;54991;9341;473;83756;142678;441869;79707;23261;1953;79906;49856,113
-1,1,1,849466,9683808,8834342,57470;388588;1677;85452;83858;6146;5590;127262;728661;199990;23463;9636;100287898;80176;8510;64856;765;26155;140625;55229;6518;54206;8764;10911;65220;339456;261734;375790;388581;90326;148398;9563;401934;80835;55735;57449;80045;643965;51150;2023;8784;2782;9651;1855;9731;27237;57801;155184;3604;387509;8863;26038;84275;126789;199953;81669;29101;6497;339453;643988;7161;126792;8718;388591;83715;219293;163688;84808;11332;11315;388585;63976;54626;6339;11079;80772;50651;55052;254173;148479;79258;984;54587;8514;5192;54973;339448;84069;9903;54998;9906;148870;116983;339451;390992;55966;3104;7293;118424;728642;127281;2563;55210;54991;9341;473;83756;142678;441869;79707;23261;1953;79906;49856,114
1,1,1,849467,249224684,248375217,277;912;55432;10654;10440;378807;148930;9636;1130;5081;8510;440560;5876;3362;55700;317772;51278;115361;79368;163786;140609;728833;79098;9887;2882;23215;8290;4751;10163;3595;22889;24;148398;3158;80045;4808;643965;26052;8565;8556;127687;55635;1629;6698;55103;81559;284611;55631;253152;6846;57216;57657;163882;5867;1907;84838;127247;115362;127845;149643;6512;79699;3664;91181;163259;9214;79084;6301;336;391114;403244;81493;284532;11315;23179;10459;11079;653121;7483;6279;79258;2980;728945;92344;2780;54873;9927;729059;163732;57489;6513;149041;100532736;149628;55001;54834;128368;79707;4898;2475;142;2702;5825;8891;23432;29889;431707;391104;148418;353139;115353;391004;127069;353500;100287898;10747;23633;391196;91687;51478;148753;8634;5451;7257;84455;51727;333926;10911;23352;55113;6282;448835;913;114034;56605;2165;163589;2214;54546;10625;89866;10092;3078;84224;54823;1296;51440;84283;284486;5236;284723;81025;353142;8407;1893;9132;10218;5784;10726;5284;64710;64858;2752;1969;4359;3290;4774;2730;653149;9580;23169;339453;440563;440699;4000;391112;26135;25893;163688;5226;23499;7809;1196;2060;5993;93183;199964;7044;64793;25932;541468;27329;4688;645425;254173;25974;10638;7805;2947;347735;984;5690;5453;84243;3284;126669;6886;55827;3104;440689;79590;2981;127281;84134;10026;7398;389;9249;223;353133;23207;83756;1307;60676;55917;90231;84301;5287;79830;26292;1733;10745;55356;54455;4595;8790;10905;55249;57402;11080;1677;4681;83858;646817;134;6814;64766;200159;57554;54507;51032;4520;3140;5877;27173;23576;7371;84196;51668;23358;6275;9911;54206;6051;343099;10420;353137;9970;676;57127;9722;723790;60484;30814;9453;9048;79717;128229;4070;5929;128344;9372;5511;55721;100131187;83416;388701;140576;57822;113802;51042;8515;23566;8704;84824;6118;23435;911;6258;113451;8995;343413;163933;2048;731;54112;54558;27101;9967;554282;8564;56833;51093;200132;2948;55672;85369;257106;3491;462;375056;100131107;51706;25912;51441;55119;128272;339448;3752;9903;645745;54900;353144;118424;998;284541;58497;116228;259283;4179;6920;23507;80003;56997;3080;9398;6635;440738;23421;4063;391192;9909;8547;343472;57530;163778;5317;93611;55509;2959;79805;6705;23029;10352;1676;343173;10207;271;114883;127707;730262;353131;199834;51742;401934;55061;2268;374986;2773;22926;5710;79862;6097;51022;149420;51611;7049;3570;55732;127544;79363;148641;148534;29956;5087;84614;5928;284525;159;1912;81563;1179;50717;284521;8569;114625;25936;5549;84275;65108;5996;23046;26279;27185;1269;5538;79871;391059;2517;6202;116841;54707;84808;6504;117178;51118;22826;6847;23254;4807;3918;343521;400735;9410;27129;116496;11009;200008;57085;3925;8443;910;8751;57645;4352;55599;26027;91408;348378;5322;4998;403314;199920;1996;343171;163351;90874;400823;6271;101928120;64129;23632;84938;51375;127124;4802;64216;403239;127255;6007;84284;1491;7062;7799;26523;9890;54865;200162;2005;11266;9682;5590;100129924;23585;6700;9653;23463;10753;286826;55740;8832;90806;10630;765;55127;148979;339479;653604;3744;65220;51253;127829;115350;400818;79961;388633;51686;6391;57449;149603;388695;9826;2023;199870;65243;23127;54460;5313;391003;114803;388610;728116;10401;55707;80143;192670;6018;1580;64121;23126;284467;58511;2899;284654;57111;23436;343505;5664;64756;126637;127703;9588;8503;10327;1647;113444;6135;54741;26009;23028;54987;653519;128308;4931;391190;8718;51177;9019;647219;84966;51100;56882;81629;27097;779;6401;23612;6708;79180;284695;83941;9923;777;64175;7188;56950;25802;57549;6403;2786;4656;3964;4904;279;8991;23623;656;54991;80342;3713;51249;149563;55277;3953;51463;84618;8880;9672;127602;6016;55225;249;25950;57470;1117;56998;10885;64853;9813;1118;467;80149;440585;1604;353238;80135;64222;148281;80176;57821;4919;55108;388595;5298;10223;730159;163404;65123;127064;339398;79894;128153;644634;149647;90326;7133;5052;8497;26994;9898;10100;91156;388646;51150;54665;7813;343066;127253;5865;6006;79753;261726;5788;339501;57710;553115;431704;280;163782;149297;79630;6703;256435;114827;128077;81573;5733;388697;339487;100527963;126859;374946;148523;1465;1513;2205;4660;356;118427;725;8707;81626;8431;80263;149461;204;6883;148741;22911;10623;1660;25790;80834;2827;80222;477;29949;8674;51133;8412;10451;164153;23334;10487;56956;51086;400745;56900;149465;54998;8289;6429;2848;3915;128367;6675;7293;10067;204851;5498;401992;405;59352;23557;92241;607;257194;8672;84251;80128;56776;9411;9917;148304;10765;22796;2331;127077;23385;63036;1944;388630;23219;10628;714;128312;27095;149478;200186;127623;89886;64856;5692;83953;127731;1650;63967;63923;8394;200010;149499;26232;148811;6518;722;4139;9829;10136;261734;10446;81888;339512;3208;9563;51361;11126;4610;6646;5195;1131;83881;653820;57823;51102;2275;148789;2052;26227;5351;84871;2782;8761;6273;23443;79605;832;440574;9877;84432;58;128061;57535;9910;57592;343169;149466;255738;128025;26508;81669;8548;4146;84950;50809;1263;6497;284697;25949;7161;1952;81472;127066;400736;63950;2330;2590;92346;85414;388677;3766;441933;1870;3756;54879;23456;64645;2209;79727;3898;9725;5906;164127;343071;84967;8543;90853;6464;29957;126755;729528;148345;7709;713;27022;55243;6913;55532;2135;10691;919;1435;79656;115273;57463;473;6536;2224;93185;9507;9064;3061;7804;50848;864;401994;388588;5743;9095;55223;84944;3782;199990;23155;1901;149175;27159;164118;81469;84886;255231;55224;83540;200150;84734;93974;4725;9528;200081;83442;2166;55229;26119;914;65005;255928;8574;110117498;712;7412;54935;92312;51430;3020;127385;101927844;64064;6421;25973;64123;192669;127795;128346;81627;23400;375057;23013;84976;1805;164091;8784;163859;387338;387597;533;79679;114548;260425;515;9077;55057;29914;56893;9869;27005;23569;8863;23114;199953;128239;51060;4803;3192;65979;84065;110117499;440695;5629;51018;115209;79729;103;55187;10903;149111;10000;25874;80232;79639;55624;55974;27245;54802;7159;7579;390992;65260;23380;92342;388743;2944;254879;9341;6375;3775;9859;1380;727684;80267;149428;8668;54955;22874;79577;576;84722;55699;65121;115352;100526739;10763;339559;1163;22887;4893;391107;2140;117145;2787;6402;55650;55758;79647;8560;11085;51744;391013;55083;25903;80896;339403;5909;83872;6491;5565;79626;55746;353132;353140;100534012;23252;909;339456;441925;6342;10456;100505741;8613;51538;284546;645922;84033;1520;254268;255631;79947;29929;1600;8915;64769;26245;79005;353299;9047;127003;200172;64407;6390;100132074;84328;22920;1314;7143;149483;183;252995;127391;10878;89796;11022;23271;343263;64746;388662;84230;10542;1266;54964;54680;2634;8934;127733;1043;127068;646627;79802;126792;10450;149373;9635;23139;64754;148479;254428;4170;148808;5686;55450;9783;494115;7832;732;58512;84919;55210;284680;338324;5586;55182;34;10380;844;1939;5872;4881;163590;4811;148823;27042;5997;51097;9447;90780;56256;10962;128240;127262;54583;55220;101928436;440730;388698;4259;1503;49860;5208;51107;574414;64600;51043;441871;127833;391189;10657;3310;127670;79762;57795;1382;6548;127495;107181291;8073;441932;6000;84217;57685;57326;3068;63931;23596;7100;3737;84970;163747;199857;83417;391195;9473;57829;6277;1185;6723;5320;3151;26188;55920;4438;63906;91624;155184;54996;148362;113452;1141;3604;1945;11146;11123;90529;8682;645382;54499;126695;92235;127074;64388;8703;7812;10236;2987;26191;149069;54856;128372;553;2306;11332;126731;55194;388585;6746;55657;79654;127665;9939;55765;93273;54973;3633;23648;148870;27252;962;51506;55966;81448;8804;7798;728642;7268;645414;2329;440590;6944;127540;114771;10896;23248;3645;343068;2104;148327;10899;7780;7827;200185;149281;9659;25909;148545;2582;3428;57568;126917;58480;11189;353135;10877;57648;58985;11221;128387;26750;149076;56063;200035;6706;164045;5321;59349;140625;80133;81839;7175;3930;2629;276;55268;257177;2029;388581;375790;64218;55248;128360;80835;126820;126868;440561;1942;3914;127002;56957;9651;10561;3283;5016;8370;84842;255104;148738;81569;84451;9295;632;9403;1441;148867;8337;6041;845;1122;10022;85440;6900;149018;440712;374955;55204;388591;64834;57165;51205;126767;991;29765;7678;9204;23065;79078;4608;284677;6283;50651;5768;5142;4194;117143;7135;29920;284565;3142;54432;84072;3707;54627;9673;10806;391123;4720;100129094;388692;11243;128366;142678;441869;3765;81470;343406;5792;2703;55143;100526835;79693;83998;9557;23418;79573;7286;10485;5362;57035;1806;2117;22977;22854;10216;79169;55629;353143;4878;6121;440603;3075;23528;1718;11313;57863;51127;57134;5563;343035;2210;2537;1486;2709;3065;59269;57115;9213;5999;6004;8317;64744;10472;3932;11124;5279;9202;388722;79932;267002;391002;60313;6276;126668;149013;127550;375061;23381;5546;51377;55616;338094;199974;81607;3814;54797;29937;81494;9181;10500;7107;1104;359948;481;127700;375035;3738;114784;391194;6195;476;79814;5132;51603;10946;55924;116461;5972;54936;51514;64801;7292;8338;8643;645142;57413;6726;653598;374969;7059;1802;55585;55929;100132406;388611;23266;126823;4879;54587;127059;51094;81442;55970;339451;29922;51179;64802;56944;84320;83593;116362;23154;128371;54361;6699;644591;8416;9283;54751;55733;89872;1953;8476;9462;55283;10390;10250;93190;23285;22955;6146;6924;728661;7388;79957;55105;480;127579;51029;2949;54933;2328;460;84879;10717;6280;284615;64326;26246;3586;643314;3716;6738;400757;252839;4009;23318;128338;401993;9068;606495;80851;54953;10103;55891;54482;10228;8349;91544;9129;5778;1429;2672;2326;23341;200205;5738;27;55160;79574;126969;9670;7482;3155;51027;6248;65018;79000;388753;55157;374977;10262;6003;387509;4853;79033;2215;1379;6487;9406;643988;22883;9156;26092;93474;7389;9122;3321;148423;259266;81611;3352;127933;63976;88;4580;26270;80772;343450;84958;2701;54596;57576;126638;55791;178;79570;1063;2635;399474;11147;10712;55811;54855;54544;3339;5202;26289;50999;2327;9015;112970;9293;388730;57147;29899;51154;284613;49856;81609;85452;440567;360023;148581;65094;2633;4184;84288;3725;374973;6894;1116;9857;50604;947;963;126626;51592;149345;378708;4332;10772;284656;84144;57185;127018;8458;56267;25782;148932;6704;6278;2058;2046;54344;80308;127943;54897;284498;2170;4678;317705;728621;2707;58155;55793;7802;127294;27237;23095;140;343069;353141;4914;64783;55706;2134;339488;126789;55116;83931;1378;142683;27285;7042;128218;6045;10256;388759;5174;1401;219293;391109;26099;26254;85397;554313;5567;4582;63827;29089;2271;55052;23032;2532;54896;5192;81466;127062;84069;9906;116983;57643;100506144;30836;112770;63948;57459;4014;25778;127435;441873;100381270;23261;29097;100128071;84146;257;55870;348487;79906;6232;375;400793;9698;2810;55705;26476;10277;92815;84265;8438;100527978;57540;4985;7252;10076;55154;200014;84066;126961;842;11330;1573;3776;26155;10969;353145;11004;10560;339416;8764;5051;284716;448834;9816;27246;4116;2035;115572;60672;2152;28982;9900;55170;375033;1855;2494;28956;6274;54810;57801;353134;7391;391211;333932;5737;81849;55600;127343;26038;27293;2207;50486;8659;7399;9804;493;2153;9641;284485;10465;9261;80818;128209;83479;2312;1999;10158;5824;6701;284612;7779;149233;5724;266675;54874;6339;339541;3652;2213;8444;26696;391191;5396;57190;127396;11000;10489;8514;7170;400746;6272;7203;1579;4237;729533;29943;79594;25896;6566;401944;339500;5129;149371;1031;64789;57198;3749;390999;10269;260293;9191;10637;1187;9860;922;26097;829;64757;7139;57708;7075;11223;22802;4817;2212;388650;114836;10286;23673;23038;1889;26239;149095;1810;127254;6905;4209;6281;51702;978;128178;11240;254910;7818;9928;11218;6884;646262;943;57116;10768;2946;55735;257101;64960;149473;81788;343563;8799;163479;653619;653464;10964;3608;83873;9731;100129271;54952;55144;4653;79927;278;84676;388649;127534;79819;83932;79140;4524;205;5394;84648;4548;163702;6262;325;163486;57095;441911;127428;29101;22996;270;1325;9674;23208;55092;4343;343172;83715;9696;79971;654790;56181;1298;6125;6707;55219;112950;89780;54626;5525;824;8490;11311;23057;92703;115019;4921;204962;65122;89884;1510;2563;2301;1301;22823;6284;117157;200030;1188;83667;100191040;257044;57172;51058;3399;1376;79739;81875;965;5293;9926,1987
1,1,1,849467,249224684,248375217,277;912;55432;10654;10440;378807;148930;9636;1130;5081;8510;440560;5876;3362;55700;317772;51278;115361;79368;163786;140609;728833;79098;9887;2882;23215;8290;4751;10163;3595;22889;24;148398;3158;80045;4808;643965;26052;8565;8556;127687;55635;1629;6698;55103;81559;284611;55631;253152;6846;57216;57657;163882;5867;1907;84838;127247;115362;127845;149643;6512;79699;3664;91181;163259;9214;79084;6301;336;391114;403244;81493;284532;11315;23179;10459;11079;653121;7483;6279;79258;2980;728945;92344;2780;54873;9927;729059;163732;57489;6513;149041;100532736;149628;55001;54834;128368;79707;4898;2475;142;2702;5825;8891;23432;29889;431707;391104;148418;353139;115353;391004;127069;353500;100287898;10747;23633;391196;91687;51478;148753;8634;5451;7257;84455;51727;333926;10911;23352;55113;6282;448835;913;114034;56605;2165;163589;2214;54546;10625;89866;10092;3078;84224;54823;1296;51440;84283;284486;5236;284723;81025;353142;8407;1893;9132;10218;5784;10726;5284;64710;64858;2752;1969;4359;3290;4774;2730;653149;9580;23169;339453;440563;440699;4000;391112;26135;25893;163688;5226;23499;7809;1196;2060;5993;93183;199964;7044;64793;25932;541468;27329;4688;645425;254173;25974;10638;7805;2947;347735;984;5690;5453;84243;3284;126669;6886;55827;3104;440689;79590;2981;127281;84134;10026;7398;389;9249;223;353133;23207;83756;1307;60676;55917;90231;84301;5287;79830;26292;1733;10745;55356;54455;4595;8790;10905;55249;57402;11080;1677;4681;83858;646817;134;6814;64766;200159;57554;54507;51032;4520;3140;5877;27173;23576;7371;84196;51668;23358;6275;9911;54206;6051;343099;10420;353137;9970;676;57127;9722;723790;60484;30814;9453;9048;79717;128229;4070;5929;128344;9372;5511;55721;100131187;83416;388701;140576;57822;113802;51042;8515;23566;8704;84824;6118;23435;911;6258;113451;8995;343413;163933;2048;731;54112;54558;27101;9967;554282;8564;56833;51093;200132;2948;55672;85369;257106;3491;462;375056;100131107;51706;25912;51441;55119;128272;339448;3752;9903;645745;54900;353144;118424;998;284541;58497;116228;259283;4179;6920;23507;80003;56997;3080;9398;6635;440738;23421;4063;391192;9909;8547;343472;57530;163778;5317;93611;55509;2959;79805;6705;23029;10352;1676;343173;10207;271;114883;127707;730262;353131;199834;51742;401934;55061;2268;374986;2773;22926;5710;79862;6097;51022;149420;51611;7049;3570;55732;127544;79363;148641;148534;29956;5087;84614;5928;284525;159;1912;81563;1179;50717;284521;8569;114625;25936;5549;84275;65108;5996;23046;26279;27185;1269;5538;79871;391059;2517;6202;116841;54707;84808;6504;117178;51118;22826;6847;23254;4807;3918;343521;400735;9410;27129;116496;11009;200008;57085;3925;8443;910;8751;57645;4352;55599;26027;91408;348378;5322;4998;403314;199920;1996;343171;163351;90874;400823;6271;101928120;64129;23632;84938;51375;127124;4802;64216;403239;127255;6007;84284;1491;7062;7799;26523;9890;54865;200162;2005;11266;9682;5590;100129924;23585;6700;9653;23463;10753;286826;55740;8832;90806;10630;765;55127;148979;339479;653604;3744;65220;51253;127829;115350;400818;79961;388633;51686;6391;57449;149603;388695;9826;2023;199870;65243;23127;54460;5313;391003;114803;388610;728116;10401;55707;80143;192670;6018;1580;64121;23126;284467;58511;2899;284654;57111;23436;343505;5664;64756;126637;127703;9588;8503;10327;1647;113444;6135;54741;26009;23028;54987;653519;128308;4931;391190;8718;51177;9019;647219;84966;51100;56882;81629;27097;779;6401;23612;6708;79180;284695;83941;9923;777;64175;7188;56950;25802;57549;6403;2786;4656;3964;4904;279;8991;23623;656;54991;80342;3713;51249;149563;55277;3953;51463;84618;8880;9672;127602;6016;55225;249;25950;57470;1117;56998;10885;64853;9813;1118;467;80149;440585;1604;353238;80135;64222;148281;80176;57821;4919;55108;388595;5298;10223;730159;163404;65123;127064;339398;79894;128153;644634;149647;90326;7133;5052;8497;26994;9898;10100;91156;388646;51150;54665;7813;343066;127253;5865;6006;79753;261726;5788;339501;57710;553115;431704;280;163782;149297;79630;6703;256435;114827;128077;81573;5733;388697;339487;100527963;126859;374946;148523;1465;1513;2205;4660;356;118427;725;8707;81626;8431;80263;149461;204;6883;148741;22911;10623;1660;25790;80834;2827;80222;477;29949;8674;51133;8412;10451;164153;23334;10487;56956;51086;400745;56900;149465;54998;8289;6429;2848;3915;128367;6675;7293;10067;204851;5498;401992;405;59352;23557;92241;607;257194;8672;84251;80128;56776;9411;9917;148304;10765;22796;2331;127077;23385;63036;1944;388630;23219;10628;714;128312;27095;149478;200186;127623;89886;64856;5692;83953;127731;1650;63967;63923;8394;200010;149499;26232;148811;6518;722;4139;9829;10136;261734;10446;81888;339512;3208;9563;51361;11126;4610;6646;5195;1131;83881;653820;57823;51102;2275;148789;2052;26227;5351;84871;2782;8761;6273;23443;79605;832;440574;9877;84432;58;128061;57535;9910;57592;343169;149466;255738;128025;26508;81669;8548;4146;84950;50809;1263;6497;284697;25949;7161;1952;81472;127066;400736;63950;2330;2590;92346;85414;388677;3766;441933;1870;3756;54879;23456;64645;2209;79727;3898;9725;5906;164127;343071;84967;8543;90853;6464;29957;126755;729528;148345;7709;713;27022;55243;6913;55532;2135;10691;919;1435;79656;115273;57463;473;6536;2224;93185;9507;9064;3061;7804;50848;864;401994;388588;5743;9095;55223;84944;3782;199990;23155;1901;149175;27159;164118;81469;84886;255231;55224;83540;200150;84734;93974;4725;9528;200081;83442;2166;55229;26119;914;65005;255928;8574;110117498;712;7412;54935;92312;51430;3020;127385;101927844;64064;6421;25973;64123;192669;127795;128346;81627;23400;375057;23013;84976;1805;164091;8784;163859;387338;387597;533;79679;114548;260425;515;9077;55057;29914;56893;9869;27005;23569;8863;23114;199953;128239;51060;4803;3192;65979;84065;110117499;440695;5629;51018;115209;79729;103;55187;10903;149111;10000;25874;80232;79639;55624;55974;27245;54802;7159;7579;390992;65260;23380;92342;388743;2944;254879;9341;6375;3775;9859;1380;727684;80267;149428;8668;54955;22874;79577;576;84722;55699;65121;115352;100526739;10763;339559;1163;22887;4893;391107;2140;117145;2787;6402;55650;55758;79647;8560;11085;51744;391013;55083;25903;80896;339403;5909;83872;6491;5565;79626;55746;353132;353140;100534012;23252;909;339456;441925;6342;10456;100505741;8613;51538;284546;645922;84033;1520;254268;255631;79947;29929;1600;8915;64769;26245;79005;353299;9047;127003;200172;64407;6390;100132074;84328;22920;1314;7143;149483;183;252995;127391;10878;89796;11022;23271;343263;64746;388662;84230;10542;1266;54964;54680;2634;8934;127733;1043;127068;646627;79802;126792;10450;149373;9635;23139;64754;148479;254428;4170;148808;5686;55450;9783;494115;7832;732;58512;84919;55210;284680;338324;5586;55182;34;10380;844;1939;5872;4881;163590;4811;148823;27042;5997;51097;9447;90780;56256;10962;128240;127262;54583;55220;101928436;440730;388698;4259;1503;49860;5208;51107;574414;64600;51043;441871;127833;391189;10657;3310;127670;79762;57795;1382;6548;127495;107181291;8073;441932;6000;84217;57685;57326;3068;63931;23596;7100;3737;84970;163747;199857;83417;391195;9473;57829;6277;1185;6723;5320;3151;26188;55920;4438;63906;91624;155184;54996;148362;113452;1141;3604;1945;11146;11123;90529;8682;645382;54499;126695;92235;127074;64388;8703;7812;10236;2987;26191;149069;54856;128372;553;2306;11332;126731;55194;388585;6746;55657;79654;127665;9939;55765;93273;54973;3633;23648;148870;27252;962;51506;55966;81448;8804;7798;728642;7268;645414;2329;440590;6944;127540;114771;10896;23248;3645;343068;2104;148327;10899;7780;7827;200185;149281;9659;25909;148545;2582;3428;57568;126917;58480;11189;353135;10877;57648;58985;11221;128387;26750;149076;56063;200035;6706;164045;5321;59349;140625;80133;81839;7175;3930;2629;276;55268;257177;2029;388581;375790;64218;55248;128360;80835;126820;126868;440561;1942;3914;127002;56957;9651;10561;3283;5016;8370;84842;255104;148738;81569;84451;9295;632;9403;1441;148867;8337;6041;845;1122;10022;85440;6900;149018;440712;374955;55204;388591;64834;57165;51205;126767;991;29765;7678;9204;23065;79078;4608;284677;6283;50651;5768;5142;4194;117143;7135;29920;284565;3142;54432;84072;3707;54627;9673;10806;391123;4720;100129094;388692;11243;128366;142678;441869;3765;81470;343406;5792;2703;55143;100526835;79693;83998;9557;23418;79573;7286;10485;5362;57035;1806;2117;22977;22854;10216;79169;55629;353143;4878;6121;440603;3075;23528;1718;11313;57863;51127;57134;5563;343035;2210;2537;1486;2709;3065;59269;57115;9213;5999;6004;8317;64744;10472;3932;11124;5279;9202;388722;79932;267002;391002;60313;6276;126668;149013;127550;375061;23381;5546;51377;55616;338094;199974;81607;3814;54797;29937;81494;9181;10500;7107;1104;359948;481;127700;375035;3738;114784;391194;6195;476;79814;5132;51603;10946;55924;116461;5972;54936;51514;64801;7292;8338;8643;645142;57413;6726;653598;374969;7059;1802;55585;55929;100132406;388611;23266;126823;4879;54587;127059;51094;81442;55970;339451;29922;51179;64802;56944;84320;83593;116362;23154;128371;54361;6699;644591;8416;9283;54751;55733;89872;1953;8476;9462;55283;10390;10250;93190;23285;22955;6146;6924;728661;7388;79957;55105;480;127579;51029;2949;54933;2328;460;84879;10717;6280;284615;64326;26246;3586;643314;3716;6738;400757;252839;4009;23318;128338;401993;9068;606495;80851;54953;10103;55891;54482;10228;8349;91544;9129;5778;1429;2672;2326;23341;200205;5738;27;55160;79574;126969;9670;7482;3155;51027;6248;65018;79000;388753;55157;374977;10262;6003;387509;4853;79033;2215;1379;6487;9406;643988;22883;9156;26092;93474;7389;9122;3321;148423;259266;81611;3352;127933;63976;88;4580;26270;80772;343450;84958;2701;54596;57576;126638;55791;178;79570;1063;2635;399474;11147;10712;55811;54855;54544;3339;5202;26289;50999;2327;9015;112970;9293;388730;57147;29899;51154;284613;49856;81609;85452;440567;360023;148581;65094;2633;4184;84288;3725;374973;6894;1116;9857;50604;947;963;126626;51592;149345;378708;4332;10772;284656;84144;57185;127018;8458;56267;25782;148932;6704;6278;2058;2046;54344;80308;127943;54897;284498;2170;4678;317705;728621;2707;58155;55793;7802;127294;27237;23095;140;343069;353141;4914;64783;55706;2134;339488;126789;55116;83931;1378;142683;27285;7042;128218;6045;10256;388759;5174;1401;219293;391109;26099;26254;85397;554313;5567;4582;63827;29089;2271;55052;23032;2532;54896;5192;81466;127062;84069;9906;116983;57643;100506144;30836;112770;63948;57459;4014;25778;127435;441873;100381270;23261;29097;100128071;84146;257;55870;348487;79906;6232;375;400793;9698;2810;55705;26476;10277;92815;84265;8438;100527978;57540;4985;7252;10076;55154;200014;84066;126961;842;11330;1573;3776;26155;10969;353145;11004;10560;339416;8764;5051;284716;448834;9816;27246;4116;2035;115572;60672;2152;28982;9900;55170;375033;1855;2494;28956;6274;54810;57801;353134;7391;391211;333932;5737;81849;55600;127343;26038;27293;2207;50486;8659;7399;9804;493;2153;9641;284485;10465;9261;80818;128209;83479;2312;1999;10158;5824;6701;284612;7779;149233;5724;266675;54874;6339;339541;3652;2213;8444;26696;391191;5396;57190;127396;11000;10489;8514;7170;400746;6272;7203;1579;4237;729533;29943;79594;25896;6566;401944;339500;5129;149371;1031;64789;57198;3749;390999;10269;260293;9191;10637;1187;9860;922;26097;829;64757;7139;57708;7075;11223;22802;4817;2212;388650;114836;10286;23673;23038;1889;26239;149095;1810;127254;6905;4209;6281;51702;978;128178;11240;254910;7818;9928;11218;6884;646262;943;57116;10768;2946;55735;257101;64960;149473;81788;343563;8799;163479;653619;653464;10964;3608;83873;9731;100129271;54952;55144;4653;79927;278;84676;388649;127534;79819;83932;79140;4524;205;5394;84648;4548;163702;6262;325;163486;57095;441911;127428;29101;22996;270;1325;9674;23208;55092;4343;343172;83715;9696;79971;654790;56181;1298;6125;6707;55219;112950;89780;54626;5525;824;8490;11311;23057;92703;115019;4921;204962;65122;89884;1510;2563;2301;1301;22823;6284;117157;200030;1188;83667;100191040;257044;57172;51058;3399;1376;79739;81875;965;5293;9926,1987
1,-1,1,852863,1008286,155423,375790;84808;84069;148398;401934;26155;339451;9636;57801,9
1,-1,1,852863,1008286,155423,375790;84808;84069;148398;401934;26155;339451;9636;57801,9
-1,1,1,885378,5396112,4510734,57470;388588;85452;1677;83858;5590;127262;728661;199990;9636;100287898;8510;64856;26155;140625;55229;8764;65220;339456;375790;388581;401934;643965;51150;8784;2782;9651;1855;9731;27237;57801;126789;81669;29101;339453;6497;643988;7161;126792;219293;163688;84808;388585;63976;6339;55052;254173;80772;11079;79258;984;54587;5192;54973;84069;339448;54998;9906;148870;116983;339451;55966;7293;118424;728642;2563;127281;55210;54991;83756;142678;441869;1953;79906;49856,75
-1,1,1,885378,6635005,5749627,57470;388588;1677;85452;83858;6146;5590;127262;728661;199990;23463;9636;100287898;8510;64856;26155;140625;55229;8764;65220;339456;261734;375790;388581;401934;80835;57449;643965;51150;8784;2782;9651;1855;9731;27237;57801;387509;26038;126789;81669;29101;6497;339453;643988;7161;126792;8718;388591;83715;219293;163688;84808;11332;388585;63976;54626;6339;11079;80772;55052;254173;79258;984;54587;8514;5192;54973;339448;84069;54998;9906;148870;116983;339451;390992;55966;7293;118424;728642;127281;2563;55210;54991;83756;142678;441869;79707;1953;79906;49856,90
1,-1,1,889745,897726,7981,339451;26155,2
1,-1,1,890945,1008286,117341,375790;84808;84069;401934;26155;339451;9636;57801,8
1,-1,1,913631,1008286,94655,375790;9636;84808;57801;401934,5
1,-1,1,913631,1008286,94655,375790;9636;84808;57801;401934,5
1,-1,1,913631,1008286,94655,375790;9636;84808;57801;401934,5
1,-1,1,931484,1008286,76802,375790;401934;9636;57801,4
-1,1,1,948461,1654038,705577,83858;126789;81669;728661;29101;339453;643988;9636;126792;219293;8510;64856;6339;55052;80772;254173;375790;984;388581;54587;54973;401934;54998;116983;643965;51150;7293;118424;728642;8784;55210;54991;1855;83756;142678;441869,36
-1,1,1,957474,4725355,3767881,57470;388588;85452;1677;83858;5590;127262;728661;199990;100287898;8510;64856;140625;55229;8764;65220;339456;375790;388581;401934;643965;51150;8784;2782;9651;1855;9731;27237;126789;81669;29101;339453;6497;643988;7161;126792;219293;163688;388585;63976;6339;55052;80772;254173;11079;79258;984;54587;5192;54973;339448;54998;9906;148870;116983;55966;7293;118424;728642;2563;127281;55210;54991;83756;142678;441869;1953;79906;49856,69
1,-1,1,964697,1008286,43589,375790;401934,2
1,-1,1,964697,1008286,43589,375790;401934,2
1,-1,1,964697,1008286,43589,375790;401934,2
1,-1,1,964697,1008286,43589,375790;401934,2
1,-1,1,964697,1008286,43589,375790;401934,2
-1,1,1,1008286,2723403,1715117,85452;83858;126789;5590;81669;728661;29101;199990;339453;6497;643988;100287898;126792;219293;8510;163688;64856;388585;55229;55052;6339;80772;254173;65220;339456;11079;8764;79258;984;388581;54587;54973;5192;401934;54998;9906;116983;643965;51150;7293;118424;728642;2563;127281;8784;55210;2782;54991;1855;9651;83756;142678;441869;79906,54
-1,1,1,1054016,4239140,3185124,57470;388588;85452;1677;83858;5590;127262;728661;199990;100287898;8510;64856;140625;55229;8764;65220;339456;388581;643965;51150;8784;2782;9651;1855;9731;27237;126789;81669;29101;339453;6497;643988;7161;126792;219293;163688;388585;63976;55052;6339;80772;254173;11079;79258;984;54587;5192;54973;339448;54998;9906;148870;116983;7293;118424;728642;2563;127281;55210;83756;142678;441869;1953;79906;49856,65
-1,-1,1,1078536,1158683,80147,254173;51150;7293;8784,4
1,-1,1,1226242,1268865,42623,126789;54973;6339;80772;83756;116983,6
1,-1,1,1241799,1268865,27066,54973;126789;80772;83756;116983,5
1,-1,1,1387704,1425677,37973,219293;83858,2
-1,-1,1,1400189,1425677,25488,219293;83858,2
-1,-1,1,1400189,1425677,25488,219293;83858,2
-1,-1,1,1400189,1425677,25488,219293;83858,2
-1,-1,1,1400189,1425677,25488,219293;83858,2
1,-1,1,1403417,1462949,59532,219293;55210;83858,3
-1,1,1,1415800,5007235,3591435,57470;388588;85452;1677;83858;5590;127262;728661;29101;199990;339453;6497;643988;7161;100287898;163688;8510;140625;388585;63976;55229;11079;8764;65220;339456;79258;984;5192;339448;148870;9906;55966;728642;127281;2563;55210;2782;9651;9731;27237;142678;1953;79906;49856,44
-1,-1,1,1417977,1451373,33396,55210;83858,2
-1,1,1,1538143,2140271,602128,163688;8510;984;2782;85452;5590;142678;728661;9906;199990;65220;728642;339456;2563,14
1,-1,1,2495137,2620704,125567,79258;127281;100287898;8764,4
-1,-1,1,2582760,2633368,50608,100287898,1
-1,-1,1,2582760,2633368,50608,100287898,1
1,-1,1,2582760,2633368,50608,100287898,1
1,-1,1,2590844,2605254,14410,100287898,1
1,-1,1,2590844,2605254,14410,100287898,1
1,-1,1,2590844,2605254,14410,100287898,1
1,-1,1,2590844,2605254,14410,100287898,1
1,-1,1,2590844,2605254,14410,100287898,1
1,-1,1,2609223,2631378,22155,100287898,1
1,-1,1,2736695,2922757,186062,,0
-1,1,1,2749920,22564787,19814867,10277;100526739;1677;93190;4681;6146;63036;57540;23463;126917;51032;5081;391013;440560;842;10630;11330;3362;5909;84196;765;127731;140625;1650;26232;6518;54206;10136;261734;9563;30814;80835;57449;80045;5195;60672;2023;440561;391003;5351;55707;23341;6390;55160;84328;832;440574;6248;65018;23435;255104;23436;387509;81569;26038;163933;8659;50809;7161;22883;400736;127733;374955;8718;388591;55672;126767;11315;23065;84966;63976;10459;26270;50651;343071;148479;57576;79180;8514;128272;339448;126755;9903;9927;148345;729528;7709;4237;55450;100532736;29943;79594;401944;3339;998;473;79707;149563;2475;390999;51154;49856;1187;249;57470;388588;56998;440567;127262;11223;391004;93611;353238;4878;22977;10747;80176;1889;64600;441871;388595;1676;378708;51702;127707;10911;23352;978;11240;8574;90326;7133;943;55735;54897;284498;54546;23400;391002;23013;84224;653619;343066;79363;9731;1185;27237;6723;5320;284723;23095;55920;343069;23252;10218;29914;155184;4524;5394;3604;23569;8863;1969;114827;84275;26279;199953;374946;1325;645382;440563;79814;55092;83715;9696;5226;26099;55187;11332;645425;54626;80834;23254;400735;57085;4879;27129;54896;148870;400745;390992;55966;65122;3104;5322;64802;645414;116362;441873;54361;9249;9341;1188;23207;23261;54751;90231;727684;1953;84301;348487;343068;8672;5293;54455;65121;7799,217
-1,1,1,2785042,7392629,4607587,57470;388588;1677;26038;6146;127262;23463;7161;83715;8718;388591;11332;140625;63976;54626;261734;148479;8514;90326;339448;9903;148870;80835;390992;57449;55735;55966;3104;9731;27237;79707;23261;1953;49856;387509,35
-1,1,1,2793822,7510850,4717028,57470;388588;1677;26038;6146;127262;23463;7161;83715;8718;388591;11332;140625;63976;54626;261734;148479;8514;90326;339448;9903;148870;80835;390992;57449;55735;55966;3104;9731;27237;79707;23261;1953;49856;387509,35
-1,1,1,2817420,10670878,7853458,57470;388588;1677;56998;10277;6146;100526739;127262;23463;80176;1676;765;378708;140625;10911;54206;6518;261734;90326;9563;80835;55735;57449;80045;5195;2023;9731;27237;84328;23095;155184;3604;387509;8863;26038;84275;199953;1325;7161;22883;83715;8718;388591;5226;11332;11315;63976;54626;50651;148479;8514;339448;9903;148870;390992;55966;3104;64802;116362;9341;473;23261;79707;1953;49856;5293,66
-1,1,1,2822585,5396176,2573591,57470;388588;1677;9731;127262;27237;339448;148870;140625;63976;55966;1953;7161;49856,14
1,1,1,3628652,4087427,458775,57470;388588;1677;7161;9731;148870;339448,7
1,1,1,3628652,4087427,458775,57470;388588;1677;7161;9731;148870;339448,7
-1,1,1,3657629,9018919,5361290,57470;388588;1677;26038;8863;6146;23463;8718;83715;388591;11332;765;11315;54626;10911;54206;50651;261734;148479;8514;90326;339448;9903;148870;80835;390992;57449;55735;55966;3104;2023;9341;9731;473;23261;79707;3604;387509,38
-1,1,1,4558588,13187457,8628869,10277;100526739;93190;56998;6146;57540;23463;93611;4878;10747;80176;440560;441871;1676;765;378708;26232;6518;54206;10911;261734;90326;7133;9563;943;80835;55735;57449;80045;5195;60672;54897;284498;2023;440561;391003;5351;343066;1185;84328;6723;23095;343069;10218;23435;29914;4524;155184;5394;3604;387509;8863;26038;84275;199953;374946;1325;440563;22883;8718;83715;388591;5226;126767;55187;11332;11315;10459;54626;26270;50651;343071;148479;400735;57085;4879;8514;9903;9927;148345;390992;55966;65122;3104;64802;116362;9249;9341;473;23261;79707;2475;90231;390999;5293;65121,96
-1,1,1,4958499,12971757,8013258,10277;100526739;93190;56998;6146;57540;23463;93611;4878;10747;80176;440560;1676;765;378708;26232;6518;54206;10911;261734;90326;7133;9563;943;80835;55735;57449;80045;5195;60672;54897;284498;2023;5351;343066;1185;84328;6723;23095;343069;10218;23435;29914;4524;155184;5394;3604;387509;8863;26038;84275;199953;374946;1325;22883;8718;83715;388591;5226;126767;55187;11332;11315;10459;54626;26270;50651;343071;148479;400735;57085;4879;8514;9903;9927;148345;390992;65122;3104;64802;116362;9249;9341;473;23261;79707;2475;90231;390999;5293;65121,91
-1,1,1,5270319,8576813,3306494,8863;26038;6146;8514;90326;9903;80835;390992;57449;55735;23463;3104;387509;83715;8718;388591;9341;473;11332;23261;11315;261734;79707;54626;10911;54206;50651;3604;148479,29
-1,1,1,5423886,18686796,13262910,10277;100526739;93190;6146;63036;57540;23463;51032;440560;842;10630;11330;765;26232;6518;54206;261734;9563;80835;57449;80045;5195;60672;2023;440561;391003;5351;55707;23341;6390;55160;84328;6248;23435;387509;81569;26038;22883;400736;374955;8718;388591;55672;126767;11315;84966;10459;26270;50651;343071;148479;79180;8514;128272;126755;9903;9927;148345;729528;7709;4237;29943;473;79707;149563;2475;390999;1187;56998;440567;11223;391004;93611;353238;4878;10747;80176;441871;388595;1676;378708;51702;10911;11240;90326;7133;943;55735;54897;284498;23400;391002;23013;653619;343066;79363;1185;6723;284723;23095;55920;343069;10218;29914;4524;155184;5394;3604;23569;8863;1969;114827;84275;199953;374946;1325;645382;440563;79814;55092;83715;9696;5226;26099;55187;11332;645425;54626;23254;400735;57085;4879;27129;390992;65122;3104;64802;645414;116362;441873;9249;9341;1188;23207;23261;54751;90231;727684;84301;348487;343068;5293;54455;65121;7799,155
-1,1,1,6363701,16125588,9761887,10277;100526739;93190;56998;63036;57540;391004;93611;4878;10747;51032;80176;440560;842;10630;11330;441871;388595;1676;765;378708;26232;6518;54206;10911;90326;7133;9563;943;80835;55735;57449;80045;5195;60672;54897;284498;391002;2023;440561;391003;653619;5351;343066;23341;1185;84328;6723;284723;23095;343069;6248;10218;23435;29914;4524;155184;5394;3604;8863;114827;84275;199953;374946;1325;645382;440563;79814;22883;400736;55092;8718;83715;5226;126767;55187;11332;11315;10459;645425;54626;26270;23254;50651;343071;148479;400735;57085;4879;79180;126755;9903;9927;148345;729528;65122;3104;64802;645414;116362;441873;9249;9341;473;23207;79707;23261;54751;2475;90231;390999;727684;84301;343068;5293;65121;7799,117
1,1,1,6614945,16382506,9767561,10277;100526739;93190;56998;440567;63036;57540;391004;93611;4878;10747;51032;80176;440560;842;10630;11330;441871;388595;1676;765;378708;26232;6518;54206;10911;90326;7133;9563;943;80835;55735;80045;5195;60672;54897;284498;391002;2023;440561;23013;391003;653619;5351;343066;23341;1185;84328;6723;284723;23095;343069;6248;10218;23435;29914;4524;155184;5394;3604;8863;114827;84275;199953;374946;1325;645382;440563;79814;22883;400736;55092;5226;126767;55187;11315;10459;645425;26270;23254;50651;343071;148479;400735;57085;4879;79180;27129;126755;9903;9927;148345;729528;7709;65122;3104;64802;645414;116362;441873;9249;9341;1188;473;23207;149563;23261;54751;2475;90231;390999;727684;84301;343068;1187;5293;65121;7799,118
1,1,1,7301946,11143298,3841352,8863;10277;56998;100526739;84275;199953;1325;22883;10747;80176;5226;1676;765;11315;378708;10911;54206;6518;50651;9563;148345;80045;5195;54897;2023;64802;116362;9341;473;23261;84328;6723;23095;23435;155184;5293;5394;3604,38
-1,1,1,8343754,12530188,4186434,10277;100526739;56998;84275;199953;57540;374946;1325;93611;22883;4878;10747;80176;5226;1676;55187;765;378708;10459;26232;6518;26270;50651;57085;4879;7133;9563;9927;943;148345;80045;5195;54897;284498;60672;2023;4524;64802;116362;5351;1185;473;84328;6723;23095;2475;90231;10218;23435;29914;155184;5293;5394,53
1,1,1,8990090,16518045,7527955,10277;100526739;93190;56998;440567;63036;57540;391004;93611;4878;10747;51032;80176;440560;842;10630;11330;441871;388595;1676;765;378708;26232;6518;7133;9563;943;80045;5195;60672;54897;284498;391002;440561;23013;391003;653619;5351;343066;23341;1185;84328;6723;284723;23095;343069;6248;10218;23435;29914;4524;155184;5394;1969;114827;84275;199953;374946;1325;645382;440563;79814;22883;400736;55092;5226;126767;55187;10459;645425;26270;23254;343071;400735;57085;4879;79180;27129;126755;9927;729528;148345;7709;65122;64802;645414;116362;441873;9249;1188;23207;54751;149563;2475;90231;390999;727684;84301;348487;343068;1187;5293;65121;7799,104
-1,1,1,9124551,12726755,3602204,10277;100526739;56998;84275;199953;57540;374946;1325;93611;22883;4878;10747;80176;5226;1676;55187;378708;10459;26232;6518;26270;57085;4879;7133;9563;9927;943;148345;80045;5195;54897;284498;60672;64802;116362;5351;343066;9249;1185;84328;6723;23095;2475;90231;10218;23435;29914;4524;5293;5394,50
-1,1,1,9488597,16142286,6653689,10277;100526739;93190;56998;440567;63036;57540;391004;93611;4878;10747;51032;440560;842;10630;11330;441871;388595;1676;378708;26232;7133;943;60672;5195;54897;284498;391002;440561;391003;653619;5351;343066;23341;1185;84328;6723;284723;23095;343069;6248;10218;23435;29914;4524;5394;114827;84275;199953;374946;1325;645382;440563;79814;22883;400736;55092;5226;126767;55187;10459;645425;26270;23254;343071;400735;57085;4879;79180;126755;9927;729528;148345;65122;64802;645414;116362;441873;9249;23207;54751;2475;90231;390999;727684;84301;343068;5293;65121;7799,90
-1,1,1,10324455,16107335,5782880,93190;100526739;63036;57540;391004;93611;4878;10747;51032;440560;842;10630;11330;441871;388595;1676;378708;26232;7133;943;60672;5195;54897;284498;391002;440561;391003;653619;5351;343066;23341;1185;6723;284723;23095;343069;6248;10218;23435;29914;4524;5394;114827;374946;1325;645382;440563;79814;400736;55092;5226;126767;55187;10459;645425;26270;23254;343071;400735;57085;4879;79180;126755;9927;729528;148345;65122;645414;441873;9249;23207;54751;2475;90231;390999;727684;84301;343068;65121;7799,80
-1,1,1,10448139,16107331,5659192,93190;100526739;63036;57540;391004;93611;4878;10747;51032;440560;842;10630;11330;441871;388595;1676;378708;26232;7133;943;60672;5195;54897;284498;391002;440561;391003;653619;5351;343066;23341;1185;6723;284723;343069;6248;10218;23435;29914;4524;5394;114827;374946;1325;645382;440563;79814;400736;55092;5226;126767;55187;10459;645425;26270;23254;343071;400735;57085;4879;79180;126755;9927;729528;148345;65122;645414;441873;9249;23207;54751;2475;90231;390999;727684;84301;343068;65121;7799,79
1,-1,1,10697093,10753078,55985,54897,1
1,-1,1,10697093,10804053,106960,54897,1
1,-1,1,10753078,10804053,50975,54897,1
1,-1,1,12353332,13178669,825337,93190;343066;440560;400735;441871;9249;126767;55187;343069;390999;65122;440561;391003;65121;343071,15
1,-1,1,12726725,13385572,658847,93190;400735;440563;65122;440561;391003;343066;440560;441873;441871;126767;343069;390999;343068;65121;343071,16
1,-1,1,12726725,13385572,658847,93190;400735;440563;65122;440561;391003;343066;440560;441873;441871;126767;343069;390999;343068;65121;343071,16
-1,1,1,12784752,16361283,3576531,93190;114827;440567;63036;645382;79814;440563;391004;400736;55092;51032;440560;842;10630;441871;11330;388595;126767;645425;23254;343071;400735;27129;79180;126755;729528;7709;65122;391002;440561;23013;391003;645414;653619;441873;23341;23207;54751;149563;284723;727684;343069;390999;84301;6248;343068;1187;65121;7799,49
-1,-1,1,12839441,13142569,303128,400735;440560;441871;343069;65122;440561;391003;65121;343071,9
-1,-1,1,12839474,13158536,319062,400735;440560;441871;343069;65122;440561;391003;65121;343071,9
1,-1,1,12839474,13699359,859885,400735;729528;645382;440563;65122;400736;391002;440561;645414;391003;653619;440560;441873;441871;343069;343068;65121;343071,18
1,-1,1,12839474,13737920,898446,400735;729528;645382;440563;391004;65122;400736;391002;440561;645414;391003;653619;440560;441873;441871;343069;645425;343068;65121;343071,20
1,-1,1,12839474,13737920,898446,400735;729528;645382;440563;391004;65122;400736;391002;440561;645414;391003;653619;440560;441873;441871;343069;645425;343068;65121;343071,20
1,-1,1,12839474,13737920,898446,400735;729528;645382;440563;391004;65122;400736;391002;440561;645414;391003;653619;440560;441873;441871;343069;645425;343068;65121;343071,20
1,-1,1,12839474,13737920,898446,400735;729528;645382;440563;391004;65122;400736;391002;440561;645414;391003;653619;440560;441873;441871;343069;645425;343068;65121;343071,20
1,-1,1,12839474,13737920,898446,400735;729528;645382;440563;391004;65122;400736;391002;440561;645414;391003;653619;440560;441873;441871;343069;645425;343068;65121;343071,20
1,-1,1,12839474,13737920,898446,400735;729528;645382;440563;391004;65122;400736;391002;440561;645414;391003;653619;440560;441873;441871;343069;645425;343068;65121;343071,20
1,-1,1,12839474,13737920,898446,400735;729528;645382;440563;391004;65122;400736;391002;440561;645414;391003;653619;440560;441873;441871;343069;645425;343068;65121;343071,20
1,-1,1,12839474,13737920,898446,400735;729528;645382;440563;391004;65122;400736;391002;440561;645414;391003;653619;440560;441873;441871;343069;645425;343068;65121;343071,20
1,-1,1,12839474,13737920,898446,400735;729528;645382;440563;391004;65122;400736;391002;440561;645414;391003;653619;440560;441873;441871;343069;645425;343068;65121;343071,20
1,-1,1,12839474,13737920,898446,400735;729528;645382;440563;391004;65122;400736;391002;440561;645414;391003;653619;440560;441873;441871;343069;645425;343068;65121;343071,20
1,-1,1,12839474,13737920,898446,400735;729528;645382;440563;391004;65122;400736;391002;440561;645414;391003;653619;440560;441873;441871;343069;645425;343068;65121;343071,20
1,-1,1,12839474,13737920,898446,400735;729528;645382;440563;391004;65122;400736;391002;440561;645414;391003;653619;440560;441873;441871;343069;645425;343068;65121;343071,20
1,-1,1,12839474,13737920,898446,400735;729528;645382;440563;391004;65122;400736;391002;440561;645414;391003;653619;440560;441873;441871;343069;645425;343068;65121;343071,20
1,-1,1,12839474,13737920,898446,400735;729528;645382;440563;391004;65122;400736;391002;440561;645414;391003;653619;440560;441873;441871;343069;645425;343068;65121;343071,20
1,-1,1,12839474,13737920,898446,400735;729528;645382;440563;391004;65122;400736;391002;440561;645414;391003;653619;440560;441873;441871;343069;645425;343068;65121;343071,20
1,-1,1,12839474,13737920,898446,400735;729528;645382;440563;391004;65122;400736;391002;440561;645414;391003;653619;440560;441873;441871;343069;645425;343068;65121;343071,20
1,-1,1,12839474,13737920,898446,400735;729528;645382;440563;391004;65122;400736;391002;440561;645414;391003;653619;440560;441873;441871;343069;645425;343068;65121;343071,20
1,-1,1,12839474,13737920,898446,400735;729528;645382;440563;391004;65122;400736;391002;440561;645414;391003;653619;440560;441873;441871;343069;645425;343068;65121;343071,20
1,-1,1,12839474,13757756,918282,400735;729528;645382;440563;391004;65122;400736;391002;440561;645414;391003;653619;440560;441873;441871;343069;645425;343068;65121;343071,20
1,-1,1,12839474,13757756,918282,400735;729528;645382;440563;391004;65122;400736;391002;440561;645414;391003;653619;440560;441873;441871;343069;645425;343068;65121;343071,20
1,-1,1,12839474,13757756,918282,400735;729528;645382;440563;391004;65122;400736;391002;440561;645414;391003;653619;440560;441873;441871;343069;645425;343068;65121;343071,20
1,-1,1,12839474,13757756,918282,400735;729528;645382;440563;391004;65122;400736;391002;440561;645414;391003;653619;440560;441873;441871;343069;645425;343068;65121;343071,20
1,-1,1,12839474,13757756,918282,400735;729528;645382;440563;391004;65122;400736;391002;440561;645414;391003;653619;440560;441873;441871;343069;645425;343068;65121;343071,20
1,-1,1,12839474,13757756,918282,400735;729528;645382;440563;391004;65122;400736;391002;440561;645414;391003;653619;440560;441873;441871;343069;645425;343068;65121;343071,20
1,-1,1,12839474,13757756,918282,400735;729528;645382;440563;391004;65122;400736;391002;440561;645414;391003;653619;440560;441873;441871;343069;645425;343068;65121;343071,20
1,-1,1,12839474,13775144,935670,400735;729528;645382;440563;391004;65122;400736;391002;440561;645414;391003;653619;440560;441873;441871;343069;645425;343068;65121;343071,20
1,-1,1,12839474,13775144,935670,400735;729528;645382;440563;391004;65122;400736;391002;440561;645414;391003;653619;440560;441873;441871;343069;645425;343068;65121;343071,20
1,-1,1,12839474,13775144,935670,400735;729528;645382;440563;391004;65122;400736;391002;440561;645414;391003;653619;440560;441873;441871;343069;645425;343068;65121;343071,20
1,-1,1,12839474,13775144,935670,400735;729528;645382;440563;391004;65122;400736;391002;440561;645414;391003;653619;440560;441873;441871;343069;645425;343068;65121;343071,20
-1,-1,1,12850038,13158536,308498,400735;440560;441871;343069;65122;440561;391003;65121;343071,9
-1,-1,1,12850038,13448280,598242,400735;440560;441873;441871;645382;343069;440563;65122;343068;400736;440561;391003;65121;343071,14
-1,-1,1,12850038,13448280,598242,400735;440560;441873;441871;645382;343069;440563;65122;343068;400736;440561;391003;65121;343071,14
-1,-1,1,12850038,13448280,598242,400735;440560;441873;441871;645382;343069;440563;65122;343068;400736;440561;391003;65121;343071,14
1,-1,1,12850038,13757756,907718,400735;729528;645382;440563;391004;65122;400736;391002;440561;645414;391003;653619;440560;441873;441871;343069;645425;343068;65121;343071,20
1,-1,1,12850038,13757756,907718,400735;729528;645382;440563;391004;65122;400736;391002;440561;645414;391003;653619;440560;441873;441871;343069;645425;343068;65121;343071,20
1,-1,1,12850038,13757756,907718,400735;729528;645382;440563;391004;65122;400736;391002;440561;645414;391003;653619;440560;441873;441871;343069;645425;343068;65121;343071,20
1,-1,1,12850038,13757756,907718,400735;729528;645382;440563;391004;65122;400736;391002;440561;645414;391003;653619;440560;441873;441871;343069;645425;343068;65121;343071,20
1,-1,1,12850038,13757756,907718,400735;729528;645382;440563;391004;65122;400736;391002;440561;645414;391003;653619;440560;441873;441871;343069;645425;343068;65121;343071,20
-1,-1,1,12860810,12918815,58005,343069;440560;65122,3
-1,-1,1,12860810,12918815,58005,343069;440560;65122,3
1,-1,1,12866505,13757756,891251,400735;729528;645382;440563;391004;65122;400736;391002;440561;645414;391003;653619;440560;441873;441871;343069;645425;343068;343071,19
-1,1,1,13178371,19961858,6783487,440567;63036;11223;391004;353238;126917;22977;51032;5081;842;10630;11330;388595;51702;127707;23352;11240;8574;23400;391002;23013;653619;23341;79363;6390;55160;284723;55920;832;440574;6248;23569;1969;114827;81569;8659;645382;79814;440563;400736;55092;374955;9696;26099;55672;23065;84966;645425;80834;23254;27129;54896;79180;128272;126755;729528;4237;7709;100532736;29943;645414;441873;1188;23207;54751;149563;727684;84301;51154;348487;343068;1187;55707;54455;7799,75
-1,-1,1,13203161,13737920,534759,441873;729528;645382;391004;645425;400736;391002;343068;645414;653619,10
-1,1,1,16008307,19988832,3980525,1969;81569;4681;440567;8659;11223;22977;353238;126917;374955;5081;9696;388595;26099;55672;23065;84966;51702;127707;80834;23352;11240;8574;27129;54896;128272;4237;7709;23400;23013;29943;100532736;1188;79363;6390;54751;23207;149563;55160;284723;55920;832;440574;51154;348487;1187;55707;54455;23569,49
1,-1,1,16350393,16358989,8596,1187,1
1,-1,1,16350393,16358989,8596,1187,1
1,-1,1,16350393,16358989,8596,1187,1
1,-1,1,16350393,16358989,8596,1187,1
1,-1,1,16350393,16358989,8596,1187,1
1,-1,1,16350393,16381893,31500,1187;1188,2
1,-1,1,16358989,16381893,22904,1187;1188,2
1,-1,1,16358989,16384554,25565,1187;348487;1188,3
-1,-1,1,16364253,16376855,12602,1188,1
1,-1,1,16372151,16381893,9742,1188,1
1,-1,1,16372151,16381893,9742,1188,1
1,-1,1,16372151,16381893,9742,1188,1
1,-1,1,16372151,16381893,9742,1188,1
1,-1,1,16372151,16384554,12403,348487;1188,2
-1,-1,1,16372151,16384554,12403,348487;1188,2
1,-1,1,16372151,16384554,12403,348487;1188,2
1,-1,1,16372151,16384554,12403,348487;1188,2
1,-1,1,16372151,16384554,12403,348487;1188,2
1,-1,1,16372151,16390104,17953,348487;1188,2
1,-1,1,16372151,16390104,17953,348487;1188,2
1,-1,1,16372151,16390104,17953,348487;1188,2
1,-1,1,16714294,17284789,570495,9696;26099;55672;55707;11223;374955,6
1,-1,1,16785307,17363575,578268,9696;55672;23400;6390;55707;4237;11223,7
-1,-1,1,16814372,17104536,290164,55672;11223,2
1,-1,1,16814372,17104536,290164,55672;11223,2
-1,-1,1,16849629,17284789,435160,9696;55672;11223,3
-1,-1,1,16926777,17048762,121985,55672,1
1,-1,1,16941653,17231817,290164,11223,1
-1,-1,1,16948127,17231817,283690,11223,1
-1,-1,1,16963573,17053916,90343,,0
1,-1,1,17051209,17231787,180578,11223,1
-1,-1,1,17088427,17106477,18050,11223,1
-1,1,1,20067124,22537862,2470738,163933;26279;50809;127733;1889;391013;64600;5909;84196;127731;1650;978;10136;57576;30814;400745;55450;54546;79594;5322;84224;401944;3339;998;54361;5320;23252;65018;8672;255104;23436;249,32
1,-1,1,23106615,23241148,134533,2048,1
1,1,1,24707696,41886350,17178654,339559;7780;22955;2140;378807;23585;4985;55650;64766;79647;10076;57648;4520;27095;149076;54933;56063;55700;84879;63967;643314;10163;5051;51538;3208;2035;4610;115572;8565;79947;199870;5511;91544;51102;55721;388610;728116;64769;127687;2275;6018;8761;192670;200172;100132074;64121;51042;2899;284654;6118;113451;79000;252995;127391;127703;27293;26508;1441;113444;4146;9967;25949;1043;81493;9204;10450;5724;79727;653121;81629;57190;84967;84958;90853;51441;2701;127396;400746;79570;163732;9783;2810;399474;10691;58512;656;115273;64789;9064;84618;3061;9672;10269;864;55143;29889;79693;8547;55223;80149;57035;353500;23673;149175;23038;1503;23633;55108;200081;93974;57134;84734;4725;83442;10657;26119;2537;284656;2709;57185;3065;55113;6548;8073;64744;64064;3932;2268;6421;9202;257101;192669;79932;64960;84970;2170;164091;149420;127550;1296;9473;2707;51440;6006;79753;127544;54952;7802;79927;3151;81025;54797;84676;5928;9132;55057;1912;63906;553115;1104;10726;79140;127534;113452;2134;127700;65108;339488;114784;11123;90529;6195;55116;339487;83931;5538;65979;84065;126695;27285;10946;10256;149069;54936;23499;54707;8431;79729;56181;25932;1298;64793;6883;204;55194;55219;51118;22826;2827;7805;388611;27245;9410;347735;10487;54802;5690;3925;3633;7579;84243;5453;8289;6429;100506144;23154;65243;83667;127540;64129;1307;100128071;54955;8668;79830;4802;9698;26292;576;6007;10250;26523,232
-1,-1,1,25609479,25648287,38808,6007;57035,2
1,-1,1,25611203,25688876,77673,6006;23585;6007;57035,4
1,-1,1,25611203,25688876,77673,6006;23585;6007;57035,4
1,-1,1,25611203,25688876,77673,6006;23585;6007;57035,4
1,-1,1,25702769,25913028,210259,55219;26119;6006,3
-1,1,1,28751378,33588455,4837077,65108;55116;339487;4985;4146;64766;65979;10076;57648;23633;149069;56063;55108;81493;200081;84734;204;6883;10657;653121;3065;81629;7805;9410;51441;347735;90853;8073;51538;3208;79570;2035;3932;6429;399474;79140;8565;55721;51102;2170;728116;10691;115273;127544;54952;64129;1307;100128071;3061;9672;8668;5928;113451;9698;252995;1104;576;113452;553115,59
1,-1,1,28904254,28907123,2869,54952,1
-1,1,1,29600988,31598923,1997935,4146;9672;9698;10076;7805,5
-1,-1,1,30589668,31169396,579728,,0
-1,1,1,34830287,36945093,2114806,127700;127703;339488;1441;113444;83931;27285;9967;27095;54936;55700;79729;9204;63967;55194;2709;84967;2701;5690;6421;9202;192669;100506144;79932;64960;23154;1296;58512;2707;192670;127534;79830;26523,33
-1,1,1,41300076,43588742,2288666,114625;2980;22955;1907;22887;284716;100129924;84217;79717;163732;64175;10465;6513;2981;1503;728621;4904;200172;149461;100132074;51058;79078;9132;374969;59269,25
-1,1,1,42914303,45001279,2086976,114625;149466;100129924;9682;440585;79033;7075;6487;10465;128218;128209;64834;149461;991;10969;79078;374969;112950;1802;55929;23334;84217;81888;79717;149465;9048;64175;4352;6513;149473;728621;4904;9670;533;55182;51058;6536;8704;5792,39
-1,-1,1,44979717,45001279,21562,55182,1
1,-1,1,46335187,46546272,211085,23139;110117499;8503,3
-1,-1,1,49929425,49988076,58651,84871,1
-1,-1,1,49929425,49988076,58651,84871,1
-1,-1,1,49929425,49988076,58651,84871,1
-1,-1,1,49929425,49988076,58651,84871,1
-1,-1,1,49959425,50049480,90055,84871,1
-1,1,1,51729573,55164001,3434428,51060;127428;22996;84950;6512;79699;115353;54987;200014;2060;51668;114883;9528;148979;2882;51253;23318;55268;200008;6342;606495;23648;4116;388633;54432;26994;65260;26027;348378;91408;9372;4998;63948;127435;112970;5865;440590;338094;4898;1376;55706;7804;1733;374977,44
-1,1,1,54092945,64714537,10621592,255738;4774;148581;731;127428;115353;3725;85440;4919;1718;115209;1573;10207;7809;51668;199964;9528;23358;5563;27329;84455;148979;51253;200008;54596;606495;8613;23648;51361;388633;54432;83941;25973;4070;127795;26027;27022;163747;732;7268;199920;1600;114803;29929;7398;55001;5236;338094;84938;55277;55706;163782;1733;374977;23421,55
-1,1,1,55791287,63405767,7614480,54596;4774;8613;51361;731;83941;4070;127795;3725;85440;732;1600;114803;199920;7398;115209;1573;10207;84938;55277;5563;27329;163782,23
-1,1,1,59285277,69572791,10287514,4774;1647;148581;57708;23169;55225;54741;6121;85440;10022;26135;4919;200132;79971;1573;10207;84455;27329;149233;3716;9829;400757;5142;54596;3595;57685;51361;83941;55970;127795;27022;205;29929;7398;55635;5236;84938;55277;3953;9077;84251;79819;163782;23421,44
-1,1,1,59285277,86564294,27279017,100526835;11080;431707;2787;148581;57708;148418;57554;6121;80135;4919;23576;255231;5876;1573;10207;127254;84455;1486;84144;3716;9829;400757;3595;100505741;57685;51361;374986;64123;126820;127795;255631;29929;8915;1429;55635;127253;10964;5236;10561;55631;23566;58511;9077;54810;4438;79819;91624;205;163782;5737;256435;9295;81849;81573;5733;4774;1647;127247;23169;54680;54741;9406;26009;85440;10022;148423;26135;200132;79971;5567;27329;117178;149233;23032;3491;23266;5142;54596;51086;83941;55970;27022;204962;11147;10026;26289;7398;34;84938;55277;3953;79739;8880;257194;84251;127255;55283;55225;1491;8790;23421,102
-1,1,1,60226528,72043735,11817207,9295;81573;5733;4774;1647;148581;163782;57708;23169;54741;9406;57554;6121;85440;10022;26135;4919;200132;79971;1573;10207;84455;27329;149233;3716;9829;400757;5142;54596;3595;57685;51361;83941;55970;127795;27022;11147;29929;7398;55635;5236;84938;55277;3953;55631;9077;257194;84251;79819;205;55225;1491;23421,53
-1,1,1,60226528,72043735,11817207,9295;81573;5733;4774;1647;148581;163782;57708;23169;54741;9406;57554;6121;85440;10022;26135;4919;200132;79971;1573;10207;84455;27329;149233;3716;9829;400757;5142;54596;3595;57685;51361;83941;55970;127795;27022;11147;29929;7398;55635;5236;84938;55277;3953;55631;9077;257194;84251;79819;205;55225;1491;23421,53
-1,1,1,61351024,79583933,18232909,100526835;11080;431707;148581;57708;57554;6121;4919;5876;10207;127254;84455;3716;9829;400757;3595;57685;374986;64123;29929;1429;55635;127253;10964;5236;10561;55631;9077;54810;4438;79819;91624;205;163782;5737;256435;9295;81849;81573;5733;4774;1647;127247;23169;54741;9406;26009;85440;10022;26135;200132;79971;27329;149233;23032;5142;54596;51086;83941;55970;27022;204962;11147;10026;26289;7398;34;84938;3953;8880;257194;84251;127255;55225;1491;8790;23421,77
1,-1,1,61693951,62199657,505706,83941;4774,2
1,1,1,61785602,67430956,5645354,5142;54596;4774;57685;148581;57708;83941;54741;55225;27022;205;85440;10022;29929;7398;4919;200132;5236;10207;84455;84938;27329;3953;84251;79819;163782;3716;9829;23421,29
-1,1,1,63252828,77402595,14149767,100526835;256435;9295;431707;81573;5733;81849;1647;148581;127247;57708;23169;54741;9406;57554;6121;10022;26135;4919;200132;79971;5876;127254;84455;149233;3716;9829;400757;5142;3595;57685;51086;55970;27022;204962;205;11147;29929;1429;55635;127253;5236;34;84938;55631;3953;9077;257194;4438;84251;79819;127255;55225;1491;8790;23421,56
-1,-1,1,64151170,64176502,25332,,0
-1,1,1,64321264,88153669,23832405,100526835;11080;431707;2787;148581;57708;22802;148418;9653;57554;6121;80135;4919;23576;255231;5876;127254;1486;84144;3716;400757;9829;101927844;3595;100505741;57685;374986;64123;126820;255631;8915;1429;55635;127253;10964;10561;55631;23566;58511;9077;54810;4438;79819;91624;205;1179;5737;256435;9295;81849;81573;5733;1647;127247;9403;23169;54680;54741;9406;26009;10022;148423;26135;200132;79971;5567;117178;149233;9635;51100;23032;3491;8543;23266;5142;51086;57489;55970;204962;11147;10026;26289;34;3953;79739;8880;257194;84251;127255;55283;55225;1491;8790,93
1,1,1,64538290,75984117,11445827,100526835;9295;431707;81573;5733;1647;148581;57708;23169;54741;9406;57554;6121;10022;26135;4919;200132;79971;127254;149233;3716;400757;9829;5142;3595;57685;51086;55970;204962;205;11147;1429;55635;127253;55631;3953;9077;257194;84251;79819;127255;55225;1491;8790,44
1,1,1,64538290,75984117,11445827,100526835;9295;431707;81573;5733;1647;148581;57708;23169;54741;9406;57554;6121;10022;26135;4919;200132;79971;127254;149233;3716;400757;9829;5142;3595;57685;51086;55970;204962;205;11147;1429;55635;127253;55631;3953;9077;257194;84251;79819;127255;55225;1491;8790,44
1,-1,1,65881068,65939484,58416,9829;3953;54741,3
1,-1,1,65939484,66007500,68016,3953,1
-1,1,1,67330808,77589066,10258258,100526835;256435;9295;431707;81573;5733;81849;1647;127247;57708;23169;9406;57554;6121;26135;79971;5876;127254;149233;400757;3595;51086;55970;204962;11147;1429;10026;55635;127253;34;55631;9077;257194;4438;79819;127255;1491;8790,38
1,-1,1,69789895,69938097,148202,,0
-1,1,1,72044544,92505091,20460547,100526835;11080;431707;343472;2787;22802;148418;9653;2959;2633;80135;255231;23576;5876;115361;127254;164045;1486;84144;56267;676;101927844;8317;100505741;374986;64123;126820;255631;388646;8915;1429;7049;127253;10964;10561;55144;23566;58511;253152;54810;4438;91624;1179;5737;256435;81849;84230;127247;115362;9403;54680;2634;26009;148423;5567;117178;9635;51100;23032;3491;8543;23266;284695;51086;57489;204962;2635;494115;10026;26289;163351;5586;34;23507;79739;84146;8880;257194;127255;55283;8790,81
-1,-1,1,72124095,72241965,117870,257194,1
1,-1,1,76718950,77039352,320402,256435,1
-1,1,1,76884987,89094147,12209160,256435;81849;11080;2787;9403;54680;22802;148418;9653;26009;80135;148423;255231;23576;5567;117178;9635;1486;51100;23032;84144;3491;23266;8543;101927844;100505741;374986;64123;57489;126820;255631;8915;10026;26289;10964;10561;23566;79739;58511;8880;54810;91624;1179;55283;5737,45
-1,-1,1,79541360,79612216,70856,,0
-1,-1,1,81087249,82506486,1419237,23266,1
1,-1,1,81436507,81923572,487065,,0
1,1,1,83923008,104816539,20893531,9890;277;23285;343472;2787;646817;100527978;22802;101928436;148418;1806;9653;388650;2959;2633;80135;1901;255231;23576;8634;1810;163404;115361;164045;163786;343099;1486;84144;56267;7412;676;276;127495;101927844;8317;100505741;24;126820;255631;54482;388646;2152;199857;8915;7813;8556;51611;2672;1629;7049;58155;55144;126969;148534;23566;23443;58511;253152;388649;278;280;1179;11146;84230;2730;1266;115362;9403;54112;54680;148867;2634;284697;79871;391059;118427;148423;5567;6125;117178;64645;9635;51100;54874;3491;8543;8412;284695;178;54873;57489;55599;2635;494115;2135;30836;279;163351;22823;50999;1301;5586;23507;79739;84146;51375;5825;9411;55283;25950,110
-1,1,1,92956486,93972848,1016362,22823;50999;1810;6125;388650;343099;54874;7813,8
1,1,1,93837992,121343783,27505791,9890;277;200162;4893;100527978;6814;148545;7252;11085;2949;10717;163786;3744;81839;276;24;3158;79961;4808;254268;128344;54482;126868;653820;2152;127002;8556;26227;1629;127003;80143;55170;5738;284611;126969;113802;79574;23443;5016;7482;284467;3283;84432;343505;57535;343263;4853;388662;10542;1266;54112;148867;1952;845;9122;163259;6301;79084;3321;2948;54879;284612;85369;64645;54874;5906;55119;55791;29957;178;54873;6272;5686;2780;3752;6913;2135;6566;54855;279;1435;54834;57463;3749;9398;29899;5825;284613;9860;25950;1117;83998;10885;829;101928436;1806;22854;23155;10286;1901;148281;440603;27159;8634;10352;963;163404;271;51592;333926;2210;914;7412;8458;127495;11218;6884;2773;2946;10768;10100;3737;128346;54665;199857;163479;51611;653464;83873;58155;79679;148534;260425;140;515;278;128338;280;64783;64858;2730;653149;3738;270;476;4803;55924;391059;118427;26191;7812;4343;80263;57413;22911;6847;2947;8412;10451;164153;3284;56900;55599;30836;204851;51179;56944;2944;1301;90874;389;55917;51375;257;10745;965;55356;9411;84722;10390;10905,181
-1,-1,1,97665736,98343102,677366,1806,1
-1,1,1,97737905,109435760,11697855,9890;277;653149;54112;148867;101928436;1806;148545;6814;22854;1901;391059;118427;8634;163404;64645;163786;7412;127495;276;10451;55119;29957;178;54873;55599;254268;54482;2135;163479;8556;51611;279;1629;1301;55170;284611;113802;23443;51375;278;29899;280,43
-1,1,1,97737948,104321746,6583798,9890;277;276;178;54873;54112;148867;101928436;1806;55599;54482;2135;1901;391059;118427;8556;51611;279;8634;1629;1301;163404;23443;64645;51375;278;163786;280;7412;127495,30
-1,-1,1,102656654,102849723,193069,,0
-1,-1,1,102656654,102849723,193069,,0
-1,-1,1,102656654,102849723,193069,,0
-1,-1,1,102656654,102849723,193069,,0
-1,1,1,103657255,112451259,8794004,277;1117;101928436;6814;148545;22854;23155;2949;27159;963;271;3744;276;11218;6884;79961;2773;2946;10768;254268;128344;3737;128346;127002;163479;127003;83873;55170;284611;113802;79574;5016;140;515;278;128338;280;64783;84432;57535;343263;388662;10542;3738;653149;1952;55924;9122;6301;79084;2948;284612;85369;57413;22911;5906;2947;10451;164153;55119;55791;29957;6272;2780;5686;3752;56900;55599;2944;279;1435;57463;3749;257;29899;284613;84722;10390,78
-1,-1,1,103746487,104297301,550814,279;276;277;55599;278;280;101928436,7
-1,-1,1,104092317,104642037,549720,279;55599;276;277;278;280,6
1,-1,1,104107559,104163781,56222,279;280,2
1,-1,1,104124935,104297301,172366,279;277;278;276,4
1,-1,1,104124935,104297301,172366,279;277;278;276,4
1,-1,1,104124935,104297301,172366,279;277;278;276,4
1,-1,1,104161001,104211027,50026,279;276,2
-1,1,1,104185489,104284282,98793,276;277,2
1,1,1,104868106,120471049,15602943,200162;4893;6814;148545;7252;11085;2949;10717;81839;3744;3158;79961;4808;254268;128344;126868;127002;26227;127003;80143;55170;5738;284611;113802;79574;7482;5016;284467;3283;84432;343505;57535;343263;4853;388662;10542;1952;845;9122;163259;6301;79084;3321;2948;54879;284612;85369;5906;55119;55791;29957;6272;2780;5686;3752;6913;6566;54855;1435;54834;57463;3749;9398;29899;284613;9860;1117;83998;10885;829;22854;23155;10286;148281;440603;27159;10352;963;271;51592;333926;914;8458;11218;6884;2773;2946;10768;10100;3737;128346;54665;163479;83873;79679;260425;140;515;128338;64783;64858;3738;653149;270;476;4803;55924;7812;26191;4343;80263;57413;22911;6847;2947;10451;164153;3284;56900;204851;51179;56944;2944;90874;389;55917;257;10745;965;55356;84722;10390;10905,133
-1,-1,1,105426437,105828217,401780,,0
-1,1,1,106010914,112733248,6722334,1117;6814;148545;22854;23155;2949;27159;963;271;3744;11218;6884;2773;2946;10768;79961;254268;3737;128344;128346;163479;127002;127003;83873;55170;284611;113802;79574;5016;140;515;128338;64783;84432;57535;343263;388662;10542;653149;3738;1952;55924;9122;6301;79084;2948;284612;85369;57413;22911;5906;2947;10451;164153;55119;55791;29957;6272;2780;5686;3752;56900;2944;1435;57463;3749;257;29899;284613;84722;10390,71
-1,-1,1,106042587,106258450,215863,,0
-1,-1,1,106042587,106258450,215863,,0
-1,-1,1,106042587,106258450,215863,,0
-1,-1,1,106060371,106258498,198127,,0
-1,-1,1,106060371,106258498,198127,,0
1,-1,1,106686815,106769435,82620,,0
1,1,1,107921992,142552733,34630741,200162;4893;6814;148545;7252;11085;2949;10717;81839;3744;3158;79961;4808;254268;128344;126868;653820;127002;26227;127003;80143;5738;284611;113802;284467;79574;7482;5016;3283;84432;343505;57535;343263;4853;388662;10542;1952;845;9122;163259;6301;79084;3321;84722;2948;54879;284612;85369;5906;55119;55791;29957;6272;2780;5686;3752;6913;6566;54855;1435;54834;57463;3749;9398;29899;284613;9860;1117;83998;10885;829;22854;23155;10286;148281;440603;27159;10352;963;271;51592;333926;2210;914;8458;11218;6884;2773;2946;10768;10100;3737;128346;54665;163479;653464;83873;79679;260425;140;515;128338;64783;64858;3738;653149;270;476;4803;55924;7812;26191;4343;80263;57413;22911;6847;2947;10451;164153;3284;56900;204851;51179;56944;2944;90874;389;55917;257;965;55356;10745;10390;10905,135
1,-1,1,108789087,108968534,179447,,0
1,-1,1,108789087,108968534,179447,,0
1,-1,1,108789087,108968534,179447,,0
1,-1,1,108811026,108941110,130084,,0
1,-1,1,108811026,108968534,157508,,0
1,-1,1,108811026,108968534,157508,,0
1,1,1,114507501,120494232,5986731,83998;10885;200162;4853;4893;270;476;4803;7252;10286;845;11085;148281;7812;163259;3321;10352;80263;51592;6847;81839;914;8458;3284;3158;10100;4808;126868;6913;204851;51179;56944;54855;26227;90874;54834;80143;5738;79679;3283;9398;965;55356;343505;10905,45
1,1,1,114792300,121349803,6557503,83998;10885;200162;4853;4893;270;476;4803;7252;10286;845;11085;3321;7812;163259;10352;80263;51592;2210;6847;81839;914;8458;3284;3158;10100;4808;126868;6913;653820;51179;54855;26227;653464;90874;54834;80143;5738;79679;3283;9398;965;55356;343505;10905,45
1,-1,1,120556740,120635392,78652,4853,1
1,-1,1,120556740,120635392,78652,4853,1
1,-1,1,120556740,120635392,78652,4853,1
1,-1,1,120569414,120635392,65978,4853,1
1,-1,1,120672583,142552733,21880150,653820;2210;653464,3
1,-1,1,120767793,120921239,153446,653820,1
-1,-1,1,120854455,120935334,80879,653820;2210,2
1,-1,1,121158554,121349803,191249,,0
1,-1,1,121184268,121349803,165535,,0
-1,-1,1,142594227,142642753,48526,,0
-1,-1,1,142594227,142642753,48526,,0
1,-1,1,142604414,142642753,38339,,0
-1,-1,1,142604414,142642753,38339,,0
-1,-1,1,142604414,142642753,38339,,0
-1,-1,1,142604414,142642753,38339,,0
-1,-1,1,142604414,142642753,38339,,0
-1,-1,1,142604414,142642753,38339,,0
-1,-1,1,142604414,142642753,38339,,0
1,1,1,142618650,148535229,5916579,9557;148738;128077;84265;9659;10628;2330;653519;5174;388677;200035;51205;284615;645142;5565;148741;10623;728833;100132406;9939;27246;11126;400818;8799;149013;10401;644591;8515;51463;607;2702;200030;2703,33
1,-1,1,142663112,142791662,128550,,0
1,-1,1,142728921,142907112,178191,,0
1,-1,1,143134063,143284670,150607,,0
1,-1,1,143391916,143457097,65181,,0
1,-1,1,143400885,143504612,103727,,0
1,-1,1,143428345,143532171,103826,,0
1,-1,1,143441231,143518139,76908,,0
1,-1,1,143441231,143532171,90940,,0
1,-1,1,143457097,143532171,75074,,0
1,-1,1,143457097,143532171,75074,,0
-1,-1,1,143482388,143540851,58463,,0
1,-1,1,143504612,143540851,36239,,0
1,1,1,143544035,149754161,6210126,9557;148738;128077;84265;9659;10628;2330;653519;554282;5174;388677;200035;51205;284615;645142;5565;148741;730262;653598;10623;728833;100132406;644634;9939;728945;27246;284565;11126;400818;8799;388692;149013;10401;644591;8515;51463;607;2702;200030;2703,40
-1,-1,1,143646652,143908838,262186,728833,1
-1,-1,1,143652719,143771002,118283,,0
1,-1,1,143673098,144389627,716529,728833,1
1,-1,1,143719563,144860341,1140778,728833;400818;9659,3
1,1,1,143753740,151399970,7646230,9557;10962;84265;9659;10628;54507;126961;51107;200035;5298;317772;5692;284615;126626;5565;79626;8394;653604;100534012;730262;728833;644634;723790;2029;27246;11126;400818;1520;5710;388695;54460;8349;8799;9129;56957;149013;79005;10401;9900;55793;23126;8515;29956;8370;51027;1893;10500;9869;333932;10262;79630;57592;148738;128077;54964;8337;148523;2330;1513;653519;554282;81611;51177;388677;55204;5174;8338;51205;29765;554313;5993;645142;10903;2209;148741;653598;56882;10623;80222;100132406;9939;4170;728945;284565;11311;84072;440689;388692;8991;58497;405;644591;8416;6944;23632;51463;23248;607;2702;149428;200030;2703,102
1,-1,1,144009907,144090824,80917,,0
1,-1,1,144009907,144090824,80917,,0
-1,1,1,144368497,148636756,4268259,9557;148738;128077;84265;9659;10628;2330;653519;5174;388677;200035;51205;284615;645142;5565;148741;10623;100132406;9939;27246;284565;11126;400818;8799;149013;10401;644591;8515;51463;607;2702;200030;2703,33
-1,1,1,144371838,148832359,4460521,9557;148738;128077;84265;9659;10628;2330;653519;5174;388677;200035;51205;284615;645142;5565;148741;730262;10623;100132406;9939;728945;27246;284565;11126;400818;8799;149013;10401;644591;8515;51463;607;2702;200030;2703,35
1,-1,1,144451745,144524956,73211,,0
1,-1,1,144451745,144524956,73211,,0
1,-1,1,144451745,144524956,73211,,0
-1,-1,1,144451745,144524956,73211,,0
1,-1,1,144607254,144616674,9420,400818,1
1,-1,1,144619884,144828763,208879,400818,1
1,-1,1,144619884,144828763,208879,400818,1
1,-1,1,144619884,144828763,208879,400818,1
1,-1,1,144674799,144828763,153964,400818,1
1,1,1,144833672,148870387,4036715,9557;148738;128077;84265;9659;10628;2330;653519;5174;388677;200035;51205;284615;645142;5565;148741;730262;10623;100132406;9939;728945;27246;284565;11126;8799;149013;10401;644591;8515;51463;607;2702;200030;2703,34
-1,1,1,144880315,148832359,3952044,9557;148738;128077;84265;9659;10628;2330;653519;5174;388677;200035;51205;284615;645142;5565;148741;730262;10623;100132406;9939;728945;27246;284565;11126;8799;149013;10401;644591;8515;51463;607;2702;200030;2703,34
-1,-1,1,144955198,145079786,124588,9659,1
-1,1,1,144955198,145831720,876522,148738;128077;27246;84265;11126;9659;10628;653519;8799;5174;388677;10401;200035;284615;8515;148741;10623;100132406;9939,19
1,-1,1,145112506,145291030,178524,388677,1
1,-1,1,145112506,145368848,256342,388677;100132406,2
1,-1,1,145112506,145368848,256342,388677;100132406,2
1,-1,1,145112506,145368848,256342,388677;100132406,2
1,-1,1,145112506,145368848,256342,388677;100132406,2
1,-1,1,145112506,145368848,256342,388677;100132406,2
1,-1,1,145112506,145368848,256342,388677;100132406,2
1,1,1,145112506,145735326,622820,148738;128077;27246;84265;11126;10628;8799;5174;388677;10401;200035;284615;8515;148741;10623;100132406;9939,17
1,-1,1,145194054,145361282,167228,388677;100132406,2
1,1,1,145224606,145735326,510720,148738;128077;27246;84265;11126;10628;8799;5174;388677;10401;200035;284615;8515;148741;10623;100132406;9939,17
1,1,1,145271815,145746912,475097,148738;128077;27246;84265;11126;10628;8799;5174;388677;10401;200035;284615;8515;148741;10623;100132406;9939,17
1,1,1,145271815,148254822,2983007,9557;148738;128077;27246;84265;11126;10628;2330;653519;8799;149013;5174;388677;10401;200035;644591;51205;284615;645142;8515;51463;5565;148741;607;2702;10623;200030;100132406;2703;9939,30
1,1,1,145283118,145735326,452208,148738;128077;27246;84265;11126;10628;8799;5174;388677;10401;200035;284615;8515;148741;10623;100132406;9939,17
-1,1,1,145311043,147915048,2604005,9557;148738;128077;27246;84265;11126;10628;2330;653519;8799;149013;5174;10401;200035;51205;284615;8515;51463;5565;148741;607;2702;10623;200030;100132406;2703;9939,27
1,-1,1,145368848,145421552,52704,148738,1
-1,1,1,145376675,147860552,2483877,9557;148738;128077;27246;84265;11126;10628;2330;653519;8799;149013;5174;10401;200035;51205;284615;8515;51463;5565;148741;607;2702;10623;200030;2703;9939,26
-1,1,1,145376675,147860552,2483877,9557;148738;128077;27246;84265;11126;10628;2330;653519;8799;149013;5174;10401;200035;51205;284615;8515;51463;5565;148741;607;2702;10623;200030;2703;9939,26
-1,1,1,145387023,145792051,405028,148738;128077;27246;84265;11126;10628;653519;8799;5174;10401;200035;284615;8515;148741;10623;9939,16
-1,1,1,145387023,145803834,416811,148738;128077;27246;84265;11126;10628;653519;8799;5174;10401;200035;284615;8515;148741;10623;9939,16
-1,1,1,145387945,145735326,347381,148738;128077;10401;200035;27246;84265;284615;5174;11126;8515;148741;10628;10623;8799;9939,15
-1,1,1,145387945,145735326,347381,148738;128077;10401;200035;27246;84265;284615;5174;11126;8515;148741;10628;10623;8799;9939,15
1,1,1,145387945,145735326,347381,148738;128077;10401;200035;27246;84265;284615;5174;11126;8515;148741;10628;10623;8799;9939,15
-1,1,1,145387945,145735326,347381,148738;128077;10401;200035;27246;84265;284615;5174;11126;8515;148741;10628;10623;8799;9939,15
-1,1,1,145388004,146535353,1147349,148738;128077;27246;84265;11126;10628;653519;8799;149013;5174;10401;200035;284615;8515;148741;10623;9939,17
1,-1,1,145388355,145430633,42278,148738,1
-1,1,1,145388355,149418924,4030569,9557;148738;128077;84265;10628;2330;653519;5174;200035;51205;284615;645142;5565;148741;730262;10623;9939;728945;27246;284565;11126;8799;388692;149013;10401;644591;8515;51463;607;2702;200030;2703,32
-1,1,1,145388369,145899418,511049,148738;128077;27246;84265;11126;10628;653519;8799;5174;10401;200035;284615;8515;148741;10623;9939,16
1,-1,1,145415156,145799615,384459,148738;128077;27246;84265;11126;10628;653519;8799;5174;10401;200035;284615;8515;148741;10623;9939,16
-1,1,1,145415156,147824212,2409056,9557;148738;128077;27246;84265;11126;10628;2330;653519;8799;149013;5174;10401;200035;51205;284615;8515;51463;5565;148741;607;2702;10623;200030;2703;9939,26
-1,1,1,145415156,149433207,4018051,9557;148738;128077;84265;10628;2330;653519;5174;200035;51205;284615;645142;5565;148741;730262;10623;9939;728945;27246;284565;11126;8799;388692;149013;10401;644591;8515;51463;607;2702;200030;2703,32
-1,1,1,145415190,146053471,638281,148738;128077;27246;84265;11126;10628;653519;8799;5174;10401;200035;284615;8515;148741;10623;9939,16
1,1,1,145415190,148809863,3394673,9557;148738;128077;728945;27246;284565;84265;11126;10628;2330;653519;8799;149013;5174;10401;200035;644591;51205;284615;645142;8515;51463;5565;148741;607;2702;730262;10623;200030;2703;9939,31
-1,1,1,145415190,148809863,3394673,9557;148738;128077;728945;27246;284565;84265;11126;10628;2330;653519;8799;149013;5174;10401;200035;644591;51205;284615;645142;8515;51463;5565;148741;607;2702;730262;10623;200030;2703;9939,31
-1,1,1,145415190,148809863,3394673,9557;148738;128077;728945;27246;284565;84265;11126;10628;2330;653519;8799;149013;5174;10401;200035;644591;51205;284615;645142;8515;51463;5565;148741;607;2702;730262;10623;200030;2703;9939,31
-1,1,1,145425395,145799602,374207,128077;10401;200035;27246;84265;284615;5174;11126;8515;148741;10628;10623;653519;8799;9939,15
-1,1,1,145425395,145799602,374207,128077;10401;200035;27246;84265;284615;5174;11126;8515;148741;10628;10623;653519;8799;9939,15
-1,1,1,145425395,145799602,374207,128077;10401;200035;27246;84265;284615;5174;11126;8515;148741;10628;10623;653519;8799;9939,15
1,-1,1,145425395,145799602,374207,128077;10401;200035;27246;84265;284615;5174;11126;8515;148741;10628;10623;653519;8799;9939,15
-1,1,1,145425395,145799602,374207,128077;10401;200035;27246;84265;284615;5174;11126;8515;148741;10628;10623;653519;8799;9939,15
-1,1,1,145425395,145799602,374207,128077;10401;200035;27246;84265;284615;5174;11126;8515;148741;10628;10623;653519;8799;9939,15
1,-1,1,145425395,146507577,1082182,128077;27246;84265;11126;10628;653519;8799;149013;5174;10401;200035;284615;8515;148741;10623;9939,16
1,1,1,145425395,148867610,3442215,9557;128077;728945;27246;284565;84265;11126;10628;2330;653519;8799;149013;5174;10401;200035;644591;51205;284615;645142;8515;51463;5565;148741;607;2702;730262;10623;200030;2703;9939,30
1,1,1,145425395,149091187,3665792,9557;128077;728945;27246;284565;84265;11126;10628;2330;653519;8799;149013;5174;10401;200035;644591;51205;284615;645142;8515;51463;5565;148741;607;2702;730262;10623;200030;2703;9939,30
1,1,1,145425395,149699420,4274025,9557;128077;84265;10628;2330;653519;554282;5174;200035;51205;284615;645142;5565;148741;730262;653598;10623;644634;9939;728945;27246;284565;11126;8799;388692;149013;10401;644591;8515;51463;607;2702;200030;2703,34
-1,-1,1,145610469,145922633,312164,27246;10623;653519;11126;5174,5
1,-1,1,145611279,145735326,124047,11126;27246;5174,3
1,-1,1,145611279,145735326,124047,11126;27246;5174,3
1,-1,1,145611279,145735326,124047,11126;27246;5174,3
1,-1,1,145611279,145735326,124047,11126;27246;5174,3
1,-1,1,145620108,145735326,115218,11126;27246;5174,3
1,-1,1,145620108,145935640,315532,653519;11126;27246;5174,4
1,-1,1,145620108,145935640,315532,653519;11126;27246;5174,4
1,-1,1,145626237,145735326,109089,11126;27246;5174,3
1,-1,1,145626237,145831720,205483,653519;11126;27246;5174,4
-1,1,1,145626237,147828089,2201852,9557;27246;51205;11126;51463;5565;607;2702;149013;2330;653519;200030;2703;5174,14
-1,1,1,145626237,147828089,2201852,9557;27246;51205;11126;51463;5565;607;2702;149013;2330;653519;200030;2703;5174,14
-1,1,1,145626237,147828089,2201852,9557;27246;51205;11126;51463;5565;607;2702;149013;2330;653519;200030;2703;5174,14
-1,1,1,145626237,147828089,2201852,9557;27246;51205;11126;51463;5565;607;2702;149013;2330;653519;200030;2703;5174,14
-1,1,1,145626237,147828089,2201852,9557;27246;51205;11126;51463;5565;607;2702;149013;2330;653519;200030;2703;5174,14
-1,1,1,145626237,147828089,2201852,9557;27246;51205;11126;51463;5565;607;2702;149013;2330;653519;200030;2703;5174,14
-1,1,1,145626237,147828089,2201852,9557;27246;51205;11126;51463;5565;607;2702;149013;2330;653519;200030;2703;5174,14
-1,1,1,145626237,147828089,2201852,9557;27246;51205;11126;51463;5565;607;2702;149013;2330;653519;200030;2703;5174,14
-1,1,1,145626237,147828089,2201852,9557;27246;51205;11126;51463;5565;607;2702;149013;2330;653519;200030;2703;5174,14
-1,1,1,145626237,147828089,2201852,9557;27246;51205;11126;51463;5565;607;2702;149013;2330;653519;200030;2703;5174,14
-1,1,1,145626237,149244468,3618231,9557;728945;27246;284565;11126;2330;653519;149013;5174;644591;51205;645142;51463;5565;607;2702;730262;200030;2703,19
-1,1,1,145626237,149244468,3618231,9557;728945;27246;284565;11126;2330;653519;149013;5174;644591;51205;645142;51463;5565;607;2702;730262;200030;2703,19
-1,1,1,145626237,149453964,3827727,9557;728945;27246;284565;11126;2330;653519;554282;388692;149013;5174;644591;51205;645142;51463;5565;607;2702;730262;200030;2703,21
-1,1,1,145655992,147828089,2172097,9557;27246;51205;11126;51463;5565;607;2702;149013;2330;653519;200030;2703;5174,14
-1,1,1,145655992,147909094,2253102,9557;27246;51205;11126;51463;5565;607;2702;149013;2330;653519;200030;2703;5174,14
-1,1,1,145655992,147909094,2253102,9557;27246;51205;11126;51463;5565;607;2702;149013;2330;653519;200030;2703;5174,14
-1,1,1,145655992,147909094,2253102,9557;27246;51205;11126;51463;5565;607;2702;149013;2330;653519;200030;2703;5174,14
-1,1,1,145655992,147909094,2253102,9557;27246;51205;11126;51463;5565;607;2702;149013;2330;653519;200030;2703;5174,14
-1,1,1,145655992,148545520,2889528,9557;27246;11126;2330;653519;149013;5174;644591;51205;645142;51463;5565;607;2702;200030;2703,16
-1,1,1,145655992,149232481,3576489,9557;728945;27246;284565;11126;2330;653519;149013;5174;644591;51205;645142;51463;5565;607;2702;730262;200030;2703,19
-1,1,1,145723321,147828089,2104768,9557;51205;51463;2703;5565;607;2702;2330;653519;200030;149013;5174,12
1,1,1,145743623,147824031,2080408,9557;51205;51463;5565;607;2702;149013;2330;653519;200030;2703;5174,12
1,1,1,145743623,147872253,2128630,9557;51205;51463;5565;607;2702;149013;2330;653519;200030;2703;5174,12
1,1,1,145743623,147907013,2163390,9557;51205;51463;5565;607;2702;149013;2330;653519;200030;2703;5174,12
-1,1,1,145747242,149155026,3407784,9557;728945;284565;2330;653519;149013;5174;644591;51205;645142;51463;5565;607;2702;730262;200030;2703,17
1,1,1,145751815,148000664,2248849,9557;644591;51205;51463;5565;607;2702;149013;2330;653519;200030;2703;5174,13
1,1,1,145764499,249233096,103468597,912;10763;1163;391107;117145;10654;10440;55432;6402;55758;8560;1130;51744;55083;25903;80896;317772;339403;51278;83872;5565;79626;79368;353132;353140;100534012;55746;140609;909;79098;9887;441925;23215;8290;4751;10456;22889;645922;84033;1520;26052;26245;353299;79005;6698;9047;81559;55103;64407;22920;1314;57216;6846;7143;57657;183;163882;10878;89796;11022;23271;5867;64746;84838;54964;127845;149643;3664;91181;8934;9214;127068;79802;336;646627;391114;403244;284532;23179;149373;7483;6279;64754;4170;728945;254428;92344;148808;149041;7832;149628;338324;84919;284680;128368;10380;844;1939;142;5872;2702;4881;163590;4811;148823;27042;23432;5997;51097;9447;90780;56256;10962;128240;391104;54583;55220;440730;388698;353139;127069;4259;391196;49860;51478;91687;51107;574414;5451;51043;148753;5208;7257;127833;391189;3310;127670;913;6282;448835;1382;57795;79762;107181291;441932;6000;56605;57326;3068;63931;2165;23596;7100;163589;2214;10625;89866;10092;3078;83417;391195;54823;284486;84283;57829;6277;26188;353142;8407;1893;54996;148362;5284;1141;64710;2752;1945;4359;3290;9580;8682;54499;8703;92235;127074;440699;64388;4000;391112;2987;25893;54856;128372;553;1196;7044;5993;93183;126731;4688;6746;10638;55657;127665;55765;93273;126669;27252;962;51506;81448;8804;55827;440689;79590;84134;2329;6944;353133;114771;223;10896;60676;23248;3645;5287;387597;2104;55249;57402;148327;10899;7827;200185;3428;149281;134;25909;353135;10877;57568;11221;58480;11189;128387;54507;200150;200159;3140;5877;26750;27173;7371;6706;5321;59349;80133;6275;9911;7175;6051;3930;353137;9970;2629;57127;257177;9722;723790;2029;60484;64218;55248;128360;128229;5929;1942;3914;56957;100131187;83416;388701;140576;8370;84824;911;6258;8995;632;343413;84451;8337;27101;6041;1122;554282;8564;56833;6900;149018;51093;55204;440712;57165;51205;29765;7678;257106;4608;284677;6283;462;100131107;375056;5768;25912;51706;4194;117143;7135;284565;29920;3142;645745;54900;84072;3707;54627;9673;10806;391123;353144;4720;100129094;388692;11243;58497;116228;128366;4179;80003;56997;3080;3765;6635;81470;343406;440738;4063;2703;23418;9557;79573;391192;9909;57530;7286;10485;163778;5362;2117;5317;55509;10216;79805;353143;79169;6705;3075;23528;23029;57863;343173;51127;343035;730262;353131;57115;5999;9213;6004;199834;10472;51742;55061;5279;22926;388722;79862;5710;6097;51022;267002;6276;126668;149013;375061;23381;3570;5546;55732;51377;148641;81607;29956;5087;84614;3814;284525;29937;81494;9181;10500;81563;50717;7107;159;359948;284521;25936;481;5549;375035;5996;23046;27185;391194;5132;51603;116461;5972;64801;51514;7292;116841;8338;6504;645142;6726;653598;7059;4807;3918;55585;116496;126823;11009;8443;127059;81442;51094;910;8751;57645;29922;84320;403314;128371;83593;343171;6699;644591;8416;6271;9283;101928120;400823;23632;55733;89872;127124;8476;64216;9462;403239;84284;7062;54865;11266;2005;6700;79957;55105;55740;10753;480;127579;286826;8832;90806;51029;2328;460;6280;64326;26246;55127;3586;339479;653604;6738;252839;4009;127829;401993;9068;115350;80851;51686;6391;54953;55891;388695;149603;9826;10228;54460;23127;8349;5313;9129;5778;5784;2326;200205;27;23126;51027;57111;388753;55157;10262;6003;5664;126637;9588;2215;1379;9156;93474;26092;653519;128308;259266;4931;391190;81611;51177;127933;9019;647219;88;4580;56882;27097;779;6401;343450;23612;6708;126638;1063;777;7188;56950;25802;57549;10712;55811;6403;54544;4656;2786;8991;5202;3964;23623;2327;9293;9015;388730;3713;57147;80342;51463;127602;6016;81609;64853;360023;1118;467;65094;1604;4184;84288;64222;57821;6894;1116;9857;50604;947;5298;10223;730159;65123;126626;339398;149345;127064;79894;4332;128153;127018;25782;6704;644634;149647;6278;2058;54344;80308;8497;127943;9898;91156;317705;55793;261726;5788;339501;353141;4914;57710;431704;149297;79630;6703;388697;100527963;126859;1378;148523;142683;1465;7042;1513;2205;356;6045;4660;725;388759;1401;8707;81626;391109;85397;26254;554313;4582;63827;29089;2271;1660;29949;25790;8674;80222;477;51133;2532;56956;81466;127062;2848;3915;6675;10067;128367;112770;57459;4014;5498;25778;401992;405;100381270;59352;23557;92241;29097;607;6232;80128;55870;400793;375;10765;9917;55705;26476;148304;22796;56776;2331;92815;127077;23385;1944;23219;55154;128312;84066;126961;200186;127623;89886;5692;83953;3776;353145;63923;8394;10560;148811;149499;339416;722;10446;9816;448834;339512;6646;1131;83881;57823;2052;148789;9900;28982;6273;375033;2494;79605;28956;6274;9877;353134;7391;58;333932;9910;128061;391211;57592;343169;55600;50486;128025;2207;7399;9804;8548;493;2153;9641;284485;9261;2330;2590;81472;127066;92346;85414;1999;83479;2312;441933;3766;5824;6701;3756;23456;7779;2209;3898;2213;9725;8444;26696;5396;164127;391191;11000;6464;7170;7203;55243;55532;729533;25896;5129;339500;149371;919;57198;93185;2224;9507;50848;9191;10637;401994;922;26097;5743;9095;64757;7139;84944;4817;3782;2212;114836;26239;164118;84886;81469;149095;55224;83540;6905;4209;6281;128178;65005;255928;254910;54935;7818;51430;92312;127385;9928;3020;57116;81627;81788;375057;343563;84976;1805;163859;3608;4653;100129271;114548;4139;9453;56893;83932;9869;27005;325;84648;4548;6262;23114;163486;128239;441911;9674;3192;23208;440695;5629;343172;51018;103;654790;10903;149111;10000;6707;25874;80232;89780;5525;824;55974;8490;7159;11311;23057;92703;115019;4921;23380;92342;89884;1510;388743;6284;254879;117157;100191040;6375;257044;57172;3775;9859;1380;81875;80267;149428;22874;79577;200030;9926;55699;115352,923
-1,1,1,145765829,147834136,2068307,9557;51205;51463;5565;607;2702;149013;2330;653519;200030;2703,11
-1,1,1,145765829,147872253,2106424,9557;51205;51463;5565;607;2702;149013;2330;653519;200030;2703,11
-1,1,1,145765829,147872253,2106424,9557;51205;51463;5565;607;2702;149013;2330;653519;200030;2703,11
-1,1,1,145765829,147872253,2106424,9557;51205;51463;5565;607;2702;149013;2330;653519;200030;2703,11
1,1,1,145788863,148809863,3021000,9557;728945;284565;2330;653519;149013;644591;51205;645142;51463;5565;607;2702;730262;200030;2703,16
1,1,1,145788863,148809863,3021000,9557;728945;284565;2330;653519;149013;644591;51205;645142;51463;5565;607;2702;730262;200030;2703,16
1,1,1,145791974,147759730,1967756,9557;51205;51463;5565;607;2702;149013;2330;653519;200030;2703,11
-1,1,1,145791974,147848380,2056406,9557;51205;51463;5565;607;2702;149013;2330;653519;200030;2703,11
1,1,1,145799556,147824212,2024656,9557;51205;51463;5565;607;2702;149013;2330;653519;200030;2703,11
1,1,1,145799556,147824212,2024656,9557;51205;51463;5565;607;2702;149013;2330;653519;200030;2703,11
1,1,1,145799556,148867640,3068084,9557;728945;284565;2330;653519;149013;644591;51205;645142;51463;5565;607;2702;730262;200030;2703,16
-1,1,1,145804679,147828089,2023410,9557;51205;51463;5565;607;2702;149013;2330;653519;200030;2703,11
1,1,1,145804738,148832322,3027584,9557;728945;284565;2330;653519;149013;644591;51205;645142;51463;5565;607;2702;730262;200030;2703,16
1,1,1,145804738,148832322,3027584,9557;728945;284565;2330;653519;149013;644591;51205;645142;51463;5565;607;2702;730262;200030;2703,16
1,1,1,145883452,147872253,1988801,9557;51205;51463;2703;5565;607;2702;2330;200030;149013,10
-1,1,1,145885645,147947839,2062194,9557;51205;51463;2703;5565;607;2702;2330;200030;149013,10
-1,1,1,145886339,147897962,2011623,9557;51205;51463;2703;5565;607;2702;2330;200030;149013,10
-1,1,1,145888925,147926347,2037422,9557;51205;51463;2703;5565;607;2702;2330;200030;149013,10
-1,1,1,145888925,147926347,2037422,9557;51205;51463;2703;5565;607;2702;2330;200030;149013,10
-1,1,1,145888925,148020200,2131275,9557;644591;51205;51463;2703;5565;607;2702;2330;200030;149013,11
-1,1,1,145895746,147856007,1960261,9557;51205;51463;2703;5565;607;2702;2330;200030;149013,10
-1,1,1,145895746,147897962,2002216,9557;51205;51463;2703;5565;607;2702;2330;200030;149013,10
1,1,1,145895747,147831170,1935423,9557;51205;51463;2703;5565;607;2702;2330;200030;149013,10
1,1,1,145899339,148782879,2883540,9557;284565;644591;51205;645142;51463;2703;5565;607;2702;730262;2330;200030;149013,14
1,1,1,145899359,147887713,1988354,9557;51205;51463;2703;5565;607;2702;2330;200030;149013,10
1,1,1,145932454,147819294,1886840,9557;51205;51463;2703;5565;607;2702;2330;200030;149013,10
-1,1,1,145932455,147385641,1453186,9557;51205;2703;5565;607;2702;2330;149013,8
1,1,1,145987156,147909094,1921938,9557;51205;51463;2703;5565;607;2702;2330;200030;149013,10
1,1,1,145987156,147909094,1921938,9557;51205;51463;2703;5565;607;2702;2330;200030;149013,10
1,1,1,145987156,147909094,1921938,9557;51205;51463;2703;5565;607;2702;2330;200030;149013,10
1,1,1,145987156,147909094,1921938,9557;51205;51463;2703;5565;607;2702;2330;200030;149013,10
1,1,1,145987156,148545520,2558364,9557;644591;51205;645142;51463;2703;5565;607;2702;2330;200030;149013,12
1,1,1,145987156,148545520,2558364,9557;644591;51205;645142;51463;2703;5565;607;2702;2330;200030;149013,12
-1,1,1,145987156,148545520,2558364,9557;644591;51205;645142;51463;2703;5565;607;2702;2330;200030;149013,12
-1,1,1,145987156,148545520,2558364,9557;644591;51205;645142;51463;2703;5565;607;2702;2330;200030;149013,12
-1,1,1,145987156,148545520,2558364,9557;644591;51205;645142;51463;2703;5565;607;2702;2330;200030;149013,12
-1,1,1,145987156,148545520,2558364,9557;644591;51205;645142;51463;2703;5565;607;2702;2330;200030;149013,12
1,1,1,146016526,147830830,1814304,9557;51205;51463;2703;5565;607;2702;2330;200030;149013,10
-1,1,1,146023923,147929323,1905400,9557;51205;51463;2703;5565;607;2702;2330;200030;149013,10
1,1,1,146034513,148832322,2797809,9557;728945;284565;644591;51205;645142;51463;2703;5565;607;2702;730262;2330;200030;149013,15
1,1,1,146038914,147838700,1799786,9557;51205;51463;2703;5565;607;2702;2330;200030;149013,10
1,1,1,146043713,147819294,1775581,9557;51205;51463;2703;5565;607;2702;2330;200030;149013,10
-1,1,1,146043713,147844758,1801045,9557;51205;51463;2703;5565;607;2702;2330;200030;149013,10
-1,1,1,146043713,147897962,1854249,9557;51205;51463;2703;5565;607;2702;2330;200030;149013,10
-1,1,1,146043713,147897962,1854249,9557;51205;51463;2703;5565;607;2702;2330;200030;149013,10
-1,1,1,146043713,147897962,1854249,9557;51205;51463;2703;5565;607;2702;2330;200030;149013,10
-1,1,1,146043713,147897962,1854249,9557;51205;51463;2703;5565;607;2702;2330;200030;149013,10
-1,1,1,146043713,147897962,1854249,9557;51205;51463;2703;5565;607;2702;2330;200030;149013,10
-1,1,1,146043713,147929323,1885610,9557;51205;51463;2703;5565;607;2702;2330;200030;149013,10
-1,1,1,146053394,249233096,103179702,912;10763;1163;391107;117145;10654;10440;55432;6402;55758;8560;1130;51744;55083;25903;80896;317772;339403;51278;83872;5565;79626;79368;353132;353140;100534012;55746;140609;909;79098;9887;441925;23215;8290;4751;10456;22889;645922;84033;1520;26052;26245;353299;79005;6698;9047;81559;55103;64407;22920;1314;57216;6846;7143;57657;183;163882;10878;89796;11022;23271;5867;64746;84838;54964;127845;149643;3664;91181;8934;9214;127068;79802;336;646627;391114;403244;284532;23179;149373;7483;6279;64754;4170;728945;254428;92344;148808;149041;7832;149628;338324;84919;284680;128368;10380;844;1939;142;5872;2702;4881;163590;4811;148823;27042;23432;5997;51097;9447;90780;56256;10962;128240;391104;54583;55220;440730;388698;353139;127069;4259;391196;49860;51478;91687;51107;574414;5451;51043;148753;5208;7257;127833;391189;3310;127670;913;6282;448835;1382;57795;79762;107181291;441932;6000;56605;57326;3068;63931;2165;23596;7100;163589;2214;10625;89866;10092;3078;83417;391195;54823;284486;84283;57829;6277;26188;353142;8407;1893;54996;148362;5284;1141;64710;2752;1945;4359;3290;9580;8682;54499;8703;92235;127074;440699;64388;4000;391112;2987;25893;54856;128372;553;1196;7044;5993;93183;126731;4688;6746;10638;55657;127665;55765;93273;126669;27252;962;51506;81448;8804;55827;440689;79590;84134;2329;6944;353133;114771;223;10896;60676;23248;3645;5287;387597;2104;55249;57402;148327;10899;7827;200185;3428;149281;134;25909;353135;10877;57568;11221;58480;11189;128387;54507;200150;200159;3140;5877;26750;27173;7371;6706;5321;59349;80133;6275;9911;7175;6051;3930;353137;9970;2629;57127;257177;9722;723790;2029;60484;64218;55248;128360;128229;5929;1942;3914;56957;100131187;83416;388701;140576;8370;84824;911;6258;8995;632;343413;84451;8337;27101;6041;1122;554282;8564;56833;6900;149018;51093;55204;440712;57165;51205;29765;7678;257106;4608;284677;6283;462;100131107;375056;5768;25912;51706;4194;117143;7135;284565;29920;3142;645745;54900;84072;3707;54627;9673;10806;391123;353144;4720;100129094;388692;11243;58497;116228;128366;4179;80003;56997;3080;3765;6635;81470;343406;440738;4063;2703;23418;9557;79573;391192;9909;57530;7286;10485;163778;5362;2117;5317;55509;10216;79805;353143;79169;6705;3075;23528;23029;57863;343173;51127;343035;730262;353131;57115;5999;9213;6004;199834;10472;51742;55061;5279;22926;388722;79862;5710;6097;51022;267002;6276;126668;149013;375061;23381;3570;5546;55732;51377;148641;81607;29956;5087;84614;3814;284525;29937;81494;9181;10500;81563;50717;7107;159;359948;284521;25936;481;5549;375035;5996;23046;27185;391194;5132;51603;116461;5972;64801;51514;7292;116841;8338;6504;645142;6726;653598;7059;4807;3918;55585;116496;126823;11009;8443;127059;81442;51094;910;8751;57645;29922;84320;403314;128371;83593;343171;6699;644591;8416;6271;9283;101928120;400823;23632;55733;89872;127124;8476;64216;9462;403239;84284;7062;54865;11266;2005;6700;79957;55105;55740;10753;480;127579;286826;8832;90806;51029;2328;460;6280;64326;26246;55127;3586;339479;653604;6738;252839;4009;127829;401993;9068;115350;80851;51686;6391;54953;55891;388695;149603;9826;10228;54460;23127;8349;5313;9129;5778;5784;2326;200205;27;23126;51027;57111;388753;55157;10262;6003;5664;126637;9588;2215;1379;9156;93474;26092;128308;259266;4931;391190;81611;51177;127933;9019;647219;88;4580;56882;27097;779;6401;343450;23612;6708;126638;1063;777;7188;56950;25802;57549;10712;55811;6403;54544;4656;2786;8991;5202;3964;23623;2327;9293;9015;388730;3713;57147;80342;51463;127602;6016;81609;64853;360023;1118;467;65094;1604;4184;84288;64222;57821;6894;1116;9857;50604;947;5298;10223;730159;65123;126626;339398;149345;127064;79894;4332;128153;127018;25782;6704;644634;149647;6278;2058;54344;80308;8497;127943;9898;91156;317705;55793;261726;5788;339501;353141;4914;57710;431704;149297;79630;6703;388697;100527963;126859;1378;148523;142683;1465;7042;1513;2205;356;6045;4660;725;388759;1401;8707;81626;391109;85397;26254;554313;4582;63827;29089;2271;1660;29949;25790;8674;80222;477;51133;2532;56956;81466;127062;2848;3915;6675;10067;128367;112770;57459;4014;5498;25778;401992;405;100381270;59352;23557;92241;29097;607;6232;80128;55870;400793;375;10765;9917;55705;26476;148304;22796;56776;2331;92815;127077;23385;1944;23219;55154;128312;84066;126961;200186;127623;89886;5692;83953;3776;353145;63923;8394;10560;148811;149499;339416;722;10446;9816;448834;339512;6646;1131;83881;57823;2052;148789;9900;28982;6273;375033;2494;79605;28956;6274;9877;353134;7391;58;333932;9910;128061;391211;57592;343169;55600;50486;128025;2207;7399;9804;8548;493;2153;9641;284485;9261;2330;2590;81472;127066;92346;85414;1999;83479;2312;441933;3766;5824;6701;3756;23456;7779;2209;3898;2213;9725;8444;26696;5396;164127;391191;11000;6464;7170;7203;55243;55532;729533;25896;5129;339500;149371;919;57198;93185;2224;9507;50848;9191;10637;401994;922;26097;5743;9095;64757;7139;84944;4817;3782;2212;114836;26239;164118;84886;81469;149095;55224;83540;6905;4209;6281;128178;65005;255928;254910;54935;7818;51430;92312;127385;9928;3020;57116;81627;81788;375057;343563;84976;1805;163859;3608;4653;100129271;114548;4139;9453;56893;83932;9869;27005;325;84648;4548;6262;23114;163486;128239;441911;9674;3192;23208;440695;5629;343172;51018;103;654790;10903;149111;10000;6707;25874;80232;89780;5525;824;55974;8490;7159;11311;23057;92703;115019;4921;23380;92342;89884;1510;388743;6284;254879;117157;100191040;6375;257044;57172;3775;9859;1380;81875;80267;149428;22874;79577;200030;9926;55699;115352,922
-1,1,1,146053414,147828089,1774675,9557;51205;51463;2703;5565;607;2702;2330;200030;149013,10
-1,1,1,146053414,147828089,1774675,9557;51205;51463;2703;5565;607;2702;2330;200030;149013,10
-1,1,1,146053414,147828089,1774675,9557;51205;51463;2703;5565;607;2702;2330;200030;149013,10
-1,1,1,146053414,147860552,1807138,9557;51205;51463;2703;5565;607;2702;2330;200030;149013,10
1,1,1,146053414,148535229,2481815,9557;644591;51205;645142;51463;2703;5565;607;2702;2330;200030;149013,12
1,1,1,146053414,148535229,2481815,9557;644591;51205;645142;51463;2703;5565;607;2702;2330;200030;149013,12
-1,1,1,146053453,147834136,1780683,9557;51205;51463;2703;5565;607;2702;2330;200030;149013,10
1,1,1,146053453,147872253,1818800,9557;51205;51463;2703;5565;607;2702;2330;200030;149013,10
-1,1,1,146053453,147872253,1818800,9557;51205;51463;2703;5565;607;2702;2330;200030;149013,10
1,1,1,146053453,147907013,1853560,9557;51205;51463;2703;5565;607;2702;2330;200030;149013,10
1,1,1,146053453,147907013,1853560,9557;51205;51463;2703;5565;607;2702;2330;200030;149013,10
1,1,1,146053453,147907013,1853560,9557;51205;51463;2703;5565;607;2702;2330;200030;149013,10
1,1,1,146096700,147819294,1722594,9557;51205;51463;2703;5565;607;2702;2330;200030;149013,10
-1,1,1,146096701,147898062,1801361,9557;51205;51463;2703;5565;607;2702;2330;200030;149013,10
1,1,1,146101790,147830830,1729040,9557;51205;51463;2703;5565;607;2702;2330;200030;149013,10
-1,1,1,146101790,147830830,1729040,9557;51205;51463;2703;5565;607;2702;2330;200030;149013,10
-1,1,1,146101790,147897962,1796172,9557;51205;51463;2703;5565;607;2702;2330;200030;149013,10
-1,1,1,146101790,148020200,1918410,9557;644591;51205;51463;2703;5565;607;2702;2330;200030;149013,11
-1,1,1,146105170,147830830,1725660,9557;51205;51463;2703;5565;607;2702;2330;200030;149013,10
1,1,1,146105170,147830830,1725660,9557;51205;51463;2703;5565;607;2702;2330;200030;149013,10
-1,1,1,146105170,147830830,1725660,9557;51205;51463;2703;5565;607;2702;2330;200030;149013,10
-1,1,1,146105170,147897962,1792792,9557;51205;51463;2703;5565;607;2702;2330;200030;149013,10
-1,1,1,146105170,147897962,1792792,9557;51205;51463;2703;5565;607;2702;2330;200030;149013,10
-1,1,1,146105170,147897962,1792792,9557;51205;51463;2703;5565;607;2702;2330;200030;149013,10
-1,1,1,146105170,147897962,1792792,9557;51205;51463;2703;5565;607;2702;2330;200030;149013,10
-1,1,1,146105170,147929323,1824153,9557;51205;51463;2703;5565;607;2702;2330;200030;149013,10
-1,1,1,146105170,147929323,1824153,9557;51205;51463;2703;5565;607;2702;2330;200030;149013,10
-1,1,1,146105170,148016122,1910952,9557;644591;51205;51463;2703;5565;607;2702;2330;200030;149013,11
-1,1,1,146105170,148016122,1910952,9557;644591;51205;51463;2703;5565;607;2702;2330;200030;149013,11
-1,1,1,146105170,148016122,1910952,9557;644591;51205;51463;2703;5565;607;2702;2330;200030;149013,11
-1,1,1,146105170,148020200,1915030,9557;644591;51205;51463;2703;5565;607;2702;2330;200030;149013,11
-1,1,1,146105170,148513854,2408684,9557;644591;51205;645142;51463;2703;5565;607;2702;2330;200030;149013,12
1,1,1,146106723,147830830,1724107,9557;51205;51463;2703;5565;607;2702;2330;200030;149013,10
-1,1,1,146127815,147844758,1716943,9557;51205;51463;2703;5565;607;2702;2330;200030;149013,10
-1,1,1,146143189,147721869,1578680,9557;51205;51463;2703;5565;607;2702;2330;200030;149013,10
-1,1,1,146143189,147909094,1765905,9557;51205;51463;2703;5565;607;2702;2330;200030;149013,10
1,1,1,146143189,147909094,1765905,9557;51205;51463;2703;5565;607;2702;2330;200030;149013,10
-1,1,1,146143189,147909094,1765905,9557;51205;51463;2703;5565;607;2702;2330;200030;149013,10
-1,1,1,146143189,147909094,1765905,9557;51205;51463;2703;5565;607;2702;2330;200030;149013,10
-1,1,1,146143189,147909094,1765905,9557;51205;51463;2703;5565;607;2702;2330;200030;149013,10
1,1,1,146143189,147909094,1765905,9557;51205;51463;2703;5565;607;2702;2330;200030;149013,10
-1,1,1,146143189,147909094,1765905,9557;51205;51463;2703;5565;607;2702;2330;200030;149013,10
-1,1,1,146143189,147909094,1765905,9557;51205;51463;2703;5565;607;2702;2330;200030;149013,10
-1,1,1,146143189,147909094,1765905,9557;51205;51463;2703;5565;607;2702;2330;200030;149013,10
-1,1,1,146143189,147909094,1765905,9557;51205;51463;2703;5565;607;2702;2330;200030;149013,10
-1,1,1,146143189,147909094,1765905,9557;51205;51463;2703;5565;607;2702;2330;200030;149013,10
1,1,1,146143189,147909094,1765905,9557;51205;51463;2703;5565;607;2702;2330;200030;149013,10
1,1,1,146143189,148545520,2402331,9557;644591;51205;645142;51463;2703;5565;607;2702;2330;200030;149013,12
1,1,1,146143189,148545520,2402331,9557;644591;51205;645142;51463;2703;5565;607;2702;2330;200030;149013,12
1,1,1,146143189,148545520,2402331,9557;644591;51205;645142;51463;2703;5565;607;2702;2330;200030;149013,12
1,1,1,146143189,148545520,2402331,9557;644591;51205;645142;51463;2703;5565;607;2702;2330;200030;149013,12
-1,1,1,146143189,149232481,3089292,9557;728945;284565;644591;51205;645142;51463;2703;5565;607;2702;730262;2330;200030;149013,15
-1,1,1,146143189,149232481,3089292,9557;728945;284565;644591;51205;645142;51463;2703;5565;607;2702;730262;2330;200030;149013,15
-1,1,1,146145424,147929323,1783899,9557;51205;51463;2703;5565;607;2702;2330;200030;149013,10
1,1,1,146470888,147830903,1360015,9557;51205;51463;5565;607;2702;2330;200030;2703,9
-1,1,1,146474216,147828089,1353873,9557;51205;51463;5565;607;2702;2330;200030;2703,9
1,1,1,146488131,147052016,563885,9557;607;2330;5565,4
1,1,1,146496382,147409820,913438,9557;51205;51463;5565;607;2702;2330;2703,8
1,1,1,146496425,147048600,552175,9557;607;2330;5565,4
1,1,1,146496425,147929323,1432898,9557;51205;51463;5565;607;2702;2330;200030;2703,9
1,1,1,146498198,147926347,1428149,9557;51205;51463;5565;607;2702;2330;200030;2703,9
1,1,1,146500972,147824207,1323235,9557;51205;51463;5565;607;2702;2330;200030;2703,9
1,1,1,146500972,147828089,1327117,9557;51205;51463;5565;607;2702;2330;200030;2703,9
-1,1,1,146500972,147828089,1327117,9557;51205;51463;5565;607;2702;2330;200030;2703,9
-1,1,1,146500972,147828089,1327117,9557;51205;51463;5565;607;2702;2330;200030;2703,9
-1,1,1,146500972,147828089,1327117,9557;51205;51463;5565;607;2702;2330;200030;2703,9
1,1,1,146500972,147828089,1327117,9557;51205;51463;5565;607;2702;2330;200030;2703,9
-1,1,1,146500972,147828089,1327117,9557;51205;51463;5565;607;2702;2330;200030;2703,9
-1,1,1,146500972,147828089,1327117,9557;51205;51463;5565;607;2702;2330;200030;2703,9
-1,1,1,146500972,147828089,1327117,9557;51205;51463;5565;607;2702;2330;200030;2703,9
1,1,1,146500972,147828089,1327117,9557;51205;51463;5565;607;2702;2330;200030;2703,9
-1,1,1,146500972,147828089,1327117,9557;51205;51463;5565;607;2702;2330;200030;2703,9
1,1,1,146500972,147828089,1327117,9557;51205;51463;5565;607;2702;2330;200030;2703,9
1,1,1,146500972,147828089,1327117,9557;51205;51463;5565;607;2702;2330;200030;2703,9
-1,1,1,146500972,147828089,1327117,9557;51205;51463;5565;607;2702;2330;200030;2703,9
1,1,1,146500972,147828089,1327117,9557;51205;51463;5565;607;2702;2330;200030;2703,9
1,1,1,146500972,148535229,2034257,9557;644591;51205;645142;51463;5565;607;2702;2330;200030;2703,11
1,1,1,146500972,148535229,2034257,9557;644591;51205;645142;51463;5565;607;2702;2330;200030;2703,11
1,1,1,146500972,148535229,2034257,9557;644591;51205;645142;51463;5565;607;2702;2330;200030;2703,11
1,1,1,146500972,148535229,2034257,9557;644591;51205;645142;51463;5565;607;2702;2330;200030;2703,11
1,1,1,146500972,148535229,2034257,9557;644591;51205;645142;51463;5565;607;2702;2330;200030;2703,11
1,1,1,146500972,148535229,2034257,9557;644591;51205;645142;51463;5565;607;2702;2330;200030;2703,11
1,1,1,146500972,148535229,2034257,9557;644591;51205;645142;51463;5565;607;2702;2330;200030;2703,11
1,1,1,146500972,148535229,2034257,9557;644591;51205;645142;51463;5565;607;2702;2330;200030;2703,11
1,1,1,146500972,148535229,2034257,9557;644591;51205;645142;51463;5565;607;2702;2330;200030;2703,11
1,1,1,146500972,148535229,2034257,9557;644591;51205;645142;51463;5565;607;2702;2330;200030;2703,11
1,1,1,146500972,149433185,2932213,9557;728945;284565;644591;51205;645142;51463;5565;607;2702;730262;2330;200030;388692;2703,15
1,1,1,146507518,147441040,933522,9557;51205;51463;5565;607;2702;2330;2703,8
1,1,1,146507518,147824207,1316689,9557;51205;51463;5565;607;2702;2330;200030;2703,9
1,1,1,146507518,147824207,1316689,9557;51205;51463;5565;607;2702;2330;200030;2703,9
1,1,1,146507518,147824207,1316689,9557;51205;51463;5565;607;2702;2330;200030;2703,9
-1,1,1,146507518,147909094,1401576,9557;51205;51463;5565;607;2702;2330;200030;2703,9
-1,1,1,146507649,147381479,873830,9557;607;2702;2330;51205;2703;5565,7
1,1,1,146507649,147824212,1316563,9557;51205;51463;5565;607;2702;2330;200030;2703,9
-1,1,1,146507649,148545664,2038015,9557;644591;51205;645142;51463;5565;607;2702;2330;200030;2703,11
-1,1,1,146507649,148545664,2038015,9557;644591;51205;645142;51463;5565;607;2702;2330;200030;2703,11
-1,1,1,146507649,149433207,2925558,9557;728945;284565;644591;51205;645142;51463;5565;607;2702;730262;2330;200030;388692;2703,15
-1,1,1,146507711,147417736,910025,9557;51205;51463;5565;607;2702;2330;2703,8
1,1,1,146526310,147828089,1301779,9557;51205;51463;5565;607;2702;2330;200030;2703,9
1,1,1,146526310,147828089,1301779,9557;51205;51463;5565;607;2702;2330;200030;2703,9
1,1,1,146526310,148535229,2008919,9557;644591;51205;645142;51463;5565;607;2702;2330;200030;2703,11
1,1,1,146526310,148535229,2008919,9557;644591;51205;645142;51463;5565;607;2702;2330;200030;2703,11
1,1,1,146526310,148535229,2008919,9557;644591;51205;645142;51463;5565;607;2702;2330;200030;2703,11
-1,1,1,146535353,147857078,1321725,9557;51205;51463;5565;607;2702;2330;200030;2703,9
-1,1,1,146535353,147857078,1321725,9557;51205;51463;5565;607;2702;2330;200030;2703,9
-1,1,1,146535353,147857078,1321725,9557;51205;51463;5565;607;2702;2330;200030;2703,9
-1,1,1,146535353,147857078,1321725,9557;51205;51463;5565;607;2702;2330;200030;2703,9
-1,1,1,146535353,147857078,1321725,9557;51205;51463;5565;607;2702;2330;200030;2703,9
1,1,1,146535353,147867734,1332381,9557;51205;51463;5565;607;2702;2330;200030;2703,9
1,1,1,146535353,147877162,1341809,9557;51205;51463;5565;607;2702;2330;200030;2703,9
1,1,1,146535353,147900955,1365602,9557;51205;51463;5565;607;2702;2330;200030;2703,9
-1,1,1,146542843,147828089,1285246,9557;51205;51463;5565;607;2702;2330;200030;2703,9
-1,1,1,146564743,147735011,1170268,9557;51205;51463;5565;607;2702;2330;200030;2703,9
1,1,1,146571304,148545520,1974216,9557;644591;51205;645142;51463;5565;607;2702;2330;200030;2703,11
1,1,1,146628101,147824212,1196111,9557;51205;51463;5565;607;2702;2330;200030;2703,9
1,1,1,146807433,147381411,573978,607;2702;2703;51205,4
-1,-1,1,146849965,146927600,77635,,0
1,-1,1,147228667,147248718,20051,2702,1
1,-1,1,147394188,147424808,30620,51463,1
1,1,1,147411534,149699420,2287886,728945;284565;644591;645142;51463;730262;653598;554282;200030;388692;644634,11
-1,-1,1,147505013,148209425,704412,200030;645142;644591,3
1,-1,1,147599068,147599100,32,200030,1
1,-1,1,147599068,147857078,258010,200030,1
1,-1,1,147734952,147909430,174478,,0
-1,-1,1,147735759,147824148,88389,,0
1,-1,1,147824212,149817768,1993556,126961;728945;284565;644591;645142;8370;2209;8337;730262;653598;653604;440689;554282;388692;644634,15
1,-1,1,147828088,149039684,1211596,728945;284565;644591;730262;645142,5
1,-1,1,147828088,149736090,1908002,728945;284565;644591;645142;730262;653598;554282;388692;644634,9
1,-1,1,147860611,149817768,1957157,126961;728945;284565;644591;645142;8370;2209;8337;730262;653598;653604;440689;554282;388692;644634,15
1,-1,1,147897667,147909430,11763,,0
1,-1,1,147909430,147962225,52795,644591,1
1,-1,1,147962225,149418924,1456699,388692;728945;284565;730262;645142,5
1,-1,1,148004766,149754410,1749644,728945;284565;645142;2209;730262;653598;440689;554282;388692;644634,10
1,-1,1,148247978,148345159,97181,,0
1,-1,1,148256138,148327665,71527,,0
1,-1,1,148256138,148345159,89021,,0
-1,-1,1,148545476,149232481,687005,728945;730262;284565,3
1,-1,1,148552009,148782879,230870,730262;284565,2
1,-1,1,148574680,148757827,183147,730262;284565,2
1,-1,1,148591245,148757827,166582,730262;284565,2
1,-1,1,148591245,148757827,166582,730262;284565,2
1,-1,1,148591245,148757827,166582,730262;284565,2
1,-1,1,148591245,148757827,166582,730262;284565,2
1,-1,1,148591245,148757827,166582,730262;284565,2
1,-1,1,148591245,148757827,166582,730262;284565,2
1,-1,1,148591245,148757827,166582,730262;284565,2
1,-1,1,148591245,148757827,166582,730262;284565,2
1,-1,1,148591245,148757827,166582,730262;284565,2
1,-1,1,148591245,148771600,180355,730262;284565,2
1,-1,1,148591245,148771600,180355,730262;284565,2
1,-1,1,148817029,149519295,702266,554282;388692,2
1,-1,1,148817029,149519295,702266,554282;388692,2
1,-1,1,148817029,149519295,702266,554282;388692,2
1,-1,1,148817029,149817768,1000739,126961;8370;2209;8337;653598;653604;440689;554282;388692;644634,10
1,-1,1,148817029,149817768,1000739,126961;8370;2209;8337;653598;653604;440689;554282;388692;644634,10
1,-1,1,148817029,149817768,1000739,126961;8370;2209;8337;653598;653604;440689;554282;388692;644634,10
1,-1,1,148832327,149576317,743990,554282;653598;388692,3
-1,-1,1,148867551,149699420,831869,554282;653598;388692;644634,4
-1,-1,1,148867551,149699420,831869,554282;653598;388692;644634,4
-1,-1,1,148867551,149699420,831869,554282;653598;388692;644634,4
-1,-1,1,148867551,149699420,831869,554282;653598;388692;644634,4
-1,-1,1,148867551,149699420,831869,554282;653598;388692;644634,4
-1,-1,1,148867551,149699420,831869,554282;653598;388692;644634,4
-1,-1,1,148867551,149699420,831869,554282;653598;388692;644634,4
-1,-1,1,148867551,149699420,831869,554282;653598;388692;644634,4
-1,-1,1,148867551,149699420,831869,554282;653598;388692;644634,4
1,-1,1,148867581,149699396,831815,554282;653598;388692;644634,4
1,-1,1,148867634,149817768,950134,126961;8370;2209;8337;653598;653604;440689;554282;388692;644634,10
1,-1,1,148881775,149519295,637520,554282;388692,2
1,-1,1,148881775,149519295,637520,554282;388692,2
1,-1,1,148881775,149817768,935993,126961;8370;2209;8337;653598;653604;440689;554282;388692;644634,10
1,-1,1,148894796,149519295,624499,554282;388692,2
1,-1,1,148894796,149519295,624499,554282;388692,2
1,-1,1,148894796,149754161,859365,554282;653598;388692;644634,4
-1,-1,1,148936623,149433207,496584,388692,1
-1,-1,1,148936623,149699396,762773,554282;653598;388692;644634,4
-1,-1,1,148936623,149699396,762773,554282;653598;388692;644634,4
1,-1,1,148936682,149817768,881086,126961;8370;2209;8337;653598;653604;440689;554282;388692;644634,10
-1,-1,1,148940709,149763756,823047,2209;653598;440689;554282;388692;644634,6
-1,-1,1,149039684,149244504,204820,,0
-1,-1,1,149039684,149244504,204820,,0
-1,-1,1,149039684,149244504,204820,,0
-1,-1,1,149039684,149244504,204820,,0
-1,-1,1,149039684,149244504,204820,,0
-1,-1,1,149039684,149244504,204820,,0
-1,-1,1,149039684,149244504,204820,,0
-1,-1,1,149039684,149244504,204820,,0
-1,-1,1,149039684,149244504,204820,,0
-1,-1,1,149039684,149244504,204820,,0
-1,-1,1,149039684,149244504,204820,,0
-1,-1,1,149039684,149244504,204820,,0
-1,-1,1,149039684,149244504,204820,,0
-1,-1,1,149039684,149244504,204820,,0
-1,-1,1,149039684,149244504,204820,,0
-1,-1,1,149039684,149244504,204820,,0
-1,-1,1,149039684,149244504,204820,,0
-1,-1,1,149039684,149244504,204820,,0
-1,-1,1,149039684,149244504,204820,,0
-1,-1,1,149039684,149244504,204820,,0
-1,-1,1,149039684,149254178,214494,,0
-1,-1,1,149039684,149433215,393531,388692,1
-1,-1,1,149039684,149433215,393531,388692,1
-1,-1,1,149015233,149519295,504062,554282;388692,2
-1,-1,1,149015233,149519295,504062,554282;388692,2
-1,-1,1,149015233,149519295,504062,554282;388692,2
-1,-1,1,149015233,149519295,504062,554282;388692,2
-1,-1,1,149015233,149519295,504062,554282;388692,2
-1,-1,1,149015233,149519295,504062,554282;388692,2
-1,-1,1,149015233,149519295,504062,554282;388692,2
-1,-1,1,149041023,149244504,203481,,0
-1,-1,1,149041023,149244504,203481,,0
-1,-1,1,149041023,149254178,213155,,0
-1,-1,1,149137673,149433215,295542,388692,1
-1,-1,1,149041013,149232481,191468,,0
-1,-1,1,149041013,149232481,191468,,0
1,-1,1,149041013,149232481,191468,,0
1,-1,1,149041013,149232481,191468,,0
-1,-1,1,149041013,149275124,234111,,0
-1,-1,1,149041013,149699420,658407,554282;653598;388692;644634,4
-1,-1,1,149041013,149699420,658407,554282;653598;388692;644634,4
-1,-1,1,149041013,149699420,658407,554282;653598;388692;644634,4
-1,-1,1,149041013,149699420,658407,554282;653598;388692;644634,4
-1,-1,1,149041013,149699420,658407,554282;653598;388692;644634,4
-1,-1,1,149041013,149699420,658407,554282;653598;388692;644634,4
-1,-1,1,149041013,149699420,658407,554282;653598;388692;644634,4
-1,-1,1,149041013,149699420,658407,554282;653598;388692;644634,4
-1,-1,1,149041013,149699420,658407,554282;653598;388692;644634,4
-1,-1,1,149041013,149699420,658407,554282;653598;388692;644634,4
-1,-1,1,149041013,149699420,658407,554282;653598;388692;644634,4
-1,-1,1,149041013,149768855,727842,2209;653598;440689;554282;388692;644634,6
-1,-1,1,149041023,149699396,658373,554282;653598;388692;644634,4
-1,-1,1,149041023,149768869,727846,2209;653598;440689;554282;388692;644634,6
-1,-1,1,149041042,149192074,151032,,0
-1,-1,1,149041042,149275102,234060,,0
-1,-1,1,149091130,149699420,608290,554282;653598;388692;644634,4
1,-1,1,149137529,149224014,86485,,0
-1,-1,1,149137732,149519295,381563,554282;388692,2
-1,-1,1,149137732,149519295,381563,554282;388692,2
-1,-1,1,149137732,149519295,381563,554282;388692,2
-1,-1,1,149137732,149519295,381563,554282;388692,2
-1,-1,1,149155041,149699396,544355,554282;653598;388692;644634,4
-1,-1,1,149155041,149699396,544355,554282;653598;388692;644634,4
-1,-1,1,149754410,149763756,9346,2209;440689,2
1,1,1,149825831,180236332,30410501,912;54865;10763;11266;1163;391107;117145;10654;6700;6402;79957;480;127579;51744;8832;2328;25903;460;317772;339403;6280;64326;79368;79626;353132;353140;100534012;909;4009;23215;9068;10456;22889;115350;645922;51686;6391;1520;55891;388695;26052;9826;54460;8349;5313;9129;79005;6698;9047;2326;55103;27;22920;23126;1314;51027;57111;57216;6846;7143;57657;55157;10262;11022;126637;9588;54964;2215;91181;26092;336;81611;391114;51177;127933;9019;4580;56882;6401;6279;6708;4170;126638;92344;149041;149628;57549;10712;55811;6403;54544;8991;5202;338324;23623;284680;2327;9293;3713;128368;57147;844;5872;4881;163590;6016;23432;81609;9447;90780;10962;128240;391104;388698;353139;4259;4184;64222;57821;49860;51478;91687;51107;574414;5451;51043;148753;9857;5298;10223;730159;65123;126626;339398;4332;3310;913;6282;448835;1382;57795;6704;107181291;6278;57326;3068;63931;54344;80308;127943;9898;163589;2214;89866;83417;284486;84283;55793;6277;261726;353142;8407;1893;353141;4914;149297;79630;1141;6703;1945;4359;388697;100527963;8682;126859;148523;142683;54499;8703;92235;1513;440699;2205;4000;391112;356;1401;391109;54856;128372;1196;554313;5993;93183;4582;63827;6746;25790;8674;80222;477;2532;126669;27252;962;51506;6675;81448;8804;55827;10067;128367;79590;112770;57459;4014;84134;5498;2329;405;6944;353133;114771;223;23557;60676;92241;23248;3645;6232;80128;55870;400793;387597;9917;26476;55249;57402;148327;10899;7827;23385;200185;3428;149281;1944;353135;11189;54507;55154;84066;27173;7371;200186;89886;5692;6706;353145;63923;8394;80133;6275;10560;149499;339416;353137;9970;2629;57127;257177;9722;2029;60484;448834;64218;339512;128360;128229;6646;57823;1942;56957;100131187;83416;388701;140576;9900;6273;375033;28956;6274;84824;911;6258;353134;7391;9910;8995;57592;632;343413;55600;2207;8548;2153;284485;27101;56833;92346;149018;51093;55204;2312;3766;5824;29765;6701;257106;284677;2213;6283;462;100131107;5396;5768;25912;11000;117143;6464;7170;7203;84072;55243;9673;391123;353144;4720;11243;58497;919;128366;57198;93185;2224;3765;9507;343406;50848;9191;4063;922;26097;9909;57530;7286;9095;10485;163778;84944;4817;2117;3782;2212;114836;353143;6705;26239;164118;149095;83540;57863;4209;6281;65005;353131;254910;54935;7818;51430;57115;5999;92312;127385;199834;5279;22926;5710;6097;6276;1805;126668;23381;3608;3570;5546;55732;4653;100129271;81607;29956;5087;84614;284525;9181;10500;56893;50717;9869;27005;325;84648;481;375035;128239;441911;9674;51603;23208;440695;7292;8338;103;654790;6504;10903;6707;25874;7059;4807;55585;55974;126823;8490;81442;11311;910;8751;57645;4921;92342;29922;89884;128371;6284;117157;6699;100191040;8416;6271;6375;101928120;23632;89872;81875;149428;9462;7062;115352,458
1,-1,1,151333124,151399960,66836,8991;23126;5692,3
-1,-1,1,152499180,152702192,203012,199834;100129271;353145;353142;353139;353140;353141;353143;353144;84648;26239,11
-1,-1,1,152538937,152586281,47344,353144;84648;353145,3
-1,-1,1,152538937,152586281,47344,353144;84648;353145,3
1,-1,1,152647750,152659287,11537,353140;26239,2
1,-1,1,152647750,152670818,23068,353140;26239,2
1,-1,1,153613593,153724866,111273,26097;4881;3608;65123;23557,5
1,1,1,154012994,157048591,3035597,54865;10763;90780;1163;128240;391104;10654;200185;10485;1944;79957;3782;127579;55154;164118;149095;51043;339403;4209;149499;7818;2629;57127;1382;92312;10456;22889;60484;64218;57326;54344;80308;3068;128229;9898;55891;9826;1942;5313;126668;388701;9047;23381;84283;3570;5546;375033;28956;57111;4914;9181;57657;56893;1141;1945;632;128239;100527963;91181;23208;4000;51093;54856;103;1196;4582;63827;4580;7059;6746;55585;55974;25912;6464;7170;7203;126669;8751;10067;9673;112770;79590;10712;11243;23623;101928120;57198;2224;89872;81875;3645;80128;55870;6016;55249,95
1,1,1,154538977,157593874,3054897,54865;10763;90780;1163;128240;391104;10654;200185;10485;1944;79957;3782;2117;127579;55154;164118;149095;51043;339403;4209;149499;7818;2629;57127;1382;92312;22889;60484;64218;57326;54344;80308;3068;128229;55891;9826;1942;5313;83417;83416;9047;23381;84283;5546;375033;28956;57111;4914;9181;57657;56893;1141;1945;632;128239;100527963;23208;440695;4000;51093;54856;103;1196;4582;63827;4580;7059;6746;55974;6464;7203;8751;10067;9673;112770;79590;10712;11243;23623;101928120;2224;81875;3645;80128;55870;6016;55249,87
1,-1,1,155181714,155207954,26240,4580;2629,2
1,-1,1,155181714,155207954,26240,4580;2629,2
1,-1,1,155181714,155207954,26240,4580;2629,2
1,-1,1,155181714,155207954,26240,4580;2629,2
1,-1,1,155184360,155207954,23594,2629,1
1,-1,1,155184360,155207954,23594,2629,1
1,-1,1,155184360,155207954,23594,2629,1
1,-1,1,155184360,155207954,23594,2629,1
-1,-1,1,156262460,156269217,6757,391104;112770,2
1,-1,1,157230055,157351515,121460,,0
-1,-1,1,160029416,160105986,76570,3765;3766;477;93185,4
-1,-1,1,160029416,160105986,76570,3765;3766;477;93185,4
1,-1,1,160029416,160105986,76570,3765;3766;477;93185,4
1,-1,1,160029416,160105986,76570,3765;3766;477;93185,4
-1,-1,1,160029416,160105986,76570,3765;3766;477;93185,4
-1,-1,1,160029416,160105986,76570,3765;3766;477;93185,4
1,-1,1,160029416,160187302,157886,3766;844;93185;8682;3765;480;50717;477,8
-1,-1,1,161501808,161537484,35676,2214,1
1,-1,1,161559766,161618874,59108,2215,1
-1,1,1,161676893,184071723,22394830,11266;7827;149281;6402;84066;3140;2328;7371;25903;460;80896;51278;64326;63923;10560;80133;339416;9887;4009;9722;23215;9068;339512;6646;26052;10228;23127;353299;2326;55103;27;22920;84824;6846;6258;7143;55157;9910;8995;9588;8548;2153;27101;6041;26092;92346;127933;9019;23179;462;6401;5396;5768;117143;92344;777;149041;6403;55811;919;2327;284680;9293;57147;163590;23432;9095;84944;4259;64222;57821;91687;51478;148753;9857;5451;83540;10223;730159;127670;51430;57795;9213;5999;6004;63931;127943;22926;5279;163589;89866;10092;1805;55732;4653;261726;5087;84614;284525;57710;149297;2752;481;375035;126859;9674;51603;54499;92235;356;440699;116461;7292;81626;85397;25874;4688;1660;3918;8674;127665;8490;23057;57645;27252;3915;6675;4921;8804;55827;92342;29922;89884;84320;403314;2329;117157;223;6375;92241;60676;400793;9462;387597;9917,145
-1,1,1,163352313,175846158,12493845,9095;84944;149281;6402;4259;57821;2328;91687;7371;5451;730159;10223;63923;10560;80133;339416;4009;51430;23215;63931;5279;26052;1805;2326;55732;4653;261726;22920;5087;84614;284525;6846;6258;7143;55157;149297;9910;8995;481;9588;375035;8548;2153;9674;51603;27101;54499;92235;356;440699;92346;7292;9019;25874;8674;462;6401;5396;117143;92344;57645;27252;8804;149041;55827;92342;29922;6403;55811;2329;919;2327;9293;223;6375;57147;92241;387597;23432,79
-1,1,1,169187474,178044969,8857495,9588;8548;149281;2153;6402;9674;51603;27101;356;92346;57821;2328;91687;7292;460;730159;64326;63923;10560;80133;339416;8674;462;6401;5396;51430;57795;23215;92344;63931;27252;5279;149041;92342;26052;29922;89866;6403;2329;2326;2327;9293;55732;4653;57147;22920;60676;84614;284525;7143;55157;9910;8995,53
-1,1,1,169873155,181823980,11950825,7827;149281;64222;84066;3140;2328;91687;148753;9857;460;730159;51278;64326;63923;80133;339416;51430;57795;9213;23215;9068;63931;5279;6646;163589;26052;10228;89866;2326;55103;27;4653;22920;84614;284525;7143;57710;55157;9910;8995;9588;126859;9674;51603;27101;356;26092;92346;7292;8674;462;5396;5768;92344;27252;777;149041;89884;84320;2329;2327;9293;60676;163590;9462;9917,66
-1,1,1,170005209,187524280,17519071,5743;7827;149281;10216;64222;84066;3140;2328;91687;148753;9857;460;80896;730159;51278;83872;64326;5321;63923;80133;339416;7175;127670;9887;51430;57795;9213;23215;6004;9068;63931;5279;6646;54953;163589;81627;10625;26052;10228;23127;89866;10092;54823;353299;2326;55103;27;4653;22920;84614;284525;7143;57710;81563;55157;9910;8995;2752;9588;126859;9674;51603;27101;6041;5132;26092;356;6045;92346;116461;7292;81626;85397;23179;4688;1660;3918;8674;462;5396;127665;5768;116496;92344;23057;27252;777;3915;149041;89884;84320;403314;2329;2327;9293;10896;60676;80267;163590;9462;9917,101
-1,1,1,170898861,191034539,20135678,5743;7827;10216;64222;84066;3140;2328;91687;148753;9857;460;80896;730159;51278;83872;64326;5321;63923;80133;339479;339416;7175;127670;9887;51430;57795;9213;23215;6004;9068;63931;5279;6646;54953;163589;81627;10625;26052;10228;23127;89866;10092;54823;353299;2326;55103;27;4653;84614;284525;7143;57710;81563;55157;9910;8995;2752;9588;126859;9674;51603;27101;6041;5132;26092;356;6045;92346;116461;7292;81626;85397;23179;4688;1660;3918;8674;462;127665;5768;116496;23057;27252;777;3915;149041;89884;84320;403314;2329;2327;9293;10896;60676;80267;163590;9462;9917,98
1,1,1,171009116,186845089,15835973,5743;7827;10216;64222;84066;3140;2328;91687;148753;9857;460;80896;730159;51278;83872;64326;5321;63923;80133;339416;7175;127670;9887;51430;57795;9213;23215;6004;9068;63931;5279;6646;54953;163589;81627;10625;26052;10228;23127;89866;10092;54823;353299;2326;55103;27;4653;84614;284525;7143;57710;81563;55157;9910;8995;2752;9588;126859;9674;51603;27101;6041;5132;26092;356;6045;92346;116461;7292;81626;85397;23179;4688;1660;3918;8674;462;127665;5768;116496;23057;27252;777;3915;149041;89884;84320;403314;2329;2327;9293;10896;60676;80267;163590;9462;9917,97
-1,1,1,171990029,195086758,23096729,5743;7827;10216;64222;84066;3140;91687;148753;9857;460;80896;730159;51278;83872;64326;5321;63923;339479;9462;339416;7175;6738;9887;127670;51430;57795;9213;6004;9068;63931;5279;6646;54953;163589;81627;10625;26052;51022;10228;23127;89866;10092;54823;353299;55103;27;64407;51377;84614;284525;7143;57710;81563;431704;55157;9910;6003;8995;2752;9588;5996;126859;9674;5132;27101;6041;26092;356;6045;92346;116461;8707;7292;81626;85397;23179;4688;1660;3918;462;127665;5768;116496;23057;27252;777;3915;149041;89884;84320;403314;9293;10896;60676;80267;163590;79577;9917;5997,99
-1,-1,1,174468168,174656796,188628,9910,1
1,-1,1,175437001,175704743,267742,7143,1
1,-1,1,175437001,175704743,267742,7143,1
1,-1,1,175437001,175704743,267742,7143,1
-1,1,1,176565098,196270818,19705720,5743;7827;10216;64222;84066;3140;148753;9857;460;80896;51278;83872;5321;339479;9462;7175;127670;9887;6738;57795;9213;6004;9068;6646;54953;163589;81627;10625;51022;10228;89866;10092;23127;54823;353299;55103;27;64407;51377;57710;431704;81563;6003;2752;5996;126859;5132;6041;26092;6045;116461;8707;81626;85397;23179;4688;1660;3918;343450;127665;5768;116496;23057;777;3915;89884;84320;403314;10896;60676;80267;163590;79577;9917;5997,75
-1,-1,1,176712791,176781116,68325,60676,1
-1,1,1,179011314,199022759,20011445,5743;360023;7827;10877;10216;64222;3140;3075;148753;9857;80896;51278;83872;5321;339479;140609;7175;6738;9887;127670;9213;6004;2165;388722;6646;54953;163589;81627;10625;51022;10228;23127;10092;3078;54823;353299;27;64407;51377;5788;81494;57710;431704;81563;10878;6003;2752;163486;5996;126859;5132;6041;26092;6045;259266;116461;8707;81626;85397;23179;4688;1660;3918;343450;127665;5768;116496;56956;23057;777;3915;89884;84320;403314;10896;3080;80267;127124;163590;79577;9917;5997;23418,83
-1,1,1,179073386,200192265,21118879,5743;360023;7827;10877;10216;3140;3075;148753;9857;80896;51278;83872;5321;339479;140609;7175;6738;9887;127670;9213;6004;2165;388722;6646;54953;163589;81627;10625;51022;10228;23127;10092;3078;54823;353299;27;64407;51377;2494;5788;81494;57710;431704;81563;10878;6003;2752;163486;5996;126859;5132;6041;26092;6045;259266;116461;8707;81626;85397;23179;4688;1660;3918;343450;127665;5768;116496;56956;23057;777;3915;89884;84320;403314;10896;3080;80267;127124;163590;79577;5997;23418,82
-1,1,1,179413479,201764737,22351258,5743;360023;7827;7139;10877;5317;10216;3140;3075;23528;148753;9857;80896;51278;83872;5321;339479;140609;7175;6738;9887;252839;127670;9213;9928;6004;2165;388722;54953;163589;81627;10625;91156;51022;10228;23127;10092;3078;54823;353299;64407;51377;2494;5788;81494;57710;431704;81563;10878;6003;89796;23271;2752;163486;5996;23046;126859;5132;1465;6041;26092;6045;259266;116461;83479;8707;81626;85397;23179;647219;4688;3898;1660;3918;779;343450;23612;127665;5768;116496;55765;7135;56956;23057;777;2848;3915;89884;84320;403314;10896;3080;80267;127124;163590;79577;5997;23418,98
-1,1,1,179564752,183850820,4286068,6041;26092;3140;148753;9857;81626;80896;85397;51278;23179;4688;1660;3918;127670;9887;127665;9213;5768;6004;23057;777;3915;163589;89884;10228;10092;84320;403314;353299;163590;57710;2752,32
1,-1,1,183861204,184091272,230068,23127;23179;116461,3
-1,1,1,184857562,186591462,1733900,54823;10896;83872;54953;81627;5132;10625;10216;7175;6045;116496,11
-1,-1,1,187644027,187745698,101671,,0
1,-1,1,187956640,189056310,1099670,,0
-1,-1,1,188205949,188574502,368553,,0
1,-1,1,188736609,188849004,112395,,0
-1,1,1,189003614,199584994,10581380,163486;5996;360023;56956;2165;388722;10877;51022;3078;259266;3075;8707;64407;51377;5788;10878;431704;3080;127124;339479;81494;140609;79577;6738;6003;343450;5997;23418,28
1,-1,1,189093350,189957275,863925,,0
1,-1,1,189129332,189924389,795057,,0
-1,-1,1,189331211,189542589,211378,,0
-1,-1,1,189331211,189542589,211378,,0
-1,-1,1,189331211,189542589,211378,,0
-1,-1,1,189331211,189542589,211378,,0
-1,-1,1,189331211,189542589,211378,,0
-1,-1,1,189331211,189542589,211378,,0
-1,-1,1,189331211,189542589,211378,,0
-1,-1,1,189331211,189542589,211378,,0
-1,-1,1,189331211,189542589,211378,,0
-1,-1,1,189331211,189542589,211378,,0
-1,-1,1,189331211,189542589,211378,,0
-1,-1,1,189331211,189542589,211378,,0
-1,-1,1,189331211,189542589,211378,,0
-1,-1,1,189331211,189542589,211378,,0
-1,-1,1,189331211,189542589,211378,,0
-1,-1,1,189331211,189542589,211378,,0
-1,-1,1,189331211,189542589,211378,,0
-1,-1,1,189331211,189542589,211378,,0
-1,-1,1,189331211,189542589,211378,,0
-1,-1,1,189331252,189512888,181636,,0
-1,-1,1,189331252,189512888,181636,,0
-1,-1,1,189331252,189512888,181636,,0
-1,-1,1,189331252,189512888,181636,,0
-1,-1,1,189331252,189512888,181636,,0
-1,-1,1,189396085,189512829,116744,,0
-1,-1,1,189396085,189512829,116744,,0
-1,-1,1,189430102,189562215,132113,,0
-1,-1,1,189430102,189562274,132172,,0
1,-1,1,190484823,191590282,1105459,,0
-1,-1,1,190990954,191197531,206577,,0
-1,-1,1,191689637,191826625,136988,,0
1,-1,1,193983247,194067135,83888,,0
1,-1,1,194779033,195627237,848204,,0
-1,-1,1,195262138,195348432,86294,,0
-1,1,1,195483439,197865624,2382185,163486;360023;2165;259266;3080;10877;81494;3078;10878;343450;3075;23418,12
1,1,1,195483439,249213000,53729561,2005;55432;10440;55758;55105;8560;55740;10753;286826;1130;90806;51029;55083;26246;55746;55127;3586;140609;79098;441925;252839;8290;127829;4751;401993;80851;84033;149603;5778;5784;26245;81559;200205;183;388753;163882;10878;89796;23271;5867;64746;5664;84838;1379;127845;149643;3664;9156;93474;128308;8934;259266;9214;127068;79802;646627;4931;403244;391190;284532;647219;149373;88;27097;779;7483;343450;23612;64754;254428;148808;1063;7188;56950;7832;25802;4656;2786;3964;84919;9015;388730;80342;10380;1939;142;148823;4811;127602;27042;51097;64853;56256;360023;54583;1118;467;65094;55220;1604;440730;127069;84288;391196;6894;5208;1116;50604;947;7257;127833;149345;127064;391189;79894;128153;127018;25782;79762;441932;149647;6000;2058;56605;8497;2165;23596;7100;91156;3078;317705;391195;57829;5788;26188;339501;54996;148362;5284;64710;3290;9580;1378;1465;7042;127074;725;64388;4660;2987;388759;25893;26254;553;7044;126731;29089;2271;29949;10638;51133;55657;55765;93273;56956;81466;127062;2848;25778;401992;100381270;9926;59352;29097;5287;56776;375;148304;2104;22796;10765;55705;2331;92815;127077;25909;134;23219;10877;200150;57568;11221;58480;200159;128387;128312;5877;26750;127623;83953;3776;59349;148811;9911;722;6051;3930;10446;9816;55248;5929;1131;83881;3914;2052;148789;28982;2494;79605;9877;128061;58;391211;343169;50486;84451;128025;7399;9804;493;9641;9261;1122;2590;8564;81472;6900;127066;440712;85414;1999;83479;441933;57165;3756;7678;23456;7779;4608;3898;9725;8444;375056;26696;164127;391191;51706;4194;7135;29920;3142;645745;54900;3707;54627;55532;10806;100129094;729533;25896;5129;339500;149371;116228;4179;80003;56997;3080;6635;81470;440738;10637;401994;391192;23418;79573;64757;7139;5362;5317;55509;79805;79169;3075;23528;84886;81469;23029;55224;343173;51127;6905;343035;128178;255928;3020;9928;10472;51742;57116;55061;388722;79862;81788;267002;375057;343563;84976;163859;375061;114548;148641;3814;4139;29937;81494;159;7107;9453;284521;83932;359948;4548;6262;25936;5549;23114;163486;27185;23046;391194;3192;5629;343172;5972;64801;51514;51018;116841;149111;10000;6726;80232;89780;5525;824;11009;8443;127059;51094;7159;92703;115019;23380;1510;388743;83593;343171;254879;400823;9283;257044;57172;3775;55733;9859;1380;127124;8476;64216;403239;22874;84284;55699,384
1,-1,1,196011881,196208885,197004,343450,1
-1,-1,1,196738927,196799273,60346,3078;10878,2
1,-1,1,196738927,196799273,60346,3078;10878,2
-1,-1,1,196738927,196898635,159708,10877;3078;10878,3
-1,-1,1,196746064,196797163,51099,3078;10878,2
-1,-1,1,196746064,196797163,51099,3078;10878,2
-1,-1,1,196746064,196797163,51099,3078;10878,2
-1,-1,1,196746064,196797163,51099,3078;10878,2
-1,-1,1,196746064,196797163,51099,3078;10878,2
-1,-1,1,196746064,196797163,51099,3078;10878,2
-1,-1,1,196746064,196797163,51099,3078;10878,2
-1,-1,1,196746064,196797163,51099,3078;10878,2
-1,-1,1,196746064,196797163,51099,3078;10878,2
-1,-1,1,196746064,196797163,51099,3078;10878,2
-1,-1,1,196746064,196797163,51099,3078;10878,2
-1,-1,1,196746064,196797163,51099,3078;10878,2
-1,-1,1,196746064,196797163,51099,3078;10878,2
-1,-1,1,196746064,196797163,51099,3078;10878,2
-1,-1,1,196746064,196797163,51099,3078;10878,2
1,-1,1,196746064,196797163,51099,3078;10878,2
-1,-1,1,196746064,196797163,51099,3078;10878,2
-1,-1,1,196746064,196797163,51099,3078;10878,2
-1,-1,1,196746064,196797163,51099,3078;10878,2
-1,-1,1,196746064,196797163,51099,3078;10878,2
-1,-1,1,196746064,196797163,51099,3078;10878,2
-1,-1,1,196746064,196797163,51099,3078;10878,2
-1,-1,1,196746064,196797163,51099,3078;10878,2
-1,-1,1,196746064,196797163,51099,3078;10878,2
-1,-1,1,196746064,196797163,51099,3078;10878,2
-1,-1,1,196746064,196883398,137334,10877;3078;10878,3
-1,-1,1,196746064,196883398,137334,10877;3078;10878,3
-1,-1,1,196746064,196883398,137334,10877;3078;10878,3
-1,-1,1,196746064,196883398,137334,10877;3078;10878,3
-1,-1,1,196746064,196883398,137334,10877;3078;10878,3
-1,-1,1,196746064,196883398,137334,10877;3078;10878,3
-1,-1,1,196746064,196883398,137334,10877;3078;10878,3
-1,-1,1,196746064,196883398,137334,10877;3078;10878,3
-1,-1,1,196788212,196883398,95186,10877;3078,2
-1,-1,1,196788212,196883398,95186,10877;3078,2
-1,-1,1,196788212,196883398,95186,10877;3078,2
-1,-1,1,196788212,196883398,95186,10877;3078,2
1,-1,1,196797104,196883398,86294,10877;3078,2
-1,-1,1,196799273,196891639,92366,10877;3078,2
-1,-1,1,196825165,196891639,66474,10877,1
-1,1,1,200113731,203081206,2967475,23046;7139;10440;5317;1465;4660;5877;1999;23528;83479;127833;149345;647219;59349;29089;3898;6051;779;252839;23612;51706;9928;55765;7135;127829;51094;8497;92703;2848;91156;25802;4656;5778;9283;2494;59352;10765;55705;89796;23271,40
-1,1,1,200113731,203081206,2967475,23046;7139;10440;5317;1465;4660;5877;1999;23528;83479;127833;149345;647219;59349;29089;3898;6051;779;252839;23612;51706;9928;55765;7135;127829;51094;8497;92703;2848;91156;25802;4656;5778;9283;2494;59352;10765;55705;89796;23271,40
1,1,1,204734042,225596400,20862358,64853;2005;56256;64757;55432;467;55220;1604;5362;23219;55758;55105;8560;11221;79805;55509;128387;148304;90806;26750;5208;50604;947;83953;3776;3586;148811;9911;343035;722;3930;79098;255928;128153;127018;25782;79762;149647;4751;2058;55248;55061;5929;7100;81788;3914;84976;5784;28982;4139;29937;54996;148362;5284;64710;23114;25936;3290;50486;7399;1379;9641;149643;1378;3664;9261;7042;725;8934;6900;9214;85414;440712;79802;4931;5629;51018;51514;553;3756;7779;149111;80232;5525;29949;8444;375056;51133;164127;824;254428;93273;11009;7159;148808;1063;3142;7188;56950;55532;115019;23380;729533;25896;1510;5129;25778;83593;388743;9015;4179;388730;80342;10380;400823;57172;9926;29097;1939;55733;1380;127602;27042;2104;55699,125
1,-1,1,206075579,206154280,78701,729533,1
1,-1,1,206075579,206154280,78701,729533,1
1,-1,1,206075579,206154280,78701,729533,1
1,-1,1,206075579,206154280,78701,729533,1
1,1,1,207519987,249224684,41704697,55758;55105;8560;55740;286826;10753;1130;90806;51029;55083;26246;55746;55127;441925;8290;401993;4751;80851;84033;149603;5784;26245;81559;200205;183;388753;163882;5664;5867;64746;84838;1379;149643;3664;9156;93474;128308;127068;4931;79802;391190;646627;403244;284532;149373;88;27097;7483;64754;1063;7188;56950;2786;3964;9015;80342;10380;142;127602;4811;148823;27042;51097;64853;56256;467;65094;54583;1604;440730;127069;84288;6894;391196;947;7257;127064;79894;391189;128153;127018;25782;79762;149647;441932;6000;2058;56605;23596;7100;317705;391195;57829;26188;339501;54996;148362;3290;1378;7042;127074;64388;2987;388759;25893;7044;126731;2271;10638;51133;55657;81466;127062;401992;9926;29097;56776;375;148304;22796;2104;92815;127077;25909;23219;200159;200150;57568;11221;58480;128387;128312;26750;127623;3776;3930;9816;55248;1131;83881;3914;2052;148789;28982;79605;128061;58;391211;343169;50486;84451;128025;7399;9804;1122;2590;8564;81472;127066;441933;57165;3756;7678;23456;7779;9725;375056;26696;164127;391191;29920;3142;645745;55532;3707;54627;10806;100129094;25896;339500;149371;116228;4179;80003;56997;81470;440738;10637;401994;391192;79573;64757;5362;79805;55509;79169;84886;81469;23029;343173;51127;6905;343035;128178;255928;3020;10472;51742;57116;55061;79862;267002;375057;343563;84976;163859;375061;114548;148641;4139;29937;9453;83932;7107;159;284521;359948;4548;6262;25936;27185;391194;3192;5629;343172;51018;51514;64801;116841;149111;10000;6726;80232;89780;5525;824;8443;127059;7159;388743;343171;254879;400823;257044;57172;3775;55733;1380;9859;8476;64216;403239;84284;55699,264
-1,1,1,207756872,210332526,2575654,3290;50486;947;4179;80342;57172;1379;5362;3914;1378;148304;3664;255928;27042,14
-1,1,1,208236806,212081154,3844348,3290;50486;4751;56256;5362;7188;55758;148304;3664;3914;80342;3756;57172;55733;7779;343035;255928;27042;9926,19
1,-1,1,208786440,208980535,194095,,0
-1,1,1,209742722,210774573,1031851,3290;50486;56256;80342;27042;57172;55733;3664;255928;3914;148304,11
1,1,1,210136970,249212668,39075698,92815;127077;25909;23219;55758;55105;8560;11221;55740;286826;128387;58480;128312;10753;90806;57568;26750;1130;51029;55083;127623;3776;26246;55746;55127;3930;2104;441925;8290;401993;4751;9816;375;55248;80851;84033;1131;83881;149603;2052;5784;148789;26245;28982;200205;81559;79605;183;128061;58;388753;163882;391211;343169;5664;5867;64746;84451;128025;84838;7399;9804;149643;9156;93474;1122;128308;2590;8564;81472;127066;127068;4931;79802;391190;646627;441933;403244;57165;3756;7678;284532;23456;7779;149373;88;9725;27097;375056;7483;26696;164127;64754;391191;29920;1063;3142;645745;7188;56950;55532;3707;54627;10806;100129094;25896;2786;339500;3964;149371;116228;9015;200159;10380;80003;56997;142;81470;127602;4811;148823;440738;10637;401994;391192;79573;51097;64853;56256;64757;467;65094;54583;440730;127069;79805;55509;79169;84288;84886;6894;81469;391196;23029;200150;7257;343173;51127;6905;127064;79894;391189;343035;128178;255928;128153;127018;25782;79762;3020;149647;441932;6000;10472;2058;51742;56605;57116;55061;79862;23596;7100;267002;375057;343563;84976;317705;391195;163859;375061;57829;114548;148641;26188;4139;339501;29937;9453;54996;83932;7107;159;148362;359948;4548;6262;284521;25936;27185;391194;3192;7042;127074;22796;64388;2987;388759;5629;343172;25893;51018;51514;64801;116841;7044;126731;149111;10000;6726;80232;89780;5525;2271;10638;51133;55657;824;8443;81466;7159;127059;127062;388743;401992;343171;254879;400823;9926;257044;3775;29097;55733;9859;8476;64216;403239;56776;84284;55699,249
1,1,1,214697099,249224684,34527585,92815;127077;25909;23219;200150;55105;8560;11221;55740;286826;58480;10753;128312;57568;1130;51029;55083;127623;3776;26246;55746;55127;3930;2104;441925;8290;401993;9816;375;80851;84033;1131;83881;149603;2052;5784;148789;26245;81559;200205;79605;183;128061;58;388753;163882;391211;343169;5664;5867;64746;84451;128025;84838;7399;9804;9156;93474;1122;128308;2590;8564;81472;127066;127068;4931;79802;391190;646627;441933;403244;57165;7678;284532;23456;149373;88;9725;27097;375056;7483;26696;164127;64754;391191;29920;1063;3142;645745;55532;3707;54627;10806;100129094;2786;339500;3964;149371;116228;9015;200159;10380;80003;56997;142;81470;127602;4811;148823;440738;10637;401994;391192;79573;51097;64853;64757;54583;65094;440730;127069;79169;84288;84886;6894;81469;391196;23029;7257;343173;51127;6905;127064;79894;391189;128178;128153;127018;25782;79762;3020;441932;6000;10472;2058;51742;56605;57116;55061;79862;23596;7100;267002;375057;343563;84976;317705;391195;163859;375061;57829;114548;148641;26188;4139;339501;9453;54996;83932;7107;159;148362;359948;4548;6262;284521;27185;391194;3192;7042;127074;22796;64388;2987;388759;343172;25893;51018;64801;116841;7044;126731;149111;10000;6726;80232;89780;2271;10638;51133;55657;824;8443;81466;7159;127059;127062;388743;401992;343171;254879;400823;257044;3775;29097;9859;8476;64216;403239;56776;84284;55699,222
-1,1,1,215380103,222177410,6797307,64757;2058;7399;3142;55532;55105;11221;7042;51133;51018;10380;3776;4139;2104;54996;128153;127018;25782;55699;79762,20
-1,1,1,215380103,222177410,6797307,64757;2058;7399;3142;55532;55105;11221;7042;51133;51018;10380;3776;4139;2104;54996;128153;127018;25782;55699;79762,20
-1,-1,1,215452796,215526068,73272,,0
-1,1,1,217699328,218689648,990320,51018;128153;55105;7042,4
1,-1,1,218693490,218776969,83479,,0
-1,1,1,220846877,223871214,3024337,64853;64757;3142;55061;79762;7100;11221;84976;388743;79802;9015;400823;54996;375056;148362;164127,16
-1,1,1,223521035,228744033,5222998,64746;92815;65094;23219;55740;8560;286826;79169;128308;128312;2987;4931;116841;57165;51127;7044;149111;6726;80232;89780;9725;3930;7483;824;164127;3020;8290;29920;7159;55061;84033;10637;83881;3707;149603;375057;100129094;388743;2052;339500;163859;81559;200205;56997;29097;142;339501;127602;8476;375;5664,51
1,1,1,224002849,249212668,25209819,92815;127077;25909;23219;200150;55740;8560;58480;286826;10753;57568;200159;128312;1130;51029;55083;127623;26246;55746;55127;3930;441925;8290;401993;9816;375;80851;84033;1131;83881;149603;2052;148789;26245;81559;200205;79605;183;128061;58;388753;163882;391211;343169;5664;5867;64746;84451;128025;84838;9804;9156;93474;1122;128308;2590;8564;81472;127066;127068;4931;391190;646627;441933;403244;57165;7678;284532;23456;149373;88;9725;27097;7483;26696;391191;64754;29920;645745;3707;54627;10806;100129094;2786;339500;3964;149371;116228;80003;56997;142;81470;127602;4811;148823;440738;10637;401994;391192;79573;51097;54583;65094;440730;127069;79169;84288;84886;6894;81469;391196;23029;7257;343173;51127;6905;127064;79894;391189;128178;3020;441932;6000;10472;51742;56605;57116;79862;23596;267002;375057;343563;317705;391195;163859;375061;57829;114548;148641;26188;339501;9453;83932;7107;159;284521;359948;4548;6262;27185;84284;391194;3192;127074;64388;2987;388759;343172;25893;64801;116841;7044;126731;149111;10000;6726;80232;89780;2271;10638;55657;8443;81466;7159;127059;127062;401992;343171;254879;257044;3775;29097;9859;8476;64216;403239;56776;22796,188
1,-1,1,224079085,224180364,101279,,0
1,1,1,224105294,249224684,25119390,92815;127077;25909;23219;200150;55740;8560;58480;286826;10753;57568;200159;128312;1130;51029;55083;127623;26246;55746;55127;3930;441925;8290;401993;9816;80851;84033;1131;83881;149603;2052;148789;26245;81559;200205;79605;183;128061;58;388753;163882;391211;343169;5664;5867;64746;84451;128025;84838;9804;9156;93474;1122;128308;2590;8564;81472;127066;127068;4931;391190;646627;441933;403244;57165;7678;284532;23456;149373;88;9725;27097;7483;26696;391191;64754;29920;645745;3707;54627;10806;100129094;2786;339500;3964;149371;116228;80003;56997;142;81470;127602;4811;148823;440738;10637;401994;391192;79573;51097;54583;65094;440730;127069;79169;84288;84886;6894;81469;391196;23029;7257;343173;51127;6905;127064;79894;391189;128178;3020;441932;6000;10472;51742;56605;57116;79862;23596;267002;375057;343563;317705;391195;163859;375061;57829;114548;148641;26188;339501;9453;83932;7107;159;284521;359948;4548;6262;27185;56776;391194;3192;127074;22796;64388;2987;388759;343172;25893;64801;116841;7044;126731;149111;10000;6726;80232;89780;2271;10638;55657;8443;81466;127059;127062;401992;343171;254879;257044;3775;29097;9859;8476;64216;403239;375;84284,187
1,1,1,224210564,249212668,25002104,92815;127077;25909;23219;200150;55740;8560;58480;286826;10753;57568;200159;128312;1130;51029;55083;127623;26246;55746;55127;3930;441925;8290;401993;9816;80851;84033;1131;83881;149603;2052;148789;26245;81559;200205;79605;183;128061;58;388753;163882;391211;343169;5664;5867;64746;84451;128025;84838;9804;9156;93474;1122;128308;2590;8564;81472;127066;127068;4931;391190;646627;441933;403244;57165;7678;284532;23456;149373;88;9725;27097;7483;26696;391191;64754;29920;645745;3707;54627;10806;100129094;2786;339500;3964;149371;116228;80003;56997;142;81470;127602;4811;148823;440738;10637;401994;391192;79573;51097;54583;65094;440730;127069;79169;84288;84886;6894;81469;391196;23029;7257;343173;51127;6905;127064;79894;391189;128178;3020;441932;6000;10472;51742;56605;57116;79862;23596;267002;375057;343563;317705;391195;163859;375061;57829;114548;148641;26188;339501;9453;83932;7107;159;284521;359948;4548;6262;27185;56776;391194;3192;127074;22796;64388;2987;388759;343172;25893;64801;116841;7044;126731;149111;10000;6726;80232;89780;2271;10638;55657;8443;81466;127059;127062;401992;343171;254879;257044;3775;29097;9859;8476;64216;403239;375;84284,187
1,1,1,225049987,249233096,24183109,92815;127077;25909;200150;55740;57568;58480;286826;10753;200159;128312;1130;51029;55083;127623;26246;55746;55127;3930;441925;8290;401993;9816;80851;84033;1131;83881;149603;2052;148789;26245;81559;200205;79605;183;128061;388753;58;163882;391211;343169;5664;5867;64746;84451;128025;84838;9804;9156;93474;1122;128308;2590;8564;81472;127066;127068;646627;391190;441933;403244;57165;7678;284532;23456;149373;88;9725;27097;7483;26696;391191;64754;29920;645745;3707;54627;10806;100129094;2786;339500;3964;149371;116228;80003;56997;142;81470;127602;4811;148823;440738;10637;401994;391192;79573;51097;54583;65094;440730;127069;79169;84288;84886;6894;81469;391196;23029;7257;343173;51127;6905;127064;79894;391189;128178;3020;441932;6000;10472;51742;56605;57116;79862;23596;267002;375057;343563;317705;391195;163859;375061;57829;114548;148641;26188;339501;9453;83932;7107;159;284521;359948;4548;6262;27185;56776;391194;3192;127074;22796;64388;2987;388759;343172;25893;64801;116841;7044;126731;10000;6726;2271;89780;10638;55657;8443;81466;127059;127062;401992;343171;254879;257044;3775;9859;8476;64216;403239;375;84284,181
-1,1,1,225569874,230554547,4984673,5867;64746;92815;65094;55740;58480;286826;79169;128308;2590;128312;2987;116841;57165;51127;7044;126731;23456;55746;6726;89780;3930;9725;27097;10638;7483;3020;8290;29920;9816;84033;10637;83881;3707;149603;375057;100129094;2052;339500;163859;81559;200205;56997;79605;142;339501;127602;8476;375;58;5664,51
1,1,1,225626182,249060210,23434028,92815;127077;25909;200150;55740;57568;58480;286826;10753;200159;128312;1130;51029;55083;127623;26246;55746;55127;441925;8290;401993;9816;84033;1131;83881;149603;2052;148789;26245;81559;200205;79605;183;128061;388753;58;163882;391211;343169;5664;5867;64746;84451;128025;84838;9804;9156;93474;1122;128308;2590;8564;81472;127066;127068;646627;391190;441933;403244;57165;7678;284532;23456;149373;88;9725;27097;7483;26696;391191;64754;29920;645745;3707;54627;10806;100129094;2786;339500;3964;149371;116228;80003;56997;142;81470;148823;4811;440738;10637;401994;391192;79573;51097;54583;65094;440730;127069;79169;84288;84886;6894;81469;391196;23029;7257;343173;51127;6905;127064;391189;128178;3020;441932;6000;10472;51742;56605;57116;79862;23596;375057;343563;317705;391195;163859;375061;57829;114548;148641;26188;339501;9453;83932;7107;159;284521;359948;4548;6262;27185;56776;391194;3192;127074;22796;64388;2987;388759;343172;25893;64801;116841;7044;126731;10000;6726;2271;89780;10638;8443;81466;127059;127062;401992;343171;254879;257044;3775;9859;8476;64216;403239;375;84284,175
-1,1,1,226372825,233008234,6635409,5867;64746;92815;27185;54583;65094;440730;57568;58480;286826;79169;128308;2590;128312;10753;2987;183;84886;5664;64801;116841;57165;7257;51127;126731;23456;55746;149373;89780;27097;10638;7483;8290;9816;8443;375;84033;83881;3707;149603;54627;375057;100129094;339500;375061;149371;81559;200205;56997;79605;142;339501;8476;83932;128061;58;22796;79573,58
1,-1,1,229122568,229295677,173109,,0
1,1,1,229158656,249212668,20054012,127077;25909;200150;200159;57568;10753;1130;51029;55083;127623;26246;55746;55127;441925;401993;9816;80851;1131;148789;26245;79605;183;388753;128061;58;163882;391211;343169;5867;84451;128025;84838;9804;9156;93474;1122;2590;8564;81472;127066;127068;646627;391190;441933;403244;7678;284532;23456;149373;88;27097;26696;391191;64754;645745;54627;10806;2786;3964;149371;116228;80003;81470;148823;4811;440738;401994;391192;79573;51097;54583;440730;127069;84288;84886;6894;81469;391196;23029;7257;343173;6905;127064;79894;391189;128178;441932;6000;10472;51742;56605;57116;79862;23596;267002;343563;317705;391195;375061;57829;114548;148641;26188;9453;7107;83932;159;284521;4548;359948;6262;27185;391194;3192;127074;22796;64388;388759;343172;25893;64801;126731;10000;2271;10638;55657;8443;81466;127059;127062;401992;343171;254879;257044;3775;9859;64216;403239;56776;84284,140
1,1,1,231670870,249213000,17542130,127077;25909;200150;200159;57568;127069;84288;1130;51029;6894;81469;55083;391196;23029;127623;7257;343173;6905;127064;26246;55127;79894;391189;128178;441925;441932;401993;6000;10472;51742;56605;57116;80851;79862;23596;1131;267002;343563;317705;148789;391195;26245;57829;114548;148641;26188;403239;9453;7107;388753;163882;391211;159;284521;4548;343169;359948;6262;84451;128025;27185;84838;391194;9804;3192;9156;93474;1122;127074;8564;81472;127066;127068;646627;391190;64388;388759;441933;403244;343172;25893;7678;284532;10000;88;2271;26696;55657;391191;64754;81466;127059;127062;645745;54627;10806;2786;3964;401992;343171;254879;116228;257044;80003;3775;9859;81470;148823;4811;64216;440738;56776;84284;401994;391192;51097,116
1,-1,1,231710352,231813921,103569,27185,1
1,-1,1,231710352,231813921,103569,27185,1
1,-1,1,231715133,231813921,98788,27185,1
-1,1,1,232226609,241010904,8784295,84451;56776;9804;57568;1130;64388;6894;23029;6905;55127;88;128178;6000;51742;56605;645745;1131;54627;2786;148789;3964;57829;4548;148641;80003;3775;4811;9453;7107;388753;84284;359948;6262,33
-1,1,1,232646424,242656339,10009915,84451;128025;9804;200150;57568;9156;1122;1130;64388;8564;6894;23029;6905;7107;55127;88;128178;2271;441925;388753;6000;51742;56605;359948;645745;23596;1131;54627;2786;148789;3964;57829;148641;80003;3775;4811;9453;440738;56776;84284;4548;6262,42
-1,1,1,234605553,240932205,6326652,51742;56605;645745;9804;1131;1130;64388;2786;148789;3964;6894;23029;57829;4548;6905;55127;88;128178;4811;9453;7107;56776;359948;6262,24
-1,1,1,235374095,249224684,13850589,127077;25909;200150;200159;127069;84288;1130;51029;391196;81469;55083;127623;343173;6905;127064;26246;55127;79894;391189;128178;441925;441932;401993;6000;10472;51742;56605;57116;80851;79862;23596;1131;267002;343563;317705;148789;391195;26245;57829;114548;26188;403239;9453;7107;159;163882;391211;284521;4548;343169;6262;128025;84838;391194;3192;9156;93474;1122;127074;8564;81472;127066;127068;646627;391190;64388;388759;441933;403244;343172;25893;7678;284532;10000;88;2271;26696;55657;391191;64754;81466;127059;127062;645745;10806;2786;3964;401992;343171;254879;116228;257044;9859;81470;148823;4811;64216;440738;56776;401994;391192;51097,102
1,1,1,235551307,237433932,1882625,56605;645745;6905;55127;88;128178;4811;7107;2786;1130;4548;3964;6262;148789,14
-1,1,1,235797384,249224684,13427300,127077;25909;200150;200159;127069;84288;1130;51029;391196;81469;55083;127623;343173;127064;26246;55127;79894;391189;128178;441925;441932;401993;6000;10472;56605;57116;80851;79862;23596;1131;267002;343563;317705;391195;26245;57829;114548;26188;403239;159;7107;163882;391211;284521;4548;343169;6262;128025;84838;391194;3192;9156;93474;1122;127074;8564;81472;127066;127068;646627;391190;64388;388759;441933;403244;343172;25893;7678;284532;10000;88;2271;26696;55657;391191;64754;81466;127059;127062;645745;10806;2786;3964;401992;343171;254879;116228;257044;9859;81470;148823;4811;64216;440738;56776;401994;391192;51097,98
1,1,1,236515525,249224684,12709159,127077;25909;200150;200159;127069;84288;51029;391196;81469;55083;127623;343173;127064;26246;55127;79894;391189;128178;441925;441932;401993;6000;10472;57116;80851;79862;23596;1131;267002;343563;317705;391195;26245;57829;114548;26188;403239;159;163882;391211;284521;4548;343169;6262;128025;84838;391194;3192;9156;93474;1122;127074;8564;81472;127066;127068;646627;391190;64388;388759;441933;403244;343172;25893;7678;284532;10000;88;2271;26696;55657;391191;64754;81466;127059;127062;645745;10806;3964;401992;343171;254879;116228;257044;9859;81470;148823;64216;440738;56776;401994;391192;51097,93
-1,1,1,236719382,249212668,12493286,127077;25909;200150;200159;127069;84288;51029;391196;81469;55083;127623;343173;127064;26246;55127;79894;391189;441925;441932;401993;6000;10472;57116;80851;79862;23596;1131;267002;343563;317705;391195;26245;57829;114548;26188;403239;159;163882;391211;284521;4548;343169;6262;128025;84838;391194;3192;9156;93474;1122;127074;8564;81472;127066;127068;646627;391190;64388;388759;441933;403244;343172;25893;7678;284532;10000;88;2271;26696;55657;391191;64754;81466;127059;127062;645745;10806;401992;343171;254879;116228;257044;9859;81470;148823;64216;440738;56776;401994;391192;51097,91
-1,1,1,237233879,249206548,11972669,127077;25909;200159;200150;127069;84288;51029;391196;81469;55083;127623;343173;127064;26246;79894;391189;441925;441932;401993;6000;10472;57116;80851;79862;23596;1131;267002;343563;317705;391195;26245;57829;114548;26188;403239;159;163882;391211;284521;6262;343169;128025;84838;391194;3192;9156;93474;1122;127074;8564;81472;127066;127068;646627;391190;64388;388759;441933;403244;343172;25893;7678;284532;10000;2271;26696;55657;391191;64754;81466;127059;127062;10806;401992;343171;254879;116228;257044;9859;81470;148823;64216;440738;56776;401994;391192;51097,87
-1,1,1,237806581,249212668,11406087,127077;25909;200159;200150;127069;84288;51029;391196;81469;55083;127623;343173;127064;26246;79894;391189;441925;441932;401993;6000;10472;57116;80851;79862;23596;1131;267002;343563;317705;391195;26245;57829;114548;26188;403239;159;163882;391211;284521;6262;343169;128025;84838;391194;3192;9156;93474;1122;127074;8564;81472;127066;127068;646627;391190;64388;388759;441933;403244;343172;25893;7678;284532;10000;2271;26696;55657;391191;64754;81466;127059;127062;10806;401992;343171;254879;116228;257044;9859;81470;148823;64216;440738;56776;401994;391192;51097,87
-1,1,1,238196875,249218733,11021858,127077;25909;200159;200150;127069;84288;51029;391196;81469;55083;127623;343173;127064;26246;79894;391189;441925;441932;401993;6000;10472;57116;80851;79862;23596;1131;267002;343563;317705;391195;26245;114548;26188;403239;159;163882;391211;284521;343169;128025;84838;391194;3192;9156;93474;1122;127074;8564;81472;127066;127068;646627;391190;64388;388759;441933;403244;343172;25893;7678;284532;10000;2271;26696;55657;391191;64754;81466;127059;127062;10806;401992;343171;254879;116228;257044;9859;81470;148823;64216;440738;56776;401994;391192;51097,85
-1,1,1,238356180,249224684,10868504,127077;25909;200159;200150;127069;84288;51029;391196;81469;55083;127623;343173;127064;26246;79894;391189;441925;441932;401993;6000;10472;57116;80851;79862;23596;1131;267002;343563;317705;391195;26245;114548;26188;403239;159;163882;391211;284521;343169;128025;84838;391194;3192;9156;93474;1122;127074;8564;81472;127066;127068;646627;391190;64388;388759;441933;403244;343172;25893;7678;284532;10000;2271;26696;55657;391191;64754;81466;127059;127062;10806;401992;343171;254879;116228;257044;9859;81470;148823;64216;440738;56776;401994;391192;51097,85
1,1,1,238514419,238865550,351131,,0
-1,1,1,238514421,249212668,10698247,127077;25909;200159;200150;127069;84288;51029;391196;81469;55083;127623;343173;127064;26246;79894;391189;441925;441932;401993;6000;10472;57116;80851;79862;23596;1131;267002;343563;317705;391195;26245;114548;26188;403239;159;163882;391211;284521;343169;128025;84838;391194;3192;9156;93474;1122;127074;8564;81472;127066;127068;646627;391190;64388;388759;441933;403244;343172;25893;7678;284532;10000;2271;26696;55657;391191;64754;81466;127059;127062;10806;401992;343171;254879;116228;257044;9859;81470;148823;64216;440738;56776;401994;391192;51097,85
1,-1,1,238676252,238753428,77176,,0
-1,1,1,238917049,249212666,10295617,127077;25909;200159;200150;127069;84288;51029;391196;81469;55083;127623;343173;127064;26246;79894;391189;441925;441932;401993;6000;10472;57116;80851;79862;23596;1131;267002;343563;317705;391195;26245;114548;26188;403239;159;163882;391211;284521;343169;128025;84838;391194;3192;9156;93474;1122;127074;8564;81472;127066;127068;646627;391190;64388;388759;441933;403244;343172;25893;7678;284532;10000;2271;26696;55657;391191;64754;81466;127059;127062;10806;401992;343171;254879;116228;257044;9859;81470;148823;64216;440738;56776;401994;391192;51097,85
-1,1,1,239451325,242621355,3170030,6000;128025;23596;1131;200150;8564;2271;9156;1122;440738;56776;64388;441925,13
1,1,1,239781260,249224684,9443424,127077;25909;200150;200159;127069;84288;51029;391196;81469;55083;127623;343173;127064;26246;79894;391189;441925;441932;401993;6000;10472;57116;80851;79862;23596;1131;267002;343563;317705;391195;26245;114548;26188;403239;159;163882;391211;284521;343169;128025;84838;391194;3192;9156;93474;1122;127074;8564;81472;127066;127068;646627;391190;64388;388759;441933;403244;343172;25893;7678;284532;10000;2271;26696;55657;391191;64754;81466;127059;127062;10806;401992;343171;254879;116228;257044;9859;81470;148823;64216;440738;56776;401994;391192;51097,85
-1,1,1,240620284,247690417,7070133,128025;84838;25909;200150;200159;3192;9156;93474;1122;84288;8564;64388;388759;51029;55083;127623;7678;10000;2271;441925;64754;441932;6000;10472;57116;79862;23596;10806;317705;163882;116228;114548;257044;9859;148823;159;440738;56776;64216;51097,40
-1,1,1,240628422,249212668,8584246,127077;25909;200150;200159;127069;84288;51029;391196;81469;55083;127623;343173;127064;26246;79894;391189;441925;441932;401993;6000;10472;57116;80851;79862;23596;267002;343563;317705;391195;26245;114548;26188;403239;159;163882;391211;284521;343169;128025;84838;391194;3192;9156;93474;1122;127074;8564;81472;127066;127068;646627;391190;64388;388759;441933;403244;343172;25893;7678;284532;10000;2271;26696;55657;391191;64754;81466;127059;127062;10806;401992;343171;254879;116228;257044;9859;81470;148823;64216;440738;56776;401994;391192;51097,84
-1,1,1,241094652,246670839,5576187,6000;128025;10472;23596;200150;200159;3192;9156;1122;84288;10806;8564;51029;55083;116228;257044;9859;10000;2271;159;440738;441925;64754,23
-1,1,1,241601964,249224684,7622720,127077;25909;200150;200159;127069;84288;51029;391196;81469;55083;127623;343173;127064;26246;79894;391189;441925;441932;401993;10472;57116;80851;79862;23596;267002;343563;317705;391195;26245;114548;26188;403239;159;163882;391211;284521;343169;128025;84838;391194;3192;9156;93474;1122;127074;8564;81472;127066;127068;646627;391190;388759;343172;441933;403244;25893;7678;284532;10000;2271;26696;55657;391191;64754;81466;127059;127062;10806;401992;343171;254879;116228;257044;9859;81470;148823;64216;440738;401994;391192;51097,81
1,1,1,241788417,245617084,3828667,128025;10472;23596;200150;200159;3192;9156;1122;84288;10806;51029;55083;116228;257044;9859;10000;159;440738;441925,19
-1,1,1,242208581,249224684,7016103,127077;25909;200150;200159;127069;84288;51029;81469;391196;55083;127623;343173;127064;26246;391189;79894;441932;401993;10472;57116;80851;79862;267002;343563;317705;391195;26245;114548;26188;159;284521;163882;391211;343169;84838;391194;3192;93474;127074;81472;127066;388759;127068;646627;343172;25893;391190;441933;403244;7678;284532;10000;26696;55657;391191;64754;81466;127059;127062;10806;401992;343171;254879;116228;257044;9859;81470;148823;64216;403239;401994;391192;51097,73
1,1,1,242656460,249213000,6556540,127077;25909;200150;200159;127069;84288;51029;81469;391196;55083;127623;343173;127064;26246;391189;79894;441932;401993;10472;57116;80851;79862;267002;343563;317705;391195;26245;114548;26188;159;284521;163882;391211;343169;84838;391194;3192;93474;127074;81472;127066;388759;127068;646627;343172;25893;391190;441933;403244;7678;284532;10000;26696;55657;391191;64754;81466;127059;127062;10806;401992;343171;254879;116228;257044;9859;81470;148823;64216;403239;401994;391192;51097,73
1,1,1,243095878,249158835,6062957,127077;25909;200159;127069;84288;51029;81469;391196;55083;127623;343173;127064;26246;391189;79894;441932;401993;10472;57116;80851;79862;343563;317705;391195;26245;114548;26188;159;284521;163882;391211;343169;84838;391194;3192;93474;127074;81472;127066;388759;127068;646627;343172;25893;391190;441933;403244;7678;284532;10000;26696;55657;391191;64754;81466;127059;127062;10806;401992;343171;254879;116228;257044;9859;81470;148823;64216;403239;401994;391192;51097,71
-1,1,1,243393248,243774475,381227,10806;9859;10000,3
-1,1,1,243427494,244831765,1404271,10472;257044;10000;200159;10806;159;51029,7
-1,1,1,243477620,249233096,5755476,127077;25909;200159;127069;84288;51029;81469;391196;55083;127623;343173;127064;26246;391189;79894;441932;401993;10472;57116;80851;79862;267002;343563;317705;391195;26245;114548;26188;159;284521;163882;391211;343169;84838;391194;3192;93474;127074;81472;127066;388759;127068;646627;343172;25893;391190;441933;403244;7678;284532;10000;26696;55657;391191;64754;81466;127059;127062;10806;401992;343171;254879;116228;257044;81470;148823;64216;403239;401994;391192;51097,71
-1,1,1,243681404,244812435,1131031,200159;10472;159;257044;10000,5
1,-1,1,243684045,243694734,10689,10000,1
1,-1,1,243684045,243694734,10689,10000,1
1,-1,1,243684045,243694734,10689,10000,1
1,-1,1,243684045,243694734,10689,10000,1
1,-1,1,243684045,243694734,10689,10000,1
-1,1,1,243949931,244033798,83867,10000,1
-1,1,1,244385524,246707775,2322251,55083;116228;257044;200159;3192;159;84288;64216;64754;51029,10
-1,1,1,244517415,246324760,1807345,55083;116228;257044;51029;200159;3192;159;84288;64754,9
-1,1,1,244745425,249212668,4467243,127077;25909;127069;84288;51029;81469;391196;55083;127623;343173;127064;26246;391189;79894;441932;401993;57116;80851;79862;267002;343563;317705;391195;26245;114548;26188;284521;163882;391211;343169;84838;391194;3192;93474;127074;81472;127066;388759;127068;646627;343172;25893;391190;441933;403244;7678;284532;26696;55657;391191;64754;81466;127059;127062;401992;343171;254879;116228;257044;81470;148823;64216;403239;401994;391192;51097,66
1,-1,1,245151901,245665521,513620,55083;84288,2
1,1,1,245476117,249212668,3736551,127077;84838;391194;25909;127069;93474;127074;81472;127066;388759;127068;646627;343172;81469;25893;55083;441933;391190;391196;403244;127623;343173;7678;284532;343169;127064;26246;391189;79894;26696;55657;391191;64754;441932;401993;81466;127059;127062;57116;80851;79862;267002;343563;317705;391195;26245;343171;401992;254879;163882;114548;26188;81470;148823;64216;403239;284521;391211;401994;391192;51097,61
1,1,1,245665463,249233096,3567633,127077;84838;391194;25909;127069;93474;127074;81472;127066;388759;127068;646627;343172;81469;25893;55083;441933;391190;391196;403244;127623;343173;7678;284532;343169;127064;26246;391189;79894;26696;55657;391191;64754;441932;401993;81466;127059;127062;57116;80851;79862;267002;343563;317705;391195;26245;343171;401992;254879;163882;114548;26188;81470;148823;64216;403239;284521;391211;401994;391192;51097,61
1,-1,1,245747724,246655416,907692,55083;64754,2
-1,-1,1,246501633,246579174,77541,64754,1
-1,-1,1,247200511,247264759,64248,93474;79862,2
1,-1,1,247695693,248060419,364726,343171;441933;284532;26188;391189;81470;148823;81469;81472;343169;25893,11
1,-1,1,247776410,248256864,480454,343171;441933;81466;284532;26188;391192;26246;391189;343172;284521;391190;391191;343169;25893,14
1,-1,1,247776537,248684891,908354,401993;81466;127059;127062;391194;391192;127074;127066;343172;391190;25893;441933;391196;391195;26245;343171;401992;254879;343173;284532;26188;127064;26246;391189;284521;26696;391191;343169,28
1,-1,1,247834885,248480750,645865,81466;127059;127062;391194;391192;343172;391190;25893;441933;391195;26245;343171;284532;26188;127064;26246;391189;284521;391191;343169,20
1,-1,1,247846231,248256998,410767,343171;81466;284532;26188;391192;26246;391189;343172;284521;391190;391191;343169;25893,13
1,-1,1,247846231,248256998,410767,343171;81466;284532;26188;391192;26246;391189;343172;284521;391190;391191;343169;25893,13
1,-1,1,247846231,248256998,410767,343171;81466;284532;26188;391192;26246;391189;343172;284521;391190;391191;343169;25893,13
1,-1,1,247846231,248256998,410767,343171;81466;284532;26188;391192;26246;391189;343172;284521;391190;391191;343169;25893,13
1,-1,1,247846231,248256998,410767,343171;81466;284532;26188;391192;26246;391189;343172;284521;391190;391191;343169;25893,13
1,-1,1,247846231,248684891,838660,401993;81466;127059;127062;391194;391192;127074;127066;343172;391190;25893;391196;391195;26245;343171;401992;254879;343173;284532;26188;127064;26246;391189;284521;26696;391191;343169,27
1,-1,1,247846231,248785598,939367,401993;81466;127059;127062;391194;391192;127069;127074;343563;127066;127068;343172;391190;25893;391196;391195;26245;343171;401992;254879;343173;284532;26188;127064;26246;391189;284521;391211;26696;391191;343169,31
1,-1,1,247846233,248256864,410631,343171;81466;284532;26188;391192;26246;391189;343172;284521;391190;391191;343169;25893,13
1,-1,1,247846233,248256864,410631,343171;81466;284532;26188;391192;26246;391189;343172;284521;391190;391191;343169;25893,13
1,-1,1,247879926,248278070,398144,343171;81466;284532;26188;391192;26246;391189;284521;391190;391191;343172;25893,12
1,-1,1,247879926,248278070,398144,343171;81466;284532;26188;391192;26246;391189;284521;391190;391191;343172;25893,12
1,-1,1,247962269,248260734,298465,343171;81466;284532;391192;26246;391189;284521;391190;391191;343172;25893,11
1,-1,1,247962269,248260734,298465,343171;81466;284532;391192;26246;391189;284521;391190;391191;343172;25893,11
1,-1,1,247962269,248684909,722640,401993;81466;127059;127062;391194;127074;127066;391196;391190;343172;25893;391195;26245;343171;401992;254879;343173;284532;127064;26246;391189;284521;26696;391191;391192,25
1,-1,1,248033647,248034322,675,25893,1
1,-1,1,248093829,248785562,691733,401993;81466;127059;127062;391194;127069;127074;343563;127066;127068;391196;391190;391195;401992;26245;254879;343173;127064;26246;284521;391211;26696;391191;391192,24
-1,-1,1,248158939,248205955,47016,284521;81466;26246,3
-1,-1,1,248291569,248339940,48371,127059,1
1,-1,1,248291569,248339940,48371,127059,1
-1,-1,1,248291569,248339940,48371,127059,1
-1,-1,1,248301479,248480750,179271,391195;127062;127059;391194;127064;26245,6
1,-1,1,248339970,248569417,229447,254879;391196;127062;391194;127064;127074;127066;26696;391195;26245,10
-1,-1,1,248339973,248563858,223885,254879;391196;127062;391194;127064;127074;127066;391195;26245,9
1,-1,1,248414258,249081340,667082,401993;127077;127069;127074;343563;127066;127068;646627;391196;401992;391195;403244;254879;343173;127064;403239;391211;26696;401994,19
1,-1,1,248563799,248861875,298076,401993;403244;127077;343173;127069;403239;343563;391211;26696;127068;401994;401992,12
-1,-1,1,248727929,248785533,57604,127069;127068,2
-1,-1,1,248727929,248792227,64298,127069;127068;127077,3
-1,-1,1,248756245,248792227,35982,127069;127077,2
-1,-1,1,248756245,248792227,35982,127069;127077,2
1,-1,1,248862205,248901720,39515,,0
1,-1,1,248862205,248901720,39515,,0
1,-1,1,248862205,248901720,39515,,0
1,-1,1,248862205,249113356,251151,80851;646627,2
1,-1,1,249098884,249189747,90863,80851;55657;79894,3
1,-1,1,249104658,249139858,35200,80851;79894,2
-1,1,2,12770,2752444,2739674,7837;23040;642273;7173;54221;26751;285016;129787;52,9
1,1,2,12770,20081474,20068704,9270;129642;54221;285148;100526794;348654;51692;55256;4613;7173;10971;81553;57665;129787;8853;51112;26751;285016;78989;51594;9475;9687;79677;129607;28951;4953;151354;130497;3398;9014;79954;10408;245973;91543;23175;52;6664;9781;57498;7447;93034;130813;1653;6241;642273;10130;1876;246243;23620;192668;7837;23040;343930;348738;8462;7260;3241;729475;55821;6201;29841;3754;728597;3790;6868;130814,66
1,1,2,12770,25262563,25249793,9270;114818;129642;54221;285148;100526794;64342;375190;348654;51692;9741;55256;6382;54454;4613;7173;10971;60526;81553;57665;129787;8853;100129278;51112;26751;285016;130502;78989;51594;9475;151449;9687;391356;338;79677;129607;28951;130497;4953;151354;9014;3398;79954;10408;245973;51639;91543;52;23175;6664;375189;9781;7447;57498;93034;130813;9540;109;1653;6241;642273;23369;80304;10130;1876;246243;23620;388931;192668;653140;7837;23040;388;343930;348738;8462;7260;3241;729475;8648;79172;57539;55821;165324;6201;29841;4148;3754;2281;728597;51277;3790;6868;130814;50618,95
1,1,2,12770,33936576,33923806,388939;114818;54221;285148;100526794;375190;348654;51692;55256;6382;54454;6716;339778;3777;4613;200634;10971;9577;9784;57665;92749;11321;3797;129787;8853;3032;1058;51112;339779;8890;22950;51374;130502;78989;22924;338;79677;129607;28951;9014;30845;7349;8884;64838;51639;9913;52;1788;9781;23160;58484;109;253558;54978;23369;80304;150921;790;85465;2976;84226;10890;23620;2646;7837;23040;55622;165082;343930;5443;84450;238;57448;348738;8462;7260;3241;729475;440854;1838;4052;51646;165324;6201;4148;2281;728597;130106;11117;57159;54867;3790;84661;130814;50618;9270;5500;7781;129642;64342;9741;165186;9553;151056;55676;55252;7173;60526;81553;79635;56896;84696;100129278;22979;130557;26751;285016;6683;51594;4358;9475;151449;9687;25940;3795;391356;130497;4953;151354;26160;3398;79954;10408;245973;91543;23175;6664;375189;92291;7447;57498;150946;93034;100128731;79745;5496;130813;9540;10669;1653;6241;245711;642273;79623;10130;1876;51072;29959;246243;2355;388931;192668;653140;81606;84272;388;8648;79172;57539;55821;64080;60509;29841;3754;285126;25780;7498;9381;51277;6868;55006;10113;3030,183
1,1,2,12771,242783384,242770613,150684;6335;151258;6694;6382;84865;3777;284996;3234;130916;200634;389058;9541;129787;8853;6670;1058;1386;339779;64965;408029;23233;7277;6574;84279;80255;80146;100271715;130340;10578;3329;9781;23160;29842;55759;375287;200734;6160;9360;1286;347730;26504;55571;84140;200539;6936;80705;7852;23177;547;55054;7141;55622;165082;55686;165530;238;4072;220988;2820;348738;471;344387;2202;130106;8802;9936;8708;4999;7035;50618;6364;84173;84639;55252;65065;7173;60482;7444;8809;1674;55289;100129278;51449;8324;6295;285180;2956;653275;130399;10787;391356;130497;26160;64844;9595;51719;10438;151230;10408;165215;116093;391475;10123;11017;1653;151112;785;92737;130560;518;375318;3577;729540;65062;150572;55997;285175;164781;55355;84365;58190;11138;130752;3754;2019;25780;9381;22868;3557;5163;284992;1420;151278;9320;250;79853;27436;25972;10575;54891;3553;5136;170850;1716;57223;339778;64225;580;7857;2863;10971;1412;79083;5967;3176;3032;286749;80059;91409;8890;29789;84693;119;285051;1781;2825;10494;129607;129881;55437;7849;5093;25791;9378;50649;65080;29926;130940;130132;4436;51776;51141;60491;58484;1593;5968;84058;83444;23369;130026;2817;1421;51455;2976;79828;3336;23020;3549;10602;51232;274;1195;7145;343930;646915;84450;7260;440854;51646;80055;116255;2487;27013;130367;84661;3099;3694;389084;10322;728294;129446;7840;129642;23505;55683;100526664;130120;64708;3238;100526832;3267;2859;165186;64284;55676;64895;10267;60526;26122;81553;6556;51318;22979;2181;26751;805;10936;51594;7039;402117;56902;25940;55041;391365;7247;4430;91543;23175;1768;200523;3357;7447;57498;9801;29094;55777;79901;165100;3300;9427;80704;130813;64427;57730;57703;5861;150696;51072;10130;925;27179;246243;1745;653192;92691;130576;27247;1639;79172;841;60509;11069;8869;51277;10113;130617;150590;4084;1281;84289;3623;100526794;29798;55660;388962;11037;84812;10316;83879;9577;57665;3797;80034;79800;8808;29994;151188;55230;493753;129531;2274;10170;64320;2335;23550;5966;5757;338;130271;57471;9014;8575;200407;254773;6323;53353;10324;9581;51239;8807;377007;285190;6233;54910;165257;3987;30061;85465;22930;10890;9839;4632;2736;58538;79919;23040;375316;5443;23498;3241;6741;1803;2840;9874;90957;150726;25843;525;151306;6439;11249;3235;151176;56300;25806;26003;57683;51602;10314;8647;4760;84620;9741;80775;26010;1329;6168;79635;57669;617;7429;80731;84083;54659;3196;30818;653489;27347;5194;653781;10865;64859;151246;8609;55854;151354;79595;79954;5147;10199;200424;55677;142679;79843;25801;51601;23671;285172;5496;57007;151525;65055;129401;1876;63892;51540;54529;10574;80067;81606;2677;389073;55818;11320;57162;57282;6672;57539;55821;130733;1844;653784;57624;7498;10797;3554;6549;55006;3030;9855;388939;54658;9173;344191;678;54221;9637;84542;9168;150737;53632;388946;55825;25885;442038;57574;54579;80856;66037;55627;100131390;23451;285141;57140;8446;114880;22950;84141;54657;2637;92935;29081;54738;129804;10096;117581;3485;1146;51130;64838;3628;22807;51639;3685;79031;79998;1622;200728;129530;80122;8520;4735;72;23620;51057;116987;112714;339804;3769;3233;100529241;116372;5775;9391;51252;10461;11117;401027;666;8440;4118;285025;51542;79586;3790;130814;55577;653437;64090;554251;57628;8452;96626;6775;57504;100526767;57404;130612;57679;130013;653269;51078;10128;6772;150709;130589;1746;9687;54576;50489;200373;344561;8864;9689;5581;130872;2660;130535;80309;23178;727851;55654;375189;92291;8941;400954;84172;205147;27249;3488;79823;130355;129521;27233;245711;7701;29959;27177;316;100652824;653140;10791;57818;57181;9451;84695;64682;375307;6519;1796;5534;3344;55037;307;1493;114818;129831;1285;56171;79582;285148;51661;5000;51652;8576;9784;150681;150483;92749;11321;2641;151050;5334;25953;200504;80097;51112;248;130162;91752;9208;10913;51374;64114;8491;79634;4211;84913;10018;1419;81618;27302;54575;27248;285193;84220;80326;100130451;1123;6120;1261;843;8837;5510;728819;150472;79712;255101;56603;4705;9736;9392;150677;4719;253558;23549;646960;22837;151516;200558;84226;92104;84524;8527;2646;7837;94097;5342;65124;8462;1838;84759;92196;4148;55471;2281;389075;3800;5077;3625;10254;5610;6819;100288695;10887;54842;10618;9419;4780;9553;5798;57590;26525;8828;2888;2168;79781;129880;56475;10056;151449;55183;344148;1134;93349;3398;6654;26225;7535;7514;57835;431705;151011;9448;3431;7130;64241;51665;257407;10669;7072;253782;10120;22934;6326;165140;130574;4691;2355;5281;10651;11036;494143;65061;55233;51052;151254;1418;10058;79054;3938;87178;285126;343990;4144;23332;7475;11262;9470;65977;7273;4065;130540;84269;129450;55256;6716;729967;2492;5624;6711;100144595;54578;4709;376940;84804;10213;25992;5068;3635;3667;130502;22924;66008;55240;23192;388963;56918;150465;79677;84874;91461;30845;659;7349;3631;9913;344167;8886;23198;9167;164832;344558;7520;1545;109;4759;14;140469;140739;5212;101929926;150921;1615;55704;790;57405;400961;54497;130074;23704;6496;445582;57448;7851;4052;54600;3655;2071;85461;728597;1961;8942;10678;151295;54812;129303;8673;7781;4880;130749;90411;130507;64342;11250;339768;25927;84910;26058;389072;731220;56655;189;84696;3237;140738;375298;55619;11132;285016;112942;117583;8436;2043;493911;3973;55137;54577;339761;151242;4953;10153;4664;92906;90423;6242;23683;10617;245973;8604;6664;4249;10920;80219;79745;1841;81615;10713;54520;10505;57695;699;6697;6344;200765;905;56947;23559;2016;11159;113457;2571;25797;55022;57142;388;150763;6744;65059;7844;8648;5455;4648;10152;29841;375248;10290;83439;79833;729857;728378;9655;375190;51692;54454;3760;79065;4613;93010;23363;84168;165545;10190;50485;78989;57520;5270;1933;8291;28951;6546;8884;129852;52;1788;1385;5903;151393;23677;388969;92;2744;84236;7850;6328;100131211;344018;55843;3236;84084;2034;151313;6869;80304;84417;100996693;150771;10746;339766;129684;33;9111;6432;5013;7360;79137;3231;9330;5746;3579;6201;130888;10736;9270;5500;4190;9262;3417;79411;8685;9792;56886;388951;3232;9669;53938;84908;84281;10109;3899;2591;151056;129285;4036;5495;26056;254042;200576;50940;6683;129868;55139;4358;64795;55258;3795;114805;55502;6332;26275;9290;26146;79134;114793;5707;80895;4175;80745;150946;93034;91526;9540;129807;23397;642273;51315;9027;79675;27332;92856;200350;5343;10477;56287;400966;51011;114800;926;822;7855;64080;27429;80210;8745;84317;85474;56660;83607;389015;56888;7456;7549;26154;5433;90;348654;5899;23301;54465;130827;10010;339745;2995;64395;84128;27148;400986;129293;253635;6801;51454;151195;151556;8540;150962;8502;100302652;2066;389090;91404;5341;23314;1373;1290;3069;29851;55133;51255;116540;9654;151473;54978;150678;151126;6509;401036;284948;9486;79568;165055;27178;390;7841;81562;205327;116143;55339;150864;150786;90134;100505876;51002;4528;150468;51263;729475;2673;64240;165324;6508;5937;54980;94101;57159;7341;5378;22848;1496;54867;3676;54431;9938;23190;4867;9125;10716;56910;10203;114790;90342;26505;55120;22925;494513;414061;3552;56896;1144;9759;129563;4703;9394;11227;113419;130557;10097;9475;98;4862;64135;151531;80303;400950;79840;1293;200726;115677;80204;130951;940;151194;100128731;550;344022;53335;6241;90557;55515;151;79623;23518;23433;54884;79074;6637;4929;388931;84826;192668;84272;251;64969;51626;79809;3239;57217;10989;64172;2191;200403;55679;388960;93082;4133;51281;26469;9648;6868;50636,1210
1,1,2,12771,242783384,242770613,150684;6335;151258;6694;6382;84865;3777;284996;3234;130916;200634;389058;9541;129787;8853;6670;1058;1386;339779;64965;408029;23233;7277;6574;84279;80255;80146;100271715;130340;10578;3329;9781;23160;29842;55759;375287;200734;6160;9360;1286;347730;26504;55571;84140;200539;6936;80705;7852;23177;547;55054;7141;55622;165082;55686;165530;238;4072;220988;2820;348738;471;344387;2202;130106;8802;9936;8708;4999;7035;50618;6364;84173;84639;55252;65065;7173;60482;7444;8809;1674;55289;100129278;51449;8324;6295;285180;2956;653275;130399;10787;391356;130497;26160;64844;9595;51719;10438;151230;10408;165215;116093;391475;10123;11017;1653;151112;785;92737;130560;518;375318;3577;729540;65062;150572;55997;285175;164781;55355;84365;58190;11138;130752;3754;2019;25780;9381;22868;3557;5163;284992;1420;151278;9320;250;79853;27436;25972;10575;54891;3553;5136;170850;1716;57223;339778;64225;580;7857;2863;10971;1412;79083;5967;3176;3032;286749;80059;91409;8890;29789;84693;119;285051;1781;2825;10494;129607;129881;55437;7849;5093;25791;9378;50649;65080;29926;130940;130132;4436;51776;51141;60491;58484;1593;5968;84058;83444;23369;130026;2817;1421;51455;2976;79828;3336;23020;3549;10602;51232;274;1195;7145;343930;646915;84450;7260;440854;51646;80055;116255;2487;27013;130367;84661;3099;3694;389084;10322;728294;129446;7840;129642;23505;55683;100526664;130120;64708;3238;100526832;3267;2859;165186;64284;55676;64895;10267;60526;26122;81553;6556;51318;22979;2181;26751;805;10936;51594;7039;402117;56902;25940;55041;391365;7247;4430;91543;23175;1768;200523;3357;7447;57498;9801;29094;55777;79901;165100;3300;9427;80704;130813;64427;57730;57703;5861;150696;51072;10130;925;27179;246243;1745;653192;92691;130576;27247;1639;79172;841;60509;11069;8869;51277;10113;130617;150590;4084;1281;84289;3623;100526794;29798;55660;388962;11037;84812;10316;83879;9577;57665;3797;80034;79800;8808;29994;151188;55230;493753;129531;2274;10170;64320;2335;23550;5966;5757;338;130271;57471;9014;8575;200407;254773;6323;53353;10324;9581;51239;8807;377007;285190;6233;54910;165257;3987;30061;85465;22930;10890;9839;4632;2736;58538;79919;23040;375316;5443;23498;3241;6741;1803;2840;9874;90957;150726;25843;525;151306;6439;11249;3235;151176;56300;25806;26003;57683;51602;10314;8647;4760;84620;9741;80775;26010;1329;6168;79635;57669;617;7429;80731;84083;54659;3196;30818;653489;27347;5194;653781;10865;64859;151246;8609;55854;151354;79595;79954;5147;10199;200424;55677;142679;79843;25801;51601;23671;285172;5496;57007;151525;65055;129401;1876;63892;51540;54529;10574;80067;81606;2677;389073;55818;11320;57162;57282;6672;57539;55821;130733;1844;653784;57624;7498;10797;3554;6549;55006;3030;9855;388939;54658;9173;344191;678;54221;9637;84542;9168;150737;53632;388946;55825;25885;442038;57574;54579;80856;66037;55627;100131390;23451;285141;57140;8446;114880;22950;84141;54657;2637;92935;29081;54738;129804;10096;117581;3485;1146;51130;64838;3628;22807;51639;3685;79031;79998;1622;200728;129530;80122;8520;4735;72;23620;51057;116987;112714;339804;3769;3233;100529241;116372;5775;9391;51252;10461;11117;401027;666;8440;4118;285025;51542;79586;3790;130814;55577;653437;64090;554251;57628;8452;96626;6775;57504;100526767;57404;130612;57679;130013;653269;51078;10128;6772;150709;130589;1746;9687;54576;50489;200373;344561;8864;9689;5581;130872;2660;130535;80309;23178;727851;55654;375189;92291;8941;400954;84172;205147;27249;3488;79823;130355;129521;27233;245711;7701;29959;27177;316;100652824;653140;10791;57818;57181;9451;84695;64682;375307;6519;1796;5534;3344;55037;307;1493;114818;129831;1285;56171;79582;285148;51661;5000;51652;8576;9784;150681;150483;92749;11321;2641;151050;5334;25953;200504;80097;51112;248;130162;91752;9208;10913;51374;64114;8491;79634;4211;84913;10018;1419;81618;27302;54575;27248;285193;84220;80326;100130451;1123;6120;1261;843;8837;5510;728819;150472;79712;255101;56603;4705;9736;9392;150677;4719;253558;23549;646960;22837;151516;200558;84226;92104;84524;8527;2646;7837;94097;5342;65124;8462;1838;84759;92196;4148;55471;2281;389075;3800;5077;3625;10254;5610;6819;100288695;10887;54842;10618;9419;4780;9553;5798;57590;26525;8828;2888;2168;79781;129880;56475;10056;151449;55183;344148;1134;93349;3398;6654;26225;7535;7514;57835;431705;151011;9448;3431;7130;64241;51665;257407;10669;7072;253782;10120;22934;6326;165140;130574;4691;2355;5281;10651;11036;494143;65061;55233;51052;151254;1418;10058;79054;3938;87178;285126;343990;4144;23332;7475;11262;9470;65977;7273;4065;130540;84269;129450;55256;6716;729967;2492;5624;6711;100144595;54578;4709;376940;84804;10213;25992;5068;3635;3667;130502;22924;66008;55240;23192;388963;56918;150465;79677;84874;91461;30845;659;7349;3631;9913;344167;8886;23198;9167;164832;344558;7520;1545;109;4759;14;140469;140739;5212;101929926;150921;1615;55704;790;57405;400961;54497;130074;23704;6496;445582;57448;7851;4052;54600;3655;2071;85461;728597;1961;8942;10678;151295;54812;129303;8673;7781;4880;130749;90411;130507;64342;11250;339768;25927;84910;26058;389072;731220;56655;189;84696;3237;140738;375298;55619;11132;285016;112942;117583;8436;2043;493911;3973;55137;54577;339761;151242;4953;10153;4664;92906;90423;6242;23683;10617;245973;8604;6664;4249;10920;80219;79745;1841;81615;10713;54520;10505;57695;699;6697;6344;200765;905;56947;23559;2016;11159;113457;2571;25797;55022;57142;388;150763;6744;65059;7844;8648;5455;4648;10152;29841;375248;10290;83439;79833;729857;728378;9655;375190;51692;54454;3760;79065;4613;93010;23363;84168;165545;10190;50485;78989;57520;5270;1933;8291;28951;6546;8884;129852;52;1788;1385;5903;151393;23677;388969;92;2744;84236;7850;6328;100131211;344018;55843;3236;84084;2034;151313;6869;80304;84417;100996693;150771;10746;339766;129684;33;9111;6432;5013;7360;79137;3231;9330;5746;3579;6201;130888;10736;9270;5500;4190;9262;3417;79411;8685;9792;56886;388951;3232;9669;53938;84908;84281;10109;3899;2591;151056;129285;4036;5495;26056;254042;200576;50940;6683;129868;55139;4358;64795;55258;3795;114805;55502;6332;26275;9290;26146;79134;114793;5707;80895;4175;80745;150946;93034;91526;9540;129807;23397;642273;51315;9027;79675;27332;92856;200350;5343;10477;56287;400966;51011;114800;926;822;7855;64080;27429;80210;8745;84317;85474;56660;83607;389015;56888;7456;7549;26154;5433;90;348654;5899;23301;54465;130827;10010;339745;2995;64395;84128;27148;400986;129293;253635;6801;51454;151195;151556;8540;150962;8502;100302652;2066;389090;91404;5341;23314;1373;1290;3069;29851;55133;51255;116540;9654;151473;54978;150678;151126;6509;401036;284948;9486;79568;165055;27178;390;7841;81562;205327;116143;55339;150864;150786;90134;100505876;51002;4528;150468;51263;729475;2673;64240;165324;6508;5937;54980;94101;57159;7341;5378;22848;1496;54867;3676;54431;9938;23190;4867;9125;10716;56910;10203;114790;90342;26505;55120;22925;494513;414061;3552;56896;1144;9759;129563;4703;9394;11227;113419;130557;10097;9475;98;4862;64135;151531;80303;400950;79840;1293;200726;115677;80204;130951;940;151194;100128731;550;344022;53335;6241;90557;55515;151;79623;23518;23433;54884;79074;6637;4929;388931;84826;192668;84272;251;64969;51626;79809;3239;57217;10989;64172;2191;200403;55679;388960;93082;4133;51281;26469;9648;6868;50636,1210
-1,1,2,17019,2309039,2292020,7837;23040;642273;7173;54221;26751;285016;129787;52,9
1,1,2,17019,20200817,20183798,9270;129642;54221;285148;100526794;348654;51692;55256;4613;7173;10971;81553;57665;129787;8853;51112;26751;285016;130502;78989;51594;9475;9687;79677;129607;28951;4953;151354;130497;3398;9014;79954;10408;245973;91543;23175;52;6664;9781;57498;7447;93034;130813;1653;6241;642273;10130;1876;246243;23620;192668;7837;23040;343930;348738;8462;7260;3241;729475;57539;55821;6201;29841;4148;3754;728597;3790;6868;130814,69
1,1,2,17019,26541714,26524695,9270;114818;129642;54221;285148;100526794;64342;375190;348654;51692;9741;55256;6382;54454;3030;4613;55252;7173;10971;60526;81553;57665;3797;129787;8853;3032;100129278;51112;22979;26751;285016;130502;78989;51594;9475;151449;9687;391356;338;79677;129607;28951;130497;4953;151354;9014;3398;79954;10408;245973;51639;91543;52;1788;23175;6664;375189;9781;7447;57498;150946;93034;130813;9540;109;1653;6241;642273;23369;80304;10130;1876;10890;246243;23620;388931;192668;653140;7837;23040;388;165082;343930;5443;348738;8462;7260;3241;729475;8648;1838;79172;57539;55821;165324;6201;29841;4148;3754;2281;728597;51277;3790;6868;130814;50618,106
1,-1,2,24400,57011,32611,642273,1
1,1,2,24400,813454,789054,642273;52;129787;26751;285016,5
1,-1,2,30341,84728,54387,642273,1
1,-1,2,30341,84728,54387,642273,1
-1,1,2,30341,1973174,1942833,7837;23040;642273;7173;54221;26751;285016;129787;52,9
-1,1,2,30341,2659911,2629570,7837;23040;642273;7173;54221;26751;285016;129787;52,9
-1,1,2,30341,3452903,3422562,7837;23040;642273;51112;7173;54221;26751;285016;7260;129787;52,11
1,1,2,30341,4689989,4659648,7837;23040;51112;54221;26751;285016;7260;78989;55821;55256;6201;642273;728597;7173;246243;129787;52,17
1,1,2,30341,4979949,4949608,7837;23040;51112;54221;26751;285016;7260;78989;55821;55256;6201;642273;728597;7173;246243;129787;52,17
1,1,2,30341,28642531,28612190,114818;54221;285148;100526794;375190;348654;51692;55256;6382;54454;339778;3777;4613;200634;10971;9577;9784;57665;92749;11321;3797;129787;8853;3032;1058;51112;339779;8890;22950;51374;130502;78989;22924;338;79677;129607;28951;9014;7349;8884;64838;51639;9913;52;1788;9781;109;54978;23369;80304;150921;790;85465;2976;84226;10890;23620;2646;7837;23040;165082;343930;5443;84450;348738;8462;7260;3241;729475;1838;165324;6201;4148;2281;728597;130106;11117;57159;54867;3790;130814;50618;9270;7781;129642;64342;9741;9553;55252;7173;60526;81553;79635;56896;84696;100129278;22979;130557;26751;285016;51594;4358;9475;151449;9687;3795;391356;130497;4953;151354;26160;3398;79954;10408;245973;91543;23175;6664;375189;7447;57498;150946;93034;100128731;5496;130813;9540;10669;1653;6241;642273;10130;1876;29959;246243;2355;388931;192668;653140;388;8648;79172;57539;55821;64080;60509;29841;3754;285126;9381;51277;6868;10113;3030,154
-1,1,2,39193,1546506,1507313,642273;129787;52;7173;54221;26751;285016,7
-1,-1,2,84669,206271,121602,,0
-1,-1,2,84669,206271,121602,,0
-1,-1,2,84669,206271,121602,,0
-1,1,2,131730,2717289,2585559,7837;23040;7173;54221;26751;285016;129787;52,8
-1,-1,2,134623,172636,38013,,0
1,-1,2,153031,252990,99959,26751,1
1,-1,2,153031,252990,99959,26751,1
1,1,2,236816,46210371,45973555,388939;114818;27436;79833;678;54221;285148;100526794;9637;375190;348654;51692;170850;55256;6382;54454;6716;339778;3777;64225;729967;4613;200634;10971;9577;9784;57665;92749;11321;3797;129787;8853;3032;1058;6801;253635;51112;339779;8890;22950;51374;8491;130502;78989;22924;338;79677;129607;130271;28951;6546;9014;91461;30845;100271715;7349;8884;55133;64838;51639;9913;52;1788;9781;9167;151393;23160;9581;728819;58484;1545;109;253558;54978;23369;80304;5212;150921;790;85465;2976;84226;10890;23620;10602;51232;54497;2646;7837;23040;55622;6432;165082;343930;6496;5443;84450;238;57448;100505876;348738;23498;8462;7260;3241;729475;440854;1838;4052;51646;165324;64240;344387;6201;4148;55471;2281;728597;130106;11117;57159;54867;10736;90957;3790;84661;130814;50618;9270;5500;5610;7781;129642;64342;9741;57504;165186;9553;151056;55676;55252;7173;60526;81553;79635;5495;56896;84696;10128;100129278;22979;130589;130557;26751;6683;285016;51594;4358;9475;151449;9687;25940;3795;391365;391356;130497;4953;151354;26160;3398;10153;92906;6654;79954;10408;23683;5581;245973;400950;91543;23175;6664;375189;92291;7447;57498;80745;64241;150946;93034;100128731;79745;5496;130813;9540;10669;79823;1653;6241;245711;165140;79623;10130;1876;51072;63892;29959;246243;2355;388931;25797;192668;653140;81606;84272;51626;388;8648;79172;57539;55821;130733;64080;60509;29841;3754;285126;25780;7498;6519;9381;51277;6868;55006;10113;3030,236
1,-1,2,331045,844989,513944,129787,1
1,-1,2,330817,938774,607957,129787,1
1,-1,2,383231,721431,338200,129787,1
1,-1,2,622175,1106638,484463,129787;54221,2
1,-1,2,844940,1106638,261698,54221,1
1,-1,2,883836,1495173,611337,7173;54221,2
1,-1,2,1442042,1507882,65840,7173,1
1,1,2,1668387,23887012,22218625,9270;114818;129642;285148;100526794;64342;348654;51692;9741;55256;6382;4613;10971;60526;81553;57665;8853;100129278;51112;130502;78989;51594;9475;151449;9687;338;79677;129607;28951;4953;151354;130497;3398;9014;79954;10408;245973;91543;23175;6664;9781;57498;7447;93034;130813;1653;6241;23369;10130;1876;246243;23620;192668;7837;23040;388;343930;348738;8462;7260;3241;729475;57539;55821;6201;29841;4148;3754;728597;3790;6868;130814,72
1,-1,2,1788489,2309039,520550,23040,1
1,-1,2,4881726,5058788,177062,,0
1,-1,2,7635254,88005418,80370164,307;150684;114818;83439;79833;4084;285148;100526794;9655;375190;51692;6382;388962;84865;54454;11037;3777;200634;51652;4613;9577;9784;57665;92749;11321;3797;8853;1058;200504;84168;165545;130162;339779;51374;8491;23233;5966;4211;84913;84279;338;8291;27302;130271;28951;6546;27248;9014;100271715;8884;10578;129852;1788;151393;388969;23160;9581;728819;56603;344018;9736;200734;253558;6233;347730;2034;6869;80304;84140;151516;200558;6936;23177;84226;85465;10890;2646;55622;94097;6432;165082;165530;5443;238;4072;5013;348738;23498;8462;3241;7360;1838;84759;344387;4148;55471;2202;2281;130106;8802;10736;90957;150726;525;6439;50618;9270;5610;5500;4190;25806;84173;9792;388951;10887;9741;84908;10618;9419;9553;151056;129285;55252;7444;79635;5495;100129278;51449;26056;2956;3196;6683;4358;5194;151449;64795;3795;391356;130497;26160;151354;3398;6654;10438;79954;10408;10199;7514;57835;200424;80745;64241;150946;11017;93034;5496;10669;9540;7072;1653;65055;165140;9027;1876;63892;27332;2355;5281;10574;5343;11036;494143;56287;400966;81606;2677;114800;926;55818;55233;57162;822;57539;130733;64080;87178;27429;3754;285126;25780;7498;10797;9381;85474;56660;4144;55006;3030;56888;388939;27436;10575;678;9637;84542;348654;170850;9168;1716;6716;57223;23301;388946;339778;54465;64225;729967;2492;25885;64395;10971;5967;6711;129293;3032;286749;253635;80059;6801;8446;8890;22950;5068;84141;150962;84693;119;100302652;130502;285051;22924;5341;388963;79677;5093;91461;30845;51130;7349;55133;9378;64838;51639;9913;23198;9167;51255;4436;116540;79998;58484;1545;200728;109;5968;54978;84058;83444;23369;5212;6509;150921;72;55704;790;2976;284948;23620;51057;10602;400961;51232;339804;54497;7841;343930;6496;116143;84450;57448;100505876;51002;4528;4052;729475;440854;2673;51646;64240;165324;54980;11117;57159;22848;1496;54867;51542;1961;9938;84661;3790;3099;130814;55577;10678;10322;54812;129303;8673;7781;554251;7840;129642;90411;64342;130120;57504;25927;100526767;165186;55676;64895;55120;60526;81553;56655;56896;84696;10128;51318;22979;113419;130589;130557;805;10097;10936;112942;51594;7039;56902;9475;9687;25940;3973;98;391365;50489;4953;10153;92906;90423;6242;23683;5581;130872;10617;245973;400950;23175;1768;375189;92291;7447;57498;9801;29094;80204;130951;400954;100128731;79745;79823;130813;550;344022;64427;53335;6241;245711;5861;10713;10505;6697;51072;10130;79623;23433;925;54884;29959;23559;2016;6637;25797;388931;57142;192668;653140;84272;10791;51626;388;57217;10989;27247;7844;1639;79172;8648;84695;60509;29841;388960;8869;6519;51277;1796;6868;3344;5534;55037;10113,433
1,1,2,10930789,14557258,3626469,3754;10130;1876;28951;130813;23620;9475;130814;9687;23175,10
1,-1,2,12939430,13523912,584482,,0
1,-1,2,13207008,13337147,130139,,0
1,-1,2,13207037,13278805,71768,,0
-1,-1,2,13278775,13417994,139219,,0
-1,1,2,13804435,16409693,2605258,51594;10408;4613;1653;151354,5
1,-1,2,14147182,14590377,443195,,0
1,-1,2,14182010,14278837,96827,,0
-1,1,2,14617464,16467586,1850122,51594;10408;4613;1653;151354,5
-1,1,2,16904863,21823606,4918743,388;7447;343930;100526794;64342;93034;130502;348654;729475;57539;151449;9741;6382;4148;338;79677;23369;130497;60526;57665;3790;100129278,22
-1,1,2,22802524,28748053,5945529,114818;7781;375190;54454;339778;3777;9553;151056;3030;200634;55252;9577;79635;9784;56896;84696;92749;11321;3797;3032;1058;22979;339779;8890;22950;51374;130557;22924;4358;3795;391356;26160;7349;8884;64838;51639;9913;1788;375189;150946;100128731;5496;9540;10669;109;54978;80304;150921;790;85465;2976;84226;10890;29959;2355;388931;653140;2646;165082;5443;84450;8648;79172;1838;165324;64080;60509;285126;2281;11117;130106;57159;54867;9381;51277;10113;50618,77
1,1,2,22922551,33992077,11069526,5500;388939;114818;7781;375190;6716;54454;165186;339778;3777;9553;151056;55676;200634;55252;3030;9577;79635;9784;56896;84696;92749;11321;3797;3032;1058;22979;339779;8890;22950;51374;130557;6683;22924;4358;25940;3795;391356;26160;30845;7349;8884;64838;51639;9913;1788;375189;92291;23160;150946;100128731;58484;79745;5496;9540;10669;109;245711;253558;54978;80304;79623;150921;51072;790;85465;2976;84226;10890;29959;2355;388931;84272;653140;81606;2646;55622;165082;5443;84450;238;57448;4052;8648;79172;440854;1838;51646;165324;64080;60509;285126;2281;11117;130106;57159;25780;54867;7498;9381;51277;84661;55006;10113;50618,105
1,1,2,28069882,43543420,15473538,5500;388939;5610;27436;79833;678;9637;170850;57504;6716;165186;64225;151056;729967;55676;9577;253635;6801;130589;6683;8491;25940;391365;6546;10153;92906;6654;30845;91461;100271715;23683;400950;92291;9167;151393;80745;23160;58484;79745;1545;245711;253558;165140;5212;79623;51072;63892;2355;25797;10602;84272;51232;81606;55622;54497;6432;57448;238;100505876;23498;4052;440854;51646;64080;130733;344387;55471;25780;7498;90957;84661;55006,72
-1,-1,2,29801273,30164069,362796,238,1
-1,-1,2,29801273,30164069,362796,238,1
-1,-1,2,29801273,30164069,362796,238,1
-1,-1,2,29801273,30164069,362796,238,1
-1,-1,2,29801273,30164069,362796,238,1
-1,-1,2,29801273,30164069,362796,238,1
-1,-1,2,29801273,30164069,362796,238,1
-1,-1,2,29801273,30164069,362796,238,1
-1,-1,2,29801273,30164069,362796,238,1
-1,-1,2,29801273,30164069,362796,238,1
-1,-1,2,29801273,30164069,362796,238,1
1,-1,2,32514528,33249136,734608,57448;4052;84272;55622,4
1,-1,2,32610082,33285390,675308,57448;4052;55622,3
1,-1,2,32663325,33275463,612138,57448;4052;55622,3
1,-1,2,32663325,33294774,631449,57448;4052;55622,3
1,-1,2,32663325,33294774,631449,57448;4052;55622,3
1,-1,2,32663325,33294774,631449,57448;4052;55622,3
1,-1,2,32677683,33257379,579696,57448;4052;55622,3
1,-1,2,32677714,33257514,579800,57448;4052;55622,3
1,-1,2,32677714,33257514,579800,57448;4052;55622,3
1,-1,2,32677714,33257514,579800,57448;4052;55622,3
1,-1,2,32677714,33257514,579800,57448;4052;55622,3
1,-1,2,32677714,33257514,579800,57448;4052;55622,3
1,-1,2,32677714,33257514,579800,57448;4052;55622,3
1,-1,2,32677714,33294723,617009,57448;4052;55622,3
1,-1,2,32677714,33294723,617009,57448;4052;55622,3
1,-1,2,32787199,32968519,181320,57448;55622,2
1,-1,2,32787199,33121586,334387,57448;55622,2
-1,-1,2,34702930,34915000,212070,,0
-1,-1,2,35524142,35620511,96369,,0
1,-1,2,35576002,35769464,193462,,0
-1,-1,2,35576002,35821806,245804,,0
-1,-1,2,35822006,36077697,255691,,0
-1,-1,2,35822006,36077697,255691,,0
-1,-1,2,35822006,36077697,255691,,0
-1,-1,2,35822006,36077697,255691,,0
-1,-1,2,35822006,36077697,255691,,0
-1,-1,2,35822006,36077697,255691,,0
-1,-1,2,35822006,36077697,255691,,0
-1,-1,2,35822006,36077697,255691,,0
-1,-1,2,35821806,35956621,134815,,0
-1,-1,2,35821806,36061904,240098,,0
-1,1,2,37227700,42181826,4954126,5610;6432;151393;130589;79833;80745;100505876;8491;1545;400950;130733;391365;344387;64225;729967;55471;6546;10153;92906;6654;90957;100271715;23683;25797;10602;253635;54497,27
-1,-1,2,37967394,38115263,147869,,0
-1,-1,2,39324297,39328794,4497,6654,1
1,-1,2,39412970,39605266,192296,8491;344387,2
1,-1,2,44065338,44079721,14383,64240;64241,2
-1,-1,2,44231393,44276924,45531,,0
-1,-1,2,44510781,44525874,15093,6519,1
-1,1,2,44531130,44552898,21768,9581;6519,2
-1,1,2,44534506,44543435,8929,6519,1
-1,1,2,44914980,45172628,257648,79823;6496,2
-1,-1,2,45095754,45171902,76148,6496,1
1,-1,2,45168836,45169314,478,6496,1
1,-1,2,45168836,45169885,1049,6496,1
1,-1,2,45171843,45172394,551,6496,1
1,-1,2,45171857,45172394,537,6496,1
1,-1,2,45172206,45172394,188,6496,1
1,-1,2,46800828,46959977,159149,9419;9655;5281;23433,4
-1,1,2,47033357,50792676,3759319,80204;4436;4072;57217;90411;805;2956;285051;3344;3973;11037;129285;2492;56660;9378;11036;286749,17
-1,1,2,47280431,47714665,434234,285051;4436;4072;57217;805,5
-1,1,2,47361260,54934153,7572893,23198;80204;4436;2956;4072;100302652;805;10936;285051;129852;388951;3973;98;11037;129285;2492;9378;27248;51130;6711;56660;3344;11036;494143;286749,25
-1,1,2,47414693,47636335,221642,4436;4072,2
-1,1,2,47598133,47684221,86088,4436;4072,2
1,1,2,47847527,86929845,39082318,307;150684;56888;83439;10575;4084;84542;9168;1716;57223;23301;11037;388962;84865;54465;2492;51652;25885;64395;5967;6711;129293;286749;84168;200504;80059;165545;8446;130162;84141;5068;150962;100302652;119;84693;23233;5966;4211;5341;84913;388963;84279;8291;27302;27248;5093;51130;9378;10578;129852;23198;388969;51255;116540;79998;200728;56603;344018;9736;200734;5968;6233;84058;347730;83444;6869;84140;6509;151516;200558;72;55704;6936;23177;284948;51057;400961;339804;7841;94097;116143;165530;5013;51002;4528;7360;2673;84759;2202;54980;22848;1496;8802;51542;9938;150726;1961;525;55577;3099;10678;6439;10322;4190;54812;8673;129303;25806;554251;7840;84173;9792;388951;130120;10887;25927;84908;10618;100526767;129285;64895;55120;7444;56655;51449;51318;113419;26056;2956;3196;10097;10936;112942;7039;5194;56902;98;3973;50489;10438;6242;130872;10199;7514;10617;200424;57835;1768;80204;29094;130951;400954;9801;11017;550;344022;53335;7072;64427;5861;65055;10713;10505;9027;6697;27332;54884;6637;2016;23559;10574;11036;57142;494143;56287;2677;10791;114800;55818;55233;57162;822;27247;10989;1639;7844;84695;87178;27429;388960;10797;85474;8869;1796;5534;3344;4144;55037,198
-1,1,2,47890992,48012867,121875,2956,1
-1,1,2,48861903,48988580,126677,11036;3973;286749,3
-1,1,2,49156753,51066637,1909884,2492;9378,2
-1,1,2,50138070,52689474,2551404,9378,1
-1,1,2,50280210,51109690,829480,9378,1
1,-1,2,50281917,50282100,183,9378,1
-1,1,2,50512908,50957337,444429,9378,1
-1,1,2,50680795,50892906,212111,9378,1
-1,1,2,50680795,50892906,212111,9378,1
-1,1,2,50680795,50937503,256708,9378,1
-1,1,2,50707763,50793781,86018,9378,1
-1,1,2,50725729,50937503,211774,9378,1
-1,1,2,50802121,50937503,135382,9378,1
-1,1,2,50804279,51027599,223320,9378,1
-1,1,2,50811167,50870064,58897,9378,1
-1,1,2,50813343,50948464,135121,9378,1
-1,1,2,50814676,50957455,142779,9378,1
-1,1,2,50818355,51158300,339945,9378,1
-1,1,2,50826550,50925896,99346,9378,1
-1,1,2,50838594,51119793,281199,9378,1
1,-1,2,50847100,50847341,241,9378,1
-1,1,2,50847100,50982172,135072,9378,1
-1,1,2,50847100,51556715,709615,9378,1
-1,1,2,50850691,50982113,131422,9378,1
-1,1,2,50851432,51492867,641435,9378,1
-1,1,2,50886432,243102476,192216044,307;150684;6335;1493;129831;151258;1285;56171;79582;51661;6694;5000;84865;284996;3234;130916;51652;8576;389058;9541;150681;150483;2641;151050;5334;6670;25953;200504;80097;248;130162;1386;91752;64965;9208;10913;408029;64114;79634;23233;4211;84913;10018;1419;7277;6574;81618;84279;80255;27302;54575;27248;285193;80146;84220;130340;10578;80326;100130451;3329;1123;6120;1261;843;8837;5510;150472;29842;79712;55759;375287;56603;255101;4705;9736;9392;200734;6160;9360;4719;23549;347730;26504;1286;646960;55571;84140;151516;22837;200558;6936;200539;80705;23177;7852;547;55054;92104;84524;7141;5342;94097;8527;55686;165530;220988;471;2820;65124;84759;92196;2202;8802;9936;389075;3800;8708;4999;7035;5077;3625;10254;6364;84173;84639;6819;100288695;10887;54842;10618;4780;5798;57590;65065;26525;60482;7444;8809;2888;8828;1674;2168;55289;79781;129880;51449;56475;8324;6295;285180;10056;653275;130399;10787;55183;344148;64844;1134;9595;93349;51719;10438;151230;26225;7535;7514;57835;431705;151011;165215;9448;116093;3431;7130;391475;10123;11017;51665;257407;7072;253782;151112;785;10120;22934;6326;130574;92737;4691;130560;518;375318;10651;3577;729540;494143;65062;65061;150572;55233;51052;55997;151254;1418;285175;10058;164781;84365;58190;55355;11138;130752;79054;3938;87178;2019;22868;343990;4144;23332;3557;5163;284992;65977;1420;7273;7475;151278;9320;11262;9470;79853;25972;10575;54891;4065;285093;3553;130540;5136;84269;1716;57223;129450;580;7857;2863;79083;1412;5624;5967;6711;100144595;54578;4709;376940;3176;80059;84804;10213;91409;25992;29789;5068;3635;84693;119;3667;1781;2825;66008;55240;23192;388963;56918;10494;150465;84874;129881;55437;7849;5093;659;25791;3631;9378;344167;50649;65080;8886;23198;130940;130132;29926;164832;51776;51141;344558;60491;7520;1593;4759;14;5968;84058;83444;140469;1421;130026;140739;101929926;2817;1615;51455;55704;57405;79828;3336;23020;3549;400961;274;1195;130074;7145;23704;646915;445582;7851;80055;54600;3655;116255;2071;85461;2487;27013;130367;1961;3099;8942;3694;10678;151295;389084;10322;54812;129303;8673;129446;4880;728294;7840;130749;23505;130507;11250;55683;100526664;130120;64708;339768;3238;100526832;25927;84910;3267;26058;2859;64284;64895;10267;26122;389072;731220;6556;56655;189;3237;140738;375298;55619;51318;2181;11132;10936;112942;402117;7039;117583;8436;56902;2043;493911;55041;55137;54577;339761;7247;151242;4664;4430;6242;10617;8604;1768;200523;3357;165100;9801;29094;4249;55777;79901;3300;10920;80219;9427;80704;64427;1841;57730;81615;5861;57703;10713;54520;10505;57695;699;6697;150696;925;27179;6344;200765;905;56947;23559;2016;11159;113457;2571;1745;55022;57142;653192;92691;150677;130576;150763;6744;27247;7844;1639;65059;5455;4648;10152;841;11069;375248;8869;130617;10290;83439;150590;4084;1281;84289;3623;729857;728378;29798;55660;388962;3760;84812;79065;10316;93010;83879;23363;80034;84168;79800;165545;8808;151188;29994;55230;493753;129531;2274;10170;64320;2335;10190;23550;5966;50485;57520;5270;1933;5757;8291;57471;8575;200407;254773;129852;1385;5903;6323;53353;23677;388969;92;2744;10324;8807;51239;84236;377007;7850;6328;100131211;344018;285190;6233;54910;84084;55843;3236;151313;6869;165257;84417;3987;30061;100996693;22930;150771;10746;9839;2736;4632;58538;339766;129684;33;9111;79919;375316;5013;7360;79137;3231;9330;5746;3579;6741;1803;2840;130888;9874;150726;25843;525;151306;6439;4190;11249;3235;56300;25806;9262;151176;26003;3417;57683;51602;10314;8685;8647;79411;9792;56886;4760;388951;84620;9669;3232;84908;84281;53938;80775;10109;3899;2591;26010;4036;1329;6168;57669;617;26056;254042;7429;200576;80731;84083;54659;3196;50940;30818;653489;129868;55139;27347;5194;653781;64795;55258;10865;114805;64859;151246;8609;55502;6332;55854;26275;250;79595;9290;26146;79134;5147;10199;200424;114793;5707;55677;142679;80895;79843;25801;51601;23671;4175;285172;91526;57007;129807;23397;151525;65055;129401;51315;9027;79675;27332;51540;92856;54529;200350;10574;5343;10477;56287;400966;51011;2677;80067;389073;114800;926;55818;11320;57162;57282;822;6672;7855;27429;1844;80210;653784;8745;84317;10797;85474;3554;57624;6549;83607;389015;56888;7456;54658;9855;7549;9173;344191;26154;5433;90;84542;9168;5899;150737;53632;23301;54465;130827;10010;339745;2995;25885;64395;55825;442038;57574;54579;80856;84128;66037;27148;400986;129293;55627;100131390;23451;151195;285141;51454;151556;57140;8446;114880;84141;8540;150962;8502;100302652;2066;54657;2637;389090;92935;91404;5341;29081;23314;1373;1290;54738;3069;129804;10096;117581;3485;1146;51130;29851;3628;22807;3685;79031;51255;116540;79998;1622;9654;200728;129530;151473;80122;150678;8520;151126;6509;4735;72;401036;284948;9486;79568;51057;165055;112714;339804;27178;7841;390;81562;3769;116987;205327;3233;116143;55339;150864;150786;90134;100529241;51002;4528;150468;51263;116372;5775;2673;6508;9391;5937;51252;10461;54980;94101;401027;22848;1496;54431;666;5378;8440;4118;3676;7341;285025;51542;9938;23190;4867;9125;79586;55577;653437;64090;554251;57628;8452;96626;10716;56910;6775;10203;100526767;57404;114790;90342;130612;26505;55120;22925;494513;57679;3552;414061;1144;9759;129563;130013;653269;51078;6772;4703;150709;9394;11227;113419;10097;1746;98;4862;54576;64135;50489;200373;344561;8864;9689;130535;130872;151531;2660;79840;80309;727851;80303;1293;55654;115677;200726;5133;130951;8941;940;400954;84172;205147;27249;151194;3488;23178;550;344022;130355;53335;129521;27233;90557;55515;151;23518;7701;54884;79074;6637;27177;4929;316;84826;100652824;251;10791;64969;79809;57818;9451;3239;57181;10989;84695;64682;64172;2191;200403;55679;388960;93082;375307;4133;51281;26469;9648;1796;5534;50636;55037,952
-1,1,2,50905757,51249333,343576,9378,1
-1,1,2,50909765,51335129,425364,9378,1
-1,1,2,50959192,51402934,443742,9378,1
-1,1,2,50962008,51260667,298659,9378,1
-1,1,2,50964034,51227294,263260,9378,1
-1,1,2,50964034,51915187,951153,9378,1
1,-1,2,50970662,51008023,37361,9378,1
-1,1,2,50978466,51528474,550008,9378,1
-1,1,2,50978466,51528474,550008,9378,1
-1,1,2,50982113,51226229,244116,9378,1
-1,1,2,51032041,51189570,157529,9378,1
-1,1,2,51037104,51446873,409769,9378,1
-1,-1,2,51049645,51066578,16933,9378,1
-1,-1,2,51049645,51122091,72446,9378,1
-1,1,2,51054373,51180620,126247,9378,1
-1,1,2,51066578,51260667,194089,9378,1
-1,1,2,51078335,51562416,484081,9378,1
-1,1,2,51083410,51226229,142819,9378,1
-1,1,2,51083410,51226229,142819,9378,1
-1,1,2,51083410,51314371,230961,9378,1
-1,1,2,51088055,51257067,169012,9378,1
-1,1,2,51088055,51257067,169012,9378,1
-1,1,2,51107486,51375539,268053,9378,1
-1,1,2,51113043,51257100,144057,9378,1
-1,1,2,51142849,51226229,83380,9378,1
-1,1,2,51142849,51510961,368112,9378,1
-1,1,2,51146817,51854353,707536,9378,1
-1,1,2,51172123,51251498,79375,9378,1
-1,1,2,51180561,51358881,178320,9378,1
-1,1,2,51191164,51354468,163304,9378,1
-1,1,2,51193626,51382813,189187,9378,1
-1,1,2,51205897,51279290,73393,9378,1
-1,1,2,51225621,51304763,79142,9378,1
-1,1,2,51225621,51337449,111828,9378,1
-1,1,2,51226170,51314430,88260,9378,1
-1,1,2,51226170,51314430,88260,9378,1
-1,1,2,51226170,51382872,156702,9378,1
-1,1,2,51226170,51556715,330545,9378,1
-1,1,2,51226170,51556715,330545,9378,1
-1,1,2,51229995,51363342,133347,9378,1
-1,1,2,51234059,51263065,29006,9378,1
-1,1,2,51237000,51382813,145813,9378,1
-1,1,2,51238789,51309967,71178,9378,1
1,-1,2,51259160,51259694,534,9378,1
-1,-1,2,51314371,51467462,153091,,0
-1,-1,2,52706226,52781440,75214,,0
-1,-1,2,52750773,52781440,30667,,0
1,-1,2,52750774,52781440,30666,,0
-1,-1,2,52750774,52781440,30666,,0
-1,-1,2,52844384,52885500,41116,,0
-1,-1,2,52952780,53056631,103851,,0
-1,1,2,58259051,63838944,5579893,4190;150684;10575;150962;5013;130872;84542;200728;5966;5194;9736;53335;23301;84140;64895;55120;7444;51057;7514;10678;339804,21
1,1,2,58506654,83814086,25307432,307;150684;10575;4084;84542;1716;23301;388962;84865;54465;64395;5967;84168;200504;80059;165545;8446;84141;5068;150962;84693;119;23233;5966;4211;5341;388963;84279;8291;27302;5093;116540;79998;200728;56603;344018;9736;200734;5968;84058;347730;83444;6869;84140;6509;151516;200558;72;6936;23177;51057;400961;339804;7841;94097;116143;165530;5013;51002;7360;2673;84759;54980;22848;1496;51542;9938;150726;1961;525;55577;3099;10678;10322;4190;54812;25806;554251;7840;9792;130120;10887;25927;84908;64895;56655;51449;113419;26056;3196;10097;7039;5194;56902;50489;10438;6242;130872;10199;7514;10617;200424;57835;130951;29094;9801;11017;550;344022;53335;7072;64427;5861;10505;9027;6697;27332;6637;2016;23559;10574;56287;55233;57162;27247;1639;84695;27429;388960;10797;85474;1796;5534,133
-1,1,2,58837279,63720819,4883540,150684;10575;150962;5013;130872;5966;84542;200728;5194;9736;53335;23301;84140;64895;51057;7514;10678;339804,18
-1,-1,2,61113419,61149619,36200,5966,1
-1,-1,2,61113419,61149619,36200,5966,1
-1,-1,2,61113419,61149619,36200,5966,1
-1,-1,2,61113419,61149619,36200,5966,1
-1,1,2,61198769,61319645,120876,150962;84542;5194,3
1,1,2,62245236,86978895,24733659,307;150684;56888;83439;4084;9168;1716;23301;388962;84865;54465;51652;25885;64395;5967;129293;84168;200504;80059;165545;8446;84141;5068;84693;119;23233;4211;5341;84913;388963;84279;8291;27302;5093;10578;388969;51255;116540;79998;200728;56603;344018;200734;5968;84058;347730;83444;6869;6509;151516;200558;72;6936;284948;23177;51057;400961;7841;94097;116143;165530;5013;51002;7360;2673;84759;54980;22848;1496;8802;51542;9938;150726;1961;525;55577;3099;10678;6439;10322;4190;54812;8673;129303;25806;554251;7840;84173;9792;130120;10887;25927;84908;10618;100526767;56655;51449;51318;113419;26056;3196;10097;7039;56902;64795;50489;10438;6242;10199;10617;200424;57835;1768;130951;29094;9801;11017;550;344022;7072;64427;5861;65055;10713;10505;9027;6697;27332;54884;6637;2016;23559;10574;56287;2677;10791;55818;55233;57162;822;27247;10989;1639;7844;84695;27429;388960;10797;85474;8869;1796;5534;4144;55037,154
-1,1,2,63234780,67908846,4674066,4190;54812;29094;57162;5013;10097;7360;9792;4211;200734;23301;5861;54465;6509;23177;51542;51057,17
-1,1,2,63669709,66333670,2663961,4190;54812;29094;6509;57162;10097;23177;7360;51542;9792;51057;200734;5861,13
-1,-1,2,68846932,68881993,35061,10887,1
1,-1,2,70704251,70760447,56196,7039,1
-1,1,2,74365484,89129064,14763580,56888;129303;8673;83439;84173;729857;130120;9168;100526767;388962;84865;10618;51652;25885;5967;56655;129293;2168;80059;51318;165545;84141;5068;3196;84913;64795;55258;388963;6242;10578;57835;344167;1768;200523;130951;9801;388969;51255;116540;550;64427;5968;65055;10713;84058;347730;22934;83444;10505;6869;51315;6936;54884;284948;925;23559;5343;400966;2677;7841;5342;10791;926;150572;55818;55233;9451;822;10989;7844;1639;84695;84759;27429;1496;8802;10797;85474;8869;1796;4144;3099;55037;6439,84
1,-1,2,75160356,75196822,36466,56655,1
1,1,2,77252342,91619262,14366920,56888;129303;8673;83439;388969;51255;84173;729857;1768;130120;9168;100526767;5968;10618;10713;347730;65055;51315;22934;51652;25885;54884;284948;5967;925;5343;129293;2168;400966;80059;2677;51318;10791;926;5342;150572;55818;9451;5068;822;10989;7844;84913;64795;55258;1496;8802;8869;4144;10578;55037;6439;344167;200523,54
-1,-1,2,81721756,81899151,177395,,0
1,-1,2,82220038,82293622,73584,,0
1,-1,2,82220038,82293622,73584,,0
-1,-1,2,82600210,82923012,322802,,0
-1,-1,2,83291704,83775616,483912,,0
1,-1,2,83675238,84251319,576081,,0
1,-1,2,83804793,84054882,250089,,0
-1,1,2,85241809,89126132,3884323,56888;129303;8673;83439;388969;51255;84173;729857;100526767;10618;10713;65055;22934;51315;51652;25885;54884;284948;925;5343;2168;400966;2677;51318;10791;926;5342;150572;55818;9451;822;10989;7844;84913;64795;55258;8869;4144;10578;55037;6439;344167;200523,43
1,-1,2,87190529,88106063,915534,5343;400966;729857;5342,4
1,-1,2,87258795,88037771,778976,,0
1,-1,2,87258795,88037771,778976,,0
1,-1,2,87258795,88037771,778976,,0
1,-1,2,87258795,88037771,778976,,0
1,-1,2,87258795,88037771,778976,,0
1,-1,2,87258795,88037771,778976,,0
1,-1,2,87295705,88037771,742066,,0
1,-1,2,87295705,88037771,742066,,0
1,-1,2,87304078,88037771,733693,,0
1,-1,2,87304078,88037771,733693,,0
1,-1,2,87304078,88037771,733693,,0
1,-1,2,87304078,88037771,733693,,0
1,-1,2,87304078,88037771,733693,,0
1,-1,2,87304078,88037771,733693,,0
1,-1,2,87304078,88037771,733693,,0
1,-1,2,87304078,88037771,733693,,0
1,-1,2,87304078,88037771,733693,,0
1,-1,2,87304078,88037771,733693,,0
1,-1,2,87304078,88037771,733693,,0
1,-1,2,87304078,88037771,733693,,0
1,-1,2,87304078,88037771,733693,,0
1,-1,2,87304078,88037771,733693,,0
1,-1,2,87304078,88037771,733693,,0
1,-1,2,87304078,88037771,733693,,0
1,-1,2,87304078,88037771,733693,,0
1,-1,2,87304078,88037771,733693,,0
1,-1,2,87304078,88037771,733693,,0
1,-1,2,87304078,88037771,733693,,0
1,-1,2,87304078,88037771,733693,,0
1,-1,2,87304078,88037771,733693,,0
1,-1,2,87304078,88037771,733693,,0
1,-1,2,87304078,88037771,733693,,0
1,-1,2,87304078,88037771,733693,,0
1,-1,2,87304078,88037771,733693,,0
1,-1,2,87304078,88037771,733693,,0
1,-1,2,87304078,88037771,733693,,0
1,-1,2,87304078,88037771,733693,,0
1,-1,2,87304078,88037771,733693,,0
1,-1,2,87304078,88037771,733693,,0
1,-1,2,87304078,88037771,733693,,0
1,-1,2,87304078,88037771,733693,,0
1,-1,2,87304078,88037771,733693,,0
1,-1,2,87325301,88005418,680117,,0
1,-1,2,87325327,88005429,680102,,0
-1,-1,2,87325327,88005429,680102,,0
1,-1,2,87325390,88037771,712381,,0
1,-1,2,87325390,88037771,712381,,0
1,-1,2,87325390,88037771,712381,,0
1,-1,2,87325390,88037771,712381,,0
1,-1,2,87325390,88037771,712381,,0
1,-1,2,87325390,88037771,712381,,0
1,-1,2,87325390,88037771,712381,,0
1,-1,2,87325390,88037771,712381,,0
1,-1,2,87325390,88037771,712381,,0
1,-1,2,87325390,88037771,712381,,0
1,-1,2,87325390,88037771,712381,,0
1,-1,2,87325390,88037771,712381,,0
1,-1,2,87325390,88037771,712381,,0
1,-1,2,87325390,88037771,712381,,0
1,-1,2,87325390,88037771,712381,,0
1,-1,2,87325390,88037771,712381,,0
1,-1,2,87325390,88037771,712381,,0
1,-1,2,87325390,88037771,712381,,0
1,-1,2,87325390,88037771,712381,,0
1,-1,2,87325390,88037771,712381,,0
1,-1,2,87325390,88037771,712381,,0
1,-1,2,87325390,88037771,712381,,0
1,-1,2,87325390,88037771,712381,,0
1,-1,2,87325390,88037771,712381,,0
1,-1,2,87325390,88037771,712381,,0
1,-1,2,87325390,88037771,712381,,0
1,-1,2,87325390,88037771,712381,,0
1,-1,2,87325390,88037771,712381,,0
1,-1,2,87325390,88037771,712381,,0
1,-1,2,87325390,88037771,712381,,0
1,-1,2,87325390,88037771,712381,,0
1,-1,2,87325390,88037771,712381,,0
1,-1,2,87325390,88037771,712381,,0
1,-1,2,87325390,88037771,712381,,0
1,-1,2,87325390,88037771,712381,,0
1,-1,2,87325390,88037771,712381,,0
1,-1,2,87325390,88037771,712381,,0
1,-1,2,87325390,88037771,712381,,0
1,-1,2,87325390,88037771,712381,,0
1,-1,2,87325390,88037771,712381,,0
1,-1,2,87325390,88037771,712381,,0
1,-1,2,87325390,88037771,712381,,0
1,-1,2,87325390,88037771,712381,,0
1,-1,2,87325390,88037771,712381,,0
1,-1,2,87325390,88037771,712381,,0
1,-1,2,87325390,88037771,712381,,0
1,-1,2,87325390,88037771,712381,,0
1,-1,2,87325390,88057969,732579,729857;5342,2
1,-1,2,87325390,88057969,732579,729857;5342,2
1,-1,2,87325390,88057969,732579,729857;5342,2
1,-1,2,87325390,88057969,732579,729857;5342,2
1,-1,2,87325390,88057969,732579,729857;5342,2
1,-1,2,87325390,88057969,732579,729857;5342,2
1,-1,2,87376073,88005429,629356,,0
-1,-1,2,87376077,87954920,578843,,0
1,-1,2,87376077,87954920,578843,,0
1,-1,2,87376077,88005418,629341,,0
1,-1,2,87376077,88005418,629341,,0
-1,-1,2,87376077,88005418,629341,,0
-1,-1,2,87376077,88005418,629341,,0
-1,-1,2,87376077,88005418,629341,,0
-1,-1,2,87376077,88005418,629341,,0
-1,-1,2,87376077,88005418,629341,,0
-1,-1,2,87376077,88005418,629341,,0
-1,-1,2,87376077,88005418,629341,,0
1,-1,2,87376077,88260796,884719,729857;5342,2
1,-1,2,87376077,88260796,884719,729857;5342,2
1,-1,2,87376132,88037771,661639,,0
-1,-1,2,89137662,89523818,386156,,0
-1,-1,2,89137592,89329992,192400,,0
-1,-1,2,89241017,89259510,18493,,0
-1,-1,2,89244273,89259510,15237,,0
-1,-1,2,89259571,90251481,991910,,0
-1,-1,2,89259571,90293011,1033440,,0
1,-1,2,89259571,91899595,2640024,,0
1,-1,2,89259571,91899595,2640024,,0
1,-1,2,89259571,91899595,2640024,,0
1,-1,2,89259571,92129460,2869889,,0
1,-1,2,89259571,95344251,6084680,,0
1,-1,2,89275287,91815679,2540392,,0
1,-1,2,89288236,91815679,2527443,,0
-1,-1,2,89297771,90251481,953710,,0
-1,-1,2,89297771,90293011,995240,,0
1,-1,2,89297771,90293011,995240,,0
-1,-1,2,89297771,90293011,995240,,0
-1,-1,2,89297771,90293011,995240,,0
1,-1,2,89297771,90293011,995240,,0
1,-1,2,89297771,91759386,2461615,,0
1,-1,2,89297771,91759386,2461615,,0
1,-1,2,89297771,91759386,2461615,,0
1,-1,2,89297771,91759386,2461615,,0
1,-1,2,89297771,91759386,2461615,,0
1,-1,2,89297771,91759386,2461615,,0
1,-1,2,89297771,91759386,2461615,,0
1,-1,2,89297771,91899595,2601824,,0
1,-1,2,89323386,90263882,940496,,0
1,-1,2,89323386,91815679,2492293,,0
1,-1,2,89330069,91759386,2429317,,0
1,-1,2,89330069,91759386,2429317,,0
1,-1,2,89330069,91759386,2429317,,0
-1,-1,2,89332506,90263882,931376,,0
-1,-1,2,89332506,90263882,931376,,0
-1,-1,2,89439468,90251481,812013,,0
-1,-1,2,89482269,90251823,769554,,0
1,-1,2,89500023,89527568,27545,,0
1,-1,2,89523818,90233909,710091,,0
1,-1,2,89523818,90293011,769193,,0
1,-1,2,89523818,90293011,769193,,0
1,-1,2,89523818,90293011,769193,,0
1,-1,2,89523818,90293011,769193,,0
1,-1,2,89523818,90293011,769193,,0
1,-1,2,89523818,90293011,769193,,0
1,-1,2,89523818,91759386,2235568,,0
1,-1,2,89523818,91759386,2235568,,0
1,-1,2,89523818,91759386,2235568,,0
1,-1,2,89523818,91759386,2235568,,0
-1,-1,2,89538784,90234028,695244,,0
-1,-1,2,89538845,90258291,719446,,0
1,-1,2,89538934,90293011,754077,,0
1,-1,2,89538934,90293011,754077,,0
1,-1,2,89538934,90293011,754077,,0
1,-1,2,89538934,91619163,2080229,,0
1,-1,2,89538934,91764207,2225273,,0
1,-1,2,89538934,91899595,2360661,,0
1,-1,2,89596684,90293011,696327,,0
-1,-1,2,89601879,90293011,691132,,0
-1,-1,2,89967669,90293011,325342,,0
-1,-1,2,89975495,90258291,282796,,0
1,-1,2,90233968,91693328,1459360,,0
1,-1,2,90233968,91693328,1459360,,0
1,-1,2,90233968,91693328,1459360,,0
1,-1,2,90233968,91693328,1459360,,0
1,-1,2,90233968,91693328,1459360,,0
1,-1,2,90233968,91693328,1459360,,0
1,-1,2,90233968,91759386,1525418,,0
1,-1,2,90233968,91759386,1525418,,0
1,-1,2,90233968,91759386,1525418,,0
1,-1,2,90233968,91759386,1525418,,0
1,-1,2,90233968,91759386,1525418,,0
1,-1,2,90233968,91759386,1525418,,0
1,-1,2,90233968,91759386,1525418,,0
1,-1,2,90233968,91759386,1525418,,0
1,-1,2,90233968,91759386,1525418,,0
1,-1,2,90233968,91759386,1525418,,0
1,-1,2,90233968,91759386,1525418,,0
1,-1,2,90233968,91759386,1525418,,0
1,-1,2,90233968,91759386,1525418,,0
1,-1,2,90233968,91759386,1525418,,0
1,-1,2,90233968,91759386,1525418,,0
1,-1,2,90233968,91759386,1525418,,0
1,-1,2,90233968,91759386,1525418,,0
1,-1,2,90233968,91759386,1525418,,0
1,-1,2,90251540,91759386,1507846,,0
1,-1,2,90251540,91759386,1507846,,0
1,-1,2,90251540,91759386,1507846,,0
1,-1,2,90251540,91919048,1667508,,0
-1,-1,2,91670321,91812508,142187,,0
1,-1,2,91963942,92129716,165774,,0
1,1,2,95327499,111370025,16042526,7549;150590;25972;9173;96626;23505;56910;11250;6819;55683;100288695;84620;9669;130827;3899;284996;90342;1329;26505;442038;731220;60482;8809;150483;400986;84804;8808;64965;493753;129531;2274;10913;30818;653489;10190;129868;10865;4862;84874;80146;3631;200407;84220;7535;254773;431705;151011;9448;55654;5903;79031;51601;1261;164832;8807;51239;344558;7850;285190;9392;129530;23397;6160;57730;54910;129521;10120;26504;27233;151313;55571;151;150696;84417;200539;51455;80705;3987;79074;9486;23020;150771;729540;165055;51011;64969;81562;653192;11320;7851;150763;65124;51263;5455;11138;9391;200403;51252;93082;1844;375248;8440;4118;3554;9648;343990;4867;6549;389015,109
1,1,2,95344257,111359986,16015729,7549;150590;25972;9173;96626;23505;56910;11250;6819;55683;100288695;84620;9669;130827;3899;284996;90342;1329;26505;442038;731220;60482;8809;150483;400986;84804;8808;64965;493753;129531;2274;10913;30818;653489;10190;129868;10865;4862;84874;80146;3631;200407;84220;7535;254773;431705;151011;9448;55654;5903;79031;51601;1261;164832;8807;51239;344558;7850;285190;9392;129530;23397;6160;57730;54910;129521;10120;26504;27233;151313;55571;151;150696;84417;200539;51455;80705;3987;79074;9486;23020;150771;729540;165055;51011;64969;81562;653192;11320;7851;150763;65124;51263;5455;11138;9391;200403;51252;93082;1844;375248;8440;4118;3554;9648;343990;4867;6549;389015,109
1,1,2,95529039,108518266,12989227,7549;150590;25972;9173;23505;56910;11250;55683;84620;9669;130827;3899;284996;90342;1329;26505;731220;8809;150483;400986;84804;8808;64965;493753;129531;2274;30818;653489;10190;129868;10865;4862;84874;80146;3631;200407;7535;254773;431705;9448;55654;79031;51601;1261;164832;8807;51239;7850;285190;9392;129530;23397;6160;57730;54910;129521;10120;26504;151313;55571;151;150696;84417;200539;51455;80705;79074;9486;23020;150771;51011;64969;81562;653192;11320;150763;51263;5455;11138;9391;200403;51252;93082;1844;375248;8440;4118;3554;343990;6549;389015,91
1,1,2,95691600,100587394,4895794,7549;150590;25972;51601;1261;23505;51239;56910;55683;23397;57730;129530;10120;54910;9669;26504;3899;90342;151;151313;150696;1329;26505;200539;51455;80705;23020;150771;400986;51011;64969;653192;81562;11320;493753;129531;150763;30818;10190;51263;129868;10865;9391;200403;93082;51252;84874;1844;375248;4118;3631;343990;7535;254773;431705;55654,56
1,-1,2,96012844,96076672,63828,51011;30818,2
1,-1,2,96340729,96718023,377294,400986;150763,2
1,-1,2,96475033,96671972,196939,400986,1
-1,1,2,96545350,97695409,1150059,81562;150763;51239;56910;55683;23397;10865;54910;9391;26504;93082;51252;90342;151;1844;26505;200539;23020;150771;400986;431705;55654,22
1,-1,2,96583702,96671972,88270,400986,1
1,-1,2,96635171,96671972,36801,400986,1
1,-1,2,96671972,96705053,33081,150763,1
-1,1,2,96739308,97728447,989139,81562;51239;56910;55683;23397;10865;54910;9391;26504;93082;51252;90342;151;1844;26505;200539;23020;150771;431705;55654,20
-1,1,2,96739308,98108185,1368877,81562;51239;56910;55683;23397;10865;54910;9391;26504;93082;51252;90342;151;151313;1844;26505;200539;375248;23020;150771;431705;55654,22
1,-1,2,97695402,98260508,565106,57730;151313;375248,3
1,-1,2,97695402,98260508,565106,57730;151313;375248,3
1,-1,2,97695402,98260508,565106,57730;151313;375248,3
1,-1,2,97695402,98263440,568038,1329;57730;151313;375248,4
1,-1,2,97714365,98263440,549075,1329;57730;151313;375248,4
1,-1,2,97750013,97757978,7965,151313,1
1,-1,2,98262523,98274890,12367,1329;10120,2
1,-1,2,98263858,98274890,11032,1329;10120,2
1,-1,2,99858723,99914955,56232,254773;129530,2
1,-1,2,99858723,99914955,56232,254773;129530,2
1,-1,2,99858723,99914955,56232,254773;129530,2
-1,-1,2,99858723,99914955,56232,254773;129530,2
1,-1,2,99858723,99914955,56232,254773;129530,2
-1,1,2,101850532,106295614,4445082,8808;9173;64965;2274;8807;11250;7850;5455;9392;130827;284996;55571;389015;79074;731220;3554;8809;200407;6549;84804;9448,21
1,1,2,102327287,111548995,9221708,5903;9173;96626;8807;11250;7850;6819;344558;100288695;285190;9392;84620;27233;130827;699;84417;3987;79074;60482;442038;8809;729540;165055;55289;84804;8808;64965;10913;2274;7851;653489;65124;5455;389015;3554;8440;80146;9648;84220;4867;6549;151011;9448,43
1,-1,2,105855491,106768556,913065,11250;80146;9392;84417;2274;79074;8440,7
1,-1,2,106929257,107152986,223729,653489,1
1,-1,2,108439150,108441524,2374,,0
1,-1,2,108439150,108476528,37378,285190,1
1,-1,2,108518300,109089233,570933,6819;9648;27233;442038;60482,5
-1,-1,2,110381297,110964737,583440,96626;7851;84220;4867,4
1,-1,2,110683944,111202718,518774,7851;4867,2
1,-1,2,110683944,111202718,518774,7851;4867,2
1,-1,2,110683944,111202718,518774,7851;4867,2
1,-1,2,110683944,111204317,520373,7851;4867,2
1,-1,2,110683944,111204317,520373,7851;4867,2
1,-1,2,110683944,111204317,520373,7851;4867,2
1,-1,2,110695259,111191379,496120,7851;4867,2
1,-1,2,110695259,111202718,507459,7851;4867,2
1,-1,2,110717480,111118115,400635,7851;4867,2
-1,-1,2,110732632,110964737,232105,7851;4867,2
1,-1,2,110732649,110964775,232126,7851;4867,2
1,-1,2,110732649,110964775,232126,7851;4867,2
1,-1,2,110732649,110964775,232126,7851;4867,2
1,-1,2,110732707,111204317,471610,7851;4867,2
1,-1,2,110783036,110964878,181842,7851;4867,2
1,-1,2,110783236,110964737,181501,7851;4867,2
-1,-1,2,110783236,110964737,181501,7851;4867,2
1,-1,2,110783251,111079065,295814,7851;4867,2
1,-1,2,110783251,111079065,295814,7851;4867,2
-1,-1,2,110783258,111334482,551224,729540;7851;100288695;4867,4
-1,1,2,110824257,110983418,159161,7851;4867,2
1,-1,2,110833640,110966643,133003,7851;4867,2
-1,-1,2,110833640,110966643,133003,7851;4867,2
1,-1,2,110833640,110966643,133003,7851;4867,2
1,-1,2,110833640,111015446,181806,7851;4867,2
1,-1,2,110862474,110964775,102301,7851;4867,2
1,-1,2,110862474,110964775,102301,7851;4867,2
-1,-1,2,110862474,110964775,102301,7851;4867,2
1,-1,2,110862474,110964775,102301,7851;4867,2
-1,-1,2,110862474,110964775,102301,7851;4867,2
1,-1,2,110862474,110964775,102301,7851;4867,2
-1,-1,2,110862474,110964775,102301,7851;4867,2
1,-1,2,110862474,110964775,102301,7851;4867,2
1,-1,2,110862474,110964775,102301,7851;4867,2
1,1,2,110862474,110964775,102301,7851;4867,2
1,-1,2,110862474,110964775,102301,7851;4867,2
1,-1,2,110862474,110964775,102301,7851;4867,2
1,-1,2,110862474,110964775,102301,7851;4867,2
-1,-1,2,110862474,111079065,216591,7851;4867,2
-1,-1,2,110862474,111128847,266373,7851;4867,2
-1,-1,2,110862477,110959127,96650,7851;4867,2
1,-1,2,110862477,110959127,96650,7851;4867,2
-1,1,2,110862477,110964737,102260,7851;4867,2
-1,1,2,110862477,110964737,102260,7851;4867,2
-1,1,2,110862477,110964737,102260,7851;4867,2
1,-1,2,110862477,110964737,102260,7851;4867,2
1,-1,2,110862477,110964737,102260,7851;4867,2
-1,-1,2,110862477,110964737,102260,7851;4867,2
1,-1,2,110862477,110964737,102260,7851;4867,2
1,-1,2,110862477,110964737,102260,7851;4867,2
-1,-1,2,110862477,110964737,102260,7851;4867,2
1,-1,2,110862477,110964737,102260,7851;4867,2
1,-1,2,110862477,110964737,102260,7851;4867,2
1,-1,2,110862477,110964737,102260,7851;4867,2
1,-1,2,110862477,110964737,102260,7851;4867,2
1,-1,2,110862477,110964737,102260,7851;4867,2
1,-1,2,110862477,110964737,102260,7851;4867,2
1,-1,2,110862477,110964737,102260,7851;4867,2
1,-1,2,110862477,110964737,102260,7851;4867,2
-1,-1,2,110862477,110966643,104166,7851;4867,2
-1,-1,2,110862477,110966643,104166,7851;4867,2
-1,-1,2,110862477,110966643,104166,7851;4867,2
-1,-1,2,110862477,110966643,104166,7851;4867,2
-1,-1,2,110862477,110966643,104166,7851;4867,2
-1,-1,2,110862477,110966643,104166,7851;4867,2
-1,-1,2,110862477,110966643,104166,7851;4867,2
-1,-1,2,110862477,111079057,216580,7851;4867,2
1,-1,2,110862477,111128847,266370,7851;4867,2
1,-1,2,110862477,111128847,266370,7851;4867,2
1,-1,2,110862477,111128847,266370,7851;4867,2
1,-1,2,110862477,111128847,266370,7851;4867,2
1,-1,2,110862477,111128847,266370,7851;4867,2
1,-1,2,110862477,111128847,266370,7851;4867,2
-1,-1,2,110862477,111368891,506414,729540;7851;100288695;4867,4
-1,-1,2,110873467,110966643,93176,7851;4867,2
-1,-1,2,110873467,110966643,93176,7851;4867,2
-1,-1,2,110873467,110966643,93176,7851;4867,2
-1,-1,2,110873992,110966643,92651,7851;4867,2
-1,-1,2,110873992,110966643,92651,7851;4867,2
-1,-1,2,110873992,110966643,92651,7851;4867,2
1,-1,2,110880671,110964775,84104,4867,1
1,-1,2,110881237,110964737,83500,4867,1
-1,-1,2,110901393,110980401,79008,4867,1
-1,-1,2,110901479,110980487,79008,4867,1
1,1,2,111335143,116733317,5398174,56300;57628;84172;84639;3553;150472;84269;84910;699;26525;27179;3552;200350;11159;27177;729540;376940;55289;27178;84524;150468;23550;64682;10018;6574;10461;80255;150465;129804;10096;7849;3557;727851,33
-1,1,2,111397715,113111856,1714141,10461;699;129804;10018;84910;64682;376940;55289;84524,9
-1,1,2,111406072,113111856,1705784,10461;699;129804;10018;84910;64682;376940;55289;84524,9
1,-1,2,112046584,112592176,545592,64682,1
1,-1,2,112046584,112592176,545592,64682,1
1,-1,2,112046584,112592176,545592,64682,1
1,-1,2,112046584,112592176,545592,64682,1
1,-1,2,112046584,112592176,545592,64682,1
1,-1,2,112046584,112592176,545592,64682,1
1,-1,2,112046584,112592176,545592,64682,1
1,-1,2,112046584,112592176,545592,64682,1
1,-1,2,112046584,112592176,545592,64682,1
1,-1,2,112046584,112592176,545592,64682,1
1,-1,2,112046584,112592176,545592,64682,1
1,-1,2,112046584,112592176,545592,64682,1
1,-1,2,112046584,112592176,545592,64682,1
1,-1,2,112046584,112592176,545592,64682,1
1,-1,2,112046584,112592176,545592,64682,1
1,-1,2,112046584,112592176,545592,64682,1
-1,-1,2,113735617,113891118,155501,56300;27177;3557;26525;84639;27179,6
-1,1,2,114056441,123673800,9617359,8886;57628;150472;51141;8685;1622;29842;84365;130355;5899;55240;5775;80775;54520;80255;7247;165257;10096;2019;200373;6344;200350;11159;79134;140738;23332;2736;57669;3625,29
-1,1,2,115758140,126444478,10686338,8886;57628;3625;51141;8685;1622;29842;84365;130355;5899;5775;55240;80775;54520;7247;165257;2019;200373;6344;79134;140738;23332;2736;57669;129684,25
-1,1,2,116059643,129828703,13769060,8886;57628;51141;8685;1622;29842;5433;56886;130355;5899;80775;54520;165257;2995;101929926;6344;5624;140738;10746;2736;57669;274;84826;129684;9394;55339;84365;4648;5775;55240;55679;339761;2071;7247;2840;2019;200373;79595;79134;23332;83607;55677;3625,43
-1,1,2,116754600,123897370,7142770,8886;51141;8685;1622;29842;84365;130355;5899;5775;55240;80775;54520;7247;165257;2019;200373;6344;79134;140738;23332;2736;57669;3625,23
-1,-1,2,117519462,117736809,217347,,0
1,-1,2,117803207,117913104,109897,,0
-1,1,2,119445405,122379390,2933985,8685;29842;1622;130355;5899;5775;55240;80775;2019;165257;200373;6344;79134;140738;23332;2736;57669;3625,18
-1,1,2,120571363,141627287,21055924,11249;728378;5433;29798;56886;5899;339745;2863;2995;5624;130013;653269;55627;3176;57669;9394;80097;91409;80731;84083;408029;653781;653275;55041;339761;7247;344148;344561;79595;79134;55677;50649;4249;53353;4175;205147;29842;81615;90557;80122;84084;101929926;23518;1615;7852;92856;905;22930;113457;10746;2736;84826;274;112714;129684;130074;55339;445582;646915;150786;55997;116372;84365;4648;5775;3938;55679;2071;2840;653784;84317;26469;23190;23332;83607;3625,76
-1,1,2,123927565,129217649,5290084,55339;5433;83607;56886;4648;55677;55679;339761;2071;2840;2995;101929926;5624;79595;10746;84826;274;129684;9394,19
-1,1,2,124203338,141350107,17146769,11249;728378;5433;29798;56886;339745;2863;2995;5624;130013;653269;55627;3176;9394;80097;91409;80731;84083;408029;653781;653275;55041;339761;344148;344561;79595;55677;50649;4249;53353;4175;205147;81615;90557;80122;84084;101929926;23518;1615;7852;92856;905;22930;113457;10746;84826;274;112714;129684;130074;55339;445582;646915;150786;55997;116372;4648;3938;55679;2071;2840;653784;84317;26469;23190;83607,66
-1,1,2,128490257,138210164,9719907,4249;4175;728378;205147;5433;29798;56886;81615;90557;80122;84084;2863;23518;1615;7852;92856;905;22930;113457;130013;653269;55627;112714;80097;9394;91409;130074;55339;646915;445582;150786;84083;408029;80731;55997;116372;653781;653275;55041;3938;653784;344148;344561;84317;26469;79595;23190;83607;50649,49
1,-1,2,130582258,131151349,569091,84084;91409;84317;728378;26469;92856;55627;112714;80097,9
1,-1,2,130634874,130877782,242908,84084;728378,2
1,-1,2,130694002,131198154,504152,84084;91409;84317;728378;26469;92856;55627;112714;80097,9
1,-1,2,130786789,131172028,385239,91409;84317;728378;26469;92856;55627;112714;80097,8
1,-1,2,130786789,131223148,436359,91409;84317;728378;26469;92856;653269;55627;112714;80097,9
1,-1,2,130834577,131223148,388571,91409;84317;728378;26469;92856;653269;55627;112714;80097,9
1,-1,2,130877782,131132074,254292,91409;84317;728378;26469;92856;55627;112714;80097,8
-1,-1,2,130928976,131147956,218980,92856;112714;55627;84317;26469;80097,6
-1,-1,2,130928976,131147956,218980,92856;112714;55627;84317;26469;80097,6
1,-1,2,131442815,131524418,81603,344561;205147,2
1,-1,2,131858430,131907307,48877,55041,1
1,-1,2,132068071,132266527,198456,150786;113457;653784,3
1,-1,2,132238316,132290940,52624,90557;113457;653784,3
1,-1,2,132287932,132508293,220361,90557;29798,2
1,-1,2,132287932,132558490,270558,90557;29798;408029,3
1,-1,2,132290940,132508293,217353,90557;29798,2
1,-1,2,132290940,132508293,217353,90557;29798,2
1,-1,2,132290940,132508293,217353,90557;29798,2
1,-1,2,132290940,132508293,217353,90557;29798,2
1,-1,2,132290940,132508293,217353,90557;29798,2
1,-1,2,132290940,132508293,217353,90557;29798,2
1,-1,2,132290940,132508293,217353,90557;29798,2
1,-1,2,132290940,132508293,217353,90557;29798,2
1,-1,2,132290940,132508293,217353,90557;29798,2
1,-1,2,132290940,132508293,217353,90557;29798,2
1,-1,2,132290940,132508293,217353,90557;29798,2
1,-1,2,132290940,132508293,217353,90557;29798,2
1,-1,2,132290940,132508293,217353,90557;29798,2
1,-1,2,132290940,132508293,217353,90557;29798,2
1,-1,2,132290940,132508293,217353,90557;29798,2
1,-1,2,132290940,132508293,217353,90557;29798,2
1,-1,2,132290940,132508293,217353,90557;29798,2
1,-1,2,132290940,132508293,217353,90557;29798,2
1,-1,2,132290940,132515623,224683,90557;29798,2
1,-1,2,132719325,132805998,86673,,0
1,-1,2,132862067,133327977,465910,2863;646915,2
-1,1,2,134733319,142089790,7356471,11249;4249;53353;4175;80731;84083;81615;3938;80122;339745;23518;1615;7852;905;22930;23190;130013;3176,18
1,1,2,136803050,143602728,6799678,11249;3176;339745;53353;80731;7852,6
-1,1,2,137694928,147439378,9744450,11249;339745;53353;80731;8942;79712;9839;3176;55843,9
-1,-1,2,140358784,140544934,186150,,0
-1,1,2,144051648,148471399,4419751,79712;9839;55843,3
1,1,2,144657717,159178136,14520419,130940;55777;7130;92;27249;79712;90;375287;55660;785;5000;3760;130574;26122;100144595;4929;9839;4703;390;11227;9111;56475;130576;151188;2820;151531;130399;114805;55183;57471;9595;3800;26225;114793;10254,35
-1,1,2,144796786,145564689,767903,79712;9839,2
-1,1,2,144970681,145425713,455032,79712;9839,2
-1,1,2,145192266,146949061,1756795,9839,1
-1,1,2,145192266,146949061,1756795,9839,1
-1,-1,2,145275158,145275207,49,9839,1
-1,1,2,146228621,150439084,4210463,130576;130574;55777;92;26122;3800;27249;5000,8
-1,1,2,146803587,149568729,2765142,92;26122;5000;55777,4
-1,1,2,146913477,151531586,4618109,130576;130574;55777;92;26122;3800;27249;5000;390,9
-1,1,2,147063452,154796058,7732606,9111;56475;130576;151188;55777;7130;92;27249;375287;55660;785;5000;114805;130574;55183;26122;3800;26225;114793;4703;390;10254,22
1,1,2,147081759,157075637,9993878,9111;56475;130576;151188;55777;7130;92;27249;375287;55660;785;5000;114805;3760;130574;55183;26122;3800;100144595;26225;114793;4703;390;10254,24
-1,1,2,148490468,148913835,423367,92;5000;55777,3
-1,1,2,148728326,148851964,123638,5000;55777,2
-1,1,2,148728409,149130479,402070,5000;55777,2
-1,1,2,148743880,148955720,211840,5000;55777,2
-1,1,2,148787060,149106568,319508,55777,1
-1,1,2,148842506,152370040,3527534,9111;130576;130574;55183;55777;7130;26122;27249;3800;375287;4703;390,12
-1,1,2,148893782,149041073,147291,55777,1
-1,1,2,148894900,148979973,85073,55777,1
-1,1,2,148897424,148979973,82549,55777,1
-1,1,2,148957572,149100105,142533,55777,1
-1,1,2,149198443,149948302,749859,130576;26122;55777;3800,4
1,1,2,149201266,149239392,38126,55777,1
-1,-1,2,150714201,150785122,70921,,0
-1,1,2,152478196,159367077,6888881,56475;10254;130940;151188;8502;2820;151531;90;55660;785;130399;114805;3760;57471;9595;100144595;4929;26225;114793;4703;11227,21
-1,1,2,152788858,160276245,7487387,56475;29994;130940;151188;10254;8502;2820;90;55660;151525;785;92196;130399;3760;114805;85461;57471;9595;100144595;4929;151531;114793;11227,23
-1,1,2,154466227,159041637,4575410,130940;57471;9595;2820;151531;90;4929;100144595;11227;130399;114805;3760,12
-1,1,2,154808441,159661860,4853419,130940;8502;57471;9595;2820;90;3760;4929;100144595;151531;130399;92196;114805;11227,14
1,1,2,155150555,176854100,21703545,6335;129446;151258;26003;10716;4065;130507;90;8647;100526664;100526832;3760;2591;10010;4036;83879;389058;22925;9541;2888;80856;100144595;2641;80034;6670;100131390;129880;10213;285141;11227;151556;29994;1386;254042;29789;8502;10170;79634;1781;27347;29081;1746;493911;130399;114805;55137;6332;129881;64135;64844;57471;1134;9595;151230;151531;8604;115677;1123;130940;6323;25801;79901;10324;51776;6328;253782;151525;9360;6326;140469;8520;22837;79675;57405;79828;518;2571;4929;1745;80067;79809;57818;57282;90134;2820;2191;92196;3655;5937;11069;6741;1803;85461;9936;9874;8708;5163;3694;7456,99
-1,1,2,155946236,165690342,9744106,130940;25801;10716;4065;90;100526664;151525;10010;22837;22925;2888;4929;2641;10213;11227;29994;57282;8502;90134;2820;2191;92196;130399;55137;5937;1803;85461;64135;64844;9936;57471;9595;151531;3694,34
1,-1,2,155981259,156724644,743385,,0
-1,1,2,157970774,169270675,11299901,6335;129446;130940;25801;151258;6323;10716;4065;90;6328;100526664;151525;6326;2591;10010;22837;22925;2888;2641;80034;10213;11227;79809;29994;57282;8502;90134;27347;2191;92196;130399;55137;5937;1803;6332;85461;64135;64844;9936;57471;9595;8708;151531;3694,44
-1,1,2,161773795,165310258,3536463,10010;1803;25801;10716;57282;64135;90134;55137;2641;2191;10213,11
1,1,2,163168812,167567296,4398484,6326;79809;2591;6335;6323;25801;151258;22837;6332;64135;90134;2888;6328;80034;55137,15
-1,1,2,164366067,169069454,4703387,6326;79809;2591;6335;6323;129446;151258;22837;6332;2888;6328;8708;27347;80034;55137,15
-1,1,2,164544321,170254661,5710340,115677;79809;6335;129446;6323;57818;151258;10170;8647;6328;27347;253782;55137;6326;2591;6332;22837;4036;57405;2888;8708;80034,22
-1,1,2,165663529,166239664,576135,6326;6328;151258;22837,4
1,1,2,165777072,168392949,2615877,6326;79809;2591;6335;6323;129446;151258;6332;6328;80034,10
-1,1,2,166032047,168283204,2251157,6326;79809;2591;6335;6323;129446;6332;6328;80034,9
-1,1,2,166079508,167521122,1441614,6326;79809;2591;6335;6323;6332;80034,7
-1,1,2,166094935,166971492,876557,6326;79809;2591;6323;80034,5
-1,1,2,166374955,169671203,3296248,79809;115677;2591;6335;6323;129446;6332;8708;27347;80034;253782,11
-1,1,2,166602662,167462305,859643,79809;2591;6335;6323;6332,5
-1,1,2,166744822,167042321,297499,79809;6323,2
-1,1,2,166842607,167300045,457438,6335;6323;6332,3
-1,1,2,167300067,175350537,8050470,115677;129446;79901;26003;10324;130507;51776;8647;253782;100526832;9360;140469;8520;4036;79675;83879;57405;389058;79828;9541;2571;1745;8604;6670;100131390;129880;80067;285141;57818;151556;254042;29789;10170;79634;1781;27347;29081;1746;493911;3655;11069;6741;6332;129881;9874;8708;151230;5163,48
1,1,2,169829974,215521436,45691462,1493;129831;344191;1281;56171;54891;79582;130540;5136;150737;51661;129450;3234;83879;389058;9541;80856;84128;66037;4709;5334;6670;100131390;23451;79800;285141;51454;151556;151195;1386;114880;91752;29789;8540;2066;10170;79634;1781;92935;91404;2825;29081;23314;66008;57520;1290;1933;1419;1373;129881;55437;659;29851;8575;3628;22807;3685;3329;1385;100130451;1123;6120;130132;2744;10324;51776;8837;60491;843;55759;100131211;9360;4719;3236;140469;8520;1421;151126;130026;30061;79828;3336;79568;4632;92104;1195;58538;33;205327;3233;150864;220988;100529241;3231;9330;80055;3655;5746;6741;2487;94101;401027;7341;54431;5378;9874;3676;285025;25843;4999;7035;3235;9262;26003;130749;3417;57683;130507;51602;10314;8647;4760;6775;54842;3232;3238;100526832;10203;84281;53938;57404;4780;26010;4036;65065;389072;494513;57679;8828;3237;6772;375298;129880;150709;254042;8324;200576;50940;402117;117583;8436;1746;493911;151246;64859;10787;8609;151242;55854;26275;4664;1134;5163;4430;151230;9689;130535;2660;8604;165215;142679;200726;23671;79901;116093;940;391475;285172;80219;151194;91526;151112;57703;129401;79675;518;54529;2571;1745;10651;10477;316;100652824;80067;65062;65061;389073;3239;57181;6744;151254;65059;1418;285175;64172;10152;130752;841;7855;151050;11069;4133;8745;22868;1420;284992;65977;7273;7456,219
-1,1,2,172285743,190044294,17758551,3235;129831;344191;1281;4760;5136;150737;51661;3232;3238;10203;4780;3234;83879;494513;9541;80856;3237;100131390;6670;375298;51454;151556;1386;114880;91752;29789;254042;8540;50940;79634;1781;91404;1746;1290;10787;151242;55854;1134;8575;8604;165215;3685;142679;1123;79901;116093;51776;151112;57703;3236;129401;8520;151126;79828;518;1745;10651;10477;92104;80067;3239;3233;220988;6744;3231;3655;11069;2487;54431;3676;285025;7035;5163;65977;7273;7456,77
-1,1,2,172369557,178718807,6349250,3235;1123;79901;344191;51776;150737;3232;3238;3236;4780;3234;8520;83879;9541;518;80856;3237;1745;10651;8604;100131390;6670;92104;151556;3239;1386;254042;29789;3233;8540;220988;50940;79634;1781;1746;3231;3655;11069;1134;5163;7456,41
-1,1,2,174002600,181269396,7266796,3235;1123;129831;344191;51776;150737;3232;3238;51661;57703;3236;4780;3234;151126;83879;494513;9541;518;80856;3237;10651;100131390;6670;92104;151556;3239;1386;114880;3233;29789;8540;220988;50940;79634;91404;3231;1134;8575;285025;65977;7273;7456,42
-1,1,2,174578566,176332190,1753624,151556;1123;1386;29789;6670;1134;79634;9541;518;100131390;7456,11
-1,1,2,175101179,182053573,6952394,3235;1123;129831;344191;150737;3232;3238;51661;57703;3236;4780;3234;151126;494513;9541;518;80856;3237;10651;10477;100131390;92104;151556;3239;1386;114880;3233;29789;8540;220988;50940;79634;91404;3231;1134;8575;285025;65977;7273;7456,40
-1,1,2,175499230,189865690,14366460,3235;1123;129831;116093;344191;1281;4760;5136;150737;3232;3238;51661;57703;151112;3236;129401;4780;10203;142679;3234;151126;494513;518;80856;3237;10651;10477;375298;92104;51454;3239;1386;114880;3233;91752;8540;220988;50940;6744;91404;3231;10787;151242;55854;2487;1134;54431;3676;8575;285025;7035;165215;65977;3685;7273;7456,56
-1,1,2,176940017,177020985,80968,3235;3239;3234;3233;344191;3237;3238;3236,8
-1,1,2,176951491,194066696,17115205,3235;129831;1281;4760;6775;5136;150737;3232;3238;51661;10203;84281;54842;4780;3234;494513;3237;84128;6772;375298;150709;51454;114880;91752;8540;50940;91404;8436;1290;64859;10787;151242;55854;26275;4664;8575;4430;2660;3628;165215;3685;142679;23671;116093;2744;100131211;151112;57703;3236;129401;151126;30061;54529;10651;10477;92104;3239;3233;220988;6744;64172;3231;2487;94101;54431;5378;3676;285025;7035;65977;7273,71
1,-1,2,176989222,176989646,424,3235,1
-1,1,2,177052046,182008082,4956036,129831;114880;8540;220988;50940;91404;150737;51661;57703;3231;4780;151126;65977;494513;8575;285025;10651;10477;92104;7273,20
-1,1,2,178692457,195990053,17297596,129831;23671;116093;1281;2744;4760;6775;100131211;5136;51661;10203;151112;54842;57703;84281;129401;142679;151126;30061;494513;54529;84128;10477;6772;375298;150709;51454;114880;91752;50940;6744;91404;64172;8436;7035;1290;64859;10787;151242;55854;2487;94101;26275;4664;54431;5378;165215;3676;8575;285025;4430;2660;3628;65977;3685;7273,56
1,1,2,181378520,225167565,43789045,1493;130617;10290;26154;1281;56171;54891;79582;3623;130540;5136;53632;129450;580;84812;79065;7857;55825;8576;1412;23363;57574;84128;66037;27148;4709;5334;151050;23451;79800;51454;151195;25953;91752;2066;64320;64114;2335;2825;92935;50485;23314;66008;57520;1290;1933;1419;1373;7277;5270;54738;55437;3485;659;29851;130340;80326;3628;22807;3685;3329;1385;100130451;65080;6120;29926;130132;2744;8837;843;60491;7520;9654;55759;255101;1593;100131211;4719;14;23549;1421;130026;30061;100996693;3336;79568;3549;4632;58538;1195;7141;33;7145;23704;205327;150864;55686;471;100529241;79137;9330;80055;5746;3579;6508;116255;2487;94101;401027;7341;54431;5378;27013;389075;3676;79586;130367;25843;4999;7035;9125;5077;151306;151295;9262;130749;3417;57683;51602;10314;79411;4760;6775;54842;10203;53938;84281;57404;10109;114790;26010;130612;5798;57590;65065;6168;389072;57679;8828;6556;1674;6772;375298;617;150709;8324;7429;200576;2181;285180;10056;402117;55139;117583;8436;2043;151246;64859;10787;8609;151242;55854;26275;4664;4430;9689;130535;2660;79840;165215;142679;200726;23671;116093;940;8941;3300;391475;285172;80219;151194;3488;91526;151112;129401;55515;57695;7701;54529;10477;316;3577;100652824;65062;389073;65061;92691;57181;6744;151254;65059;1418;285175;10058;64172;58190;10152;130752;841;7855;375307;4133;8745;22868;151278;7475;1420;284992,228
-1,1,2,181807629,188237115,6429486,91752;6744;4760;5136;10203;151112;142679;129401;10787;151242;55854;2487;54431;3676;10477;165215;375298;3685,18
-1,1,2,182623428,192880118,10256690,23671;116093;1281;2744;2660;3628;6775;100131211;5136;54842;10203;151112;84281;142679;129401;30061;54529;84128;6772;150709;51454;91752;6744;64172;8436;1290;64859;10787;151242;55854;2487;94101;26275;4664;54431;5378;4430;7035;165215;3685,40
1,-1,2,183059730,183500040,440310,5136,1
1,-1,2,184973933,185090910,116977,,0
1,-1,2,184973933,185090910,116977,,0
-1,1,2,186892199,201924095,15031896,9262;1281;56171;6775;54842;10203;53938;129450;84281;26010;84128;66037;6772;5334;150709;23451;51454;92935;23314;8436;57520;1290;151246;64859;55854;26275;4664;4430;9689;130535;2660;3628;165215;3685;3329;23671;116093;130132;2744;285172;80219;60491;100131211;91526;151112;30061;54529;3336;79568;316;1195;57181;205327;100529241;64172;9330;80055;94101;401027;5378;25843;4999;7035;284992,64
-1,-1,2,187080149,187173729,93580,,0
-1,-1,2,187976139,188113321,137182,,0
-1,-1,2,189200405,189368467,168062,51454,1
-1,-1,2,189248503,189354495,105992,51454,1
-1,-1,2,189354436,189462552,108116,51454,1
-1,1,2,189812229,190554339,742110,54529;84128;1281;30061;1290;150709,6
1,1,2,190300875,242783384,52482509,1493;130617;10290;1285;56171;79582;84289;3623;6694;130916;84812;79065;10316;93010;8576;23363;150681;151050;5334;25953;79800;248;55230;9208;64320;64114;2335;50485;57520;1419;7277;5270;1933;81618;5757;54575;285193;130340;80326;100130451;3329;1385;6120;23677;843;8837;5510;2744;255101;377007;84236;55759;100131211;4705;150677;4719;23549;1286;646960;30061;100996693;547;339766;4632;55054;58538;7141;8527;79919;33;375316;55686;471;79137;9330;5746;3579;130888;389075;25843;4999;5077;151306;9262;151176;6364;3417;57683;51602;10314;79411;54842;53938;84281;10109;26010;5798;57590;65065;6168;8828;1674;617;79781;8324;7429;6295;200576;285180;54659;10056;55139;151246;64859;55502;8609;26275;93349;51719;9290;26146;5147;5707;80895;79843;23671;3431;391475;10123;285172;51665;257407;91526;57007;129807;92737;4691;130560;51540;54529;375318;3577;65062;389073;65061;51052;151254;1418;285175;10058;164781;55355;58190;6672;130752;79054;7855;80210;8745;57624;22868;7475;11262;9470;250;151278;1420;284992;9320;9855;54658;79853;26154;54891;130540;53632;129450;580;7857;55825;79083;1412;57574;54579;84128;54578;66037;27148;4709;23451;151195;57140;25992;3635;54657;2066;2637;3667;389090;2825;92935;23314;66008;23192;1373;56918;10494;54738;3069;117581;55437;3485;1146;659;25791;29851;3628;22807;65080;29926;130132;60491;7520;9654;1593;4759;14;151473;150678;1421;130026;140739;2817;4735;401036;3336;79568;3549;116987;1195;7145;23704;3769;205327;150864;100529241;80055;54600;6508;116255;94101;27013;401027;7341;5378;666;130367;79586;9125;653437;151295;389084;728294;64090;4880;8452;130749;6775;339768;64708;26058;57404;3267;2859;114790;64284;130612;10267;389072;6556;57679;414061;189;9759;1144;129563;51078;6772;55619;150709;2181;11132;402117;117583;8436;2043;54577;54576;4664;4430;8864;9689;130535;2660;79840;80309;80303;1293;23178;200726;3357;165100;8941;940;3300;10920;80219;151194;9427;80704;3488;1841;55515;57695;7701;200765;56947;316;55022;100652824;251;92691;57181;65059;64172;10152;841;375307;4133;51281;50636,341
-1,1,2,190693680,190718652,24972,5378,1
-1,1,2,193803552,216569775,22766223,1493;9262;26154;130749;56171;54891;79582;3417;57683;51602;10314;130540;53938;129450;57404;26010;580;65065;389072;57679;8828;66037;4709;5334;151050;23451;79800;151195;8324;200576;2066;2335;2825;92935;402117;23314;66008;117583;57520;1419;1933;1373;151246;8609;55437;659;29851;9689;130535;22807;100130451;3329;1385;200726;6120;130132;940;843;8837;391475;285172;60491;80219;151194;55759;91526;4719;1421;130026;3336;79568;316;4632;100652824;58538;1195;65062;33;389073;65061;57181;205327;150864;471;100529241;65059;151254;1418;285175;10152;130752;9330;80055;5746;841;7855;4133;401027;8745;7341;22868;25843;4999;1420;284992,105
-1,-1,2,194384503,194718630,334127,,0
-1,1,2,194581315,201752422,7171107,9262;57181;130132;205327;1195;56171;80219;100529241;92935;91526;23314;53938;129450;57520;9330;80055;151246;26010;401027;3336;284992;79568;66037;25843;316;9689;130535;5334;23451;3329,30
-1,-1,2,195062547,195217271,154724,,0
-1,1,2,196525318,204834211,8308893,1493;9262;130132;940;56171;843;8837;285172;80219;60491;51602;55759;91526;130540;53938;129450;57404;26010;130026;65065;57679;3336;79568;66037;316;4709;5334;100652824;58538;23451;1195;65062;65061;79800;57181;205327;8324;150864;100529241;151254;65059;92935;23314;66008;10152;57520;9330;80055;151246;841;401027;55437;7341;659;29851;25843;9689;130535;4999;284992;3329,61
-1,1,2,197990184,200606471,2616287,130132;80219;100529241;3336;92935;25843;91526;66037;23314;5334;23451;3329,12
-1,1,2,199360964,200290254,929290,23314,1
-1,1,2,199632071,203218563,3586492,205327;8324;65061;843;8837;285172;51602;60491;151254;130540;23314;66008;53938;129450;841;151246;26010;55437;7341;57679;79568;9689;130535;316;4999;4709;100652824;58538;1195;65062,30
-1,1,2,200165950,200205229,39279,23314,1
-1,1,2,200801996,210896648,10094652,1493;130749;54891;57683;3417;51602;130540;53938;129450;57404;26010;65065;389072;57679;8828;4709;151050;79800;151195;8324;200576;2825;117583;66008;1419;151246;1933;8609;55437;659;29851;9689;130535;1385;200726;6120;940;843;8837;285172;391475;60491;151194;55759;4719;1421;130026;79568;316;100652824;58538;1195;65062;65061;389073;150864;65059;151254;1418;285175;10152;130752;841;7855;5746;4133;8745;7341;22868;4999;1420,71
-1,1,2,200811217,210849919,10038702,1493;130749;54891;57683;3417;51602;130540;53938;129450;57404;26010;65065;389072;57679;8828;4709;79800;151195;8324;200576;2825;117583;66008;1419;151246;1933;8609;55437;659;29851;9689;130535;1385;200726;940;843;8837;285172;391475;60491;151194;55759;4719;1421;130026;79568;316;100652824;58538;1195;65062;65061;389073;150864;65059;151254;1418;285175;10152;130752;841;7855;5746;4133;8745;7341;22868;4999;1420,69
-1,1,2,201211431,202021140,809709,26010;1195;8837;285172;60491;9689;130535;316;4999;4709;53938;151246,12
-1,1,2,203309853,203496210,186357,659,1
-1,1,2,203412125,203441031,28906,659,1
-1,1,2,203496151,205794583,2298432,1493;130026;150864;65065;940;65059;29851;55759;117583;10152;57404;79800,12
-1,1,2,205771566,210896173,5124607,6120;130749;54891;57683;391475;3417;200576;151194;1418;285175;2825;117583;130752;7855;4719;1419;1933;5746;1385;8609;389073;1421;4133;8745;389072;1420;8828;22868;151050;151195;200726,31
-1,1,2,207923610,212110328,4186718,6120;4632;3417;200576;151194;10314;1418;285175;7855;1419;1373;5746;1385;8609;1421;4133;151195;389072;1420;151050;389073;33,22
1,1,2,211444400,243059659,31615259,130617;10290;54658;79853;26154;1285;84289;79582;3623;285093;53632;6694;580;84812;79065;7857;10316;55825;93010;8576;130916;79083;1412;23363;57574;54579;150681;54578;27148;25953;57140;25992;248;55230;9208;3635;54657;2066;64320;2637;64114;2335;3667;389090;50485;23192;1373;5270;5757;7277;81618;54738;56918;3069;10494;117581;54575;3485;1146;285193;25791;130340;80326;22807;100130451;65080;29926;23677;5510;377007;255101;7520;9654;84236;1593;4705;150677;151473;14;23549;1286;4759;646960;150678;140739;2817;4735;100996693;401036;11262;3549;339766;547;55054;116987;7141;8527;79919;7145;23704;3769;375316;55686;471;79137;54600;6508;3579;116255;27013;130888;389075;666;79586;130367;5077;9125;653437;151306;151295;389084;728294;151176;4880;64090;6364;8452;79411;339768;64708;26058;10109;3267;114790;2859;130612;64284;5798;57590;10267;6168;6556;414061;9759;1674;1144;189;129563;51078;617;55619;79781;7429;6295;2181;285180;54659;11132;10056;402117;55139;2043;54577;55502;54576;93349;51719;250;9290;8864;26146;5147;79840;80303;80309;5707;1293;23178;80895;5133;3357;165100;79843;8941;3431;3300;10920;10123;3488;80704;9427;51665;257407;57007;129807;1841;55515;57695;92737;4691;7701;130560;51540;200765;56947;375318;3577;55022;251;92691;51052;10058;164781;6672;58190;55355;79054;375307;80210;57624;51281;151278;7475;50636;9470;9320;9855,227
-1,-1,2,212360252,212412705,52453,2066,1
1,1,2,213518431,242783384,29264953,130617;10290;54658;79853;26154;1285;84289;79582;3623;53632;6694;580;84812;79065;7857;10316;55825;93010;8576;130916;79083;1412;23363;57574;54579;150681;54578;27148;25953;57140;25992;248;55230;9208;3635;54657;64320;2637;64114;2335;3667;389090;50485;23192;5270;5757;7277;81618;54738;56918;3069;10494;117581;54575;3485;1146;285193;25791;130340;80326;22807;100130451;65080;29926;23677;5510;377007;255101;7520;9654;84236;1593;4705;150677;151473;14;23549;1286;4759;646960;150678;140739;2817;4735;100996693;401036;3549;339766;547;55054;116987;7141;8527;79919;7145;23704;3769;375316;55686;471;79137;54600;6508;3579;116255;27013;130888;389075;666;79586;130367;5077;9125;653437;151306;151295;389084;728294;151176;4880;64090;6364;8452;79411;339768;64708;26058;10109;3267;114790;2859;130612;64284;5798;57590;10267;6168;6556;414061;9759;1674;1144;9470;129563;189;51078;617;55619;79781;7429;6295;2181;285180;54659;11132;10056;402117;55139;2043;50636;54577;55502;54576;93349;51719;250;9290;8864;26146;5147;79840;80303;80309;5707;1293;23178;80895;3357;165100;79843;8941;3431;3300;10920;10123;3488;80704;9427;51665;257407;57007;129807;1841;55515;57695;92737;4691;7701;130560;51540;200765;56947;375318;3577;55022;251;92691;51052;10058;164781;6672;58190;55355;79054;375307;80210;57624;51281;7475;11262;151278;9320;9855,223
1,1,2,217131569,217647069,515500,3488;57574;50485;6168;3485,5
1,1,2,218966482,243059659,24093177,130617;10290;54658;79853;1285;84289;3623;285093;53632;6694;84812;79065;7857;130916;10316;93010;8576;79083;1412;23363;54579;150681;54578;27148;25953;57140;25992;248;55230;9208;3635;54657;64320;2637;64114;3667;389090;23192;5270;5757;7277;81618;54738;56918;3069;10494;117581;54575;285193;1146;25791;130340;80326;65080;29926;23677;5510;377007;255101;84236;9654;1593;4705;150677;151473;1286;14;23549;4759;646960;150678;140739;2817;4735;100996693;401036;3549;339766;547;55054;116987;79919;8527;23704;3769;375316;79137;54600;6508;3579;116255;27013;130888;389075;666;79586;130367;5077;9125;653437;151306;151295;389084;728294;151176;4880;64090;6364;8452;79411;339768;64708;26058;10109;3267;114790;2859;130612;64284;5798;57590;10267;6556;414061;9759;1674;1144;9470;129563;189;51078;617;55619;79781;7429;6295;2181;54659;11132;10056;55139;2043;50636;54577;55502;54576;93349;51719;250;9290;8864;26146;5147;79840;80303;80309;5707;1293;23178;80895;5133;3357;165100;79843;8941;3431;3300;10920;10123;9427;80704;51665;257407;57007;129807;1841;55515;57695;92737;4691;7701;130560;51540;200765;56947;375318;3577;55022;251;51052;10058;164781;6672;58190;55355;79054;375307;80210;57624;51281;7475;11262;151278;9320;9855,205
1,1,2,219966808,237815985,17849177,130617;10290;54658;79853;4880;6364;1285;8452;3623;79411;64708;6694;26058;3267;114790;79065;7857;130612;10316;93010;5798;8576;57590;23363;414061;54579;1674;1144;129563;54578;55619;79781;248;55230;3635;54657;2637;6295;2181;3667;54659;10056;55139;2043;5270;5757;7277;54577;81618;56918;54576;54575;1146;93349;51719;25791;9290;130340;5147;79840;80303;5707;80309;65080;3357;29926;165100;79843;23677;3431;3300;10123;84236;9427;80704;257407;57007;151473;1286;23549;4759;55515;646960;92737;4691;100996693;401036;130560;11262;200765;56947;339766;55022;55054;116987;251;8527;23704;3769;10058;164781;6672;55355;79137;79054;54600;6508;116255;80210;27013;130888;389075;57624;79586;130367;151278;5077;250;9470;151295;9320;389084,122
1,1,2,222077224,239394441,17317217,54658;151176;79853;4880;6364;1285;8452;339768;64708;6694;26058;3267;64284;7857;10316;93010;57590;10267;79083;414061;54579;9470;1144;129563;54578;55619;79781;248;55230;9208;3635;54657;2637;6295;2181;3667;54659;10056;2043;5270;5757;54577;81618;55502;56918;54576;54575;1146;93349;51719;25791;9290;130340;8864;26146;5147;80303;5707;80309;1293;80895;65080;3357;165100;79843;23677;3431;10920;377007;10123;84236;9427;80704;51665;257407;57007;151473;1286;4759;646960;140739;92737;4691;130560;401036;51540;11262;200765;56947;339766;55022;55054;116987;251;8527;23704;3769;375316;51052;164781;55355;6672;79054;54600;116255;80210;130888;57624;130367;5077;250;151278;9320;389084,114
-1,1,2,222528222,225290900,2762678,116255;23704;79843;7857;57590;2181;10056;130367;130340;5077;151278;5270;65080,13
1,1,2,228878865,235885068,7006203,3357;54658;165100;4880;3431;23677;10123;9427;257407;64708;6694;151473;26058;4759;646960;10316;93010;92737;4691;130560;11262;414061;200765;54579;1144;129563;54578;55022;339766;55054;251;8527;3769;248;55230;3635;6295;54657;5707;54659;55355;6672;79054;5757;54600;54577;81618;80210;54576;54575;130888;93349;51719;250;1146;25791;9290;5147;80303;80309;9470;9320;389084,63
1,1,2,229588295,242344282,12755987,54658;151176;4880;339768;64708;6694;26058;2859;130916;64284;10316;93010;10267;79083;414061;54579;150681;9759;189;1144;54578;129563;9470;79781;57140;25992;248;55230;9208;3635;54657;2637;6295;54659;11132;389090;5757;54577;81618;55502;3069;54576;117581;54575;285193;1146;93349;51719;250;25791;9290;8864;26146;5147;80303;5707;23178;1293;80895;3357;165100;23677;3431;5510;377007;10920;10123;9427;51665;257407;4705;57007;150677;151473;4759;646960;150678;140739;2817;4735;92737;4691;401036;130560;51540;200765;11262;375318;339766;547;55022;55054;116987;79919;8527;251;3769;375316;51052;55355;6672;79054;54600;80210;130888;51281;50636;653437;9320;389084;9855,111
1,1,2,230302785,234229532,3926747,3357;165100;4880;3431;9427;257407;64708;151473;26058;4759;646960;10316;93010;92737;4691;130560;200765;1144;129563;55054;251;3769;248;3635;6295;5707;6672;5757;81618;80210;130888;93349;51719;250;1146;25791;9290;5147;80303;11262;9470;9320;389084,43
-1,-1,2,230549473,230582451,32978,92737,1
1,-1,2,231250430,231378240,127810,93349;6672,2
-1,1,2,232634989,243059659,10424670,54658;151176;4880;64090;84289;285093;339768;64708;6694;26058;2859;130916;64284;10267;79083;414061;54579;150681;9759;189;1144;54578;129563;51078;9470;79781;57140;25992;248;55230;9208;3635;54657;2637;6295;54659;11132;389090;23192;54577;55502;3069;10494;54576;117581;54575;285193;1146;250;25791;8864;26146;5147;80303;23178;1293;80895;5133;23677;5510;377007;10920;10123;9427;51665;4705;57007;150677;129807;4759;1841;646960;150678;140739;2817;4735;9855;401036;51540;200765;375318;339766;547;55054;116987;79919;8527;251;3769;375316;51052;55355;79054;54600;51281;666;50636;653437;389084;728294,100
-1,1,2,232634989,243059659,10424670,54658;151176;4880;64090;84289;285093;339768;64708;6694;26058;2859;130916;64284;10267;79083;414061;54579;150681;9759;189;1144;54578;129563;51078;9470;79781;57140;25992;248;55230;9208;3635;54657;2637;6295;54659;11132;389090;23192;54577;55502;3069;10494;54576;117581;54575;285193;1146;250;25791;8864;26146;5147;80303;23178;1293;80895;5133;23677;5510;377007;10920;10123;9427;51665;4705;57007;150677;129807;4759;1841;646960;150678;140739;2817;4735;9855;401036;51540;200765;375318;339766;547;55054;116987;79919;8527;251;3769;375316;51052;55355;79054;54600;51281;666;50636;653437;389084;728294,100
-1,1,2,232756751,233517015,760264,646960;248;4880;1146;9427;200765;1144;129563;80303;250;9470;251,12
-1,1,2,232756751,233517015,760264,646960;248;4880;1146;9427;200765;1144;129563;80303;250;9470;251,12
1,-1,2,233240916,233407378,166462,9427;646960;248;1144;250;251;1146,7
1,-1,2,233396286,233409433,13147,1144;1146,2
-1,1,2,233784243,243040217,9255974,54658;151176;64090;84289;285093;339768;6694;2859;130916;64284;10267;79083;414061;54579;150681;9759;189;54578;51078;79781;57140;25992;55230;9208;3635;54657;2637;6295;54659;11132;389090;23192;54577;55502;3069;10494;54576;117581;54575;285193;25791;8864;26146;23178;1293;80895;5133;23677;5510;377007;10920;10123;51665;4705;57007;150677;129807;4759;1841;150678;140739;2817;4735;9855;401036;51540;375318;339766;547;55054;116987;79919;8527;375316;51052;55355;79054;54600;51281;666;50636;653437;728294,83
-1,1,2,233891213,243059659,9168446,54658;151176;64090;84289;285093;339768;6694;2859;130916;64284;10267;79083;414061;54579;150681;9759;189;54578;51078;79781;57140;25992;55230;9208;3635;54657;2637;6295;54659;11132;389090;23192;54577;55502;3069;10494;54576;117581;54575;285193;8864;26146;23178;1293;80895;5133;23677;5510;377007;10920;10123;51665;4705;57007;150677;129807;4759;1841;150678;140739;2817;4735;9855;401036;51540;375318;339766;547;55054;116987;79919;8527;375316;51052;55355;79054;54600;51281;666;50636;653437;728294,82
-1,1,2,234495262,242783384,8288122,54658;151176;64090;84289;339768;6694;2859;130916;64284;10267;79083;414061;54579;9759;150681;189;54578;51078;79781;57140;25992;9208;54657;2637;54659;11132;389090;23192;54577;55502;3069;10494;54576;117581;54575;285193;8864;26146;23178;1293;80895;23677;10920;10123;377007;5510;51665;4705;57007;150677;1841;129807;150678;140739;2817;4735;9855;401036;51540;375318;339766;547;116987;79919;51052;375316;55355;79054;54600;51281;666;50636;653437;728294,74
-1,1,2,234495262,242783384,8288122,54658;151176;64090;84289;339768;6694;2859;130916;64284;10267;79083;414061;54579;9759;150681;189;54578;51078;79781;57140;25992;9208;54657;2637;54659;11132;389090;23192;54577;55502;3069;10494;54576;117581;54575;285193;8864;26146;23178;1293;80895;23677;10920;10123;377007;5510;51665;4705;57007;150677;1841;129807;150678;140739;2817;4735;9855;401036;51540;375318;339766;547;116987;79919;51052;375316;55355;79054;54600;51281;666;50636;653437;728294,74
-1,-1,2,234651441,234652419,978,54576;54575;54657;54659;414061;54579;54578;54600;54577,9
-1,1,2,234967401,240365384,5397983,151176;51052;23677;9208;375316;2637;10920;10123;377007;51665;339768;57007;6694;55502;1293;64284;117581;10267;140739;79083;401036;51540;9759;8864;26146;116987;79781;80895,28
-1,1,2,235068297,242783384,7715087,151176;64090;23677;84289;10920;10123;377007;5510;51665;728294;339768;4705;57007;150677;1841;129807;2859;130916;64284;150678;10267;140739;2817;4735;79083;401036;51540;9759;150681;375318;189;51078;547;116987;79781;79919;57140;25992;51052;9208;375316;2637;11132;389090;23192;55502;3069;10494;117581;51281;285193;666;8864;26146;23178;50636;653437;1293;80895;9855,60
-1,1,2,235539337,242783384,7244047,151176;64090;23677;84289;10920;377007;5510;51665;728294;339768;4705;57007;150677;1841;129807;2859;130916;64284;150678;10267;140739;2817;4735;79083;401036;51540;9759;150681;375318;189;51078;547;116987;79781;79919;57140;25992;51052;9208;375316;2637;11132;389090;23192;55502;3069;10494;117581;51281;285193;666;8864;26146;23178;50636;653437;1293;80895;9855,59
-1,1,2,235744424,243007359,7262935,151176;64090;23677;84289;10920;377007;5510;285093;51665;728294;339768;4705;57007;150677;1841;129807;2859;130916;64284;150678;10267;140739;2817;4735;79083;401036;51540;5133;9759;150681;375318;189;51078;547;116987;79781;79919;57140;25992;51052;9208;375316;2637;11132;389090;23192;55502;3069;10494;117581;51281;285193;666;8864;26146;23178;50636;653437;1293;80895;9855,61
-1,1,2,235937073,243008259,7071186,151176;64090;23677;84289;10920;377007;5510;285093;51665;339768;4705;57007;150677;1841;129807;2859;130916;64284;150678;10267;140739;2817;4735;79083;401036;51540;9855;9759;150681;375318;189;51078;547;116987;79781;79919;57140;25992;51052;9208;375316;2637;11132;389090;23192;80895;55502;3069;10494;117581;51281;285193;666;8864;26146;23178;50636;653437;1293;5133;728294,61
1,-1,2,236115385,236420380,304995,116987,1
-1,1,2,236285213,242783384,6498171,151176;64090;84289;10920;377007;5510;51665;728294;339768;4705;57007;150677;1841;129807;2859;130916;64284;150678;10267;140739;2817;4735;79083;401036;51540;9759;150681;375318;189;51078;547;116987;79781;79919;57140;25992;51052;9208;375316;2637;11132;389090;23192;55502;3069;10494;117581;51281;285193;666;8864;26146;23178;50636;653437;1293;80895;9855,58
-1,1,2,236512248,242710466,6198218,151176;84289;10920;377007;5510;51665;339768;4705;57007;150677;1841;2859;130916;64284;150678;10267;140739;2817;4735;79083;401036;51540;9855;9759;150681;375318;189;51078;547;116987;79781;79919;57140;25992;51052;9208;375316;2637;11132;389090;23192;55502;3069;10494;117581;51281;285193;666;8864;26146;23178;50636;653437;1293;80895;728294,56
-1,1,2,236577291,242783384,6206093,151176;64090;84289;10920;377007;5510;51665;339768;4705;57007;150677;1841;129807;2859;130916;64284;150678;10267;140739;2817;4735;79083;401036;51540;9855;9759;150681;375318;189;51078;547;116987;79781;79919;57140;25992;51052;9208;375316;2637;11132;389090;23192;55502;3069;10494;117581;51281;285193;666;8864;26146;23178;50636;653437;1293;80895;728294,58
-1,1,2,236665742,240365384,3699642,151176;51052;9208;375316;2637;10920;377007;51665;339768;57007;55502;1293;64284;117581;10267;140739;79083;401036;51540;9759;8864;26146;116987;79781;80895,25
-1,1,2,236755560,242783384,6027824,151176;64090;84289;10920;377007;5510;51665;339768;4705;57007;150677;1841;129807;2859;130916;64284;150678;10267;140739;2817;4735;79083;401036;51540;9855;9759;150681;375318;189;51078;547;116987;79781;79919;57140;25992;51052;9208;375316;2637;11132;389090;23192;55502;3069;10494;117581;51281;285193;666;8864;26146;23178;50636;653437;1293;80895;728294,58
-1,1,2,236911223,242783384,5872161,151176;64090;84289;10920;377007;5510;51665;339768;4705;57007;150677;1841;129807;2859;130916;64284;150678;10267;140739;2817;4735;79083;401036;51540;9855;9759;150681;375318;189;51078;547;116987;79781;79919;57140;25992;51052;9208;375316;2637;11132;389090;23192;55502;3069;10494;117581;51281;285193;666;8864;26146;23178;50636;653437;1293;80895;728294,58
-1,1,2,237322365,243059659,5737294,151176;64090;84289;10920;377007;5510;285093;51665;339768;4705;57007;150677;1841;129807;2859;130916;64284;150678;10267;140739;2817;4735;79083;51540;9855;9759;150681;375318;189;51078;547;79781;79919;57140;25992;51052;9208;375316;11132;389090;23192;80895;55502;3069;10494;117581;51281;285193;666;8864;26146;23178;50636;653437;1293;5133;728294,57
-1,1,2,237545100,242783384,5238284,151176;64090;84289;10920;377007;5510;51665;728294;339768;4705;150677;1841;129807;2859;130916;64284;150678;10267;140739;2817;4735;79083;51540;9759;150681;375318;189;51078;547;79919;57140;25992;51052;9208;375316;11132;389090;23192;55502;3069;10494;117581;51281;285193;666;8864;26146;23178;50636;653437;1293;80895;9855,53
-1,1,2,237684405,243059659,5375254,151176;64090;84289;10920;377007;5510;285093;51665;728294;339768;4705;150677;1841;129807;2859;130916;64284;150678;10267;140739;2817;4735;79083;51540;5133;9759;150681;375318;189;51078;547;79919;57140;25992;51052;9208;375316;11132;389090;23192;55502;3069;10494;117581;51281;285193;666;8864;26146;23178;50636;653437;1293;80895;9855,55
-1,1,2,237816758,242783384,4966626,151176;64090;84289;10920;377007;5510;51665;728294;339768;4705;150677;1841;129807;2859;130916;64284;150678;10267;140739;2817;4735;79083;51540;9759;150681;375318;189;51078;547;79919;57140;25992;51052;9208;375316;11132;389090;23192;55502;3069;10494;117581;51281;285193;666;8864;26146;23178;50636;653437;1293;80895;9855,53
-1,1,2,237875406,243007359,5131953,151176;64090;84289;10920;377007;5510;285093;51665;728294;339768;4705;150677;1841;129807;2859;130916;64284;150678;10267;140739;2817;4735;79083;51540;5133;9759;150681;375318;189;51078;547;79919;57140;25992;51052;9208;375316;11132;389090;23192;55502;3069;10494;117581;51281;285193;666;8864;26146;23178;50636;653437;1293;80895;9855,55
-1,1,2,237938270,242783384,4845114,151176;64090;84289;10920;377007;5510;51665;728294;339768;4705;150677;1841;129807;2859;130916;64284;150678;10267;140739;2817;4735;79083;51540;9759;150681;375318;189;51078;547;79919;57140;25992;51052;9208;375316;11132;389090;23192;55502;3069;10494;117581;51281;285193;666;8864;26146;23178;50636;653437;1293;80895;9855,53
-1,1,2,237943119,243007359,5064240,151176;64090;84289;10920;377007;5510;285093;51665;728294;339768;4705;150677;1841;129807;2859;130916;64284;150678;10267;140739;2817;4735;79083;51540;5133;9759;150681;375318;189;51078;547;79919;57140;25992;51052;9208;375316;11132;389090;23192;55502;3069;10494;117581;51281;285193;666;8864;26146;23178;50636;653437;1293;80895;9855,55
-1,1,2,238072533,242783384,4710851,151176;64090;84289;5510;377007;51665;728294;339768;4705;150677;1841;129807;2859;130916;64284;150678;10267;140739;2817;4735;79083;51540;9759;150681;375318;189;51078;547;79919;57140;25992;51052;9208;375316;11132;389090;23192;55502;3069;10494;117581;51281;285193;666;8864;26146;23178;50636;653437;1293;80895;9855,52
-1,1,2,238140847,243007359,4866512,151176;64090;84289;5510;377007;285093;51665;728294;339768;4705;150677;1841;129807;2859;130916;64284;150678;10267;140739;2817;4735;79083;51540;5133;9759;150681;375318;189;51078;547;79919;57140;25992;51052;9208;375316;11132;389090;23192;55502;3069;10494;117581;51281;285193;666;8864;26146;23178;50636;653437;1293;80895;9855,54
1,-1,2,238475200,238475304,104,51052,1
1,-1,2,238475200,238475304,104,51052,1
-1,1,2,238811512,243059659,4248147,151176;64090;84289;5510;377007;285093;51665;339768;4705;150677;1841;129807;2859;130916;150678;10267;140739;2817;4735;9855;51540;9759;150681;375318;189;51078;547;79919;57140;25992;11132;389090;23192;80895;55502;3069;10494;117581;51281;285193;666;8864;26146;23178;50636;653437;5133;728294,48
1,1,2,239665010,242710466,3045456,84289;5510;728294;4705;150677;1841;2859;130916;150678;2817;4735;150681;9759;375318;189;51078;547;79919;57140;25992;11132;389090;23192;3069;10494;117581;51281;285193;666;23178;50636;653437;9855,33
1,1,2,239665010,242710466,3045456,84289;5510;728294;4705;150677;1841;2859;130916;150678;2817;4735;150681;9759;375318;189;51078;547;79919;57140;25992;11132;389090;23192;3069;10494;117581;51281;285193;666;23178;50636;653437;9855,33
-1,1,2,239742160,243059659,3317499,64090;84289;5510;285093;728294;4705;150677;1841;129807;2859;130916;150678;2817;4735;150681;9759;375318;189;51078;547;79919;57140;25992;11132;389090;23192;3069;10494;117581;51281;285193;666;23178;50636;653437;5133;9855,37
-1,1,2,239748306,242783384,3035078,64090;84289;5510;728294;4705;150677;1841;129807;2859;130916;150678;2817;4735;150681;9759;375318;189;51078;547;79919;57140;25992;11132;389090;23192;3069;10494;117581;51281;285193;666;23178;50636;653437;9855,35
-1,1,2,239966964,240600276,633312,9759,1
-1,1,2,240161377,242783384,2622007,64090;84289;5510;4705;150677;1841;129807;2859;130916;150678;2817;4735;9855;9759;150681;375318;189;51078;547;79919;57140;25992;11132;389090;23192;3069;10494;51281;285193;666;23178;50636;653437;728294,34
-1,1,2,240429036,242783384,2354348,64090;84289;5510;728294;4705;150677;1841;129807;2859;130916;150678;2817;4735;150681;375318;189;51078;547;79919;57140;25992;11132;389090;23192;3069;10494;51281;285193;666;23178;50636;653437;9855,33
1,-1,2,240981290,240987642,6352,150681,1
-1,1,2,241006623,243059659,2053036,64090;84289;5510;285093;728294;150677;1841;129807;2859;130916;150678;2817;4735;375318;189;51078;547;79919;57140;25992;11132;23192;3069;10494;51281;285193;666;23178;50636;653437;5133;9855,32
-1,1,2,241110554,243007359,1896805,25992;64090;84289;5510;285093;11132;23178;129807;1841;23192;2859;3069;130916;10494;2817;4735;9855;51281;57140;285193;666;375318;189;51078;547;50636;653437;79919;5133;728294,30
1,-1,2,241556949,241578483,21534,2859,1
1,-1,2,241556949,241578483,21534,2859,1
1,-1,2,241617726,241626027,8301,653437,1
1,-1,2,241617726,241626027,8301,653437,1
1,-1,2,241617726,241716779,99053,547;653437;375318,3
1,-1,2,241627284,241709290,82006,547;375318,2
1,-1,2,241627284,241709290,82006,547;375318,2
1,-1,2,241627284,241709290,82006,547;375318,2
1,-1,2,241627284,241709290,82006,547;375318,2
1,-1,2,241916309,241919234,2925,,0
1,-1,2,241916309,241919234,2925,,0
-1,-1,2,242710413,242938241,227828,129807;64090;285093;5133,4
1,-1,2,242736860,242768426,31566,129807;64090,2
-1,-1,2,242742931,242768426,25495,129807;64090,2
-1,-1,2,242798552,242969874,171322,285093;5133,2
-1,-1,2,242843643,243028424,184781,,0
-1,-1,2,242846810,243007457,160647,,0
-1,-1,2,242852514,243102476,249962,,0
-1,-1,2,242852514,243102476,249962,,0
-1,-1,2,242852514,243102476,249962,,0
-1,-1,2,242852566,243007359,154793,,0
-1,-1,2,242852595,243052335,199740,,0
-1,-1,2,242856588,242948040,91452,,0
-1,-1,2,242856588,243007359,150771,,0
-1,-1,2,242856588,243007359,150771,,0
-1,-1,2,242856588,243007359,150771,,0
-1,-1,2,242856588,243007359,150771,,0
-1,-1,2,242856588,243007359,150771,,0
-1,-1,2,242856588,243007359,150771,,0
-1,-1,2,242856588,243007359,150771,,0
-1,-1,2,242856588,243007359,150771,,0
-1,-1,2,242856588,243007359,150771,,0
-1,-1,2,242856588,243007359,150771,,0
-1,-1,2,242856588,243007359,150771,,0
-1,-1,2,242856588,243007359,150771,,0
-1,-1,2,242856588,243007359,150771,,0
-1,-1,2,242856588,243007359,150771,,0
-1,-1,2,242856588,243007359,150771,,0
-1,-1,2,242856588,243007359,150771,,0
-1,-1,2,242856588,243007359,150771,,0
1,-1,2,242856588,243007359,150771,,0
-1,-1,2,242856588,243007359,150771,,0
-1,-1,2,242856588,243008259,151671,,0
-1,-1,2,242856588,243059659,203071,,0
-1,-1,2,242856599,242947990,91391,,0
-1,-1,2,242856599,242947990,91391,,0
1,-1,2,242856599,242958350,101751,,0
-1,-1,2,242856599,242958350,101751,,0
1,-1,2,242856599,242984824,128225,,0
-1,-1,2,242856599,243007457,150858,,0
-1,-1,2,242856599,243007457,150858,,0
-1,-1,2,242856599,243007457,150858,,0
-1,-1,2,242856599,243007457,150858,,0
-1,-1,2,242856599,243007457,150858,,0
-1,-1,2,242856599,243007457,150858,,0
-1,-1,2,242856599,243007457,150858,,0
-1,-1,2,242856599,243007457,150858,,0
-1,-1,2,242856599,243007457,150858,,0
-1,-1,2,242856599,243007457,150858,,0
-1,-1,2,242856599,243007457,150858,,0
-1,-1,2,242856599,243007457,150858,,0
-1,-1,2,242856599,243007457,150858,,0
-1,-1,2,242856599,243007457,150858,,0
-1,-1,2,242856599,243007457,150858,,0
-1,-1,2,242856599,243007457,150858,,0
-1,-1,2,242856599,243007457,150858,,0
-1,-1,2,242856599,243007457,150858,,0
-1,-1,2,242856599,243007457,150858,,0
-1,-1,2,242856599,243007457,150858,,0
-1,-1,2,242856599,243007457,150858,,0
-1,-1,2,242856599,243007457,150858,,0
-1,-1,2,242856599,243007457,150858,,0
-1,-1,2,242856599,243007457,150858,,0
-1,-1,2,242856599,243007457,150858,,0
-1,-1,2,242856599,243007457,150858,,0
-1,-1,2,242856599,243007457,150858,,0
-1,-1,2,242856599,243007457,150858,,0
-1,-1,2,242856599,243007457,150858,,0
-1,-1,2,242856599,243007457,150858,,0
-1,-1,2,242856599,243007457,150858,,0
-1,-1,2,242856599,243007457,150858,,0
-1,-1,2,242856599,243007457,150858,,0
-1,-1,2,242856599,243059659,203060,,0
-1,-1,2,242856599,243059659,203060,,0
-1,-1,2,242856599,243059659,203060,,0
-1,-1,2,242856599,243059659,203060,,0
-1,-1,2,242856599,243059659,203060,,0
-1,-1,2,242856599,243059659,203060,,0
-1,-1,2,242856599,243059659,203060,,0
-1,-1,2,242856599,243059659,203060,,0
-1,-1,2,242856599,243059659,203060,,0
-1,-1,2,242856599,243059659,203060,,0
-1,-1,2,242856599,243059659,203060,,0
-1,-1,2,242856599,243059659,203060,,0
-1,-1,2,242856599,243059659,203060,,0
-1,-1,2,242856599,243059659,203060,,0
-1,-1,2,242856599,243059659,203060,,0
-1,-1,2,242856599,243059659,203060,,0
-1,-1,2,242856599,243059659,203060,,0
-1,-1,2,242856599,243059659,203060,,0
-1,-1,2,242856599,243059659,203060,,0
-1,-1,2,242856599,243059659,203060,,0
-1,-1,2,242856599,243059659,203060,,0
-1,-1,2,242856599,243059659,203060,,0
-1,-1,2,242856599,243059659,203060,,0
-1,-1,2,242856599,243059659,203060,,0
-1,-1,2,242856599,243059659,203060,,0
-1,-1,2,242856599,243059659,203060,,0
-1,-1,2,242856599,243059659,203060,,0
-1,-1,2,242856599,243059659,203060,,0
-1,-1,2,242856599,243059659,203060,,0
-1,-1,2,242856599,243059659,203060,,0
-1,-1,2,242856599,243059659,203060,,0
-1,-1,2,242856599,243059659,203060,,0
-1,-1,2,242856599,243059659,203060,,0
-1,-1,2,242856599,243059659,203060,,0
-1,-1,2,242856599,243059659,203060,,0
-1,-1,2,242856599,243059659,203060,,0
-1,-1,2,242856599,243059659,203060,,0
-1,-1,2,242856599,243059659,203060,,0
-1,-1,2,242856599,243059659,203060,,0
-1,-1,2,242856599,243059659,203060,,0
-1,-1,2,242856599,243059659,203060,,0
-1,-1,2,242856599,243059659,203060,,0
-1,-1,2,242856599,243059659,203060,,0
-1,-1,2,242856599,243059659,203060,,0
-1,-1,2,242856599,243059659,203060,,0
-1,-1,2,242856599,243059659,203060,,0
-1,-1,2,242856599,243059659,203060,,0
-1,-1,2,242856599,243059659,203060,,0
-1,-1,2,242856599,243059659,203060,,0
-1,-1,2,242856599,243059659,203060,,0
-1,-1,2,242856599,243059659,203060,,0
-1,-1,2,242856599,243059659,203060,,0
-1,-1,2,242856599,243059659,203060,,0
-1,-1,2,242856599,243059659,203060,,0
-1,-1,2,242856599,243059659,203060,,0
-1,-1,2,242856599,243059659,203060,,0
-1,-1,2,242856617,243028424,171807,,0
-1,-1,2,242856617,243028424,171807,,0
1,-1,2,242866025,242958350,92325,,0
-1,-1,2,242873063,243028424,155361,,0
1,-1,2,242880065,242953640,73575,,0
1,-1,2,242886373,242958350,71977,,0
1,-1,2,242886373,242958350,71977,,0
-1,-1,2,242889825,242948040,58215,,0
-1,-1,2,242889826,242947990,58164,,0
-1,-1,2,242889826,242947990,58164,,0
-1,-1,2,242889826,242947990,58164,,0
-1,-1,2,242889826,242947990,58164,,0
1,-1,2,242889855,242910505,20650,,0
-1,-1,2,242920197,242947990,27793,,0
-1,-1,2,242920197,242947990,27793,,0
-1,-1,2,242920197,242947990,27793,,0
-1,-1,2,242920197,242947990,27793,,0
-1,-1,2,242920197,242947990,27793,,0
-1,-1,2,242920197,242947990,27793,,0
-1,-1,2,242920197,242947990,27793,,0
-1,-1,2,242920197,242947990,27793,,0
-1,-1,2,242920197,242947990,27793,,0
-1,-1,2,242920197,242947990,27793,,0
-1,-1,2,242920197,242947990,27793,,0
1,-1,2,242920197,242953640,33443,,0
-1,-1,2,242924058,242948040,23982,,0
-1,-1,2,242924058,242948040,23982,,0
-1,-1,2,242924058,242948040,23982,,0
-1,-1,2,242924082,242947990,23908,,0
-1,-1,2,242924082,242947990,23908,,0
1,-1,2,242924082,242953640,29558,,0
-1,-1,2,242927148,242947990,20842,,0
-1,-1,2,242930600,242948040,17440,,0
-1,-1,2,242930600,242948040,17440,,0
-1,-1,2,242930600,242948040,17440,,0
-1,-1,2,242930600,242948040,17440,,0
-1,-1,2,242930600,242948040,17440,,0
-1,-1,2,242930600,242948040,17440,,0
-1,-1,2,242930600,242948040,17440,,0
-1,-1,2,242930600,243007359,76759,,0
-1,-1,2,242930600,243007359,76759,,0
1,-1,2,242930600,243007359,76759,,0
-1,-1,2,242930600,243007359,76759,,0
-1,-1,2,242930600,243007359,76759,,0
-1,-1,2,242930600,243007359,76759,,0
-1,-1,2,242930600,243007359,76759,,0
-1,-1,2,242930600,243007359,76759,,0
-1,-1,2,242930600,243007359,76759,,0
-1,-1,2,242930600,243007359,76759,,0
-1,-1,2,242930600,243007359,76759,,0
-1,-1,2,242930600,243007359,76759,,0
-1,-1,2,242930600,243007359,76759,,0
-1,-1,2,242930600,243007359,76759,,0
1,-1,2,242930600,243007359,76759,,0
-1,-1,2,242930600,243007359,76759,,0
-1,-1,2,242930600,243007359,76759,,0
-1,-1,2,242930600,243007359,76759,,0
-1,-1,2,242930600,243007359,76759,,0
-1,-1,2,242930600,243007359,76759,,0
-1,-1,2,242930600,243007359,76759,,0
-1,-1,2,242930600,243007359,76759,,0
-1,-1,2,242930600,243007359,76759,,0
1,-1,2,242930600,243007359,76759,,0
-1,-1,2,242930600,243007359,76759,,0
1,-1,2,242930600,243007359,76759,,0
1,-1,2,242930600,243007359,76759,,0
-1,-1,2,242930600,243007359,76759,,0
-1,-1,2,242930600,243007359,76759,,0
1,-1,2,242930600,243007359,76759,,0
-1,-1,2,242930600,243007359,76759,,0
1,-1,2,242930600,243007359,76759,,0
-1,-1,2,242930600,243007359,76759,,0
-1,-1,2,242930600,243007359,76759,,0
-1,-1,2,242930600,243007359,76759,,0
-1,-1,2,242930600,243007359,76759,,0
-1,-1,2,242930600,243007359,76759,,0
-1,-1,2,242930600,243007359,76759,,0
-1,-1,2,242930600,243007359,76759,,0
-1,-1,2,242930600,243007359,76759,,0
1,-1,2,242930600,243007359,76759,,0
1,-1,2,242930600,243007359,76759,,0
-1,-1,2,242930600,243007359,76759,,0
-1,-1,2,242930600,243007359,76759,,0
-1,-1,2,242930600,243007359,76759,,0
-1,-1,2,242930600,243007359,76759,,0
1,-1,2,242930600,243007359,76759,,0
-1,-1,2,242930600,243007359,76759,,0
-1,-1,2,242930600,243007359,76759,,0
-1,-1,2,242930600,243007359,76759,,0
1,-1,2,242930600,243007359,76759,,0
-1,-1,2,242930600,243007359,76759,,0
-1,-1,2,242930600,243007359,76759,,0
-1,-1,2,242930600,243007359,76759,,0
-1,-1,2,242930600,243007359,76759,,0
1,-1,2,242930600,243007359,76759,,0
-1,-1,2,242930600,243007359,76759,,0
-1,-1,2,242930600,243007359,76759,,0
-1,-1,2,242930600,243007359,76759,,0
-1,-1,2,242930600,243007359,76759,,0
-1,-1,2,242930600,243007359,76759,,0
-1,-1,2,242930600,243007359,76759,,0
1,-1,2,242930600,243007359,76759,,0
-1,-1,2,242930600,243007359,76759,,0
1,-1,2,242930600,243007359,76759,,0
-1,-1,2,242930600,243007359,76759,,0
-1,-1,2,242930600,243007359,76759,,0
-1,-1,2,242930600,243007359,76759,,0
1,-1,2,242930600,243007359,76759,,0
-1,-1,2,242930600,243007359,76759,,0
-1,-1,2,242930600,243007359,76759,,0
-1,-1,2,242930600,243007359,76759,,0
1,-1,2,242930600,243007359,76759,,0
-1,-1,2,242930600,243007359,76759,,0
1,-1,2,242930600,243007359,76759,,0
1,-1,2,242930600,243007359,76759,,0
1,-1,2,242930600,243007359,76759,,0
-1,-1,2,242930600,243007359,76759,,0
1,-1,2,242930600,243007359,76759,,0
-1,-1,2,242930600,243007359,76759,,0
-1,-1,2,242930600,243007359,76759,,0
-1,-1,2,242930600,243007359,76759,,0
-1,-1,2,242930600,243007359,76759,,0
-1,-1,2,242930600,243059659,129059,,0
-1,-1,2,242930600,243059659,129059,,0
-1,-1,2,242930600,243059659,129059,,0
-1,-1,2,242930600,243059659,129059,,0
-1,-1,2,242953547,243007359,53812,,0
1,-1,2,242953581,243007457,53876,,0
-1,-1,2,242953581,243007457,53876,,0
-1,-1,2,242953581,243059659,106078,,0
-1,-1,2,242953581,243059659,106078,,0
-1,-1,2,242953581,243059659,106078,,0
-1,-1,2,242953581,243059659,106078,,0
-1,-1,2,242953581,243059659,106078,,0
-1,-1,2,242953581,243059659,106078,,0
-1,-1,2,242953581,243059659,106078,,0
-1,-1,2,242953581,243059659,106078,,0
-1,-1,2,242958497,242980267,21770,,0
-1,-1,2,242969815,243007457,37642,,0
-1,-1,2,242969815,243007457,37642,,0
-1,-1,2,242997679,243015119,17440,,0
-1,-1,2,242997679,243015119,17440,,0
-1,-1,2,242997679,243015119,17440,,0
-1,-1,2,242997679,243015119,17440,,0
-1,-1,2,242997679,243015119,17440,,0
-1,-1,2,242997679,243015119,17440,,0
-1,-1,2,242997679,243015119,17440,,0
-1,-1,2,242997679,243015119,17440,,0
-1,-1,2,242997679,243015119,17440,,0
-1,-1,2,242997679,243015119,17440,,0
-1,-1,2,242997679,243015119,17440,,0
-1,-1,2,242997679,243015119,17440,,0
-1,-1,2,242997679,243015119,17440,,0
-1,-1,2,242997679,243015119,17440,,0
1,-1,2,243088755,243175692,86937,,0
-1,1,3,61891,7456866,7394975,2917;51095;51185;3568;10752;9695;285362;27255;3708;57633;8553;6419;152330;55207,14
-1,1,3,61891,7865381,7803490,2917;51095;51185;3568;10752;9695;285362;27255;3708;57633;8553;6419;152330;55207,14
-1,1,3,61891,8600971,8539080,2917;51095;51185;3568;29995;10752;9695;285362;27255;3708;57633;8553;6419;152330;55207,15
-1,1,3,61891,8777555,8715664,2917;51095;51185;10752;9695;285362;27255;3708;6419;51066;152330;3568;29995;57633;8553;859;55207,17
-1,1,3,61891,9403721,9341830,2917;51095;51185;56852;9901;10752;9695;285362;3708;27255;6419;51066;152330;3568;29995;57633;8553;859;5021;55207,20
-1,1,3,61891,11263288,11201397,51185;55831;9901;6396;9695;7428;285367;3708;4968;491;6419;151835;6538;9797;3568;29995;26140;8536;84522;3269;859;63924;100526693;55207;2177;2917;51095;56852;25917;401052;115795;10752;132014;285368;285362;27255;10474;7862;51066;152330;51738;84818;55209;78987;3656;64419;6529;10093;55845;57633;8553;375323;5021,53
-1,1,3,61891,12575409,12513518,51185;55831;9901;6396;9695;7428;285367;3708;4968;491;6419;151835;6538;9797;3568;29995;26140;5468;8536;132001;7079;84522;3269;859;63924;100526693;55207;2177;2917;51095;56852;25917;401052;115795;10752;132014;285368;285362;6854;27255;10474;7862;51066;152330;51738;84818;55209;78987;3656;64419;6529;10093;55845;57633;8553;375323;9686;5021;10533;80746,60
1,1,3,61891,24432821,24370930,7476;23473;80746;285367;3708;8850;151648;79188;6538;23066;1618;9797;29995;80852;5468;8536;339862;132001;9975;23225;151649;84522;3269;5868;63924;2177;6138;55287;56852;25917;115795;285368;6533;285362;6854;131965;27255;7862;8292;6161;51738;5021;78987;6304;285381;9922;10093;7508;85403;55845;23228;57633;7068;8553;375323;10533;151651;51185;55831;9901;79885;23243;6396;131096;9695;7428;23609;4968;491;7325;6419;151835;79750;5894;3568;26140;7324;26061;9779;686;7079;859;7182;84077;100526693;55207;9467;2917;51095;64432;401052;100129480;10752;132014;2199;28512;10474;27258;51066;152330;84818;55209;131474;3656;64419;6529;51244;92106;152273;9686;23180;64145;117248,113
1,1,3,61891,33958201,33896310,344787;285367;3708;6538;23066;9797;5468;8536;339862;8320;9975;51143;84522;5868;63924;55287;56852;25917;285368;285362;6854;54995;27255;51738;78987;6304;85403;23228;57633;8553;9901;79885;9695;201595;4968;491;7155;151835;5894;54918;3568;26140;7324;152100;27303;7079;84077;64145;152110;51095;114884;401052;100129480;2199;28512;51066;64343;152330;3656;7048;51244;152273;9686;23180;1233;117248;7476;23473;9497;8850;151648;79188;1618;29995;80852;116135;132001;23225;25904;151649;643853;3269;10015;112616;2177;6138;23122;115795;6533;131965;7862;8292;6161;55768;152098;285381;9922;10093;7508;55845;2720;7068;7342;375323;10533;151651;51185;55831;23243;6396;131096;25827;7428;23609;7325;6419;79750;26061;131405;26032;9779;686;859;7182;100526693;55207;9467;2917;64432;10491;10752;132014;5915;10474;27258;84818;55209;131474;64419;23171;6529;92106;5021;339896;80746;152189,146
1,1,3,61891,36710181,36648290,6769;344787;285367;3708;6538;23066;9797;5468;8536;339862;8320;9975;51143;84522;5868;10777;63924;55287;56852;25917;285368;285362;6854;54995;27255;51738;78987;6304;85403;23228;57633;8553;9901;79885;9695;201595;4968;491;7155;151835;5894;54918;3568;26140;7324;152100;27303;7079;84077;64145;152110;51095;114884;401052;100129480;2199;28512;51066;64343;152330;3656;7048;51244;152273;9686;23180;1233;117248;7476;23473;9497;8850;151648;79188;1618;29995;80852;116135;132001;23225;25904;151649;643853;3269;10015;112616;2177;6138;23122;115795;6533;131965;7862;8292;6161;55768;152098;285381;9922;10093;7508;55845;2720;7068;7342;375323;10533;151651;51185;55831;23243;6396;131096;25827;7428;23609;7325;6419;79750;26061;131405;26032;9779;686;859;7182;100526693;55207;9467;2917;64432;10491;10752;132014;5915;10474;27258;84818;55209;131474;64419;23171;6529;92106;5021;339896;80746;152189,148
1,1,3,61891,37459464,37397573,6769;344787;285367;3708;6538;23066;9797;5468;8536;339862;8320;9975;51143;84522;5868;10777;63924;55287;56852;25917;9852;285368;285362;6854;54995;27255;51738;78987;6304;85403;339883;23228;57633;8553;9901;79885;9695;201595;4968;491;7155;151835;5894;54918;3568;26140;7324;152100;27303;7079;2803;84077;64145;9881;152110;51095;114884;401052;100129480;2199;28512;51066;64343;152330;3656;7048;51244;152273;9686;23180;1233;117248;7476;23473;85443;9497;8850;151648;79188;1618;29995;80852;116135;132001;23225;25904;151649;643853;3269;10015;112616;2177;6138;23122;115795;6533;131965;7862;8292;6161;55768;152098;285381;9922;10093;7508;55845;2720;7068;7342;375323;10533;151651;51185;55831;23243;6396;131096;25827;7428;9209;23609;7325;6419;79750;26061;131405;26032;9779;686;859;7182;100526693;55207;9467;2917;64432;10491;10752;132014;5915;10474;27258;84818;55209;131474;64419;23171;6529;4292;92106;5021;339896;80746;152189,155
1,1,3,61892,197851986,197790094,7634;6769;51385;29970;5290;56992;5984;403274;9797;7134;3592;1894;55349;9975;51208;79825;151742;285267;9861;55287;25917;11343;6657;6854;54870;64091;5364;285268;253461;604;9943;54716;3693;11068;57633;4638;199221;54106;9901;30849;257144;5130;8801;10721;29927;4485;7079;729085;152206;285335;4336;151827;339834;84859;51099;1356;118442;55540;57018;2199;151636;10188;25978;54756;79295;51319;344805;22906;51068;55840;79718;9390;285313;64805;201633;1238;956;93109;200931;80852;6184;257068;9136;165721;25907;93;6138;344752;285203;6010;285242;3273;3680;8927;23166;4976;286827;7508;7348;132228;646450;55831;84107;11102;11280;7325;55;131405;339906;5918;327;256076;131873;25915;89857;79572;79413;64432;26355;440957;25924;389177;152118;84818;131474;9626;8372;54762;55179;6434;25930;55129;6478;344807;2992;200933;51246;131601;200894;131076;55152;259173;5580;54965;4345;253639;95;66000;10217;165904;389123;78987;344658;165631;56945;9942;131890;51555;64943;79885;344758;26059;84239;339829;57493;7873;54585;51517;3081;22916;23200;2803;23429;11222;1427;100129480;50939;51066;353324;65010;776;347736;4711;729230;9686;1233;152065;53833;85443;200895;25852;1181;205717;5276;166348;23024;2804;100288801;23225;51421;79663;389124;51533;9076;3697;26060;84248;10402;344657;165829;27032;55802;84276;83666;10840;6161;23355;84319;23132;2779;3280;84002;10093;10289;84223;25864;151651;10225;375341;11180;51185;28972;7104;646424;55164;788;9868;11186;26061;11188;23317;4286;142686;389151;10168;23016;100131827;27230;403273;9254;1154;285220;80321;60678;27258;9819;111;57467;26339;27107;23171;64108;993;285343;6474;23007;29083;80746;6314;285367;83850;22989;25886;10051;55341;55076;5468;8320;56203;51143;29114;286676;56925;6405;401097;80012;339122;64866;8723;81050;4154;253559;64770;8553;116064;54977;9197;389125;7384;415117;64747;200909;22908;57092;4968;401089;151963;91392;10342;5437;9940;55764;6578;30;378;55830;92369;2122;6336;55193;55347;344892;51244;10954;348801;23180;5217;10195;64332;100506243;8971;868;8618;11334;4057;131408;132001;11235;23276;131920;285331;9039;26043;6599;116832;152098;389136;8646;285381;7068;285195;7018;7066;114112;402135;287015;110599583;29122;4171;23609;7474;79750;5584;375387;27031;6092;686;25994;201626;545;7110;11073;100526693;55207;22937;90226;9657;10803;3059;57406;54800;3700;2771;647309;64419;4486;1234;51368;9223;100526772;389158;344787;80235;353274;2932;8702;1857;84873;51725;165679;57514;10777;2814;10063;200844;7375;89782;23101;151790;10242;92370;820;6988;151888;9711;50852;56920;961;1173;8309;55254;9389;84343;79876;7155;5449;1371;84100;10686;56670;401052;116441;55167;152138;80254;7123;84984;3656;2815;349565;7881;152273;55032;9515;2624;1974;57415;1232;5274;55892;8850;57456;80218;89876;114885;1618;84541;407738;9807;84864;23150;3269;11259;6259;90102;7584;90407;56987;23122;23395;29925;7871;55669;132160;10181;86;55768;348793;1962;9922;166012;57577;57552;79364;2829;26137;131669;55211;151647;151887;53829;7428;84666;2876;64689;6419;2596;503582;8087;2838;51163;6091;8403;5028;5337;131118;285311;654502;646498;344905;84303;389152;4026;85476;22865;54946;5793;51300;389114;55324;1360;132158;170506;7318;26984;56941;56667;80145;8626;339862;440955;170572;8706;63924;4071;259236;79442;55573;285362;54995;27255;23043;131544;6304;151987;58477;8545;116931;11170;2119;85403;9666;8856;51364;131177;55096;1582;79714;51161;131583;7095;6565;25981;285349;57709;523;79691;4615;214;26140;7324;152100;59345;7220;51095;285382;2693;1370;200959;28512;151613;1776;1605;347;8975;57408;57501;56999;4690;55799;22871;132243;9435;8833;56650;23473;2850;622;5948;403278;84925;55486;25904;344901;151649;7037;80325;55214;8292;10644;51447;152185;5708;200916;6159;8314;11070;10425;23243;10675;100534599;94032;28976;6787;79669;54464;55773;26032;254887;23527;56983;131375;5361;375346;51726;10752;1524;57560;7545;339855;285346;3921;24142;115560;2272;5627;56922;64145;57337;55081;4311;64925;440956;5576;401067;3708;23066;3373;6750;389170;8536;285386;3836;2632;5868;8692;9852;285282;6514;51738;5210;57129;2960;84892;7433;54931;7029;6498;64147;53836;403277;201595;131566;5947;8419;151835;54918;57650;57047;83893;8994;90288;1295;79674;9616;84077;9881;57060;25847;79858;5162;9276;590;1475;255798;84561;1814;92999;6997;63899;4241;2912;152330;8820;26084;11148;254827;200958;1849;275;7476;344838;9497;28999;5523;79188;3355;110599564;22808;643853;51560;6596;79740;10015;27333;199223;7867;11344;3699;2047;6480;25937;211;115286;5359;131149;6476;55845;54899;375323;348807;64393;51304;26354;100526760;55171;57110;54681;5745;59343;941;6165;54986;5806;131540;10057;9779;6331;859;846;11167;285315;3827;668;7401;57599;132014;5915;10201;80723;51122;131831;84517;10550;1359;2257;4585;339896;257313;152189;10180;9034;200845;54763;5062;131450;80111;653659;5922;5648;7707;7047;9370;389161;8997;84522;4634;51372;5333;25976;389119;91653;7869;26998;8930;7866;54554;100505385;644974;339883;5357;205564;79929;51409;9695;79310;54625;105374250;91775;5067;3568;132112;26341;23272;4710;9045;10869;3913;84129;10991;64343;1739;942;7086;11277;23129;8893;29890;55279;29995;116135;387;51714;84692;2177;64422;63891;51188;185;55888;83939;51365;28990;317649;60675;151871;9175;10039;57088;200879;131096;7555;1499;9209;100287362;13;377047;483;201627;131870;2917;56648;8743;23350;3615;23218;3840;4292;885;79598;8607;79782;7372;131368;29072;55079;26996;50650;4291;26577;10641;79443;6538;54437;50853;25890;9730;54165;132141;285237;166336;83597;27086;10663;5352;56852;6747;285368;9941;22907;5010;56954;131578;54861;152405;152137;152078;200942;23228;151903;25871;4820;27074;197;51193;29909;152015;491;1608;729627;79012;64110;80335;5894;727936;55186;27303;1294;84315;165918;1951;152110;114884;4134;27094;5291;54859;201625;84836;645840;9934;54847;131616;7048;201562;64084;5504;141;5912;117248;10274;200810;22820;151648;57461;5096;3556;26018;255758;116211;152002;10293;152404;1237;112616;115795;131377;51460;6533;131965;4045;7862;1795;51554;51146;80117;5859;132203;205428;2720;7342;375337;64651;7200;132204;10533;84126;23023;11342;25827;6396;2317;100132146;55689;9117;93973;55779;9718;27136;64778;91869;285231;7182;90113;2049;9467;10491;58515;1981;25945;386724;10474;7879;389118;2042;6152;55209;131034;1230;6529;256356;50512;92106;5021,1044
1,1,3,61892,197851986,197790094,7634;6769;51385;29970;5290;56992;5984;403274;9797;7134;3592;1894;55349;9975;51208;79825;151742;285267;9861;55287;25917;11343;6657;6854;54870;64091;5364;285268;253461;604;9943;54716;3693;11068;57633;4638;199221;54106;9901;30849;257144;5130;8801;10721;29927;4485;7079;729085;152206;285335;4336;151827;339834;84859;51099;1356;118442;55540;57018;2199;151636;10188;25978;54756;79295;51319;344805;22906;51068;55840;79718;9390;285313;64805;201633;1238;956;93109;200931;80852;6184;257068;9136;165721;25907;93;6138;344752;285203;6010;285242;3273;3680;8927;23166;4976;286827;7508;7348;132228;646450;55831;84107;11102;11280;7325;55;131405;339906;5918;327;256076;131873;25915;89857;79572;79413;64432;26355;440957;25924;389177;152118;84818;131474;9626;8372;54762;55179;6434;25930;55129;6478;344807;2992;200933;51246;131601;200894;131076;55152;259173;5580;54965;4345;253639;95;66000;10217;165904;389123;78987;344658;165631;56945;9942;131890;51555;64943;79885;344758;26059;84239;339829;57493;7873;54585;51517;3081;22916;23200;2803;23429;11222;1427;100129480;50939;51066;353324;65010;776;347736;4711;729230;9686;1233;152065;53833;85443;200895;25852;1181;205717;5276;166348;23024;2804;100288801;23225;51421;79663;389124;51533;9076;3697;26060;84248;10402;344657;165829;27032;55802;84276;83666;10840;6161;23355;84319;23132;2779;3280;84002;10093;10289;84223;25864;151651;10225;375341;11180;51185;28972;7104;646424;55164;788;9868;11186;26061;11188;23317;4286;142686;389151;10168;23016;100131827;27230;403273;9254;1154;285220;80321;60678;27258;9819;111;57467;26339;27107;23171;64108;993;285343;6474;23007;29083;80746;6314;285367;83850;22989;25886;10051;55341;55076;5468;8320;56203;51143;29114;286676;56925;6405;401097;80012;339122;64866;8723;81050;4154;253559;64770;8553;116064;54977;9197;389125;7384;415117;64747;200909;22908;57092;4968;401089;151963;91392;10342;5437;9940;55764;6578;30;378;55830;92369;2122;6336;55193;55347;344892;51244;10954;348801;23180;5217;10195;64332;100506243;8971;868;8618;11334;4057;131408;132001;11235;23276;131920;285331;9039;26043;6599;116832;152098;389136;8646;285381;7068;285195;7018;7066;114112;402135;287015;110599583;29122;4171;23609;7474;79750;5584;375387;27031;6092;686;25994;201626;545;7110;11073;100526693;55207;22937;90226;9657;10803;3059;57406;54800;3700;2771;647309;64419;4486;1234;51368;9223;100526772;389158;344787;80235;353274;2932;8702;1857;84873;51725;165679;57514;10777;2814;10063;200844;7375;89782;23101;151790;10242;92370;820;6988;151888;9711;50852;56920;961;1173;8309;55254;9389;84343;79876;7155;5449;1371;84100;10686;56670;401052;116441;55167;152138;80254;7123;84984;3656;2815;349565;7881;152273;55032;9515;2624;1974;57415;1232;5274;55892;8850;57456;80218;89876;114885;1618;84541;407738;9807;84864;23150;3269;11259;6259;90102;7584;90407;56987;23122;23395;29925;7871;55669;132160;10181;86;55768;348793;1962;9922;166012;57577;57552;79364;2829;26137;131669;55211;151647;151887;53829;7428;84666;2876;64689;6419;2596;503582;8087;2838;51163;6091;8403;5028;5337;131118;285311;654502;646498;344905;84303;389152;4026;85476;22865;54946;5793;51300;389114;55324;1360;132158;170506;7318;26984;56941;56667;80145;8626;339862;440955;170572;8706;63924;4071;259236;79442;55573;285362;54995;27255;23043;131544;6304;151987;58477;8545;116931;11170;2119;85403;9666;8856;51364;131177;55096;1582;79714;51161;131583;7095;6565;25981;285349;57709;523;79691;4615;214;26140;7324;152100;59345;7220;51095;285382;2693;1370;200959;28512;151613;1776;1605;347;8975;57408;57501;56999;4690;55799;22871;132243;9435;8833;56650;23473;2850;622;5948;403278;84925;55486;25904;344901;151649;7037;80325;55214;8292;10644;51447;152185;5708;200916;6159;8314;11070;10425;23243;10675;100534599;94032;28976;6787;79669;54464;55773;26032;254887;23527;56983;131375;5361;375346;51726;10752;1524;57560;7545;339855;285346;3921;24142;115560;2272;5627;56922;64145;57337;55081;4311;64925;440956;5576;401067;3708;23066;3373;6750;389170;8536;285386;3836;2632;5868;8692;9852;285282;6514;51738;5210;57129;2960;84892;7433;54931;7029;6498;64147;53836;403277;201595;131566;5947;8419;151835;54918;57650;57047;83893;8994;90288;1295;79674;9616;84077;9881;57060;25847;79858;5162;9276;590;1475;255798;84561;1814;92999;6997;63899;4241;2912;152330;8820;26084;11148;254827;200958;1849;275;7476;344838;9497;28999;5523;79188;3355;110599564;22808;643853;51560;6596;79740;10015;27333;199223;7867;11344;3699;2047;6480;25937;211;115286;5359;131149;6476;55845;54899;375323;348807;64393;51304;26354;100526760;55171;57110;54681;5745;59343;941;6165;54986;5806;131540;10057;9779;6331;859;846;11167;285315;3827;668;7401;57599;132014;5915;10201;80723;51122;131831;84517;10550;1359;2257;4585;339896;257313;152189;10180;9034;200845;54763;5062;131450;80111;653659;5922;5648;7707;7047;9370;389161;8997;84522;4634;51372;5333;25976;389119;91653;7869;26998;8930;7866;54554;100505385;644974;339883;5357;205564;79929;51409;9695;79310;54625;105374250;91775;5067;3568;132112;26341;23272;4710;9045;10869;3913;84129;10991;64343;1739;942;7086;11277;23129;8893;29890;55279;29995;116135;387;51714;84692;2177;64422;63891;51188;185;55888;83939;51365;28990;317649;60675;151871;9175;10039;57088;200879;131096;7555;1499;9209;100287362;13;377047;483;201627;131870;2917;56648;8743;23350;3615;23218;3840;4292;885;79598;8607;79782;7372;131368;29072;55079;26996;50650;4291;26577;10641;79443;6538;54437;50853;25890;9730;54165;132141;285237;166336;83597;27086;10663;5352;56852;6747;285368;9941;22907;5010;56954;131578;54861;152405;152137;152078;200942;23228;151903;25871;4820;27074;197;51193;29909;152015;491;1608;729627;79012;64110;80335;5894;727936;55186;27303;1294;84315;165918;1951;152110;114884;4134;27094;5291;54859;201625;84836;645840;9934;54847;131616;7048;201562;64084;5504;141;5912;117248;10274;200810;22820;151648;57461;5096;3556;26018;255758;116211;152002;10293;152404;1237;112616;115795;131377;51460;6533;131965;4045;7862;1795;51554;51146;80117;5859;132203;205428;2720;7342;375337;64651;7200;132204;10533;84126;23023;11342;25827;6396;2317;100132146;55689;9117;93973;55779;9718;27136;64778;91869;285231;7182;90113;2049;9467;10491;58515;1981;25945;386724;10474;7879;389118;2042;6152;55209;131034;1230;6529;256356;50512;92106;5021,1044
-1,1,3,73707,2362770,2289063,27255;10752;152330,3
-1,1,3,73914,5832807,5758893,51095;51185;3568;10752;9695;285362;27255;3708;57633;8553;6419;152330;55207,13
-1,1,3,73914,6107686,6033772,51095;51185;3568;10752;9695;285362;27255;3708;57633;8553;6419;152330;55207,13
-1,1,3,73914,7098404,7024490,2917;51095;51185;3568;10752;9695;285362;27255;3708;57633;8553;6419;152330;55207,14
-1,1,3,73914,9107971,9034057,2917;51095;51185;56852;9901;10752;9695;285362;3708;27255;6419;51066;152330;3568;29995;57633;8553;859;5021;55207,20
-1,1,3,73914,9511190,9437276,2917;51095;51185;56852;9901;25917;10752;9695;285362;3708;27255;6419;51066;152330;55209;3568;29995;57633;8553;859;5021;55207,22
-1,1,3,73914,9616678,9542764,2917;51095;51185;56852;9901;25917;10752;9695;285362;3708;27255;6419;51066;152330;55209;3568;29995;57633;8553;375323;859;5021;55207,23
-1,1,3,73914,10364808,10290894,51185;55831;9901;6396;9695;7428;285367;3708;4968;6419;151835;9797;3568;29995;26140;8536;84522;859;63924;100526693;55207;2177;2917;51095;56852;25917;401052;115795;10752;132014;285368;285362;27255;10474;7862;51066;152330;51738;84818;55209;78987;3656;64419;10093;55845;57633;8553;375323;5021,49
-1,1,3,73914,10672995,10599081,51185;55831;9901;6396;9695;7428;285367;3708;4968;491;6419;151835;9797;3568;29995;26140;8536;84522;859;63924;100526693;55207;2177;2917;51095;56852;25917;401052;115795;10752;132014;285368;285362;27255;10474;7862;51066;152330;51738;84818;55209;78987;3656;64419;10093;55845;57633;8553;375323;5021,50
-1,1,3,73914,11421309,11347395,51185;55831;9901;6396;9695;7428;285367;3708;4968;491;6419;151835;6538;9797;3568;29995;26140;8536;84522;3269;859;63924;100526693;55207;2177;2917;51095;56852;25917;401052;115795;10752;132014;285368;285362;27255;10474;7862;51066;152330;51738;84818;55209;78987;3656;64419;6529;10093;55845;57633;8553;375323;5021;10533,54
-1,1,3,73914,12722982,12649068,51185;55831;9901;6396;9695;7428;285367;23609;3708;4968;491;6419;151835;6538;5894;9797;3568;29995;26140;5468;8536;132001;7079;84522;3269;859;63924;100526693;55207;2177;2917;51095;56852;25917;401052;115795;10752;132014;285368;100129480;285362;6854;27255;10474;7862;51066;152330;51738;84818;55209;78987;3656;64419;6529;10093;55845;57633;8553;375323;9686;5021;10533;80746,63
1,1,3,73914,13655318,13581404,285367;3708;6538;23066;9797;29995;5468;8536;132001;23225;84522;3269;63924;2177;55287;56852;25917;115795;285368;285362;6854;27255;7862;6161;51738;78987;9922;10093;55845;57633;8553;375323;10533;51185;55831;9901;6396;79885;9695;7428;23609;4968;491;6419;151835;5894;3568;26140;7079;859;100526693;55207;2917;51095;401052;10752;132014;100129480;2199;10474;51066;152330;84818;55209;3656;64419;6529;9686;5021;80746,70
1,1,3,73914,20375879,20301965,7476;23473;80746;285367;3708;8850;151648;79188;6538;23066;1618;9797;29995;80852;5468;8536;339862;132001;23225;151649;84522;3269;5868;63924;2177;55287;56852;25917;115795;285368;6533;285362;6854;131965;27255;7862;8292;6161;51738;5021;78987;6304;285381;9922;10093;7508;85403;55845;23228;57633;8553;375323;10533;151651;51185;55831;9901;79885;23243;6396;131096;9695;7428;23609;4968;491;6419;151835;5894;3568;26140;26061;9779;686;7079;859;7182;84077;100526693;55207;9467;2917;51095;64432;401052;100129480;10752;132014;2199;10474;27258;51066;152330;84818;55209;131474;3656;64419;6529;51244;92106;152273;9686;23180;64145;117248,106
1,1,3,73914,30105699,30031785,7476;23473;9497;80746;285367;3708;8850;151648;79188;6538;23066;1618;9797;29995;80852;5468;8536;339862;8320;9975;116135;132001;23225;84522;151649;3269;5868;63924;2177;6138;55287;56852;25917;115795;285368;6533;285362;6854;54995;27255;131965;7862;8292;6161;51738;55768;152098;5021;78987;6304;285381;9922;10093;7508;85403;55845;23228;57633;7068;8553;375323;10533;151651;51185;55831;9901;79885;23243;6396;131096;9695;7428;23609;4968;491;7325;7155;6419;151835;79750;5894;3568;26140;7324;152100;27303;26061;9779;686;7079;859;7182;84077;100526693;55207;152110;9467;51095;2917;64432;401052;100129480;10752;132014;5915;2199;28512;10474;27258;51066;64343;152330;84818;55209;131474;3656;64419;6529;51244;92106;152273;9686;23180;64145;117248,125
1,1,3,93949,910076,816127,10752,1
-1,1,3,93949,4562686,4468737,51095;51185;3568;10752;285362;27255;3708;57633;6419;152330,10
-1,1,3,93949,4869174,4775225,51095;51185;3568;10752;285362;27255;3708;57633;6419;152330,10
-1,1,3,93949,5179947,5085998,51095;51185;3568;10752;285362;27255;3708;57633;8553;6419;152330;55207,12
1,1,3,93949,6007771,5913822,51095;51185;3568;10752;9695;285362;27255;3708;57633;8553;6419;152330;55207,13
-1,1,3,93949,6319291,6225342,51095;51185;3568;10752;9695;285362;27255;3708;57633;8553;6419;152330;55207,13
-1,1,3,93949,9491994,9398045,2917;51095;51185;56852;9901;25917;10752;9695;285362;3708;27255;6419;51066;152330;55209;3568;29995;57633;8553;859;5021;55207,22
1,-1,3,94430,159779,65349,,0
-1,1,3,94430,8412059,8317629,2917;51095;51185;3568;10752;9695;285362;27255;3708;57633;8553;6419;152330;55207,14
1,1,3,94991,41423012,41328021,6769;344787;285367;3708;6538;23066;50853;9797;5468;8536;339862;8320;9975;51143;84522;5868;10777;63924;5333;285267;253639;55287;56852;25917;9852;285368;285362;6854;54995;27255;9941;285268;10217;165904;51738;78987;6304;9943;85403;339883;23228;57633;8553;54977;9942;9389;9901;79885;9695;201595;4968;491;7155;151835;4615;5894;54918;3568;26140;7324;152100;27303;9940;7079;2803;4336;84077;64145;9881;152110;51095;30;114884;401052;100129480;9045;2199;28512;51066;64343;152330;6336;3656;7048;51244;152273;9686;23180;1233;9390;117248;7476;23473;85443;9497;8850;151648;79188;956;1618;29995;80852;116135;132001;23225;25904;1237;151649;643853;3269;10015;93;112616;2177;199223;6138;23122;115795;6533;131965;3680;7862;8292;6161;55768;152098;285381;9922;10093;7508;10289;55845;2720;7068;7342;375323;64651;10533;151651;51185;55831;23243;6396;131096;25827;1499;7428;9209;23609;11280;7325;64689;6419;54986;79750;26061;131405;26032;9779;686;6331;859;7182;100526693;55207;9467;2917;64432;10491;10752;132014;5915;57599;1524;10474;27258;25924;84818;55209;131474;64419;23171;6529;4292;3921;92106;5021;339896;80746;152189,190
1,-1,3,127520,337899,210379,10752,1
1,-1,3,232496,255379,22883,10752,1
1,-1,3,232496,255379,22883,10752,1
1,-1,3,270649,283052,12403,10752,1
1,-1,3,571267,1347588,776321,27255,1
1,-1,3,571267,1347588,776321,27255,1
1,-1,3,666257,1133628,467371,,0
1,-1,3,726645,800324,73679,,0
-1,1,3,730581,11092828,10362247,51185;55831;9901;6396;9695;7428;285367;3708;4968;491;6419;151835;6538;9797;3568;29995;26140;8536;84522;859;63924;100526693;55207;2177;2917;51095;56852;25917;401052;115795;132014;285368;285362;27255;10474;7862;51066;152330;51738;84818;55209;78987;3656;64419;6529;10093;55845;57633;8553;375323;5021,51
1,-1,3,857141,1427460,570319,27255,1
1,-1,3,1120841,1301800,180959,27255,1
1,-1,3,1167732,1237717,69985,27255,1
1,-1,3,1603622,1706230,102608,,0
1,-1,3,1603622,1706230,102608,,0
1,-1,3,1603622,1706230,102608,,0
-1,-1,3,1797444,2026210,228766,,0
-1,-1,3,1822272,1980753,158481,,0
1,-1,3,1840279,1922459,82180,,0
1,-1,3,1840308,1922488,82180,,0
-1,-1,3,1922459,1962679,40220,,0
1,-1,3,2294910,2579174,284264,152330,1
-1,-1,3,2516991,2581838,64847,152330,1
-1,-1,3,2530787,2579174,48387,152330,1
1,-1,3,2644609,2796570,151961,152330,1
1,-1,3,2718482,2740059,21577,152330,1
-1,1,3,2930451,5953602,3023151,51095;51185;3568;9695;285362;3708;57633;8553;6419;152330;55207,11
-1,1,3,2933269,5953309,3020040,51095;51185;3568;9695;285362;3708;57633;8553;6419;152330;55207,11
-1,-1,3,2939700,2972075,32375,152330,1
-1,1,3,2962570,5902795,2940225,51095;51185;3568;9695;285362;3708;57633;8553;6419;152330;55207,11
-1,-1,3,3036600,3065980,29380,152330,1
-1,-1,3,4002209,4231172,228963,,0
-1,-1,3,4053328,4324235,270907,,0
-1,-1,3,4094267,4231359,137092,,0
-1,-1,3,4191029,4324235,133206,,0
-1,1,3,4513392,4573345,59953,3708,1
-1,-1,3,6319232,6852338,533106,,0
-1,1,3,6842555,10153209,3310654,2917;55831;56852;9901;25917;401052;115795;132014;285368;285367;4968;10474;7862;151835;51066;84818;55209;78987;64419;29995;26140;10093;8536;84522;375323;859;63924;5021;100526693;2177,30
1,1,3,7397797,14401942,7004145,7476;55831;9901;6396;79885;7428;285367;23609;4968;491;79188;151835;6538;23066;5894;9797;29995;26140;5468;8536;132001;23225;7079;84522;3269;859;63924;100526693;2177;2917;55287;56852;25917;401052;115795;100129480;132014;285368;2199;6854;10474;7862;27258;51066;6161;51738;84818;55209;78987;3656;64419;131474;6529;10093;9922;7508;55845;375323;9686;5021;10533;80746,62
-1,-1,3,7876256,8017421,141165,,0
-1,-1,3,7989510,8080414,90904,,0
-1,1,3,8361812,9437652,1075840,859;5021;56852;29995;9901;25917;51066,7
-1,1,3,9436558,11732086,2295528,55831;6396;7428;285367;4968;491;151835;6538;9797;26140;8536;84522;3269;63924;100526693;2177;115795;401052;132014;285368;10474;7862;51738;84818;55209;78987;3656;64419;6529;10093;55845;375323;9686;10533,34
-1,1,3,9666380,10028247,361867,55831;132014;285368;285367;4968;10474;7862;151835;84818;78987;64419;26140;10093;8536;84522;63924;100526693,17
-1,1,3,9917593,10614361,696768,55831;115795;401052;6396;132014;285368;7428;491;51738;84818;78987;3656;9797;55845;84522;63924;2177,17
-1,1,3,9937745,10262646,324901,84818;78987;55831;115795;3656;401052;132014;285368;7428;55845;2177,11
-1,1,3,10035404,11771570,1736166,55831;115795;401052;6396;7428;491;6538;51738;3656;9797;6529;55845;3269;9686;10533;2177,16
1,-1,3,12684054,12775771,91717,55287;5894,2
1,-1,3,12684054,12775771,91717,55287;5894,2
1,1,3,14402247,21697626,7295379,23473;23243;131096;8850;151648;79750;1618;80852;26061;339862;9779;686;151649;5868;7182;84077;9467;64432;6533;131965;8292;285381;6304;85403;23228;51244;92106;152273;23180;64145;117248;151651,32
-1,-1,3,20665501,20764881,99380,,0
1,-1,3,21805856,22229796,423940,,0
1,-1,3,22120611,22197035,76424,,0
-1,-1,3,22120611,22255029,134418,,0
1,-1,3,23709628,23825386,115758,,0
-1,-1,3,26060682,26237778,177096,,0
-1,-1,3,26060682,26279585,218903,,0
-1,1,3,29255443,35022806,5767363,23122;25827;344787;114884;10491;201595;54918;131405;7048;25904;27303;26032;51143;23171;643853;2720;7342;10015;339896;112616;152189;1233,22
-1,-1,3,30676131,30680105,3974,7048,1
1,1,3,33769898,40703942,6934044,9942;85443;6769;9389;9209;11280;64689;956;4615;50853;9940;1237;6331;10015;10777;2803;93;4336;9881;199223;5333;285267;253639;30;9852;57599;3680;9941;1524;9045;285268;10217;165904;25924;6336;9943;4292;3921;10289;339883;64651;54977;9390,43
1,-1,3,35807767,35926519,118752,10777,1
-1,1,3,36870006,37048718,178712,4292;9881;9852,3
1,-1,3,36976785,37099615,122830,4292;9852;9881;9209,4
1,-1,3,38598251,38598631,380,6331,1
1,-1,3,38598462,38598576,114,6331,1
1,-1,3,38598462,38598631,169,6331,1
1,1,3,45921375,50787353,4865978,10180;9034;29072;64925;51385;1232;5576;51246;10641;79443;7318;11334;3373;4057;55152;259173;10293;440955;9807;387;6405;4634;23276;83597;51372;7867;10663;63891;29925;389119;8692;259236;79442;7869;54870;22907;10181;5364;7375;8927;84276;6599;5210;51447;1795;2779;200942;820;7866;5859;132228;6988;51364;11068;151903;2829;646450;79714;84126;11070;7384;51161;375341;64147;11180;10425;10675;51409;29122;54681;100287362;5745;2876;646424;788;79012;100132146;377047;54585;11186;339906;51517;327;4485;1294;84315;285231;1951;25915;339834;22937;90226;10803;646498;9254;1154;4134;386724;10201;10869;3913;6997;54859;10991;1605;389118;65010;2771;3615;23218;1230;8372;993;4486;24142;1234;11277;729230;25930;275,120
1,1,3,45921375,50787353,4865978,10180;9034;29072;64925;51385;1232;5576;51246;10641;79443;7318;11334;3373;4057;55152;259173;10293;440955;9807;387;6405;4634;23276;83597;51372;7867;10663;63891;29925;389119;8692;259236;79442;7869;54870;22907;10181;5364;7375;8927;84276;6599;5210;51447;1795;2779;200942;820;7866;5859;132228;6988;51364;11068;151903;2829;646450;79714;84126;11070;7384;51161;375341;64147;11180;10425;10675;51409;29122;54681;100287362;5745;2876;646424;788;79012;100132146;377047;54585;11186;339906;51517;327;4485;1294;84315;285231;1951;25915;339834;22937;90226;10803;646498;9254;1154;4134;386724;10201;10869;3913;6997;54859;10991;1605;389118;65010;2771;3615;23218;1230;8372;993;4486;24142;1234;11277;729230;25930;275,120
-1,1,3,46768104,47009805,241701,100287362;377047;5745;151903;4634;339906,6
1,-1,3,49723098,49728537,5439,63891;4485,2
1,-1,3,49723098,49728537,5439,63891;4485,2
1,-1,3,49723098,49728537,5439,63891;4485,2
1,1,3,50856276,51245158,388882,1795,1
1,1,3,50856276,51245158,388882,1795,1
1,-1,3,55745130,55817929,72799,26059,1
-1,1,3,57174452,90309110,33134658,55079;57415;6314;2850;200845;8618;55279;3355;23024;26018;84541;100288801;80145;407738;56203;2272;23150;2632;285237;166336;26060;27086;9861;285203;7871;9039;200844;115286;389136;151987;8545;11170;132203;253559;317649;54899;60675;132204;55096;131177;151647;8309;2317;11102;55164;5449;8801;5067;727936;201627;6092;4286;201626;6091;7110;23429;142686;100131827;5162;378;57406;1776;25978;8820;54756;201625;2042;10550;56999;9223;5793,71
-1,1,3,57416265,64870197,7453932,9861;8309;55079;57415;6314;5162;2317;11102;7871;200845;378;57406;200844;1776;8618;132204;201625;201627;80145;11170;132203;2272;54899;56999;201626;166336;131177;5793,28
-1,-1,3,60088353,60240457,152104,2272,1
-1,-1,3,60088353,60240457,152104,2272,1
-1,-1,3,60088353,60240457,152104,2272,1
-1,-1,3,60877562,61231290,353728,2272,1
1,-1,3,62899672,63184850,285178,,0
-1,-1,3,65170204,65213448,43244,,0
1,-1,3,66631012,66668048,37036,,0
-1,1,3,67441430,73463152,6021722,285203;2850;9039;55164;8801;23024;10550;727936;151987;55096;407738;56203;317649;23150;4286;60675;7110;23429;151647;27086,20
-1,1,3,68884687,74992574,6107887,285203;2850;9039;55164;23024;5067;10550;727936;151987;56203;317649;23150;4286;60675;7110;23429;55096;151647;27086,19
-1,1,3,69964029,70538306,574277,4286,1
-1,1,3,70433832,77012164,6578332,5067;100131827;2850;727936;151987;55096;100288801;6092;317649;23024;60675;55164;23429;27086,14
-1,1,3,70992771,71911040,918269,317649;2850;60675;27086,4
-1,1,3,71008556,71049017,40461,27086,1
-1,1,3,71366497,74373822,3007325,5067;2850;727936;151987;317649;23024;60675;55164;23429;55096;27086,11
-1,1,3,73874022,90502849,16628827,5067;100131827;389136;100288801;8545;6092;253559;2632;6091;285237;55279;25978;5449;3355;2042,15
-1,1,3,74698533,89544831,14846298,100131827;389136;100288801;8545;6092;253559;2632;6091;285237;55279;25978;5449;3355;2042,14
-1,-1,3,75028665,75164716,136051,,0
1,-1,3,75571154,75703905,132751,,0
-1,-1,3,75571154,75793273,222119,100131827;100288801,2
1,-1,3,75703905,75791565,87660,100131827;100288801,2
1,-1,3,75703905,75863200,159295,100131827;100288801,2
1,-1,3,75718528,75791565,73037,100131827,1
1,-1,3,75718528,75791565,73037,100131827,1
1,-1,3,76049526,76918058,868532,6092,1
-1,-1,3,78531547,78621122,89575,,0
1,-1,3,79562574,79599463,36889,6091,1
1,-1,3,80416729,81052857,636128,,0
1,-1,3,80488971,80750263,261292,,0
1,-1,3,80488971,80750263,261292,,0
-1,-1,3,80791314,81455867,664553,,0
1,-1,3,81388075,81493667,105592,,0
-1,-1,3,82165558,82248585,83027,,0
1,-1,3,83385374,83567654,182280,,0
-1,-1,3,85457457,85615568,158111,253559,1
-1,-1,3,85570266,85615568,45302,253559,1
1,-1,3,89854127,90254003,399876,,0
1,1,3,93519464,145413168,51893704,7634;83850;54763;131450;22989;80111;26984;5922;56941;7707;55076;403274;56667;29114;286676;8997;51208;79825;91653;11343;55573;64091;339122;253461;131544;8723;81050;8930;58477;54554;9666;8856;644974;3693;64770;116064;4638;5357;199221;415117;30849;79310;257144;54625;6565;57092;401089;523;91775;10342;214;79691;10721;29927;26341;55764;6578;285335;7220;4710;151636;200959;84129;92369;79295;942;344805;55347;57501;4690;10954;348801;9435;55840;132243;56650;23129;201633;403278;5948;64332;8971;84925;868;6184;257068;80325;165721;84692;64422;6010;51365;152185;28990;7348;285195;151871;7018;114112;402135;287015;7555;100534599;4171;28976;55;79669;54464;483;55773;27031;256076;254887;56983;131873;545;5361;11073;131870;9657;79413;3059;23350;26355;339855;9626;54762;55179;79598;8607;5627;57337;55081;7372;344807;131368;2932;8702;26577;131601;84873;200894;51725;131076;54437;25890;3836;57514;4345;10063;66000;285282;56954;152405;92370;2960;151888;165631;25871;54931;50852;56945;961;7029;131890;55254;152015;403277;131566;79876;5947;8419;729627;57493;57650;1371;55186;3081;84100;90288;1295;9616;11222;25847;79858;9276;1475;55167;50939;84561;1814;80254;5291;63899;645840;54847;347736;11148;64084;201562;141;2815;349565;55032;9515;152065;10274;53833;2624;200810;344838;200895;22820;25852;28999;205717;5523;166348;57461;80218;89876;5096;114885;2804;152404;84864;51421;22808;51560;11259;6259;90102;79663;56987;2047;10402;165829;27032;4045;83666;10840;84319;51554;51146;166012;205428;57577;79364;7200;26137;348807;131669;55211;23023;10225;151887;84666;9868;941;2596;503582;55779;2838;27136;23317;51163;8403;846;389151;11167;285311;403273;285220;668;25945;80321;80723;60678;7879;84303;111;6152;131034;389152;26339;27107;256356;50512;54946;29083;51300,291
-1,1,3,93538467,116605903,23067436,7634;131368;201633;200895;403278;64332;205717;131450;55032;868;22989;80218;84873;200894;55076;403274;84864;25890;257068;29114;11259;90102;4345;84692;56987;64422;10402;91653;56954;4045;131544;81050;152185;84319;9666;151888;57577;25871;54931;50852;151871;26137;961;55211;402135;10225;151887;415117;403277;79310;131566;257144;84666;57092;9868;523;91775;10342;214;79691;2596;79669;57650;1371;55773;55779;254887;5627;26341;2838;27136;84100;1295;285335;79413;403273;285220;25945;50939;200959;1814;63899;79295;6152;9626;54847;26339;27107;11148;55347;344805;54762;79598;348801;29083;57337;56650;55081;344807,99
-1,1,3,97514213,115382196,17867983,7634;131368;348801;201633;403278;64332;205717;131450;868;22989;80218;84873;55076;403274;84864;25890;257068;29114;11259;90102;4345;84692;56987;64422;10402;91653;56954;131544;81050;152185;84319;9666;151888;57577;25871;54931;50852;151871;26137;961;55211;402135;10225;151887;403277;79310;131566;257144;84666;57092;9868;523;91775;10342;214;79691;2596;79669;57650;1371;55773;55779;254887;26341;2838;27136;84100;1295;285335;79413;403273;25945;50939;200959;1814;79295;6152;9626;54847;26339;27107;11148;55347;344805;54762;79598;55032;29083;57337;56650;55081;344807,92
1,-1,3,100360692,100444050,83358,84873;10342,2
1,-1,3,100360692,100444050,83358,84873;10342,2
1,-1,3,100360692,100444050,83358,84873;10342,2
1,-1,3,100360692,100444050,83358,84873;10342,2
1,-1,3,100360692,100444050,83358,84873;10342,2
1,-1,3,100360692,100444050,83358,84873;10342,2
1,-1,3,100360692,100444050,83358,84873;10342,2
1,-1,3,100360692,100444050,83358,84873;10342,2
1,-1,3,100360692,100444050,83358,84873;10342,2
1,-1,3,100360692,100444050,83358,84873;10342,2
1,-1,3,100360692,100444050,83358,84873;10342,2
1,-1,3,100360692,100444050,83358,84873;10342,2
1,-1,3,100360692,100444050,83358,84873;10342,2
1,-1,3,100360692,100444050,83358,84873;10342,2
1,-1,3,100360692,100444050,83358,84873;10342,2
1,-1,3,100360692,100444050,83358,84873;10342,2
1,-1,3,100360692,100444050,83358,84873;10342,2
1,-1,3,100360692,100444050,83358,84873;10342,2
1,-1,3,100360692,100444050,83358,84873;10342,2
-1,1,3,101177841,116229099,15051258,10225;151887;131368;7634;201633;64332;205717;84666;257144;57092;131450;868;55032;22989;80218;523;91775;79691;214;79669;2596;57650;55779;257068;254887;55211;29114;27136;285335;90102;84692;4345;56987;64422;79413;25945;91653;1814;4045;6152;9626;152185;54847;27107;54762;11148;55347;344805;9666;151888;57577;79598;54931;50852;26137;151871;961;29083;57337;25871;55081;344807,62
1,-1,3,102200139,102285212,85073,,0
1,1,3,103145726,197837049,94691323,7634;29970;83850;55324;54763;5290;5062;131450;1360;5984;22989;170506;80111;26984;653659;5922;5648;10051;56941;55341;56667;7707;9370;3592;389161;1894;8626;29114;286676;8997;170572;56925;51208;8706;401097;79825;151742;4071;25976;80012;91653;11343;55573;6657;26998;64091;253461;23043;339122;8723;604;4154;8930;58477;116931;2119;54554;100505385;9666;8856;644974;3693;64770;4638;116064;9197;5357;205564;199221;79929;131583;30849;7095;257144;105374250;54625;6565;64747;200909;57709;5130;401089;151963;523;79691;214;10721;29927;132112;5437;59345;55764;6578;285335;7220;151827;84859;285382;1356;257313;4710;2693;57018;1370;151636;10188;151613;84129;92369;2122;347;1739;942;51319;344805;8975;55347;344892;51068;57501;4690;22871;10954;132243;55840;9435;8833;285313;79718;5217;10195;23129;8893;622;64805;201633;5948;8971;84925;868;93109;200931;55486;6184;257068;344901;131408;11235;51714;7037;80325;165721;84692;344752;285242;64422;6010;131920;3273;55214;185;83939;51365;26043;10644;116832;4976;152185;28990;8646;5708;286827;7348;200916;285195;151871;7018;7066;9175;114112;57088;200879;287015;84107;110599583;7555;100534599;94032;4171;28976;13;55;79669;5584;54464;483;375387;5918;256076;254887;27031;23527;56983;131873;545;5361;89857;11073;131870;79572;9657;79413;51726;56648;3059;8743;57560;23350;26355;54800;7545;389177;152118;339855;9626;647309;54762;55179;3840;6434;8607;6478;56922;55081;344807;79782;7372;389158;4311;80235;2992;200933;2932;26996;8702;4291;1857;26577;131601;51725;131076;6750;54437;165679;389170;285386;54165;3836;54965;57514;4345;5352;2814;66000;10063;6747;285282;5010;89782;23101;6514;131578;152405;151790;57129;10242;152137;152078;92370;344658;2960;151888;9711;165631;25871;56945;50852;961;7029;131890;6498;51555;27074;1173;55254;197;51193;29909;53836;152015;84343;344758;79876;5947;84239;1608;8419;339829;729627;57493;64110;57650;57047;55186;3081;22916;83893;23200;165918;90288;79674;9616;11222;10686;25847;56670;79858;9276;590;1427;1475;255798;116441;55167;152138;84561;27094;1814;5291;80254;4241;84984;645840;9934;26084;347736;4711;11148;54847;64084;201562;5504;141;2815;254827;349565;200958;7881;55032;9515;5912;152065;10274;53833;2624;1974;200810;344838;25852;22820;28999;205717;5276;1181;5274;55892;5523;166348;57461;80218;89876;5096;114885;3556;2804;255758;116211;152002;110599564;152404;51421;22808;51560;6596;79740;27333;6259;90102;79663;9076;90407;56987;2047;6480;84248;344657;165829;25937;55669;27032;86;4045;83666;10840;23355;348793;5359;131149;51554;51146;80117;3280;1962;84002;166012;205428;6476;84223;57577;57552;79364;7200;348807;64393;26137;11342;131669;55211;23023;10225;55171;151887;53829;57110;84666;7104;59343;941;6165;55689;2596;503582;8087;5806;131540;10057;55779;23317;9718;27136;64778;51163;5337;8403;5028;846;389151;90113;11167;131118;285315;3827;2049;285311;654502;668;27230;7401;1981;51122;25945;344905;80321;80723;131831;60678;84517;7879;9819;84303;111;131034;389152;64108;1359;4026;85476;256356;50512;2257;22865;6474;4585;23007;54946;29083;51300,507
-1,-1,3,104077800,104264937,187137,,0
-1,1,3,105094834,117441953,12347119,10225;151887;7634;201633;205717;84666;257144;131450;868;22989;80218;523;79691;2596;214;79669;57650;55779;257068;254887;29114;27136;285335;90102;84692;4345;56987;64422;79413;25945;91653;1814;4045;9626;152185;54847;54762;11148;55347;344805;9666;151888;57577;151871;25871;50852;26137;55032;961;29083;55211;55081;344807,53
-1,-1,3,105141696,105404293,262597,214;868,2
-1,1,3,106170339,108984343,2814004,9626;57650;11148;50852;9666;84666;27136;22989;961;84692;56987;55081,12
-1,-1,3,110196839,110578711,381872,,0
-1,1,3,112152634,115507896,3355262,64422;151887;7634;201633;91653;205717;131450;1814;80218;79691;523;2596;152185;54847;54762;55779;254887;151888;57577;25871;26137;55032;29083;344807,24
-1,1,3,112144081,115514432,3370351,64422;151887;7634;201633;91653;205717;131450;1814;80218;79691;523;2596;152185;54847;54762;55779;254887;151888;57577;25871;26137;55032;29083;344807,24
-1,1,3,112144081,115514432,3370351,64422;151887;7634;201633;91653;205717;131450;1814;80218;79691;523;2596;152185;54847;54762;55779;254887;151888;57577;25871;26137;55032;29083;344807,24
-1,1,3,112183941,115492958,3309017,64422;151887;7634;201633;91653;205717;131450;1814;80218;79691;523;2596;152185;54847;54762;55779;254887;151888;57577;25871;26137;55032;29083;344807,24
-1,1,3,112239400,119749869,7510469,151887;7634;55254;201633;205717;2932;8702;131450;80218;89876;941;79691;523;2596;55779;152404;254887;56983;57514;64422;10063;91653;64091;1814;51365;4045;152405;152185;54847;54762;7348;141;8856;57577;25871;26137;55032;29083;51300;344807,40
-1,1,3,112339824,128452977,16113153,7634;2624;200810;201633;28999;205717;2932;8702;54763;84925;131450;166348;131601;80218;89876;51725;26984;114885;131076;54437;56667;7707;2804;152404;6184;286676;8997;3836;80325;57514;165721;79663;10063;91653;165829;285282;11343;64091;51365;4045;8723;83666;10840;152405;152185;2960;54554;7348;8856;166012;7372;57577;165631;64770;3693;79364;25871;116064;4638;26137;348807;131669;114112;151887;55254;152015;54625;4171;6565;57493;9515;941;79691;523;2596;503582;10721;29927;55779;3081;254887;56983;5361;846;11167;9657;285311;8607;4710;3059;1475;151636;84561;26355;1814;60678;7879;84303;111;645840;942;54847;54762;201562;141;50512;54946;10954;55840;29083;51300;152065;344807,113
-1,1,3,112590339,116461450,3871111,7634;201633;91653;205717;131450;1814;4045;80218;79691;523;2596;152185;54847;54762;55779;254887;57577;25871;26137;29083,20
-1,1,3,113841409,124251221,10409812,7634;55254;201633;2932;54625;8702;6565;84925;54763;89876;941;51725;26984;2596;2804;503582;131076;54437;10721;152404;3081;286676;8997;56983;3836;57514;846;79663;11167;9657;10063;4710;3059;1475;165829;285282;151636;64091;1814;51365;4045;26355;83666;152405;111;942;201562;2960;7348;141;8856;55840;54554;165631;64770;116064;10954;26137;4638;9515;51300,61
-1,1,3,114737921,122232245,7494324,55254;2932;8702;6565;89876;9515;941;51725;2596;2804;503582;131076;10721;152404;3081;286676;56983;3836;57514;846;11167;9657;10063;4710;3059;1475;165829;285282;64091;51365;26355;4045;152405;942;2960;7348;141;8856;54554;116064;26137;55840;51300,43
-1,-1,3,116973963,117563805,589842,,0
-1,1,3,118392745,126259573,7866828,200810;28999;2932;8702;84925;54763;89876;51725;26984;114885;2804;131076;54437;56667;7707;152404;286676;8997;3836;57514;79663;10063;165829;285282;64091;51365;83666;8723;10840;152405;2960;7348;54554;8856;166012;165631;64770;3693;79364;116064;4638;348807;131669;55254;152015;54625;6565;57493;9515;941;503582;10721;3081;56983;846;11167;9657;4710;3059;1475;151636;84561;26355;111;942;201562;141;54946;10954;55840;51300;7372,72
1,-1,3,118752388,118800220,47832,152404,1
1,-1,3,118778681,118800220,21539,152404,1
1,-1,3,118778681,118800220,21539,152404,1
-1,1,3,121643994,126501092,4857098,200810;152015;28999;54625;6565;84925;54763;57493;26984;114885;131076;54437;56667;7707;131669;286676;8997;3836;846;79663;1475;151636;84561;26355;83666;8723;10840;84303;111;645840;942;201562;54554;166012;165631;64770;3693;79364;54946;4638;10954;348807;114112;152065;7372,45
-1,1,3,129536086,141143997,11607911,53833;5948;25852;83850;5523;5096;80111;51421;22808;51560;51208;6259;2047;66000;55573;27032;253461;28990;51554;51146;92370;58477;644974;7018;56945;7200;23023;199221;287015;30849;79876;5947;8419;401089;729627;55;55186;27031;256076;23317;6578;131873;51163;8403;11073;11222;389151;25847;131870;668;79858;9276;55167;80723;80321;84129;80254;5291;92369;339855;131034;389152;55179;347736;64084;349565;4690;10274,68
-1,1,3,129536086,143100466,13564380,53833;344838;5948;25852;83850;5523;26577;5096;80111;5922;51421;22808;51560;51208;6259;2047;66000;55573;27032;253461;28990;51554;51146;92370;58477;644974;285195;7018;56945;7200;5357;23023;7029;199221;131890;287015;30849;79876;5947;8419;401089;729627;55;54464;483;55186;27031;256076;6578;23317;131873;51163;545;8403;7220;11073;9616;11222;389151;25847;131870;668;79858;9276;55167;80321;80723;23350;84129;80254;5291;92369;339855;131034;389152;55179;347736;64084;256356;349565;4690;9435;10274,83
-1,1,3,130120109,138723861,8603752,53833;25852;30849;83850;79876;5523;8419;5096;80111;401089;729627;55;27031;256076;51421;22808;23317;51560;131873;6578;51208;51163;8403;11073;6259;11222;25847;131870;2047;668;79858;66000;55573;55167;80723;27032;80321;84129;80254;5291;339855;28990;131034;51554;51146;347736;55179;58477;7018;4690;199221;10274,52
-1,1,3,132435822,144503585,12067763,53833;344838;5948;25852;83850;5523;26577;5096;80111;5922;51421;22808;51560;51208;6259;2047;66000;55573;253461;51146;92370;58477;205428;285195;7018;56945;5357;7029;199221;131890;287015;5947;8419;401089;729627;54464;483;55186;27031;6578;51163;545;8403;11073;7220;9616;389151;25847;668;9276;55167;80723;80321;23350;5291;80254;92369;339855;389152;55179;347736;64084;256356;349565;4690;9435;10274,67
-1,1,3,133976022,149447325,15471303,53833;344838;5948;25852;2992;83850;5523;26577;5096;1360;5922;51421;22808;6596;51208;5352;4071;2047;25937;185;253461;5359;51146;92370;205428;285195;56945;5357;7029;57088;199221;131890;287015;84107;84343;5947;7104;401089;729627;54464;483;57047;55186;51163;545;8403;7220;9616;389151;25847;668;9276;1356;116441;55167;80723;80321;23350;5291;80254;92369;7545;339855;389152;55179;347736;64084;1359;256356;349565;4690;9435;10274;389158,74
-1,1,3,134052395,141420300,7367905,53833;287015;5948;25852;83850;5523;5947;5096;401089;729627;5922;55186;51421;22808;51163;51208;8403;389151;25847;2047;668;9276;55167;80723;80321;5291;80254;253461;92369;339855;389152;51146;55179;347736;92370;64084;349565;4690;56945;199221;10274,41
-1,1,3,137650842,144187581,6536739,287015;344838;5948;25852;83850;5947;26577;401089;729627;5922;54464;483;55186;22808;51163;51208;545;7220;9616;389151;7029;668;9276;80321;23350;5291;253461;92369;389152;51146;55179;347736;92370;64084;205428;256356;349565;285195;56945;5357;9435;199221;131890,43
-1,1,3,137709965,143337628,5627663,287015;344838;5948;25852;83850;5947;26577;401089;729627;5922;54464;483;55186;22808;51163;51208;545;7220;9616;389151;7029;668;9276;80321;23350;5291;253461;92369;389152;51146;55179;347736;92370;64084;256356;349565;285195;56945;5357;9435;199221;131890,42
1,-1,3,137848838,137882743,33905,51146;51163,2
1,1,3,138347957,139773898,1425941,389152;55179;668;9276;5948;64084;5947;349565;5291;401089;56945;729627;389151,13
1,-1,3,141810106,141904777,94671,256356;7029,2
1,-1,3,141831928,142053109,221181,256356;54464;7029,3
1,-1,3,141831928,142053109,221181,256356;54464;7029,3
1,-1,3,141831928,142053109,221181,256356;54464;7029,3
1,-1,3,141831928,142053109,221181,256356;54464;7029,3
1,-1,3,141831928,142053109,221181,256356;54464;7029,3
1,-1,3,141831928,142053109,221181,256356;54464;7029,3
1,-1,3,141831928,142053109,221181,256356;54464;7029,3
1,-1,3,141831928,142053109,221181,256356;54464;7029,3
1,-1,3,141831928,142053109,221181,256356;54464;7029,3
1,-1,3,141867689,142051761,184072,256356;54464;7029,3
1,-1,3,141867689,142051761,184072,256356;54464;7029,3
1,-1,3,141867689,142051761,184072,256356;54464;7029,3
1,-1,3,141867689,142051761,184072,256356;54464;7029,3
1,-1,3,141867689,142051761,184072,256356;54464;7029,3
1,-1,3,141867689,142051761,184072,256356;54464;7029,3
-1,-1,3,143862793,143989329,126536,,0
-1,1,3,147180945,168415875,21234930,64805;4311;2992;5276;5274;29970;4291;1360;653659;170506;10051;165679;3592;389161;389170;56925;11235;51714;6596;79740;27333;401097;8706;151742;4071;344752;25976;6747;25937;185;83939;151790;4154;131149;80117;152078;286827;116931;100505385;6476;9197;11342;29909;53836;53829;84343;64747;344758;7104;13;5806;5918;5028;79674;285315;654502;56670;590;1356;27230;7401;51122;57018;116441;57560;131831;9819;152118;9934;51319;26084;5912;3840;1359;85476;51068;22865;6474;7881;23007;5217;6478;8833;285313,84
-1,1,3,148425748,153220169,4794421,29909;53836;53829;84343;2992;64805;7104;1360;653659;13;389161;51714;6596;5028;4071;344752;27230;7401;1356;56670;51122;25937;116441;185;83939;131831;9819;152118;4154;9934;11342;116931;1359;5217;6478;5912;285313,37
1,1,3,151818301,197845254,46026953,4311;80235;200933;29970;26996;4291;55324;5290;1857;5062;5984;170506;5648;10051;55341;9370;165679;6750;3592;1894;389170;8626;56925;285386;54165;170572;401097;8706;54965;151742;2814;25976;6747;80012;6657;26998;5010;23043;89782;23101;6514;604;131578;151790;4154;10242;57129;152137;152078;344658;100505385;2119;9711;9197;205564;6498;51555;27074;79929;1173;131583;197;51193;7095;105374250;64747;344758;200909;84239;57709;1608;339829;151963;5130;64110;132112;5437;22916;59345;83893;23200;165918;79674;151827;10686;84859;285382;590;257313;1427;2693;57018;152138;1370;255798;27094;10188;151613;2122;4241;347;1739;84984;51319;26084;4711;8975;344892;5504;51068;254827;200958;7881;22871;79718;5912;8833;10195;1974;8893;622;1181;5276;5274;55892;3556;255758;116211;93109;152002;110599564;55486;200931;131408;344901;11235;7037;79740;27333;90407;9076;285242;6480;131920;84248;3273;344657;55669;55214;86;26043;10644;116832;23355;4976;348793;131149;8646;80117;5708;1962;286827;3280;84002;200916;6476;84223;57552;7066;9175;64393;200879;55171;110599583;57110;94032;59343;6165;55689;8087;5584;5806;131540;10057;375387;5918;9718;64778;23527;5337;5028;89857;90113;131118;2049;285315;3827;79572;56648;654502;51726;1981;344905;8743;57560;54800;84517;389177;152118;647309;3840;64108;4026;85476;6434;2257;22865;6474;4585;23007;56922;79782,222
1,1,3,152356847,197851986,45495139,4311;80235;200933;29970;26996;4291;55324;5290;1857;5062;5984;170506;5648;10051;55341;9370;165679;6750;3592;1894;389170;8626;56925;285386;54165;170572;401097;8706;54965;151742;2814;25976;6747;80012;6657;26998;5010;23043;89782;23101;6514;604;131578;151790;10242;57129;152137;152078;344658;100505385;2119;9711;9197;205564;6498;51555;27074;79929;1173;131583;197;51193;7095;105374250;64747;344758;200909;84239;57709;1608;339829;151963;5130;64110;132112;5437;22916;59345;83893;23200;165918;79674;151827;10686;84859;285382;590;257313;1427;2693;57018;152138;1370;255798;27094;10188;151613;2122;4241;347;1739;84984;51319;26084;4711;8975;344892;5504;51068;254827;200958;7881;22871;79718;5912;8833;10195;1974;8893;622;1181;5276;5274;55892;3556;255758;116211;93109;152002;110599564;55486;200931;131408;344901;11235;7037;79740;27333;90407;9076;285242;6480;131920;84248;3273;344657;55669;55214;86;26043;10644;116832;23355;4976;348793;131149;8646;80117;5708;1962;286827;3280;84002;200916;6476;84223;57552;7066;9175;64393;200879;55171;110599583;57110;94032;59343;6165;55689;8087;5584;5806;131540;10057;375387;5918;9718;64778;23527;5337;5028;89857;90113;131118;2049;285315;3827;79572;56648;654502;51726;1981;344905;8743;57560;54800;84517;389177;152118;647309;3840;64108;4026;85476;6434;2257;22865;6474;4585;23007;56922;79782,221
1,-1,3,155106491,155208591,102100,23007,1
1,1,3,155836230,197851986,42015756,80235;200933;29970;26996;4291;55324;5290;1857;5062;5984;5648;10051;55341;9370;165679;6750;3592;1894;389170;8626;56925;285386;54165;170572;401097;8706;54965;151742;2814;25976;6747;80012;6657;26998;5010;23043;89782;23101;6514;604;131578;151790;10242;57129;152137;152078;344658;100505385;2119;9711;205564;6498;51555;27074;79929;1173;131583;197;51193;7095;105374250;64747;200909;84239;57709;1608;339829;151963;5130;64110;132112;5437;22916;59345;83893;23200;165918;79674;151827;10686;84859;285382;590;257313;1427;2693;57018;152138;1370;255798;27094;10188;151613;2122;4241;347;1739;84984;51319;4711;8975;344892;5504;51068;254827;200958;7881;22871;79718;10195;1974;8893;622;1181;5276;5274;55892;3556;255758;116211;93109;152002;110599564;55486;200931;131408;344901;11235;7037;79740;27333;90407;9076;285242;6480;131920;84248;3273;344657;55669;55214;86;26043;10644;116832;23355;4976;348793;131149;8646;80117;5708;1962;286827;3280;84002;200916;6476;84223;57552;7066;9175;64393;200879;55171;110599583;57110;94032;59343;6165;55689;8087;5584;5806;131540;10057;375387;5918;9718;64778;23527;5337;89857;90113;131118;2049;3827;79572;56648;654502;51726;1981;344905;8743;57560;54800;84517;389177;647309;3840;64108;4026;85476;6434;2257;22865;6474;4585;56922;79782,210
1,1,3,156039667,197840323,41800656,80235;200933;29970;26996;4291;55324;5290;1857;5062;5984;5648;10051;55341;9370;165679;6750;3592;1894;389170;8626;56925;285386;54165;170572;401097;8706;54965;151742;2814;25976;6747;80012;6657;26998;5010;23043;89782;23101;6514;604;131578;151790;10242;57129;152137;152078;344658;100505385;2119;9711;205564;6498;51555;27074;79929;1173;131583;197;51193;7095;105374250;64747;200909;84239;57709;1608;339829;151963;5130;64110;132112;5437;22916;59345;83893;23200;165918;79674;151827;10686;84859;285382;590;255798;1427;2693;57018;152138;1370;27094;10188;151613;2122;4241;347;1739;84984;51319;4711;8975;344892;5504;51068;254827;200958;7881;22871;79718;10195;1974;8893;622;1181;5276;5274;55892;3556;255758;116211;93109;152002;110599564;55486;200931;131408;344901;11235;7037;79740;27333;90407;9076;285242;6480;131920;84248;3273;344657;55669;55214;86;26043;10644;116832;23355;4976;348793;131149;8646;80117;5708;1962;286827;3280;84002;200916;6476;84223;57552;7066;9175;64393;200879;55171;110599583;57110;94032;59343;6165;55689;8087;5584;5806;131540;10057;375387;5918;9718;64778;23527;5337;56922;89857;90113;131118;2049;3827;79572;56648;654502;51726;1981;344905;8743;57560;54800;84517;389177;647309;3840;64108;4026;85476;6434;2257;22865;6474;4585;257313;79782,210
1,1,3,157128738,181637333,24508595,5276;5274;29970;26996;55892;4291;5290;10051;165679;3592;1894;56925;11235;79740;27333;401097;8706;151742;80012;344657;55669;6657;5010;23043;86;6514;151790;10242;57129;131149;80117;152078;286827;344658;100505385;200916;6476;57552;64393;6498;51555;51193;7095;64747;57709;339829;8087;5584;5806;5918;59345;83893;64778;5337;79674;151827;131118;56648;654502;590;2693;8743;57560;27094;151613;84517;2122;389177;51319;4711;3840;8975;85476;51068;254827;22865;6474;22871;79718;79782,80
1,1,3,158980631,197766890,38786259,80235;200933;29970;26996;55324;5290;1857;5062;5984;5648;10051;55341;9370;165679;6750;3592;1894;8626;285386;54165;170572;401097;8706;54965;151742;2814;80012;6657;26998;5010;23043;89782;23101;6514;604;131578;151790;10242;57129;152137;344658;100505385;2119;9711;205564;27074;6498;51555;79929;1173;131583;197;51193;7095;105374250;200909;84239;57709;1608;339829;151963;5130;64110;132112;5437;22916;59345;83893;23200;165918;151827;10686;84859;285382;590;255798;1427;2693;1370;152138;27094;10188;151613;2122;4241;347;1739;84984;4711;8975;344892;5504;51068;254827;200958;22871;79718;10195;1974;8893;622;1181;5276;5274;55892;3556;255758;116211;93109;152002;110599564;55486;200931;131408;344901;11235;7037;79740;27333;90407;9076;285242;6480;131920;84248;3273;344657;55669;55214;86;26043;10644;116832;23355;4976;348793;131149;8646;80117;5708;1962;286827;3280;84002;200916;6476;84223;57552;7066;9175;64393;200879;55171;110599583;57110;94032;59343;6165;55689;8087;5584;131540;10057;375387;9718;64778;23527;5337;56922;89857;90113;131118;2049;3827;79572;56648;654502;51726;1981;344905;8743;57560;54800;84517;389177;647309;3840;64108;4026;6434;2257;22865;4585;257313;79782,195
-1,-1,3,161435356,161520563,85207,,0
-1,-1,3,161435356,161520563,85207,,0
-1,1,3,161925999,164272614,2346615,,0
-1,-1,3,162095816,162391365,295549,,0
-1,-1,3,162540988,162768909,227921,,0
-1,-1,3,162540988,162768909,227921,,0
-1,-1,3,162540988,162768909,227921,,0
-1,-1,3,162540988,162768909,227921,,0
-1,-1,3,162540988,162768909,227921,,0
-1,-1,3,162540988,162768909,227921,,0
-1,-1,3,162540988,162768909,227921,,0
-1,-1,3,162540988,162768909,227921,,0
-1,-1,3,162540988,162768909,227921,,0
-1,-1,3,162540988,162768909,227921,,0
-1,-1,3,162540988,162768909,227921,,0
-1,-1,3,162540988,162768909,227921,,0
-1,-1,3,162540988,162768909,227921,,0
-1,-1,3,162540988,162768909,227921,,0
-1,-1,3,162540988,162768909,227921,,0
-1,-1,3,162540988,162768909,227921,,0
-1,-1,3,162540988,162768909,227921,,0
-1,-1,3,162540988,162768909,227921,,0
-1,-1,3,162540988,162768909,227921,,0
-1,-1,3,162540988,162768909,227921,,0
-1,-1,3,162540988,162768909,227921,,0
-1,-1,3,162540988,162768909,227921,,0
-1,-1,3,162540988,162768909,227921,,0
-1,-1,3,162540988,162768909,227921,,0
-1,-1,3,162540988,162768909,227921,,0
-1,-1,3,162540988,162768909,227921,,0
-1,-1,3,162540988,162768909,227921,,0
-1,-1,3,162540988,162768909,227921,,0
-1,-1,3,162540988,162768909,227921,,0
-1,-1,3,162540988,162768909,227921,,0
-1,-1,3,162540988,162768909,227921,,0
-1,-1,3,162540988,162768909,227921,,0
-1,-1,3,162540988,162768909,227921,,0
-1,-1,3,162540988,162768909,227921,,0
-1,-1,3,162540988,162768909,227921,,0
-1,-1,3,162540988,162768909,227921,,0
-1,-1,3,162540988,162768909,227921,,0
-1,-1,3,162540988,162768909,227921,,0
-1,-1,3,162540988,162768909,227921,,0
-1,-1,3,162540988,162768909,227921,,0
-1,-1,3,162540988,162768909,227921,,0
-1,-1,3,162540988,162768909,227921,,0
-1,-1,3,162540988,162768909,227921,,0
-1,-1,3,162540988,162768909,227921,,0
-1,-1,3,162540988,162768909,227921,,0
-1,-1,3,162540988,162768909,227921,,0
-1,-1,3,162540988,162768909,227921,,0
-1,-1,3,162540988,162768909,227921,,0
-1,-1,3,162540988,162768909,227921,,0
-1,-1,3,162540988,162768909,227921,,0
-1,-1,3,162540988,162768909,227921,,0
-1,-1,3,162540988,162768909,227921,,0
-1,-1,3,162540988,162768909,227921,,0
-1,-1,3,162540988,162768909,227921,,0
-1,-1,3,162540988,162768909,227921,,0
-1,-1,3,162540988,162768909,227921,,0
-1,-1,3,162540988,162768909,227921,,0
-1,-1,3,162540988,162768909,227921,,0
-1,-1,3,162540988,162768909,227921,,0
-1,-1,3,162540988,162768909,227921,,0
-1,-1,3,162540988,162768909,227921,,0
-1,-1,3,162540988,162768909,227921,,0
-1,-1,3,162540988,162768909,227921,,0
-1,-1,3,162540988,162768909,227921,,0
-1,-1,3,162540988,162768909,227921,,0
-1,-1,3,162540988,162768909,227921,,0
-1,-1,3,162540988,162768909,227921,,0
-1,-1,3,162540988,162768909,227921,,0
-1,-1,3,162540988,162768909,227921,,0
-1,-1,3,162540988,162768909,227921,,0
-1,-1,3,162540988,162768909,227921,,0
-1,-1,3,162540988,162768909,227921,,0
-1,-1,3,162540988,162768909,227921,,0
-1,-1,3,162540988,162768909,227921,,0
-1,-1,3,162540988,162768909,227921,,0
-1,-1,3,162540988,162768909,227921,,0
-1,-1,3,162540988,162768909,227921,,0
-1,-1,3,162540988,162768909,227921,,0
-1,-1,3,162540988,162768909,227921,,0
-1,-1,3,162540988,162768909,227921,,0
-1,-1,3,162540988,162768909,227921,,0
-1,-1,3,162540988,162768909,227921,,0
-1,-1,3,162540988,162768909,227921,,0
-1,-1,3,162540988,162768909,227921,,0
-1,-1,3,162540988,162768909,227921,,0
-1,-1,3,162540988,162787987,246999,,0
-1,-1,3,162540988,162787987,246999,,0
-1,-1,3,162540988,162787987,246999,,0
-1,-1,3,162540988,162787987,246999,,0
-1,-1,3,162540988,162787987,246999,,0
-1,-1,3,162540988,162787987,246999,,0
-1,-1,3,162540988,162787987,246999,,0
-1,-1,3,162540988,162787987,246999,,0
-1,-1,3,162540988,162787987,246999,,0
-1,-1,3,162540988,162787987,246999,,0
-1,-1,3,162540988,162787987,246999,,0
-1,-1,3,162540988,162787987,246999,,0
-1,-1,3,162540988,162787987,246999,,0
-1,-1,3,162540988,162787987,246999,,0
-1,-1,3,162540988,162787987,246999,,0
-1,-1,3,162540988,162787987,246999,,0
-1,-1,3,162540988,162787987,246999,,0
-1,-1,3,162540988,162787987,246999,,0
-1,-1,3,162540988,162787987,246999,,0
-1,-1,3,162540988,162787987,246999,,0
-1,-1,3,162540988,162787987,246999,,0
-1,-1,3,162540988,162787987,246999,,0
-1,-1,3,162540988,162787987,246999,,0
-1,-1,3,162540988,162787987,246999,,0
-1,-1,3,162540988,162787987,246999,,0
-1,-1,3,162540988,162787987,246999,,0
-1,-1,3,162540988,162787987,246999,,0
-1,-1,3,162540988,162787987,246999,,0
-1,-1,3,162540988,162787987,246999,,0
-1,-1,3,162540988,162787987,246999,,0
-1,-1,3,162540988,162787987,246999,,0
-1,-1,3,162540988,162787987,246999,,0
-1,-1,3,162540988,162787987,246999,,0
-1,-1,3,162540988,162787987,246999,,0
-1,-1,3,162540988,162787987,246999,,0
-1,-1,3,162540988,162787987,246999,,0
-1,-1,3,162540988,162787987,246999,,0
-1,-1,3,162540988,162787987,246999,,0
-1,-1,3,162540988,162787987,246999,,0
-1,-1,3,162540988,162787987,246999,,0
-1,-1,3,162540988,162787987,246999,,0
-1,-1,3,162540988,162787987,246999,,0
-1,-1,3,162540988,162787987,246999,,0
-1,-1,3,162540988,162787987,246999,,0
-1,-1,3,162540988,162787987,246999,,0
-1,-1,3,162540988,162787987,246999,,0
-1,-1,3,162540988,162787987,246999,,0
-1,-1,3,162540988,162787987,246999,,0
-1,-1,3,162540988,162787987,246999,,0
-1,-1,3,162540988,162787987,246999,,0
-1,-1,3,162540988,162787987,246999,,0
-1,-1,3,162540988,162787987,246999,,0
-1,-1,3,162540988,162787987,246999,,0
-1,-1,3,162540988,162787987,246999,,0
-1,-1,3,162540988,162787987,246999,,0
-1,-1,3,162540988,162787987,246999,,0
-1,-1,3,162540988,162787987,246999,,0
-1,-1,3,162540988,162787987,246999,,0
-1,-1,3,162540988,162787987,246999,,0
-1,-1,3,162540988,162787987,246999,,0
-1,-1,3,162540988,162787987,246999,,0
-1,-1,3,162540988,162787987,246999,,0
-1,-1,3,162540988,162787987,246999,,0
-1,-1,3,162540988,162787987,246999,,0
-1,-1,3,162540988,162787987,246999,,0
-1,-1,3,162540988,162787987,246999,,0
-1,-1,3,162540988,162787987,246999,,0
-1,-1,3,162540988,162787987,246999,,0
-1,-1,3,162540988,162787987,246999,,0
-1,-1,3,162540988,162787987,246999,,0
-1,-1,3,162540988,162787987,246999,,0
-1,-1,3,162540988,162787987,246999,,0
-1,-1,3,162540988,162787987,246999,,0
-1,-1,3,162540988,162787987,246999,,0
-1,-1,3,162540988,162787987,246999,,0
-1,-1,3,162540988,162787987,246999,,0
-1,-1,3,162540988,162787987,246999,,0
-1,-1,3,162540988,162787987,246999,,0
-1,-1,3,162540988,162787987,246999,,0
-1,-1,3,162540988,162787987,246999,,0
-1,-1,3,162540988,162787987,246999,,0
-1,-1,3,162540988,162787987,246999,,0
-1,-1,3,162540988,162787987,246999,,0
-1,-1,3,162540988,162787987,246999,,0
-1,-1,3,162540988,162787987,246999,,0
-1,-1,3,162540988,162787987,246999,,0
-1,-1,3,162540988,162787987,246999,,0
-1,-1,3,162540988,162787987,246999,,0
-1,-1,3,162540988,162787987,246999,,0
-1,-1,3,162540988,162787987,246999,,0
-1,-1,3,162540988,162787987,246999,,0
-1,-1,3,162540988,162787987,246999,,0
-1,-1,3,162540988,162787987,246999,,0
-1,-1,3,162540988,162787987,246999,,0
-1,-1,3,162540988,162787987,246999,,0
-1,-1,3,162540988,162787987,246999,,0
-1,-1,3,162540988,162787987,246999,,0
-1,-1,3,162540988,162787987,246999,,0
-1,-1,3,162540988,162787987,246999,,0
-1,-1,3,162540988,162787987,246999,,0
-1,-1,3,162540988,162787987,246999,,0
-1,-1,3,162540988,162787987,246999,,0
-1,-1,3,162540988,162787987,246999,,0
-1,-1,3,162540988,162787987,246999,,0
-1,-1,3,162540988,162787987,246999,,0
-1,-1,3,162540988,162787987,246999,,0
-1,-1,3,162540988,162787987,246999,,0
-1,-1,3,162540988,162787987,246999,,0
-1,-1,3,162540988,162787987,246999,,0
-1,-1,3,162540988,162787987,246999,,0
-1,-1,3,162540988,162787987,246999,,0
-1,-1,3,162540988,162787987,246999,,0
-1,-1,3,162540988,162787987,246999,,0
-1,-1,3,162540988,162787987,246999,,0
-1,-1,3,162540988,162787987,246999,,0
-1,-1,3,162540988,162787987,246999,,0
-1,-1,3,162504792,162619112,114320,,0
-1,-1,3,162504792,162619112,114320,,0
1,-1,3,162514564,162584576,70012,,0
-1,-1,3,162514564,162619112,104548,,0
-1,-1,3,162514564,162619112,104548,,0
-1,-1,3,162514564,162619112,104548,,0
-1,-1,3,162514564,162619112,104548,,0
-1,-1,3,162514564,162619112,104548,,0
-1,-1,3,162514564,162619112,104548,,0
-1,-1,3,162540838,162619112,78274,,0
-1,-1,3,162540838,162619112,78274,,0
-1,-1,3,162540838,162619112,78274,,0
-1,-1,3,162540838,162619112,78274,,0
-1,-1,3,162584576,162619112,34536,,0
-1,-1,3,162584576,162619112,34536,,0
-1,-1,3,162805350,162895756,90406,,0
-1,-1,3,162861016,162945167,84151,,0
-1,-1,3,162861016,162945167,84151,,0
-1,-1,3,162983135,163551976,568841,,0
1,-1,3,164004587,164335127,330540,,0
1,1,3,164876399,179847956,14971557,51193;5276;5274;7095;26996;55892;5290;57709;5584;1894;59345;11235;83893;64778;79740;27333;5337;151827;56648;590;80012;344657;2693;55669;8743;27094;5010;23043;86;84517;2122;6514;389177;151790;10242;57129;4711;8975;344658;200916;57552;254827;22865;22871;64393;79718;6498;51555;79782,49
1,-1,3,165772419,166613286,840867,,0
1,1,3,165854997,197851986,31996989,80235;200933;26996;55324;5290;1857;5062;5984;5648;55341;9370;6750;1894;8626;285386;54165;170572;54965;2814;80012;6657;26998;5010;23043;89782;23101;6514;604;131578;151790;10242;57129;152137;344658;2119;9711;205564;27074;6498;51555;1173;79929;131583;197;51193;7095;105374250;200909;84239;57709;1608;339829;151963;5130;64110;132112;5437;22916;59345;83893;23200;165918;151827;10686;84859;285382;257313;1427;2693;1370;152138;255798;27094;10188;151613;2122;4241;347;1739;84984;4711;8975;344892;5504;254827;200958;22871;79718;10195;1974;8893;622;1181;5274;5276;55892;3556;255758;116211;93109;152002;110599564;55486;200931;131408;344901;11235;7037;79740;27333;90407;9076;285242;6480;131920;84248;3273;344657;55669;55214;86;26043;10644;116832;23355;4976;348793;8646;5708;1962;3280;84002;200916;84223;57552;7066;9175;64393;200879;55171;110599583;57110;94032;59343;6165;55689;8087;5584;131540;10057;375387;9718;64778;23527;5337;89857;90113;131118;2049;3827;79572;56648;51726;1981;344905;8743;54800;84517;389177;647309;64108;4026;6434;2257;4585;56922;79782,177
-1,-1,3,165917468,166019876,102408,,0
-1,1,3,167336627,167406415,69788,11235;151790,2
1,1,3,167885356,197837049,29951693,80235;200933;26996;55324;5290;1857;5062;5984;5648;55341;9370;6750;1894;8626;285386;54165;170572;54965;2814;80012;6657;26998;5010;23043;89782;23101;6514;604;131578;10242;57129;152137;344658;2119;9711;205564;27074;6498;51555;1173;79929;131583;197;51193;7095;105374250;200909;84239;57709;1608;339829;151963;5130;64110;132112;5437;22916;59345;83893;23200;165918;151827;10686;84859;285382;257313;1427;2693;1370;152138;255798;27094;10188;151613;2122;4241;347;1739;84984;4711;8975;344892;5504;254827;200958;22871;79718;10195;1974;8893;622;1181;55892;3556;255758;116211;93109;152002;110599564;55486;200931;131408;344901;7037;90407;9076;285242;6480;131920;84248;3273;344657;55669;55214;86;26043;10644;116832;23355;4976;348793;8646;5708;1962;3280;84002;200916;84223;57552;7066;9175;64393;200879;55171;110599583;57110;94032;59343;6165;55689;8087;5584;131540;10057;375387;9718;64778;23527;5337;89857;90113;131118;2049;3827;79572;56648;51726;1981;344905;8743;54800;84517;389177;647309;64108;4026;6434;2257;4585;56922;79782,171
-1,-1,3,172229388,172241275,11887,8743,1
-1,1,3,173830320,182170131,8339811,51193;51555;55669;6657;27094;5290;86;151613;339829;8087;10242;57129;4711;8975;59345;254827;22871;64393;79718;131118,20
1,1,3,175886313,197845254,21958941,80235;200933;55324;5290;1857;5062;5984;5648;55341;9370;6750;8626;285386;54165;170572;54965;2814;6657;26998;89782;23101;604;131578;10242;57129;152137;2119;9711;205564;27074;51555;1173;79929;131583;197;51193;105374250;200909;84239;1608;339829;151963;5130;64110;132112;5437;22916;59345;23200;165918;10686;84859;285382;257313;1427;1370;255798;152138;27094;10188;151613;4241;347;1739;84984;4711;8975;344892;5504;200958;79718;10195;1974;8893;622;1181;3556;255758;116211;93109;152002;110599564;55486;200931;131408;344901;7037;90407;9076;285242;6480;131920;84248;3273;55214;55669;86;26043;10644;116832;23355;4976;348793;8646;5708;1962;3280;84002;84223;7066;9175;64393;200879;55171;110599583;57110;94032;59343;6165;55689;8087;131540;10057;375387;9718;23527;89857;90113;131118;2049;3827;79572;51726;1981;344905;54800;647309;64108;4026;6434;2257;4585;56922,143
1,1,3,176157699,197845254,21687555,80235;200933;55324;5290;1857;5062;5984;5648;55341;9370;6750;8626;285386;54165;170572;54965;2814;6657;26998;89782;23101;604;131578;10242;57129;152137;2119;9711;205564;27074;51555;1173;79929;131583;197;51193;105374250;200909;84239;1608;339829;151963;5130;64110;132112;5437;22916;59345;23200;165918;10686;84859;285382;257313;1427;1370;255798;152138;27094;10188;151613;4241;347;1739;84984;4711;8975;344892;5504;200958;79718;10195;1974;8893;622;1181;3556;255758;116211;93109;152002;110599564;55486;200931;131408;344901;7037;90407;9076;285242;6480;131920;84248;3273;55214;55669;86;26043;10644;116832;23355;4976;348793;8646;5708;1962;3280;84002;84223;7066;9175;64393;200879;55171;110599583;57110;94032;59343;6165;55689;8087;131540;10057;375387;9718;23527;89857;90113;131118;2049;3827;79572;51726;1981;344905;54800;647309;64108;4026;6434;2257;4585;56922,143
1,1,3,177246493,197837049,20590556,80235;200933;55324;5290;1857;5062;5984;5648;55341;9370;6750;8626;285386;54165;170572;54965;2814;6657;26998;89782;23101;604;131578;10242;57129;152137;2119;9711;205564;27074;51555;1173;79929;131583;197;51193;105374250;200909;84239;1608;339829;151963;5130;64110;132112;5437;22916;59345;23200;165918;10686;84859;285382;257313;1427;1370;255798;152138;27094;10188;151613;4241;347;1739;84984;4711;8975;344892;5504;200958;10195;1974;8893;622;1181;3556;255758;116211;93109;152002;110599564;55486;200931;131408;344901;7037;90407;9076;285242;6480;131920;84248;3273;55214;55669;86;26043;10644;116832;23355;4976;348793;8646;5708;1962;3280;84002;84223;7066;9175;64393;200879;55171;110599583;57110;94032;59343;6165;55689;8087;131540;10057;375387;9718;23527;89857;90113;131118;2049;3827;79572;51726;1981;344905;54800;647309;64108;4026;6434;2257;4585;56922,142
1,-1,3,179666123,179899347,233224,51555,1
-1,1,3,180856452,192229812,11373360,1974;8893;1181;55324;1857;5984;5648;3556;9370;6750;110599564;55486;8626;131408;344901;285386;54165;170572;90407;9076;285242;6480;131920;3273;55214;6657;26998;23101;10644;116832;604;23355;8646;152137;5708;1962;2119;84002;7066;9175;27074;200879;79929;1173;55171;197;110599583;105374250;94032;200909;1608;59343;64110;55689;10057;132112;5437;23200;9718;89857;10686;90113;2049;3827;285382;51726;1981;1427;257313;152138;54800;647309;64108;344892;4026;6434;2257;56922;10195,79
-1,1,3,180939665,182170131,1230466,6657,1
1,-1,3,181362779,181469511,106732,6657,1
-1,1,3,181407035,181511904,104869,6657,1
1,-1,3,181429948,181430953,1005,6657,1
1,1,3,181911498,197851986,15940488,1974;8893;622;80235;200933;1181;55324;1857;5062;5984;5648;55341;3556;9370;6750;255758;116211;93109;152002;110599564;55486;8626;200931;131408;344901;285386;54165;170572;7037;54965;90407;9076;2814;285242;6480;131920;84248;3273;55214;26998;89782;23101;26043;10644;116832;604;131578;23355;4976;348793;8646;152137;5708;1962;3280;2119;84002;9711;84223;7066;9175;205564;27074;200879;79929;1173;131583;55171;197;110599583;105374250;57110;94032;200909;84239;1608;5130;151963;59343;6165;64110;55689;131540;10057;375387;132112;5437;22916;23200;9718;23527;165918;89857;10686;84859;90113;2049;3827;79572;285382;51726;255798;1427;1370;1981;152138;344905;257313;10188;54800;4241;347;1739;84984;647309;64108;344892;5504;4026;6434;2257;200958;4585;56922;10195,125
-1,1,3,183178932,186838042,3659110,55171;1974;8893;197;110599583;1181;105374250;94032;200909;55324;1857;1608;5984;59343;55689;64110;9370;10057;55486;110599564;131408;5437;9718;170572;89857;90407;90113;2049;3827;285242;6480;285382;51726;1981;1427;3273;26998;54800;10644;79929;23355;8646;5708;1962;2119;6434;7066;9175;10195;200879;1173,51
1,-1,3,183960109,184107620,147511,8646;5708;110599564;110599583;1981;131408;1181;94032;5437;9718;10195;7066;90113,13
1,1,3,184561415,187178796,2617381,55171;1974;6480;197;285382;51726;1427;3273;26998;1608;5984;10644;59343;116832;5648;23355;9370;1962;64108;132112;2119;6434;9175;90407;200879;3827,26
-1,1,3,184869065,185276194,407129,285382;9175;1962;90407;200879,5
-1,1,3,185224059,185695671,471612,10644;59343;6434;200879,4
-1,1,3,185419048,186575415,1156367,55171;1974;9370;197;51726;1427;2119;3273;6434;26998;1608;5984;10644;3827,14
-1,1,3,185599934,196462295,10862361,1974;200933;5984;5648;3556;55341;9370;6750;255758;93109;152002;200931;116211;8626;344901;285386;7037;54965;9076;2814;6480;131920;3273;55214;26998;26043;116832;604;131578;4976;348793;152137;3280;2119;55171;131583;197;57110;84239;1608;5130;151963;131540;375387;132112;23527;165918;10686;3827;79572;51726;255798;1427;1370;152138;344905;10188;347;84984;647309;64108;344892;4026;6434;5504;2257;200958;4585;257313,69
-1,1,3,186482937,194130145,7647208,1974;57110;84239;151963;5984;5648;3556;9370;6750;132112;8626;344901;285386;10686;9076;2814;79572;6480;131920;55214;1370;152138;344905;116832;604;131578;4976;647309;152137;3280;64108;344892;4026;2257;257313,35
1,-1,3,189383139,189397549,14410,8626,1
1,-1,3,191261671,191479946,218275,,0
1,1,3,192470726,197845254,5374528,131583;622;80235;200933;57110;84239;5062;5130;151963;6165;55341;255758;116211;93109;152002;131540;200931;375387;22916;23527;7037;165918;54965;84859;2814;79572;84248;255798;1370;344905;10188;89782;26043;4241;347;131578;1739;4976;348793;84984;3280;5504;9711;84223;200958;4585;205564,47
1,1,3,193422394,197851986,4429592,131583;622;80235;200933;5062;5130;6165;55341;255758;116211;93109;152002;131540;200931;375387;22916;23527;7037;165918;54965;84859;2814;79572;84248;255798;1370;10188;89782;26043;4241;347;131578;1739;348793;84984;3280;5504;9711;84223;200958;4585;205564,42
1,1,3,194013986,197837069,3823083,131583;622;80235;200933;5062;5130;6165;55341;255758;116211;93109;152002;131540;200931;375387;22916;23527;7037;165918;54965;84859;2814;79572;84248;255798;1370;10188;89782;26043;4241;347;131578;1739;348793;84984;5504;9711;84223;200958;4585;205564,41
-1,1,3,194059263,197420612,3361349,131583;622;80235;200933;5062;5130;55341;255758;116211;93109;152002;131540;200931;375387;22916;23527;7037;165918;54965;2814;79572;255798;1370;10188;26043;4241;347;131578;1739;348793;84984;5504;9711;200958;4585;205564,36
1,-1,3,195263979,195459589,195610,5504;347;200958,3
1,-1,3,195263979,195459589,195610,5504;347;200958,3
1,-1,3,195263987,195463502,199515,5504;347;200958,3
1,-1,3,195358277,195425875,67598,,0
1,-1,3,195358277,195425875,67598,,0
1,-1,3,195358277,195425875,67598,,0
1,-1,3,195358277,195425875,67598,,0
1,-1,3,195358277,195425875,67598,,0
1,-1,3,195358277,195425875,67598,,0
1,-1,3,195358277,195425875,67598,,0
1,-1,3,195358277,195425875,67598,,0
1,-1,3,195358277,195425875,67598,,0
1,-1,3,195358277,195425875,67598,,0
1,-1,3,195358277,195425875,67598,,0
1,-1,3,195358277,195425875,67598,,0
1,-1,3,195358277,195425875,67598,,0
1,-1,3,195358277,195425875,67598,,0
1,-1,3,195358277,195425875,67598,,0
1,-1,3,195358277,195425875,67598,,0
1,-1,3,195358277,195425875,67598,,0
1,-1,3,195358277,195425875,67598,,0
1,-1,3,195358277,195425875,67598,,0
1,-1,3,195358277,195425875,67598,,0
1,-1,3,195358277,195425875,67598,,0
1,-1,3,195358277,195425875,67598,,0
1,-1,3,195358277,195425875,67598,,0
1,-1,3,195358277,195425875,67598,,0
1,-1,3,195358277,195425875,67598,,0
1,-1,3,195358277,195425875,67598,,0
1,-1,3,195358277,195425875,67598,,0
1,-1,3,195358277,195425875,67598,,0
1,-1,3,195358277,195425875,67598,,0
1,-1,3,195358277,195425875,67598,,0
1,-1,3,195358277,195425875,67598,,0
1,-1,3,195358277,195425875,67598,,0
1,-1,3,195358277,195425875,67598,,0
1,-1,3,195358277,195425875,67598,,0
1,-1,3,195358277,195425875,67598,,0
1,-1,3,195358277,195425875,67598,,0
1,-1,3,195358277,195425875,67598,,0
1,-1,3,195358277,195425875,67598,,0
1,-1,3,195358277,195425875,67598,,0
1,-1,3,195358277,195425875,67598,,0
1,-1,3,195358277,195565159,206882,200958;4585,2
1,-1,3,195358322,195425875,67553,,0
1,-1,3,195358322,195425875,67553,,0
-1,-1,3,195358322,195425875,67553,,0
1,-1,3,195381420,195425875,44455,,0
1,-1,3,195419197,195438493,19296,,0
1,-1,3,195419197,195438493,19296,,0
-1,-1,3,195419197,195438493,19296,,0
1,1,3,195438669,197837049,2398380,84248;622;255798;80235;200933;10188;5062;89782;5130;26043;4241;6165;1739;84984;348793;255758;116211;131540;200931;375387;22916;9711;7037;84223;165918;200958;54965;4585;205564;84859,30
1,1,3,195456034,197851986,2395952,84248;622;255798;80235;200933;10188;5062;89782;5130;26043;4241;6165;1739;84984;348793;255758;116211;131540;200931;375387;22916;9711;7037;84223;200958;165918;54965;4585;205564;84859,30
1,1,3,195456034,197851986,2395952,84248;622;255798;80235;200933;10188;5062;89782;5130;26043;4241;6165;1739;84984;348793;255758;116211;131540;200931;375387;22916;9711;7037;84223;200958;165918;54965;4585;205564;84859,30
1,-1,3,195456487,195459589,3102,200958,1
1,-1,3,195460400,195463502,3102,200958,1
1,-1,3,195565159,195645536,80377,10188,1
1,-1,3,195623819,195664132,40313,10188,1
-1,1,3,195682582,197324783,1642201,622;255798;80235;200933;5062;5130;4241;26043;1739;84984;348793;255758;116211;131540;200931;375387;22916;7037;165918;54965;205564,21
-1,1,3,195690227,197356334,1666107,622;255798;80235;200933;5062;5130;4241;26043;1739;84984;348793;255758;116211;131540;200931;375387;22916;7037;165918;54965;205564,21
-1,1,3,195690227,197356334,1666107,622;255798;80235;200933;5062;5130;4241;26043;1739;84984;348793;255758;116211;131540;200931;375387;22916;7037;165918;54965;205564,21
-1,1,3,195701162,197324783,1623621,622;255798;80235;200933;5062;5130;4241;26043;1739;84984;348793;255758;116211;131540;200931;375387;22916;7037;165918;54965;205564,21
-1,1,3,195740402,197324567,1584165,622;255798;80235;200933;5062;5130;4241;26043;1739;84984;348793;255758;116211;131540;200931;375387;22916;7037;165918;54965;205564,21
-1,1,3,195703615,197356334,1652719,622;255798;80235;200933;5062;5130;4241;26043;1739;84984;348793;255758;116211;131540;200931;375387;22916;7037;165918;54965;205564,21
-1,1,3,195725290,197344176,1618886,622;255798;80235;200933;5062;5130;4241;26043;1739;84984;348793;255758;116211;131540;200931;375387;22916;7037;165918;54965;205564,21
-1,1,3,195725290,197344176,1618886,622;255798;80235;200933;5062;5130;4241;26043;1739;84984;348793;255758;116211;131540;200931;375387;22916;7037;165918;54965;205564,21
-1,1,3,195725290,197356334,1631044,622;255798;80235;200933;5062;5130;4241;26043;1739;84984;348793;255758;116211;131540;200931;375387;22916;7037;165918;54965;205564,21
-1,1,3,195740357,197324783,1584426,622;255798;80235;200933;5062;5130;4241;26043;1739;84984;348793;255758;116211;131540;200931;375387;22916;7037;165918;54965;205564,21
-1,1,3,195740357,197339270,1598913,622;255798;80235;200933;5062;5130;4241;26043;1739;84984;348793;255758;116211;131540;200931;375387;22916;7037;165918;54965;205564,21
-1,1,3,195740402,197317103,1576701,622;255798;80235;200933;5062;5130;4241;26043;1739;84984;348793;255758;116211;131540;200931;375387;22916;7037;165918;54965;205564,21
-1,1,3,195740402,197317103,1576701,622;255798;80235;200933;5062;5130;4241;26043;1739;84984;348793;255758;116211;131540;200931;375387;22916;7037;165918;54965;205564,21
1,1,3,195780280,196264407,484127,255758;116211;131540;200931;255798;7037;165918;5130;26043,9
-1,1,3,195780280,197299752,1519472,622;255798;80235;200933;5062;5130;4241;26043;1739;84984;348793;255758;116211;131540;200931;375387;22916;7037;165918;54965;205564,21
1,-1,3,196451599,196481486,29887,5062;54965,2
1,-1,3,196825864,197385366,559502,1739;622,2
1,-1,3,197031290,197146196,114906,,0
1,-1,3,197031290,197385366,354076,622,1
1,-1,3,197259235,197385366,126131,622,1
1,-1,3,197259235,197385366,126131,622,1
1,-1,3,197513379,197603336,89957,84859,1
1,-1,3,197589515,197748514,158999,84223;6165;84859;89782,4
1,-1,3,197589515,197837069,247554,84223;6165;84859;89782,4
1,-1,3,197668799,197837049,168250,84223;6165;89782,3
1,-1,3,197717518,197837049,119531,89782,1
1,-1,3,197729964,197837049,107085,89782,1
1,-1,3,197751553,197837049,85496,89782,1
1,-1,3,197751553,197837049,85496,89782,1
1,-1,3,197821738,197895169,73431,728262,1
1,-1,3,197821738,197895169,73431,728262,1
1,-1,3,197863435,197912281,48846,728262,1
1,-1,3,197863435,197946533,83098,728262,1
1,-1,4,12440,59911,47471,152687,1
1,-1,4,12440,64577,52137,152687,1
1,-1,4,12440,64577,52137,152687,1
1,-1,4,12440,64577,52137,152687,1
1,-1,4,12440,68159,55719,152687,1
1,-1,4,12440,68159,55719,152687,1
1,-1,4,12440,117871,105431,152687,1
1,-1,4,12440,117871,105431,152687,1
1,1,4,12440,190904441,190892001,132946;100129583;4589;133022;644414;651;339965;4889;166647;285533;54872;8649;10720;27236;6999;57205;131;80014;8492;59350;4547;166752;1062;152926;3166;10733;54798;9693;58478;80306;2549;113612;9908;79071;152756;55584;55132;56884;10424;79625;80854;100507096;27065;2580;53834;84525;5158;170825;6731;401137;80319;1448;152816;259282;79725;57533;3815;5197;7363;1446;285440;51191;93624;345222;5099;10891;152559;1047;58505;836;3627;55212;124;7097;55763;10886;84709;4085;170712;10144;92610;9982;2743;51170;10941;7092;100288413;59067;1259;55345;79966;55286;474;9255;26228;54433;4543;8404;7350;54436;9364;285464;257236;255119;728393;133060;4636;54502;213;1519;6286;201895;54848;3426;9429;1060;51176;63973;9079;54510;84068;60592;84803;987;57620;3600;4825;100506013;2798;1758;51778;84273;7365;27123;100132463;10983;79633;116449;118429;3425;55534;57606;10393;57545;6002;6373;10586;27201;79807;10396;132660;10252;54532;64399;574537;175;10463;84286;285429;2261;9871;3148;64116;254251;253017;266812;285555;285525;132884;9353;132321;57495;3381;28983;55153;54790;2994;9848;10460;5311;55300;100287478;5470;5431;51023;57484;83888;100287178;57482;339976;23216;80144;441027;166815;5910;6164;11107;2921;308;125;23001;7700;7469;79155;55752;1182;55646;53407;29945;2557;55714;9948;166929;79441;116984;133308;26511;152877;132954;132851;130;5530;84103;326340;80817;3818;8654;56916;2028;11019;79960;84142;4258;27284;152687;2565;10098;10874;6783;152992;51091;886;7096;23520;6691;166785;3347;65997;64579;11162;81579;3083;5356;9464;386617;57654;285527;171024;152485;2169;65008;100287327;6189;132720;11086;1400;56898;374;132320;3660;645104;91746;22998;728369;8929;55589;51802;53343;1487;100287144;1665;3248;10699;23173;645078;84708;7424;51574;2483;53371;683;55008;5308;83478;728419;114932;5471;1609;10879;55751;8821;389208;7468;23158;2919;3346;255520;81608;84448;3184;166655;8842;8615;55203;100287205;493856;174;80157;345062;339967;401152;23231;441054;11275;7364;55236;79644;6307;4487;152519;26234;5593;7466;166378;2069;901;5196;10336;401124;79931;55601;79642;55319;9227;29063;100996939;84992;401145;1998;10611;84109;8916;25849;6372;258;79658;116966;23657;2250;84869;85460;8987;952;51313;55330;2638;6452;389207;81793;5522;2044;4306;84570;1447;890;9575;9508;54726;51316;5860;201799;654254;2712;22902;1950;51056;58503;4086;83891;579;6649;132299;55858;8633;10855;1816;419;10568;57575;79730;10861;2920;8671;291;27295;285498;6696;100287404;201965;2247;93587;728405;1633;10417;55161;57619;55325;57182;685;3558;9407;85462;2244;2926;7884;170960;56978;10296;100287238;285513;114905;201725;27146;10563;127;7366;92345;2891;166379;22872;339977;345193;27071;2993;7358;201798;3516;11199;3512;8310;8470;93627;306;3033;2982;27235;391712;152518;8999;25854;202018;55351;2121;4283;60559;5981;54490;166614;132671;54959;55016;55296;79799;1040;353497;255743;3791;84076;54940;60558;84162;55602;152573;7294;246175;6622;201780;80216;64151;8532;1977;64850;2983;10815;2243;152586;10606;55435;90826;402160;55314;128;57630;85438;285521;6133;7323;4886;150159;10227;113510;768211;93621;11341;55294;23142;11157;56606;57050;255403;84057;4790;51809;22915;399;84640;55276;2160;57728;55024;85013;2823;22824;118;5458;60312;2996;23244;4750;23321;339983;80333;64854;51705;201973;166824;57600;10608;132625;57563;152940;5978;27068;26269;728373;5393;521;205860;5783;27163;7098;152831;7345;60684;9662;133015;23284;7367;132949;5188;2266;10117;55013;54969;9778;4299;4887;6374;345275;80008;10744;10333;6870;646603;92305;57537;255324;728379;54951;132612;345274;91351;285550;442117;84179;728386;91050;6443;133121;54360;51274;3622;8467;1635;80155;51088;25898;389203;132789;140458;817;7368;6423;4043;152503;51166;132864;5481;100287441;57732;7006;260436;57587;768239;389206;25819;79884;92689;83452;166863;839;79682;27306;3954;256471;115265;100288520;23022;27152;55728;80167;55247;10692;7222;50859;1834;3015;55805;256309;80273;2868;83447;950;5161;4717;8603;56034;6779;401115;658;56955;1363;53842;166793;26057;323;2560;100631383;9348;729830;100287513;26952;285489;2895;57117;126;152789;51138;5156;1909;57721;5602;10427;152815;173;27309;2195;2110;79982;153020;3576;5473;6047;152579;54729;56977;6059;4126;9957;132430;2555;92597;345079;83894;401138;8602;441024;9987;3064;287;100287364;8819;8001;132332;728400;23240;353322;152;132989;94031;201931;23324;100506564;391723;132724;54876;9061;3093;3490;2180;84779;389199,732
-1,-1,4,29214,68159,38945,152687,1
1,-1,4,29214,68159,38945,152687,1
-1,-1,4,29214,68159,38945,152687,1
-1,-1,4,29214,68159,38945,152687,1
-1,-1,4,29214,68159,38945,152687,1
-1,1,4,29214,1925508,1896294,10336;7700;521;4636;10417;84286;654254;54872;1609;2261;255403;7884;170960;7468;152877;10296;57654;10460;3954;10861;92305;285498;10815;2580;53834;84179;5158;3425;152687;1487;54729;285464,32
-1,1,4,33574,2356516,2322942,10336;7700;521;7469;401115;4636;10417;84286;654254;54872;1609;2261;255403;79441;7884;170960;57732;7468;152877;10296;57654;353497;10460;3954;10861;92305;285498;339983;10815;2580;53834;84179;5158;3425;10608;152687;1487;54729;285464,39
-1,1,4,33574,4534781,4501207,10336;7700;521;7469;401115;79155;4636;10417;133060;55646;84286;654254;345222;54872;166793;53407;1609;2261;255403;79441;4043;10227;8602;7884;170960;57732;7468;152877;10296;3064;3083;285489;57654;353497;10460;85013;118;3954;10861;152;92305;285498;339983;10815;27065;2580;53834;84179;5158;402160;3425;10608;6452;152687;1487;6047;54729;2868;6002;285464;8603,61
1,1,4,33574,6632513,6598939,7700;521;7469;401115;79155;4636;133060;55646;654254;166793;54872;53407;1609;55351;2121;79441;7468;152877;285489;353497;152789;10861;92305;285498;10815;27065;2580;53834;84179;5158;402160;3425;152687;4487;6047;54729;6002;54360;7466;10227;10336;10417;84286;345222;2261;255403;4043;8602;7884;170960;57732;132884;10296;3064;3083;57654;10460;85013;118;1400;3954;152;23324;339983;6452;5522;10608;1487;2868;285464;8603,71
-1,-1,4,36424,68211,31787,152687,1
-1,1,4,36424,1957819,1921395,10336;7700;521;4636;10417;84286;654254;54872;1609;2261;255403;7884;170960;7468;152877;10296;57654;10460;3954;10861;92305;285498;10815;2580;53834;84179;5158;3425;152687;1487;54729;285464,32
-1,1,4,36424,3267258,3230834,10336;7700;521;7469;401115;79155;4636;10417;84286;654254;345222;54872;1609;2261;255403;79441;10227;8602;7884;170960;57732;7468;152877;10296;3064;57654;353497;10460;118;3954;10861;92305;285498;339983;10815;2580;53834;84179;5158;402160;3425;10608;6452;152687;1487;6047;54729;2868;285464;8603,50
-1,1,4,36424,3883057,3846633,10336;7700;521;7469;401115;79155;4636;10417;84286;654254;345222;54872;1609;2261;255403;79441;4043;10227;8602;7884;170960;57732;7468;152877;10296;3064;3083;285489;57654;353497;10460;118;3954;10861;152;92305;285498;339983;10815;2580;53834;84179;5158;402160;3425;10608;6452;152687;1487;6047;54729;2868;6002;285464;8603,55
-1,1,4,36424,3975771,3939347,10336;7700;521;7469;401115;79155;4636;10417;84286;654254;345222;54872;1609;2261;255403;79441;4043;10227;8602;7884;170960;57732;7468;152877;10296;3064;3083;285489;57654;353497;10460;118;3954;10861;152;92305;285498;339983;10815;2580;53834;84179;5158;402160;3425;10608;6452;152687;1487;6047;54729;2868;6002;285464;8603,55
1,1,4,36424,4098729,4062305,10336;7700;521;7469;401115;79155;4636;10417;84286;654254;345222;54872;1609;2261;255403;79441;4043;10227;8602;7884;170960;57732;7468;152877;10296;3064;3083;285489;57654;353497;10460;118;3954;10861;152;92305;285498;339983;10815;2580;53834;84179;5158;402160;3425;10608;6452;152687;1487;6047;54729;2868;6002;285464;8603,55
-1,1,4,36424,7361544,7325120,257236;7700;521;7469;79155;401115;133060;4636;55646;6286;654254;53407;54872;166793;114932;1609;55351;2121;79441;7468;152877;285489;353497;152789;9778;10861;92305;285498;57537;10815;27065;2580;53834;84179;5158;402160;3425;152687;4487;6047;54729;6002;54360;7466;10227;57533;10336;10417;93621;93624;345222;84286;2261;255403;4043;8602;7884;170960;57732;132884;10296;3083;3064;57654;10460;85013;118;1400;3954;152;23324;55330;339983;6452;5522;10608;1487;80273;2868;285464;8603,81
-1,1,4,36424,9371067,9334643,728373;257236;7700;521;7469;79155;401115;728393;133060;4636;728419;55646;6286;654254;53407;54872;166793;114932;1609;55351;2121;79441;100287513;7468;152877;285489;3166;84448;353497;152789;100287205;9778;10861;92305;285498;57537;100287404;728379;8532;10815;27065;2580;53834;84179;5158;402160;728386;3425;152687;4487;6047;54729;6002;54360;728405;27201;7466;10227;57533;10336;10417;152992;93621;93624;345222;84286;2261;255403;4043;8602;7884;170960;100287441;57732;132884;10296;3083;3064;100287238;768239;100287364;57654;10460;85013;728400;100287327;100287478;118;1400;3954;152;100288520;60312;94031;23324;55330;728369;100287178;339983;6452;5522;10608;1487;100287144;8310;80273;2868;54436;389199;285464;8603,111
1,1,4,36424,47493612,47457188,728373;7700;521;7469;79155;644414;5860;55646;166647;654254;53407;54872;29945;2557;152831;9948;79441;116984;7345;51056;57205;152877;579;133015;3166;6649;1816;80306;10568;9778;79730;10861;80008;10744;10333;55584;92305;285498;57537;100287404;728379;11019;54951;285550;27065;2580;53834;84179;5158;728386;152687;91050;54360;728405;2565;51274;259282;57533;51088;10417;152992;55161;51091;389203;132789;886;93624;345222;5099;10891;7096;4043;132864;7884;170960;100287441;57732;10296;3083;100287238;768239;389206;57654;114905;386617;170712;9982;92689;27146;100287327;1400;3954;100288520;645104;22998;728369;8929;55286;55728;7358;3516;1487;100287144;1665;8310;80273;2868;54436;9364;285464;8603;683;257236;401115;728393;133060;4636;54502;728419;202018;6286;201895;166793;323;114932;2560;1609;55351;2121;9079;5981;100287513;7468;285489;84448;55296;353497;8842;57620;60558;55203;152789;100287205;152573;64151;8532;23231;10815;116449;402160;3425;4487;6047;57545;54729;6002;6133;26234;27201;7466;10396;10227;10336;9957;401124;768211;93621;10463;84286;2555;56606;29063;285429;2261;255403;8602;254251;285525;132884;9353;3064;399;57495;100287364;55276;10460;55300;57728;85013;728400;100287478;118;152;60312;85460;94031;952;83888;23324;23244;55330;100287178;339983;54876;80333;23216;6452;389207;81793;5522;10608;3093;389199,213
-1,-1,4,37126,75706,38580,152687,1
-1,-1,4,37336,59292,21956,152687,1
-1,-1,4,37336,59292,21956,152687,1
-1,-1,4,37336,64632,27296,152687,1
-1,-1,4,37336,64632,27296,152687,1
-1,-1,4,37336,64632,27296,152687,1
-1,-1,4,37336,64632,27296,152687,1
-1,-1,4,37336,64632,27296,152687,1
-1,-1,4,37336,64632,27296,152687,1
-1,-1,4,37336,64632,27296,152687,1
-1,-1,4,37336,64632,27296,152687,1
-1,-1,4,37336,64632,27296,152687,1
-1,-1,4,37336,64632,27296,152687,1
-1,-1,4,37336,64632,27296,152687,1
-1,-1,4,37336,66316,28980,152687,1
-1,-1,4,37336,66316,28980,152687,1
-1,-1,4,37336,66316,28980,152687,1
-1,-1,4,37336,66316,28980,152687,1
-1,-1,4,37336,66316,28980,152687,1
-1,-1,4,37336,66316,28980,152687,1
-1,-1,4,37336,66316,28980,152687,1
-1,-1,4,37336,66316,28980,152687,1
-1,-1,4,37336,66316,28980,152687,1
-1,-1,4,37336,66316,28980,152687,1
-1,-1,4,37336,66316,28980,152687,1
-1,-1,4,37336,66316,28980,152687,1
-1,-1,4,37336,66316,28980,152687,1
-1,-1,4,37336,66316,28980,152687,1
-1,-1,4,37336,66316,28980,152687,1
-1,-1,4,37336,66316,28980,152687,1
-1,-1,4,37336,66316,28980,152687,1
-1,-1,4,37336,66316,28980,152687,1
-1,-1,4,37336,66316,28980,152687,1
-1,-1,4,37336,66316,28980,152687,1
-1,-1,4,37336,66316,28980,152687,1
-1,-1,4,37336,66316,28980,152687,1
-1,-1,4,37336,66316,28980,152687,1
-1,-1,4,37336,66316,28980,152687,1
-1,-1,4,37336,66316,28980,152687,1
-1,-1,4,37336,66316,28980,152687,1
-1,-1,4,37336,66316,28980,152687,1
-1,-1,4,37336,66316,28980,152687,1
-1,-1,4,37336,66316,28980,152687,1
-1,-1,4,37336,66316,28980,152687,1
-1,-1,4,37336,66316,28980,152687,1
-1,-1,4,37336,66316,28980,152687,1
-1,-1,4,37336,66316,28980,152687,1
-1,-1,4,37336,66316,28980,152687,1
-1,-1,4,37336,66316,28980,152687,1
-1,-1,4,37336,66316,28980,152687,1
-1,-1,4,37336,66316,28980,152687,1
-1,-1,4,37336,66316,28980,152687,1
-1,-1,4,37336,66316,28980,152687,1
-1,-1,4,37336,66316,28980,152687,1
-1,-1,4,37336,66316,28980,152687,1
-1,-1,4,37336,66316,28980,152687,1
-1,-1,4,37336,66316,28980,152687,1
-1,-1,4,37336,66316,28980,152687,1
-1,-1,4,37336,66316,28980,152687,1
-1,-1,4,37336,66316,28980,152687,1
-1,-1,4,37336,66316,28980,152687,1
-1,-1,4,37336,66316,28980,152687,1
-1,-1,4,37336,66316,28980,152687,1
-1,-1,4,37336,66316,28980,152687,1
-1,-1,4,37336,66316,28980,152687,1
-1,-1,4,37336,66316,28980,152687,1
-1,-1,4,37336,66316,28980,152687,1
-1,-1,4,37336,66316,28980,152687,1
-1,-1,4,37336,66316,28980,152687,1
-1,-1,4,37336,66316,28980,152687,1
-1,-1,4,37336,66316,28980,152687,1
-1,-1,4,37336,66316,28980,152687,1
-1,-1,4,37336,66316,28980,152687,1
-1,-1,4,37336,66316,28980,152687,1
-1,-1,4,37336,66316,28980,152687,1
-1,-1,4,37336,66316,28980,152687,1
-1,-1,4,37336,66316,28980,152687,1
-1,-1,4,37336,66316,28980,152687,1
-1,-1,4,37336,66316,28980,152687,1
-1,-1,4,37336,72379,35043,152687,1
-1,-1,4,37336,72379,35043,152687,1
1,-1,4,37336,127278,89942,152687;255403,2
-1,1,4,37336,3776839,3739503,10336;7700;521;7469;401115;79155;4636;10417;84286;654254;345222;54872;1609;2261;255403;79441;4043;10227;8602;7884;170960;57732;7468;152877;10296;3064;3083;285489;57654;353497;10460;118;3954;10861;152;92305;285498;339983;10815;2580;53834;84179;5158;402160;3425;10608;6452;152687;1487;6047;54729;2868;6002;285464;8603,55
-1,1,4,37336,9370984,9333648,728373;257236;7700;521;7469;79155;401115;728393;133060;4636;728419;55646;6286;654254;53407;54872;166793;114932;1609;55351;2121;79441;100287513;7468;152877;285489;3166;84448;353497;152789;100287205;9778;10861;92305;285498;57537;100287404;728379;8532;10815;27065;2580;53834;84179;5158;402160;728386;3425;152687;4487;6047;54729;6002;54360;728405;27201;7466;10227;57533;10336;10417;152992;93621;93624;345222;84286;2261;255403;4043;8602;7884;170960;100287441;57732;132884;10296;3083;3064;100287238;768239;100287364;57654;10460;85013;728400;100287327;100287478;118;1400;3954;152;100288520;60312;94031;23324;55330;728369;100287178;339983;6452;5522;10608;1487;100287144;8310;80273;2868;54436;389199;285464;8603,111
-1,1,4,37336,15870679,15833343,728373;7700;521;7469;79155;644414;55646;654254;53407;54872;9948;79441;152877;579;3166;1816;9778;10861;92305;285498;57537;100287404;728379;285550;27065;2580;53834;84179;5158;728386;152687;54360;728405;259282;57533;10417;152992;93624;345222;4043;132864;7884;170960;100287441;57732;10296;3083;100287238;768239;57654;114905;100287327;1400;3954;100288520;728369;1487;100287144;8310;80273;2868;54436;9364;285464;8603;683;257236;401115;728393;133060;4636;728419;6286;166793;114932;1609;55351;2121;100287513;7468;285489;84448;353497;152789;100287205;8532;10815;116449;402160;3425;4487;6047;57545;54729;6002;26234;27201;7466;10227;10336;9957;93621;84286;56606;2261;255403;8602;132884;3064;100287364;10460;85013;728400;100287478;118;152;60312;85460;94031;952;23324;55330;100287178;339983;6452;5522;10608;389199,128
-1,-1,4,45889,64632,18743,152687,1
-1,-1,4,45889,66316,20427,152687,1
-1,-1,4,45889,66316,20427,152687,1
-1,-1,4,45912,68185,22273,152687,1
-1,-1,4,48633,66316,17683,152687,1
-1,-1,4,48633,66316,17683,152687,1
1,-1,4,51413,113583,62170,152687,1
1,-1,4,51413,113583,62170,152687,1
-1,1,4,51413,1399150,1347737,10336;7700;521;4636;10417;10861;84286;654254;285498;54872;1609;255403;10815;2580;53834;84179;5158;170960;3425;152687;10296;1487;54729;57654;285464,25
1,1,4,51413,17799819,17748406,728373;7700;521;7469;79155;644414;5860;55646;654254;53407;54872;9948;79441;51056;152877;579;3166;1816;80306;9778;10861;92305;285498;57537;100287404;728379;285550;27065;2580;53834;84179;5158;728386;152687;54360;728405;259282;57533;10417;152992;93624;345222;4043;132864;7884;170960;100287441;57732;10296;3083;100287238;768239;57654;114905;9982;27146;100287327;1400;3954;100288520;645104;728369;1487;100287144;8310;80273;2868;54436;9364;285464;8603;683;257236;401115;728393;133060;4636;728419;202018;6286;166793;114932;1609;55351;2121;9079;100287513;7468;285489;84448;353497;8842;152789;100287205;8532;10815;116449;402160;3425;4487;6047;57545;54729;6002;26234;27201;7466;10227;10336;9957;93621;84286;56606;2261;255403;8602;132884;3064;100287364;10460;85013;728400;100287478;118;152;60312;85460;94031;952;83888;23324;55330;100287178;339983;6452;5522;10608;389199,138
1,-1,4,64577,117871,53294,152687,1
1,-1,4,66257,127278,61021,152687;255403,2
-1,1,4,68345,1999185,1930840,10336;7700;521;7469;4636;10417;84286;654254;54872;1609;2261;255403;7884;170960;7468;152877;10296;57654;10460;3954;10861;92305;285498;10815;2580;53834;84179;5158;3425;152687;1487;54729;285464,33
-1,1,4,68345,2126308,2057963,10336;7700;521;7469;401115;4636;10417;84286;654254;54872;1609;2261;255403;7884;170960;7468;152877;10296;57654;353497;10460;3954;10861;92305;285498;339983;10815;2580;53834;84179;5158;3425;152687;1487;54729;285464,36
-1,1,4,68345,2155022,2086677,10336;7700;521;7469;401115;4636;10417;84286;654254;54872;1609;2261;255403;7884;170960;7468;152877;10296;57654;353497;10460;3954;10861;92305;285498;339983;10815;2580;53834;84179;5158;3425;152687;1487;54729;285464,36
-1,1,4,68345,2502977,2434632,10336;7700;521;7469;401115;4636;10417;84286;654254;54872;1609;2261;255403;79441;7884;170960;57732;7468;152877;10296;57654;353497;10460;3954;10861;92305;285498;339983;10815;2580;53834;84179;5158;402160;3425;10608;152687;1487;6047;54729;285464,41
-1,1,4,68345,3891984,3823639,10336;7700;521;7469;401115;79155;4636;10417;84286;654254;345222;54872;1609;2261;255403;79441;4043;8602;7884;170960;57732;7468;152877;10296;3064;3083;285489;57654;353497;10460;285464;118;3954;10861;152;92305;285498;339983;10815;2580;53834;84179;5158;402160;3425;10608;6452;152687;1487;6047;54729;2868;6002;10227;8603,55
-1,1,4,68345,4044985,3976640,10336;7700;521;7469;401115;79155;4636;10417;84286;654254;345222;54872;1609;2261;255403;79441;4043;8602;7884;170960;57732;7468;152877;10296;3064;3083;285489;57654;353497;10460;285464;118;3954;10861;152;92305;285498;339983;10815;2580;53834;84179;5158;402160;3425;10608;6452;152687;1487;6047;54729;2868;6002;10227;8603,55
-1,1,4,68345,5319773,5251428,7700;521;7469;401115;79155;4636;133060;55646;654254;166793;54872;53407;1609;55351;79441;7468;152877;285489;353497;10861;92305;285498;10815;27065;2580;53834;84179;5158;402160;3425;152687;4487;6047;54729;6002;54360;10227;10336;10417;84286;345222;2261;255403;4043;8602;7884;170960;57732;10296;3064;3083;57654;10460;85013;118;3954;152;339983;6452;10608;1487;2868;285464;8603,64
-1,1,4,68345,6056753,5988408,7700;521;7469;401115;79155;4636;133060;55646;654254;166793;54872;53407;1609;55351;2121;79441;7468;152877;285489;353497;152789;10861;92305;285498;10815;27065;2580;53834;84179;5158;402160;3425;152687;4487;6047;54729;6002;54360;10227;10336;10417;84286;345222;2261;255403;4043;8602;7884;170960;57732;132884;10296;3064;3083;57654;10460;85013;118;1400;3954;152;339983;6452;10608;1487;2868;285464;8603,68
-1,1,4,68345,8731855,8663510,257236;7700;521;7469;79155;401115;133060;4636;55646;6286;654254;53407;54872;166793;114932;1609;55351;2121;79441;7468;152877;285489;84448;353497;152789;9778;10861;92305;285498;57537;8532;10815;27065;2580;53834;84179;5158;402160;3425;152687;4487;6047;54729;6002;54360;27201;7466;10227;57533;10336;10417;152992;93621;93624;345222;84286;2261;255403;4043;8602;7884;170960;57732;132884;10296;3083;3064;768239;57654;10460;85013;118;1400;3954;152;60312;94031;23324;55330;339983;6452;5522;10608;1487;8310;80273;2868;54436;389199;285464;8603,91
1,1,4,68345,8731855,8663510,257236;7700;521;7469;79155;401115;133060;4636;55646;6286;654254;53407;54872;166793;114932;1609;55351;2121;79441;7468;152877;285489;84448;353497;152789;9778;10861;92305;285498;57537;8532;10815;27065;2580;53834;84179;5158;402160;3425;152687;4487;6047;54729;6002;54360;27201;7466;10227;57533;10336;10417;152992;93621;93624;345222;84286;2261;255403;4043;8602;7884;170960;57732;132884;10296;3083;3064;768239;57654;10460;85013;118;1400;3954;152;60312;94031;23324;55330;339983;6452;5522;10608;1487;8310;80273;2868;54436;389199;285464;8603,91
-1,1,4,68345,10336032,10267687,728373;257236;7700;521;7469;79155;644414;401115;728393;133060;4636;728419;55646;6286;654254;53407;54872;166793;114932;1609;55351;9948;2121;79441;100287513;7468;152877;285489;3166;84448;1816;353497;152789;100287205;9778;10861;92305;285498;57537;100287404;728379;8532;10815;27065;2580;53834;84179;5158;402160;728386;3425;152687;4487;6047;54729;6002;54360;728405;27201;7466;10227;57533;10336;10417;152992;93621;93624;345222;84286;56606;2261;255403;4043;8602;7884;170960;100287441;57732;132884;10296;3083;3064;100287238;768239;100287364;57654;10460;85013;728400;100287327;100287478;118;1400;3954;152;100288520;60312;94031;23324;55330;728369;100287178;339983;6452;5522;10608;1487;100287144;8310;80273;2868;54436;389199;285464;8603,115
-1,1,4,68345,13770107,13701762,728373;257236;7700;521;7469;79155;644414;401115;728393;133060;4636;728419;55646;6286;654254;53407;54872;166793;114932;1609;55351;9948;2121;79441;100287513;7468;152877;579;285489;3166;84448;1816;353497;152789;100287205;9778;10861;92305;285498;57537;100287404;728379;8532;10815;27065;2580;53834;84179;5158;116449;728386;402160;3425;152687;4487;6047;54729;6002;54360;728405;27201;7466;259282;10227;57533;10336;9957;10417;152992;93621;93624;345222;84286;56606;2261;255403;4043;8602;7884;170960;100287441;57732;132884;10296;3083;3064;100287238;768239;100287364;57654;10460;85013;728400;100287327;100287478;118;1400;3954;152;100288520;60312;85460;94031;23324;55330;728369;100287178;339983;6452;5522;10608;1487;100287144;8310;80273;2868;54436;9364;389199;285464;8603,121
-1,1,4,68345,14614077,14545732,728373;257236;7700;521;7469;79155;644414;401115;728393;133060;4636;728419;55646;6286;654254;53407;54872;166793;114932;1609;55351;9948;2121;79441;100287513;7468;152877;579;285489;3166;84448;1816;353497;152789;100287205;9778;10861;92305;285498;57537;100287404;728379;8532;10815;27065;2580;53834;84179;5158;116449;728386;402160;3425;152687;4487;6047;54729;6002;54360;728405;27201;7466;259282;10227;57533;10336;9957;10417;152992;93621;93624;345222;84286;56606;2261;255403;4043;8602;7884;170960;100287441;57732;132884;10296;3083;3064;100287238;768239;100287364;57654;10460;85013;728400;100287327;100287478;118;1400;3954;152;100288520;60312;85460;94031;23324;55330;728369;100287178;339983;6452;5522;10608;1487;100287144;8310;80273;2868;54436;9364;389199;285464;8603,121
-1,1,4,68345,15197147,15128802,728373;257236;7700;521;7469;79155;644414;401115;728393;133060;4636;728419;55646;6286;654254;53407;54872;166793;114932;1609;55351;9948;2121;79441;100287513;7468;152877;579;285489;3166;84448;1816;353497;152789;100287205;9778;10861;92305;285498;57537;100287404;728379;8532;10815;27065;2580;53834;84179;5158;116449;728386;402160;3425;152687;4487;6047;54729;6002;54360;728405;27201;7466;259282;10227;57533;10336;9957;10417;152992;93621;93624;345222;84286;56606;2261;255403;4043;8602;132864;7884;170960;100287441;57732;132884;10296;3083;3064;100287238;768239;100287364;57654;10460;85013;728400;100287327;100287478;118;1400;3954;152;100288520;60312;85460;94031;23324;55330;728369;100287178;339983;6452;5522;10608;1487;100287144;8310;80273;2868;54436;9364;389199;285464;8603,122
-1,1,4,68345,15973383,15905038,728373;7700;521;7469;79155;644414;55646;654254;53407;54872;9948;79441;152877;579;3166;1816;9778;10861;92305;285498;57537;100287404;728379;285550;27065;2580;53834;84179;5158;728386;152687;54360;728405;259282;57533;10417;152992;93624;345222;4043;132864;7884;170960;100287441;57732;10296;3083;100287238;768239;57654;114905;9982;100287327;1400;3954;100288520;728369;1487;100287144;8310;80273;2868;54436;9364;285464;8603;683;257236;401115;728393;133060;4636;728419;6286;166793;114932;1609;55351;2121;100287513;7468;285489;84448;353497;8842;152789;100287205;8532;10815;116449;402160;3425;4487;6047;57545;54729;6002;26234;27201;7466;10227;10336;9957;93621;84286;56606;2261;255403;8602;132884;3064;100287364;10460;85013;728400;100287478;118;152;60312;85460;94031;952;83888;23324;55330;100287178;339983;6452;5522;10608;389199,131
-1,1,4,68345,20387231,20318886,728373;7700;521;7469;79155;644414;5860;55646;654254;53407;54872;9948;79441;51056;152877;579;3166;1816;80306;9778;10861;92305;285498;57537;100287404;728379;285550;27065;2580;53834;84179;5158;728386;152687;54360;728405;259282;57533;10417;152992;93624;345222;4043;132864;7884;170960;100287441;57732;10296;3083;100287238;768239;57654;114905;9982;27146;100287327;1400;3954;100288520;645104;728369;1487;100287144;8310;80273;2868;54436;9364;285464;8603;683;257236;401115;728393;133060;4636;728419;202018;6286;166793;114932;1609;55351;2121;9079;100287513;7468;285489;84448;353497;8842;152789;100287205;64151;8532;10815;116449;402160;3425;4487;6047;57545;54729;6002;26234;27201;7466;10227;10336;9957;93621;84286;56606;2261;255403;8602;254251;132884;9353;3064;100287364;10460;85013;728400;100287478;118;152;60312;85460;94031;952;83888;23324;55330;100287178;339983;54876;6452;5522;10608;389199,142
-1,1,4,68345,20533787,20465442,728373;7700;521;7469;79155;644414;5860;55646;654254;53407;54872;9948;79441;51056;152877;579;3166;1816;80306;9778;10861;92305;285498;57537;100287404;728379;285550;27065;2580;53834;84179;5158;728386;152687;54360;728405;259282;57533;10417;152992;93624;345222;4043;132864;7884;170960;100287441;57732;10296;3083;100287238;768239;57654;114905;9982;27146;100287327;1400;3954;100288520;645104;728369;1487;100287144;8310;80273;2868;54436;9364;285464;8603;683;257236;401115;728393;133060;4636;728419;202018;6286;166793;114932;1609;55351;2121;9079;100287513;7468;285489;84448;353497;8842;152789;100287205;64151;8532;10815;116449;402160;3425;4487;6047;57545;54729;6002;26234;27201;7466;10227;10336;9957;93621;84286;56606;2261;255403;8602;254251;132884;9353;3064;100287364;10460;85013;728400;100287478;118;152;60312;85460;94031;952;83888;23324;55330;100287178;339983;54876;6452;5522;10608;389199,142
1,1,4,68345,49089361,49021016,728373;7700;521;7469;79155;644414;5860;55646;166647;654254;53407;54872;29945;2557;152831;9948;79441;116984;7345;51056;57205;152877;579;133015;3166;6649;132299;1816;80306;326340;10568;9778;79730;10861;80008;10744;10333;55584;92305;285498;57537;100287404;728379;11019;54951;285550;27065;2580;53834;84179;5158;728386;152687;91050;54360;728405;2565;51274;259282;57533;51088;10417;152992;55161;51091;389203;132789;886;93624;345222;5099;10891;7096;4043;132864;7884;170960;100287441;57732;7006;10296;3083;100287238;768239;389206;57654;114905;386617;170712;9982;92689;285527;27146;100287327;1400;3954;100288520;1259;645104;22998;728369;8929;55286;55728;7358;3516;1487;100287144;1665;8310;10699;80273;2868;54436;9364;285464;8603;683;257236;152518;401115;728393;133060;4636;54502;728419;202018;6286;201895;166793;323;114932;2560;1609;55351;2121;9079;5981;100287513;7468;285489;84448;55296;353497;8842;57620;60558;54940;55203;152789;100287205;152573;7294;201780;80157;64151;8532;23231;10815;116449;402160;3425;57606;4487;152519;6047;57545;54729;6002;6133;26234;27201;7466;10396;10227;10336;9957;401124;768211;93621;10463;84286;2555;56606;29063;285429;2261;255403;8602;254251;285525;132884;9353;3064;399;57495;100287364;55276;10460;55300;57728;85013;728400;100287478;118;152;60312;85460;94031;952;83888;23324;23244;55330;100287178;339983;54876;80333;23216;6452;389207;81793;5522;10608;3093;389199,226
1,1,4,68345,49093788,49025443,728373;7700;521;7469;79155;644414;5860;55646;166647;654254;53407;54872;29945;2557;152831;9948;79441;116984;7345;51056;57205;152877;579;133015;3166;6649;132299;1816;80306;326340;10568;9778;79730;10861;80008;10744;10333;55584;92305;285498;57537;100287404;728379;11019;54951;285550;27065;2580;53834;84179;5158;728386;152687;91050;54360;728405;2565;51274;259282;57533;51088;10417;152992;55161;51091;389203;132789;886;93624;345222;5099;10891;7096;4043;132864;7884;170960;100287441;57732;7006;10296;3083;100287238;768239;389206;57654;114905;386617;170712;9982;92689;285527;27146;100287327;1400;3954;100288520;1259;645104;22998;728369;8929;55286;55728;7358;3516;1487;100287144;1665;8310;10699;80273;2868;54436;9364;285464;8603;683;257236;152518;401115;728393;133060;4636;54502;728419;202018;6286;201895;166793;323;114932;2560;1609;55351;2121;9079;5981;100287513;7468;285489;84448;55296;353497;8842;57620;60558;54940;55203;152789;100287205;152573;7294;201780;80157;64151;8532;23231;10815;116449;402160;3425;57606;4487;152519;6047;57545;54729;6002;6133;26234;27201;7466;10396;10227;10336;9957;401124;768211;93621;10463;84286;2555;56606;29063;285429;2261;255403;8602;254251;285525;132884;9353;3064;399;57495;100287364;55276;10460;55300;57728;85013;728400;100287478;118;152;60312;85460;94031;952;83888;23324;23244;55330;100287178;339983;54876;80333;23216;6452;389207;81793;5522;10608;3093;389199,226
1,1,4,68345,66440622,66372277,132946;644414;5860;166647;654254;54872;51056;57205;579;6649;3166;132299;55858;1816;80306;10568;79730;10861;55584;285498;100287404;27065;2580;53834;84525;5158;170825;6731;728405;259282;57533;3815;10417;55161;93624;345222;5099;10891;7884;170960;55763;10296;100287238;170712;114905;9982;27146;100288413;1259;339977;55286;7358;3516;8310;54436;9364;285464;257236;152518;728393;133060;4636;54502;202018;6286;201895;55351;2121;9079;5981;132671;55296;353497;3791;57620;60558;54940;152573;7294;201780;84273;64151;8532;10815;10606;116449;402160;3425;57606;57545;6002;6133;27201;10396;10227;768211;93621;23142;10463;84286;56606;285429;2261;255403;254251;253017;285525;132884;9353;399;57495;55276;10460;55300;57728;85013;100287478;118;5431;60312;83888;23244;100287178;339983;57482;80333;23216;64854;10608;5978;728373;7700;521;7469;79155;55646;53407;29945;2557;152831;9948;79441;116984;7345;26511;9662;152877;133015;132954;23284;132949;326340;9778;80008;10744;10333;92305;57537;11019;728379;54951;285550;84179;728386;152687;91050;6443;54360;2565;51274;10874;51088;152992;51091;389203;132789;886;7096;6691;4043;65997;132864;100287441;57732;7006;3083;768239;389206;57654;386617;285527;92689;100287327;1400;3954;100288520;645104;22998;728369;8929;55728;1487;100287144;1665;10699;80273;2868;84708;8603;683;401115;728419;166793;323;114932;2560;1609;5471;100287513;7468;285489;81608;84448;8842;55203;152789;100287205;5156;80157;23231;79644;4487;152519;6047;152579;54729;26234;7466;10336;9957;401124;2555;29063;8602;3064;100287364;728400;152;85460;94031;952;23324;100506564;55330;54876;6452;389207;81793;5522;2044;3093;3490;9575;389199,264
1,1,4,68346,190957473,190889127,132946;100129583;4589;133022;644414;651;339965;4889;166647;285533;54872;8649;10720;27236;6999;57205;131;80014;8492;59350;4547;166752;1062;152926;3166;10733;54798;9693;58478;80306;2549;113612;9908;79071;152756;55584;55132;56884;10424;79625;80854;100507096;27065;2580;53834;84525;5158;170825;6731;401137;80319;1448;152816;259282;79725;57533;3815;5197;7363;1446;285440;51191;93624;345222;5099;10891;152559;1047;58505;836;3627;55212;124;7097;55763;10886;84709;4085;170712;10144;92610;9982;2743;51170;10941;7092;100288413;59067;1259;55345;79966;84779;55286;474;9255;26228;54433;4543;8404;7350;54436;9364;285464;257236;255119;728393;133060;4636;54502;213;1519;6286;201895;54848;3426;9429;1060;51176;63973;9079;54510;84068;60592;84803;987;57620;3600;4825;100506013;2798;1758;51778;84273;7365;27123;100132463;10983;79633;116449;118429;3425;55534;57606;10393;57545;6002;6373;10586;27201;79807;10396;132660;10252;54532;64399;574537;175;10463;84286;285429;2261;9871;3148;64116;254251;253017;266812;285555;285525;132884;9353;132321;57495;3381;389199;28983;55153;54790;2994;9848;10460;5311;55300;100287478;5470;5431;51023;57484;83888;100287178;57482;339976;23216;80144;441027;166815;5910;6164;11107;2921;308;125;23001;7700;7469;79155;55752;1182;55646;53407;29945;2557;55714;9948;166929;79441;116984;133308;26511;152877;132954;132851;130;5530;84103;326340;80817;3818;8654;56916;2028;11019;79960;84142;4258;27284;152687;2565;10098;10874;6783;152992;51091;886;7096;23520;6691;166785;3347;65997;64579;11162;81579;3083;5356;9464;386617;57654;285527;171024;152485;2169;65008;100287327;6189;132720;11086;1400;56898;374;132320;3660;645104;91746;22998;728369;8929;55589;51802;53343;1487;100287144;1665;3248;10699;23173;645078;84708;7424;51574;2483;53371;683;55008;5308;83478;728419;114932;5471;1609;10879;55751;8821;389208;7468;23158;2919;3346;255520;81608;84448;3184;166655;8842;8615;55203;100287205;493856;174;80157;345062;339967;401152;23231;441054;11275;7364;55236;79644;6307;4487;152519;26234;5593;7466;166378;2069;901;5196;10336;401124;79931;55601;79642;55319;9227;29063;100996939;84992;401145;1998;10611;84109;25849;6372;258;79658;116966;23657;2250;84869;85460;8987;952;51313;55330;2638;6452;389207;81793;5522;2044;4306;84570;1447;890;9575;9508;54726;51316;5860;201799;654254;2712;22902;1950;51056;58503;4086;83891;579;6649;132299;55858;8633;10855;1816;419;10568;57575;79730;10861;2920;8671;291;27295;285498;6696;100287404;201965;2247;93587;728405;1633;10417;55161;57619;55325;57182;685;3558;9407;85462;2244;2926;7884;170960;56978;10296;100287238;285513;114905;201725;27146;10563;127;7366;92345;2891;166379;22872;339977;345193;27071;2993;7358;201798;3516;11199;3512;8310;8470;93627;306;3033;2982;27235;391712;152518;8999;25854;202018;55351;2121;4283;60559;5981;54490;166614;132671;54959;55016;55296;79799;1040;353497;255743;3791;84076;54940;60558;84162;55602;152573;7294;246175;6622;201780;80216;64151;8532;1977;64850;10815;2243;152586;10606;55435;90826;402160;55314;128;57630;85438;285521;6133;7323;4886;150159;10227;113510;768211;93621;11341;55294;23142;11157;56606;57050;255403;84057;4790;448831;51809;22915;399;84640;55276;2160;57728;55024;85013;2823;22824;118;5458;60312;2996;23244;4750;23321;339983;80333;64854;51705;201973;166824;57600;10608;132625;57563;152940;5978;27068;26269;728373;5393;521;205860;5783;27163;7098;152831;7345;60684;9662;133015;23284;7367;132949;5188;2266;10117;55013;54969;9778;4299;4887;6374;345275;80008;10744;10333;6870;646603;92305;57537;255324;728379;54951;132612;345274;91351;285550;442117;84179;728386;91050;6443;133121;54360;51274;3622;8467;1635;80155;51088;25898;389203;132789;140458;817;7368;6423;4043;152503;51166;132864;5481;100287441;57732;7006;260436;57587;768239;389206;25819;79884;92689;83452;166863;839;79682;27306;3954;256471;115265;100288520;23022;27152;55728;80167;55247;10692;7222;50859;1834;3015;55805;256309;80273;2868;83447;950;5161;4717;8603;56034;6779;401115;658;56955;1363;53842;166793;26057;323;2560;100631383;9348;729830;100287513;26952;285489;2895;57117;126;152789;51138;5156;1909;57721;5602;10427;152815;173;27309;2195;2110;79982;153020;3576;5473;6047;152579;54729;56977;6059;4126;9957;132430;2555;92597;345079;83894;401138;8602;441024;9987;3064;287;100287364;8819;8001;132332;728400;23240;353322;152;132989;94031;201931;23324;100506564;391723;132724;54876;9061;3093;3490;2180;2983;8916,733
1,1,4,68346,190957473,190889127,132946;100129583;4589;133022;644414;651;339965;4889;166647;285533;54872;8649;10720;27236;6999;57205;131;80014;8492;59350;4547;166752;1062;152926;3166;10733;54798;9693;58478;80306;2549;113612;9908;79071;152756;55584;55132;56884;10424;79625;80854;100507096;27065;2580;53834;84525;5158;170825;6731;401137;80319;1448;152816;259282;79725;57533;3815;5197;7363;1446;285440;51191;93624;345222;5099;10891;152559;1047;58505;836;3627;55212;124;7097;55763;10886;84709;4085;170712;10144;92610;9982;2743;51170;10941;7092;100288413;59067;1259;55345;79966;84779;55286;474;9255;26228;54433;4543;8404;7350;54436;9364;285464;257236;255119;728393;133060;4636;54502;213;1519;6286;201895;54848;3426;9429;1060;51176;63973;9079;54510;84068;60592;84803;987;57620;3600;4825;100506013;2798;1758;51778;84273;7365;27123;100132463;10983;79633;116449;118429;3425;55534;57606;10393;57545;6002;6373;10586;27201;79807;10396;132660;10252;54532;64399;574537;175;10463;84286;285429;2261;9871;3148;64116;254251;253017;266812;285555;285525;132884;9353;132321;57495;3381;389199;28983;55153;54790;2994;9848;10460;5311;55300;100287478;5470;5431;51023;57484;83888;100287178;57482;339976;23216;80144;441027;166815;5910;6164;11107;2921;308;125;23001;7700;7469;79155;55752;1182;55646;53407;29945;2557;55714;9948;166929;79441;116984;133308;26511;152877;132954;132851;130;5530;84103;326340;80817;3818;8654;56916;2028;11019;79960;84142;4258;27284;152687;2565;10098;10874;6783;152992;51091;886;7096;23520;6691;166785;3347;65997;64579;11162;81579;3083;5356;9464;386617;57654;285527;171024;152485;2169;65008;100287327;6189;132720;11086;1400;56898;374;132320;3660;645104;91746;22998;728369;8929;55589;51802;53343;1487;100287144;1665;3248;10699;23173;645078;84708;7424;51574;2483;53371;683;55008;5308;83478;728419;114932;5471;1609;10879;55751;8821;389208;7468;23158;2919;3346;255520;81608;84448;3184;166655;8842;8615;55203;100287205;493856;174;80157;345062;339967;401152;23231;441054;11275;7364;55236;79644;6307;4487;152519;26234;5593;7466;166378;2069;901;5196;10336;401124;79931;55601;79642;55319;9227;29063;100996939;84992;401145;1998;10611;84109;25849;6372;258;79658;116966;23657;2250;84869;85460;8987;952;51313;55330;2638;6452;389207;81793;5522;2044;4306;84570;1447;890;9575;9508;54726;51316;5860;201799;654254;2712;22902;1950;51056;58503;4086;83891;579;6649;132299;55858;8633;10855;1816;419;10568;57575;79730;10861;2920;8671;291;27295;285498;6696;100287404;201965;2247;93587;728405;1633;10417;55161;57619;55325;57182;685;3558;9407;85462;2244;2926;7884;170960;56978;10296;100287238;285513;114905;201725;27146;10563;127;7366;92345;2891;166379;22872;339977;345193;27071;2993;7358;201798;3516;11199;3512;8310;8470;93627;306;3033;2982;27235;391712;152518;8999;25854;202018;55351;2121;4283;60559;5981;54490;166614;132671;54959;55016;55296;79799;1040;353497;255743;3791;84076;54940;60558;84162;55602;152573;7294;246175;6622;201780;80216;64151;8532;1977;64850;10815;2243;152586;10606;55435;90826;402160;55314;128;57630;85438;285521;6133;7323;4886;150159;10227;113510;768211;93621;11341;55294;23142;11157;56606;57050;255403;84057;4790;448831;51809;22915;399;84640;55276;2160;57728;55024;85013;2823;22824;118;5458;60312;2996;23244;4750;23321;339983;80333;64854;51705;201973;166824;57600;10608;132625;57563;152940;5978;27068;26269;728373;5393;521;205860;5783;27163;7098;152831;7345;60684;9662;133015;23284;7367;132949;5188;2266;10117;55013;54969;9778;4299;4887;6374;345275;80008;10744;10333;6870;646603;92305;57537;255324;728379;54951;132612;345274;91351;285550;442117;84179;728386;91050;6443;133121;54360;51274;3622;8467;1635;80155;51088;25898;389203;132789;140458;817;7368;6423;4043;152503;51166;132864;5481;100287441;57732;7006;260436;57587;768239;389206;25819;79884;92689;83452;166863;839;79682;27306;3954;256471;115265;100288520;23022;27152;55728;80167;55247;10692;7222;50859;1834;3015;55805;256309;80273;2868;83447;950;5161;4717;8603;56034;6779;401115;658;56955;1363;53842;166793;26057;323;2560;100631383;9348;729830;100287513;26952;285489;2895;57117;126;152789;51138;5156;1909;57721;5602;10427;152815;173;27309;2195;2110;79982;153020;3576;5473;6047;152579;54729;56977;6059;4126;9957;132430;2555;92597;345079;83894;401138;8602;441024;9987;3064;287;100287364;8819;8001;132332;728400;23240;353322;152;132989;94031;201931;23324;100506564;391723;132724;54876;9061;3093;3490;2180;2983;8916,733
-1,1,4,71552,15302739,15231187,728373;257236;7700;521;7469;79155;644414;401115;728393;133060;4636;728419;55646;6286;654254;53407;54872;166793;114932;1609;55351;9948;2121;79441;100287513;7468;152877;579;285489;3166;84448;1816;353497;152789;100287205;9778;10861;92305;285498;57537;100287404;728379;8532;10815;27065;2580;53834;84179;5158;116449;728386;402160;3425;152687;4487;6047;54729;6002;54360;728405;27201;7466;259282;10227;57533;10336;9957;10417;152992;93621;93624;345222;84286;56606;2261;255403;4043;8602;132864;7884;170960;100287441;57732;132884;10296;3083;3064;100287238;768239;100287364;57654;10460;85013;728400;100287327;100287478;118;1400;3954;152;100288520;60312;85460;94031;23324;55330;728369;100287178;339983;6452;5522;10608;1487;100287144;8310;80273;2868;54436;9364;389199;285464;8603,122
1,-1,4,72320,117920,45600,152687,1
1,-1,4,72320,127278,54958,152687;255403,2
1,-1,4,72320,127278,54958,152687;255403,2
1,-1,4,72320,127278,54958,152687;255403,2
1,-1,4,72320,127278,54958,152687;255403,2
1,-1,4,72320,127278,54958,152687;255403,2
1,-1,4,72320,127278,54958,152687;255403,2
1,-1,4,72320,139860,67540,152687;255403,2
1,-1,4,72320,156164,83844,152687;255403,2
1,-1,4,72447,113583,41136,152687,1
1,-1,4,72447,113583,41136,152687,1
1,-1,4,72447,113583,41136,152687,1
1,-1,4,72447,113583,41136,152687,1
1,-1,4,72447,113583,41136,152687,1
1,-1,4,72447,113583,41136,152687,1
1,-1,4,72447,113583,41136,152687,1
1,-1,4,72447,113583,41136,152687,1
1,-1,4,72447,113583,41136,152687,1
1,-1,4,72447,160647,88200,152687;255403,2
1,-1,4,72447,160647,88200,152687;255403,2
1,-1,4,72447,160647,88200,152687;255403,2
1,-1,4,72447,160647,88200,152687;255403,2
-1,1,4,72447,2110334,2037887,10336;7700;521;7469;401115;4636;10417;84286;654254;54872;1609;2261;255403;7884;170960;7468;152877;10296;57654;353497;10460;3954;10861;92305;285498;339983;10815;2580;53834;84179;5158;3425;152687;1487;54729;285464,36
-1,1,4,72447,2691306,2618859,10336;7700;521;7469;401115;4636;10417;84286;654254;54872;1609;2261;255403;79441;7884;170960;57732;7468;152877;10296;57654;353497;10460;3954;10861;92305;285498;339983;10815;2580;53834;84179;5158;402160;3425;10608;152687;1487;6047;54729;285464;8603,42
-1,1,4,72447,3563382,3490935,10336;7700;521;7469;401115;79155;4636;10417;84286;654254;345222;54872;1609;2261;255403;79441;4043;8602;7884;170960;57732;7468;152877;10296;3064;3083;285489;57654;353497;10460;285464;118;3954;10861;92305;285498;339983;10815;2580;53834;84179;5158;402160;3425;10608;6452;152687;1487;6047;54729;2868;6002;10227;8603,54
-1,1,4,72447,3725774,3653327,10336;7700;521;7469;401115;79155;4636;10417;84286;654254;345222;54872;1609;2261;255403;79441;4043;8602;7884;170960;57732;7468;152877;10296;3064;3083;285489;57654;353497;10460;285464;118;3954;10861;92305;285498;339983;10815;2580;53834;84179;5158;402160;3425;10608;6452;152687;1487;6047;54729;2868;6002;10227;8603,54
-1,1,4,72447,4360445,4287998,10336;7700;521;7469;401115;79155;4636;10417;133060;55646;84286;654254;345222;54872;166793;1609;2261;255403;79441;4043;8602;7884;170960;57732;7468;152877;10296;3064;3083;285489;57654;353497;10460;85013;285464;118;3954;10861;152;92305;285498;339983;10815;2580;53834;84179;5158;402160;3425;10608;6452;152687;1487;6047;54729;2868;6002;10227;8603,59
-1,1,4,72447,4360445,4287998,10336;7700;521;7469;401115;79155;4636;10417;133060;55646;84286;654254;345222;54872;166793;1609;2261;255403;79441;4043;8602;7884;170960;57732;7468;152877;10296;3064;3083;285489;57654;353497;10460;85013;285464;118;3954;10861;152;92305;285498;339983;10815;2580;53834;84179;5158;402160;3425;10608;6452;152687;1487;6047;54729;2868;6002;10227;8603,59
-1,1,4,72447,4889835,4817388,10336;7700;521;7469;401115;79155;4636;10417;133060;55646;84286;654254;345222;54872;166793;53407;1609;2261;255403;79441;4043;8602;7884;170960;57732;7468;152877;10296;3064;3083;285489;57654;353497;10460;85013;285464;118;3954;10861;152;92305;285498;339983;10815;27065;2580;53834;84179;5158;402160;3425;10608;6452;152687;1487;4487;6047;54729;2868;6002;10227;8603,62
-1,1,4,72447,5346537,5274090,7700;521;7469;401115;79155;4636;133060;55646;654254;166793;54872;53407;1609;55351;79441;7468;152877;285489;353497;10861;92305;285498;10815;27065;2580;53834;84179;5158;402160;3425;152687;4487;6047;54729;6002;54360;10227;10336;10417;84286;345222;2261;255403;4043;8602;7884;170960;57732;10296;3064;3083;57654;10460;85013;118;3954;152;339983;6452;10608;1487;2868;285464;8603,64
-1,1,4,72447,6245152,6172705,7700;521;7469;401115;79155;4636;133060;55646;654254;166793;54872;53407;1609;55351;2121;79441;7468;152877;285489;353497;152789;10861;92305;285498;10815;27065;2580;53834;84179;5158;402160;3425;152687;4487;6047;54729;6002;54360;10227;10336;10417;84286;345222;2261;255403;4043;8602;7884;170960;57732;132884;10296;3064;3083;57654;10460;85013;118;1400;3954;152;339983;6452;10608;1487;2868;285464;8603,68
-1,1,4,72447,10252290,10179843,728373;257236;7700;521;7469;79155;644414;401115;728393;133060;4636;728419;55646;6286;654254;53407;54872;166793;114932;1609;55351;9948;2121;79441;100287513;7468;152877;285489;3166;84448;1816;353497;152789;100287205;9778;10861;92305;285498;57537;100287404;728379;8532;10815;27065;2580;53834;84179;5158;402160;728386;3425;152687;4487;6047;54729;6002;54360;728405;27201;7466;10227;57533;10336;10417;152992;93621;93624;345222;84286;56606;2261;255403;4043;8602;7884;170960;100287441;57732;132884;10296;3083;3064;100287238;768239;100287364;57654;10460;85013;728400;100287327;100287478;118;1400;3954;152;100288520;60312;94031;23324;55330;728369;100287178;339983;6452;5522;10608;1487;100287144;8310;80273;2868;54436;389199;285464;8603,115
-1,1,4,72447,12900236,12827789,728373;257236;7700;521;7469;79155;644414;401115;728393;133060;4636;728419;55646;6286;654254;53407;54872;166793;114932;1609;55351;9948;2121;79441;100287513;7468;152877;285489;3166;84448;1816;353497;152789;100287205;9778;10861;92305;285498;57537;100287404;728379;8532;10815;27065;2580;53834;84179;5158;116449;728386;402160;3425;152687;4487;6047;54729;6002;54360;728405;27201;7466;10227;57533;10336;9957;10417;152992;93621;93624;345222;84286;56606;2261;255403;4043;8602;7884;170960;100287441;57732;132884;10296;3083;3064;100287238;768239;100287364;57654;10460;85013;728400;100287327;100287478;118;1400;3954;152;100288520;60312;85460;94031;23324;55330;728369;100287178;339983;6452;5522;10608;1487;100287144;8310;80273;2868;54436;389199;285464;8603,118
-1,1,4,72447,15659658,15587211,728373;257236;7700;521;7469;79155;644414;401115;728393;133060;4636;728419;55646;6286;654254;53407;54872;166793;114932;1609;55351;9948;2121;79441;100287513;7468;152877;579;285489;3166;84448;1816;353497;152789;100287205;9778;10861;92305;285498;57537;100287404;728379;8532;10815;27065;2580;53834;84179;5158;116449;728386;402160;3425;152687;4487;6047;57545;54729;6002;54360;728405;26234;27201;7466;259282;10227;57533;10336;9957;10417;152992;93621;93624;345222;84286;56606;2261;255403;4043;8602;132864;7884;170960;100287441;57732;132884;10296;3083;3064;100287238;768239;100287364;57654;114905;10460;85013;728400;100287327;100287478;118;1400;3954;152;100288520;60312;85460;94031;23324;55330;728369;100287178;339983;6452;5522;10608;1487;100287144;8310;80273;2868;54436;9364;389199;285464;8603,125
-1,1,4,72447,17279636,17207189,728373;7700;521;7469;79155;644414;55646;654254;53407;54872;9948;79441;152877;579;3166;1816;9778;10861;92305;285498;57537;100287404;728379;285550;27065;2580;53834;84179;5158;728386;152687;54360;728405;259282;57533;10417;152992;93624;345222;4043;132864;7884;170960;100287441;57732;10296;3083;100287238;768239;57654;114905;9982;100287327;1400;3954;100288520;728369;1487;100287144;8310;80273;2868;54436;9364;285464;8603;683;257236;401115;728393;133060;4636;728419;202018;6286;166793;114932;1609;55351;2121;9079;100287513;7468;285489;84448;353497;8842;152789;100287205;8532;10815;116449;402160;3425;4487;6047;57545;54729;6002;26234;27201;7466;10227;10336;9957;93621;84286;56606;2261;255403;8602;132884;3064;100287364;10460;85013;728400;100287478;118;152;60312;85460;94031;952;83888;23324;55330;100287178;339983;6452;5522;10608;389199,133
1,1,4,72447,21024037,20951590,728373;7700;521;7469;79155;644414;5860;55646;654254;53407;54872;9948;79441;51056;152877;579;133015;3166;1816;80306;9778;10861;92305;285498;57537;100287404;728379;285550;27065;2580;53834;84179;5158;728386;152687;54360;728405;259282;57533;10417;152992;93624;345222;4043;132864;7884;170960;100287441;57732;10296;3083;100287238;768239;57654;114905;9982;27146;100287327;1400;3954;100288520;645104;728369;1487;100287144;8310;80273;2868;54436;9364;285464;8603;683;257236;401115;728393;133060;4636;728419;202018;6286;166793;114932;1609;55351;2121;9079;100287513;7468;285489;84448;353497;8842;152789;100287205;64151;8532;10815;116449;402160;3425;4487;6047;57545;54729;6002;26234;27201;7466;10227;10336;9957;93621;84286;56606;2261;255403;8602;254251;132884;9353;3064;100287364;10460;85013;728400;100287478;118;152;60312;85460;94031;952;83888;23324;55330;100287178;339983;54876;80333;6452;5522;10608;389199,144
1,1,4,72447,39478764,39406317,728373;7700;521;7469;79155;644414;5860;55646;166647;654254;53407;54872;29945;152831;9948;79441;116984;51056;152877;579;133015;3166;6649;1816;80306;10568;9778;10861;80008;10744;10333;92305;285498;57537;100287404;728379;11019;285550;27065;2580;53834;84179;5158;728386;152687;91050;54360;728405;51274;259282;57533;51088;10417;152992;51091;389203;886;93624;345222;5099;10891;7096;4043;132864;7884;170960;100287441;57732;10296;3083;100287238;768239;57654;114905;9982;92689;27146;100287327;1400;3954;100288520;645104;728369;55286;3516;1487;100287144;1665;8310;80273;2868;54436;9364;285464;8603;683;257236;401115;728393;133060;4636;728419;202018;6286;166793;114932;1609;55351;2121;9079;5981;100287513;7468;285489;84448;55296;353497;8842;57620;55203;152789;100287205;64151;8532;23231;10815;116449;402160;3425;4487;6047;57545;54729;6002;6133;26234;27201;7466;10227;10336;9957;401124;768211;93621;84286;56606;29063;2261;255403;8602;254251;132884;9353;3064;57495;100287364;55276;10460;55300;57728;85013;728400;100287478;118;152;60312;85460;94031;952;83888;23324;55330;100287178;339983;54876;80333;23216;6452;81793;5522;10608;389199,182
1,1,4,72447,39478764,39406317,728373;7700;521;7469;79155;644414;5860;55646;166647;654254;53407;54872;29945;152831;9948;79441;116984;51056;152877;579;133015;3166;6649;1816;80306;10568;9778;10861;80008;10744;10333;92305;285498;57537;100287404;728379;11019;285550;27065;2580;53834;84179;5158;728386;152687;91050;54360;728405;51274;259282;57533;51088;10417;152992;51091;389203;886;93624;345222;5099;10891;7096;4043;132864;7884;170960;100287441;57732;10296;3083;100287238;768239;57654;114905;9982;92689;27146;100287327;1400;3954;100288520;645104;728369;55286;3516;1487;100287144;1665;8310;80273;2868;54436;9364;285464;8603;683;257236;401115;728393;133060;4636;728419;202018;6286;166793;114932;1609;55351;2121;9079;5981;100287513;7468;285489;84448;55296;353497;8842;57620;55203;152789;100287205;64151;8532;23231;10815;116449;402160;3425;4487;6047;57545;54729;6002;6133;26234;27201;7466;10227;10336;9957;401124;768211;93621;84286;56606;29063;2261;255403;8602;254251;132884;9353;3064;57495;100287364;55276;10460;55300;57728;85013;728400;100287478;118;152;60312;85460;94031;952;83888;23324;55330;100287178;339983;54876;80333;23216;6452;81793;5522;10608;389199,182
1,-1,4,78470,117871,39401,152687,1
1,-1,4,78470,117871,39401,152687,1
-1,1,4,78470,3364946,3286476,10336;7700;521;7469;401115;79155;4636;10417;84286;654254;345222;54872;1609;2261;255403;79441;8602;7884;170960;57732;7468;152877;10296;3064;57654;353497;10460;285464;118;3954;10861;92305;285498;339983;10815;2580;53834;84179;5158;402160;3425;10608;6452;152687;1487;6047;54729;2868;6002;10227;8603,51
-1,1,4,78470,10337237,10258767,728373;257236;7700;521;7469;79155;644414;401115;728393;133060;4636;728419;55646;6286;654254;53407;54872;166793;114932;1609;55351;9948;2121;79441;100287513;7468;152877;285489;3166;84448;1816;353497;152789;100287205;9778;10861;92305;285498;57537;100287404;728379;8532;10815;27065;2580;53834;84179;5158;402160;728386;3425;152687;4487;6047;54729;6002;54360;728405;27201;7466;10227;57533;10336;10417;152992;93621;93624;345222;84286;56606;2261;255403;4043;8602;7884;170960;100287441;57732;132884;10296;3083;3064;100287238;768239;100287364;57654;10460;85013;728400;100287327;100287478;118;1400;3954;152;100288520;60312;94031;23324;55330;728369;100287178;339983;6452;5522;10608;1487;100287144;8310;80273;2868;54436;389199;285464;8603,115
1,1,4,78470,15627196,15548726,728373;257236;7700;521;7469;79155;644414;401115;728393;133060;4636;728419;55646;6286;654254;53407;54872;166793;114932;1609;55351;9948;2121;79441;100287513;7468;152877;579;285489;3166;84448;1816;353497;152789;100287205;9778;10861;92305;285498;57537;100287404;728379;8532;10815;27065;2580;53834;84179;5158;116449;728386;402160;3425;152687;4487;6047;57545;54729;6002;54360;728405;26234;27201;7466;259282;10227;57533;10336;9957;10417;152992;93621;93624;345222;84286;56606;2261;255403;4043;8602;132864;7884;170960;100287441;57732;132884;10296;3083;3064;100287238;768239;100287364;57654;114905;10460;85013;728400;100287327;100287478;118;1400;3954;152;100288520;60312;85460;94031;23324;55330;728369;100287178;339983;6452;5522;10608;1487;100287144;8310;80273;2868;54436;9364;389199;285464;8603,125
-1,-1,4,102091,143143,41052,255403,1
1,-1,4,129753,221449,91696,255403,1
-1,1,4,129753,9371067,9241314,728373;257236;7700;521;7469;79155;401115;728393;133060;4636;728419;55646;6286;654254;53407;54872;166793;114932;1609;55351;2121;79441;100287513;7468;152877;285489;3166;84448;353497;152789;100287205;9778;10861;92305;285498;57537;100287404;728379;8532;10815;27065;2580;53834;84179;5158;402160;728386;3425;4487;6047;54729;6002;54360;728405;27201;7466;10227;57533;10336;10417;152992;93621;93624;345222;84286;2261;255403;4043;8602;7884;170960;100287441;57732;132884;10296;3083;3064;100287238;768239;100287364;57654;10460;85013;728400;100287327;100287478;118;1400;3954;152;100288520;60312;94031;23324;55330;728369;100287178;339983;6452;5522;10608;1487;100287144;8310;80273;2868;54436;389199;285464;8603,110
1,-1,4,160648,174508,13860,,0
-1,-1,4,160648,185308,24660,,0
-1,-1,4,160648,185308,24660,,0
-1,-1,4,160648,185425,24777,,0
-1,-1,4,160648,185425,24777,,0
-1,-1,4,160648,185425,24777,,0
-1,-1,4,160648,185425,24777,,0
-1,-1,4,160648,185425,24777,,0
-1,-1,4,160648,185425,24777,,0
1,-1,4,952406,1020417,68011,84286;53834;3425;1609;10861,5
1,-1,4,952406,1020417,68011,84286;53834;3425;1609;10861,5
1,-1,4,952406,1020417,68011,84286;53834;3425;1609;10861,5
1,-1,4,952406,1020417,68011,84286;53834;3425;1609;10861,5
1,-1,4,952406,1020417,68011,84286;53834;3425;1609;10861,5
1,-1,4,952406,1020417,68011,84286;53834;3425;1609;10861,5
1,-1,4,952406,1020417,68011,84286;53834;3425;1609;10861,5
1,-1,4,952406,1020417,68011,84286;53834;3425;1609;10861,5
1,-1,4,952406,1020417,68011,84286;53834;3425;1609;10861,5
1,-1,4,952406,1020417,68011,84286;53834;3425;1609;10861,5
1,-1,4,952406,1020417,68011,84286;53834;3425;1609;10861,5
1,-1,4,952406,1020417,68011,84286;53834;3425;1609;10861,5
1,-1,4,952406,1020417,68011,84286;53834;3425;1609;10861,5
1,-1,4,952406,1020417,68011,84286;53834;3425;1609;10861,5
1,-1,4,952406,1020417,68011,84286;53834;3425;1609;10861,5
1,-1,4,952406,1020417,68011,84286;53834;3425;1609;10861,5
1,-1,4,952406,1020417,68011,84286;53834;3425;1609;10861,5
1,-1,4,952465,1020417,67952,1609;53834;10861;3425,4
1,-1,4,968925,1020417,51492,3425;10861;53834,3
1,-1,4,968925,1020417,51492,3425;10861;53834,3
1,-1,4,968925,1020476,51551,3425;10861;53834,3
-1,1,4,1228528,2862002,1633474,118;7469;401115;79155;3954;92305;79441;2261;339983;6452;7884;402160;10608;57732;7468;1487;152877;10296;6047;54729;57654;353497;10460;285464;8603,25
1,-1,4,1389570,1496153,106583,54729;285464,2
1,-1,4,1389570,1496153,106583,54729;285464,2
-1,1,4,1966266,5913899,3947633,7469;401115;79155;133060;55646;345222;166793;53407;55351;2121;79441;4043;8602;57732;7468;285489;132884;3064;3083;353497;85013;118;1400;152;339983;27065;6452;402160;10608;4487;6047;6002;2868;54360;10227;8603,36
-1,-1,4,1986918,1988906,1988,7469,1
1,-1,4,3444416,3475134,30718,285489;3083,2
1,-1,4,3444416,3475134,30718,285489;3083,2
1,-1,4,3444416,3487232,42816,285489;3083,2
1,-1,4,3903555,4029211,125656,,0
-1,-1,4,4029241,4209171,179930,133060,1
1,-1,4,4166772,4190047,23275,,0
1,-1,4,4166772,4249253,82481,133060;85013,2
1,-1,4,4166772,4249253,82481,133060;85013,2
1,-1,4,4190047,4249253,59206,133060;85013,2
-1,1,4,4428130,17462172,13034042,728373;683;257236;728393;644414;728419;202018;6286;53407;114932;55351;2121;9948;9079;100287513;579;3166;84448;1816;8842;152789;100287205;9778;8532;57537;100287404;728379;285550;116449;728386;4487;57545;54360;728405;26234;27201;7466;259282;57533;9957;93621;152992;93624;56606;132864;100287441;132884;100287238;768239;100287364;114905;9982;728400;100287327;100287478;1400;100288520;60312;85460;94031;952;83888;23324;55330;100287178;728369;5522;100287144;8310;80273;54436;9364;389199,73
1,-1,4,10121950,10403654,281704,,0
1,-1,4,10121950,10403654,281704,,0
1,-1,4,13000279,13071530,71251,,0
1,-1,4,15613881,15659599,45718,26234,1
1,-1,4,15613881,15659599,45718,26234,1
1,-1,4,15613881,15659599,45718,26234,1
1,-1,4,15613881,15659599,45718,26234,1
1,-1,4,15613881,15683370,69489,26234;285550,2
-1,1,4,16926645,32114698,15188053,51091;389203;5860;166647;886;64151;5099;10891;29945;29063;23231;645104;10568;54876;51056;80333;254251;3516;9353;133015;6649;57620;1665;91050;55296;55300;80306;27146;55203,29
-1,1,4,23863623,27687168,3823545,51091;389203;886;10891;29945;55203;29063;23231;3516;1665;6649;91050;55300;55296;57620;10568,16
1,-1,4,33520754,33717980,197226,,0
-1,-1,4,34367737,34527822,160085,,0
-1,-1,4,35542014,35604731,62717,,0
1,-1,4,39223728,39493230,269502,11019;6133;5981;152831;57728,5
1,1,4,40498493,49581867,9083374,152518;54502;55161;132789;10463;2555;323;285429;2557;2560;7345;57205;285525;7006;132299;389206;386617;170712;285527;54940;60558;326340;152573;7294;79730;201780;80157;54951;1259;22998;8929;389207;57606;152519;10699;2565;10396,37
1,-1,4,49163546,49202553,39007,,0
1,-1,4,49163546,49215538,51992,,0
1,-1,4,49163546,49215538,51992,,0
1,-1,4,49163546,49237502,73956,,0
1,-1,4,49163546,49237502,73956,,0
1,-1,4,49163546,49501695,338149,,0
1,-1,4,49163546,49501695,338149,,0
1,-1,4,49163546,49501695,338149,,0
1,-1,4,49163546,49501695,338149,,0
1,-1,4,49163546,49501695,338149,,0
1,-1,4,49237502,49333282,95780,,0
1,-1,4,49237502,49333282,95780,,0
1,-1,4,49237502,49333282,95780,,0
1,-1,4,49237502,49333282,95780,,0
1,-1,4,49260988,49538325,277337,,0
1,-1,4,49260988,49538325,277337,,0
1,-1,4,49260988,49538325,277337,,0
1,-1,4,49260988,49538325,277337,,0
1,-1,4,49260988,49538325,277337,,0
-1,-1,4,49261077,49538398,277321,,0
-1,1,4,55587786,55614038,26252,3815,1
1,-1,4,57915534,58084629,169095,3490,1
-1,1,4,59167245,101910659,42743414,23001;100129583;4589;651;55752;9508;5783;339965;51316;27163;8649;2712;22902;10720;58503;131;4547;23284;152926;8633;10855;7367;130;84103;58478;419;10117;9908;4299;6374;56916;345275;2920;8671;255324;6696;84142;345274;27284;401137;93587;1448;152816;10098;6783;1633;79725;5197;7363;1446;25898;51191;57619;152559;685;9407;3347;2926;3627;124;10886;56978;260436;285513;10144;10563;65008;51170;127;7366;10941;27306;374;115265;22872;79966;91746;84779;27071;55589;474;26228;1834;53343;3015;3512;8404;23173;306;950;27235;5161;53371;125;6779;255119;55008;658;8999;83478;56955;213;26057;9429;1060;4283;10879;100631383;389208;26952;54490;2919;3346;54959;2895;3184;79799;84803;1040;126;8615;4825;51138;2798;246175;6622;1758;174;5602;7365;10983;339967;152815;1977;173;7364;55236;79982;118429;153020;3576;128;5473;85438;285521;6373;5593;2069;901;5196;113510;132660;574537;92597;57050;345079;100996939;84992;401138;401145;441024;253017;266812;10611;285555;9987;22915;3381;28983;55153;25849;5311;6372;5470;258;51023;2250;132989;8987;132724;51705;2638;80144;2044;166824;441027;166815;5910;57563;2921;1447;8916,192
1,-1,4,63025655,63568620,542965,,0
1,-1,4,63737871,64116915,379044,,0
-1,1,4,66017575,76772947,10755372,6779;4589;8999;9508;213;26057;22902;1060;10720;10879;58503;389208;26952;54490;2919;3346;54959;79799;7367;8615;10117;9908;2798;6374;174;2920;7365;8671;255324;339967;152815;27284;173;7364;401137;55236;3576;1448;5473;85438;285521;152816;6783;1633;2069;5196;5197;7363;1446;25898;574537;92597;57050;685;9407;3347;401138;441024;2926;10886;260436;28983;25849;6372;7366;10941;258;374;91746;132724;2638;2044;166824;26228;3512;2921;1447,77
1,-1,4,69276372,69592846,316474,28983;7367;7366,3
1,-1,4,69375169,69433921,58752,7367,1
-1,-1,4,69375169,69433921,58752,7367,1
1,-1,4,69375169,69462125,86956,7367,1
-1,-1,4,69375169,69462125,86956,7367,1
1,-1,4,69375169,69462125,86956,7367,1
-1,-1,4,69375169,69462125,86956,7367,1
-1,-1,4,69375169,69462125,86956,7367,1
-1,-1,4,69375169,69462125,86956,7367,1
-1,-1,4,69375169,69483248,108079,7367,1
1,-1,4,69375169,69483248,108079,7367,1
-1,-1,4,69375169,69483248,108079,7367,1
1,-1,4,69375169,69483248,108079,7367,1
-1,-1,4,69375170,69483248,108078,7367,1
1,-1,4,69375170,69483248,108078,7367,1
1,-1,4,69375170,69483248,108078,7367,1
1,-1,4,69392575,69462125,69550,7367,1
1,-1,4,69402791,70476029,1073238,7366;10941;7363;54490;7365;574537;79799;7367;10720;7364,10
1,1,4,69551806,96215607,26663801,23001;100129583;4589;651;55752;9508;5783;339965;51316;27163;2712;22902;10720;58503;152926;8633;10855;58478;419;10117;9908;4299;6374;56916;345275;2920;8671;255324;6696;84142;345274;27284;401137;1448;152816;6783;1633;79725;5197;7363;1446;25898;51191;57619;152559;685;3347;2926;3627;10886;56978;260436;285513;10144;10563;65008;51170;10941;27306;374;22872;79966;84779;55589;474;1834;53343;3512;8404;306;950;27235;53371;6779;255119;55008;658;8999;83478;56955;213;26057;9429;4283;10879;100631383;26952;54490;2919;3346;54959;2895;3184;79799;84803;1040;8615;4825;51138;246175;6622;1758;174;5602;7365;10983;152815;173;7364;118429;153020;3576;5473;85438;285521;6373;5593;2069;901;5196;113510;132660;574537;92597;57050;345079;100996939;84992;401138;401145;441024;266812;10611;9987;22915;3381;55153;25849;5311;6372;5470;258;51023;2250;132989;8987;2638;80144;166824;441027;166815;57563;2921;1447;8916,155
1,1,4,69767879,71485990,1718111,6779;10941;7363;1446;4589;258;574537;27284;10720;10879;3347;401138;7364;401137;58503;26952;54490;260436;1448;3346;54959;85438;79799;1447;6783,25
1,-1,4,70125131,70182147,57016,54490,1
1,-1,4,70153895,70203219,49324,54490,1
1,-1,4,70153895,70230130,76235,54490,1
1,1,4,73127975,86923300,13795325,23001;100129583;255119;651;55752;9508;8999;83478;213;339965;51316;27163;26057;2712;4283;100631383;2919;3184;10855;1040;84803;8615;58478;4825;419;51138;9908;6374;246175;174;2920;10983;255324;84142;152815;173;118429;153020;3576;5473;285521;6373;152816;5593;79725;2069;901;5196;113510;5197;25898;132660;57619;152559;345079;685;441024;3627;56978;9987;55153;25849;6372;10563;65008;5470;51023;374;2250;22872;8987;79966;55589;80144;166824;441027;306;950;2921;84779;27235;53371,82
1,-1,4,73819067,74044813,225746,285521;26057,2
-1,1,4,74718441,77413508,2695067,5196;100129583;5197;25898;8999;57619;339965;27163;4283;685;100631383;441024;3627;2919;55153;8615;25849;419;5470;9908;6374;2920;374;255324;8987;152815;5473;6373;950;152816;2921;53371;2069,33
1,1,4,76722296,79926959,3204663,901;5470;100129583;246175;55752;57619;339965;10983;27163;8987;345079;4283;152559;100631383;55589;80144;3627;6373;55153;306;950;8615;53371;10563;419;65008,26
-1,1,4,80707668,86753960,6046292,113510;51138;23001;255119;132660;651;83478;51023;51316;2250;22872;84142;79966;441027;118429;153020;56978;9987;3184;10855;84803;1040;5593;27235;58478;4825;79725,27
-1,1,4,80965103,87869469,6904366,113510;23001;255119;132660;651;83478;5783;51316;56978;9987;3184;10855;84803;1040;58478;4825;51138;4299;5602;51023;2250;22872;132989;84142;345274;79966;441027;118429;153020;5593;27235;79725,32
-1,1,4,81348177,101776598,20428421,125;23001;255119;55008;658;651;83478;56955;5783;51316;8649;9429;131;4547;152926;2895;8633;3184;10855;130;1040;84103;84803;126;58478;4825;51138;4299;6622;56916;345275;1758;5602;6696;84142;1977;345274;93587;79982;153020;128;5593;10098;79725;113510;132660;27235;51191;100996939;84992;401145;124;266812;10611;285555;9987;22915;3381;285513;10144;5311;51170;127;27306;51023;115265;22872;132989;79966;27071;474;51705;441027;1834;3015;53343;166815;5910;57563;8404;23173;5161;8916,83
-1,-1,4,81693246,81800931,107685,255119,1
-1,1,4,81800931,95730598,13929667,113510;23001;255119;132660;55008;651;83478;56955;5783;51191;658;51316;9429;100996939;84992;401145;266812;10611;9987;22915;152926;2895;3381;3184;10855;84803;1040;10144;5311;285513;58478;4825;51170;51138;4299;27306;6622;56916;345275;5602;51023;1758;22872;132989;6696;84142;345274;79966;474;441027;153020;1834;166815;53343;57563;8404;5593;27235;8916;79725,60
-1,1,4,82283358,90341831,8058473,113510;23001;132660;55008;83478;56955;5783;51191;51316;9429;100996939;84992;266812;9987;152926;3381;3184;10855;84803;1040;10144;5311;285513;58478;4825;51170;51138;4299;345275;5602;51023;1758;22872;132989;6696;84142;345274;79966;441027;153020;1834;166815;53343;57563;8404;27235;8916;79725,48
-1,1,4,85250704,88600356,3349652,23001;4299;83478;5602;5783;345275;1758;132989;345274;1834;53343;57563;8404;1040;4825;51170,16
-1,1,4,85250704,94575625,9324921,23001;55008;83478;56955;5783;51191;9429;100996939;84992;401145;266812;22915;152926;2895;3381;1040;10144;285513;5311;4825;51170;4299;6622;345275;5602;1758;132989;6696;345274;1834;166815;53343;57563;8404;8916,35
1,1,4,85498672,86998700,1500028,83478;23001;1040;5602,4
-1,1,4,85805268,103678797,17873529,23001;55008;658;83478;56955;5783;8649;9429;131;4547;152926;2895;8633;130;126;5530;84103;4299;6622;56916;345275;5602;1758;6696;1977;345274;93587;79982;128;10098;4126;51191;100996939;84992;401145;64116;266812;10611;285555;124;4790;22915;3381;8916;285513;10144;5311;55024;51170;127;27306;115265;132989;27071;474;51705;1834;166815;53343;5910;3015;57563;8404;23173;5161;125,66
-1,1,4,85839771,93071150,7231379,23001;55008;83478;56955;5783;51191;9429;100996939;84992;401145;266812;22915;152926;3381;285513;10144;5311;51170;4299;6622;345275;5602;1758;132989;6696;345274;1834;166815;53343;57563;8404;8916,32
-1,1,4,86370518,94894345,8523827,55008;83478;56955;5783;51191;9429;100996939;84992;401145;266812;22915;152926;2895;3381;285513;10144;5311;51170;4299;6622;345275;5602;1758;132989;6696;345274;474;1834;166815;53343;57563;8404;8916,33
-1,1,4,86893239,87952527,1059288,132989;4299;345274;83478;5602;5783,6
-1,1,4,88265488,94575586,6310098,55008;6622;56955;1758;51191;6696;9429;84992;100996939;401145;266812;1834;166815;53343;22915;152926;2895;8404;3381;285513;10144;5311;8916;51170,24
-1,-1,4,91342219,91842807,500588,401145,1
1,-1,4,91753638,92240582,486944,401145,1
-1,1,4,92201567,103043808,10842241,658;8649;401145;131;10611;285555;124;4547;2895;8633;130;126;5530;84103;10098;55024;127;27306;56916;115265;1977;27071;474;51705;93587;79982;3015;5910;128;23173;5161;125,32
1,-1,4,92240523,93434401,1193878,401145;2895,2
1,1,4,93071152,190957473,97886321,133022;54726;4889;285533;201799;8649;1950;27236;6999;131;80014;8492;59350;4547;166752;4086;83891;1062;10733;8633;54798;9693;2549;113612;57575;79071;152756;291;27295;55132;56884;10424;79625;80854;201965;2247;100507096;93587;80319;285440;55325;57182;1047;3558;85462;2244;58505;836;55212;7097;124;84709;4085;92610;201725;2743;127;92345;2891;7092;166379;59067;55345;345193;27071;474;2993;201798;9255;4543;54433;11199;7350;8470;93627;3033;2982;391712;1519;25854;54848;3426;51176;63973;60559;54510;84068;166614;55016;60592;255743;84076;987;55602;3600;84162;100506013;51778;80216;27123;100132463;1977;64850;79633;2983;2243;152586;55435;90826;55314;55534;128;57630;10393;7323;4886;150159;10586;79807;10252;54532;11341;64399;55294;175;11157;9871;3148;64116;285555;84057;4790;448831;51809;132321;84640;54790;2994;9848;2160;55024;2823;22824;5458;2996;57484;4750;23321;339976;51705;201973;57600;5910;132625;152940;6164;27068;26269;11107;308;125;5393;205860;1182;7098;55714;166929;133308;60684;132851;130;5530;84103;80817;5188;3818;2266;55013;54969;8654;4887;56916;2028;6870;646603;91351;132612;79960;4258;442117;133121;10098;3622;8467;1635;80155;140458;23520;817;7368;6423;166785;152503;51166;5481;57587;64579;11162;81579;5356;9464;25819;171024;79884;152485;83452;2169;166863;839;6189;132720;79682;11086;27306;256471;56898;115265;132320;23022;3660;27152;51802;80167;55247;10692;7222;50859;3015;55805;3248;23173;645078;256309;83447;7424;51574;5161;2483;4717;56034;658;5308;1363;53842;729830;55751;9348;8821;23158;2895;255520;57117;166655;126;1909;57721;493856;10427;345062;401152;441054;27309;2195;11275;2110;6307;79982;56977;166378;6059;4126;79931;55601;132430;79642;55319;9227;83894;1998;10611;84109;287;8819;8001;132332;23240;353322;79658;116966;23657;84869;201931;51313;391723;9061;4306;84570;2180;890,309
-1,1,4,93531564,102443148,8911584,27306;658;56916;115265;8649;1977;27071;474;51705;93587;131;10611;285555;124;4547;79982;3015;5910;128;2895;23173;8633;130;126;5530;84103;10098;5161;125;127,30
-1,1,4,93978239,94073948,95709,2895,1
1,-1,4,98632408,98757752,125344,285555,1
1,-1,4,98632408,98757752,125344,285555,1
1,1,4,109199664,189752726,80553062,5393;133022;205860;54726;1182;4889;201799;285533;7098;55714;1950;27236;6999;60684;80014;8492;4086;59350;166752;83891;132851;10733;54798;9693;5188;2266;2549;57575;55013;54969;79071;80817;8654;4887;3818;2028;152756;291;27295;646603;55132;132612;79960;10424;4258;56884;91351;79625;80854;442117;201965;2247;133121;3622;890;8467;1635;80155;285440;55325;140458;23520;817;7368;57182;6423;1047;3558;166785;85462;2244;58505;152503;51166;55212;7097;5481;836;57587;64579;4085;81579;11162;84709;5356;9464;25819;92610;171024;83452;152485;2169;839;166863;79884;2743;201725;6189;132720;92345;11086;79682;256471;2891;166379;7092;59067;132320;23022;55345;3660;345193;27152;80167;2993;51802;10692;55247;7222;201798;50859;54433;4543;11199;55805;7350;645078;3248;256309;8470;83447;7424;51574;2982;4717;56034;391712;1363;5308;53842;1519;25854;3426;63973;729830;9348;54510;55751;60559;8821;84068;23158;166614;55016;255520;60592;84076;166655;987;55602;3600;84162;1909;100506013;57721;51778;80216;10427;100132463;345062;64850;401152;27309;441054;79633;2983;11275;2195;2243;152586;55435;90826;2110;55314;6307;55534;57630;10393;4886;56977;10586;166378;6059;79931;55601;132430;10252;54532;79642;64399;55319;55294;9227;11341;175;11157;83894;9871;3148;1998;84057;84109;51809;287;132321;84640;2994;8819;9848;8001;132332;2160;2823;23240;22824;353322;5458;79658;116966;23657;84869;2996;201931;57484;4750;51313;391723;23321;339976;201973;57600;132625;152940;4306;6164;84570;2180;26269;11107;308,250
-1,-1,4,116321349,116913753,592404,,0
-1,-1,4,116731797,117041205,309408,,0
-1,-1,4,116913694,117097417,183723,,0
-1,1,4,118273037,134486822,16213785,79931;5393;10252;54532;57182;3558;9348;9871;55212;8492;84109;4085;11162;132321;10733;171024;132332;2169;84162;22824;57575;57721;8654;51778;256471;166379;59067;132612;55132;10424;79960;401152;132320;79625;79633;2247;27152;80167;7222;83447;11107;308;166378;890,44
-1,1,4,119281458,121845311,2563853,11107;57721;8654;51778;54532;4085;401152;171024;2169;9871,10
-1,1,4,126039775,133694234,7654459,22824;256471;132321;10733;80167;55132;10424;83447;79960;132320;79633;27152,12
1,1,4,126354098,186683041,60328943,54726;1182;4889;201799;285533;55714;27236;6999;60684;80014;4086;59350;83891;166752;132851;10733;54798;9693;5188;2266;2549;57575;80817;54969;4887;152756;291;27295;646603;55132;56884;79960;10424;4258;91351;80854;442117;201965;133121;3622;8467;1635;80155;55325;140458;23520;6423;1047;166785;85462;2244;152503;51166;836;7097;5481;57587;84709;5356;9464;25819;201725;79884;83452;152485;166863;2743;6189;92345;79682;11086;256471;2891;7092;132320;23022;3660;80167;27152;2993;51802;55247;201798;50859;11199;55805;7350;3248;256309;8470;83447;7424;2982;4717;56034;391712;1363;53842;1519;729830;55751;54510;60559;8821;84068;23158;166614;55016;255520;60592;84076;166655;987;55602;3600;1909;100506013;100132463;345062;27309;441054;79633;11275;2243;152586;90826;2110;55314;6307;55534;57630;10393;4886;56977;10586;6059;55601;132430;55319;64399;11341;55294;9227;175;11157;83894;3148;1998;84057;51809;132321;84640;2994;8819;9848;8001;2823;23240;22824;353322;5458;79658;116966;23657;84869;2996;201931;57484;4750;51313;391723;23321;201973;57600;152940;4306;2180;26269;2983,179
1,-1,4,129778026,129905056,127030,132320;79960,2
1,-1,4,129785683,129857992,72309,132320;79960,2
1,-1,4,131966420,132330721,364301,,0
1,-1,4,131966420,132330721,364301,,0
-1,-1,4,132288191,132451729,163538,,0
-1,-1,4,132755488,133091760,336272,,0
1,1,4,132906408,190828225,57921817,205860;54726;1182;4889;201799;285533;7098;55714;27236;6999;60684;80014;4086;59350;83891;166752;132851;54798;9693;5188;2266;2549;57575;80817;54969;3818;4887;152756;291;27295;646603;91351;56884;4258;80854;442117;201965;133121;3622;8467;1635;80155;285440;55325;140458;23520;6423;1047;166785;85462;2244;152503;51166;836;7097;5481;57587;84709;5356;9464;25819;201725;79884;83452;152485;166863;2743;6189;92345;79682;11086;2891;7092;23022;3660;51802;2993;55247;201798;50859;4543;11199;55805;7350;3248;256309;8470;7424;2982;4717;56034;391712;1363;53842;1519;25854;729830;55751;54510;60559;8821;84068;23158;166614;55016;255520;60592;84076;166655;987;55602;3600;1909;100506013;100132463;345062;27309;441054;2195;11275;2243;152586;90826;2110;55314;6307;55534;57630;10393;4886;56977;10586;6059;55601;132430;55319;64399;11341;55294;9227;175;11157;83894;3148;1998;84057;51809;84640;2994;8819;9848;8001;2160;2823;23240;353322;5458;79658;116966;23657;84869;2996;201931;57484;4750;51313;391723;23321;339976;201973;57600;132625;152940;4306;2180;26269;2983,177
-1,-1,4,134943036,135180310,237274,132430,1
-1,-1,4,134943236,135180169,236933,132430,1
1,1,4,135856771,190957473,55100702,205860;54726;1182;4889;201799;285533;7098;55714;27236;6999;60684;80014;4086;59350;83891;166752;132851;54798;9693;5188;2266;2549;80817;3818;54969;4887;152756;291;27295;646603;91351;56884;4258;80854;442117;201965;133121;3622;8467;1635;80155;285440;55325;140458;23520;6423;1047;166785;85462;2244;152503;51166;836;7097;5481;57587;84709;5356;9464;25819;201725;79884;83452;152485;166863;2743;6189;92345;79682;11086;2891;7092;23022;3660;51802;2993;55247;201798;50859;4543;11199;55805;7350;3248;256309;8470;7424;2982;4717;2483;56034;391712;1363;53842;1519;25854;729830;55751;54510;60559;8821;84068;23158;166614;55016;255520;60592;84076;166655;987;55602;3600;1909;100506013;100132463;345062;27309;441054;2195;11275;2243;152586;90826;2110;55314;6307;55534;57630;10393;4886;56977;10586;6059;55601;55319;64399;11341;55294;9227;175;11157;83894;3148;1998;84057;448831;51809;84640;2994;8819;9848;8001;2160;2823;23240;353322;5458;79658;116966;23657;84869;2996;201931;57484;4750;51313;391723;23321;339976;201973;57600;132625;152940;4306;2180;26269;2983,177
-1,-1,4,138104885,138181367,76482,,0
-1,-1,4,138727743,139163316,435573,23657,1
1,1,4,139431686,190828225,51396539,205860;54726;1182;4889;201799;285533;7098;55714;27236;6999;60684;80014;4086;59350;83891;166752;132851;54798;9693;5188;2266;2549;80817;3818;54969;4887;152756;291;27295;646603;91351;56884;4258;80854;442117;201965;133121;3622;8467;1635;80155;285440;55325;140458;23520;6423;1047;166785;85462;2244;152503;51166;836;7097;5481;57587;84709;5356;9464;25819;201725;79884;83452;152485;166863;2743;6189;92345;79682;11086;2891;7092;23022;3660;51802;2993;55247;201798;50859;4543;11199;55805;7350;3248;256309;8470;7424;2982;4717;56034;391712;1363;53842;1519;25854;729830;55751;60559;8821;84068;23158;166614;55016;255520;60592;84076;166655;987;55602;3600;1909;100506013;100132463;345062;27309;441054;2195;11275;2243;152586;90826;2110;55314;6307;55534;57630;10393;4886;56977;10586;6059;55601;55319;64399;11341;55294;9227;175;11157;83894;3148;1998;84057;51809;84640;2994;8819;9848;8001;2160;2823;23240;353322;5458;79658;116966;84869;2996;201931;57484;4750;51313;391723;23321;339976;201973;57600;132625;152940;4306;2180;26269;2983,173
1,-1,4,143086405,143195842,109437,8821,1
-1,1,4,144509997,149435179,4925182,1909;54726;64399;5458;79658;646603;11157;2996;83894;166785;55751;2993;90826;84068;4086;166752;10393;4306;2994;152485;6059,21
-1,1,4,144659362,146791626,2132264,2993;4086;54726;64399;10393;646603;2996;2994;152485;6059;166785,11
1,-1,4,144782893,145301546,518653,2993;2996;2994,3
1,1,4,145963820,190828225,44864405,205860;54726;1182;4889;201799;285533;7098;55714;27236;6999;60684;80014;4086;59350;83891;132851;54798;9693;5188;2266;80817;3818;54969;4887;152756;291;27295;646603;91351;56884;442117;201965;133121;3622;1635;285440;55325;140458;23520;6423;166785;85462;2244;152503;51166;836;7097;5481;57587;5356;9464;201725;79884;152485;2743;166863;6189;92345;79682;11086;2891;7092;23022;3660;51802;55247;201798;50859;4543;11199;55805;3248;256309;8470;7424;2982;56034;391712;1363;53842;1519;25854;729830;55751;60559;84068;166614;55016;84076;166655;987;55602;1909;100506013;100132463;345062;441054;2195;11275;2243;90826;2110;55314;6307;57630;10393;4886;56977;10586;6059;55601;55319;11341;55294;9227;175;11157;83894;3148;84057;51809;8819;9848;8001;2160;2823;23240;353322;5458;79658;116966;84869;201931;4750;51313;391723;23321;339976;201973;57600;132625;152940;4306;2180;26269;2983,146
-1,1,4,149277637,149669181,391544,4306,1
-1,-1,4,150070565,150173256,102691,,0
-1,1,4,153203431,162912359,9708928,55294;9227;1519;201799;285533;6423;27236;2244;85462;6999;7097;5481;84057;59350;5356;54798;201725;79884;2743;9693;166863;2266;23240;4887;2891;56884;51313;23321;2243;51802;2110;201798;55314;57600;152940;2982;2983;56034,38
1,1,4,153890440,190957473,37067033,391712;1363;205860;53842;1182;4889;1519;285533;25854;7098;55714;6999;60684;60559;80014;59350;83891;132851;55016;84076;166655;54798;55602;9693;80817;2266;3818;100506013;54969;4887;152756;291;27295;100132463;91351;56884;441054;2195;442117;201965;11275;2243;2110;55314;6307;57630;133121;4886;56977;3622;1635;55601;285440;55319;11341;9227;55325;175;140458;23520;6423;85462;2244;3148;51166;836;7097;5481;84057;448831;57587;51809;5356;9464;8819;201725;79884;2743;9848;166863;8001;2160;2823;23240;92345;79682;353322;11086;2891;116966;7092;23022;84869;3660;201931;4750;51313;391723;23321;339976;51802;55247;201973;50859;57600;4543;11199;55805;132625;3248;256309;8470;152940;2180;26269;7424;2982;2983;2483;56034,120
-1,1,4,156084134,171880704,15796570,391712;55601;1363;55319;1519;4889;1182;23520;6999;51166;5481;59350;55016;84076;166655;201725;79884;2743;9693;9848;100506013;54969;92345;4887;2891;152756;7092;91351;56884;23022;84869;201931;4750;51313;11275;51802;2110;55314;57600;6307;50859;57630;11199;152940;4886;2982;2983;56034,48
1,1,4,156465633,190957473,34491840,391712;1363;205860;53842;1182;4889;1519;25854;7098;55714;6999;60684;60559;80014;59350;83891;132851;55016;84076;166655;55602;9693;80817;3818;100506013;54969;152756;291;27295;100132463;91351;56884;441054;2195;442117;201965;11275;2110;55314;6307;57630;133121;4886;56977;3622;1635;55601;285440;55319;11341;55325;175;140458;23520;3148;51166;836;5481;448831;57587;51809;9464;8819;201725;9848;2743;8001;2160;2823;92345;79682;353322;11086;2891;116966;7092;23022;84869;3660;201931;4750;51313;391723;339976;51802;55247;201973;50859;57600;4543;11199;55805;132625;3248;256309;8470;152940;2180;26269;7424;2982;2983;2483;56034,104
1,1,4,159309080,167766877,8457797,100506013;92345;391712;1363;55319;152756;7092;4889;56884;23520;201931;11275;2110;5481;59350;6307;57600;50859;55016;152940;84076;166655;4886;201725;9693,25
1,1,4,161678851,191012562,29333711,391712;1363;205860;53842;1182;4889;25854;7098;55714;60684;60559;80014;83891;132851;55016;84076;166655;55602;80817;3818;100506013;54969;152756;291;27295;100132463;91351;56884;441054;2195;442117;201965;11275;6307;57630;133121;4886;56977;3622;1635;55601;285440;55319;11341;55325;175;140458;23520;3148;51166;836;448831;57587;51809;9464;8819;9848;8001;2160;2823;92345;79682;353322;11086;116966;7092;23022;84869;3660;201931;4750;391723;339976;55247;201973;50859;4543;11199;55805;132625;3248;256309;8470;2180;26269;7424;2483,87
-1,1,4,162205710,182329883,20124173,391712;55601;1363;55319;11341;1182;4889;175;140458;23520;60559;3148;51166;51809;132851;55016;9464;84076;166655;8819;9848;8001;80817;2823;100506013;54969;92345;11086;116966;152756;7092;91351;56884;23022;84869;201931;4750;442117;11275;55247;6307;50859;57630;11199;3248;26269;4886;7424,48
1,-1,4,165876480,165879671,3191,152756;391712,2
1,-1,4,165876480,165879671,3191,152756;391712,2
1,-1,4,165876480,165879671,3191,152756;391712,2
1,-1,4,165876480,165879671,3191,152756;391712,2
1,-1,4,165876480,165879671,3191,152756;391712,2
1,-1,4,165876480,165879671,3191,152756;391712,2
1,-1,4,165876480,165879671,3191,152756;391712,2
1,-1,4,165876480,165879671,3191,152756;391712,2
1,-1,4,165876480,165879671,3191,152756;391712,2
1,-1,4,165876480,165879671,3191,152756;391712,2
1,-1,4,165876480,165879671,3191,152756;391712,2
1,-1,4,165876480,165879671,3191,152756;391712,2
1,-1,4,165876480,165879671,3191,152756;391712,2
1,-1,4,165876480,165879671,3191,152756;391712,2
1,-1,4,165876480,165879671,3191,152756;391712,2
1,-1,4,165876480,165879671,3191,152756;391712,2
1,-1,4,165876480,165879671,3191,152756;391712,2
1,-1,4,165876480,165879671,3191,152756;391712,2
1,-1,4,165876480,165879671,3191,152756;391712,2
1,-1,4,165876480,165879671,3191,152756;391712,2
1,-1,4,165876480,165879671,3191,152756;391712,2
1,-1,4,165876480,165889702,13222,152756;391712,2
1,-1,4,165876480,165889702,13222,152756;391712,2
1,-1,4,165876480,165889702,13222,152756;391712,2
1,-1,4,165879671,166171638,291967,391712;166655;201931;152756;11275,5
-1,1,4,166202188,190939340,24737152,1363;53842;205860;1182;25854;7098;55714;60684;60559;80014;83891;132851;55602;80817;3818;54969;291;100132463;27295;91351;441054;2195;442117;201965;11275;6307;57630;133121;56977;3622;1635;55601;285440;11341;175;55325;140458;3148;51166;836;51809;57587;9464;8819;9848;8001;2160;2823;79682;353322;11086;116966;7092;23022;84869;3660;4750;391723;339976;55247;201973;50859;4543;11199;55805;132625;3248;256309;8470;2180;26269;7424;2483,73
1,1,4,166436844,190957473,24520629,53842;205860;1182;25854;7098;55714;60684;60559;80014;83891;132851;55602;80817;3818;54969;291;100132463;27295;91351;441054;2195;442117;201965;57630;133121;56977;3622;1635;55601;285440;11341;175;55325;140458;3148;51166;836;448831;51809;57587;9464;8819;9848;8001;2160;2823;79682;353322;11086;116966;7092;23022;84869;3660;4750;391723;339976;55247;201973;50859;4543;11199;55805;132625;3248;256309;8470;2180;26269;7424;2483,71
1,1,4,166735148,190957473,24222325,53842;205860;1182;25854;7098;55714;60684;60559;80014;83891;132851;55602;80817;3818;54969;291;100132463;27295;91351;441054;2195;442117;201965;57630;133121;56977;3622;1635;55601;285440;11341;175;55325;140458;3148;51166;836;448831;51809;57587;9464;8819;9848;8001;2160;2823;79682;353322;11086;116966;7092;23022;84869;3660;4750;391723;339976;55247;201973;50859;4543;11199;55805;132625;3248;256309;8470;2180;26269;7424;2483,71
-1,1,4,167238739,190828225,23589486,53842;205860;1182;25854;7098;55714;60684;60559;80014;83891;132851;55602;80817;3818;54969;291;100132463;27295;91351;441054;2195;442117;201965;57630;133121;56977;3622;1635;55601;285440;11341;175;55325;140458;3148;51166;836;51809;57587;9464;8819;9848;8001;2160;2823;79682;353322;11086;116966;23022;84869;3660;4750;391723;339976;55247;201973;50859;4543;11199;55805;132625;3248;256309;8470;2180;26269;7424,68
-1,1,4,167413365,190957473,23544108,53842;205860;1182;25854;7098;55714;60684;60559;80014;83891;132851;55602;80817;3818;54969;291;100132463;27295;91351;441054;2195;442117;201965;57630;133121;56977;3622;1635;55601;285440;11341;175;55325;140458;3148;51166;836;448831;51809;57587;9464;8819;9848;8001;2160;2823;79682;353322;11086;116966;23022;84869;3660;4750;391723;339976;55247;201973;50859;4543;11199;55805;132625;3248;256309;8470;2180;26269;7424;2483,70
-1,1,4,167551358,180742113,13190755,54969;55601;11086;11341;116966;1182;175;91351;140458;23022;84869;4750;442117;60559;3148;51166;55247;50859;51809;57630;11199;132851;3248;9464;26269;8819;9848;8001;7424;80817;2823,31
-1,1,4,168294867,190957473,22662606,53842;205860;1182;25854;7098;55714;60684;60559;80014;83891;132851;55602;80817;3818;54969;291;100132463;27295;91351;441054;2195;442117;201965;57630;133121;56977;3622;1635;55601;285440;11341;175;55325;140458;3148;51166;836;448831;51809;57587;9464;8819;9848;8001;2160;2823;79682;353322;11086;116966;23022;84869;3660;4750;391723;339976;55247;201973;4543;11199;55805;132625;3248;256309;8470;2180;26269;7424;2483,69
1,-1,4,168321293,168477137,155844,,0
-1,-1,4,168681147,168831927,150780,,0
-1,-1,4,168831927,168977531,145604,,0
-1,-1,4,168831927,168977531,145604,,0
-1,-1,4,168831927,168977531,145604,,0
-1,-1,4,168831927,168977531,145604,,0
1,1,4,169040468,190828225,21787757,53842;205860;1182;25854;7098;55714;60684;60559;80014;83891;132851;55602;80817;3818;54969;291;100132463;27295;91351;441054;2195;442117;201965;57630;133121;56977;3622;1635;55601;285440;11341;175;55325;140458;3148;51166;836;51809;57587;9464;8819;9848;8001;2160;2823;79682;353322;11086;116966;23022;84869;3660;4750;391723;339976;55247;201973;4543;11199;132625;55805;3248;256309;8470;2180;26269;7424,67
1,1,4,169242739,190512479,21269740,53842;205860;1182;25854;7098;55714;60684;60559;80014;83891;132851;55602;80817;3818;54969;291;100132463;27295;91351;441054;2195;442117;201965;57630;133121;56977;3622;1635;285440;11341;175;55325;140458;3148;51166;836;51809;57587;9464;8819;9848;8001;2160;2823;79682;353322;11086;116966;23022;84869;3660;4750;391723;339976;55247;201973;4543;132625;55805;3248;256309;8470;2180;26269;7424,65
-1,1,4,169891551,187857892,17966341,285440;53842;11341;1182;175;55325;25854;140458;7098;55714;60684;60559;3148;51166;836;80014;83891;51809;57587;132851;9464;8819;9848;8001;55602;2160;80817;2823;3818;54969;79682;353322;11086;116966;291;100132463;27295;84869;3660;4750;441054;391723;442117;201965;2195;55247;201973;4543;57630;55805;3248;133121;256309;8470;2180;26269;7424;56977;3622;1635,60
-1,1,4,170794659,190939340,20144681,285440;53842;11341;205860;25854;175;55325;140458;7098;55714;60684;60559;3148;51166;836;80014;83891;51809;57587;132851;9464;8819;9848;8001;55602;2160;80817;2823;3818;79682;353322;11086;116966;291;100132463;27295;3660;441054;391723;442117;201965;2195;339976;55247;201973;4543;132625;55805;3248;133121;256309;8470;2180;26269;7424;56977;3622;2483;1635,59
-1,1,4,171820275,190957473,19137198,285440;53842;11341;205860;25854;175;55325;140458;7098;55714;60684;60559;3148;836;80014;83891;448831;51809;57587;132851;9464;8819;55602;8001;2160;80817;2823;3818;79682;353322;11086;116966;291;100132463;27295;3660;441054;391723;442117;201965;2195;339976;55247;201973;4543;132625;55805;3248;133121;256309;8470;2180;26269;7424;56977;3622;2483;1635,58
-1,1,4,173422525,190828225,17405700,285440;53842;11341;205860;25854;175;55325;140458;7098;55714;60684;60559;3148;836;80014;83891;51809;57587;132851;9464;8819;55602;8001;2160;80817;2823;3818;79682;353322;11086;116966;291;100132463;27295;3660;441054;391723;442117;201965;2195;339976;55247;201973;4543;132625;55805;3248;133121;256309;8470;2180;26269;7424;56977;3622;1635,56
1,1,4,174655220,174742050,86830,,0
-1,1,4,174775711,190469337,15693626,285440;53842;205860;25854;175;55325;140458;7098;55714;60684;60559;836;80014;83891;57587;132851;55602;8001;2160;80817;2823;3818;79682;353322;11086;116966;291;100132463;27295;3660;441054;391723;201965;2195;339976;55247;201973;4543;132625;55805;3248;133121;256309;8470;2180;26269;7424;56977;3622;1635,50
-1,1,4,174910180,190828225,15918045,285440;53842;205860;25854;175;55325;140458;7098;55714;60684;60559;836;80014;83891;57587;132851;55602;8001;2160;80817;2823;3818;79682;353322;11086;116966;291;100132463;27295;3660;441054;391723;201965;2195;339976;55247;201973;4543;132625;55805;3248;133121;256309;8470;2180;26269;7424;56977;3622;1635,50
-1,1,4,175071334,189180209,14108875,285440;53842;205860;25854;175;55325;140458;7098;55714;60684;60559;836;80014;83891;57587;132851;55602;8001;2160;80817;2823;3818;79682;353322;11086;116966;291;100132463;27295;3660;441054;391723;201965;2195;339976;55247;201973;4543;132625;55805;3248;133121;256309;8470;2180;26269;7424;56977;3622;1635,50
-1,1,4,175550289,190838582,15288293,285440;53842;205860;25854;175;55325;140458;7098;55714;60684;60559;836;80014;83891;57587;132851;55602;8001;2160;2823;3818;79682;353322;11086;116966;291;100132463;27295;3660;441054;391723;201965;2195;339976;55247;201973;4543;132625;55805;133121;256309;8470;2180;7424;56977;3622;1635,47
-1,1,4,175550289,190957473,15407184,285440;53842;205860;25854;175;55325;140458;7098;55714;60684;60559;836;80014;83891;448831;57587;132851;55602;8001;2160;2823;3818;79682;353322;11086;116966;291;100132463;27295;3660;441054;391723;201965;2195;339976;55247;201973;4543;132625;55805;133121;256309;8470;2180;7424;56977;3622;2483;1635,49
-1,1,4,175749001,190957473,15208472,285440;53842;205860;25854;175;55325;140458;7098;55714;60684;60559;836;80014;83891;448831;57587;132851;55602;8001;2160;2823;3818;79682;353322;11086;116966;291;100132463;27295;3660;441054;391723;201965;2195;339976;55247;201973;4543;132625;55805;133121;256309;8470;2180;7424;56977;3622;2483;1635,49
1,1,4,176306103,190957473,14651370,285440;53842;205860;25854;175;55325;140458;7098;55714;60684;60559;836;80014;83891;448831;57587;132851;55602;2160;2823;3818;79682;353322;116966;291;100132463;27295;3660;441054;391723;201965;2195;339976;55247;201973;4543;132625;55805;133121;256309;8470;2180;7424;56977;3622;2483;1635,47
-1,-1,4,178267221,178501048,233827,55247;175,2
-1,1,4,178907110,190828225,11921115,285440;53842;205860;25854;55325;7098;55714;60684;836;80014;83891;57587;55602;2160;3818;79682;353322;291;100132463;27295;3660;441054;391723;201965;2195;339976;201973;4543;132625;55805;133121;256309;8470;2180;56977;3622;1635,37
-1,1,4,178935724,190828225,11892501,285440;53842;205860;25854;55325;7098;55714;60684;836;80014;83891;57587;55602;2160;3818;79682;353322;291;100132463;27295;3660;441054;391723;201965;2195;339976;201973;4543;132625;55805;133121;256309;8470;2180;56977;3622;1635,37
-1,1,4,179470626,190828225,11357599,285440;53842;205860;25854;55325;7098;55714;60684;836;80014;83891;57587;55602;2160;3818;79682;353322;291;100132463;27295;3660;441054;391723;201965;2195;339976;201973;4543;132625;55805;133121;256309;8470;2180;56977;3622;1635,37
1,1,4,180216665,190957473,10740808,285440;53842;205860;25854;55325;7098;55714;60684;836;80014;83891;448831;57587;55602;2160;3818;79682;353322;291;100132463;27295;3660;441054;391723;201965;2195;339976;201973;4543;132625;55805;133121;256309;8470;2180;56977;3622;2483;1635,39
1,1,4,180702769,190957473,10254704,285440;53842;205860;25854;55325;7098;55714;60684;836;80014;83891;448831;57587;55602;2160;3818;79682;353322;291;100132463;27295;3660;441054;391723;201965;2195;339976;201973;4543;132625;55805;133121;256309;8470;2180;56977;3622;2483;1635,39
-1,-1,4,181224542,181927559,703017,,0
-1,1,4,181496115,190828225,9332110,285440;53842;205860;25854;55325;7098;55714;60684;836;80014;83891;57587;55602;2160;3818;79682;353322;291;100132463;27295;3660;441054;391723;201965;2195;339976;201973;4543;132625;55805;133121;256309;8470;2180;56977;3622;1635,37
-1,1,4,181547444,190790911,9243467,285440;53842;205860;25854;55325;7098;55714;60684;836;80014;83891;57587;55602;2160;3818;79682;353322;291;100132463;27295;3660;441054;391723;201965;2195;339976;201973;4543;132625;55805;133121;256309;8470;2180;56977;3622;1635,37
1,1,4,181639003,190828225,9189222,285440;53842;205860;25854;55325;7098;55714;60684;836;80014;83891;57587;55602;2160;3818;79682;353322;291;100132463;27295;3660;441054;391723;201965;2195;339976;201973;4543;132625;55805;133121;256309;8470;2180;56977;3622;1635,37
-1,1,4,182500779,187021353,4520574,79682;353322;53842;291;100132463;55325;27295;7098;3660;55714;441054;391723;201965;60684;836;201973;80014;83891;57587;55805;133121;256309;8470;2180;56977;55602;3622;1635,28
-1,1,4,182500779,187021353,4520574,79682;353322;53842;291;100132463;55325;27295;7098;3660;55714;441054;391723;201965;60684;836;201973;80014;83891;57587;55805;133121;256309;8470;2180;56977;55602;3622;1635,28
-1,1,4,183358244,190939340,7581096,285440;53842;205860;25854;55325;7098;55714;60684;836;80014;83891;57587;55602;2160;3818;79682;353322;291;100132463;27295;3660;441054;391723;201965;2195;339976;201973;4543;132625;55805;133121;256309;8470;2180;56977;3622;2483;1635,38
-1,1,4,183993896,190828225,6834329,285440;53842;205860;25854;55325;7098;60684;836;80014;83891;57587;55602;2160;3818;79682;353322;291;100132463;27295;3660;441054;391723;201965;2195;339976;201973;4543;132625;55805;133121;256309;8470;2180;56977;3622,35
-1,1,4,185160684,190828225,5667541,79682;285440;353322;205860;291;25854;55325;27295;7098;3660;441054;391723;2195;339976;836;201973;83891;4543;57587;132625;55805;256309;8470;2180;2160;3818,26
1,1,4,185248234,190828225,5579991,79682;285440;353322;205860;291;25854;55325;27295;7098;3660;441054;391723;2195;339976;836;201973;83891;4543;57587;132625;55805;256309;8470;2180;2160;3818,26
1,1,4,185248234,190828225,5579991,79682;285440;353322;205860;291;25854;55325;27295;7098;3660;441054;391723;2195;339976;836;201973;83891;4543;57587;132625;55805;256309;8470;2180;2160;3818,26
-1,1,4,185253508,190713591,5460083,79682;285440;353322;205860;291;25854;55325;27295;7098;3660;441054;391723;2195;339976;836;201973;83891;4543;57587;132625;55805;256309;8470;2180;2160;3818,26
1,1,4,185328126,189836692,4508566,79682;285440;353322;205860;291;25854;55325;27295;7098;3660;441054;391723;2195;339976;836;201973;83891;4543;57587;132625;55805;256309;8470;2180;2160;3818,26
-1,1,4,185353135,190790911,5437776,79682;285440;353322;205860;291;25854;55325;27295;7098;3660;441054;391723;2195;339976;836;201973;83891;4543;57587;132625;55805;256309;8470;2180;2160;3818,26
-1,1,4,185381293,190957473,5576180,79682;285440;353322;205860;291;25854;55325;27295;7098;3660;441054;391723;2195;339976;836;201973;83891;448831;4543;57587;132625;55805;256309;8470;2180;2160;2483;3818,28
1,1,4,185845419,187499543,1654124,353322;285440;291;27295;55325;25854;7098;441054;391723;83891;4543;57587;55805;256309;8470;2160;3818,17
-1,1,4,186252440,190713591,4461151,353322;285440;205860;27295;55325;25854;7098;441054;2195;339976;83891;4543;132625;55805;256309;8470;2160;3818,18
1,-1,4,186638639,186659293,20654,8470,1
-1,1,4,186958290,187192748,234458,7098;285440;2160;25854;3818,5
-1,1,4,187108903,190722107,3613204,285440;4543;205860;132625;2160;2195;339976;3818,8
1,-1,4,187210595,187476383,265788,4543;2160,2
1,-1,4,187367725,187476383,108658,4543,1
1,-1,4,187367725,187476383,108658,4543,1
1,-1,4,187367725,187476383,108658,4543,1
1,-1,4,187367725,187476383,108658,4543,1
1,-1,4,187367725,187476383,108658,4543,1
1,-1,4,187367725,187476383,108658,4543,1
-1,1,4,187546424,190939340,3392916,205860;2195;132625;339976;2483,5
1,-1,4,188105977,189786913,1680936,205860;132625;339976,3
1,-1,4,188191879,189374480,1182601,205860;132625;339976,3
1,-1,4,188462395,189036166,573771,205860;132625,2
1,-1,4,188462395,189036166,573771,205860;132625,2
1,-1,4,188462395,189036166,573771,205860;132625,2
1,-1,4,188462395,189036166,573771,205860;132625,2
1,-1,4,188511040,189036294,525254,205860;132625,2
1,-1,4,188511040,189036294,525254,205860;132625,2
1,-1,4,188511081,188810990,299909,,0
1,-1,4,188511081,188810990,299909,,0
1,-1,4,188590472,189508371,917899,205860;132625;339976,3
1,-1,4,188590472,189508371,917899,205860;132625;339976,3
1,-1,4,189012426,189180135,167709,205860;339976,2
1,-1,4,189180150,189644372,464222,,0
1,-1,4,189247673,189435216,187543,,0
-1,-1,4,189407830,189968308,560478,,0
1,-1,4,189703193,189914227,211034,,0
1,-1,4,189703193,189914227,211034,,0
1,-1,4,189786628,189948946,162318,,0
1,-1,4,189836620,190713599,876979,,0
1,-1,4,189836633,190092994,256361,,0
1,-1,4,189836692,190092994,256302,,0
-1,-1,4,189897659,190469515,571856,,0
-1,-1,4,189897659,190828225,930566,,0
-1,1,4,189914168,190828225,914057,,0
-1,-1,4,189968268,190713599,745331,,0
1,-1,4,189968268,190348253,379985,,0
-1,-1,4,190027826,190469515,441689,,0
-1,-1,4,190032372,190828225,795853,,0
-1,-1,4,190032372,190828225,795853,,0
1,-1,4,190079238,190159449,80211,,0
1,-1,4,190079238,190159449,80211,,0
-1,-1,4,190085170,190713650,628480,,0
-1,-1,4,190217377,190469515,252138,,0
1,-1,4,190226013,190439714,213701,,0
1,-1,4,190245201,190309240,64039,,0
1,-1,4,190245201,190309240,64039,,0
1,-1,4,190245201,190309240,64039,,0
1,-1,4,190245201,190309240,64039,,0
1,-1,4,190245201,190309240,64039,,0
-1,-1,4,190348193,190747563,399370,,0
1,-1,4,190469456,190828225,358769,,0
-1,1,4,190509807,190957473,447666,2483;448831,2
-1,-1,4,190533611,190747613,214002,,0
-1,1,4,190713591,190828225,114634,,0
1,-1,4,190874457,190943374,68917,2483,1
1,-1,4,190943374,191012562,69188,448831,1
-1,-1,5,22149,52245,30096,,0
1,-1,5,22149,83274,61125,,0
1,-1,5,22149,83274,61125,,0
1,-1,5,22149,83274,61125,,0
1,-1,5,22149,83274,61125,,0
1,-1,5,22149,86366,64217,,0
-1,-1,5,22149,120415,98266,,0
1,-1,5,22149,163401,141252,153478,1
1,-1,5,22149,167219,145070,153478,1
-1,1,5,22149,1429714,1407565,10016;7015;6389;81037;11336;133957;9319;340024;65980;348932;153478;85409;79844;57491;6550;6531;10723;11076;55722;389257,20
1,1,5,22149,1659250,1637101,10016;7015;6389;81037;11336;133957;9319;340024;65980;348932;153478;85409;79844;57491;6550;79888;10723;6531;11076;55722;389257,21
1,1,5,22149,2324057,2301908,4726;10016;7015;6389;81037;11336;133957;9319;340024;65980;348932;153478;85409;79844;50805;57491;6550;64979;79888;10723;6531;11076;55722;389257,24
-1,1,5,22149,2965987,2943838,4726;10016;7015;6389;81037;11336;133957;9319;340024;65980;348932;153478;153572;85409;79844;50805;153571;57491;6550;64979;79888;10723;6531;11076;55722;389257,26
-1,1,5,22149,4163847,4141698,4726;10016;7015;6389;79192;81037;11336;133957;9319;340024;65980;348932;153478;153572;85409;79844;50805;153571;57491;6550;64979;79888;10723;6531;11076;55722;389257,27
-1,1,5,22149,4260264,4238115,4726;10016;7015;6389;79192;81037;11336;133957;9319;340024;65980;348932;153478;153572;85409;79844;50805;153571;57491;6550;64979;79888;10723;6531;11076;55722;389257,27
-1,1,5,22149,4641409,4619260,4726;10016;7015;6389;79192;81037;11336;133957;9319;340024;65980;348932;153478;153572;85409;79844;50805;153571;57491;6550;64979;79888;10723;6531;11076;55722;389257,27
-1,1,5,22149,4833739,4811590,4726;10016;7015;6389;79192;81037;11336;133957;9319;340024;65980;348932;153478;153572;85409;79844;50805;153571;57491;6550;64979;79888;10723;6531;11076;55722;389257,27
-1,1,5,22149,5060009,5037860,4726;10016;7015;6389;79192;81037;11336;133957;9319;340024;65980;348932;153478;153572;85409;79844;50805;153571;57491;6550;64979;79888;10723;6531;11076;55722;389257,27
-1,1,5,22149,5102699,5080550,4726;10016;7015;6389;79192;81037;11336;133957;9319;340024;65980;348932;153478;153572;85409;79844;50805;153571;57491;6550;64979;79888;10723;6531;11076;55722;389257,27
-1,1,5,22149,6060215,6038066,4726;10016;7015;6389;79192;81037;11336;133957;9319;340024;65980;348932;153478;153572;85409;79844;50805;153571;57491;55722;6550;64979;170690;79888;10723;6531;11076;23379;389257,29
-1,1,5,22149,6112711,6090562,4726;10016;7015;6389;79192;81037;11336;133957;9319;340024;65980;348932;153478;153572;85409;79844;50805;153571;57491;55722;6550;64979;170690;79888;10723;6531;11076;23379;389257,29
-1,1,5,22149,6500967,6478818,4726;10016;7015;6389;79192;81037;11336;133957;9319;340024;65980;348932;153478;153572;85409;79844;50805;153571;57491;55722;6550;64979;170690;79888;10723;6531;11076;134111;23379;84246;389257,31
-1,1,5,22149,9958240,9936091,50834;79192;81037;11336;65980;50805;153571;11044;64979;108;79888;10723;11076;23379;4726;9037;10016;7015;6389;133957;9319;340024;348932;153478;153572;54888;85409;79844;57491;4552;6550;170690;134121;79072;6715;6531;134111;55722;84246;389257,40
1,1,5,22149,10293118,10270969,50834;79192;81037;11336;65980;50805;134147;153571;11044;64979;22948;108;79888;10723;11076;23379;4726;9037;10016;7015;6389;134145;133957;9319;340024;348932;153478;153572;54888;85409;79844;57491;4552;6550;170690;134121;79072;6715;6531;134111;55722;84246;389257,43
-1,1,5,22149,11429370,11407221,10299;50834;79192;81037;11336;65980;50805;134147;153571;1501;11044;64979;22948;108;79888;10723;11076;23379;1611;4726;9037;10016;7015;6389;134145;133957;9319;340024;348932;153478;153572;54888;651746;85409;79844;83853;57491;4552;6550;170690;134121;79072;6715;6531;134111;55722;84246;389257,48
-1,1,5,22149,11530503,11508354,10299;50834;79192;81037;11336;65980;50805;134147;153571;1501;11044;64979;22948;108;79888;10723;11076;23379;1611;4726;9037;10016;7015;6389;134145;133957;9319;340024;348932;153478;153572;54888;651746;85409;79844;83853;57491;4552;6550;170690;134121;79072;6715;6531;134111;55722;84246;389257,48
-1,1,5,22149,12820111,12797962,10299;50834;79192;81037;11336;65980;50805;134147;153571;1501;11044;64979;22948;108;79888;10723;11076;23379;1611;4726;9037;10016;7015;6389;134145;133957;9319;340024;348932;153478;153572;54888;651746;85409;79844;83853;57491;4552;6550;170690;134121;79072;6715;6531;134111;55722;84246;389257,48
1,1,5,22149,15851485,15829336,10299;7204;50834;79192;81037;11336;65980;50805;134147;153571;1501;56172;11044;64979;54491;22948;23194;108;79888;10723;11076;23379;1611;4726;9037;10016;7015;6389;134145;133957;9319;340024;348932;153478;153572;54888;651746;85409;79844;83853;57491;4552;6550;90268;170690;134121;79072;1767;6715;6531;134111;55722;84246;389257,54
-1,1,5,22149,16584684,16562535,54463;10299;7204;50834;79192;81037;11336;65980;50805;134147;153571;1501;56172;11044;64979;54491;22948;23194;108;79888;10723;11076;23379;90441;1611;4726;9037;10016;7015;6389;134145;133957;9319;340024;348932;153478;153572;54888;651746;85409;79844;83853;57491;4552;6550;90268;170690;134121;79072;1767;6715;441061;6531;134111;55722;84246;389257,57
-1,1,5,22149,16930125,16907976,54463;10299;7204;50834;79192;81037;11336;65980;50805;134147;153571;1501;56172;11044;64979;54491;22948;23194;108;79888;10723;11076;23379;90441;1611;4651;4726;9037;10016;7015;6389;134145;133957;9319;340024;348932;153478;153572;54888;651746;85409;79844;83853;57491;4552;6550;90268;170690;134121;79072;1767;6715;441061;6531;134111;55722;84246;389257,58
-1,1,5,22149,17788806,17766657,54463;10299;7204;50834;79192;81037;11336;65980;50805;134147;153571;1501;56172;11044;64979;54491;22948;23194;108;79888;10723;11076;23379;90441;1611;4651;4726;9037;10016;7015;6389;134145;133957;9319;340024;348932;153478;153572;54888;651746;85409;79844;83853;57491;4552;6550;90268;170690;134121;79072;1767;6715;441061;6531;134111;10409;55722;84246;389257,59
-1,1,5,22149,21217229,21195080,54463;10299;7204;50834;79192;81037;11336;65980;50805;134147;153571;1501;56172;11044;64979;54491;22948;23194;1016;108;79888;10723;11076;23379;90441;1611;4651;4726;9037;10016;7015;6389;134145;133957;9319;340024;348932;153478;153572;54888;651746;85409;79844;83853;57491;4552;6550;90268;170690;134121;79072;1767;6715;441061;6531;134111;10409;55722;84246;389257,60
-1,1,5,22149,21726469,21704320,54463;10299;7204;50834;79192;81037;11336;65980;50805;134147;153571;1501;56172;11044;64979;54491;22948;23194;1016;108;79888;10723;11076;23379;90441;1611;4651;4726;9037;10016;7015;6389;134145;133957;9319;340024;348932;153478;153572;54888;651746;85409;79844;83853;57491;4552;6550;90268;170690;134121;79072;1767;6715;441061;6531;134111;10409;55722;84246;389257,60
-1,1,5,22149,22775404,22753255,54463;10299;7204;1010;50834;79192;81037;11336;65980;50805;134147;153571;1501;56172;11044;64979;54491;22948;23194;1016;108;79888;10723;11076;23379;90441;1611;4651;4726;9037;10016;7015;6389;134145;133957;9319;340024;348932;153478;153572;54888;651746;85409;79844;83853;57491;4552;6550;90268;170690;134121;79072;1767;6715;441061;6531;134111;10409;55722;84246;389257,61
1,1,5,22149,23607162,23585013,54463;10299;7204;1010;50834;79192;81037;11336;65980;50805;134147;153571;1501;56172;11044;64979;54491;22948;23194;1016;108;79888;10723;11076;23379;90441;1611;4651;4726;9037;10016;7015;6389;134145;56979;133957;9319;340024;348932;153478;153572;54888;651746;85409;79844;83853;57491;4552;6550;90268;170690;134121;79072;1767;6715;441061;6531;134111;10409;55722;84246;389257,62
-1,1,5,22149,24835567,24813418,54463;10299;7204;1010;50834;79192;81037;11336;65980;50805;134147;153571;1501;56172;11044;64979;54491;22948;23194;1016;108;79888;10723;11076;23379;90441;1611;4651;4726;9037;10016;7015;6389;134145;56979;133957;9319;340024;348932;153478;153572;54888;1008;651746;85409;79844;83853;57491;4552;6550;90268;170690;134121;79072;1767;6715;441061;6531;134111;10409;55722;84246;389257,63
-1,1,5,22149,25699714,25677565,54463;10299;7204;1010;50834;79192;81037;11336;65980;50805;134147;153571;1501;56172;11044;64979;54491;22948;23194;1016;108;79888;10723;11076;23379;90441;1611;4651;4726;9037;10016;7015;6389;134145;56979;133957;9319;340024;348932;153478;153572;54888;1008;651746;85409;79844;83853;57491;4552;6550;90268;170690;134121;79072;1767;6715;441061;6531;134111;10409;55722;84246;389257,63
-1,1,5,22149,26594000,26571851,54463;10299;7204;1010;50834;79192;81037;11336;65980;50805;134147;153571;1501;56172;11044;64979;54491;22948;23194;1016;108;79888;10723;11076;23379;90441;1611;4651;4726;9037;10016;7015;6389;134145;56979;133957;9319;340024;348932;153478;153572;54888;1008;651746;85409;79844;83853;57491;4552;6550;90268;170690;134121;79072;1767;6715;441061;6531;134111;10409;55722;84246;389257,63
-1,1,5,22149,27188057,27165908,54463;10299;7204;50834;50805;11044;23194;108;10723;90441;133957;9319;348932;651746;85409;79844;83853;57491;4552;6550;170690;1767;441061;6531;90268;55722;134121;84246;389257;1010;79192;81037;11336;65980;1007;134147;153571;1501;56172;64979;54491;22948;1016;79888;11076;23379;1611;4651;4726;9037;10016;7015;6389;134145;340024;1008;153478;153572;79072;6715;134111;54888;10409;56979,64
-1,1,5,22149,27485726,27463577,54463;10299;7204;50834;50805;11044;23194;108;10723;90441;133957;9319;348932;651746;85409;79844;83853;57491;4552;6550;170690;1767;441061;6531;90268;55722;134121;84246;389257;1010;79192;81037;11336;65980;1007;134147;153571;1501;56172;64979;54491;22948;1016;79888;11076;23379;1611;4651;4726;9037;10016;7015;6389;134145;340024;1008;153478;153572;79072;6715;134111;54888;10409;56979,64
-1,1,5,22149,27485726,27463577,54463;10299;7204;50834;50805;11044;23194;108;10723;90441;133957;9319;348932;651746;85409;79844;83853;57491;4552;6550;170690;1767;441061;6531;90268;55722;134121;84246;389257;1010;79192;81037;11336;65980;1007;134147;153571;1501;56172;64979;54491;22948;1016;79888;11076;23379;1611;4651;4726;9037;10016;7015;6389;134145;340024;1008;153478;153572;79072;6715;134111;54888;10409;56979,64
-1,1,5,22149,27611270,27589121,54463;10299;7204;50834;50805;11044;23194;108;10723;90441;133957;9319;348932;651746;85409;79844;83853;57491;4552;6550;170690;1767;441061;6531;90268;55722;134121;84246;389257;1010;79192;81037;11336;65980;1007;134147;153571;1501;56172;64979;54491;22948;1016;79888;11076;23379;1611;4651;4726;9037;10016;7015;6389;134145;340024;1008;153478;153572;79072;6715;134111;54888;10409;56979,64
-1,1,5,22149,27788723,27766574,54463;10299;7204;50834;50805;11044;23194;108;10723;90441;133957;9319;348932;651746;85409;79844;83853;57491;4552;6550;170690;1767;441061;6531;90268;55722;134121;84246;389257;1010;79192;81037;11336;65980;1007;134147;153571;1501;56172;64979;54491;22948;1016;79888;11076;23379;1611;4651;4726;9037;10016;7015;6389;134145;340024;1008;153478;153572;79072;6715;134111;54888;10409;56979,64
1,1,5,22149,28075213,28053064,54463;10299;7204;50834;50805;11044;23194;108;10723;90441;133957;9319;348932;651746;85409;79844;83853;57491;4552;6550;170690;1767;441061;6531;90268;55722;134121;84246;389257;1010;79192;81037;11336;65980;1007;134147;153571;1501;56172;64979;54491;22948;1016;79888;11076;23379;1611;4651;4726;9037;10016;7015;6389;134145;340024;1008;153478;153572;79072;6715;134111;54888;10409;56979,64
-1,1,5,22149,28429348,28407199,54463;10299;7204;50834;50805;11044;23194;108;10723;90441;133957;9319;348932;651746;85409;79844;83853;57491;4552;6550;170690;1767;441061;6531;90268;55722;134121;84246;389257;1010;79192;81037;11336;65980;1007;134147;153571;1501;56172;64979;54491;22948;1016;79888;11076;23379;1611;4651;4726;9037;10016;7015;6389;134145;340024;1008;153478;153572;79072;6715;134111;54888;10409;56979,64
-1,1,5,22149,28589299,28567150,54463;10299;7204;50834;50805;11044;23194;108;10723;90441;133957;9319;348932;651746;85409;79844;83853;57491;4552;6550;170690;1767;441061;6531;90268;55722;134121;84246;389257;1010;79192;81037;11336;65980;1007;134147;153571;1501;56172;64979;54491;22948;1016;79888;11076;23379;1611;4651;4726;9037;10016;7015;6389;134145;340024;1008;153478;153572;79072;6715;134111;54888;10409;56979,64
-1,1,5,22149,32248116,32225967,54463;10299;7204;50834;55322;50805;11044;29102;23194;1004;108;10723;90441;23037;133957;9319;348932;651746;85409;79844;83853;57491;4552;6550;170690;1767;441061;6531;90268;55722;134121;84246;54545;389257;1010;79192;81037;11336;65980;1007;134147;153571;1501;56172;64979;54491;22948;1016;79888;11076;23379;1611;4651;4726;9037;10016;7015;6389;134145;340024;1008;153478;153572;79072;6715;134111;54888;10409;56979;64083,70
1,1,5,22149,33418294,33396145,54463;10299;7204;50834;55322;50805;4883;11044;29102;23194;1004;108;10723;90441;23037;133957;9319;348932;10923;651746;85409;79844;83853;57491;4552;6550;170690;1767;441061;6531;90268;51663;55722;134121;84246;54545;389257;1010;79192;81037;11336;65980;1007;134147;153571;1501;56172;64979;54491;22948;1016;79888;11076;23379;1611;4651;4726;9037;10016;7015;6389;134145;340024;1008;153478;153572;79072;6715;134111;54888;10409;56979;64083,73
-1,1,5,22149,34041196,34019047,54463;10299;7204;50834;6897;55322;50805;4883;11044;29102;23194;1004;108;10723;90441;23037;348932;9319;133957;10923;651746;85409;79844;83853;51151;57491;4552;6550;1767;170690;441061;6531;90268;51663;55722;134121;84246;54545;389257;1010;79192;81037;11336;65980;1007;134147;56172;1501;153571;64979;1016;22948;54491;51289;79888;11076;23379;4651;1611;4726;114899;9037;10016;7015;6389;134145;340024;81792;1008;153572;153478;23600;79072;6715;134111;54888;10409;56979;64083,79
-1,1,5,22149,35831640,35809491,54463;10299;7204;50834;6897;55322;64902;50805;4883;11044;29102;23194;1004;108;10723;90441;23037;348932;9319;133957;10923;55299;651746;85409;79844;83853;51151;57491;4552;153657;6550;5618;1767;170690;441061;6531;90268;51663;55722;134121;84246;54545;389257;5810;1010;79192;81037;11336;65980;1007;134147;56172;1501;153571;64979;1016;22948;54491;51289;79888;11076;23379;4651;1611;4726;114899;9037;10016;7015;6389;134145;340024;81792;1008;153572;153478;23600;26064;79072;6715;79925;134111;54888;134218;10409;56979;64083,87
1,1,5,22149,73708550,73686401,54463;10299;80006;4338;50834;10769;285672;55322;1601;2255;9607;50805;3350;5144;11044;29102;23398;729;1004;10884;108;167127;65056;10723;51194;9631;3842;3673;133396;54557;10468;202151;23107;348932;9319;253260;5562;6607;167465;10923;57486;651746;202243;79844;389289;373;4131;51151;4552;6550;100129792;1022;100130733;5618;1767;55100;441061;6531;90268;166968;55914;84674;134121;84246;54545;389257;57688;23517;1010;2668;3672;92259;81037;11336;10605;2297;65980;5734;84135;6167;493869;11082;134147;56172;133686;6606;285668;3670;689;64979;1016;22948;285671;102157402;345651;8988;401190;23379;4651;153129;4726;9037;7015;6389;134145;285636;81792;153572;643155;4064;23600;26064;4671;166979;91942;23530;2966;2690;54505;134288;133383;3157;101928448;1161;79072;115548;6715;79925;375444;10409;100132916;64083;64283;7204;115827;891;728492;6897;100861519;345557;4724;64924;64087;64902;54622;112574;79810;4883;133688;64946;153562;23194;27292;55789;100506658;54514;90441;133690;23037;6414;348980;133957;65250;10309;55299;133584;85409;79668;83853;730;4214;6507;2533;140890;57491;23548;153657;133558;170690;10283;51663;3575;55722;5810;133418;375449;5884;3977;92255;64417;735;79192;5295;11174;1007;8611;1501;153571;3003;7690;57763;53918;56477;54491;51289;134285;9180;79888;6502;11076;1611;114899;10016;79722;26272;79993;340024;1008;153478;5019;202309;3001;3572;64105;6880;8293;55814;345643;728340;25836;134111;54888;3796;134218;167359;56979,236
1,-1,5,50093,83274,33181,,0
1,-1,5,50093,83274,33181,,0
-1,1,5,50093,15678560,15628467,10299;7204;50834;79192;81037;11336;65980;50805;134147;153571;1501;56172;11044;64979;54491;22948;23194;108;79888;10723;11076;23379;1611;4726;9037;10016;7015;6389;134145;133957;9319;340024;348932;153478;153572;54888;651746;85409;79844;83853;57491;4552;6550;90268;170690;134121;79072;1767;6715;6531;134111;55722;84246;389257,54
-1,1,5,50093,15678560,15628467,10299;7204;50834;79192;81037;11336;65980;50805;134147;153571;1501;56172;11044;64979;54491;22948;23194;108;79888;10723;11076;23379;1611;4726;9037;10016;7015;6389;134145;133957;9319;340024;348932;153478;153572;54888;651746;85409;79844;83853;57491;4552;6550;90268;170690;134121;79072;1767;6715;6531;134111;55722;84246;389257,54
-1,1,5,50093,30112642,30062549,54463;10299;7204;50834;50805;11044;23194;108;10723;90441;133957;9319;348932;651746;85409;79844;83853;57491;4552;6550;170690;1767;441061;6531;90268;55722;134121;84246;389257;1010;79192;81037;11336;65980;1007;134147;153571;1501;56172;64979;54491;22948;1016;79888;11076;23379;1611;4651;4726;9037;10016;7015;6389;134145;340024;1008;153478;153572;79072;6715;134111;54888;10409;56979,64
1,1,5,50093,46115086,46064993,54463;10299;50834;55322;1601;2255;50805;11044;29102;729;1004;10884;108;167127;10723;9631;202151;348932;9319;253260;5562;10923;651746;79844;389289;51151;4552;6550;100129792;5618;1767;55100;441061;6531;90268;84674;134121;84246;54545;389257;1010;2668;81037;11336;10605;65980;5734;6167;134147;56172;133686;64979;1016;22948;23379;4651;4726;9037;7015;6389;134145;285636;81792;153572;23600;26064;23530;2690;3157;79072;6715;79925;375444;10409;64083;7204;6897;100861519;345557;64902;4883;133688;23194;90441;133690;23037;6414;348980;133957;65250;55299;133584;85409;83853;730;6507;2533;57491;23548;153657;133558;170690;51663;3575;55722;5810;3977;92255;64417;735;79192;1007;1501;153571;7690;56477;54491;51289;9180;79888;6502;11076;1611;114899;10016;26272;340024;1008;153478;5019;25836;134111;54888;134218;167359;56979,136
1,-1,5,52186,151737,99551,153478,1
1,-1,5,71904,113885,41981,,0
1,-1,5,71904,113885,41981,,0
1,-1,5,71904,116862,44958,,0
1,-1,5,71904,116862,44958,,0
1,-1,5,71904,138446,66542,,0
1,-1,5,71913,116846,44933,,0
1,-1,5,71913,116846,44933,,0
1,-1,5,71913,116846,44933,,0
1,-1,5,79146,138446,59300,,0
1,-1,5,79146,182568,103422,153478,1
-1,1,5,79146,22152284,22073138,54463;10299;7204;1010;50834;79192;81037;11336;65980;50805;134147;153571;1501;56172;11044;64979;54491;22948;23194;1016;108;79888;10723;11076;23379;90441;1611;4651;4726;9037;10016;7015;6389;134145;133957;9319;340024;348932;153478;153572;54888;651746;85409;79844;83853;57491;4552;6550;90268;170690;134121;79072;1767;6715;441061;6531;134111;10409;55722;84246;389257,61
-1,-1,5,90224,138412,48188,,0
-1,1,5,95243,5834664,5739421,4726;10016;7015;6389;79192;81037;11336;133957;9319;340024;65980;348932;153478;153572;85409;79844;50805;153571;57491;55722;6550;64979;170690;79888;10723;6531;11076;23379;389257,29
1,-1,5,100354,182681,82327,153478,1
-1,1,5,113576,4175855,4062279,4726;10016;7015;6389;79192;81037;11336;133957;9319;340024;65980;348932;153478;153572;85409;79844;50805;153571;57491;6550;64979;79888;10723;6531;11076;55722;389257,27
-1,1,5,113576,5380741,5267165,4726;10016;7015;6389;79192;81037;11336;133957;9319;340024;65980;348932;153478;153572;85409;79844;50805;153571;57491;6550;64979;170690;79888;10723;6531;11076;55722;389257,28
-1,1,5,113576,6244090,6130514,4726;10016;7015;6389;79192;81037;11336;133957;9319;340024;65980;348932;153478;153572;85409;79844;50805;153571;57491;55722;6550;64979;170690;79888;10723;6531;11076;23379;389257,29
-1,1,5,113576,6737134,6623558,79192;81037;11336;65980;50805;153571;11044;64979;79888;10723;11076;23379;4726;10016;7015;6389;133957;9319;340024;348932;153478;153572;54888;85409;79844;57491;6550;170690;6715;6531;134111;55722;84246;389257,34
-1,1,5,113576,8876045,8762469,79192;81037;11336;65980;50805;153571;11044;64979;108;79888;10723;11076;23379;4726;10016;7015;6389;133957;9319;340024;348932;153478;153572;54888;85409;79844;57491;4552;6550;170690;134121;79072;6715;6531;134111;55722;84246;389257,38
-1,1,5,113576,10163809,10050233,50834;79192;81037;11336;65980;50805;153571;11044;64979;108;79888;10723;11076;23379;4726;9037;10016;7015;6389;133957;9319;340024;348932;153478;153572;54888;85409;79844;57491;4552;6550;170690;134121;79072;6715;6531;134111;55722;84246;389257,40
-1,1,5,113576,10729838,10616262,10299;50834;79192;81037;11336;65980;50805;134147;153571;11044;64979;22948;108;79888;10723;11076;23379;1611;4726;9037;10016;7015;6389;134145;133957;9319;340024;348932;153478;153572;54888;651746;85409;79844;83853;57491;4552;6550;170690;134121;79072;6715;6531;134111;55722;84246;389257,47
1,1,5,113576,14238330,14124754,10299;7204;50834;79192;81037;11336;65980;50805;134147;153571;1501;11044;64979;22948;108;79888;10723;11076;23379;1611;4726;9037;10016;7015;6389;134145;133957;9319;340024;348932;153478;153572;54888;651746;85409;79844;83853;57491;4552;6550;170690;134121;79072;1767;6715;6531;134111;55722;84246;389257,50
-1,1,5,113576,14684471,14570895,10299;7204;50834;79192;81037;11336;65980;50805;134147;153571;1501;11044;64979;54491;22948;108;79888;10723;11076;23379;1611;4726;9037;10016;7015;6389;134145;133957;9319;340024;348932;153478;153572;54888;651746;85409;79844;83853;57491;4552;6550;90268;170690;134121;79072;1767;6715;6531;134111;55722;84246;389257,52
-1,1,5,113576,15291661,15178085,10299;7204;50834;79192;81037;11336;65980;50805;134147;153571;1501;56172;11044;64979;54491;22948;108;79888;10723;11076;23379;1611;4726;9037;10016;7015;6389;134145;133957;9319;340024;348932;153478;153572;54888;651746;85409;79844;83853;57491;4552;6550;90268;170690;134121;79072;1767;6715;6531;134111;55722;84246;389257,53
-1,1,5,113576,16854340,16740764,54463;10299;7204;50834;79192;81037;11336;65980;50805;134147;153571;1501;56172;11044;64979;54491;22948;23194;108;79888;10723;11076;23379;90441;1611;4651;4726;9037;10016;7015;6389;134145;133957;9319;340024;348932;153478;153572;54888;651746;85409;79844;83853;57491;4552;6550;90268;170690;134121;79072;1767;6715;441061;6531;134111;55722;84246;389257,58
-1,1,5,113576,17334977,17221401,54463;10299;7204;50834;79192;81037;11336;65980;50805;134147;153571;1501;56172;11044;64979;54491;22948;23194;108;79888;10723;11076;23379;90441;1611;4651;4726;9037;10016;7015;6389;134145;133957;9319;340024;348932;153478;153572;54888;651746;85409;79844;83853;57491;4552;6550;90268;170690;134121;79072;1767;6715;441061;6531;134111;10409;55722;84246;389257,59
1,1,5,113576,20240392,20126816,54463;10299;7204;50834;79192;81037;11336;65980;50805;134147;153571;1501;56172;11044;64979;54491;22948;23194;1016;108;79888;10723;11076;23379;90441;1611;4651;4726;9037;10016;7015;6389;134145;133957;9319;340024;348932;153478;153572;54888;651746;85409;79844;83853;57491;4552;6550;90268;170690;134121;79072;1767;6715;441061;6531;134111;10409;55722;84246;389257,60
-1,1,5,113576,21786246,21672670,54463;10299;7204;1010;50834;79192;81037;11336;65980;50805;134147;153571;1501;56172;11044;64979;54491;22948;23194;1016;108;79888;10723;11076;23379;90441;1611;4651;4726;9037;10016;7015;6389;134145;133957;9319;340024;348932;153478;153572;54888;651746;85409;79844;83853;57491;4552;6550;90268;170690;134121;79072;1767;6715;441061;6531;134111;10409;55722;84246;389257,61
-1,1,5,113576,23047959,22934383,54463;10299;7204;1010;50834;79192;81037;11336;65980;50805;134147;153571;1501;56172;11044;64979;54491;22948;23194;1016;108;79888;10723;11076;23379;90441;1611;4651;4726;9037;10016;7015;6389;134145;133957;9319;340024;348932;153478;153572;54888;651746;85409;79844;83853;57491;4552;6550;90268;170690;134121;79072;1767;6715;441061;6531;134111;10409;55722;84246;389257,61
-1,1,5,113576,23147737,23034161,54463;10299;7204;1010;50834;79192;81037;11336;65980;50805;134147;153571;1501;56172;11044;64979;54491;22948;23194;1016;108;79888;10723;11076;23379;90441;1611;4651;4726;9037;10016;7015;6389;134145;133957;9319;340024;348932;153478;153572;54888;651746;85409;79844;83853;57491;4552;6550;90268;170690;134121;79072;1767;6715;441061;6531;134111;10409;55722;84246;389257,61
-1,1,5,113576,25091472,24977896,54463;10299;7204;1010;50834;79192;81037;11336;65980;50805;134147;153571;1501;56172;11044;64979;54491;22948;23194;1016;108;79888;10723;11076;23379;90441;1611;4651;4726;9037;10016;7015;6389;134145;56979;133957;9319;340024;348932;153478;153572;54888;1008;651746;85409;79844;83853;57491;4552;6550;90268;170690;134121;79072;1767;6715;441061;6531;134111;10409;55722;84246;389257,63
-1,1,5,113576,25948451,25834875,54463;10299;7204;1010;50834;79192;81037;11336;65980;50805;134147;153571;1501;56172;11044;64979;54491;22948;23194;1016;108;79888;10723;11076;23379;90441;1611;4651;4726;9037;10016;7015;6389;134145;56979;133957;9319;340024;348932;153478;153572;54888;1008;651746;85409;79844;83853;57491;4552;6550;90268;170690;134121;79072;1767;6715;441061;6531;134111;10409;55722;84246;389257,63
-1,1,5,113576,26234903,26121327,54463;10299;7204;1010;50834;79192;81037;11336;65980;50805;134147;153571;1501;56172;11044;64979;54491;22948;23194;1016;108;79888;10723;11076;23379;90441;1611;4651;4726;9037;10016;7015;6389;134145;56979;133957;9319;340024;348932;153478;153572;54888;1008;651746;85409;79844;83853;57491;4552;6550;90268;170690;134121;79072;1767;6715;441061;6531;134111;10409;55722;84246;389257,63
-1,1,5,113576,26948599,26835023,54463;10299;7204;50834;50805;11044;23194;108;10723;90441;133957;9319;348932;651746;85409;79844;83853;57491;4552;6550;170690;1767;441061;6531;90268;55722;134121;84246;389257;1010;79192;81037;11336;65980;1007;134147;153571;1501;56172;64979;54491;22948;1016;79888;11076;23379;1611;4651;4726;9037;10016;7015;6389;134145;340024;1008;153478;153572;79072;6715;134111;54888;10409;56979,64
-1,1,5,113576,27338567,27224991,54463;10299;7204;50834;50805;11044;23194;108;10723;90441;133957;9319;348932;651746;85409;79844;83853;57491;4552;6550;170690;1767;441061;6531;90268;55722;134121;84246;389257;1010;79192;81037;11336;65980;1007;134147;153571;1501;56172;64979;54491;22948;1016;79888;11076;23379;1611;4651;4726;9037;10016;7015;6389;134145;340024;1008;153478;153572;79072;6715;134111;54888;10409;56979,64
1,1,5,113576,30279389,30165813,54463;10299;7204;50834;50805;11044;23194;108;10723;90441;133957;9319;348932;651746;85409;79844;83853;57491;4552;6550;170690;1767;441061;6531;90268;55722;134121;84246;389257;1010;79192;81037;11336;65980;1007;134147;153571;1501;56172;64979;54491;22948;1016;79888;11076;23379;1611;4651;4726;9037;10016;7015;6389;134145;340024;1008;153478;153572;79072;6715;134111;54888;10409;56979,64
-1,1,5,113576,33493797,33380221,54463;10299;7204;50834;6897;55322;50805;4883;11044;29102;23194;1004;108;10723;90441;23037;133957;9319;348932;10923;651746;85409;79844;83853;57491;4552;6550;170690;1767;441061;6531;90268;51663;55722;134121;84246;54545;389257;1010;79192;81037;11336;65980;1007;134147;153571;1501;56172;64979;54491;22948;1016;79888;11076;23379;1611;4651;4726;9037;10016;7015;6389;134145;340024;1008;153478;153572;79072;6715;134111;54888;10409;56979;64083,74
-1,1,5,113576,33998394,33884818,54463;10299;7204;50834;6897;55322;50805;4883;11044;29102;23194;1004;108;10723;90441;23037;348932;9319;133957;10923;651746;85409;79844;83853;51151;57491;4552;6550;1767;170690;441061;6531;90268;51663;55722;134121;84246;54545;389257;1010;79192;81037;11336;65980;1007;134147;56172;1501;153571;64979;1016;22948;54491;51289;79888;11076;23379;4651;1611;4726;9037;10016;7015;6389;134145;340024;81792;1008;153572;153478;23600;79072;6715;134111;54888;10409;56979;64083,78
-1,1,5,113576,34372083,34258507,54463;10299;7204;50834;6897;55322;50805;4883;11044;29102;23194;1004;108;10723;90441;23037;348932;9319;133957;10923;651746;85409;79844;83853;51151;57491;4552;6550;1767;170690;441061;6531;90268;51663;55722;134121;84246;54545;389257;1010;79192;81037;11336;65980;1007;134147;56172;1501;153571;64979;1016;22948;54491;51289;79888;11076;23379;4651;1611;4726;114899;9037;10016;7015;6389;134145;340024;81792;1008;153572;153478;23600;79072;6715;134111;54888;10409;56979;64083,79
1,1,5,113577,180719789,180606212,10299;5159;645121;93166;4338;10769;56127;133746;30832;55322;5813;56101;3308;3074;153339;167127;30012;84321;9604;3673;26262;10468;80758;3593;348932;345456;23286;133874;10007;56121;1809;56923;1022;6500;4488;153201;134549;285676;55100;441061;117156;55914;10814;8817;134121;285659;642987;401207;4015;6620;28966;11336;51301;2297;6167;493869;134147;10788;6606;285668;4238;9421;27039;23197;1016;22948;100505841;23438;2151;345651;8988;84250;10112;57561;1812;23105;90933;3550;133491;23440;51128;81792;9443;56143;26064;80315;91942;23530;2966;134288;3035;404203;133383;11063;101928448;4245;89848;78991;375444;114787;51752;64283;9555;2908;51428;83989;51014;101928093;100861519;345462;3779;492311;112574;285643;79810;4883;116068;133688;134266;1879;27292;6208;5921;56132;814;6414;324;85027;348980;6879;256987;10309;100131897;140890;64411;84466;56123;353189;5480;285601;23092;57222;64839;51663;22836;5884;375449;2161;3977;56126;153643;56103;54492;117608;134265;9708;285605;91977;9627;56139;1007;10917;2745;1501;1462;9315;7690;56477;51617;51289;83942;3578;79888;202333;6728;80108;1437;64777;1836;11005;1611;114899;79722;23567;23635;26999;2201;10011;1393;134553;3562;4163;64105;51265;26167;8293;8992;345643;133482;51247;56140;57824;83463;57396;613212;2661;85480;80230;2916;929;56134;256006;4090;7322;51491;345757;26762;6586;167555;1601;51121;53917;23138;11044;134391;729;1004;153830;84059;51780;1436;51523;134510;6583;23120;10569;6534;8641;51151;83697;81848;100129792;56145;56114;1767;167153;84246;57688;5066;2668;171019;10111;5307;5734;9652;140947;153579;1350;7320;819;56172;133686;56104;2299;115123;26045;84240;64979;10902;1160;56110;6444;4651;7478;7015;5229;23367;285636;64167;11282;1452;5098;285588;64901;10318;114898;153328;166979;56131;56097;1843;2690;54505;1719;5626;831;206338;79072;115548;79925;10184;2172;64324;8614;167410;7518;7204;115827;891;340075;348938;153769;9685;8546;55696;1729;404734;64924;64848;134187;51294;64946;3187;23194;79616;728780;56137;57179;56136;2107;10412;80762;9140;1495;23037;79646;340120;6940;9456;64097;8697;84418;81545;83853;730;153657;641700;11127;3360;10283;4001;27190;7905;2760;9879;153642;8841;5810;133418;3937;2878;92255;5201;735;1946;134548;2676;202134;134083;1176;345611;56135;1958;8611;3295;57763;56133;1482;84851;9180;340061;153396;153733;79993;2264;3094;56147;9832;51015;6643;4056;134111;153218;100506658;134492;81786;92259;56979;2150;995;22838;1404;80006;347732;50834;51164;285672;29958;91522;644100;6902;30820;56100;3350;7265;9522;51334;9945;84249;375484;10884;108;9867;3274;3842;54825;9631;90249;133396;644994;6584;23743;9794;22987;54557;6690;79908;202151;134359;153770;23107;373863;83884;5562;202374;57486;9542;56105;8728;9963;4012;373;1794;55109;4552;6695;55819;5618;6678;1627;6531;90268;26249;1070;84674;285641;54545;6932;6793;253314;3702;501;56112;81037;65980;134526;4208;5515;728586;1212;3670;27089;102157402;56098;643836;54826;51520;255426;9547;134145;54540;4064;11346;23600;4671;1036;340069;56108;91975;8507;1456;3157;7060;5601;6715;57113;3161;64083;643226;54882;6897;56951;9232;100127206;9260;54819;4724;56099;64902;54622;10949;29930;635;153768;815;7025;100302736;408263;90441;83890;57451;133690;5097;63920;23305;662;65250;7045;91272;55299;10085;133584;1105;206358;170591;79668;821;4214;55568;84651;389337;23548;133558;497189;55255;22936;170690;3575;972;100462981;5122;64417;84340;51426;285704;5295;114825;167227;6569;56102;11174;51149;90355;54853;23061;3003;285596;56109;26223;23176;54491;153745;23291;11076;56130;202051;10016;57717;5145;26272;2241;94033;2559;1008;10827;2566;153478;79628;6880;56990;285598;7416;83734;85007;389333;54908;25836;56144;23517;23262;134218;643155;167359;56146;153527;4869;5924;54463;2324;56113;56142;10307;55781;2890;3156;91137;2255;1839;5459;9607;50805;3182;5144;51808;90624;134353;29102;23398;7903;1044;65056;153241;56106;134430;10723;51194;147;285590;116842;3565;3101;56124;56138;56107;9319;253260;6607;167465;4124;10923;65983;56111;22885;64374;651746;202243;79844;389289;10399;4131;91937;51397;10915;10146;6550;100130733;81789;27430;2870;2561;84327;84654;285600;166968;389257;51735;1010;3672;55374;56929;643394;10605;57507;23338;79685;84135;51306;10802;56128;337876;2196;10636;11082;317671;27166;9509;689;285671;6949;57472;9812;401190;3567;23379;3313;153443;4695;51720;153129;4726;9037;26112;26693;6389;11285;9765;57528;153572;8572;10826;475;3781;1161;92304;10409;100132916;8382;81555;153222;3950;133522;22993;285679;8974;728492;353376;9337;92181;345557;10622;64087;91368;154;3596;3659;51237;153562;133619;285613;646019;55789;1657;389320;345778;113829;25816;54514;79770;9499;2246;56129;56125;133957;54732;85409;29093;6507;2533;84105;57491;411;26025;2149;25929;134429;9782;26049;100996485;54974;55722;8637;83594;133923;51308;96459;79192;6558;51307;56122;56141;28965;9752;54439;153571;27125;53918;10087;3340;2741;84868;134285;6502;10960;902;79772;728637;900;2554;6228;340024;92270;79930;5019;5521;5917;202309;2568;8622;202052;4437;192286;3001;3572;153364;408187;100190949;55521;55814;94081;728340;55651;8878;3796;54888;389336;4762;57556;309,848
1,1,5,113577,180719789,180606212,10299;5159;645121;93166;4338;10769;56127;133746;30832;55322;5813;56101;3308;3074;153339;167127;30012;84321;9604;3673;26262;10468;80758;3593;348932;345456;23286;133874;10007;56121;1809;56923;1022;6500;4488;153201;134549;285676;55100;441061;117156;55914;10814;8817;134121;285659;642987;401207;4015;6620;28966;11336;51301;2297;6167;493869;134147;10788;6606;285668;4238;9421;27039;23197;1016;22948;100505841;23438;2151;345651;8988;84250;10112;57561;1812;23105;90933;3550;133491;23440;51128;81792;9443;56143;26064;80315;91942;23530;2966;134288;3035;404203;133383;11063;101928448;4245;89848;78991;375444;114787;51752;64283;9555;2908;51428;83989;51014;101928093;100861519;345462;3779;492311;112574;285643;79810;4883;116068;133688;134266;1879;27292;6208;5921;56132;814;6414;324;85027;348980;6879;256987;10309;100131897;140890;64411;84466;56123;353189;5480;285601;23092;57222;64839;51663;22836;5884;375449;2161;3977;56126;153643;56103;54492;117608;134265;9708;285605;91977;9627;56139;1007;10917;2745;1501;1462;9315;7690;56477;51617;51289;83942;3578;79888;202333;6728;80108;1437;64777;1836;11005;1611;114899;79722;23567;23635;26999;2201;10011;1393;134553;3562;4163;64105;51265;26167;8293;8992;345643;133482;51247;56140;57824;83463;57396;613212;2661;85480;80230;2916;929;56134;256006;4090;7322;51491;345757;26762;6586;167555;1601;51121;53917;23138;11044;134391;729;1004;153830;84059;51780;1436;51523;134510;6583;23120;10569;6534;8641;51151;83697;81848;100129792;56145;56114;1767;167153;84246;57688;5066;2668;171019;10111;5307;5734;9652;140947;153579;1350;7320;819;56172;133686;56104;2299;115123;26045;84240;64979;10902;1160;56110;6444;4651;7478;7015;5229;23367;285636;64167;11282;1452;5098;285588;64901;10318;114898;153328;166979;56131;56097;1843;2690;54505;1719;5626;831;206338;79072;115548;79925;10184;2172;64324;8614;167410;7518;7204;115827;891;340075;348938;153769;9685;8546;55696;1729;404734;64924;64848;134187;51294;64946;3187;23194;79616;728780;56137;57179;56136;2107;10412;80762;9140;1495;23037;79646;340120;6940;9456;64097;8697;84418;81545;83853;730;153657;641700;11127;3360;10283;4001;27190;7905;2760;9879;153642;8841;5810;133418;3937;2878;92255;5201;735;1946;134548;2676;202134;134083;1176;345611;56135;1958;8611;3295;57763;56133;1482;84851;9180;340061;153396;153733;79993;2264;3094;56147;9832;51015;6643;4056;134111;153218;100506658;134492;81786;92259;56979;2150;995;22838;1404;80006;347732;50834;51164;285672;29958;91522;644100;6902;30820;56100;3350;7265;9522;51334;9945;84249;375484;10884;108;9867;3274;3842;54825;9631;90249;133396;644994;6584;23743;9794;22987;54557;6690;79908;202151;134359;153770;23107;373863;83884;5562;202374;57486;9542;56105;8728;9963;4012;373;1794;55109;4552;6695;55819;5618;6678;1627;6531;90268;26249;1070;84674;285641;54545;6932;6793;253314;3702;501;56112;81037;65980;134526;4208;5515;728586;1212;3670;27089;102157402;56098;643836;54826;51520;255426;9547;134145;54540;4064;11346;23600;4671;1036;340069;56108;91975;8507;1456;3157;7060;5601;6715;57113;3161;64083;643226;54882;6897;56951;9232;100127206;9260;54819;4724;56099;64902;54622;10949;29930;635;153768;815;7025;100302736;408263;90441;83890;57451;133690;5097;63920;23305;662;65250;7045;91272;55299;10085;133584;1105;206358;170591;79668;821;4214;55568;84651;389337;23548;133558;497189;55255;22936;170690;3575;972;100462981;5122;64417;84340;51426;285704;5295;114825;167227;6569;56102;11174;51149;90355;54853;23061;3003;285596;56109;26223;23176;54491;153745;23291;11076;56130;202051;10016;57717;5145;26272;2241;94033;2559;1008;10827;2566;153478;79628;6880;56990;285598;7416;83734;85007;389333;54908;25836;56144;23517;23262;134218;643155;167359;56146;153527;4869;5924;54463;2324;56113;56142;10307;55781;2890;3156;91137;2255;1839;5459;9607;50805;3182;5144;51808;90624;134353;29102;23398;7903;1044;65056;153241;56106;134430;10723;51194;147;285590;116842;3565;3101;56124;56138;56107;9319;253260;6607;167465;4124;10923;65983;56111;22885;64374;651746;202243;79844;389289;10399;4131;91937;51397;10915;10146;6550;100130733;81789;27430;2870;2561;84327;84654;285600;166968;389257;51735;1010;3672;55374;56929;643394;10605;57507;23338;79685;84135;51306;10802;56128;337876;2196;10636;11082;317671;27166;9509;689;285671;6949;57472;9812;401190;3567;23379;3313;153443;4695;51720;153129;4726;9037;26112;26693;6389;11285;9765;57528;153572;8572;10826;475;3781;1161;92304;10409;100132916;8382;81555;153222;3950;133522;22993;285679;8974;728492;353376;9337;92181;345557;10622;64087;91368;154;3596;3659;51237;153562;133619;285613;646019;55789;1657;389320;345778;113829;25816;54514;79770;9499;2246;56129;56125;133957;54732;85409;29093;6507;2533;84105;57491;411;26025;2149;25929;134429;9782;26049;100996485;54974;55722;8637;83594;133923;51308;96459;79192;6558;51307;56122;56141;28965;9752;54439;153571;27125;53918;10087;3340;2741;84868;134285;6502;10960;902;79772;728637;900;2554;6228;340024;92270;79930;5019;5521;5917;202309;2568;8622;202052;4437;192286;3001;3572;153364;408187;100190949;55521;55814;94081;728340;55651;8878;3796;54888;389336;4762;57556;309,848
1,1,5,149372,7883578,7734206,84246;79192;81037;11336;65980;50805;153571;11044;64979;108;79888;10723;11076;23379;4726;10016;7015;6389;133957;9319;340024;348932;153478;153572;85409;79844;57491;4552;6550;170690;79072;6715;6531;54888;134111;55722;134121;389257,38
1,-1,5,167219,204849,37630,153478;389257,2
1,-1,5,220428,470621,250193,6389;10016;57491;11336,4
1,-1,5,220428,470621,250193,6389;10016;57491;11336,4
1,-1,5,234160,292679,58519,6389;10016,2
-1,-1,5,314910,496182,181272,57491;10016;6550;11336,4
1,-1,5,346277,404721,58444,57491,1
1,-1,5,369870,574895,205025,6550;57491;11336,3
1,-1,5,470562,496182,25620,6550,1
1,-1,5,554274,607624,53350,,0
1,-1,5,554274,607624,53350,,0
1,-1,5,560768,599121,38353,,0
1,-1,5,560768,599121,38353,,0
1,-1,5,560768,599121,38353,,0
1,-1,5,560768,667623,106855,11076;55722,2
-1,-1,5,574904,759228,184324,11076;55722,2
1,-1,5,629255,820616,191361,11076;79844;55722,3
1,-1,5,629255,820616,191361,11076;79844;55722,3
1,-1,5,629255,820616,191361,11076;79844;55722,3
1,-1,5,629255,820616,191361,11076;79844;55722,3
1,-1,5,629455,820475,191020,11076;79844;55722,3
-1,-1,5,629455,820475,191020,11076;79844;55722,3
1,-1,5,648152,820475,172323,11076;79844;55722,3
-1,-1,5,692881,773074,80193,11076,1
1,-1,5,692881,795774,102893,11076;79844,2
1,-1,5,710494,820475,109981,79844,1
1,-1,5,710494,820475,109981,79844,1
1,-1,5,710494,820475,109981,79844,1
1,-1,5,710494,820475,109981,79844,1
1,-1,5,710494,820475,109981,79844,1
-1,-1,5,710494,890017,179523,79844;65980,2
-1,-1,5,710494,890017,179523,79844;65980,2
1,-1,5,710524,795774,85250,79844,1
1,-1,5,759199,820446,61247,79844,1
-1,-1,5,795774,821908,26134,79844,1
1,-1,5,890085,1079592,189507,85409;65980;9319;10723,4
-1,-1,5,981535,1021681,40146,85409,1
-1,-1,5,1050550,1087475,36925,10723,1
1,1,5,1544400,8681553,7137153,84246;4726;79192;153572;50805;153571;4552;11044;64979;170690;79072;108;6715;134111;54888;23379;134121,17
1,-1,5,1556938,1755372,198434,,0
1,-1,5,2749039,2753361,4322,153571;153572,2
1,-1,5,2749039,2755084,6045,153571;153572,2
1,-1,5,2749039,2755084,6045,153571;153572,2
-1,1,5,2886277,7108408,4222131,11044;79192;170690;6715;134111;54888;23379;84246,8
1,1,5,3159498,30585683,27426185,84246;10299;54463;7204;1010;50834;79192;1007;134147;1501;56172;11044;54491;22948;23194;1016;108;23379;90441;1611;4651;9037;134145;56979;1008;651746;83853;4552;90268;170690;1767;79072;6715;441061;134111;54888;10409;134121,38
1,1,5,4849611,36818821,31969210,54463;10299;7204;50834;6897;55322;64902;4883;11044;133688;29102;23194;1004;108;167127;90441;133690;23037;202151;10923;55299;651746;83853;51151;6507;4552;153657;5618;170690;1767;441061;51663;90268;3575;5810;84246;134121;54545;92255;1010;1007;134147;1501;56172;133686;54491;22948;1016;51289;6502;23379;1611;4651;114899;9037;134145;1008;81792;23600;26064;79072;79925;6715;134111;54888;134218;10409;56979;64083,69
-1,1,5,4932820,18465470,13532650,84246;10299;54463;7204;50834;134147;1501;56172;11044;54491;22948;23194;108;23379;90441;1611;4651;9037;134145;651746;83853;4552;90268;170690;1767;79072;6715;441061;134111;54888;10409;134121,32
1,-1,5,7422161,7449338,27177,108,1
-1,1,5,7671046,13624106,5953060,134147;10299;1501;4552;9037;50834;134145;22948;134121;79072;108;651746;83853;1611,14
-1,1,5,7806183,31019599,23213416,54463;10299;9037;7204;1010;50834;134145;1008;4651;651746;1007;83853;134147;1501;56172;4552;54491;22948;23194;1016;1767;108;79072;441061;134121;90268;10409;56979;90441;1611,30
-1,1,5,8824418,14246208,5421790,134147;10299;1501;9037;7204;134145;50834;22948;1767;651746;83853;1611,12
-1,1,5,9120813,24274030,15153217,54463;10299;9037;7204;1010;1611;50834;134145;651746;83853;134147;1501;56172;54491;22948;23194;1016;1767;441061;90268;10409;56979;90441;4651,24
-1,1,5,9120813,24274030,15153217,54463;10299;9037;7204;1010;1611;50834;134145;651746;83853;134147;1501;56172;54491;22948;23194;1016;1767;441061;90268;10409;56979;90441;4651,24
1,1,5,10212992,16770583,6557591,54463;10299;7204;1611;134145;651746;83853;134147;1501;56172;54491;22948;1767;23194;441061;90268;90441;4651,18
-1,1,5,11815205,21494542,9679337,54463;1501;56172;7204;54491;1016;1767;23194;441061;90268;10409;90441;4651,13
-1,-1,5,12404457,12902472,498015,,0
-1,-1,5,12404457,12902472,498015,,0
-1,1,5,12572675,17966097,5393422,54463;56172;7204;54491;1767;23194;441061;90268;10409;90441;4651,11
1,-1,5,12820052,13030604,210552,,0
1,-1,5,13802308,14153561,351253,1767;7204,2
1,-1,5,13802308,14153561,351253,1767;7204,2
1,-1,5,13802308,14153561,351253,1767;7204,2
1,-1,5,13802308,14153561,351253,1767;7204,2
1,-1,5,13830669,14153561,322892,1767;7204,2
1,-1,5,13830669,14153561,322892,1767;7204,2
1,-1,5,13830669,14153561,322892,1767;7204,2
1,-1,5,13830669,14190872,360203,1767;7204,2
1,-1,5,13847044,14246208,399164,1767;7204,2
-1,1,5,17628741,176575720,158946979,5159;645121;93166;4338;10769;56127;133746;55322;5813;56101;3308;3074;153339;167127;30012;84321;9604;3673;26262;10468;3593;23286;133874;10007;56121;1809;56923;1022;6500;4488;153201;134549;55100;117156;55914;10814;8817;642987;401207;4015;6620;28966;51301;2297;6167;493869;10788;6606;285668;4238;9421;27039;23197;1016;100505841;23438;2151;345651;8988;84250;10112;57561;1812;23105;3550;133491;23440;51128;81792;9443;56143;26064;80315;91942;23530;2966;134288;3035;404203;133383;11063;101928448;89848;78991;375444;114787;51752;64283;9555;2908;83989;51014;101928093;100861519;3779;492311;112574;285643;79810;4883;116068;133688;134266;1879;27292;6208;5921;56132;814;6414;324;85027;348980;6879;256987;10309;100131897;140890;64411;84466;56123;353189;5480;285601;23092;57222;64839;51663;22836;5884;375449;3977;56126;153643;56103;54492;134265;9708;285605;91977;9627;56139;1007;2745;1462;9315;7690;56477;51617;51289;83942;3578;202333;6728;1437;1836;11005;114899;79722;23567;23635;26999;2201;10011;1393;134553;3562;4163;64105;51265;26167;8293;8992;345643;133482;51247;56140;57824;613212;2661;85480;929;56134;256006;4090;7322;51491;345757;26762;6586;167555;1601;51121;134391;729;1004;153830;84059;51780;1436;51523;134510;6583;23120;10569;6534;8641;51151;83697;81848;100129792;56145;56114;167153;57688;5066;2668;171019;10111;5307;5734;9652;140947;1350;7320;819;133686;56104;2299;115123;26045;84240;10902;1160;56110;6444;7478;5229;23367;285636;64167;1452;5098;285588;64901;10318;114898;153328;166979;56131;56097;1843;2690;54505;1719;831;206338;115548;79925;10184;2172;64324;8614;167410;7518;115827;891;340075;348938;153769;9685;8546;55696;1729;404734;64924;64848;134187;51294;64946;79616;728780;56137;57179;56136;2107;10412;80762;9140;1495;23037;79646;340120;9456;64097;8697;84418;81545;730;153657;641700;11127;3360;10283;4001;27190;7905;2760;9879;153642;8841;5810;133418;3937;2878;92255;5201;735;1946;134548;2676;202134;1176;345611;56135;1958;8611;3295;57763;56133;1482;9180;340061;153396;153733;79993;2264;3094;56147;9832;51015;6643;153218;134492;100506658;92259;56979;2150;995;22838;1404;80006;347732;51164;285672;29958;644100;6902;30820;56100;3350;7265;9522;51334;84249;375484;10884;9867;3274;3842;54825;9631;90249;133396;644994;6584;23743;22987;54557;6690;202151;134359;153770;23107;373863;83884;5562;202374;57486;9542;56105;8728;9963;4012;373;1794;55109;6695;5618;6678;26249;285641;1070;84674;54545;6932;6793;253314;3702;501;56112;134526;4208;5515;728586;1212;3670;27089;102157402;56098;54826;51520;9547;4064;11346;23600;4671;1036;340069;56108;91975;8507;1456;3157;7060;57113;3161;64083;643226;54882;6897;56951;9232;100127206;54819;4724;56099;64902;54622;10949;29930;635;153768;815;7025;100302736;408263;83890;57451;133690;5097;63920;23305;662;65250;7045;91272;55299;10085;133584;1105;206358;170591;79668;4214;55568;84651;389337;23548;133558;497189;55255;22936;3575;972;100462981;5122;64417;84340;51426;285704;5295;114825;167227;56102;11174;90355;54853;3003;56109;26223;23176;153745;23291;56130;202051;57717;2566;5145;26272;2241;94033;2559;1008;10827;79628;6880;56990;285598;7416;83734;389333;54908;25836;56144;23517;23262;134218;643155;167359;56146;153527;4869;5924;56113;56142;10307;55781;2890;3156;91137;2255;1839;5459;9607;5144;51808;90624;134353;29102;23398;7903;1044;65056;153241;56106;134430;51194;147;285590;116842;3565;3101;56124;56138;56107;65983;253260;6607;167465;4124;10923;22885;56111;64374;202243;389289;4131;91937;51397;10915;10146;100130733;81789;27430;2561;84327;84654;285600;166968;51735;1010;3672;55374;56929;643394;10605;57507;23338;79685;84135;51306;10802;56128;337876;2196;11082;317671;689;285671;6949;9812;401190;3567;3313;4695;153443;51720;153129;26112;9765;57528;8572;10826;475;3781;1161;100132916;8382;81555;153222;3950;133522;22993;8974;728492;353376;9337;92181;345557;10622;64087;91368;154;3596;3659;51237;153562;133619;285613;55789;1657;389320;345778;113829;25816;54514;79770;9499;2246;56129;56125;29093;6507;2533;84105;411;26025;2149;25929;134429;9782;26049;100996485;54974;8637;83594;133923;51308;96459;6558;51307;56122;56141;28965;9752;54439;27125;53918;10087;3340;2741;84868;134285;6502;902;79772;728637;900;2554;6228;92270;5019;5521;5917;202309;2568;8622;202052;4437;192286;3001;3572;153364;408187;100190949;55521;55814;94081;728340;3796;389336;4762;57556;309,725
-1,-1,5,18379231,26804015,8424784,1010;56979;1008;1016,4
-1,-1,5,20474748,20674100,199352,1016,1
-1,-1,5,20474748,20711990,237242,1016,1
1,-1,5,21288794,21377276,88482,,0
1,-1,5,21288794,21377276,88482,,0
1,-1,5,21288794,21377276,88482,,0
1,-1,5,21351834,21377276,25442,,0
-1,-1,5,21402939,21527562,124623,,0
1,-1,5,21527621,21726410,198789,,0
-1,-1,5,21872141,22156646,284505,1010,1
1,1,5,25801684,27125454,1323770,1007,1
1,1,5,31208860,32173350,964490,55322;1004;23037;29102;64083,5
1,-1,5,32110734,32149723,38989,23037;64083,2
1,-1,5,32110734,32149723,38989,23037;64083,2
1,-1,5,32110734,32149723,38989,23037;64083,2
1,-1,5,32110734,32149723,38989,23037;64083,2
-1,-1,5,33120488,33282372,161884,,0
1,1,5,35201661,61198968,25997307,115827;4338;10769;167359;1601;100861519;345557;4724;2255;54622;112574;5144;133688;729;10884;65056;167127;55789;9631;3673;133396;54514;10468;133690;202151;6414;348980;253260;5562;65250;10309;133584;389289;79668;730;4214;6507;2533;23548;133558;100129792;5618;55100;166968;3575;84674;133418;57688;3977;92255;64417;735;2668;3672;10605;5734;6167;8611;493869;11082;3003;133686;7690;285668;53918;3670;56477;345651;9180;8988;6502;153129;79722;26272;79993;285636;5019;202309;166979;91942;23530;3001;2690;54505;3572;133383;3157;101928448;1161;345643;79925;25836;375444;23517;643155,95
-1,1,5,36916860,36960223,43363,25836,1
-1,1,5,36916860,36960224,43364,25836,1
-1,1,5,36926004,37242249,316245,65250;25836,2
-1,1,5,41902086,42896162,994076,2690;6414;100129792;26272;285636,5
-1,-1,5,42804840,43067088,262248,389289;6414,2
-1,-1,5,45858833,45880709,21876,,0
-1,-1,5,45858833,45880709,21876,,0
-1,-1,5,45858833,45880709,21876,,0
1,-1,5,45935369,46055437,120068,,0
-1,-1,5,53092696,53284566,191870,54622,1
1,1,5,56243677,61021228,4777551,91942;57688;5144;115827;285668;10769;79993;1161;65056;345651;55789;166968;202309;643155,14
-1,-1,5,58962510,59388525,426015,5144,1
-1,1,5,59794904,63223610,3428706,91942;57688;51194;285668;79993;100130733;1161;27292;55789;3796;643155,11
-1,1,5,59794904,63223610,3428706,91942;57688;51194;285668;79993;100130733;1161;27292;55789;3796;643155,11
-1,1,5,60180775,60428760,247985,91942;1161,2
-1,1,5,60722469,70792199,10069730,57688;80006;891;728492;92259;285672;5295;11174;64924;3350;6606;285668;23398;285671;64946;153562;102157402;27292;51194;401190;54557;6607;4064;57486;202243;140890;373;4671;64105;6880;2966;1022;8293;100130733;55814;728340;10283;3796;55914;100506658;100132916;5884;375449,43
-1,-1,5,63640694,63666372,25678,285671,1
-1,-1,5,68791270,70328742,1537472,6607;6606;100506658;8293;728492;4671;728340,7
-1,-1,5,68828320,69170815,342495,100506658;728340,2
-1,-1,5,68828320,70647478,1819158,2966;6606;8293;728492;728340;6607;100506658;4671,8
-1,-1,5,68828320,70647478,1819158,2966;6606;8293;728492;728340;6607;100506658;4671,8
-1,-1,5,68849603,69170815,321212,100506658;728340,2
1,-1,5,68935901,69691667,755766,6607;728492,2
-1,-1,5,68849603,69691667,842064,100506658;6607;728340;728492,4
1,-1,5,68935901,69866583,930682,6607;728492,2
1,-1,5,68935901,69866583,930682,6607;728492,2
1,-1,5,68935901,70079377,1143476,6607;728492,2
1,-1,5,68935901,70079377,1143476,6607;728492,2
1,-1,5,68935901,70316732,1380831,6607;6606;8293;728492;4671,5
1,-1,5,68935901,70316732,1380831,6607;6606;8293;728492;4671,5
1,-1,5,68935901,70316732,1380831,6607;6606;8293;728492;4671,5
1,-1,5,68849603,70471774,1622171,2966;6606;8293;728492;728340;6607;100506658;4671,8
-1,-1,5,68849603,70489434,1639831,2966;6606;8293;728492;728340;6607;100506658;4671,8
1,-1,5,68935901,70498111,1562210,6607;2966;6606;8293;728492;4671,6
1,-1,5,68935901,70498111,1562210,6607;2966;6606;8293;728492;4671,6
1,-1,5,68935901,70498111,1562210,6607;2966;6606;8293;728492;4671,6
1,-1,5,68935901,70498111,1562210,6607;2966;6606;8293;728492;4671,6
1,-1,5,68935901,70498111,1562210,6607;2966;6606;8293;728492;4671,6
1,-1,5,68935901,70498111,1562210,6607;2966;6606;8293;728492;4671,6
1,-1,5,68935901,70498111,1562210,6607;2966;6606;8293;728492;4671,6
1,-1,5,68935901,70498111,1562210,6607;2966;6606;8293;728492;4671,6
1,-1,5,68935901,70498111,1562210,6607;2966;6606;8293;728492;4671,6
1,-1,5,68935901,70498111,1562210,6607;2966;6606;8293;728492;4671,6
1,-1,5,68935901,70498111,1562210,6607;2966;6606;8293;728492;4671,6
1,-1,5,68935901,70498111,1562210,6607;2966;6606;8293;728492;4671,6
1,-1,5,68935901,70498111,1562210,6607;2966;6606;8293;728492;4671,6
1,-1,5,68935901,70498111,1562210,6607;2966;6606;8293;728492;4671,6
1,-1,5,68935901,70498111,1562210,6607;2966;6606;8293;728492;4671,6
1,-1,5,68935901,70498111,1562210,6607;2966;6606;8293;728492;4671,6
1,-1,5,68935901,70498111,1562210,6607;2966;6606;8293;728492;4671,6
1,-1,5,68935901,70498111,1562210,6607;2966;6606;8293;728492;4671,6
1,-1,5,68935901,70498111,1562210,6607;2966;6606;8293;728492;4671,6
1,-1,5,68935901,70498111,1562210,6607;2966;6606;8293;728492;4671,6
1,-1,5,68935901,70498111,1562210,6607;2966;6606;8293;728492;4671,6
1,-1,5,68935901,70498111,1562210,6607;2966;6606;8293;728492;4671,6
1,-1,5,68935901,70498111,1562210,6607;2966;6606;8293;728492;4671,6
1,-1,5,68935901,70498111,1562210,6607;2966;6606;8293;728492;4671,6
1,-1,5,68935901,70498111,1562210,6607;2966;6606;8293;728492;4671,6
1,-1,5,68935901,70498111,1562210,6607;2966;6606;8293;728492;4671,6
1,-1,5,68935901,70498111,1562210,6607;2966;6606;8293;728492;4671,6
1,-1,5,68935901,70498111,1562210,6607;2966;6606;8293;728492;4671,6
1,-1,5,68935901,70498111,1562210,6607;2966;6606;8293;728492;4671,6
1,-1,5,68935901,70498111,1562210,6607;2966;6606;8293;728492;4671,6
1,-1,5,68935901,70498111,1562210,6607;2966;6606;8293;728492;4671,6
1,-1,5,68935901,70498111,1562210,6607;2966;6606;8293;728492;4671,6
1,-1,5,68935901,70498111,1562210,6607;2966;6606;8293;728492;4671,6
1,-1,5,68935901,70498111,1562210,6607;2966;6606;8293;728492;4671,6
1,-1,5,68935901,70498111,1562210,6607;2966;6606;8293;728492;4671,6
1,-1,5,68935901,70498111,1562210,6607;2966;6606;8293;728492;4671,6
1,-1,5,68935901,70498111,1562210,6607;2966;6606;8293;728492;4671,6
1,-1,5,68935901,70498111,1562210,6607;2966;6606;8293;728492;4671,6
1,-1,5,68935901,70498111,1562210,6607;2966;6606;8293;728492;4671,6
1,-1,5,68935901,70498111,1562210,6607;2966;6606;8293;728492;4671,6
1,-1,5,68935901,70498111,1562210,6607;2966;6606;8293;728492;4671,6
1,-1,5,68935901,70498111,1562210,6607;2966;6606;8293;728492;4671,6
1,-1,5,68935901,70498111,1562210,6607;2966;6606;8293;728492;4671,6
1,-1,5,68935901,70498111,1562210,6607;2966;6606;8293;728492;4671,6
1,-1,5,68935901,70498111,1562210,6607;2966;6606;8293;728492;4671,6
1,-1,5,68935901,70498111,1562210,6607;2966;6606;8293;728492;4671,6
1,-1,5,68935901,70498111,1562210,6607;2966;6606;8293;728492;4671,6
1,-1,5,68935901,70498111,1562210,6607;2966;6606;8293;728492;4671,6
1,-1,5,68935901,70498111,1562210,6607;2966;6606;8293;728492;4671,6
1,-1,5,68935901,70498111,1562210,6607;2966;6606;8293;728492;4671,6
1,-1,5,68935901,70498111,1562210,6607;2966;6606;8293;728492;4671,6
1,-1,5,68935901,70498111,1562210,6607;2966;6606;8293;728492;4671,6
1,-1,5,68935901,70498111,1562210,6607;2966;6606;8293;728492;4671,6
1,-1,5,68935901,70498111,1562210,6607;2966;6606;8293;728492;4671,6
1,-1,5,68935901,70498111,1562210,6607;2966;6606;8293;728492;4671,6
1,-1,5,68935901,70498111,1562210,6607;2966;6606;8293;728492;4671,6
1,-1,5,68935901,70498111,1562210,6607;2966;6606;8293;728492;4671,6
1,-1,5,68935901,70498111,1562210,6607;2966;6606;8293;728492;4671,6
1,-1,5,68935901,70498111,1562210,6607;2966;6606;8293;728492;4671,6
1,-1,5,68935901,70498111,1562210,6607;2966;6606;8293;728492;4671,6
1,-1,5,68935901,70498111,1562210,6607;2966;6606;8293;728492;4671,6
1,-1,5,68935901,70498111,1562210,6607;2966;6606;8293;728492;4671,6
1,-1,5,68935901,70498111,1562210,6607;2966;6606;8293;728492;4671,6
1,-1,5,68935901,70498111,1562210,6607;2966;6606;8293;728492;4671,6
1,-1,5,68935901,70498111,1562210,6607;2966;6606;8293;728492;4671,6
1,-1,5,68935901,70498111,1562210,6607;2966;6606;8293;728492;4671,6
1,-1,5,68935901,70498111,1562210,6607;2966;6606;8293;728492;4671,6
1,-1,5,68935901,70498111,1562210,6607;2966;6606;8293;728492;4671,6
1,-1,5,68935901,70498111,1562210,6607;2966;6606;8293;728492;4671,6
1,-1,5,68935901,70498111,1562210,6607;2966;6606;8293;728492;4671,6
1,-1,5,68935901,70498111,1562210,6607;2966;6606;8293;728492;4671,6
1,-1,5,68935901,70498111,1562210,6607;2966;6606;8293;728492;4671,6
1,-1,5,68935901,70498111,1562210,6607;2966;6606;8293;728492;4671,6
1,-1,5,68935901,70498111,1562210,6607;2966;6606;8293;728492;4671,6
1,-1,5,68935901,70498111,1562210,6607;2966;6606;8293;728492;4671,6
1,-1,5,68935901,70498111,1562210,6607;2966;6606;8293;728492;4671,6
1,-1,5,68935901,70498111,1562210,6607;2966;6606;8293;728492;4671,6
1,-1,5,68935901,70498111,1562210,6607;2966;6606;8293;728492;4671,6
1,-1,5,68935901,70498111,1562210,6607;2966;6606;8293;728492;4671,6
1,-1,5,68935901,70498111,1562210,6607;2966;6606;8293;728492;4671,6
1,-1,5,68935901,70498111,1562210,6607;2966;6606;8293;728492;4671,6
1,-1,5,68849603,70613325,1763722,2966;6606;8293;728492;728340;6607;100506658;4671,8
1,-1,5,68849603,70643196,1793593,2966;6606;8293;728492;728340;6607;100506658;4671,8
-1,-1,5,68849603,70647478,1797875,2966;6606;8293;728492;728340;6607;100506658;4671,8
1,-1,5,68849603,70647478,1797875,2966;6606;8293;728492;728340;6607;100506658;4671,8
-1,-1,5,68849603,70647478,1797875,2966;6606;8293;728492;728340;6607;100506658;4671,8
1,-1,5,68849603,70647478,1797875,2966;6606;8293;728492;728340;6607;100506658;4671,8
-1,-1,5,68849603,70647478,1797875,2966;6606;8293;728492;728340;6607;100506658;4671,8
1,-1,5,68849603,70647478,1797875,2966;6606;8293;728492;728340;6607;100506658;4671,8
-1,-1,5,68849603,70647478,1797875,2966;6606;8293;728492;728340;6607;100506658;4671,8
1,-1,5,68849603,70647478,1797875,2966;6606;8293;728492;728340;6607;100506658;4671,8
1,-1,5,68849603,70647478,1797875,2966;6606;8293;728492;728340;6607;100506658;4671,8
-1,-1,5,68849603,70647478,1797875,2966;6606;8293;728492;728340;6607;100506658;4671,8
-1,-1,5,68849603,70647478,1797875,2966;6606;8293;728492;728340;6607;100506658;4671,8
-1,-1,5,68849603,70647478,1797875,2966;6606;8293;728492;728340;6607;100506658;4671,8
1,-1,5,68849603,70647478,1797875,2966;6606;8293;728492;728340;6607;100506658;4671,8
1,-1,5,68849603,70647478,1797875,2966;6606;8293;728492;728340;6607;100506658;4671,8
1,-1,5,68849603,70647478,1797875,2966;6606;8293;728492;728340;6607;100506658;4671,8
1,-1,5,68849603,70657769,1808166,2966;6606;8293;728492;728340;6607;100506658;4671,8
1,-1,5,68849603,70657769,1808166,2966;6606;8293;728492;728340;6607;100506658;4671,8
1,-1,5,68849603,70657769,1808166,2966;6606;8293;728492;728340;6607;100506658;4671,8
1,-1,5,68849603,70657769,1808166,2966;6606;8293;728492;728340;6607;100506658;4671,8
1,-1,5,68849603,70657769,1808166,2966;6606;8293;728492;728340;6607;100506658;4671,8
1,-1,5,68849603,70657769,1808166,2966;6606;8293;728492;728340;6607;100506658;4671,8
1,-1,5,68849603,70657769,1808166,2966;6606;8293;728492;728340;6607;100506658;4671,8
1,-1,5,68849603,70657769,1808166,2966;6606;8293;728492;728340;6607;100506658;4671,8
1,-1,5,68849603,70657769,1808166,2966;6606;8293;728492;728340;6607;100506658;4671,8
1,-1,5,68849603,70657769,1808166,2966;6606;8293;728492;728340;6607;100506658;4671,8
-1,-1,5,68849603,70613325,1763722,2966;6606;8293;728492;728340;6607;100506658;4671,8
-1,-1,5,68864176,70647478,1783302,6607;2966;6606;8293;728492;4671;728340,7
1,-1,5,68864176,70647478,1783302,6607;2966;6606;8293;728492;4671;728340,7
1,-1,5,68864176,70647478,1783302,6607;2966;6606;8293;728492;4671;728340,7
-1,-1,5,68864176,70647478,1783302,6607;2966;6606;8293;728492;4671;728340,7
1,-1,5,68864176,70647478,1783302,6607;2966;6606;8293;728492;4671;728340,7
1,-1,5,68864176,70647478,1783302,6607;2966;6606;8293;728492;4671;728340,7
1,-1,5,68864176,70657769,1793593,6607;2966;6606;8293;728492;4671;728340,7
1,-1,5,68864176,70657769,1793593,6607;2966;6606;8293;728492;4671;728340,7
1,-1,5,68864176,70657769,1793593,6607;2966;6606;8293;728492;4671;728340,7
1,-1,5,68864176,70657769,1793593,6607;2966;6606;8293;728492;4671;728340,7
1,-1,5,68864176,70657769,1793593,6607;2966;6606;8293;728492;4671;728340,7
1,-1,5,68864176,70657769,1793593,6607;2966;6606;8293;728492;4671;728340,7
1,-1,5,68864176,70657769,1793593,6607;2966;6606;8293;728492;4671;728340,7
1,-1,5,68878234,70657769,1779535,6607;2966;6606;8293;728492;4671;728340,7
1,-1,5,68878234,70657769,1779535,6607;2966;6606;8293;728492;4671;728340,7
1,-1,5,68878234,70657769,1779535,6607;2966;6606;8293;728492;4671;728340,7
1,-1,5,68878234,70657769,1779535,6607;2966;6606;8293;728492;4671;728340,7
1,-1,5,68878234,70657769,1779535,6607;2966;6606;8293;728492;4671;728340,7
1,-1,5,68878234,70657769,1779535,6607;2966;6606;8293;728492;4671;728340,7
1,-1,5,68878234,70657769,1779535,6607;2966;6606;8293;728492;4671;728340,7
1,-1,5,68890454,70134637,1244183,6607;728492,2
1,-1,5,68890454,70657769,1767315,6607;2966;6606;8293;728492;4671,6
1,-1,5,68890454,70657769,1767315,6607;2966;6606;8293;728492;4671,6
1,-1,5,68902781,69691667,788886,6607;728492,2
1,-1,5,68902781,69705635,802854,6607;728492,2
1,-1,5,68902781,70134637,1231856,6607;728492,2
1,-1,5,68902781,70643196,1740415,6607;2966;6606;8293;728492;4671,6
1,-1,5,68902781,70647478,1744697,6607;2966;6606;8293;728492;4671,6
1,-1,5,68902781,70647478,1744697,6607;2966;6606;8293;728492;4671,6
1,-1,5,68914355,69691667,777312,6607;728492,2
1,-1,5,68914355,69691667,777312,6607;728492,2
1,-1,5,68914355,69705635,791280,6607;728492,2
1,-1,5,68914355,69705635,791280,6607;728492,2
1,-1,5,68914355,70134637,1220282,6607;728492,2
1,-1,5,68914355,70209495,1295140,6607;8293;728492,3
1,-1,5,68914355,70268219,1353864,6607;6606;8293;728492;4671,5
-1,-1,5,68914355,70280668,1366313,6607;6606;8293;728492;4671,5
1,-1,5,68914355,70316732,1402377,6607;6606;8293;728492;4671,5
1,-1,5,68914355,70657769,1743414,6607;2966;6606;8293;728492;4671,6
1,-1,5,68914355,70657769,1743414,6607;2966;6606;8293;728492;4671,6
1,-1,5,68935901,70268219,1332318,6607;6606;8293;728492;4671,5
-1,-1,5,68935930,70613129,1677199,6607;2966;6606;8293;728492;4671,6
-1,-1,5,68935930,70613129,1677199,6607;2966;6606;8293;728492;4671,6
-1,-1,5,68935930,70613129,1677199,6607;2966;6606;8293;728492;4671,6
-1,-1,5,68935930,70613129,1677199,6607;2966;6606;8293;728492;4671,6
1,-1,5,69079437,69866583,787146,6607;728492,2
1,-1,5,69079437,69866583,787146,6607;728492,2
1,-1,5,69079437,69866583,787146,6607;728492,2
1,-1,5,69079437,69866583,787146,6607;728492,2
1,-1,5,69079437,69866583,787146,6607;728492,2
1,-1,5,69079437,69866583,787146,6607;728492,2
1,-1,5,69079437,69866583,787146,6607;728492,2
1,-1,5,69079437,69866583,787146,6607;728492,2
1,-1,5,69079437,69866583,787146,6607;728492,2
-1,-1,5,69079437,69866583,787146,6607;728492,2
1,-1,5,69079437,69866583,787146,6607;728492,2
1,-1,5,69079437,69866583,787146,6607;728492,2
1,-1,5,69079437,69866583,787146,6607;728492,2
1,-1,5,69079437,69866583,787146,6607;728492,2
1,-1,5,69079437,69866583,787146,6607;728492,2
1,-1,5,69079437,69866583,787146,6607;728492,2
1,-1,5,69079437,69866583,787146,6607;728492,2
1,-1,5,69079437,69866583,787146,6607;728492,2
-1,-1,5,69079437,69866583,787146,6607;728492,2
-1,-1,5,69079437,69866583,787146,6607;728492,2
1,-1,5,69079437,69866583,787146,6607;728492,2
1,-1,5,69079437,69866583,787146,6607;728492,2
1,-1,5,69079437,69866583,787146,6607;728492,2
-1,-1,5,69079437,69866583,787146,6607;728492,2
1,-1,5,69079437,69866583,787146,6607;728492,2
1,-1,5,69079437,69866583,787146,6607;728492,2
1,-1,5,69079437,69866583,787146,6607;728492,2
1,-1,5,69079437,69866583,787146,6607;728492,2
1,-1,5,69079437,69866583,787146,6607;728492,2
1,-1,5,69079437,69866583,787146,6607;728492,2
-1,-1,5,69079437,69866583,787146,6607;728492,2
1,-1,5,69079437,69866583,787146,6607;728492,2
1,-1,5,69079437,69866583,787146,6607;728492,2
1,-1,5,69079437,69866583,787146,6607;728492,2
1,-1,5,69079437,69866583,787146,6607;728492,2
1,-1,5,69079437,70079377,999940,6607;728492,2
1,-1,5,69079437,70316732,1237295,6607;6606;8293;728492;4671,5
1,-1,5,69079437,70316732,1237295,6607;6606;8293;728492;4671,5
1,-1,5,69079437,70316732,1237295,6607;6606;8293;728492;4671,5
1,-1,5,69079437,70316732,1237295,6607;6606;8293;728492;4671,5
1,-1,5,69079437,70316732,1237295,6607;6606;8293;728492;4671,5
1,-1,5,69079437,70316732,1237295,6607;6606;8293;728492;4671,5
1,-1,5,69079437,70316732,1237295,6607;6606;8293;728492;4671,5
1,-1,5,69079437,70316732,1237295,6607;6606;8293;728492;4671,5
1,-1,5,69079437,70316732,1237295,6607;6606;8293;728492;4671,5
1,-1,5,69079437,70316732,1237295,6607;6606;8293;728492;4671,5
1,-1,5,69079437,70316732,1237295,6607;6606;8293;728492;4671,5
1,-1,5,69079437,70316732,1237295,6607;6606;8293;728492;4671,5
1,-1,5,69079437,70316732,1237295,6607;6606;8293;728492;4671,5
1,-1,5,69079437,70316732,1237295,6607;6606;8293;728492;4671,5
1,-1,5,69079437,70316732,1237295,6607;6606;8293;728492;4671,5
1,-1,5,69079437,70498111,1418674,6607;2966;6606;8293;728492;4671,6
1,-1,5,69079437,70498111,1418674,6607;2966;6606;8293;728492;4671,6
1,-1,5,69079437,70498111,1418674,6607;2966;6606;8293;728492;4671,6
1,-1,5,69079437,70498111,1418674,6607;2966;6606;8293;728492;4671,6
-1,-1,5,69079437,70498111,1418674,6607;2966;6606;8293;728492;4671,6
1,-1,5,69079437,70498111,1418674,6607;2966;6606;8293;728492;4671,6
1,-1,5,69079437,70498111,1418674,6607;2966;6606;8293;728492;4671,6
1,-1,5,69079437,70498111,1418674,6607;2966;6606;8293;728492;4671,6
1,-1,5,68975303,70046728,1071425,6607;728492,2
1,-1,5,68975303,70134637,1159334,6607;728492,2
-1,-1,5,68975303,70647478,1672175,6607;2966;6606;8293;728492;4671,6
1,-1,5,68975303,70657769,1682466,6607;2966;6606;8293;728492;4671,6
1,-1,5,68975303,70657769,1682466,6607;2966;6606;8293;728492;4671,6
1,-1,5,68975303,70657769,1682466,6607;2966;6606;8293;728492;4671,6
1,-1,5,68975303,70657769,1682466,6607;2966;6606;8293;728492;4671,6
1,-1,5,68975309,70489473,1514164,6607;2966;6606;8293;728492;4671,6
-1,-1,5,68975309,70613129,1637820,6607;2966;6606;8293;728492;4671,6
-1,-1,5,68975309,70613129,1637820,6607;2966;6606;8293;728492;4671,6
-1,-1,5,68975309,70613129,1637820,6607;2966;6606;8293;728492;4671,6
-1,-1,5,69204240,69515709,311469,6607;728492,2
-1,-1,5,69220692,69439654,218962,6607;728492,2
-1,-1,5,69220692,69463214,242522,6607;728492,2
-1,-1,5,69220692,69463214,242522,6607;728492,2
-1,-1,5,69220692,69463214,242522,6607;728492,2
-1,-1,5,69220692,69463214,242522,6607;728492,2
-1,-1,5,69220692,69463214,242522,6607;728492,2
-1,-1,5,69220692,69463214,242522,6607;728492,2
-1,-1,5,69220692,69483792,263100,6607;728492,2
-1,-1,5,69220692,69463228,242536,6607;728492,2
-1,-1,5,69238677,70247802,1009125,6607;8293;728492;6606,4
-1,-1,5,69238677,70247802,1009125,6607;8293;728492;6606,4
-1,-1,5,69238677,70247802,1009125,6607;8293;728492;6606,4
1,-1,5,69238677,70247802,1009125,6607;8293;728492;6606,4
-1,-1,5,69238677,70247802,1009125,6607;8293;728492;6606,4
-1,-1,5,69238677,70328742,1090065,6607;6606;8293;728492;4671,5
-1,-1,5,69238677,70328742,1090065,6607;6606;8293;728492;4671,5
1,-1,5,69238677,70328742,1090065,6607;6606;8293;728492;4671,5
-1,-1,5,69238677,70386600,1147923,6607;2966;6606;8293;728492;4671,6
-1,-1,5,69238677,70386600,1147923,6607;2966;6606;8293;728492;4671,6
1,-1,5,69238677,70386600,1147923,6607;2966;6606;8293;728492;4671,6
-1,-1,5,69238677,70386600,1147923,6607;2966;6606;8293;728492;4671,6
-1,-1,5,69238677,70386600,1147923,6607;2966;6606;8293;728492;4671,6
1,-1,5,69238677,70386600,1147923,6607;2966;6606;8293;728492;4671,6
-1,-1,5,69238677,70587018,1348341,6607;2966;6606;8293;728492;4671,6
-1,-1,5,69238677,70587018,1348341,6607;2966;6606;8293;728492;4671,6
-1,-1,5,69238677,70587018,1348341,6607;2966;6606;8293;728492;4671,6
-1,-1,5,69238677,70587018,1348341,6607;2966;6606;8293;728492;4671,6
1,-1,5,69238677,70587018,1348341,6607;2966;6606;8293;728492;4671,6
-1,-1,5,69238677,70587018,1348341,6607;2966;6606;8293;728492;4671,6
-1,-1,5,69238677,70587018,1348341,6607;2966;6606;8293;728492;4671,6
-1,-1,5,69238677,70587018,1348341,6607;2966;6606;8293;728492;4671,6
-1,-1,5,69238677,70587018,1348341,6607;2966;6606;8293;728492;4671,6
-1,-1,5,69238677,70587018,1348341,6607;2966;6606;8293;728492;4671,6
-1,-1,5,69238677,70587018,1348341,6607;2966;6606;8293;728492;4671,6
-1,-1,5,69238677,70587018,1348341,6607;2966;6606;8293;728492;4671,6
-1,-1,5,69238677,70587018,1348341,6607;2966;6606;8293;728492;4671,6
-1,-1,5,69238677,70587018,1348341,6607;2966;6606;8293;728492;4671,6
-1,-1,5,69238677,70587018,1348341,6607;2966;6606;8293;728492;4671,6
-1,-1,5,69238677,70587018,1348341,6607;2966;6606;8293;728492;4671,6
-1,-1,5,69238677,70587018,1348341,6607;2966;6606;8293;728492;4671,6
-1,-1,5,69238677,70587018,1348341,6607;2966;6606;8293;728492;4671,6
-1,-1,5,69238689,69483826,245137,6607;728492,2
1,-1,5,69238689,69925315,686626,6607;728492,2
-1,-1,5,69238689,70247828,1009139,6607;8293;728492;6606,4
-1,-1,5,69238689,70247828,1009139,6607;8293;728492;6606,4
-1,-1,5,69238689,70328742,1090053,6607;6606;8293;728492;4671,5
1,-1,5,69238689,70328742,1090053,6607;6606;8293;728492;4671,5
-1,-1,5,69238689,70328742,1090053,6607;6606;8293;728492;4671,5
-1,-1,5,69238689,70328742,1090053,6607;6606;8293;728492;4671,5
-1,-1,5,69238689,70328742,1090053,6607;6606;8293;728492;4671,5
-1,-1,5,69238689,70328742,1090053,6607;6606;8293;728492;4671,5
-1,-1,5,69238689,70328742,1090053,6607;6606;8293;728492;4671,5
1,-1,5,69238689,70328742,1090053,6607;6606;8293;728492;4671,5
-1,-1,5,69238689,70328742,1090053,6607;6606;8293;728492;4671,5
1,-1,5,69238689,70328742,1090053,6607;6606;8293;728492;4671,5
-1,-1,5,69238689,70328742,1090053,6607;6606;8293;728492;4671,5
1,-1,5,69238689,70328742,1090053,6607;6606;8293;728492;4671,5
-1,-1,5,69238689,70328742,1090053,6607;6606;8293;728492;4671,5
-1,-1,5,69238689,70328742,1090053,6607;6606;8293;728492;4671,5
1,-1,5,69238689,70328742,1090053,6607;6606;8293;728492;4671,5
1,-1,5,69238689,70386594,1147905,6607;2966;6606;8293;728492;4671,6
1,-1,5,69238689,70386594,1147905,6607;2966;6606;8293;728492;4671,6
1,-1,5,69238689,70386594,1147905,6607;2966;6606;8293;728492;4671,6
1,-1,5,69238689,70386594,1147905,6607;2966;6606;8293;728492;4671,6
-1,-1,5,69238689,70386594,1147905,6607;2966;6606;8293;728492;4671,6
1,-1,5,69238689,70386594,1147905,6607;2966;6606;8293;728492;4671,6
1,-1,5,69238689,70386594,1147905,6607;2966;6606;8293;728492;4671,6
1,-1,5,69238689,70386594,1147905,6607;2966;6606;8293;728492;4671,6
1,-1,5,69238689,70386594,1147905,6607;2966;6606;8293;728492;4671,6
1,-1,5,69238689,70386594,1147905,6607;2966;6606;8293;728492;4671,6
-1,-1,5,69238689,70386594,1147905,6607;2966;6606;8293;728492;4671,6
-1,-1,5,69238689,70587019,1348330,6607;2966;6606;8293;728492;4671,6
-1,-1,5,69238689,70587019,1348330,6607;2966;6606;8293;728492;4671,6
-1,-1,5,69238689,70587019,1348330,6607;2966;6606;8293;728492;4671,6
1,-1,5,69238689,70587019,1348330,6607;2966;6606;8293;728492;4671,6
-1,-1,5,69238689,70587019,1348330,6607;2966;6606;8293;728492;4671,6
-1,-1,5,69238689,70587019,1348330,6607;2966;6606;8293;728492;4671,6
1,-1,5,69238689,70587019,1348330,6607;2966;6606;8293;728492;4671,6
-1,-1,5,69238689,70587019,1348330,6607;2966;6606;8293;728492;4671,6
-1,-1,5,69238689,70587019,1348330,6607;2966;6606;8293;728492;4671,6
-1,-1,5,69238689,70587019,1348330,6607;2966;6606;8293;728492;4671,6
-1,-1,5,69238689,70587019,1348330,6607;2966;6606;8293;728492;4671,6
-1,-1,5,69238689,70587019,1348330,6607;2966;6606;8293;728492;4671,6
-1,-1,5,69238689,70587019,1348330,6607;2966;6606;8293;728492;4671,6
1,-1,5,69238689,70587019,1348330,6607;2966;6606;8293;728492;4671,6
1,-1,5,69238689,70587019,1348330,6607;2966;6606;8293;728492;4671,6
-1,-1,5,69238689,70587019,1348330,6607;2966;6606;8293;728492;4671,6
1,-1,5,69238689,70587019,1348330,6607;2966;6606;8293;728492;4671,6
-1,-1,5,69238689,70587019,1348330,6607;2966;6606;8293;728492;4671,6
-1,-1,5,69238689,70587019,1348330,6607;2966;6606;8293;728492;4671,6
-1,-1,5,69238689,70587019,1348330,6607;2966;6606;8293;728492;4671,6
-1,-1,5,69238689,70587019,1348330,6607;2966;6606;8293;728492;4671,6
-1,-1,5,69238689,70587019,1348330,6607;2966;6606;8293;728492;4671,6
-1,-1,5,69238689,70587019,1348330,6607;2966;6606;8293;728492;4671,6
-1,-1,5,69238689,70587019,1348330,6607;2966;6606;8293;728492;4671,6
-1,-1,5,69238689,70587019,1348330,6607;2966;6606;8293;728492;4671,6
-1,-1,5,69238689,70587019,1348330,6607;2966;6606;8293;728492;4671,6
-1,-1,5,69238689,70587019,1348330,6607;2966;6606;8293;728492;4671,6
-1,-1,5,69238689,70587019,1348330,6607;2966;6606;8293;728492;4671,6
-1,-1,5,69238689,70587019,1348330,6607;2966;6606;8293;728492;4671,6
-1,-1,5,69238689,70587019,1348330,6607;2966;6606;8293;728492;4671,6
-1,-1,5,69238689,70587019,1348330,6607;2966;6606;8293;728492;4671,6
-1,-1,5,69238689,70587019,1348330,6607;2966;6606;8293;728492;4671,6
1,-1,5,69238689,70587019,1348330,6607;2966;6606;8293;728492;4671,6
-1,-1,5,69238689,70587019,1348330,6607;2966;6606;8293;728492;4671,6
-1,-1,5,69238689,70587019,1348330,6607;2966;6606;8293;728492;4671,6
-1,-1,5,69238689,70587019,1348330,6607;2966;6606;8293;728492;4671,6
-1,-1,5,69238689,70587019,1348330,6607;2966;6606;8293;728492;4671,6
-1,-1,5,69238689,70587019,1348330,6607;2966;6606;8293;728492;4671,6
-1,-1,5,69238689,70587019,1348330,6607;2966;6606;8293;728492;4671,6
-1,-1,5,69238689,70587019,1348330,6607;2966;6606;8293;728492;4671,6
-1,-1,5,69238689,70587019,1348330,6607;2966;6606;8293;728492;4671,6
-1,-1,5,69238689,70587019,1348330,6607;2966;6606;8293;728492;4671,6
-1,-1,5,69238689,70587019,1348330,6607;2966;6606;8293;728492;4671,6
1,-1,5,69238689,70587019,1348330,6607;2966;6606;8293;728492;4671,6
1,-1,5,69483733,70316732,832999,4671;8293;6606,3
-1,-1,5,69372450,70328742,956292,6607;8293;4671;6606,4
-1,-1,5,69372450,70328742,956292,6607;8293;4671;6606,4
-1,-1,5,69372450,70328742,956292,6607;8293;4671;6606,4
-1,-1,5,69372450,70328742,956292,6607;8293;4671;6606,4
1,-1,5,69372450,70386594,1014144,6607;2966;6606;8293;4671,5
-1,-1,5,69372450,70587019,1214569,6607;2966;6606;8293;4671,5
-1,-1,5,69372450,70587019,1214569,6607;2966;6606;8293;4671,5
-1,-1,5,69372450,70587019,1214569,6607;2966;6606;8293;4671,5
-1,-1,5,69372450,70587019,1214569,6607;2966;6606;8293;4671,5
-1,-1,5,69372450,70587019,1214569,6607;2966;6606;8293;4671,5
-1,-1,5,69372450,70587019,1214569,6607;2966;6606;8293;4671,5
-1,-1,5,69372450,70587019,1214569,6607;2966;6606;8293;4671,5
-1,-1,5,69372450,70587019,1214569,6607;2966;6606;8293;4671,5
-1,-1,5,69372450,70587019,1214569,6607;2966;6606;8293;4671,5
1,-1,5,69372472,70247802,875330,6607;8293;6606,3
-1,-1,5,69372472,70247802,875330,6607;8293;6606,3
-1,-1,5,69372472,70386600,1014128,6607;2966;6606;8293;4671,5
1,-1,5,69372472,70587018,1214546,6607;2966;6606;8293;4671,5
1,-1,5,69372472,70587018,1214546,6607;2966;6606;8293;4671,5
1,-1,5,69426275,70134637,708362,,0
1,-1,5,69426275,70134637,708362,,0
1,-1,5,69426275,70134637,708362,,0
1,-1,5,69426275,70134637,708362,,0
-1,-1,5,69426278,70309826,883548,4671;8293;6606,3
1,-1,5,69439595,70134637,695042,,0
1,-1,5,69439595,70134637,695042,,0
1,-1,5,69691608,70498111,806503,4671;8293;2966;6606,4
1,-1,5,69691608,70498111,806503,4671;8293;2966;6606,4
1,-1,5,69691608,70498111,806503,4671;8293;2966;6606,4
1,-1,5,69691608,70498111,806503,4671;8293;2966;6606,4
-1,-1,5,69555040,70046728,491688,,0
1,-1,5,69555040,70388845,833805,4671;8293;2966;6606,4
-1,-1,5,69600758,70046728,445970,,0
1,-1,5,69705592,70386571,680979,4671;8293;2966;6606,4
1,-1,5,69732162,70386594,654432,4671;8293;2966;6606,4
1,-1,5,69732162,70587019,854857,4671;8293;2966;6606,4
-1,-1,5,69732192,70587018,854826,4671;8293;2966;6606,4
-1,-1,5,69732192,70587018,854826,4671;8293;2966;6606,4
-1,-1,5,69732192,70587018,854826,4671;8293;2966;6606,4
-1,-1,5,69732192,70587018,854826,4671;8293;2966;6606,4
1,-1,5,69732192,70587018,854826,4671;8293;2966;6606,4
-1,-1,5,69732192,70587018,854826,4671;8293;2966;6606,4
-1,-1,5,69732192,70587018,854826,4671;8293;2966;6606,4
-1,-1,5,69732192,70587018,854826,4671;8293;2966;6606,4
-1,-1,5,69732192,70587018,854826,4671;8293;2966;6606,4
-1,-1,5,69732192,70587018,854826,4671;8293;2966;6606,4
-1,-1,5,69732192,70587018,854826,4671;8293;2966;6606,4
-1,-1,5,69732192,70587018,854826,4671;8293;2966;6606,4
-1,-1,5,69732192,70587018,854826,4671;8293;2966;6606,4
1,-1,5,69757941,70268219,510278,4671;8293;6606,3
-1,-1,5,69790756,70268219,477463,4671;8293;6606,3
-1,-1,5,69790756,70280668,489912,4671;8293;6606,3
1,-1,5,69790756,70316732,525976,4671;8293;6606,3
-1,-1,5,69843658,70046728,203070,,0
-1,-1,5,69843658,70046728,203070,,0
-1,-1,5,69843658,70280668,437010,4671;8293;6606,3
1,-1,5,69843629,70386600,542971,4671;8293;2966;6606,4
-1,-1,5,69843629,70587018,743389,4671;8293;2966;6606,4
-1,-1,5,69843651,70587019,743368,4671;8293;2966;6606,4
-1,-1,5,69843651,70587019,743368,4671;8293;2966;6606,4
-1,-1,5,69843651,70587019,743368,4671;8293;2966;6606,4
-1,-1,5,69843651,70587019,743368,4671;8293;2966;6606,4
-1,-1,5,69843651,70587019,743368,4671;8293;2966;6606,4
-1,-1,5,70079318,70280668,201350,4671;8293;6606,3
-1,-1,5,70247769,70587019,339250,4671;2966;6606,3
-1,-1,5,70369930,70388814,18884,,0
-1,-1,5,70369930,70657718,287788,,0
-1,-1,5,70386570,70663068,276498,,0
-1,-1,5,83780847,83899398,118551,,0
-1,1,5,83899398,110770779,26871381,642987;51752;5066;153643;285704;83989;55781;1946;345757;9652;90355;10622;4208;91137;1350;134187;317671;2745;116068;7903;7025;83594;9867;134430;84059;153642;153396;902;84250;79772;83890;57561;54826;5921;814;2241;64167;4124;1105;4012;22836;353189;153364;285601;831;22936;133482;64839;285600;23262;1070;85480;167410;5122,54
1,-1,5,84770220,85460511,690291,,0
-1,1,5,85078722,89276707,4197985,5921;4208;153396;902;1350,5
-1,-1,5,85261873,85338858,76985,,0
-1,1,5,85954428,86904060,949632,5921;902,2
-1,1,5,86062776,91444662,5381886,57561;5921;153364;116068;84059;10622;4208;1070;153396;902,10
-1,1,5,86254118,86777028,522910,5921;902,2
-1,1,5,86487715,89253266,2765551,4208;153396;5921;902,4
-1,1,5,86530415,88893604,2363189,4208;153396;5921;902,4
1,1,5,87493549,92528869,5035320,57561;153364;116068;10622;84059;1070;153396;4208,8
-1,1,5,87664106,91698938,4034832,57561;10622;153364;116068;84059;1070;4208,7
-1,1,5,87764485,90147447,2382962,10622;153364;116068;84059;1070;4208,6
-1,1,5,87999726,88137439,137713,4208,1
-1,1,5,88039877,88045439,5562,4208,1
-1,1,5,88062493,88104672,42179,4208,1
-1,1,5,88062497,89028098,965601,4208,1
-1,1,5,89670423,127412115,37741692,51752;93166;83989;55781;345757;51014;353376;644100;10622;91137;64848;134187;51808;51334;116068;7903;133619;7025;9867;153241;134430;1657;84059;100302736;389320;25816;83890;9140;814;324;65983;64097;4124;1105;4012;84466;353189;51397;5480;285601;22936;134429;4001;64839;7905;285600;22836;1070;153642;83594;5122;133923;642987;5066;401207;153643;4015;285704;501;28966;1946;56929;57507;167227;1176;9652;90355;285605;9627;317671;728586;2745;9315;3295;115123;100505841;83942;6728;153443;84250;54826;79772;57561;153733;5229;94033;2241;64167;1036;340069;6643;4163;153364;1456;3781;55521;831;133482;206338;613212;23262;57556;85480;167410,104
-1,1,5,90707525,130655256,39947731,51752;93166;83989;55781;345757;51014;353376;644100;100127206;91137;64848;134187;90624;51808;51334;7903;133619;7025;9867;153241;134430;1657;100302736;389320;25816;83890;9140;814;324;65983;64097;4124;1105;4012;84466;353189;51397;5480;285601;22936;134429;4001;64839;7905;285600;22836;153642;83594;5122;133923;642987;5066;401207;153643;4015;285704;501;28966;1946;56929;171019;57507;167227;1176;6558;9652;90355;337876;285605;28965;9627;317671;728586;2745;9315;3295;115123;100505841;83942;6728;153443;84250;54826;79772;153733;5229;94033;2241;64167;2201;3094;1036;340069;51015;6643;4163;56990;1456;3781;55521;831;133482;206338;613212;23262;57556;85480;167410,108
-1,1,5,92235441,118949814,26714373,51752;83989;55781;345757;51014;353376;644100;91137;64848;134187;7903;7025;9867;134430;100302736;1657;25816;83890;9140;814;324;64097;4124;1105;4012;353189;51397;285601;22936;134429;64839;7905;285600;22836;153642;83594;5122;642987;5066;153643;285704;1946;56929;167227;1176;9652;90355;285605;317671;2745;9315;3295;83942;6728;84250;79772;54826;153733;5229;2241;64167;1036;4163;3781;55521;831;133482;206338;23262;57556;85480;167410,72
-1,1,5,92528810,112623492,20094682,642987;51752;5066;153643;285600;285704;83989;55781;1946;345757;167227;9652;90355;91137;134187;317671;2745;9315;7903;7025;83594;9867;134430;6728;84250;83890;79772;54826;814;324;2241;64167;64097;4124;1105;4012;353189;4163;285601;831;22936;133482;134429;64839;7905;22836;23262;153642;85480;167410;5122,51
-1,-1,5,96673541,96818093,144552,,0
-1,-1,5,97051910,97077322,25412,,0
-1,-1,5,97051910,97129673,77763,,0
-1,-1,5,97051910,97129673,77763,,0
-1,-1,5,97051910,97129673,77763,,0
1,-1,5,99211169,99324697,113528,,0
1,-1,5,100558510,100908238,349728,,0
-1,1,5,100607918,125900735,25292817,642987;5066;4015;93166;501;1946;28966;56929;51014;167227;57507;353376;1176;644100;90355;285605;91137;9627;64848;9315;3295;51334;100505841;83942;9867;153241;134430;6728;100302736;1657;25816;153443;54826;153733;9140;814;324;2241;5229;94033;65983;64097;4124;1036;340069;6643;353189;4163;51397;5480;1456;3781;55521;133482;134429;206338;133923;64839;7905;23262;57556;85480;83594,63
-1,-1,5,101148890,101423754,274864,,0
-1,-1,5,101794089,101834242,40153,133482,1
-1,-1,5,104332410,104473254,140844,,0
-1,-1,5,104473283,104583261,109978,,0
1,-1,5,105021792,105810456,788664,,0
1,-1,5,105392930,105522364,129434,,0
-1,-1,5,105779167,105865777,86610,,0
-1,1,5,105921779,112342282,6420503,642987;814;1946;2241;324;167227;64097;4124;91137;9315;134429;9867;64839;134430;6728;7905;85480,17
-1,1,5,106337910,117361011,11023101,642987;1946;56929;51014;167227;353376;1176;644100;91137;64848;9315;83942;9867;134430;6728;100302736;153733;9140;814;324;2241;5229;64097;4124;1036;4163;51397;3781;55521;134429;206338;64839;7905;57556;85480,35
1,1,5,106716357,180687338,73970981,5159;645121;347732;93166;56127;51164;30832;91522;644100;30820;56100;5813;7265;51334;56101;9945;3308;84249;375484;9867;3274;30012;54825;84321;90249;9604;644994;26262;6584;9794;79908;6690;80758;3593;153770;373863;345456;83884;202374;9542;56105;8728;23286;133874;9963;10007;1794;56121;1809;56923;6695;55819;6500;4488;153201;134549;285676;6678;1627;117156;10814;26249;285641;8817;285659;6932;6793;642987;401207;253314;3702;4015;6620;28966;501;56112;5515;728586;1212;4238;9421;27039;23197;27089;100505841;23438;56098;643836;10112;1812;23105;90933;3550;133491;51520;255426;9547;54540;51128;11346;9443;56143;1036;340069;80315;91975;56108;3035;404203;57556;1456;4245;11063;5601;89848;78991;57113;3161;114787;9555;2908;51428;643226;54882;51014;56951;101928093;9232;100127206;9260;54819;345462;56099;3779;492311;10949;29930;285643;134266;153768;1879;815;6208;100302736;408263;57451;56132;814;5097;324;85027;63920;23305;6879;662;7045;91272;821;100131897;206358;64411;55568;84466;56123;5480;23092;57222;84651;389337;497189;64839;972;2161;54492;56126;56103;117608;134265;9708;114825;6569;167227;51149;56102;285605;91977;54853;9627;56139;10917;23061;9315;285596;56109;26223;23176;51617;83942;3578;153745;80108;6728;23291;1437;64777;1836;11005;56130;202051;57717;2566;23567;5145;94033;26999;2241;2201;10011;2559;10827;134553;3562;79628;4163;56990;285598;7416;51265;26167;85007;389333;8992;56140;51247;57396;57824;83463;54908;613212;56144;4869;2661;85480;80230;56146;153527;2916;929;2324;56113;56134;56142;4090;7322;51491;10307;26762;2890;6586;51121;91137;53917;1839;23138;5459;3182;90624;51808;134353;134391;1044;153241;153830;56106;147;134430;285590;51780;1436;51523;116842;134510;6583;3565;3101;56124;23120;10569;56138;56107;65983;22885;6534;4124;56111;10399;64374;8641;83697;91937;51397;10915;10146;81848;56145;56114;27430;81789;2870;2561;51735;55374;56929;171019;10111;5307;643394;79685;57507;23338;51306;2196;10802;56128;337876;140947;153579;10636;7320;819;56104;27166;2299;9509;115123;26045;6949;10902;57472;9812;56110;3567;3313;6444;4695;153443;51720;7478;26112;26693;11285;5229;23367;11282;57528;1452;5098;285588;64901;8572;10318;114898;153328;56097;56131;1843;10826;3781;5626;92304;206338;2172;64324;8382;8614;81555;153222;3950;133522;340075;22993;348938;285679;8974;153769;9685;55696;353376;9337;1729;92181;404734;64848;91368;51294;154;3596;3659;51237;3187;79616;133619;56137;81786;285613;646019;57179;1657;389320;56136;113829;25816;2107;79770;9499;80762;9140;1495;79646;2246;56129;56125;54732;6940;64097;8697;84418;81545;29093;84105;26025;641700;25929;11127;3360;4001;134429;9782;27190;7905;2760;9879;8841;100996485;54974;8637;3937;133923;51308;2878;5201;1946;96459;134548;2676;202134;134083;1176;345611;6558;51307;56122;56141;56135;28965;1958;9752;54439;27125;3295;56133;1482;3340;84851;2741;84868;340061;10960;728637;153733;900;2554;2264;3094;56147;79930;9832;5521;5917;2568;51015;202052;6643;192286;408187;100190949;55521;4056;94081;8878;55651;153218;134492;389336;4762;475;309;995;22838,509
-1,1,5,107644164,125113490,17469326,642987;4015;93166;28966;56929;51014;167227;57507;353376;1176;644100;285605;91137;9627;64848;9315;3295;51334;100505841;83942;9867;153241;134430;6728;100302736;1657;25816;153443;153733;9140;814;324;2241;5229;94033;64097;4124;1036;340069;6643;4163;51397;5480;1456;3781;55521;134429;206338;64839;7905;57556;85480;133923,53
-1,1,5,107920965,116150771,8229806,642987;56929;51014;167227;353376;1176;644100;91137;64848;9315;83942;9867;134430;6728;100302736;153733;9140;814;324;2241;5229;64097;4124;1036;4163;51397;3781;55521;134429;206338;7905;57556;85480,33
-1,-1,5,109626656,109941854,315198,642987,1
-1,1,5,110023143,129439531,19416388,93166;51014;353376;644100;100127206;91137;64848;51808;51334;133619;153241;134430;100302736;1657;389320;25816;9140;814;324;65983;64097;84466;5480;51397;134429;4001;7905;133923;642987;401207;4015;501;28966;56929;171019;167227;57507;1176;6558;285605;337876;28965;9627;9315;728586;3295;115123;100505841;83942;6728;153443;153733;5229;94033;2201;1036;340069;6643;51015;4163;1456;3781;55521;206338;613212;57556;85480,67
-1,1,5,110407606,122522885,12115279,4015;93166;28966;56929;51014;167227;353376;1176;644100;285605;9627;64848;9315;3295;51334;100505841;83942;134430;100302736;6728;1657;25816;153443;153733;9140;814;324;5229;94033;64097;1036;340069;6643;4163;51397;5480;3781;55521;134429;206338;7905;57556;85480;133923,44
-1,-1,5,110576011,110653209,77198,814,1
-1,1,5,110798714,126528730,15730016,401207;4015;93166;501;28966;56929;51014;167227;57507;353376;1176;644100;285605;9627;64848;9315;3295;51808;51334;115123;100505841;83942;153241;1657;100302736;6728;389320;25816;153443;153733;9140;814;324;5229;94033;65983;64097;1036;340069;6643;4163;51397;5480;1456;3781;55521;134429;206338;4001;7905;57556;133923,52
-1,1,5,111659214,117109202,5449988,153733;9140;324;5229;56929;51014;167227;64097;353376;1176;644100;64848;1036;6728;4163;51397;3781;55521;206338;83942;7905;100302736;57556,23
-1,1,5,112155137,113946731,1791594,4163;324;3781;167227;83942;7905;6728;64848,8
-1,-1,5,113079086,113170149,91063,,0
-1,1,5,114043258,125843436,11800178,4015;93166;28966;56929;51014;57507;353376;1176;644100;285605;9627;3295;51334;100505841;153241;1657;100302736;25816;153443;153733;9140;5229;94033;65983;340069;1036;6643;5480;51397;1456;55521;206338;57556;133923,34
1,-1,5,115508329,115533467,25138,51397,1
-1,-1,5,115533467,115585253,51786,51397,1
1,-1,5,119028921,119134844,105923,,0
-1,-1,5,119354448,120770069,1415621,51334,1
-1,-1,5,120158999,120256126,97127,,0
-1,1,5,122442467,129980139,7537672,401207;93166;501;171019;2201;65983;57507;100127206;6558;337876;28965;51015;84466;728586;51808;115123;1456;133619;4001;153241;613212;389320,22
1,-1,5,124943170,125619664,676494,,0
1,-1,5,124943170,125634960,691790,,0
1,1,5,126002101,126341594,339493,4001;115123,2
1,1,5,126002101,126351612,349511,4001;115123,2
-1,1,5,126861666,135269155,8407489,9555;645121;347732;8974;56951;100127206;54819;90624;91368;3596;3659;3308;133619;6584;79770;116842;6583;3565;23305;84105;497189;6500;11127;134549;100996485;9879;6932;51735;96459;171019;10111;134548;5307;23338;6558;10802;337876;28965;140947;5515;728586;7320;819;27125;26223;23176;27089;3578;1437;3567;728637;23105;9547;2201;3094;51128;134553;8572;3562;51015;153328;56990;7416;51265;613212;4762;2661,67
-1,1,5,127770494,127822042,51548,2201,1
1,-1,5,128770640,129098541,327901,100127206;171019,2
1,1,5,129183487,152733106,23549619,5159;645121;347732;56127;51164;56100;5813;56101;3308;84249;9604;6584;6690;153770;373863;83884;202374;9542;56105;9963;10007;56121;1809;56923;6695;6500;6678;153201;134549;26249;117156;285641;6932;56112;5515;27039;27089;23438;56098;10112;23105;51520;3550;9547;51128;11346;56143;91975;56108;3035;404203;89848;78991;57113;9555;2908;643226;54882;56951;54819;56099;10949;492311;29930;153768;134266;815;6208;56132;5097;85027;23305;6879;7045;206358;64411;56123;23092;84651;389337;497189;972;56126;56103;134265;9708;56102;54853;91977;56139;56109;26223;23176;3578;1437;56130;11005;1836;202051;57717;5145;10011;134553;3562;79628;56990;7416;51265;26167;389333;56140;51247;57824;56144;56146;2661;153527;929;56113;56142;56134;4090;7322;10307;1839;5459;90624;134391;1044;56106;51780;1436;51523;116842;6583;3565;56124;56138;56107;22885;6534;56111;64374;8641;83697;10915;10146;81848;56145;56114;81789;51735;55374;643394;10111;5307;23338;51306;2196;10802;56128;337876;140947;7320;819;56104;26045;6949;10902;9812;56110;3567;3313;4695;7478;26112;57528;1452;5098;8572;10318;153328;56097;56131;8382;81555;3950;133522;22993;340075;8974;153769;55696;1729;404734;91368;51294;3596;154;3659;51237;56137;285613;113829;56136;79770;2107;9499;80762;1495;2246;56129;56125;8697;84418;81545;84105;26025;641700;11127;3360;9782;27190;2760;100996485;9879;8841;8637;51308;2878;5201;96459;134548;2676;345611;51307;56122;56141;56135;1958;9752;54439;27125;56133;3340;2741;340061;728637;3094;56147;9832;5521;202052;408187;389336;153218;4762;475;309;995,260
1,1,5,130125085,157574910,27449825,5159;645121;347732;56127;51164;56100;5813;56101;3308;84249;9604;6584;6690;153770;373863;83884;202374;9542;56105;8728;9963;10007;56121;1809;56923;6695;6500;6678;153201;134549;26249;117156;285641;6932;3702;56112;5515;4238;9421;27039;27089;23438;56098;10112;23105;51520;3550;9547;51128;11346;9443;56143;91975;56108;3035;404203;11063;89848;78991;57113;9555;2908;643226;54882;56951;54819;56099;10949;492311;29930;285643;153768;134266;815;6208;408263;56132;5097;85027;23305;6879;7045;206358;64411;55568;56123;23092;84651;389337;497189;972;56126;56103;134265;9708;56102;54853;91977;56139;56109;26223;23176;3578;153745;1437;56130;11005;1836;202051;57717;5145;26999;10011;10827;134553;3562;79628;56990;7416;51265;26167;389333;56140;51247;57824;56144;56146;2661;153527;929;56113;56142;56134;4090;7322;10307;26762;2890;1839;5459;90624;134353;134391;1044;56106;51780;1436;51523;116842;6583;3565;56124;56138;56107;22885;6534;56111;64374;8641;83697;91937;10915;10146;81848;56145;56114;81789;51735;55374;643394;10111;5307;79685;23338;51306;2196;10802;56128;140947;7320;819;56104;26045;6949;10902;9812;56110;3567;3313;4695;6444;7478;26112;23367;57528;1452;5098;8572;10318;153328;56097;56131;10826;8382;81555;3950;133522;22993;340075;348938;8974;153769;9685;55696;9337;1729;404734;91368;51294;3596;154;3659;51237;56137;285613;113829;56136;79770;2107;9499;80762;1495;2246;56129;56125;8697;84418;81545;29093;84105;26025;641700;25929;11127;3360;9782;27190;2760;100996485;9879;8841;54974;8637;51308;2878;5201;96459;134548;2676;345611;51307;56122;56141;56135;1958;9752;54439;27125;56133;3340;2741;84868;340061;728637;3094;56147;9832;5521;202052;408187;100190949;389336;153218;4762;475;309;995,287
-1,1,5,130962196,135150743,4188547,51735;9555;645121;347732;8974;96459;10111;134548;56951;23338;5307;10802;54819;140947;5515;7320;819;27125;91368;3596;3659;23176;27089;3308;9879;3567;1437;6584;79770;728637;116842;6583;3565;23105;9547;23305;51128;134553;8572;3562;84105;7416;51265;497189;6500;11127;134549;100996485;4762;2661;6932,51
1,1,5,134632984,139485588,4852604,51308;3950;9555;4090;7322;2676;51306;51307;140947;1958;10949;26045;26223;27039;51237;84249;3578;10902;340061;51780;3313;2107;51523;9499;10112;1495;7478;202051;57113;9547;7045;8697;9542;64374;9963;153328;202052;6695;497189;389333;641700;51247;9782;26249;100996485;4762;8382;995,48
1,1,5,134632984,139485588,4852604,51308;3950;9555;4090;7322;2676;51306;51307;140947;1958;10949;26045;26223;27039;51237;84249;3578;10902;340061;51780;3313;2107;51523;9499;10112;1495;7478;202051;57113;9547;7045;8697;9542;64374;9963;153328;202052;6695;497189;389333;641700;51247;9782;26249;100996485;4762;8382;995,48
1,1,5,137172371,140075946,2903575,51308;929;5201;7322;10307;54882;55374;2676;51306;51307;54853;404734;1958;5813;1839;492311;26045;27039;51237;84249;23438;10902;340061;113829;4695;3313;51780;2107;51523;10112;9499;1495;7478;202051;3550;10011;373863;8697;9542;84418;64374;9963;202052;83697;3035;641700;389333;51247;9782;8382;8637;995,52
1,1,5,140469572,148910241,8440669,56113;2908;643226;56127;153769;1729;56100;56099;5459;51294;154;56101;153768;134266;134391;285613;56106;9604;80762;6690;56132;56124;2246;56129;153770;56125;5097;83884;56107;202374;22885;6879;56105;56111;81545;8641;64411;10007;56123;56121;10915;1809;26025;23092;81848;84651;56114;3360;27190;117156;8841;56126;56103;134265;56112;643394;9708;56102;56128;56122;54439;56104;56109;56133;9812;56110;56098;56130;11005;51520;57717;57528;1452;5098;9832;5521;56097;56131;56108;79628;404203;408187;26167;89848;78991;57824;389336;153218;81555,89
1,-1,5,140568025,140572033,4008,56127;56126,2
-1,-1,5,140570431,140572077,1646,56127;56126,2
1,-1,5,140581626,140589370,7744,56125;56124,2
1,-1,5,140581626,140589370,7744,56125;56124,2
1,-1,5,140581626,140593602,11976,56125;56123;56124,3
-1,1,5,141113273,149154835,8041562,133522;2908;643226;153769;134265;643394;5459;54439;51294;154;153768;134266;134391;9812;9604;11005;80762;6690;51520;2246;5097;153770;57528;202374;22885;1452;9832;5521;81545;10007;79628;404203;23092;10915;1809;408187;81848;84651;389337;3360;78991;57824;27190;117156;389336;153218;81555,47
1,-1,5,142176123,142241875,65752,23092,1
-1,-1,5,144027588,144238284,210696,,0
-1,1,5,144576918,147921074,3344156,6690;51520;643226;153770;153769;643394;202374;9832;5521;81545;5459;54439;404203;10915;1809;408187;84651;153768;134391;3360;117156;389336;153218;11005,24
1,1,5,146540455,163262200,16721745,133522;5159;22993;340075;348938;51164;9685;26762;2890;55696;9337;9232;7265;285643;134353;154;134266;1044;815;1879;79616;147;153830;6208;408263;1436;134510;6690;23120;63920;3593;85027;10569;202374;22885;6534;8728;81545;206358;29093;55568;91937;1809;10146;56923;84651;389337;27430;81789;25929;6678;3360;153201;2561;27190;117156;2760;285641;972;54974;2878;3702;134265;643394;114825;79685;345611;2196;91977;4238;9421;6949;3340;2741;84868;153745;6444;1836;11005;900;26112;2566;2554;5145;23367;26999;2559;10827;1452;11346;9832;9443;10318;114898;91975;10826;79628;404203;408187;100190949;11063;78991;389336;153218;134492;2172;3161;475;309,109
-1,1,5,149731885,149738613,6728,6949,1
-1,1,5,151823430,165531397,13707967,3702;348938;3161;9685;26762;2890;79685;114825;9337;9232;7265;285643;134353;4238;9421;1879;79616;84868;147;153745;153830;408263;6444;134510;900;2566;23120;63920;3593;23367;26999;10569;2559;10827;2554;8728;9443;29093;114898;55568;10826;91937;100190949;27430;25929;11063;2561;134492;2172;54974,50
1,1,5,156252523,180696806,24444283,2916;2324;51491;26762;91522;30832;6586;30820;51121;53917;23138;3182;7265;134353;9945;375484;147;153830;3274;30012;285590;84321;54825;90249;644994;26262;9794;134510;79908;3101;23120;80758;3593;10569;345456;8728;10399;23286;133874;1794;91937;27430;2870;55819;285676;4488;1627;2561;10814;8817;285659;253314;6793;3702;6620;10636;153579;27166;2299;1212;9509;23197;57472;643836;51720;1812;90933;133491;255426;11285;26693;54540;11282;9443;64901;285588;114898;1843;80315;4245;11063;5626;5601;92304;2172;3161;64324;8614;153222;114787;285679;348938;51428;9685;101928093;9232;92181;9260;345462;3779;1879;79616;3187;646019;57179;408263;57451;79646;63920;662;54732;6940;91272;821;100131897;57222;54974;3937;2161;54492;117608;114825;202134;6569;51149;134083;10917;23061;285596;1482;51617;84851;84868;153745;80108;23291;10960;64777;900;2566;2554;23567;26999;2559;2264;79930;5917;2568;192286;285598;100190949;85007;94081;8992;4056;55651;54908;57396;8878;83463;134492;81786;4869;80230;22838,165
-1,1,5,158368362,163813766,5445404,134510;900;2566;23120;63920;3593;2554;10569;2559;114825;9232;114898;7265;27430;1879;79616;2561;147;153830;134492;2172;3161,22
-1,1,5,161381034,161534024,152990,2566,1
-1,1,5,161547032,161575610,28578,2566,1
-1,1,5,161547033,161572618,25585,2566,1
1,1,5,163813707,180696806,16883099,2916;2324;51491;30832;91522;6586;30820;51121;53917;23138;3182;9945;375484;3274;30012;285590;84321;54825;90249;644994;26262;9794;79908;3101;80758;345456;10399;23286;133874;1794;2870;55819;285676;4488;1627;10814;8817;285659;253314;6793;6620;10636;153579;27166;2299;1212;9509;23197;57472;643836;51720;1812;90933;133491;255426;11285;26693;54540;11282;285588;64901;1843;80315;4245;5626;92304;5601;64324;8614;114787;153222;285679;51428;101928093;92181;9260;345462;3779;3187;646019;57179;57451;79646;662;54732;6940;91272;821;100131897;57222;3937;2161;54492;117608;202134;6569;134083;51149;10917;23061;285596;1482;51617;84851;80108;23291;10960;64777;23567;2264;79930;5917;2568;192286;285598;85007;94081;8992;4056;55651;54908;57396;8878;83463;81786;4869;80230;22838,128
-1,1,5,164207156,172799124,8591968,6793;54492;6586;101928093;92181;30820;51121;3779;2299;1482;30012;23291;285590;644994;57451;8614;79646;662;5917;285588;64901;23286;100131897;133874;2568;1843;1794;57222;8992;54908;4869;8817;153222;3937,34
1,1,5,164391372,180696806,16305434,2916;2324;51491;30832;91522;6586;30820;51121;53917;23138;3182;9945;375484;3274;30012;285590;84321;54825;90249;644994;26262;9794;79908;3101;80758;345456;10399;23286;133874;1794;2870;55819;285676;4488;1627;10814;8817;285659;253314;6793;6620;10636;153579;27166;2299;1212;9509;23197;57472;643836;51720;1812;90933;133491;255426;11285;26693;54540;11282;285588;64901;1843;80315;4245;5626;92304;5601;64324;8614;114787;153222;285679;51428;101928093;92181;9260;345462;3779;3187;646019;57179;57451;79646;662;54732;6940;91272;821;100131897;57222;3937;2161;54492;117608;202134;6569;134083;51149;10917;23061;285596;1482;51617;84851;80108;23291;10960;64777;23567;2264;79930;5917;2568;192286;285598;85007;94081;8992;4056;55651;54908;57396;8878;83463;81786;4869;80230;22838,128
1,-1,5,165287964,165847276,559312,,0
1,1,5,168761759,180712302,11950543,2916;2324;285679;51428;51491;30832;91522;101928093;92181;9260;30820;51121;345462;53917;3779;23138;3182;9945;3187;375484;3274;646019;81786;285590;30012;84321;54825;90249;57179;644994;26262;9794;79908;3101;80758;662;54732;345456;6940;91272;10399;821;100131897;133874;1794;153222;57222;2870;55819;285676;4488;1627;10814;8817;285659;3937;2161;253314;6793;54492;117608;6620;202134;6569;134083;51149;10636;153579;10917;23061;27166;2299;285596;1212;9509;1482;23197;51617;84851;57472;80108;23291;10960;643836;64777;51720;1812;90933;133491;255426;11285;26693;23567;54540;4869;2264;11282;79930;285588;64901;2568;1843;80315;192286;285598;85007;4245;5626;92304;5601;94081;8992;4056;55651;114787;54908;57396;8878;83463;64324;80230;8614;22838,123
1,1,5,171396359,180719789,9323430,2916;2324;285679;51428;51491;30832;91522;101928093;92181;9260;51121;345462;53917;23138;3182;9945;3187;375484;3274;646019;81786;285590;54825;84321;90249;57179;26262;9794;79908;3101;80758;662;54732;345456;6940;91272;10399;821;57222;2870;55819;285676;4488;1627;10814;285659;2161;253314;6793;54492;117608;6620;202134;6569;134083;51149;10636;153579;10917;23061;27166;285596;1212;9509;1482;23197;51617;84851;57472;23291;80108;10960;643836;64777;51720;1812;90933;8614;133491;255426;11285;26693;23567;54540;2264;11282;79930;285588;1843;80315;192286;285598;85007;4245;5626;92304;5601;94081;8992;4056;55651;114787;8878;57396;83463;64324;80230;153222;22838,109
1,1,5,172031248,180719789,8688541,2916;2324;285679;51428;51491;30832;91522;101928093;9260;51121;345462;53917;23138;3182;9945;3187;375484;3274;646019;81786;57179;54825;84321;90249;26262;9794;79908;3101;80758;662;54732;345456;6940;91272;10399;821;57222;2870;55819;285676;4488;1627;10814;285659;2161;253314;54492;117608;6620;202134;6569;134083;51149;10636;153579;10917;23061;27166;285596;1212;9509;1482;23197;51617;84851;57472;80108;10960;643836;64777;51720;1812;90933;8614;133491;255426;11285;26693;23567;54540;2264;11282;79930;1843;80315;192286;285598;85007;4245;5626;92304;5601;94081;8992;4056;55651;114787;8878;57396;83463;64324;80230;153222;22838,104
1,-1,5,172085912,172116412,30500,54492,1
1,1,5,172664775,176041619,3376844,1812;8614;133491;51491;202134;91272;10814;80315;192286;285598;1212;94081;23197;51617;375484;4488;3274;57179;54825;84321;114787;22838,22
-1,1,5,173376776,174327398,950622,51617;133491;4488;80315,4
-1,1,5,174151144,174169790,18646,4488,1
-1,1,5,174427052,180719789,6292737,2916;2324;285679;51428;51491;30832;91522;9260;345462;53917;23138;3182;9945;3187;375484;3274;646019;57179;54825;84321;90249;26262;9794;79908;3101;80758;54732;345456;6940;10399;821;55819;2870;285676;1627;10814;285659;2161;253314;117608;6620;202134;6569;134083;51149;10636;153579;10917;23061;27166;285596;1212;9509;23197;84851;57472;80108;10960;643836;64777;51720;1812;90933;255426;26693;11285;23567;54540;2264;11282;79930;192286;285598;85007;4245;5626;92304;5601;94081;4056;8878;55651;57396;83463;81786;64324;80230;114787;22838,89
-1,1,5,174963774,180719789,5756015,2916;2324;285679;51428;51491;30832;91522;9260;345462;53917;23138;3182;9945;3187;375484;3274;646019;57179;54825;84321;90249;26262;9794;79908;3101;80758;54732;345456;6940;10399;821;2870;55819;285676;1627;10814;285659;2161;253314;117608;6620;202134;6569;134083;51149;10636;153579;10917;23061;27166;285596;1212;9509;23197;84851;57472;80108;10960;643836;64777;51720;90933;255426;26693;11285;23567;54540;2264;11282;79930;192286;285598;85007;4245;5626;92304;5601;4056;8878;55651;57396;83463;81786;64324;80230;114787;22838,87
-1,1,5,175416095,177436413,2020318,51428;51491;6620;202134;6569;9260;10636;53917;27166;285596;1212;23197;375484;57179;54825;90249;10960;26262;51720;3101;23567;80758;11285;54540;2264;345456;54732;79930;22838;192286;285598;2870;5626;1627;83463;64324;114787;2161;253314,39
-1,1,5,175438045,177392885,1954840,51428;51491;6620;202134;6569;9260;10636;53917;27166;285596;1212;23197;375484;57179;54825;90249;10960;26262;51720;3101;23567;80758;11285;54540;2264;345456;54732;79930;22838;192286;285598;2870;1627;83463;64324;114787;2161;253314,38
-1,1,5,175559343,177422760,1863417,51428;51491;6620;6569;9260;10636;53917;27166;285596;1212;23197;375484;57179;54825;90249;10960;26262;51720;3101;23567;80758;11285;54540;2264;345456;54732;79930;22838;192286;285598;2870;5626;1627;83463;64324;114787;2161;253314,38
-1,1,5,175570677,177436413,1865736,51428;51491;6620;6569;9260;10636;53917;27166;285596;1212;23197;375484;57179;54825;90249;10960;26262;51720;3101;23567;80758;11285;54540;2264;345456;54732;79930;22838;192286;285598;2870;5626;1627;83463;64324;114787;2161;253314,38
1,1,5,175570677,177439550,1868873,51428;51491;6620;6569;9260;10636;53917;27166;285596;1212;23197;375484;57179;54825;90249;10960;26262;51720;3101;23567;80758;11285;54540;2264;345456;54732;79930;22838;192286;285598;2870;5626;1627;83463;64324;114787;2161;253314,38
-1,1,5,175570677,180719789,5149112,2916;2324;285679;51428;51491;30832;91522;9260;345462;53917;23138;3182;9945;3187;375484;646019;57179;54825;90249;26262;9794;79908;3101;80758;54732;345456;6940;10399;821;2870;55819;285676;1627;285659;2161;253314;117608;6620;6569;134083;51149;10636;153579;10917;23061;27166;285596;1212;9509;23197;84851;57472;80108;10960;643836;64777;51720;90933;255426;26693;11285;23567;54540;2264;11282;79930;192286;285598;85007;4245;5626;92304;5601;4056;8878;55651;57396;83463;81786;64324;80230;114787;22838,83
-1,1,5,175570678,177437340,1866662,51428;51491;6620;6569;9260;10636;53917;27166;285596;1212;23197;375484;57179;54825;90249;10960;26262;51720;3101;23567;80758;11285;54540;2264;345456;54732;79930;22838;192286;285598;2870;5626;1627;83463;64324;114787;2161;253314,38
-1,1,5,175601473,180100378,4498905,2916;2324;285679;51428;51491;30832;91522;9260;345462;53917;23138;3182;9945;3187;375484;646019;57179;54825;90249;26262;9794;3101;80758;54732;345456;6940;821;2870;55819;285676;1627;2161;253314;117608;6620;6569;51149;10636;23061;27166;285596;1212;9509;23197;80108;57472;10960;64777;51720;255426;23567;11285;54540;2264;11282;79930;192286;285598;85007;5626;4056;55651;8878;57396;5601;83463;92304;64324;80230;114787;22838,71
-1,1,5,175718841,178089700,2370859,51428;51491;6620;6569;91522;9260;10636;53917;23138;253314;3182;27166;285596;1212;23197;375484;57179;54825;90249;10960;64777;26262;51720;3101;23567;80758;11285;54540;2264;345456;54732;79930;192286;285598;85007;2870;5626;55651;1627;57396;83463;64324;114787;2161;22838,45
1,1,5,175722788,177423091,1700303,51428;51491;6620;6569;9260;10636;53917;253314;27166;285596;1212;23197;375484;57179;54825;90249;10960;26262;51720;3101;23567;80758;11285;54540;2264;345456;54732;79930;192286;285598;2870;5626;1627;83463;64324;114787;2161;22838,38
-1,1,5,175944340,177136290,1191950,3101;64324;51428;6620;23567;80758;11285;54540;2264;6569;345456;54732;79930;9260;10636;53917;22838;27166;2870;1627;51720;83463;54825;90249;10960;114787;26262;2161;253314,29
-1,1,5,176127129,180696806,4569677,2916;2324;285679;51428;30832;91522;9260;345462;53917;23138;3182;9945;3187;646019;90249;9794;79908;3101;80758;54732;345456;6940;10399;821;2870;55819;285676;1627;285659;2161;117608;6569;134083;51149;10636;10917;153579;23061;27166;285596;9509;84851;80108;57472;10960;64777;643836;51720;90933;255426;26693;23567;11285;54540;2264;11282;79930;85007;4245;5626;4056;55651;8878;57396;5601;83463;92304;81786;64324;80230,70
-1,1,5,176274007,180719789,4445782,2916;2324;285679;51428;30832;91522;9260;345462;53917;23138;3182;9945;3187;646019;90249;9794;79908;3101;80758;54732;345456;6940;10399;821;2870;55819;285676;1627;285659;2161;117608;6569;134083;51149;10636;10917;153579;23061;27166;285596;9509;84851;80108;57472;10960;64777;643836;51720;90933;255426;26693;23567;11285;54540;2264;11282;79930;85007;4245;5626;4056;55651;8878;57396;5601;83463;92304;81786;64324;80230,70
1,1,5,176390551,176879528,488977,27166;64324;23567;80758;2870;2264;6569;345456;53917;83463;10636;10960;2161;51720,14
-1,1,5,176505173,178230923,1725750,64324;51428;23567;80758;11285;54540;2264;6569;91522;345456;54732;9260;6940;79930;10636;53917;23138;3182;27166;285596;85007;2870;5626;55651;1627;57396;83463;10960;64777;2161,30
-1,1,5,176666707,176718909,52202,64324,1
1,1,5,178228725,180678091,2449366,2916;117608;2324;285679;30832;134083;51149;345462;10917;153579;23061;9509;9945;3187;646019;80108;57472;643836;9794;79908;90933;255426;26693;11282;10399;821;55819;4245;4056;285676;8878;5601;92304;285659;81786;80230,36
1,-1,5,178567431,178835508,268077,9509,1
1,-1,5,178769471,178933407,163936,9509,1
1,-1,5,178769471,178933407,163936,9509,1
1,1,5,179309535,180719789,1410254,79908;2324;90933;255426;26693;134083;10399;153579;10917;23061;9945;55819;4245;92304;5601;84851;285659;57472;81786;643836,20
1,-1,5,180008319,180273638,265319,2324;4245;92304;134083,4
1,-1,5,180177527,180191645,14118,,0
1,-1,5,180191645,180286067,94422,643836;4245,2
1,-1,5,180432453,180474868,42415,10917;153579,2
1,-1,5,180467222,180487246,20024,153579,1
-1,-1,5,180552331,180567133,14802,,0
1,-1,5,180576812,180604344,27532,285659,1
1,-1,5,180724243,180751873,27630,,0
1,-1,5,180724243,180751873,27630,,0
1,-1,5,180765809,180875621,109812,26683,1
1,-1,5,180765809,180890113,124304,26683,1
-1,-1,5,180783055,180825790,42735,26683,1
1,-1,5,180783055,180825790,42735,26683,1
1,-1,5,180783055,180875621,92566,26683,1
1,-1,5,180809804,180875621,65817,,0
1,-1,5,180821959,180875621,53662,,0
-1,-1,5,180835713,180904634,68921,,0
1,-1,5,180852761,180875621,22860,,0
-1,1,6,60523,1768235,1707712,2295;56940;55770;2762;3662;135458;94234;2296,8
-1,1,6,152634,5315912,5163278,10455;404220;57128;648791;56940;389362;10667;2762;1992;4835;94234;2296;8899;8737;63027;2295;56897;5269;222826;55770;670;340156;7280;347733;221749;5272;26240;10799;3662;135458;9425,31
-1,1,6,152634,6027780,5875146,57128;56940;94234;2296;9425;63027;51299;222826;670;5272;10799;3662;10455;404220;648791;389362;10667;2762;1992;4835;8899;8737;2295;56897;55770;340156;7280;347733;221749;26240;135458;5269,32
-1,1,6,152634,6290037,6137403,57128;56940;94234;2296;9425;63027;51299;222826;670;5272;10799;3662;10455;404220;648791;389362;10667;2762;1992;2162;4835;8899;8737;2295;56897;55770;340156;7280;347733;221749;26240;135458;5269,33
1,1,6,152634,14417234,14264600,6745;51256;6239;56940;100130357;1832;654;81853;94234;2296;10048;51299;54438;51522;23408;389362;2762;1992;2162;4835;9308;8899;221692;56897;84830;51406;51000;340156;7280;347733;26240;9521;10667;2651;154007;4117;57128;9450;1906;63933;221711;4739;55003;63027;3096;222826;670;9247;5272;10799;285782;3662;107080638;10455;404220;648791;54898;100113407;221687;7020;8737;2295;63915;5269;81567;55770;347744;221710;221749;405754;83732;135458;9425,73
1,1,6,152634,15732394,15579760,6745;51256;6239;56940;100130357;1832;654;81853;94234;2296;10048;84062;51299;54438;51522;23408;389362;2762;1992;2162;4835;9308;8899;221692;56897;84830;51406;51000;340156;7280;347733;26240;9521;10667;2651;154007;4117;57128;9450;1906;63933;221711;4739;55003;63027;3096;222826;3720;670;9247;5272;10799;285782;3662;107080638;10455;404220;648791;54898;100113407;221687;7020;8737;2295;63915;5269;81567;55770;347744;221710;221749;405754;83732;135458;9425,75
-1,-1,6,152664,184808,32144,,0
1,1,6,155807,17058645,16902838,6745;51256;6239;56940;100130357;1832;29116;654;81853;94234;2296;10048;84062;51299;54438;51522;23408;2766;389362;2762;1992;2162;4835;9308;8899;221692;56897;84830;51406;51000;340156;7280;347733;26240;9521;10667;2651;154007;4117;9450;57128;1906;63933;221711;4739;55003;63027;3096;222826;3720;670;9247;5272;10799;285782;3662;107080638;10455;404220;648791;6310;54898;100113407;221687;7020;8737;2295;63915;5269;81567;347744;55770;221710;221749;405754;83732;135458;9425,78
-1,-1,6,156974,233750,76776,,0
-1,1,6,156974,2030623,1873649,2295;56940;55770;2762;3662;135458;94234;2296,8
-1,1,6,156974,4907926,4750952,10455;404220;56940;389362;2762;1992;4835;94234;2296;8899;8737;63027;2295;56897;5269;222826;55770;670;340156;7280;347733;221749;5272;26240;3662;135458;9425,27
-1,1,6,156974,6417749,6260775,57128;56940;94234;2296;9425;63027;51299;222826;670;5272;10799;3662;10455;404220;648791;389362;10667;2762;1992;2162;4835;8899;8737;2295;56897;55770;340156;7280;347733;221749;26240;135458;5269,33
-1,1,6,156974,7122992,6966018,6239;57128;9450;56940;94234;2296;9425;63027;51299;222826;670;5272;10799;3662;10455;404220;648791;389362;10667;2762;1992;2162;4835;8899;8737;2295;56897;55770;340156;7280;347733;221749;26240;135458;5269,35
1,1,6,156974,8349511,8192537,6745;154007;6239;57128;9450;56940;1832;654;94234;2296;9425;63027;51299;9521;222826;670;5272;10799;285782;3662;10455;404220;648791;389362;10667;2762;1992;2162;4835;8899;8737;2295;56897;63915;81567;55770;340156;7280;347733;221749;26240;83732;135458;5269,44
-1,1,6,156974,13856156,13699182,6745;51256;6239;56940;100130357;1832;654;81853;94234;2296;10048;51299;54438;51522;23408;389362;2762;1992;2162;4835;8899;221692;56897;84830;51406;51000;340156;7280;347733;26240;9521;10667;2651;154007;4117;57128;9450;1906;63933;221711;4739;55003;63027;3096;222826;670;9247;5272;10799;285782;3662;107080638;10455;404220;648791;54898;100113407;7020;8737;2295;63915;5269;81567;55770;347744;221710;221749;405754;83732;135458;9425,71
1,1,6,156974,46757028,46600054,56658;401236;57510;10665;80742;1832;9750;23113;8831;720;8340;6046;11329;266727;3135;4439;4201;80740;22875;389362;988;51439;6204;7942;222696;55809;8357;3017;7280;51302;255626;26529;8344;3134;5467;89822;64288;221468;9820;3710;8361;116113;5603;717;6428;8367;2740;221409;51473;7915;8449;6222;6732;26707;404220;648791;6310;442184;100113407;1871;3127;51069;24149;2295;11119;1589;63915;117283;441150;10384;401250;100529239;56244;9436;534;8336;10554;401251;3024;6048;654;23564;84062;896;5292;2766;721;55173;6293;51567;10475;5514;4337;81688;4855;441151;8899;7918;80864;222663;10786;26240;85236;389384;55362;57128;378884;199;116511;1906;170680;8294;8968;6631;58496;3013;347734;8343;8331;3107;387032;7923;79865;2289;107080638;578;9656;135644;54898;10486;100507436;54210;5225;221496;3077;54209;2178;1616;81697;170954;10473;221424;221749;6892;55604;8870;4050;3115;7287;81853;11131;84547;394263;7172;10591;23;51522;57827;26692;116138;107080644;285852;116369;7913;8354;11118;8342;63940;54887;55937;2822;79897;23787;4188;25862;79969;221711;25803;696;8345;221476;1208;7629;6659;6499;10246;5272;353219;51513;27232;5252;59084;8356;7020;282890;8737;9025;83795;7422;80863;389376;221443;81567;347744;8366;7917;135458;171558;23304;8859;79692;129685;6015;100130357;222662;2739;8360;203068;64771;222642;3018;4277;51299;3008;3159;81797;3109;4800;3111;85235;7922;10050;55856;10471;222658;2162;4795;7936;56897;11120;2794;89845;81696;222698;5961;10667;177;26531;1769;7932;285848;64928;340205;3006;259215;5696;9856;10211;50619;401262;63027;442194;285782;3133;8332;629;93643;57497;80317;221472;5429;51053;89870;3117;5698;7940;6745;6239;442191;54901;6882;10048;2296;10107;6941;11165;7919;154467;222659;6568;442186;101929726;3304;29113;8352;4835;80352;9972;8334;26716;6722;51000;340156;26212;9521;8365;84300;8341;3119;2914;1026;8969;63933;4739;7741;55003;55776;6992;54676;63971;2968;8464;4736;10537;670;170679;10799;8346;5987;2978;9587;88745;8369;221710;6257;9425;10919;100188893;101928603;51256;10279;202658;255488;7005;3105;8330;5754;5528;340204;3303;1388;6903;7718;8645;7745;57176;4758;8350;221692;51406;10231;3400;80345;4794;221477;2651;8347;9277;7407;221527;221481;6891;80739;860;10864;54535;55633;23506;3010;7738;221416;80737;221613;7941;140767;50854;8355;55770;8329;154150;83732;1302;221458;2880;8335;3120;65989;94234;23294;9481;29993;114821;7124;346157;23408;221662;8705;705;2979;346171;5460;3305;57819;221400;25844;7148;5190;57699;154141;57505;11074;84830;100507679;51645;28973;1797;389383;8362;202500;9450;114781;51596;23500;84630;80736;100287718;3720;11270;9247;60685;3662;55168;221687;6954;94026;1460;3123;29777;3113;8358;5089;405754;285855;27154;10695;80741;5269;135656;221504;3833;9753;5863;3012;56940;8368;259197;29116;1192;3118;54438;10590;8339;8364;3112;221421;8970;1432;401258;23070;8348;9477;7746;257202;10930;1041;3326;30834;221545;8359;10817;2762;1992;8351;7726;9308;2030;8363;4049;7916;3122;347733;3106;154007;4117;89953;3108;3007;58530;222643;4295;9374;29964;3096;222826;63943;2550;10455;3009;53405;9278;221491;5617;4340;647024;780;221656;9533;8353;57380;10385;6890;7920,532
1,1,6,156975,170919482,170762507,56658;401236;79624;6005;64780;57510;10665;7021;253582;80742;1832;9750;23113;39;8831;720;9053;8340;619208;117289;6046;11329;254394;2898;266727;2853;3135;114327;4439;3298;4201;5314;154091;23345;25998;80740;9590;22875;6582;389362;988;51439;6204;7942;222696;55809;57579;112495;8357;222584;3017;8521;153918;23595;7280;51302;10559;22828;26268;255626;26529;8344;3134;5467;89822;64288;221468;9820;23097;10846;3710;8361;84456;81706;116113;5603;717;135138;6428;285761;8367;115004;2740;55350;6993;221409;2830;51473;7915;154313;116150;8449;6222;6732;5454;9465;5134;594;26707;404220;648791;221294;167826;6310;442184;100113407;1871;3127;55788;57211;114792;79747;55084;51069;24149;2295;11119;5550;1589;64208;63915;5110;117283;441150;27145;83551;10384;401250;1915;23195;6953;22832;100529239;2939;56244;441168;9436;257218;534;8336;84816;10554;401251;3024;6048;654;23564;55510;6492;84062;57221;5558;5169;2941;896;5292;202;728464;222553;79683;2766;721;55173;6293;25957;10690;5570;1347;93663;79632;51567;26034;10475;6206;5514;4337;83887;81688;1310;4855;340168;27242;441151;8899;7918;6648;80864;10321;25901;222663;51660;1300;9474;10786;26240;8838;85236;389384;55362;57128;378884;199;116511;1906;6785;170680;389434;8294;389432;8968;6631;54511;135293;100463487;49861;51390;58496;254228;134701;57531;3013;2569;4646;154075;347734;55166;8343;8331;9841;84870;3107;60487;387032;85315;3097;7923;79865;202559;6098;2289;107080638;578;57621;9656;135644;10345;6581;441155;54898;10486;168090;100507436;54346;94120;90523;154214;54210;5225;221496;57120;3077;245928;54209;2178;79694;1616;81697;170954;10473;221424;8676;221749;10090;6892;55604;6885;57492;221264;83443;8870;23469;135228;90025;340146;1303;4050;55274;154043;3115;8528;7287;81853;11131;2911;22858;60481;84547;394263;7172;9324;10591;23;51522;221301;54806;57827;26692;116138;85313;107080644;4224;80328;285852;116369;7913;8354;10370;8936;8871;11118;2940;4594;389396;9994;8342;28514;101928601;5071;221391;135295;63940;54887;55937;7803;8875;2822;79897;23787;134829;4082;53832;26503;9697;4188;639;7101;84539;25862;84918;79969;221711;25803;4142;696;8345;2173;221476;9038;3482;1208;7629;221357;6659;6499;10246;5272;352999;23118;81847;2037;5191;100130967;353219;51513;27232;84553;3841;51106;5252;59084;8356;6196;29940;7020;282890;8737;9025;83795;7422;25902;4121;80863;389376;135114;221443;81567;347744;8366;7917;57691;29074;9896;1235;83861;340152;135458;171558;23304;4199;8859;10767;79692;129685;6015;26230;100130357;222662;51175;442213;387263;2739;28962;113115;8360;203068;64771;222642;3018;8724;29078;4277;51299;221302;3008;9774;3159;154215;285800;6580;81797;3109;26002;4800;59336;3111;85235;7922;253769;100128124;25821;10050;55856;10471;222658;60682;387082;2162;51429;4795;7936;84498;58527;84154;56897;11120;2794;89845;81696;222698;27283;80129;9519;5961;10667;177;26531;1769;7932;285848;64928;340205;26271;168002;3006;259215;5696;9856;10211;50619;401262;57515;63027;9589;729515;3062;442194;7128;285782;3133;8332;135154;441161;629;93643;57497;114801;348995;23607;80177;80317;221472;6991;4988;51362;245806;5429;51053;383;8732;89870;245927;3117;5698;55603;285753;7940;3351;6745;9439;6239;442191;55122;11104;22881;54901;79627;81578;51389;8504;6882;10048;2296;10107;6941;60468;51534;10492;4216;11165;222545;10973;9749;7919;22999;55005;154467;3834;6943;222659;27244;2099;6568;442186;51557;101929726;9457;3304;29113;404672;8352;4835;80352;23328;9972;8334;26716;6722;11231;51000;340156;26212;3617;2070;26235;9521;8365;55278;84300;8341;167691;134637;4602;3119;64065;2914;1026;8969;63933;4739;55754;57673;345895;7741;55003;55776;6992;54676;63971;2968;79541;8464;7259;167838;4736;10537;670;170679;10799;100128327;8346;5987;577;2978;83741;9587;389421;81491;57231;55227;88745;1297;221262;8369;387119;9892;221710;6257;9532;245915;154197;134860;6908;9425;2697;10919;100188893;101928603;51256;10279;25842;8417;202658;51805;9287;255488;7005;3105;116254;55780;8330;5754;5528;58528;389400;85413;3605;340204;5689;3303;262;387104;1388;285755;6903;11149;7718;8645;222611;7745;57176;4758;23033;8350;2045;221692;51406;10231;3400;80345;4794;10758;221477;221322;5796;2651;167;100130890;117247;8347;9277;7407;221527;221481;51020;100507203;442247;4907;6891;653;80739;860;167681;3066;10864;54535;55633;23506;3010;7738;51167;221416;9096;9113;135152;84947;80737;23036;79981;7058;221613;7941;7430;135112;84085;23593;8635;140767;55023;50854;2938;4829;9729;8355;7272;55770;64094;8329;154150;83732;1302;2729;221458;64577;9444;253714;2880;8335;4217;221303;3120;65989;50508;94234;23294;9481;29993;387357;114821;7124;346157;23408;221662;8705;705;2979;4301;2444;346171;5460;3305;5238;57819;221400;206412;8763;84071;51696;57480;25844;135250;7148;5190;28978;57699;403339;83699;154141;84946;2519;57505;387103;10957;11074;56895;84830;100507679;51250;7180;51645;28973;1797;5232;245913;4172;389383;8362;6610;202500;9450;134728;26575;114781;57583;51596;221393;2534;4018;23493;23500;84630;222546;135398;80736;91749;100287718;3720;11270;892;7432;9247;23270;60685;5167;56479;3662;221336;55168;221687;1081;6954;94026;2309;1460;401265;3123;29777;3113;57038;3910;8358;112609;5089;134864;116379;405754;285855;222537;27154;10695;80741;5269;10981;135656;221504;3833;9753;5863;3012;56940;8368;259197;319100;8876;256380;5340;3354;345930;7957;29116;1192;57150;3118;54438;221395;57224;10590;8339;8364;3112;5350;6446;221421;57107;27115;8970;85015;1490;113402;1268;1432;401285;401258;23070;266977;8348;9477;7746;257202;10930;1041;3326;30834;221545;8359;10817;2762;112611;1992;154064;8351;116843;7726;9308;2030;81833;6950;8363;5980;6862;154288;4049;7916;3122;5325;347733;11116;3908;10924;375519;3106;154007;4117;7162;84694;80329;134957;57226;89953;3108;85021;84624;3007;51715;58530;222643;4295;9374;29964;79465;3096;2570;222826;80759;100507462;63943;26054;112744;667;54516;2550;246269;10455;23376;7164;3009;53405;51465;643854;9278;7402;346007;221491;5617;4340;647024;3459;59351;780;221656;55862;9533;8353;57380;100129128;353091;10385;6890;26036;7920;56995,1010
1,1,6,156975,170919482,170762507,56658;401236;79624;6005;64780;57510;10665;7021;253582;80742;1832;9750;23113;39;8831;720;9053;8340;619208;117289;6046;11329;254394;2898;266727;2853;3135;114327;4439;3298;4201;5314;154091;23345;25998;80740;9590;22875;6582;389362;988;51439;6204;7942;222696;55809;57579;112495;8357;222584;3017;8521;153918;23595;7280;51302;10559;22828;26268;255626;26529;8344;3134;5467;89822;64288;221468;9820;23097;10846;3710;8361;84456;81706;116113;5603;717;135138;6428;285761;8367;115004;2740;55350;6993;221409;2830;51473;7915;154313;116150;8449;6222;6732;5454;9465;5134;594;26707;404220;648791;221294;167826;6310;442184;100113407;1871;3127;55788;57211;114792;79747;55084;51069;24149;2295;11119;5550;1589;64208;63915;5110;117283;441150;27145;83551;10384;401250;1915;23195;6953;22832;100529239;2939;56244;441168;9436;257218;534;8336;84816;10554;401251;3024;6048;654;23564;55510;6492;84062;57221;5558;5169;2941;896;5292;202;728464;222553;79683;2766;721;55173;6293;25957;10690;5570;1347;93663;79632;51567;26034;10475;6206;5514;4337;83887;81688;1310;4855;340168;27242;441151;8899;7918;6648;80864;10321;25901;222663;51660;1300;9474;10786;26240;8838;85236;389384;55362;57128;378884;199;116511;1906;6785;170680;389434;8294;389432;8968;6631;54511;135293;100463487;49861;51390;58496;254228;134701;57531;3013;2569;4646;154075;347734;55166;8343;8331;9841;84870;3107;60487;387032;85315;3097;7923;79865;202559;6098;2289;107080638;578;57621;9656;135644;10345;6581;441155;54898;10486;168090;100507436;54346;94120;90523;154214;54210;5225;221496;57120;3077;245928;54209;2178;79694;1616;81697;170954;10473;221424;8676;221749;10090;6892;55604;6885;57492;221264;83443;8870;23469;135228;90025;340146;1303;4050;55274;154043;3115;8528;7287;81853;11131;2911;22858;60481;84547;394263;7172;9324;10591;23;51522;221301;54806;57827;26692;116138;85313;107080644;4224;80328;285852;116369;7913;8354;10370;8936;8871;11118;2940;4594;389396;9994;8342;28514;101928601;5071;221391;135295;63940;54887;55937;7803;8875;2822;79897;23787;134829;4082;53832;26503;9697;4188;639;7101;84539;25862;84918;79969;221711;25803;4142;696;8345;2173;221476;9038;3482;1208;7629;221357;6659;6499;10246;5272;352999;23118;81847;2037;5191;100130967;353219;51513;27232;84553;3841;51106;5252;59084;8356;6196;29940;7020;282890;8737;9025;83795;7422;25902;4121;80863;389376;135114;221443;81567;347744;8366;7917;57691;29074;9896;1235;83861;340152;135458;171558;23304;4199;8859;10767;79692;129685;6015;26230;100130357;222662;51175;442213;387263;2739;28962;113115;8360;203068;64771;222642;3018;8724;29078;4277;51299;221302;3008;9774;3159;154215;285800;6580;81797;3109;26002;4800;59336;3111;85235;7922;253769;100128124;25821;10050;55856;10471;222658;60682;387082;2162;51429;4795;7936;84498;58527;84154;56897;11120;2794;89845;81696;222698;27283;80129;9519;5961;10667;177;26531;1769;7932;285848;64928;340205;26271;168002;3006;259215;5696;9856;10211;50619;401262;57515;63027;9589;729515;3062;442194;7128;285782;3133;8332;135154;441161;629;93643;57497;114801;348995;23607;80177;80317;221472;6991;4988;51362;245806;5429;51053;383;8732;89870;245927;3117;5698;55603;285753;7940;3351;6745;9439;6239;442191;55122;11104;22881;54901;79627;81578;51389;8504;6882;10048;2296;10107;6941;60468;51534;10492;4216;11165;222545;10973;9749;7919;22999;55005;154467;3834;6943;222659;27244;2099;6568;442186;51557;101929726;9457;3304;29113;404672;8352;4835;80352;23328;9972;8334;26716;6722;11231;51000;340156;26212;3617;2070;26235;9521;8365;55278;84300;8341;167691;134637;4602;3119;64065;2914;1026;8969;63933;4739;55754;57673;345895;7741;55003;55776;6992;54676;63971;2968;79541;8464;7259;167838;4736;10537;670;170679;10799;100128327;8346;5987;577;2978;83741;9587;389421;81491;57231;55227;88745;1297;221262;8369;387119;9892;221710;6257;9532;245915;154197;134860;6908;9425;2697;10919;100188893;101928603;51256;10279;25842;8417;202658;51805;9287;255488;7005;3105;116254;55780;8330;5754;5528;58528;389400;85413;3605;340204;5689;3303;262;387104;1388;285755;6903;11149;7718;8645;222611;7745;57176;4758;23033;8350;2045;221692;51406;10231;3400;80345;4794;10758;221477;221322;5796;2651;167;100130890;117247;8347;9277;7407;221527;221481;51020;100507203;442247;4907;6891;653;80739;860;167681;3066;10864;54535;55633;23506;3010;7738;51167;221416;9096;9113;135152;84947;80737;23036;79981;7058;221613;7941;7430;135112;84085;23593;8635;140767;55023;50854;2938;4829;9729;8355;7272;55770;64094;8329;154150;83732;1302;2729;221458;64577;9444;253714;2880;8335;4217;221303;3120;65989;50508;94234;23294;9481;29993;387357;114821;7124;346157;23408;221662;8705;705;2979;4301;2444;346171;5460;3305;5238;57819;221400;206412;8763;84071;51696;57480;25844;135250;7148;5190;28978;57699;403339;83699;154141;84946;2519;57505;387103;10957;11074;56895;84830;100507679;51250;7180;51645;28973;1797;5232;245913;4172;389383;8362;6610;202500;9450;134728;26575;114781;57583;51596;221393;2534;4018;23493;23500;84630;222546;135398;80736;91749;100287718;3720;11270;892;7432;9247;23270;60685;5167;56479;3662;221336;55168;221687;1081;6954;94026;2309;1460;401265;3123;29777;3113;57038;3910;8358;112609;5089;134864;116379;405754;285855;222537;27154;10695;80741;5269;10981;135656;221504;3833;9753;5863;3012;56940;8368;259197;319100;8876;256380;5340;3354;345930;7957;29116;1192;57150;3118;54438;221395;57224;10590;8339;8364;3112;5350;6446;221421;57107;27115;8970;85015;1490;113402;1268;1432;401285;401258;23070;266977;8348;9477;7746;257202;10930;1041;3326;30834;221545;8359;10817;2762;112611;1992;154064;8351;116843;7726;9308;2030;81833;6950;8363;5980;6862;154288;4049;7916;3122;5325;347733;11116;3908;10924;375519;3106;154007;4117;7162;84694;80329;134957;57226;89953;3108;85021;84624;3007;51715;58530;222643;4295;9374;29964;79465;3096;2570;222826;80759;100507462;63943;26054;112744;667;54516;2550;246269;10455;23376;7164;3009;53405;51465;643854;9278;7402;346007;221491;5617;4340;647024;3459;59351;780;221656;55862;9533;8353;57380;100129128;353091;10385;6890;26036;7920;56995,1010
-1,-1,6,163083,184838,21755,,0
1,-1,6,163083,293493,130410,56940,1
1,-1,6,163083,307998,144915,56940,1
1,1,6,163083,2029765,1866682,2295;56940;55770;2762;3662;135458;94234;2296,8
-1,1,6,163083,3459841,3296758,56940;389362;2762;1992;4835;94234;2296;8737;63027;2295;56897;55770;670;340156;7280;347733;5272;3662;135458;5269,20
1,1,6,163083,9525729,9362646,6745;154007;6239;57128;9450;56940;1832;654;94234;2296;9425;63027;51299;9521;222826;670;5272;10799;285782;3662;10455;404220;648791;389362;10667;2762;1992;2162;4835;8899;8737;2295;56897;63915;81567;55770;340156;7280;51000;347733;221749;26240;83732;135458;5269,45
1,-1,6,164360,293497,129137,56940,1
1,1,6,164360,13340113,13175753,6745;51256;6239;56940;100130357;1832;654;81853;94234;2296;51299;51522;389362;2762;1992;2162;4835;8899;221692;56897;84830;51000;340156;7280;347733;26240;9521;10667;2651;154007;4117;57128;9450;1906;221711;4739;55003;63027;3096;222826;670;9247;5272;10799;285782;3662;107080638;10455;404220;648791;54898;100113407;7020;8737;2295;63915;5269;81567;55770;347744;221710;221749;405754;83732;135458;9425,66
-1,1,6,170426,1622218,1451792,55770;2295;56940;3662;135458;94234;2296,7
-1,1,6,195229,2117379,1922150,2295;56940;55770;2762;3662;135458;94234;2296,8
-1,-1,6,221768,339802,118034,56940,1
-1,-1,6,229815,293493,63678,56940,1
1,-1,6,241739,339797,98058,56940,1
1,-1,6,253107,293497,40390,56940,1
1,-1,6,253107,293782,40675,56940,1
1,-1,6,255324,339797,84473,56940,1
1,-1,6,255324,339797,84473,56940,1
1,-1,6,255324,339797,84473,56940,1
1,-1,6,255350,283860,28510,,0
-1,-1,6,255380,366778,111398,56940,1
1,-1,6,259318,279373,20055,,0
1,-1,6,259318,283860,24542,,0
1,-1,6,259318,289174,29856,,0
-1,-1,6,259318,289174,29856,,0
-1,-1,6,259318,289174,29856,,0
1,-1,6,259318,289174,29856,,0
1,-1,6,259318,289174,29856,,0
1,-1,6,259318,289174,29856,,0
1,-1,6,259318,289174,29856,,0
1,-1,6,259318,289174,29856,,0
1,-1,6,259318,289174,29856,,0
1,-1,6,259318,289174,29856,,0
1,-1,6,259318,289174,29856,,0
1,-1,6,259318,289174,29856,,0
-1,-1,6,259318,289174,29856,,0
-1,-1,6,259318,293615,34297,56940,1
-1,-1,6,259318,293615,34297,56940,1
1,-1,6,259318,293615,34297,56940,1
1,-1,6,259318,293615,34297,56940,1
-1,-1,6,259318,293615,34297,56940,1
-1,-1,6,259318,293615,34297,56940,1
-1,-1,6,259318,293615,34297,56940,1
1,-1,6,259318,293615,34297,56940,1
1,-1,6,259318,296733,37415,56940,1
1,-1,6,259318,296733,37415,56940,1
1,-1,6,259318,301907,42589,56940,1
-1,-1,6,259318,307998,48680,56940,1
-1,-1,6,259318,307998,48680,56940,1
-1,-1,6,259318,307998,48680,56940,1
-1,-1,6,259318,339802,80484,56940,1
-1,-1,6,259318,339802,80484,56940,1
-1,-1,6,259318,339802,80484,56940,1
-1,-1,6,259318,339802,80484,56940,1
-1,-1,6,259318,339802,80484,56940,1
-1,-1,6,259318,339802,80484,56940,1
-1,-1,6,259318,339802,80484,56940,1
-1,-1,6,259318,339802,80484,56940,1
-1,-1,6,259318,339802,80484,56940,1
1,-1,6,259318,339802,80484,56940,1
-1,-1,6,259318,339802,80484,56940,1
-1,-1,6,259318,339802,80484,56940,1
1,-1,6,259318,339802,80484,56940,1
-1,-1,6,259318,339802,80484,56940,1
1,-1,6,259318,339802,80484,56940,1
-1,-1,6,259318,339802,80484,56940,1
-1,-1,6,259345,289144,29799,,0
-1,-1,6,259345,293592,34247,56940,1
1,-1,6,259345,296704,37359,56940,1
-1,-1,6,259345,350238,90893,56940,1
-1,-1,6,259345,366778,107433,56940,1
-1,-1,6,259345,366778,107433,56940,1
-1,-1,6,259528,293493,33965,56940,1
-1,-1,6,259528,293493,33965,56940,1
-1,-1,6,259528,293493,33965,56940,1
-1,-1,6,259528,293493,33965,56940,1
-1,-1,6,259528,293493,33965,56940,1
-1,-1,6,259528,293493,33965,56940,1
-1,-1,6,259528,293493,33965,56940,1
1,-1,6,259528,293493,33965,56940,1
-1,-1,6,259528,293493,33965,56940,1
1,-1,6,259528,293493,33965,56940,1
-1,-1,6,259528,293493,33965,56940,1
-1,-1,6,259528,293493,33965,56940,1
-1,-1,6,259528,293493,33965,56940,1
-1,-1,6,259528,293493,33965,56940,1
-1,-1,6,259528,293493,33965,56940,1
-1,-1,6,259528,293493,33965,56940,1
-1,-1,6,259528,293493,33965,56940,1
-1,-1,6,259528,293493,33965,56940,1
-1,-1,6,259528,293493,33965,56940,1
-1,-1,6,259528,293493,33965,56940,1
-1,-1,6,259528,293493,33965,56940,1
1,-1,6,259528,293493,33965,56940,1
-1,-1,6,259528,293493,33965,56940,1
1,-1,6,259528,293493,33965,56940,1
-1,-1,6,259528,293493,33965,56940,1
1,-1,6,259528,293493,33965,56940,1
1,-1,6,259528,293493,33965,56940,1
-1,-1,6,259528,293493,33965,56940,1
1,-1,6,259528,293493,33965,56940,1
1,-1,6,259528,293493,33965,56940,1
1,-1,6,259528,293493,33965,56940,1
1,-1,6,259528,293493,33965,56940,1
-1,-1,6,259528,293493,33965,56940,1
1,-1,6,259528,293493,33965,56940,1
1,-1,6,259528,293493,33965,56940,1
-1,-1,6,259528,293493,33965,56940,1
-1,-1,6,259528,293493,33965,56940,1
-1,-1,6,259528,293493,33965,56940,1
1,-1,6,259528,293493,33965,56940,1
-1,-1,6,259528,293493,33965,56940,1
1,-1,6,259528,293493,33965,56940,1
-1,-1,6,259528,293493,33965,56940,1
-1,-1,6,259528,293493,33965,56940,1
-1,-1,6,259528,293493,33965,56940,1
-1,-1,6,259528,293493,33965,56940,1
-1,-1,6,259528,293493,33965,56940,1
-1,-1,6,259528,293493,33965,56940,1
-1,-1,6,259528,293493,33965,56940,1
-1,-1,6,259528,293493,33965,56940,1
1,-1,6,259528,293493,33965,56940,1
1,-1,6,259528,293493,33965,56940,1
1,-1,6,259528,293493,33965,56940,1
-1,-1,6,259528,293493,33965,56940,1
-1,-1,6,259528,293493,33965,56940,1
1,-1,6,259528,293493,33965,56940,1
-1,-1,6,259528,293493,33965,56940,1
-1,-1,6,259528,293493,33965,56940,1
-1,-1,6,259528,293493,33965,56940,1
-1,-1,6,259528,293493,33965,56940,1
-1,-1,6,259528,293493,33965,56940,1
-1,-1,6,259528,293493,33965,56940,1
1,-1,6,259528,293493,33965,56940,1
-1,-1,6,259528,293493,33965,56940,1
-1,-1,6,259528,293493,33965,56940,1
-1,-1,6,259528,293493,33965,56940,1
-1,-1,6,259528,293493,33965,56940,1
1,-1,6,259528,293493,33965,56940,1
1,-1,6,259528,293493,33965,56940,1
1,-1,6,259528,293493,33965,56940,1
1,-1,6,259528,293493,33965,56940,1
-1,-1,6,259528,293493,33965,56940,1
-1,-1,6,259528,293493,33965,56940,1
-1,-1,6,259528,293493,33965,56940,1
-1,-1,6,259528,293493,33965,56940,1
-1,-1,6,259528,293493,33965,56940,1
-1,-1,6,259528,293493,33965,56940,1
1,-1,6,259528,293493,33965,56940,1
-1,-1,6,259528,293493,33965,56940,1
-1,-1,6,259528,293493,33965,56940,1
1,-1,6,259528,293493,33965,56940,1
1,-1,6,259528,293493,33965,56940,1
1,-1,6,259528,293493,33965,56940,1
1,-1,6,259528,293493,33965,56940,1
-1,-1,6,259528,293493,33965,56940,1
1,-1,6,259528,293493,33965,56940,1
-1,-1,6,259528,293493,33965,56940,1
-1,-1,6,259528,293493,33965,56940,1
-1,-1,6,259528,293493,33965,56940,1
1,-1,6,259528,293493,33965,56940,1
-1,-1,6,259528,293493,33965,56940,1
1,-1,6,259528,293493,33965,56940,1
-1,-1,6,259528,293493,33965,56940,1
-1,-1,6,259528,293493,33965,56940,1
-1,-1,6,259528,293493,33965,56940,1
-1,-1,6,259528,293493,33965,56940,1
-1,-1,6,259528,293493,33965,56940,1
-1,-1,6,259528,293493,33965,56940,1
-1,-1,6,259528,293493,33965,56940,1
-1,-1,6,259528,293493,33965,56940,1
1,-1,6,259528,293493,33965,56940,1
-1,-1,6,259528,293493,33965,56940,1
-1,-1,6,259528,293493,33965,56940,1
-1,-1,6,259528,293493,33965,56940,1
-1,-1,6,259528,293493,33965,56940,1
-1,-1,6,259528,293493,33965,56940,1
-1,-1,6,259528,293493,33965,56940,1
1,-1,6,259528,293493,33965,56940,1
-1,-1,6,259528,293493,33965,56940,1
-1,-1,6,259528,293493,33965,56940,1
-1,-1,6,259528,293493,33965,56940,1
1,-1,6,259528,293493,33965,56940,1
-1,-1,6,259528,293493,33965,56940,1
-1,-1,6,259528,293493,33965,56940,1
-1,-1,6,259528,293493,33965,56940,1
-1,-1,6,259528,293493,33965,56940,1
-1,-1,6,259528,293493,33965,56940,1
-1,-1,6,259528,293493,33965,56940,1
-1,-1,6,259528,293493,33965,56940,1
-1,-1,6,259528,293493,33965,56940,1
-1,-1,6,259528,293493,33965,56940,1
1,-1,6,259528,293493,33965,56940,1
-1,-1,6,259528,293493,33965,56940,1
-1,-1,6,259528,293493,33965,56940,1
1,-1,6,259528,293493,33965,56940,1
-1,-1,6,259528,293493,33965,56940,1
1,-1,6,259528,293493,33965,56940,1
-1,-1,6,259528,293493,33965,56940,1
-1,-1,6,259528,293493,33965,56940,1
1,-1,6,259528,293493,33965,56940,1
-1,-1,6,259528,293493,33965,56940,1
-1,-1,6,259528,293493,33965,56940,1
1,-1,6,259528,293493,33965,56940,1
-1,-1,6,259528,293493,33965,56940,1
1,-1,6,259528,293493,33965,56940,1
1,-1,6,259528,293493,33965,56940,1
1,-1,6,259528,293493,33965,56940,1
-1,-1,6,259528,293493,33965,56940,1
-1,-1,6,259528,293493,33965,56940,1
-1,-1,6,259528,293493,33965,56940,1
-1,-1,6,259528,293493,33965,56940,1
-1,-1,6,259528,293493,33965,56940,1
-1,-1,6,259528,293493,33965,56940,1
1,-1,6,259528,293493,33965,56940,1
-1,-1,6,259528,293493,33965,56940,1
-1,-1,6,259528,293493,33965,56940,1
1,-1,6,259528,293493,33965,56940,1
1,-1,6,259528,293493,33965,56940,1
1,-1,6,259528,293493,33965,56940,1
1,-1,6,259528,293493,33965,56940,1
-1,-1,6,259528,293493,33965,56940,1
1,-1,6,259528,293493,33965,56940,1
-1,-1,6,259528,293493,33965,56940,1
-1,-1,6,259528,293493,33965,56940,1
-1,-1,6,259528,307998,48470,56940,1
-1,-1,6,259528,307998,48470,56940,1
-1,-1,6,259528,307998,48470,56940,1
1,-1,6,259528,307998,48470,56940,1
1,-1,6,259528,307998,48470,56940,1
-1,-1,6,259528,307998,48470,56940,1
-1,-1,6,259528,307998,48470,56940,1
-1,-1,6,259528,307998,48470,56940,1
-1,-1,6,259528,307998,48470,56940,1
-1,-1,6,259528,307998,48470,56940,1
-1,-1,6,259528,307998,48470,56940,1
-1,-1,6,259528,307998,48470,56940,1
-1,-1,6,259528,307998,48470,56940,1
-1,-1,6,259528,307998,48470,56940,1
-1,-1,6,259528,307998,48470,56940,1
-1,-1,6,259528,307998,48470,56940,1
-1,-1,6,259528,307998,48470,56940,1
-1,-1,6,259528,307998,48470,56940,1
-1,-1,6,259528,307998,48470,56940,1
-1,-1,6,259528,307998,48470,56940,1
-1,-1,6,259528,307998,48470,56940,1
-1,-1,6,259528,307998,48470,56940,1
-1,-1,6,259528,307998,48470,56940,1
-1,-1,6,259528,307998,48470,56940,1
-1,-1,6,259528,307998,48470,56940,1
-1,-1,6,259528,307998,48470,56940,1
-1,-1,6,259528,339802,80274,56940,1
-1,-1,6,259528,339802,80274,56940,1
-1,-1,6,259528,339802,80274,56940,1
-1,-1,6,259528,339802,80274,56940,1
-1,-1,6,259528,339802,80274,56940,1
-1,-1,6,259528,339802,80274,56940,1
-1,-1,6,259528,339802,80274,56940,1
-1,-1,6,259528,339802,80274,56940,1
-1,-1,6,259528,339802,80274,56940,1
-1,-1,6,259528,339802,80274,56940,1
-1,-1,6,259528,339802,80274,56940,1
-1,-1,6,259528,339802,80274,56940,1
1,-1,6,259528,339802,80274,56940,1
-1,-1,6,259528,339802,80274,56940,1
-1,-1,6,259528,339802,80274,56940,1
-1,-1,6,259528,339802,80274,56940,1
-1,-1,6,259528,339802,80274,56940,1
-1,-1,6,259528,339802,80274,56940,1
-1,-1,6,259528,339802,80274,56940,1
-1,-1,6,259528,339802,80274,56940,1
1,-1,6,259528,339802,80274,56940,1
-1,-1,6,259528,339802,80274,56940,1
-1,-1,6,259528,339802,80274,56940,1
-1,-1,6,259528,339802,80274,56940,1
-1,-1,6,259528,339802,80274,56940,1
-1,-1,6,259528,339802,80274,56940,1
-1,-1,6,259528,339802,80274,56940,1
-1,-1,6,259528,339802,80274,56940,1
-1,-1,6,259528,339802,80274,56940,1
-1,-1,6,259528,339802,80274,56940,1
-1,-1,6,259528,339802,80274,56940,1
-1,-1,6,259528,339802,80274,56940,1
-1,-1,6,259528,339802,80274,56940,1
-1,-1,6,259528,339802,80274,56940,1
-1,-1,6,259528,339802,80274,56940,1
-1,-1,6,259528,339802,80274,56940,1
-1,-1,6,259528,339802,80274,56940,1
-1,-1,6,259528,339802,80274,56940,1
-1,-1,6,259528,339802,80274,56940,1
1,-1,6,259528,339802,80274,56940,1
-1,-1,6,259528,339802,80274,56940,1
-1,-1,6,259528,339802,80274,56940,1
-1,-1,6,259528,339802,80274,56940,1
-1,-1,6,259528,339802,80274,56940,1
1,-1,6,259528,339802,80274,56940,1
1,-1,6,259528,339802,80274,56940,1
-1,-1,6,259528,339802,80274,56940,1
1,-1,6,259528,339802,80274,56940,1
-1,-1,6,259528,339802,80274,56940,1
-1,-1,6,259528,339802,80274,56940,1
-1,-1,6,259528,339802,80274,56940,1
-1,-1,6,259528,339802,80274,56940,1
1,-1,6,259528,339802,80274,56940,1
-1,-1,6,259528,339802,80274,56940,1
1,-1,6,259528,339802,80274,56940,1
-1,-1,6,259528,339802,80274,56940,1
-1,-1,6,259528,339802,80274,56940,1
-1,-1,6,259528,339802,80274,56940,1
-1,-1,6,259528,339802,80274,56940,1
1,-1,6,259528,339802,80274,56940,1
-1,-1,6,259528,339802,80274,56940,1
-1,-1,6,259528,339802,80274,56940,1
-1,-1,6,259528,339802,80274,56940,1
-1,-1,6,259528,339802,80274,56940,1
1,-1,6,259528,339802,80274,56940,1
-1,-1,6,259528,339802,80274,56940,1
-1,-1,6,259528,339802,80274,56940,1
-1,-1,6,259528,339802,80274,56940,1
-1,-1,6,259528,339802,80274,56940,1
-1,-1,6,259528,339802,80274,56940,1
-1,-1,6,259528,339802,80274,56940,1
-1,-1,6,259528,339802,80274,56940,1
-1,-1,6,259528,339802,80274,56940,1
-1,-1,6,259528,339802,80274,56940,1
-1,-1,6,259528,339802,80274,56940,1
-1,-1,6,259528,339802,80274,56940,1
-1,-1,6,259528,339802,80274,56940,1
-1,-1,6,259528,339802,80274,56940,1
-1,-1,6,259528,339802,80274,56940,1
-1,-1,6,259528,339802,80274,56940,1
-1,-1,6,259528,339802,80274,56940,1
1,-1,6,259528,339802,80274,56940,1
1,-1,6,259528,339802,80274,56940,1
-1,-1,6,259528,339802,80274,56940,1
1,-1,6,259528,339802,80274,56940,1
-1,-1,6,259528,339802,80274,56940,1
-1,-1,6,259528,339802,80274,56940,1
-1,-1,6,259528,339802,80274,56940,1
1,-1,6,259528,339802,80274,56940,1
1,-1,6,259528,339802,80274,56940,1
-1,-1,6,259528,339802,80274,56940,1
-1,-1,6,259528,339802,80274,56940,1
-1,-1,6,259528,339802,80274,56940,1
1,-1,6,259528,339802,80274,56940,1
-1,-1,6,259528,339802,80274,56940,1
-1,-1,6,259528,339802,80274,56940,1
-1,-1,6,259528,339802,80274,56940,1
-1,-1,6,259528,339802,80274,56940,1
-1,-1,6,259528,339802,80274,56940,1
-1,-1,6,259528,339802,80274,56940,1
-1,-1,6,259528,339802,80274,56940,1
-1,-1,6,259528,339802,80274,56940,1
-1,-1,6,259528,339802,80274,56940,1
-1,-1,6,259528,339802,80274,56940,1
-1,-1,6,259528,339802,80274,56940,1
-1,-1,6,259528,339802,80274,56940,1
-1,-1,6,259528,339802,80274,56940,1
-1,-1,6,259528,339802,80274,56940,1
-1,-1,6,259528,339802,80274,56940,1
-1,-1,6,259528,339802,80274,56940,1
-1,-1,6,259528,339802,80274,56940,1
-1,-1,6,259528,339802,80274,56940,1
-1,-1,6,259528,339802,80274,56940,1
-1,-1,6,259528,339802,80274,56940,1
-1,-1,6,259528,339802,80274,56940,1
-1,-1,6,259528,339802,80274,56940,1
-1,-1,6,259528,339802,80274,56940,1
-1,-1,6,259528,339802,80274,56940,1
-1,-1,6,259528,339802,80274,56940,1
-1,-1,6,259528,339802,80274,56940,1
1,-1,6,259528,339802,80274,56940,1
-1,-1,6,259528,339802,80274,56940,1
-1,-1,6,259528,339802,80274,56940,1
-1,-1,6,259528,339802,80274,56940,1
-1,-1,6,259528,339802,80274,56940,1
-1,-1,6,259528,339802,80274,56940,1
-1,-1,6,259528,339802,80274,56940,1
-1,-1,6,259528,339802,80274,56940,1
-1,-1,6,259528,339802,80274,56940,1
-1,-1,6,259528,339802,80274,56940,1
-1,-1,6,259528,339802,80274,56940,1
-1,-1,6,259528,339802,80274,56940,1
-1,-1,6,259528,339802,80274,56940,1
-1,-1,6,259528,339802,80274,56940,1
-1,-1,6,259528,339802,80274,56940,1
-1,-1,6,259528,339802,80274,56940,1
-1,-1,6,259528,339802,80274,56940,1
-1,-1,6,259528,339802,80274,56940,1
-1,-1,6,259528,339802,80274,56940,1
-1,-1,6,259528,339802,80274,56940,1
-1,-1,6,259528,339802,80274,56940,1
-1,-1,6,259528,339802,80274,56940,1
-1,-1,6,259528,339802,80274,56940,1
-1,-1,6,259528,339802,80274,56940,1
-1,-1,6,259528,339802,80274,56940,1
-1,-1,6,259528,339802,80274,56940,1
-1,-1,6,259528,339802,80274,56940,1
-1,-1,6,259528,339802,80274,56940,1
-1,-1,6,259528,339802,80274,56940,1
-1,-1,6,259528,339802,80274,56940,1
-1,-1,6,259528,339802,80274,56940,1
-1,-1,6,259528,339802,80274,56940,1
-1,-1,6,259528,339802,80274,56940,1
-1,-1,6,259528,339802,80274,56940,1
-1,-1,6,259528,339802,80274,56940,1
-1,-1,6,259528,339802,80274,56940,1
-1,-1,6,259528,339802,80274,56940,1
-1,-1,6,259528,339802,80274,56940,1
-1,-1,6,259528,339802,80274,56940,1
-1,-1,6,259528,339802,80274,56940,1
-1,-1,6,259528,339802,80274,56940,1
-1,-1,6,259528,339802,80274,56940,1
-1,-1,6,259528,339802,80274,56940,1
-1,-1,6,259528,339802,80274,56940,1
-1,-1,6,259528,339802,80274,56940,1
-1,-1,6,259528,339802,80274,56940,1
-1,-1,6,259528,339802,80274,56940,1
-1,-1,6,259528,339802,80274,56940,1
-1,-1,6,259528,339802,80274,56940,1
-1,-1,6,259528,339802,80274,56940,1
-1,-1,6,259528,339802,80274,56940,1
1,-1,6,259528,339802,80274,56940,1
-1,-1,6,259528,339802,80274,56940,1
-1,-1,6,259528,339802,80274,56940,1
-1,-1,6,259528,339802,80274,56940,1
-1,-1,6,259528,339802,80274,56940,1
-1,-1,6,259528,339802,80274,56940,1
-1,-1,6,259528,339802,80274,56940,1
-1,-1,6,259528,339802,80274,56940,1
-1,-1,6,259528,339802,80274,56940,1
1,-1,6,259528,339802,80274,56940,1
-1,-1,6,259528,339802,80274,56940,1
-1,-1,6,259528,339802,80274,56940,1
-1,-1,6,259528,339802,80274,56940,1
1,-1,6,259528,339802,80274,56940,1
1,-1,6,259528,339802,80274,56940,1
1,-1,6,259528,339802,80274,56940,1
-1,-1,6,259528,339802,80274,56940,1
1,-1,6,259528,339802,80274,56940,1
1,-1,6,259528,339802,80274,56940,1
1,-1,6,259528,339802,80274,56940,1
-1,-1,6,259528,339802,80274,56940,1
-1,-1,6,259528,339802,80274,56940,1
-1,-1,6,259528,339802,80274,56940,1
-1,-1,6,259528,339802,80274,56940,1
1,-1,6,259528,339802,80274,56940,1
-1,-1,6,259528,339802,80274,56940,1
-1,-1,6,259528,339802,80274,56940,1
-1,-1,6,259528,339802,80274,56940,1
-1,-1,6,259528,339802,80274,56940,1
-1,-1,6,259528,339802,80274,56940,1
-1,-1,6,259528,339802,80274,56940,1
-1,-1,6,259528,339802,80274,56940,1
-1,-1,6,259528,339802,80274,56940,1
-1,-1,6,259528,339802,80274,56940,1
1,-1,6,259528,350265,90737,56940,1
1,-1,6,259528,350265,90737,56940,1
1,-1,6,259528,350265,90737,56940,1
-1,-1,6,259528,350265,90737,56940,1
-1,-1,6,259528,350265,90737,56940,1
-1,-1,6,259528,350265,90737,56940,1
-1,-1,6,259528,350265,90737,56940,1
-1,-1,6,259528,350265,90737,56940,1
-1,-1,6,259528,350265,90737,56940,1
-1,-1,6,259528,389482,129954,56940,1
-1,-1,6,259528,389482,129954,56940,1
-1,-1,6,259528,389482,129954,56940,1
-1,-1,6,259528,389482,129954,56940,1
-1,-1,6,259528,389482,129954,56940,1
-1,-1,6,259528,389482,129954,56940,1
-1,-1,6,259528,389482,129954,56940,1
1,-1,6,259531,284008,24477,,0
1,-1,6,259531,289298,29767,,0
1,-1,6,259531,289298,29767,,0
1,-1,6,259531,289298,29767,,0
1,-1,6,259531,289298,29767,,0
1,-1,6,259531,289298,29767,,0
1,-1,6,259531,289298,29767,,0
1,-1,6,259531,289298,29767,,0
1,-1,6,259531,289298,29767,,0
1,-1,6,259531,289298,29767,,0
1,-1,6,259531,289298,29767,,0
1,-1,6,259531,289298,29767,,0
1,-1,6,259531,289298,29767,,0
1,-1,6,259531,289298,29767,,0
1,-1,6,259531,289298,29767,,0
1,-1,6,259531,289298,29767,,0
1,-1,6,259531,289298,29767,,0
1,-1,6,259531,289298,29767,,0
1,-1,6,259531,289298,29767,,0
1,-1,6,259531,289298,29767,,0
-1,-1,6,259531,293497,33966,56940,1
-1,-1,6,259531,293497,33966,56940,1
-1,-1,6,259531,293497,33966,56940,1
-1,-1,6,259531,293497,33966,56940,1
-1,-1,6,259531,293497,33966,56940,1
-1,-1,6,259531,293497,33966,56940,1
-1,-1,6,259531,293497,33966,56940,1
1,-1,6,259531,293497,33966,56940,1
-1,-1,6,259531,293497,33966,56940,1
-1,-1,6,259531,293497,33966,56940,1
-1,-1,6,259531,293497,33966,56940,1
-1,-1,6,259531,293497,33966,56940,1
-1,-1,6,259531,293497,33966,56940,1
-1,-1,6,259531,293497,33966,56940,1
-1,-1,6,259531,293497,33966,56940,1
-1,-1,6,259531,293497,33966,56940,1
1,-1,6,259531,293497,33966,56940,1
-1,-1,6,259531,293497,33966,56940,1
-1,-1,6,259531,293497,33966,56940,1
-1,-1,6,259531,293497,33966,56940,1
-1,-1,6,259531,293497,33966,56940,1
-1,-1,6,259531,293497,33966,56940,1
-1,-1,6,259531,293497,33966,56940,1
-1,-1,6,259531,293497,33966,56940,1
-1,-1,6,259531,293497,33966,56940,1
-1,-1,6,259531,293497,33966,56940,1
-1,-1,6,259531,293497,33966,56940,1
-1,-1,6,259531,293497,33966,56940,1
1,-1,6,259531,293497,33966,56940,1
-1,-1,6,259531,293497,33966,56940,1
-1,-1,6,259531,293497,33966,56940,1
-1,-1,6,259531,293497,33966,56940,1
-1,-1,6,259531,293497,33966,56940,1
-1,-1,6,259531,293497,33966,56940,1
-1,-1,6,259531,293497,33966,56940,1
-1,-1,6,259531,293497,33966,56940,1
-1,-1,6,259531,293497,33966,56940,1
1,-1,6,259531,293497,33966,56940,1
-1,-1,6,259531,293497,33966,56940,1
-1,-1,6,259531,293497,33966,56940,1
-1,-1,6,259531,293497,33966,56940,1
1,-1,6,259531,293497,33966,56940,1
1,-1,6,259531,293497,33966,56940,1
-1,-1,6,259531,293497,33966,56940,1
-1,-1,6,259531,293497,33966,56940,1
-1,-1,6,259531,293497,33966,56940,1
1,-1,6,259531,293497,33966,56940,1
-1,-1,6,259531,293497,33966,56940,1
1,-1,6,259531,293497,33966,56940,1
1,-1,6,259531,293497,33966,56940,1
-1,-1,6,259531,293497,33966,56940,1
-1,-1,6,259531,293497,33966,56940,1
-1,-1,6,259531,293497,33966,56940,1
1,-1,6,259531,293497,33966,56940,1
1,-1,6,259531,293497,33966,56940,1
-1,-1,6,259531,293497,33966,56940,1
-1,-1,6,259531,293497,33966,56940,1
-1,-1,6,259531,293497,33966,56940,1
1,-1,6,259531,293497,33966,56940,1
1,-1,6,259531,293497,33966,56940,1
-1,-1,6,259531,293497,33966,56940,1
1,-1,6,259531,293497,33966,56940,1
1,-1,6,259531,293497,33966,56940,1
-1,-1,6,259531,293497,33966,56940,1
1,-1,6,259531,293497,33966,56940,1
1,-1,6,259531,293497,33966,56940,1
-1,-1,6,259531,293497,33966,56940,1
1,-1,6,259531,293497,33966,56940,1
1,-1,6,259531,293497,33966,56940,1
1,-1,6,259531,293497,33966,56940,1
1,-1,6,259531,293497,33966,56940,1
-1,-1,6,259531,293497,33966,56940,1
-1,-1,6,259531,293497,33966,56940,1
-1,-1,6,259531,293497,33966,56940,1
-1,-1,6,259531,293497,33966,56940,1
1,-1,6,259531,293497,33966,56940,1
-1,-1,6,259531,293497,33966,56940,1
1,-1,6,259531,293497,33966,56940,1
-1,-1,6,259531,293497,33966,56940,1
-1,-1,6,259531,293497,33966,56940,1
-1,-1,6,259531,293497,33966,56940,1
-1,-1,6,259531,293497,33966,56940,1
-1,-1,6,259531,293497,33966,56940,1
-1,-1,6,259531,293497,33966,56940,1
-1,-1,6,259531,293497,33966,56940,1
-1,-1,6,259531,293497,33966,56940,1
-1,-1,6,259531,293497,33966,56940,1
-1,-1,6,259531,293497,33966,56940,1
1,-1,6,259531,293497,33966,56940,1
1,-1,6,259531,293497,33966,56940,1
-1,-1,6,259531,293497,33966,56940,1
1,-1,6,259531,293497,33966,56940,1
-1,-1,6,259531,293497,33966,56940,1
1,-1,6,259531,293497,33966,56940,1
-1,-1,6,259531,293497,33966,56940,1
-1,-1,6,259531,293497,33966,56940,1
-1,-1,6,259531,293497,33966,56940,1
-1,-1,6,259531,293497,33966,56940,1
1,-1,6,259531,293497,33966,56940,1
1,-1,6,259531,293497,33966,56940,1
-1,-1,6,259531,293497,33966,56940,1
1,-1,6,259531,293497,33966,56940,1
1,-1,6,259531,293497,33966,56940,1
-1,-1,6,259531,293497,33966,56940,1
-1,-1,6,259531,293497,33966,56940,1
-1,-1,6,259531,293497,33966,56940,1
-1,-1,6,259531,293497,33966,56940,1
-1,-1,6,259531,293497,33966,56940,1
-1,-1,6,259531,293497,33966,56940,1
-1,-1,6,259531,293497,33966,56940,1
1,-1,6,259531,293497,33966,56940,1
-1,-1,6,259531,293497,33966,56940,1
-1,-1,6,259531,293497,33966,56940,1
1,-1,6,259531,293497,33966,56940,1
-1,-1,6,259531,293497,33966,56940,1
1,-1,6,259531,293497,33966,56940,1
1,-1,6,259531,293497,33966,56940,1
-1,-1,6,259531,293497,33966,56940,1
1,-1,6,259531,293497,33966,56940,1
1,-1,6,259531,293497,33966,56940,1
1,-1,6,259531,293497,33966,56940,1
1,-1,6,259531,293497,33966,56940,1
-1,-1,6,259531,293497,33966,56940,1
-1,-1,6,259531,293497,33966,56940,1
-1,-1,6,259531,293497,33966,56940,1
-1,-1,6,259531,293497,33966,56940,1
-1,-1,6,259531,293497,33966,56940,1
-1,-1,6,259531,293497,33966,56940,1
1,-1,6,259531,293497,33966,56940,1
-1,-1,6,259531,293497,33966,56940,1
1,-1,6,259531,293497,33966,56940,1
1,-1,6,259531,293497,33966,56940,1
1,-1,6,259531,293497,33966,56940,1
-1,-1,6,259531,293497,33966,56940,1
-1,-1,6,259531,293497,33966,56940,1
1,-1,6,259531,293497,33966,56940,1
-1,-1,6,259531,293497,33966,56940,1
1,-1,6,259531,293497,33966,56940,1
-1,-1,6,259531,293497,33966,56940,1
-1,-1,6,259531,293497,33966,56940,1
-1,-1,6,259531,293497,33966,56940,1
-1,-1,6,259531,293497,33966,56940,1
-1,-1,6,259531,293497,33966,56940,1
1,-1,6,259531,293497,33966,56940,1
1,-1,6,259531,293497,33966,56940,1
-1,-1,6,259531,293497,33966,56940,1
1,-1,6,259531,293497,33966,56940,1
-1,-1,6,259531,293497,33966,56940,1
1,-1,6,259531,293497,33966,56940,1
-1,-1,6,259531,293497,33966,56940,1
1,-1,6,259531,293497,33966,56940,1
-1,-1,6,259531,293497,33966,56940,1
-1,-1,6,259531,293497,33966,56940,1
1,-1,6,259531,293497,33966,56940,1
-1,-1,6,259531,293497,33966,56940,1
-1,-1,6,259531,293497,33966,56940,1
1,-1,6,259531,293497,33966,56940,1
1,-1,6,259531,293497,33966,56940,1
-1,-1,6,259531,293497,33966,56940,1
-1,-1,6,259531,293497,33966,56940,1
1,-1,6,259531,293497,33966,56940,1
-1,-1,6,259531,293497,33966,56940,1
1,-1,6,259531,293497,33966,56940,1
-1,-1,6,259531,293497,33966,56940,1
1,-1,6,259531,293497,33966,56940,1
1,-1,6,259531,293497,33966,56940,1
-1,-1,6,259531,293497,33966,56940,1
-1,-1,6,259531,293497,33966,56940,1
-1,-1,6,259531,293497,33966,56940,1
-1,-1,6,259531,293497,33966,56940,1
1,-1,6,259531,293497,33966,56940,1
1,-1,6,259531,293497,33966,56940,1
-1,-1,6,259531,293497,33966,56940,1
-1,-1,6,259531,293497,33966,56940,1
1,-1,6,259531,293497,33966,56940,1
-1,-1,6,259531,293497,33966,56940,1
-1,-1,6,259531,293497,33966,56940,1
-1,-1,6,259531,293497,33966,56940,1
-1,-1,6,259531,293497,33966,56940,1
1,-1,6,259531,293497,33966,56940,1
1,-1,6,259531,293782,34251,56940,1
1,-1,6,259531,293782,34251,56940,1
1,-1,6,259531,296523,36992,56940,1
-1,-1,6,259531,296605,37074,56940,1
-1,-1,6,259531,296605,37074,56940,1
-1,-1,6,259531,296605,37074,56940,1
-1,-1,6,259531,296605,37074,56940,1
1,-1,6,259531,296605,37074,56940,1
1,-1,6,259531,296605,37074,56940,1
-1,-1,6,259531,296605,37074,56940,1
-1,-1,6,259531,296605,37074,56940,1
-1,-1,6,259531,296605,37074,56940,1
-1,-1,6,259531,296605,37074,56940,1
1,-1,6,259531,296605,37074,56940,1
-1,-1,6,259531,296605,37074,56940,1
-1,-1,6,259531,296605,37074,56940,1
-1,-1,6,259531,296605,37074,56940,1
-1,-1,6,259531,296605,37074,56940,1
1,-1,6,259531,296605,37074,56940,1
-1,-1,6,259531,296605,37074,56940,1
1,-1,6,259531,296605,37074,56940,1
-1,-1,6,259531,301899,42368,56940,1
1,-1,6,259531,301899,42368,56940,1
-1,-1,6,259531,301899,42368,56940,1
-1,-1,6,259531,301899,42368,56940,1
-1,-1,6,259531,301899,42368,56940,1
-1,-1,6,259531,301899,42368,56940,1
-1,-1,6,259531,301899,42368,56940,1
-1,-1,6,259531,301899,42368,56940,1
1,-1,6,259531,301899,42368,56940,1
1,-1,6,259531,301899,42368,56940,1
-1,-1,6,259531,301899,42368,56940,1
1,-1,6,259531,301899,42368,56940,1
-1,-1,6,259531,307995,48464,56940,1
-1,-1,6,259531,307995,48464,56940,1
1,-1,6,259531,307995,48464,56940,1
1,-1,6,259531,307995,48464,56940,1
-1,-1,6,259531,307995,48464,56940,1
1,-1,6,259531,307995,48464,56940,1
-1,-1,6,259531,307995,48464,56940,1
1,-1,6,259531,307995,48464,56940,1
-1,-1,6,259531,307995,48464,56940,1
1,-1,6,259531,307995,48464,56940,1
-1,-1,6,259531,307995,48464,56940,1
-1,-1,6,259531,307995,48464,56940,1
1,-1,6,259531,307995,48464,56940,1
-1,-1,6,259531,307995,48464,56940,1
1,-1,6,259531,307995,48464,56940,1
1,-1,6,259531,307995,48464,56940,1
1,-1,6,259531,307995,48464,56940,1
-1,-1,6,259531,307995,48464,56940,1
1,-1,6,259531,307995,48464,56940,1
1,-1,6,259531,307995,48464,56940,1
-1,-1,6,259531,307995,48464,56940,1
-1,-1,6,259531,307995,48464,56940,1
-1,-1,6,259531,307995,48464,56940,1
1,-1,6,259531,307995,48464,56940,1
1,-1,6,259531,307995,48464,56940,1
1,-1,6,259531,307995,48464,56940,1
1,-1,6,259531,339797,80266,56940,1
1,-1,6,259531,339797,80266,56940,1
1,-1,6,259531,339797,80266,56940,1
1,-1,6,259531,339797,80266,56940,1
1,-1,6,259531,339797,80266,56940,1
-1,-1,6,259531,339797,80266,56940,1
1,-1,6,259531,339797,80266,56940,1
1,-1,6,259531,339797,80266,56940,1
1,-1,6,259531,339797,80266,56940,1
1,-1,6,259531,339797,80266,56940,1
1,-1,6,259531,339797,80266,56940,1
1,-1,6,259531,339797,80266,56940,1
1,-1,6,259531,339797,80266,56940,1
1,-1,6,259531,339797,80266,56940,1
1,-1,6,259531,339797,80266,56940,1
1,-1,6,259531,339797,80266,56940,1
-1,-1,6,259531,339797,80266,56940,1
1,-1,6,259531,339797,80266,56940,1
1,-1,6,259531,339797,80266,56940,1
1,-1,6,259531,339797,80266,56940,1
1,-1,6,259531,339797,80266,56940,1
1,-1,6,259531,339797,80266,56940,1
1,-1,6,259531,339797,80266,56940,1
1,-1,6,259531,339797,80266,56940,1
1,-1,6,259531,339797,80266,56940,1
-1,-1,6,259531,339797,80266,56940,1
1,-1,6,259531,339797,80266,56940,1
1,-1,6,259531,339797,80266,56940,1
1,-1,6,259531,339797,80266,56940,1
1,-1,6,259531,339797,80266,56940,1
1,-1,6,259531,339797,80266,56940,1
1,-1,6,259531,339797,80266,56940,1
1,-1,6,259531,339797,80266,56940,1
1,-1,6,259531,339797,80266,56940,1
-1,-1,6,259531,339797,80266,56940,1
1,-1,6,259531,339797,80266,56940,1
1,-1,6,259531,339797,80266,56940,1
-1,-1,6,259531,339797,80266,56940,1
1,-1,6,259531,339797,80266,56940,1
1,-1,6,259531,339797,80266,56940,1
1,-1,6,259531,339797,80266,56940,1
-1,-1,6,259531,339797,80266,56940,1
1,-1,6,259531,339797,80266,56940,1
-1,-1,6,259531,339797,80266,56940,1
1,-1,6,259531,339797,80266,56940,1
1,-1,6,259531,339797,80266,56940,1
1,-1,6,259531,339797,80266,56940,1
-1,-1,6,259531,339797,80266,56940,1
1,-1,6,259531,339797,80266,56940,1
-1,-1,6,259531,339797,80266,56940,1
1,-1,6,259531,339797,80266,56940,1
1,-1,6,259531,339797,80266,56940,1
1,-1,6,259531,339797,80266,56940,1
1,-1,6,259531,339797,80266,56940,1
1,-1,6,259531,339797,80266,56940,1
1,-1,6,259531,339797,80266,56940,1
1,-1,6,259531,339797,80266,56940,1
1,-1,6,259531,339797,80266,56940,1
1,-1,6,259531,339797,80266,56940,1
1,-1,6,259531,339797,80266,56940,1
1,-1,6,259531,339797,80266,56940,1
1,-1,6,259531,339797,80266,56940,1
1,-1,6,259531,339797,80266,56940,1
-1,-1,6,259531,339797,80266,56940,1
1,-1,6,259531,339797,80266,56940,1
1,-1,6,259531,339797,80266,56940,1
-1,-1,6,259531,339797,80266,56940,1
1,-1,6,259531,339797,80266,56940,1
1,-1,6,259531,339797,80266,56940,1
1,-1,6,259531,339797,80266,56940,1
1,-1,6,259531,339797,80266,56940,1
1,-1,6,259531,339797,80266,56940,1
1,-1,6,259531,339797,80266,56940,1
1,-1,6,259531,339797,80266,56940,1
1,-1,6,259531,339797,80266,56940,1
1,-1,6,259531,339797,80266,56940,1
1,-1,6,259531,339797,80266,56940,1
1,-1,6,259531,339797,80266,56940,1
1,-1,6,259531,339797,80266,56940,1
-1,-1,6,259531,339797,80266,56940,1
1,-1,6,259531,339797,80266,56940,1
-1,-1,6,259531,339797,80266,56940,1
1,-1,6,259531,339797,80266,56940,1
1,-1,6,259531,339797,80266,56940,1
1,-1,6,259531,339797,80266,56940,1
1,-1,6,259531,339797,80266,56940,1
1,-1,6,259531,339797,80266,56940,1
1,-1,6,259531,339797,80266,56940,1
1,-1,6,259531,339797,80266,56940,1
-1,-1,6,259531,339797,80266,56940,1
-1,-1,6,259531,339797,80266,56940,1
1,-1,6,259531,339797,80266,56940,1
1,-1,6,259531,339797,80266,56940,1
1,-1,6,259531,339797,80266,56940,1
1,-1,6,259531,339797,80266,56940,1
1,-1,6,259531,339797,80266,56940,1
1,-1,6,259531,339797,80266,56940,1
1,-1,6,259531,339797,80266,56940,1
1,-1,6,259531,339797,80266,56940,1
1,-1,6,259531,339797,80266,56940,1
1,-1,6,259531,339797,80266,56940,1
1,-1,6,259531,339797,80266,56940,1
1,-1,6,259531,339797,80266,56940,1
1,-1,6,259531,339797,80266,56940,1
1,-1,6,259531,339797,80266,56940,1
1,-1,6,259531,339797,80266,56940,1
1,-1,6,259531,339797,80266,56940,1
-1,-1,6,259531,339797,80266,56940,1
1,-1,6,259531,339797,80266,56940,1
1,-1,6,259531,339797,80266,56940,1
1,-1,6,259531,339797,80266,56940,1
1,-1,6,259531,339797,80266,56940,1
1,-1,6,259531,339797,80266,56940,1
1,-1,6,259531,339797,80266,56940,1
1,-1,6,259531,339797,80266,56940,1
1,-1,6,259531,339797,80266,56940,1
-1,-1,6,259531,339797,80266,56940,1
1,-1,6,259531,339797,80266,56940,1
1,-1,6,259531,339797,80266,56940,1
1,-1,6,259531,339797,80266,56940,1
1,-1,6,259531,339797,80266,56940,1
-1,-1,6,259531,339797,80266,56940,1
1,-1,6,259531,339797,80266,56940,1
1,-1,6,259531,339797,80266,56940,1
1,-1,6,259531,339797,80266,56940,1
1,-1,6,259531,339797,80266,56940,1
-1,-1,6,259531,339797,80266,56940,1
1,-1,6,259531,339797,80266,56940,1
1,-1,6,259531,339797,80266,56940,1
1,-1,6,259531,339797,80266,56940,1
1,-1,6,259531,339797,80266,56940,1
1,-1,6,259531,339797,80266,56940,1
1,-1,6,259531,339797,80266,56940,1
1,-1,6,259531,339797,80266,56940,1
1,-1,6,259531,339797,80266,56940,1
1,-1,6,259531,339797,80266,56940,1
1,-1,6,259531,339797,80266,56940,1
1,-1,6,259531,339797,80266,56940,1
1,-1,6,259531,339797,80266,56940,1
1,-1,6,259531,339797,80266,56940,1
1,-1,6,259531,339797,80266,56940,1
1,-1,6,259531,339797,80266,56940,1
1,-1,6,259531,339797,80266,56940,1
1,-1,6,259531,339797,80266,56940,1
1,-1,6,259531,339797,80266,56940,1
1,-1,6,259531,339797,80266,56940,1
1,-1,6,259531,339797,80266,56940,1
1,-1,6,259531,339797,80266,56940,1
1,-1,6,259531,339797,80266,56940,1
1,-1,6,259531,339797,80266,56940,1
1,-1,6,259531,339797,80266,56940,1
1,-1,6,259531,339797,80266,56940,1
1,-1,6,259531,339797,80266,56940,1
1,-1,6,259531,339797,80266,56940,1
-1,-1,6,259531,339797,80266,56940,1
-1,-1,6,259531,339797,80266,56940,1
1,-1,6,259531,339797,80266,56940,1
1,-1,6,259531,339797,80266,56940,1
1,-1,6,259531,339797,80266,56940,1
1,-1,6,259531,339797,80266,56940,1
-1,-1,6,259531,339797,80266,56940,1
-1,-1,6,259531,339797,80266,56940,1
1,-1,6,259531,339797,80266,56940,1
-1,-1,6,259531,339797,80266,56940,1
1,-1,6,259531,339797,80266,56940,1
1,-1,6,259531,339797,80266,56940,1
1,-1,6,259531,339797,80266,56940,1
1,-1,6,259531,339797,80266,56940,1
1,-1,6,259531,339797,80266,56940,1
1,-1,6,259531,339797,80266,56940,1
1,-1,6,259531,339797,80266,56940,1
1,-1,6,259531,339797,80266,56940,1
1,-1,6,259531,339797,80266,56940,1
1,-1,6,259531,339797,80266,56940,1
1,-1,6,259531,339797,80266,56940,1
1,-1,6,259531,339797,80266,56940,1
1,-1,6,259531,339797,80266,56940,1
-1,-1,6,259531,339797,80266,56940,1
-1,-1,6,259531,339797,80266,56940,1
1,-1,6,259531,339797,80266,56940,1
1,-1,6,259531,339797,80266,56940,1
1,-1,6,259531,339797,80266,56940,1
-1,-1,6,259531,339797,80266,56940,1
1,-1,6,259531,339797,80266,56940,1
1,-1,6,259531,339797,80266,56940,1
1,-1,6,259531,339797,80266,56940,1
1,-1,6,259531,339797,80266,56940,1
1,-1,6,259531,339797,80266,56940,1
1,-1,6,259531,339797,80266,56940,1
1,-1,6,259531,339797,80266,56940,1
1,-1,6,259531,339797,80266,56940,1
-1,-1,6,259531,339797,80266,56940,1
-1,-1,6,259531,339797,80266,56940,1
-1,-1,6,259531,339797,80266,56940,1
-1,-1,6,259531,339797,80266,56940,1
-1,-1,6,259531,339797,80266,56940,1
-1,-1,6,259531,339797,80266,56940,1
-1,-1,6,259531,339797,80266,56940,1
1,-1,6,259531,339797,80266,56940,1
-1,-1,6,259531,339797,80266,56940,1
1,-1,6,259531,339797,80266,56940,1
-1,-1,6,259531,339797,80266,56940,1
-1,-1,6,259531,339797,80266,56940,1
-1,-1,6,259531,339797,80266,56940,1
-1,-1,6,259531,339797,80266,56940,1
-1,-1,6,259531,339797,80266,56940,1
-1,-1,6,259531,339797,80266,56940,1
-1,-1,6,259531,339797,80266,56940,1
1,-1,6,259531,339797,80266,56940,1
-1,-1,6,259531,339797,80266,56940,1
-1,-1,6,259531,339797,80266,56940,1
-1,-1,6,259531,339797,80266,56940,1
1,-1,6,259531,339797,80266,56940,1
-1,-1,6,259531,339797,80266,56940,1
-1,-1,6,259531,339797,80266,56940,1
-1,-1,6,259531,339797,80266,56940,1
-1,-1,6,259531,339797,80266,56940,1
-1,-1,6,259531,339797,80266,56940,1
1,-1,6,259531,339797,80266,56940,1
-1,-1,6,259531,339797,80266,56940,1
1,-1,6,259531,339797,80266,56940,1
-1,-1,6,259531,339797,80266,56940,1
-1,-1,6,259531,339797,80266,56940,1
1,-1,6,259531,339797,80266,56940,1
-1,-1,6,259531,339797,80266,56940,1
-1,-1,6,259531,339797,80266,56940,1
-1,-1,6,259531,339797,80266,56940,1
-1,-1,6,259531,339797,80266,56940,1
-1,-1,6,259531,339797,80266,56940,1
-1,-1,6,259531,339797,80266,56940,1
-1,-1,6,259531,339797,80266,56940,1
-1,-1,6,259531,339797,80266,56940,1
-1,-1,6,259531,339797,80266,56940,1
-1,-1,6,259531,339797,80266,56940,1
-1,-1,6,259531,339797,80266,56940,1
-1,-1,6,259531,339797,80266,56940,1
-1,-1,6,259531,339797,80266,56940,1
-1,-1,6,259531,339797,80266,56940,1
-1,-1,6,259531,339797,80266,56940,1
-1,-1,6,259531,339797,80266,56940,1
-1,-1,6,259531,339797,80266,56940,1
-1,-1,6,259531,339797,80266,56940,1
-1,-1,6,259531,339797,80266,56940,1
-1,-1,6,259531,339797,80266,56940,1
-1,-1,6,259531,339797,80266,56940,1
-1,-1,6,259531,339797,80266,56940,1
-1,-1,6,259531,339797,80266,56940,1
-1,-1,6,259531,339797,80266,56940,1
-1,-1,6,259531,339797,80266,56940,1
1,-1,6,259531,339797,80266,56940,1
-1,-1,6,259531,339797,80266,56940,1
1,-1,6,259531,339797,80266,56940,1
-1,-1,6,259531,339797,80266,56940,1
-1,-1,6,259531,339797,80266,56940,1
-1,-1,6,259531,339797,80266,56940,1
-1,-1,6,259531,339797,80266,56940,1
-1,-1,6,259531,339797,80266,56940,1
-1,-1,6,259531,339797,80266,56940,1
-1,-1,6,259531,339797,80266,56940,1
-1,-1,6,259531,339797,80266,56940,1
-1,-1,6,259531,339797,80266,56940,1
-1,-1,6,259531,339797,80266,56940,1
-1,-1,6,259531,339797,80266,56940,1
-1,-1,6,259531,339797,80266,56940,1
-1,-1,6,259531,339797,80266,56940,1
-1,-1,6,259531,339797,80266,56940,1
-1,-1,6,259531,339797,80266,56940,1
-1,-1,6,259531,339797,80266,56940,1
-1,-1,6,259531,339797,80266,56940,1
-1,-1,6,259531,339797,80266,56940,1
-1,-1,6,259531,339797,80266,56940,1
-1,-1,6,259531,339797,80266,56940,1
-1,-1,6,259531,339797,80266,56940,1
-1,-1,6,259531,339797,80266,56940,1
-1,-1,6,259531,339797,80266,56940,1
-1,-1,6,259531,339797,80266,56940,1
-1,-1,6,259531,339797,80266,56940,1
-1,-1,6,259531,339797,80266,56940,1
-1,-1,6,259531,339797,80266,56940,1
-1,-1,6,259531,339797,80266,56940,1
-1,-1,6,259531,339797,80266,56940,1
-1,-1,6,259531,339797,80266,56940,1
-1,-1,6,259531,339797,80266,56940,1
-1,-1,6,259531,339797,80266,56940,1
-1,-1,6,259531,339797,80266,56940,1
-1,-1,6,259531,339797,80266,56940,1
-1,-1,6,259531,339797,80266,56940,1
-1,-1,6,259531,339797,80266,56940,1
-1,-1,6,259531,339797,80266,56940,1
-1,-1,6,259531,339797,80266,56940,1
-1,-1,6,259531,339797,80266,56940,1
-1,-1,6,259531,339797,80266,56940,1
-1,-1,6,259531,339797,80266,56940,1
1,-1,6,259531,339797,80266,56940,1
-1,-1,6,259531,339797,80266,56940,1
-1,-1,6,259531,339797,80266,56940,1
-1,-1,6,259531,339797,80266,56940,1
-1,-1,6,259531,339797,80266,56940,1
-1,-1,6,259531,339797,80266,56940,1
-1,-1,6,259531,339797,80266,56940,1
-1,-1,6,259531,339797,80266,56940,1
-1,-1,6,259531,339797,80266,56940,1
-1,-1,6,259531,339797,80266,56940,1
-1,-1,6,259531,339797,80266,56940,1
-1,-1,6,259531,339797,80266,56940,1
-1,-1,6,259531,339797,80266,56940,1
-1,-1,6,259531,339797,80266,56940,1
-1,-1,6,259531,339797,80266,56940,1
-1,-1,6,259531,339797,80266,56940,1
-1,-1,6,259531,339797,80266,56940,1
-1,-1,6,259531,339797,80266,56940,1
-1,-1,6,259531,339797,80266,56940,1
-1,-1,6,259531,339797,80266,56940,1
1,-1,6,259531,339797,80266,56940,1
-1,-1,6,259531,339797,80266,56940,1
-1,-1,6,259531,339797,80266,56940,1
-1,-1,6,259531,339797,80266,56940,1
-1,-1,6,259531,339797,80266,56940,1
-1,-1,6,259531,339797,80266,56940,1
-1,-1,6,259531,339797,80266,56940,1
-1,-1,6,259531,339797,80266,56940,1
-1,-1,6,259531,339797,80266,56940,1
-1,-1,6,259531,339797,80266,56940,1
-1,-1,6,259531,339797,80266,56940,1
-1,-1,6,259531,339797,80266,56940,1
1,-1,6,259531,339797,80266,56940,1
1,-1,6,259531,339797,80266,56940,1
-1,-1,6,259531,339797,80266,56940,1
-1,-1,6,259531,339797,80266,56940,1
-1,-1,6,259531,339797,80266,56940,1
-1,-1,6,259531,339797,80266,56940,1
-1,-1,6,259531,339797,80266,56940,1
-1,-1,6,259531,339797,80266,56940,1
-1,-1,6,259531,339797,80266,56940,1
-1,-1,6,259531,339797,80266,56940,1
-1,-1,6,259531,339797,80266,56940,1
-1,-1,6,259531,339797,80266,56940,1
-1,-1,6,259531,339797,80266,56940,1
-1,-1,6,259531,366639,107108,56940,1
1,-1,6,259531,389436,129905,56940,1
1,-1,6,259531,389436,129905,56940,1
1,-1,6,259531,389436,129905,56940,1
1,-1,6,259531,389436,129905,56940,1
1,-1,6,259531,439401,179870,56940;3662,2
-1,-1,6,259881,283860,23979,,0
-1,-1,6,259881,289174,29293,,0
-1,-1,6,259881,289174,29293,,0
-1,-1,6,259881,289174,29293,,0
1,-1,6,259881,289174,29293,,0
-1,-1,6,259881,289174,29293,,0
-1,-1,6,259881,289174,29293,,0
-1,-1,6,259881,289174,29293,,0
-1,-1,6,259881,293615,33734,56940,1
-1,-1,6,259881,307998,48117,56940,1
-1,-1,6,259881,339802,79921,56940,1
-1,-1,6,259881,339802,79921,56940,1
1,-1,6,259881,339802,79921,56940,1
-1,-1,6,259911,293497,33586,56940,1
-1,-1,6,259911,339797,79886,56940,1
1,-1,6,259911,339797,79886,56940,1
1,-1,6,265806,289298,23492,,0
1,-1,6,265806,289298,23492,,0
1,-1,6,265806,289298,23492,,0
1,-1,6,265806,293497,27691,56940,1
1,-1,6,265806,293497,27691,56940,1
1,-1,6,265806,588274,322468,55770;56940;3662,3
-1,-1,6,265879,350944,85065,56940,1
1,-1,6,266079,339802,73723,56940,1
-1,-1,6,266079,339802,73723,56940,1
-1,-1,6,266079,339802,73723,56940,1
1,-1,6,266079,339802,73723,56940,1
1,-1,6,274686,339797,65111,56940,1
1,-1,6,274686,339797,65111,56940,1
1,-1,6,279208,289298,10090,,0
1,-1,6,279208,289298,10090,,0
1,-1,6,279208,289298,10090,,0
1,-1,6,279208,293497,14289,56940,1
-1,-1,6,279208,293497,14289,56940,1
1,-1,6,279208,293497,14289,56940,1
1,-1,6,279208,293497,14289,56940,1
1,-1,6,279208,339797,60589,56940,1
1,-1,6,279208,339797,60589,56940,1
1,-1,6,279208,339797,60589,56940,1
1,-1,6,279208,339797,60589,56940,1
1,-1,6,279208,339797,60589,56940,1
1,-1,6,279208,339797,60589,56940,1
1,-1,6,279208,339797,60589,56940,1
1,-1,6,279208,339797,60589,56940,1
1,-1,6,279208,339797,60589,56940,1
1,-1,6,279208,339797,60589,56940,1
1,-1,6,279208,339797,60589,56940,1
1,-1,6,279208,339797,60589,56940,1
1,-1,6,279208,339797,60589,56940,1
1,-1,6,279208,339797,60589,56940,1
-1,-1,6,279208,339797,60589,56940,1
1,-1,6,279208,339797,60589,56940,1
1,-1,6,279208,339797,60589,56940,1
1,-1,6,279208,339797,60589,56940,1
1,-1,6,279208,339797,60589,56940,1
-1,-1,6,279314,293615,14301,56940,1
-1,-1,6,283968,339802,55834,56940,1
-1,-1,6,283968,339802,55834,56940,1
-1,-1,6,283968,339802,55834,56940,1
-1,-1,6,283968,339802,55834,56940,1
-1,-1,6,283968,339802,55834,56940,1
1,-1,6,293438,339797,46359,56940,1
-1,-1,6,293438,339797,46359,56940,1
-1,-1,6,293438,339797,46359,56940,1
-1,-1,6,293438,339797,46359,56940,1
-1,-1,6,293438,339797,46359,56940,1
-1,-1,6,293438,339797,46359,56940,1
-1,-1,6,293438,339797,46359,56940,1
1,-1,6,296464,366639,70175,56940,1
1,-1,6,296546,339797,43251,56940,1
1,-1,6,296546,339797,43251,56940,1
1,-1,6,296546,339797,43251,56940,1
1,-1,6,296546,339797,43251,56940,1
1,-1,6,296546,339797,43251,56940,1
1,-1,6,296546,339797,43251,56940,1
1,-1,6,296546,339797,43251,56940,1
1,-1,6,296546,339797,43251,56940,1
1,-1,6,296546,339797,43251,56940,1
1,-1,6,296546,339797,43251,56940,1
1,-1,6,296546,339797,43251,56940,1
1,-1,6,296546,339797,43251,56940,1
1,-1,6,296546,339797,43251,56940,1
1,-1,6,296546,339797,43251,56940,1
1,-1,6,296546,339797,43251,56940,1
1,-1,6,296546,339797,43251,56940,1
1,-1,6,296546,339797,43251,56940,1
1,-1,6,296546,339797,43251,56940,1
1,-1,6,296546,339797,43251,56940,1
1,-1,6,296546,339797,43251,56940,1
1,-1,6,296546,339797,43251,56940,1
1,-1,6,296546,339797,43251,56940,1
-1,-1,6,296546,339797,43251,56940,1
1,-1,6,296546,339797,43251,56940,1
1,-1,6,296546,339797,43251,56940,1
1,-1,6,296546,339797,43251,56940,1
1,-1,6,296546,339797,43251,56940,1
1,-1,6,296546,339797,43251,56940,1
1,-1,6,296546,339797,43251,56940,1
1,-1,6,296546,339797,43251,56940,1
-1,-1,6,296546,339797,43251,56940,1
1,-1,6,296546,339797,43251,56940,1
1,-1,6,296546,339797,43251,56940,1
-1,-1,6,296546,339797,43251,56940,1
1,-1,6,296546,339797,43251,56940,1
1,-1,6,296546,339797,43251,56940,1
1,-1,6,296546,339797,43251,56940,1
1,-1,6,296546,339797,43251,56940,1
1,-1,6,296546,339797,43251,56940,1
1,-1,6,296546,339797,43251,56940,1
1,-1,6,296674,339802,43128,56940,1
1,-1,6,296674,339802,43128,56940,1
1,-1,6,296674,339802,43128,56940,1
-1,-1,6,296674,339802,43128,56940,1
1,-1,6,296674,339802,43128,56940,1
1,1,6,302272,18375047,18072775,6745;401236;51256;6239;56940;100130357;1832;29116;654;81853;94234;2296;10048;84062;51299;54438;7172;51522;23408;221662;2766;7913;389362;51439;2762;1992;2162;4835;9308;8899;9972;221692;56897;84830;51406;51000;340156;7280;347733;26240;9521;10667;2651;154007;4117;9450;57128;378884;1906;63933;221711;4739;55003;63971;63027;3096;222826;3720;670;9247;5272;10799;285782;3662;107080638;10455;404220;648791;6310;54898;10486;100113407;221687;7020;8737;2295;63915;5269;221656;81567;347744;55770;221710;221749;405754;83732;135458;9425,88
-1,1,6,383951,4183288,3799337,10455;404220;389362;2762;1992;4835;94234;2296;8899;8737;63027;2295;56897;222826;55770;670;340156;7280;347733;221749;5272;26240;3662;135458;5269,25
1,-1,6,490850,700078,209228,55770;135458,2
1,1,6,815829,1825305,1009476,2296;2762;94234;2295,4
1,-1,6,815838,1093577,277739,,0
-1,1,6,1441421,2351608,910187,2762;2296,2
-1,1,6,1490870,2677705,1186835,340156;2762;2296,3
1,1,6,1490872,2667350,1176478,340156;2762;2296,3
-1,1,6,1580681,1951526,370845,2762;2296,2
-1,1,6,1580681,1951526,370845,2762;2296,2
-1,1,6,1600137,1864876,264739,2762;2296,2
-1,1,6,2109893,5962832,3852939,10455;404220;57128;648791;389362;2762;1992;4835;9425;8899;8737;63027;56897;5269;222826;340156;670;7280;347733;221749;5272;26240;10799;10667,24
-1,1,6,2862874,16698019,13835145,6745;51256;6239;100130357;1832;29116;654;81853;10048;84062;51299;54438;51522;23408;2766;389362;2162;4835;9308;8899;221692;84830;51406;51000;7280;347733;26240;9521;10667;2651;154007;4117;57128;9450;1906;63933;221711;4739;55003;9425;63027;3096;222826;3720;670;9247;5272;10799;285782;107080638;10455;404220;648791;6310;54898;100113407;221687;7020;8737;63915;81567;347744;221710;221749;405754;83732;5269,67
1,1,6,3224544,30624967,27400423,6745;401236;56658;6239;442191;2880;8335;54901;1832;9750;80742;81853;10048;10107;8340;84547;7172;23;51522;114821;346157;23408;221662;3135;26692;346171;6568;442186;7913;389362;51439;8354;11118;154141;8352;222696;80352;8342;11074;9972;8334;26716;8357;84830;3017;51000;26212;2822;79897;9521;8365;28973;8341;8362;255626;26529;9450;8344;3134;64288;8969;63933;79969;221711;4739;8361;696;7741;55003;8345;6992;63971;8367;10537;3720;6659;10246;51473;9247;10799;7915;8449;8346;5987;26707;404220;648791;353219;6310;442184;100113407;221687;1871;94026;8356;7020;282890;29777;11119;8358;63915;8369;81567;347744;8366;221710;10384;405754;9425;101928603;51256;79692;9753;3012;8368;100130357;10279;8336;3024;29116;654;8360;3018;84062;202658;51299;54438;255488;3008;10590;3105;8339;8330;8364;81797;8970;2766;51567;10475;85235;8348;7746;257202;5514;10050;30834;55856;81688;8359;221545;2162;7718;8351;7726;9308;7745;8899;8350;221692;11120;8363;2794;51406;81696;222698;347733;10786;26240;3400;80345;85236;10667;2651;154007;4117;57128;378884;26531;8347;1906;116511;7932;8294;3006;8968;3007;9856;63027;3096;3013;222826;8343;8331;442194;285782;3010;7738;8332;387032;3133;2550;107080638;10455;80317;135644;54898;10486;221613;3009;3077;51053;5617;140767;4340;81697;221656;8355;10473;8353;57380;89870;8329;221749;154150;83732;10385;55604,227
-1,1,6,4069026,13268031,9199005,6745;154007;6239;57128;9450;4117;1906;1832;221711;4739;654;55003;81853;51299;3096;9521;51522;222826;9247;285782;10799;107080638;10455;404220;648791;54898;100113407;10667;2162;7020;221692;84830;63915;81567;51000;347744;221710;405754;83732;9425;2651,41
-1,-1,6,4269700,4465244,195544,,0
-1,-1,6,6411122,6591542,180420,9450,1
-1,1,6,10601732,13987547,3385815,107080638;4117;51256;1906;100130357;54898;63933;100113407;221687;221711;4739;55003;81853;10048;54438;3096;221692;51522;84830;51406;347744;23408;221710;9247;405754;2651,26
-1,1,6,12924014,15975708,3051694,54438;107080638;51256;221692;100130357;51406;63933;23408;221687;3720;10048;9308;84062,13
1,1,6,13311751,16295791,2984040,54438;107080638;51256;63933;51406;23408;221687;3720;2766;10048;29116;9308;84062,13
-1,1,6,13693852,24225515,10531663,401236;154150;378884;6310;10486;7913;63933;221687;54901;51439;1871;154141;29116;10048;84062;63971;9308;255488;9972;7172;5617;140767;221656;3720;221662;6659;2766;51473;3400,29
1,-1,6,19479947,19570373,90426,,0
1,-1,6,19687791,19839727,151936,3400,1
-1,1,6,22519683,25226559,2706876,101928603;51053;140767;51567;353219;57380;2822;55856;51473;7915;154150;81688;9856;9750,14
1,-1,6,27515954,27696583,180629,,0
1,-1,6,27515954,27696583,180629,,0
1,-1,6,28636972,28841640,204668,,0
-1,-1,6,29102310,29122681,20371,,0
1,-1,6,29102310,29152766,50456,26707,1
1,-1,6,29718640,29760628,41988,,0
1,-1,6,29718640,29760628,41988,,0
1,-1,6,29718640,29760628,41988,,0
1,-1,6,29718640,29760628,41988,,0
1,-1,6,29718640,29760628,41988,,0
1,-1,6,29718640,29760628,41988,,0
1,-1,6,29718704,29760628,41924,,0
1,-1,6,29718704,29760628,41924,,0
1,-1,6,29718763,29760628,41865,,0
-1,-1,6,29854899,29896683,41784,,0
-1,-1,6,29854899,29902285,47386,,0
-1,-1,6,29854899,29902285,47386,,0
-1,-1,6,29854899,29937583,82684,3105,1
-1,-1,6,31218793,31445788,226995,3107;3106;100507436,3
-1,-1,6,31255002,31481339,226337,4277;3106;100507436,3
-1,-1,6,31381759,31445681,63922,100507436,1
-1,-1,6,31381759,31445681,63922,100507436,1
-1,-1,6,31782789,31797422,14633,3303;3304;3305,3
-1,-1,6,31785228,31797422,12194,3303;3304,2
-1,-1,6,31939770,31980751,40981,1797;8859;720,3
-1,-1,6,31948199,32009282,61083,7148;8859;721;1589;720,5
-1,-1,6,31963866,32009260,45394,7148;1589;721;720,4
1,-1,6,32411987,32552134,140147,3122;3123;3127,3
1,-1,6,32411987,32552134,140147,3122;3123;3127,3
1,-1,6,32411987,32552134,140147,3122;3123;3127,3
-1,-1,6,32456868,32689176,232308,3123;3119;3117;3127,4
-1,-1,6,32456868,32689176,232308,3123;3119;3117;3127,4
-1,-1,6,32456868,32748505,291637,3118;3119;3117;3120;3123;3127,6
1,-1,6,32450722,32497331,46609,3127,1
1,-1,6,32450722,32521900,71178,3127,1
1,-1,6,32450722,32526088,75366,3127,1
1,-1,6,32450722,32526088,75366,3127,1
1,-1,6,32450722,32546484,95762,3127,1
1,-1,6,32450722,32552134,101412,3123;3127,2
-1,-1,6,32450722,32552134,101412,3123;3127,2
1,-1,6,32450722,32552134,101412,3123;3127,2
1,-1,6,32450722,32564808,114086,3123;3127,2
1,-1,6,32450722,32637088,186366,3123;3119;3117;3127,4
-1,-1,6,32457212,32521900,64688,3127,1
1,-1,6,32487451,32581827,94376,3123;3127,2
1,-1,6,35489509,35538144,48635,,0
1,-1,6,35515776,35538144,22368,,0
-1,-1,6,38049585,38602064,552479,60685;114781,2
1,-1,6,39270073,39397337,127264,83795;89822;221458,3
-1,1,6,42661541,46309825,3648284,55362;202500;64928;9820;5961;57510;89953;23113;65989;11131;401262;54676;84630;8464;10591;5754;5528;347734;221409;221421;10864;860;23506;221416;4201;93643;116138;107080644;27232;3326;22875;55168;6903;25844;101929726;988;5190;9587;53405;59084;441151;57505;51069;5429;24149;7422;2030;6722;88745;89845;441150;9533;221424;10231;4794;285855;10695;171558,58
-1,1,6,43636308,50947320,7311012,55362;202500;167;64928;6005;7021;442213;221393;11131;9481;221395;135398;8464;347734;221409;221421;860;100287718;55166;221416;23607;4224;221400;266977;3326;22875;55168;988;101929726;83741;7941;403339;53405;59084;27242;441151;4594;57505;222611;389396;245928;7422;2030;221391;10321;51302;7180;10231;4794;5232;245915;245927;245913,53
1,1,6,45319017,45383847,64830,8464;860,2
-1,1,6,45508319,45526327,18008,860,1
-1,1,6,45649408,54076842,8427434,2939;167;2729;6005;7021;442213;221393;9481;22858;221395;135398;26268;60481;2941;100287718;55166;221357;114327;112744;85315;5314;3605;23607;4224;221400;266977;22875;83741;28978;90523;7941;403339;53405;27242;4594;59084;389396;2940;222611;401265;245928;221391;55227;2938;10321;8521;51302;7180;10231;245927;5232;245915;4172;9697;245913,55
-1,-1,6,48464867,48827358,362491,,0
-1,1,6,49313295,49430422,117127,4594,1
-1,1,6,50938895,57297586,6358691,2939;4172;54511;81578;51715;5558;22858;60481;2941;3062;653;221357;389400;114327;112744;85315;667;5314;3605;221336;28978;90523;2940;401265;55227;222584;2938;8521;57691;27283;9532;26036;2729;26268;9697,35
1,1,6,51061467,53724432,2662965,2939;28978;2940;401265;26268;22858;60481;55227;2941;2938;8521;221357;9697;114327;2729;4172;112744;85315;5314;3605,20
-1,1,6,51668220,52563298,895078,112744;28978;114327;4172;9697;85315;5314;3605,8
1,-1,6,52615096,52657414,42318,2938;2939,2
1,-1,6,53796341,54449718,653377,27283;90523,2
1,1,6,53796341,68859642,15063301,23469;221336;441155;51557;90523;54511;81578;51715;100463487;346007;5558;3062;222584;653;7803;57691;27283;389400;9532;26036;667;202559,22
1,-1,6,56917608,56950558,32950,57691,1
1,-1,6,57215547,57631490,415943,5558,1
1,1,6,57329882,69422120,12092238,5558;577;23469;441155;51557;7803;100463487;346007;202559,9
1,-1,6,57360339,57673830,313491,5558,1
1,-1,6,57575430,62411810,4836380,100463487;202559,2
1,-1,6,57730440,62887221,5156781,100463487;202559,2
1,-1,6,57747508,61967241,4219733,,0
1,1,6,58719923,71865108,13145185,577;57579;135152;23469;441155;1297;51557;7803;55788;1310;60682;135154;100463487;346007;202559,15
-1,-1,6,62254225,62350858,96633,100463487,1
1,-1,6,62254225,62596486,342261,100463487;202559,2
1,-1,6,62386147,62889604,503457,202559,1
1,-1,6,62396147,62889604,493457,202559,1
1,-1,6,63276588,63348841,72253,,0
-1,1,6,65259548,84136510,18876962,4199;7162;134728;135228;90025;6785;1303;79627;55754;55510;9324;115004;4646;80759;26503;441161;26054;135154;56479;22999;594;577;1347;135152;25998;5238;441155;25821;55788;112611;1310;60682;340168;83699;346007;23033;57579;101928601;55023;1297;154288;7272;100129128;27145;3617;55603;1915;167691;3351,49
-1,-1,6,67029691,67207085,177394,,0
-1,-1,6,68237467,68416993,179526,,0
-1,-1,6,68237467,68416993,179526,,0
-1,-1,6,68575208,68671903,96695,,0
1,1,6,69445541,71504096,2058555,55788;577;57579;1310;60682;135154;1297,7
-1,1,6,72555205,72807895,252690,22999,1
1,1,6,75092523,142361637,67269114,9439;64780;55122;253582;22881;51389;60468;9053;619208;10492;254394;2898;222545;10973;3298;154091;6943;25998;27244;9457;112495;11231;23595;3617;2070;26235;10559;55278;167691;4602;64065;23097;55754;57673;345895;84456;79541;7259;285761;55350;167838;2830;116150;154313;5454;9465;100128327;594;221294;167826;114792;389421;81491;55084;57231;5550;64208;221262;387119;27145;9892;83551;23195;134860;22832;2697;441168;25842;84816;6492;57221;8417;9287;51805;5169;202;728464;58528;222553;25957;10690;85413;1347;5570;93663;79632;262;387104;6206;285755;11149;23033;2045;25901;1300;9474;10758;8838;221322;5796;100130890;117247;6785;135293;51020;100507203;254228;442247;134701;4907;57531;154075;2569;4646;3066;167681;9841;84870;51167;60487;9096;6098;10345;23036;154214;135112;23593;57120;55023;79694;9729;7272;6885;221264;64577;253714;90025;340146;1303;4217;221303;8528;9324;387357;221301;54806;2444;5238;206412;8763;84071;51696;10370;8936;83699;9994;387103;10957;101928601;135295;8875;51250;134829;4082;53832;6610;639;7101;134728;84539;2534;23493;2173;222546;9038;91749;892;23270;352999;5167;81847;2037;5191;84553;1081;3841;2309;29940;57038;3910;4121;112609;135114;134864;116379;9896;222537;4199;10767;319100;8876;256380;51175;3354;345930;113115;28962;57150;9774;8724;29078;221302;57224;154215;5350;6446;27115;57107;85015;1490;26002;1268;59336;112611;116843;81833;58527;84154;5980;9519;3908;10924;375519;7162;84694;57226;85021;57515;2570;100507462;7128;26054;114801;246269;23376;51362;7164;643854;51465;245806;383;8732;3459;59351;55862;55603;285753;3351,258
-1,1,6,76635916,93420511,16784595,4199;7162;84694;134728;90025;6785;57226;55122;22881;3354;135293;57150;60468;134701;4907;9324;10492;2570;2569;167681;58528;154313;51167;9096;1268;55603;594;22832;25998;5238;206412;23036;1081;112611;83699;51465;9994;23033;10957;81833;101928601;55023;57231;57038;8732;135295;112609;7272;23595;3617;9892;10559;23195;6885;167691;3351;375519,57
1,-1,6,78351935,78763179,411244,101928601,1
1,-1,6,78873966,79045459,171493,,0
-1,-1,6,80883701,81134991,251290,594,1
1,-1,6,81572856,81699864,127008,,0
-1,1,6,84548022,99270189,14722167,253714;84694;57226;55122;22881;3354;135293;57150;60468;29078;134701;4907;10492;2570;2569;58528;154313;51167;9096;1268;10690;22832;23376;206412;23036;1081;9457;114792;51465;81491;9994;10957;81833;57231;57038;135295;2045;8732;79694;112609;23595;10559;23195;6885;375519,45
1,1,6,85779088,89113057,3333969,206412;23036;55122;1081;3354;57150;81833;57231;4907;57038;10492;23595;10559;154313;1268;375519,16
-1,1,6,85988428,120548687,34560259,221264;253714;64780;55122;22881;221303;51389;8528;60468;619208;10492;254394;221301;2898;222545;10973;2444;27244;206412;8763;84071;9457;8936;9994;10957;112495;135295;11231;23595;51250;26235;10559;55278;4082;6610;639;7101;23097;84539;2534;345895;57673;222546;7259;91749;285761;892;2830;116150;23270;154313;5454;100128327;221294;84553;1081;3841;2309;114792;389421;81491;29940;55084;57231;57038;3910;5550;4121;64208;221262;387119;9896;23195;222537;441168;25842;84816;256380;51175;3354;28962;6492;57150;8724;29078;221302;51805;5350;202;728464;58528;222553;57107;85015;1268;25957;10690;85413;59336;79632;262;285755;11149;81833;2045;84154;5980;1300;9474;10758;8838;375519;84694;100130890;117247;57226;135293;254228;442247;4907;57531;2570;2569;3066;9841;246269;6098;23376;23036;51362;51465;245806;57120;79694;8732;6885;285753,137
-1,1,6,86080434,91379512,5299078,84694;6885;206412;57226;55122;23036;1081;22881;3354;135293;51465;57150;9994;60468;10957;81833;57231;4907;57038;10492;135295;8732;2570;2569;23595;58528;10559;154313;23195;1268;375519,31
-1,1,6,86513991,93898976,7384985,84694;6885;206412;57226;55122;23036;1081;22881;3354;135293;51465;57150;9994;60468;10957;81833;57038;135295;8732;2570;2569;23595;58528;10559;154313;23195;1268;375519,28
-1,1,6,91397213,94516233,3119020,2045,1
1,-1,6,92191627,92505173,313546,,0
-1,1,6,92576950,104658245,12081295,253714;59336;100130890;23376;84539;84553;9457;114792;81491;6492;29078;51805;2045;79694;2898;892;85015;10973;26235;5454;25957;10690,22
1,-1,6,92707789,92836453,128664,,0
-1,1,6,94202605,109878834,15676229,221264;253714;639;100130890;7101;84539;64780;84816;256380;57673;28962;6492;8724;29078;51805;57531;2898;202;57107;892;85015;10973;9841;5454;25957;10690;246269;59336;23376;27244;84553;8763;84071;285755;11149;9457;2309;114792;389421;81491;55084;79694;5550;64208;221262;11231;51250;9474;26235;55278;285753;6610,52
-1,-1,6,95390505,95554368,163863,,0
-1,-1,6,95390505,95554368,163863,,0
-1,-1,6,95390505,95554368,163863,,0
-1,-1,6,95417615,95831595,413980,,0
-1,-1,6,95456833,95525616,68783,,0
-1,-1,6,95456833,95554368,97535,,0
-1,-1,6,95478783,95554368,75585,,0
-1,1,6,97057870,122482694,25424824,221264;253714;441168;64780;25842;84816;256380;221303;51175;51389;28962;8528;6492;8724;29078;221302;51805;619208;254394;221301;5350;2898;202;728464;222545;222553;57107;85015;10973;2444;25957;85413;59336;79632;27244;262;8763;84071;285755;11149;9457;8936;112495;84154;5980;11231;1300;51250;9474;26235;4082;55278;10758;8838;221322;6610;639;7101;100130890;23097;84539;117247;2534;345895;57673;254228;222546;442247;7259;91749;285761;57531;3066;892;2830;116150;23270;9841;5454;100128327;246269;6098;221294;84553;3841;2309;51362;114792;389421;81491;29940;55084;245806;57120;3910;5550;4121;64208;221262;387119;9896;222537;285753;2697,104
-1,1,6,97384446,110247755,12863309,221264;253714;639;100130890;7101;84539;64780;84816;256380;57673;28962;6492;8724;51805;57531;2898;202;57107;892;85015;10973;9841;5454;25957;246269;59336;27244;84553;8763;84071;285755;11149;2309;114792;389421;55084;5550;64208;221262;11231;51250;9474;26235;9896;55278;285753;6610,47
-1,1,6,100502765,120809300,20306535,221264;441168;64780;25842;84816;256380;221303;51175;51389;28962;8528;6492;8724;221302;619208;254394;221301;5350;2898;202;728464;222545;222553;57107;10973;2444;85413;79632;27244;262;8763;84071;285755;11149;8936;112495;84154;5980;11231;1300;51250;9474;4082;55278;10758;8838;6610;639;7101;23097;117247;2534;345895;57673;254228;222546;442247;7259;91749;285761;57531;3066;2830;116150;23270;9841;100128327;246269;6098;221294;3841;2309;51362;389421;29940;55084;245806;57120;3910;5550;4121;64208;221262;387119;9896;222537;285753,87
-1,1,6,102804377,111371082,8566705,221264;639;7101;23097;64780;84816;256380;57673;28962;8528;8724;57531;202;728464;57107;2830;9841;85413;246269;27244;262;8763;84071;285755;11149;2309;8936;51362;389421;55084;112495;5550;84154;64208;221262;11231;51250;9474;9896;55278;285753;6610,42
-1,1,6,103727340,114255403,10528063,221264;639;7101;23097;117247;64780;84816;256380;51175;2534;57673;28962;8528;8724;442247;619208;57531;91749;202;728464;57107;2830;9841;85413;246269;27244;262;8763;84071;285755;11149;2309;8936;51362;389421;55084;112495;3910;5550;84154;64208;221262;5980;11231;51250;9474;9896;55278;10758;8838;4082;285753;6610,53
-1,-1,6,104625850,104789702,163852,,0
-1,-1,6,104949785,105177184,227399,57531,1
-1,1,6,106951594,126102365,19150771,221264;441168;64780;25842;84816;256380;221303;51175;51389;28962;8528;8724;221302;619208;254394;221301;154215;5350;202;728464;222545;222553;57107;2444;3298;85413;5570;79632;27244;262;8763;84071;285755;8936;112495;84154;5980;11231;1300;51250;134829;4082;55278;10758;8838;221322;10924;6610;7101;23097;117247;2534;345895;57673;51020;23493;2173;254228;222546;442247;57515;7259;91749;285761;3066;2830;116150;23270;9841;100128327;246269;6098;221294;10345;3841;2309;51362;154214;7164;135112;29940;55084;245806;57120;3910;4121;221262;387119;9896;222537;285753;2697,92
-1,1,6,107691345,116148646,8457301,221264;7101;23097;117247;64780;256380;51175;2534;28962;8528;8724;442247;619208;91749;3066;728464;57107;2830;9841;85413;246269;27244;262;8763;84071;285755;2309;8936;51362;55084;112495;3910;8838;84154;221262;5980;11231;9896;4082;10758;222537;285753;6610,43
-1,1,6,107766485,110869110,3102625,221264;7101;27244;64780;8763;84071;285755;256380;2309;8936;51362;28962;8528;55084;8724;221262;728464;11231;6610;57107;2830;9841;9896;285753;85413;246269,26
1,-1,6,111185776,111216743,30967,262,1
1,-1,6,115281889,115470969,189080,,0
1,-1,6,115281889,115470969,189080,,0
1,-1,6,115281889,115470969,189080,,0
1,-1,6,115281889,115470969,189080,,0
-1,-1,6,115281889,115512479,230590,,0
1,-1,6,115281889,115512479,230590,,0
1,-1,6,115281889,115512479,230590,,0
1,-1,6,115281889,115512479,230590,,0
1,-1,6,115281889,115512479,230590,,0
1,-1,6,115281889,115512479,230590,,0
1,-1,6,115281889,115512479,230590,,0
1,-1,6,115281889,115512479,230590,,0
-1,-1,6,115281889,115512479,230590,,0
-1,-1,6,115281889,115512479,230590,,0
-1,-1,6,115281889,115512479,230590,,0
-1,-1,6,115281889,115512479,230590,,0
1,-1,6,115281889,115512479,230590,,0
1,-1,6,115281889,115512479,230590,,0
1,-1,6,115281889,115512479,230590,,0
1,-1,6,115281889,115512479,230590,,0
-1,-1,6,115281889,115512479,230590,,0
1,-1,6,115281889,115512479,230590,,0
-1,-1,6,115281889,115549567,267678,,0
1,-1,6,115325676,115470969,145293,,0
1,-1,6,115325676,115512479,186803,,0
1,-1,6,115325676,115512479,186803,,0
1,-1,6,115325676,115512479,186803,,0
-1,-1,6,115325676,115512479,186803,,0
1,-1,6,115325676,115549567,223891,,0
1,-1,6,115325676,115607966,282290,,0
-1,1,6,116038381,123952199,7913818,441168;25842;221303;51389;345895;2173;221302;254228;222546;57515;7259;285761;254394;221301;5350;222553;222545;116150;23270;2444;100128327;3298;6098;5570;79632;221294;10345;3841;245806;29940;57120;4121;1300;387119;134829;221322;10924;2697,38
1,1,6,117928310,127021125,9092815,5570;79632;10345;25842;221322;154214;51020;7164;23493;135112;2173;387103;57515;4121;254394;154215;5350;135114;222553;387119;134829;116150;60487;3298;10924;2697,26
1,-1,6,118787404,119016237,228833,5350;387119,2
1,-1,6,118787404,119016237,228833,5350;387119,2
-1,-1,6,119712156,119992270,280114,,0
-1,-1,6,119712186,119998618,286432,,0
1,1,6,121332050,146247408,24915358,64577;83443;9439;10767;319100;8876;340146;257218;253582;4217;345930;7957;113115;8504;9774;57221;8417;9287;9053;51534;57224;5169;387357;54806;154215;6446;27115;26002;1490;9749;3298;154091;93663;5570;6943;387104;6206;51696;10370;84946;2519;116843;387103;58527;25901;153918;5325;8875;134829;2070;9519;53832;221322;3908;5796;10924;134637;4602;64065;85021;51020;84456;23493;100507203;2173;51390;57515;9038;79541;55350;167838;154075;100507462;84870;7128;352999;5167;60487;9465;81847;3097;114801;2037;5191;10345;167826;57211;154214;7164;643854;135112;84085;7402;23593;383;4829;3459;9729;135114;55862;83551;134864;59351;8676;116379;134860;2697,107
-1,1,6,122612641,131564463,8951822,253582;51020;84456;23493;100507203;2173;57515;387357;154215;154075;84870;352999;60487;9465;81847;3298;93663;114801;5570;2037;10345;387104;154214;7164;135112;5796;387103;9729;135114;55862;134829;3908;10924,33
1,1,6,124280383,156115172,31834789,64577;83443;9439;79624;340146;253582;11104;4217;154043;50508;2911;9053;51534;387357;54806;9749;154091;85313;55005;80328;6943;23345;57480;9590;2099;51696;135250;10370;84946;2519;387103;23328;153918;8875;2070;22828;53832;134637;4602;64065;26575;84918;84456;23493;81706;9038;79541;55350;167838;7432;23118;352999;5167;9465;81847;2037;5191;167826;51106;57211;79747;25902;135114;5110;83551;134864;116379;340152;134860;10981;10767;319100;8876;257218;26230;345930;7957;113115;8504;9774;57221;8417;9287;116254;57224;5169;154215;6446;27115;26002;1490;93663;26034;387104;6206;154064;387082;116843;58527;25901;5325;80129;9519;3908;5796;389434;80329;134957;26271;389432;85021;51020;100507203;49861;51390;79465;154075;100507462;84870;7128;60487;3097;9113;348995;114801;54516;57621;80177;4988;154214;7164;643854;135112;84085;7402;23593;383;4829;3459;9729;55862;59351;353091;8676;10090,145
-1,-1,6,127114447,127202157,87710,,0
1,-1,6,129912803,130095047,182244,93663,1
-1,1,6,133077239,143761582,10684343,64577;134637;4602;10767;64065;340146;4217;85021;345930;113115;9774;57221;51390;9053;51534;57224;167838;54806;6446;27115;100507462;7128;3097;154091;6943;5191;6206;167826;51696;10370;57211;116843;23593;58527;4829;3459;25901;59351;8875;2070;116379;9519;53832,43
1,1,6,133858409,166289033,32430624,64577;83443;79624;340146;11104;4217;39;154043;50508;2911;9053;51534;117289;4216;54806;9749;154091;85313;55005;80328;6943;23345;57480;9590;2099;6582;51696;135250;10370;8871;84946;404672;2519;23328;5071;56895;56995;153918;22828;53832;134637;4602;64065;26575;57583;84918;10846;4142;81706;4018;135138;167838;6993;7432;23118;5191;100130967;167826;51106;57211;79747;25902;5110;116379;29074;83861;340152;154197;10981;10767;257218;26230;5340;345930;7957;113115;8504;9774;57221;116254;57224;6580;6446;27115;79683;26034;3482;154064;387082;51429;6648;58527;6950;25901;5325;80129;9519;389434;80329;134957;26271;389432;85021;84624;49861;51390;9589;79465;729515;100507462;7128;3097;9113;348995;54516;9444;57621;84947;80177;6581;168090;4988;94120;7430;84085;7402;23593;4829;3459;59351;353091;8676;10090;57492,134
1,1,6,135679288,155776251,20096963,83443;79624;257218;340146;26230;11104;4217;345930;7957;113115;154043;8504;9774;50508;57221;2911;116254;9053;51534;57224;54806;27115;9749;85313;55005;80328;23345;26034;57480;9590;2099;51696;135250;10370;154064;387082;84946;2519;23328;58527;25901;153918;5325;80129;22828;53832;134637;64065;389434;26575;80329;134957;26271;84918;389432;85021;81706;49861;51390;167838;79465;100507462;7432;7128;23118;3097;9113;348995;54516;57621;80177;5191;167826;51106;57211;4988;79747;84085;7402;23593;25902;4829;3459;59351;5110;353091;8676;116379;10090;340152;10981,91
-1,1,6,136341788,146648942,10307154,134637;83443;64065;257218;340146;4217;85021;345930;7957;113115;8504;9774;57221;51390;2911;9053;51534;57224;167838;100507462;27115;7128;9749;3097;5191;167826;51696;10370;57211;84946;84085;2519;7402;23593;58527;4829;3459;25901;59351;153918;5325;8676;116379;53832,44
-1,1,6,139513020,150389231,10876211,134637;83443;80329;257218;134957;84918;389432;11104;7957;8504;51390;2911;51534;116254;167838;79465;23118;9749;3097;9113;348995;85313;80328;135250;10370;57211;154064;387082;84946;84085;2519;79747;7402;23328;4829;153918;5325;5110;353091;8676;10090;340152;10981,43
-1,1,6,140746967,146877424,6130457,134637;83443;257218;57211;7957;8504;84946;84085;2519;7402;51390;2911;51534;4829;153918;5325;8676;9749;3097;10981,20
-1,1,6,142057731,145692400,3634669,51390;134637;51534;83443;4829;153918;5325;84946;57211;8676;8504;3097;2519;7402;9749,15
1,1,6,143940111,144734319,794208,83443;84946;8676;9749;7402;153918;5325,7
-1,1,6,144075695,152337005,8261310,83443;389434;79624;80329;257218;134957;84918;389432;11104;7957;81706;2911;116254;79465;23118;9749;9113;348995;85313;55005;80328;57621;57480;9590;2099;135250;154064;387082;84946;79747;84085;7402;23328;25902;153918;5325;5110;353091;8676;80129;10090;340152;10981,43
1,-1,6,144328623,144328976,353,5325,1
-1,1,6,148126255,151214851,3088596,80328;389434;57480;80329;84918;11104;135250;154064;387082;81706;116254;23328;10090;25902;79465;5110;353091;23118;340152;9113;348995;85313,22
-1,1,6,148433471,149971120,1537649,116254;23328;10090;387082;11104;23118;340152;85313,8
-1,1,6,150702375,159974984,9272609,389434;79624;26575;26230;26271;57583;84624;154043;50508;49861;729515;6993;117289;7432;79683;57492;54516;55005;57621;23345;80177;26034;84947;57480;9590;2099;100130967;51106;4988;94120;8871;7430;404672;51429;25902;80129;22828;83861;56995,39
1,1,6,151214792,170892243,19677451,79624;26230;5340;387263;55274;39;154043;50508;55780;117289;4216;2853;285800;6580;79683;4301;113402;55005;3834;401285;23345;5689;26034;9590;2099;3482;6582;253769;100128124;83887;8871;404672;51429;28514;5071;84498;6648;6950;56895;6862;56995;51660;80129;22828;11116;26575;26271;57583;168002;10846;4142;84624;4018;49861;9589;135138;729515;6993;7432;5134;54516;9444;57621;84947;80177;100130967;6581;54346;79981;168090;51106;7058;6991;4988;94120;7430;6196;8635;25902;64094;29074;1235;83861;6953;154197;57492;6908,87
1,1,6,152697473,170921089,18223616,26230;5340;387263;55274;39;154043;50508;55780;117289;4216;2853;285800;6580;79683;4301;113402;401285;3834;23345;5689;26034;3482;6582;253769;100128124;83887;8871;404672;51429;28514;5071;84498;6648;6950;56895;6862;56995;51660;22828;11116;26575;26271;57583;168002;10846;4142;84624;4018;49861;9589;135138;729515;6993;7432;5134;54516;9444;84947;80177;100130967;6581;54346;79981;168090;51106;7058;6991;4988;94120;7430;6196;8635;64094;29074;1235;83861;6953;154197;57492;6908,80
1,1,6,152697473,170921089,18223616,26230;5340;387263;55274;39;154043;50508;55780;117289;4216;2853;285800;6580;79683;4301;113402;401285;3834;23345;5689;26034;3482;6582;253769;100128124;83887;8871;404672;51429;28514;5071;84498;6648;6950;56895;6862;56995;51660;22828;11116;26575;26271;57583;168002;10846;4142;84624;4018;49861;9589;135138;729515;6993;7432;5134;54516;9444;84947;80177;100130967;6581;54346;79981;168090;51106;7058;6991;4988;94120;7430;6196;8635;64094;29074;1235;83861;6953;154197;57492;6908,80
-1,1,6,153114537,170919482,17804945,26230;5340;387263;55274;39;154043;50508;55780;117289;4216;2853;285800;6580;79683;4301;113402;57492;401285;3834;5689;26034;3482;6582;253769;100128124;83887;8871;404672;51429;28514;5071;84498;6648;6950;56895;6862;51660;22828;11116;26575;26271;57583;168002;10846;4142;84624;4018;49861;9589;135138;729515;6993;5134;54516;9444;84947;100130967;6581;54346;79981;168090;51106;7058;6991;4988;94120;7430;6196;8635;64094;29074;1235;83861;6953;154197;56995;6908,77
-1,1,6,153647248,158255989,4608741,26034;729515;26230;51106;4988;79683;22828;154043;51429;57492;50508;49861,12
-1,1,6,154860789,171023595,16162806,26230;5340;387263;55274;39;50508;55780;117289;4216;285800;2853;6580;79683;4301;113402;401285;3834;5689;3482;6582;253769;100128124;83887;8871;404672;51429;28514;5071;84498;6648;6950;56895;6862;56995;51660;22828;11116;168002;57583;10846;4142;84624;4018;49861;9589;135138;729515;6993;5134;9444;84947;100130967;6581;54346;79981;168090;51106;7058;6991;94120;7430;6196;8635;64094;29074;1235;83861;6953;154197;57492;6908,71
-1,1,6,155525920,159889169,4363249,84947;100130967;26230;57583;51106;94120;84624;8871;7430;404672;51429;50508;49861;729515;6993;117289;56995;79683;83861;57492,20
-1,1,6,155699183,163554531,7855348,57583;5340;4142;84624;39;4018;50508;9589;135138;729515;6993;117289;4216;6580;79683;57492;84947;100130967;6581;3482;6582;94120;8871;7430;404672;51429;5071;6648;6950;56895;29074;83861;154197;56995,34
-1,1,6,156674766,157870814,1196048,57492;79683;729515,3
-1,1,6,157286551,157414586,128035,57492,1
-1,1,6,157431664,158489904,1058240,79683;8871;729515;51429;57492,5
-1,1,6,157473931,157870049,396118,57492;79683;729515,3
-1,1,6,160336422,171023595,10687173,168002;10846;5340;387263;55274;4018;135138;55780;4216;285800;2853;6580;4301;113402;5134;9444;401285;3834;5689;6581;3482;6582;54346;100128124;168090;79981;7058;83887;253769;6991;6196;8635;28514;5071;6953;84498;56895;6862;51660;64094;1235;11116;6908,43
1,-1,6,160554084,160579554,25470,6580,1
-1,1,6,160905842,170921099,10015257,168002;10846;5340;387263;55274;4018;135138;55780;4216;285800;2853;4301;113402;5134;9444;401285;3834;5689;54346;253769;100128124;168090;79981;7058;83887;6991;6196;8635;28514;5071;6953;84498;56895;6862;51660;64094;1235;11116;6908,39
-1,1,6,161320930,170919482,9598552,168002;10846;387263;55274;135138;55780;4216;285800;2853;4301;113402;5134;9444;401285;3834;5689;54346;253769;100128124;168090;79981;7058;83887;6991;6196;8635;28514;5071;6953;84498;56895;6862;51660;64094;1235;11116;6908,37
1,-1,6,161653240,161769727,116487,56895;5071,2
-1,-1,6,162113360,162351639,238279,5071,1
-1,1,6,162381975,170919482,8537507,168002;10846;387263;55274;135138;55780;285800;2853;4301;113402;5134;9444;401285;3834;5689;54346;253769;100128124;168090;79981;7058;83887;6991;6196;11116;8635;28514;5071;84498;6862;51660;64094;1235;6953;6908,35
-1,-1,6,162514945,162748288,233343,5071,1
-1,-1,6,162514945,162748288,233343,5071,1
-1,-1,6,162514945,162748288,233343,5071,1
-1,-1,6,162541352,162777193,235841,5071,1
-1,-1,6,162576235,162777193,200958,5071,1
-1,-1,6,162605894,162694798,88904,5071,1
-1,-1,6,162654063,162870548,216485,5071,1
-1,1,6,162638345,162754162,115817,5071,1
-1,-1,6,162654091,162748288,94197,5071,1
-1,-1,6,162685340,163000261,314921,5071,1
-1,-1,6,162685340,163000261,314921,5071,1
-1,-1,6,162777185,163030972,253787,5071,1
-1,-1,6,162799322,163000261,200939,5071,1
-1,-1,6,162870369,162933097,62728,5071,1
-1,-1,6,162870369,162933097,62728,5071,1
-1,-1,6,162902283,163000261,97978,5071,1
-1,-1,6,162960111,163050344,90233,5071,1
-1,-1,6,163000261,163089344,89083,5071,1
-1,-1,6,163129464,163516451,386987,135138;5071,2
-1,1,6,163606025,171055067,7449042,168002;10846;387263;55274;135138;55780;285800;2853;4301;113402;5134;9444;401285;3834;5689;54346;253769;100128124;168090;79981;7058;83887;6991;6196;11116;8635;28514;84498;6862;51660;64094;1235;6953;6908,34
-1,-1,6,163731741,163950870,219129,135138;9444,2
-1,1,6,163731741,167090237,3358496,135138;6862;285800;168090;51660;10846;6196;113402;9444,9
-1,1,6,164276935,170919482,6642547,168002;10846;387263;55274;55780;285800;2853;4301;113402;5134;401285;3834;5689;54346;253769;100128124;168090;79981;7058;83887;6991;6196;8635;28514;84498;6953;6862;51660;64094;1235;11116;6908,32
-1,1,6,164361517,170919482,6557965,168002;10846;387263;55274;55780;285800;2853;4301;113402;5134;401285;3834;5689;54346;253769;100128124;168090;79981;7058;83887;6991;6196;8635;28514;84498;6953;6862;51660;64094;1235;11116;6908,32
-1,1,6,165203779,170921089,5717310,168002;10846;387263;55274;55780;285800;2853;4301;113402;5134;401285;3834;5689;54346;253769;100128124;168090;79981;7058;83887;6991;6196;8635;28514;84498;6953;6862;51660;64094;1235;11116;6908,32
-1,1,6,166110423,170919482,4809059,3834;5689;54346;168002;253769;100128124;79981;7058;6991;387263;83887;55274;6196;11116;8635;28514;84498;6953;55780;6862;285800;2853;51660;64094;1235;4301;113402;5134;6908;401285,30
-1,1,6,167148528,171055067,3906539,3834;5689;54346;168002;253769;100128124;79981;7058;6991;387263;83887;55274;6196;11116;8635;28514;84498;6953;55780;2853;64094;1235;4301;5134;6908;401285,26
-1,1,6,167558538,171023595,3465057,3834;5689;54346;168002;253769;100128124;79981;7058;6991;387263;83887;55274;28514;84498;6953;55780;2853;64094;4301;5134;6908;401285,22
1,-1,6,168089899,168196434,106535,,0
-1,1,6,168161046,170919482,2758436,3834;5689;168002;79981;100128124;7058;253769;6991;387263;55274;28514;84498;55780;64094;4301;5134;6908,17
1,-1,6,168225290,168265762,40472,4301,1
-1,1,6,168297593,171023595,2726002,3834;5689;168002;79981;100128124;7058;253769;6991;387263;55274;28514;84498;55780;64094;4301;5134;6908,17
1,-1,6,168343841,168776932,433091,3834;100128124;4301;168002;79981,5
1,-1,6,168350998,169054014,703016,3834;64094;100128124;4301;168002;79981,6
1,-1,6,168364298,168557878,193580,3834;4301;100128124;79981,4
-1,1,6,168364298,170906766,2542468,3834;5689;168002;79981;100128124;7058;253769;6991;387263;55274;28514;84498;55780;64094;4301;5134;6908,17
1,-1,6,168364343,168557983,193640,3834;4301;100128124;79981,4
1,-1,6,168419548,168549222,129674,3834;79981,2
1,-1,6,168419548,168549222,129674,3834;79981,2
1,-1,6,168419548,168656919,237371,3834;79981,2
1,-1,6,168419548,168656919,237371,3834;79981,2
1,-1,6,168419548,168656919,237371,3834;79981,2
1,-1,6,168419548,168656919,237371,3834;79981,2
1,-1,6,168447123,168656919,209796,79981,1
1,-1,6,168619459,168860854,241395,64094;168002,2
1,-1,6,168619459,168996563,377104,64094;168002,2
-1,1,6,168827897,170919482,2091585,28514;5689;84498;55780;253769;7058;6991;387263;64094;55274;5134;6908,12
-1,1,6,168923404,170919482,1996078,28514;5689;84498;55780;253769;7058;6991;387263;64094;55274;5134;6908,12
-1,1,6,168981939,170919482,1937543,28514;5689;84498;55780;253769;7058;6991;387263;64094;55274;5134;6908,12
1,1,6,169131334,170919482,1788148,28514;5689;84498;55780;253769;7058;6991;387263;55274;5134;6908,11
-1,1,6,169235041,170921089,1686048,28514;5689;84498;55780;253769;7058;6991;387263;55274;5134;6908,11
-1,1,6,169281562,170911240,1629678,28514;5689;84498;55780;253769;7058;6991;387263;55274;5134;6908,11
-1,1,6,170088905,170892302,803397,28514;5689;84498;55780;253769;6991;387263;55274;5134;6908,10
-1,-1,6,170342687,170566148,223461,,0
-1,-1,6,170540592,170667507,126915,28514;84498,2
1,-1,6,170766049,170848729,82680,5689,1
-1,-1,6,170808200,170841628,33428,,0
1,-1,6,170832432,170911240,78808,5689;5134;6908,3
1,-1,6,170937459,170983403,45944,,0
1,-1,6,170937459,171008097,70638,,0
1,-1,6,170937459,171025471,88012,,0
1,-1,7,10239,229852,219613,56975,1
1,-1,7,24385,65604,41219,,0
1,-1,7,36480,80075,43595,,0
1,-1,7,36480,80075,43595,,0
1,-1,7,36480,102404,65924,,0
1,-1,7,36480,227774,191294,56975,1
-1,1,7,43360,3642604,3599244,79778;84433;8662;8379;155185;202915;29960;2852;402635;3955;55501;54905;51608;80727;392617;90637;2768;84310;54919;29886;115330;5154;221935;23288;90639;84262;23353;4521;26173;221927;5575;340260;7975;11033;56975,35
1,1,7,43360,5443709,5400349,79778;84433;57786;9907;8662;84629;8379;155185;202915;29960;2852;221938;221937;55698;402635;3955;222962;100533952;55501;54905;51608;80727;392617;90637;2768;84310;54919;56903;29886;115330;5154;221935;23288;90639;84262;23353;4521;26173;221927;5575;340260;26100;7975;11033;56975,45
1,1,7,43360,11567351,11523991,30010;3382;9907;79034;9265;84629;155185;2852;55146;221937;55698;3955;100533952;55501;54905;27102;51608;392617;5395;54476;5879;84310;84792;221955;29886;5154;221935;23288;90639;4521;84262;221981;113263;654231;56975;79778;84433;51622;57786;729852;8662;8379;54753;202915;6119;29960;7559;221938;222967;7965;221960;392862;402635;222962;80028;56913;4697;100131017;80727;60;90637;84132;2768;54468;54919;56903;115330;9678;23353;26173;221927;100310846;5575;340260;728194;6624;26100;7975;11033;340267;11014,81
1,1,7,43360,12098696,12055336,30010;3382;9907;79034;9265;84629;155185;2852;55146;221937;55698;3955;100533952;55501;54905;27102;51608;392617;5395;54476;5879;84310;84792;221955;29886;5154;221935;23288;90639;4521;84262;221981;113263;654231;56975;79778;84433;51622;57786;729852;8662;8379;54753;202915;6119;29960;7559;221938;222967;7965;221960;392862;402635;222962;80028;56913;4697;100131017;80727;60;90637;84132;2768;54468;54919;56903;115330;9678;23353;26173;221927;100310846;5575;340260;728194;6624;26100;7975;11033;340267;11014,81
1,1,7,43360,14664158,14620798,30010;3382;2115;9907;79034;9265;84629;155185;2852;55146;221937;55698;3955;100533952;55501;54905;27102;51608;392617;5395;54476;5879;84310;84792;1607;221955;29886;5154;221935;23288;90639;4521;84262;221981;221806;113263;654231;56975;79778;84433;51622;57786;729852;8662;8379;54753;202915;6119;29960;7559;221938;222967;7965;221960;392862;402635;222962;80028;56913;4697;100131017;80727;60;90637;84132;2768;54468;54919;54664;56903;115330;9678;85477;10124;23353;26173;221927;100310846;5575;340260;728194;6624;26100;7975;11033;340267;11014,87
1,1,7,43360,17656861,17613501,30010;3382;2115;392636;27075;9907;79034;9265;25928;84629;155185;4223;2852;55146;221937;55698;3955;100533952;55501;54905;729920;27102;51608;392617;196;5395;54476;5879;84310;84792;1607;221955;29886;28969;5154;221935;155465;23288;90639;4521;10551;84262;57037;221981;221806;113263;654231;56975;79778;84433;51622;57786;729852;8662;8379;54753;202915;6119;100506049;29960;7559;221938;222967;7965;221960;392862;402635;222962;80028;56913;4697;100131017;80727;60;90637;84132;2768;54468;54919;54664;56903;115330;9678;85477;10124;23353;26173;221927;100310846;5575;340260;728194;6624;26100;7975;11033;340267;11014,98
1,1,7,43360,23674928,23631568,30010;3382;2115;392636;55536;27075;90693;9907;79034;9265;25928;84629;155185;4223;84668;2852;115416;55146;221937;55698;3955;8701;100533952;55501;54905;729920;27102;51608;392617;196;5395;54476;5879;10457;84310;84792;1607;221955;29886;11097;28969;5154;221935;155465;23288;90639;4521;10551;84262;221823;57037;7291;23161;10643;221981;9734;221806;113263;654231;56975;79778;84433;51622;57786;222894;729852;8662;256130;256227;340273;8379;54753;202915;6119;100506049;3569;29960;7559;221830;221938;222967;7965;221960;392862;221833;402635;222962;80028;56913;346389;4697;54543;100131017;80727;60;90637;84132;2768;55975;54468;54919;54664;56903;115330;9678;85477;9771;10124;23353;26173;221927;100310846;5575;340260;728194;6671;29896;6624;26100;7975;3696;11033;340267;11014,124
1,1,7,43360,27236023,27192663,3382;2115;392636;55536;27075;90693;9907;136895;79034;84629;155185;51678;2852;56164;221937;55698;729920;27102;51608;54476;1607;221955;29886;28969;221935;155465;23288;90639;4521;10551;221823;23161;9734;221806;84433;222894;8662;3198;256130;256227;340273;8379;54753;6119;100506049;3569;222967;7965;392862;3202;80028;4852;346389;4697;54543;100131017;60;84132;2768;3181;55975;3201;54919;54664;56903;9678;10124;26173;285941;221927;100310846;5575;340260;728194;6671;29896;11033;340267;115416;11014;30010;26031;9265;25928;340277;29887;4223;84668;3207;55146;3955;8701;100533952;55501;3205;54905;8935;392617;196;5395;5879;10457;64111;84310;3204;11097;5154;84262;3206;57037;7291;10643;221981;113263;654231;79778;51622;57786;729852;3199;202915;29960;7559;221830;221938;221960;221833;402635;222962;3203;11335;56913;80727;90637;54468;3200;115330;1687;85477;9771;23353;54205;6624;26100;7975;3696;84792;9603;56975,149
-1,1,7,43360,159119707,159076347,3382;2115;2041;29923;50640;27075;136895;346562;84725;51593;7791;168537;27072;9296;51678;84691;10282;56164;257415;55698;60561;4708;57180;51384;27044;100861540;10320;857;5137;6717;729920;54809;26211;168507;948;23554;6718;3624;2913;346517;1607;221955;5054;441234;9988;168544;221935;4521;100128553;55112;55744;55971;100463482;10371;10467;1576;4232;58160;8427;55063;55365;91584;55069;23660;154790;222256;100507421;2128;51119;8379;389549;154791;7472;79706;57464;3202;7551;7458;4967;346389;11328;4697;54543;154743;2636;100130880;83637;3201;5898;7462;389541;222236;22853;51427;202865;51251;340260;25851;136371;29896;5118;155038;154907;246721;358;5304;140545;445347;81844;85025;1124;7979;80228;5243;10095;392843;8701;9031;165;11185;5764;222068;222183;54927;55503;222166;23480;23165;392617;196;5782;442590;799;5224;29881;64418;3792;83590;231;3364;5078;9715;136051;3082;23333;9069;222235;3751;4899;285973;221981;54784;728927;442721;654231;9805;285955;375593;10049;57488;858;781;23148;136541;340307;58508;346606;3199;10268;29062;80853;643641;10157;1357;8972;8454;11179;136991;27010;221938;1020;221960;1780;221833;402635;222962;56913;349149;26047;100287482;100289678;889;54468;50831;2146;170575;78996;107;64792;115330;9883;85477;100289561;2845;83605;100527949;2645;54205;54517;154872;155368;155066;84060;6624;23382;7975;3696;95681;60412;9263;25913;816;90693;84277;4885;64764;259285;8805;3952;221908;83992;647087;79989;494551;90827;5577;1811;10344;55607;100130705;22797;25798;9551;100310812;79872;84912;375612;63917;9275;54476;3484;10234;441294;653361;10603;23288;54606;51142;5001;27000;25870;222865;219578;27445;440;51530;285888;340348;50832;54892;23089;136319;767558;84433;222894;2918;81392;3198;168417;8985;3569;644150;8321;3209;79037;222967;442361;55033;5803;56302;80028;9586;51657;135946;100131017;402682;3181;11333;2050;223117;2791;51314;55253;11062;3757;51650;5260;10875;7980;8295;2990;6856;5244;29992;135948;5726;64101;100310846;55665;4034;100996928;54429;55131;8460;57541;1551;57016;255374;100130988;340277;55262;3268;79974;1080;10165;3207;51631;89122;55146;22976;100533952;2969;401387;64598;55904;3205;54905;6878;9238;28988;22932;26136;7586;830;6677;7589;5447;5879;29999;10457;441282;261729;3204;3315;83862;813;3206;9690;5649;7425;5445;389493;5189;113263;100316904;673;114049;1956;79778;349075;10392;729852;9162;9723;5218;221785;7378;22798;79689;346673;4176;29960;5294;389558;7461;56829;56311;26959;6009;81554;56257;7984;100142659;55750;23008;340351;2318;259286;285966;51667;4850;130075;135932;83451;5166;9771;136306;23353;64759;23658;9569;26100;2770;10248;9603;375616;445328;1395;392636;55536;222171;9907;221914;51691;79034;908;136242;442319;84629;135941;154664;2852;389602;11194;80099;4698;4233;57414;346528;168391;27102;6742;100101267;51422;2617;64224;100526740;154865;9747;55303;349136;155051;26266;27147;7036;3092;29886;101927655;117;26958;155465;10061;7982;402317;100134938;4897;401335;8621;730130;989;27297;26157;9734;79161;221806;26872;2006;100534592;94239;54480;1749;51085;154807;8662;5683;7532;57157;6561;256227;79783;64761;54753;155054;51619;1021;2086;53616;5701;3984;57798;392862;83698;105375396;60;9311;9865;63979;55975;54919;63974;56903;26053;7455;2792;7205;54677;51024;23534;9678;10922;10135;79020;402573;135935;26173;285941;2051;5506;7516;4191;93986;54749;340252;54329;346653;51200;375611;3663;30010;64983;222008;84163;222255;8896;84626;9265;25928;154881;84668;84928;644;26;80820;155061;6469;10142;55501;5172;256979;346288;8976;5395;155435;2631;3912;221895;55340;64327;5814;7328;1750;85865;142685;11097;5154;7988;2861;285989;5478;84262;223082;7291;100271927;10552;10643;222234;5420;222950;285971;168433;114960;373156;51622;389524;5799;353345;57154;245812;5444;548644;441250;79027;378925;9601;1738;7559;221830;6804;30816;58498;3203;8887;6100;10156;8326;23145;84182;441272;93664;10071;84255;80727;1174;222229;23608;653857;43;90637;10898;64921;57189;7978;6424;3200;136647;4289;401427;9179;10926;338398;79846;29990;1595;1644;23242;55973;155006;221786;26024;100289187;254048;729438;84792;10980;55915;54504;24146;6863;168850;90956;154661;10512;54467;105375355;168374;155185;2692;11112;221937;27241;8468;223075;136288;375607;23386;10793;8910;136263;11281;2783;51608;375567;286006;92092;3361;28969;10551;90639;221823;835;23553;23161;7434;54103;113878;93408;393046;222223;1180;57001;65999;6733;474344;219557;10466;55695;135927;256130;340273;3486;6119;100506049;168667;135892;26261;800;346525;7965;27434;155382;64005;55610;93979;136259;83930;64951;4852;313;352954;140453;2056;1129;3638;219285;7697;54443;51351;84132;2768;7784;54664;253012;1523;29803;64434;259287;1364;10124;221927;168620;728194;5575;168455;79571;6671;392138;51412;54674;11033;55798;340267;115416;79017;11014;5982;26031;64816;378108;27153;3614;29887;222194;1804;10447;4223;29969;57670;23601;435;4951;3955;4584;6916;136227;81628;28996;5644;116988;3110;401409;8935;1365;346689;563;381;113763;83943;730291;64111;84310;9512;64409;28959;669;4189;273;57057;64753;55972;5723;9844;57037;6604;5425;1577;136332;2737;136853;55281;56975;387129;1278;9863;729597;57786;57639;51666;64599;50617;3475;57002;135886;100507507;202915;93432;9732;402569;401399;83787;26608;1358;11335;10652;11055;79690;2020;5919;2887;135924;50833;6369;6608;23366;81552;23080;285877;5439;6522;4846;441273;54556;611;109504726;1687;10842;84124;10734;25948;51373;56996;23072;5446;168451;27342,884
1,1,7,43361,159119707,159076346,3382;2115;2041;29923;50640;27075;136895;346562;84725;51593;7791;168537;27072;9296;51678;84691;10282;56164;257415;55698;60561;4708;57180;51384;27044;100861540;10320;857;5137;6717;729920;54809;26211;168507;948;23554;6718;3624;2913;346517;1607;221955;5054;441234;9988;168544;221935;4521;100128553;55112;55744;55971;100463482;10371;10467;1576;4232;58160;8427;55063;55365;91584;55069;23660;154790;222256;100507421;2128;51119;8379;389549;154791;7472;79706;57464;3202;7551;7458;4967;346389;11328;4697;54543;154743;2636;100130880;83637;3201;5898;7462;389541;222236;22853;51427;202865;51251;340260;25851;136371;29896;5118;155038;154907;246721;358;5304;140545;445347;81844;85025;1124;7979;80228;5243;10095;392843;8701;9031;165;11185;5764;222068;222183;54927;55503;222166;23480;23165;392617;196;5782;442590;799;5224;29881;64418;3792;83590;231;3364;5078;9715;136051;3082;23333;9069;222235;3751;4899;285973;221981;54784;728927;442721;654231;9805;285955;375593;10049;57488;858;781;23148;136541;340307;58508;346606;3199;10268;29062;80853;643641;10157;1357;8972;8454;11179;136991;27010;221938;1020;221960;1780;221833;402635;222962;56913;349149;26047;100287482;100289678;889;54468;50831;2146;170575;78996;107;64792;115330;9883;85477;100289561;2845;83605;100527949;2645;54205;54517;154872;155368;155066;84060;6624;23382;7975;3696;95681;60412;9263;25913;816;90693;84277;4885;64764;259285;8805;3952;221908;83992;647087;79989;494551;90827;5577;1811;10344;55607;100130705;22797;25798;9551;100310812;79872;84912;375612;63917;9275;54476;3484;10234;441294;653361;10603;23288;54606;51142;5001;27000;25870;222865;219578;27445;440;51530;285888;340348;50832;54892;23089;136319;767558;84433;222894;2918;81392;3198;168417;8985;3569;644150;8321;3209;79037;222967;442361;55033;5803;56302;80028;9586;51657;135946;100131017;402682;3181;11333;2050;223117;2791;51314;55253;11062;3757;51650;5260;10875;7980;8295;2990;6856;5244;29992;135948;5726;64101;100310846;55665;4034;100996928;54429;55131;8460;57541;1551;57016;255374;100130988;340277;55262;3268;79974;1080;10165;3207;51631;89122;55146;22976;100533952;2969;401387;64598;55904;3205;54905;6878;9238;28988;22932;26136;7586;830;6677;7589;5447;5879;29999;10457;441282;261729;3204;3315;83862;813;3206;9690;5649;7425;5445;389493;5189;113263;100316904;673;114049;1956;79778;349075;10392;729852;9162;9723;5218;221785;7378;22798;79689;346673;4176;29960;5294;389558;7461;56829;56311;26959;6009;81554;56257;7984;100142659;55750;23008;340351;2318;259286;285966;51667;4850;130075;135932;83451;5166;9771;136306;23353;64759;23658;9569;26100;2770;10248;9603;375616;445328;1395;392636;55536;222171;9907;221914;51691;79034;908;136242;442319;84629;135941;154664;2852;389602;11194;80099;4698;4233;57414;346528;168391;27102;6742;100101267;51422;2617;64224;100526740;154865;9747;55303;349136;155051;26266;27147;7036;3092;29886;101927655;117;26958;155465;10061;7982;402317;100134938;4897;401335;8621;730130;989;27297;26157;9734;79161;221806;26872;2006;100534592;94239;54480;1749;51085;154807;8662;5683;7532;57157;6561;256227;79783;64761;54753;155054;51619;1021;2086;53616;5701;3984;57798;392862;83698;105375396;60;9311;9865;63979;55975;54919;63974;56903;26053;7455;2792;7205;54677;51024;23534;9678;10922;10135;79020;402573;135935;26173;285941;2051;5506;7516;4191;93986;54749;340252;54329;346653;51200;375611;3663;30010;64983;222008;84163;222255;8896;84626;9265;25928;154881;84668;84928;644;26;80820;155061;6469;10142;55501;5172;256979;346288;8976;5395;155435;2631;3912;221895;55340;64327;5814;7328;1750;85865;142685;11097;5154;7988;2861;285989;5478;84262;223082;7291;100271927;10552;10643;222234;5420;222950;285971;168433;114960;373156;51622;389524;5799;353345;57154;245812;5444;548644;441250;79027;378925;9601;1738;7559;221830;6804;30816;58498;3203;8887;6100;10156;8326;23145;84182;441272;93664;10071;84255;80727;1174;222229;23608;653857;43;90637;10898;64921;57189;7978;6424;3200;136647;4289;401427;9179;10926;338398;79846;29990;1595;1644;23242;55973;155006;221786;26024;100289187;254048;729438;84792;10980;55915;54504;24146;6863;168850;90956;154661;10512;54467;105375355;168374;155185;2692;11112;221937;27241;8468;223075;136288;375607;23386;10793;8910;136263;11281;2783;51608;375567;286006;92092;3361;28969;10551;90639;221823;835;23553;23161;7434;54103;113878;93408;393046;222223;1180;57001;65999;6733;474344;219557;10466;55695;135927;256130;340273;3486;6119;100506049;168667;135892;26261;800;346525;7965;27434;155382;64005;55610;93979;136259;83930;64951;4852;313;352954;140453;2056;1129;3638;219285;7697;54443;51351;84132;2768;7784;54664;253012;1523;29803;64434;259287;1364;10124;221927;168620;728194;5575;168455;79571;6671;392138;51412;54674;11033;55798;340267;115416;79017;11014;5982;26031;64816;378108;27153;3614;29887;222194;1804;10447;4223;29969;57670;23601;435;4951;3955;4584;6916;136227;81628;28996;5644;116988;3110;401409;8935;1365;346689;563;381;113763;83943;730291;64111;84310;9512;64409;28959;669;4189;273;57057;64753;55972;5723;9844;57037;6604;5425;1577;136332;2737;136853;55281;56975;387129;1278;9863;729597;57786;57639;51666;64599;50617;3475;57002;135886;100507507;202915;93432;9732;402569;401399;83787;26608;1358;11335;10652;11055;79690;2020;5919;2887;135924;50833;6369;6608;23366;81552;23080;285877;5439;6522;4846;441273;54556;611;109504726;1687;10842;84124;10734;25948;51373;56996;23072;5446;168451;27342,884
1,1,7,43361,159119707,159076346,3382;2115;2041;29923;50640;27075;136895;346562;84725;51593;7791;168537;27072;9296;51678;84691;10282;56164;257415;55698;60561;4708;57180;51384;27044;100861540;10320;857;5137;6717;729920;54809;26211;168507;948;23554;6718;3624;2913;346517;1607;221955;5054;441234;9988;168544;221935;4521;100128553;55112;55744;55971;100463482;10371;10467;1576;4232;58160;8427;55063;55365;91584;55069;23660;154790;222256;100507421;2128;51119;8379;389549;154791;7472;79706;57464;3202;7551;7458;4967;346389;11328;4697;54543;154743;2636;100130880;83637;3201;5898;7462;389541;222236;22853;51427;202865;51251;340260;25851;136371;29896;5118;155038;154907;246721;358;5304;140545;445347;81844;85025;1124;7979;80228;5243;10095;392843;8701;9031;165;11185;5764;222068;222183;54927;55503;222166;23480;23165;392617;196;5782;442590;799;5224;29881;64418;3792;83590;231;3364;5078;9715;136051;3082;23333;9069;222235;3751;4899;285973;221981;54784;728927;442721;654231;9805;285955;375593;10049;57488;858;781;23148;136541;340307;58508;346606;3199;10268;29062;80853;643641;10157;1357;8972;8454;11179;136991;27010;221938;1020;221960;1780;221833;402635;222962;56913;349149;26047;100287482;100289678;889;54468;50831;2146;170575;78996;107;64792;115330;9883;85477;100289561;2845;83605;100527949;2645;54205;54517;154872;155368;155066;84060;6624;23382;7975;3696;95681;60412;9263;25913;816;90693;84277;4885;64764;259285;8805;3952;221908;83992;647087;79989;494551;90827;5577;1811;10344;55607;100130705;22797;25798;9551;100310812;79872;84912;375612;63917;9275;54476;3484;10234;441294;653361;10603;23288;54606;51142;5001;27000;25870;222865;219578;27445;440;51530;285888;340348;50832;54892;23089;136319;767558;84433;222894;2918;81392;3198;168417;8985;3569;644150;8321;3209;79037;222967;442361;55033;5803;56302;80028;9586;51657;135946;100131017;402682;3181;11333;2050;223117;2791;51314;55253;11062;3757;51650;5260;10875;7980;8295;2990;6856;5244;29992;135948;5726;64101;100310846;55665;4034;100996928;54429;55131;8460;57541;1551;57016;255374;100130988;340277;55262;3268;79974;1080;10165;3207;51631;89122;55146;22976;100533952;2969;401387;64598;55904;3205;54905;6878;9238;28988;22932;26136;7586;830;6677;7589;5447;5879;29999;10457;441282;261729;3204;3315;83862;813;3206;9690;5649;7425;5445;389493;5189;113263;100316904;673;114049;1956;79778;349075;10392;729852;9162;9723;5218;221785;7378;22798;79689;346673;4176;29960;5294;389558;7461;56829;56311;26959;6009;81554;56257;7984;100142659;55750;23008;340351;2318;259286;285966;51667;4850;130075;135932;83451;5166;9771;136306;23353;64759;23658;9569;26100;2770;10248;9603;375616;445328;1395;392636;55536;222171;9907;221914;51691;79034;908;136242;442319;84629;135941;154664;2852;389602;11194;80099;4698;4233;57414;346528;168391;27102;6742;100101267;51422;2617;64224;100526740;154865;9747;55303;349136;155051;26266;27147;7036;3092;29886;101927655;117;26958;155465;10061;7982;402317;100134938;4897;401335;8621;730130;989;27297;26157;9734;79161;221806;26872;2006;100534592;94239;54480;1749;51085;154807;8662;5683;7532;57157;6561;256227;79783;64761;54753;155054;51619;1021;2086;53616;5701;3984;57798;392862;83698;105375396;60;9311;9865;63979;55975;54919;63974;56903;26053;7455;2792;7205;54677;51024;23534;9678;10922;10135;79020;402573;135935;26173;285941;2051;5506;7516;4191;93986;54749;340252;54329;346653;51200;375611;3663;30010;64983;222008;84163;222255;8896;84626;9265;25928;154881;84668;84928;644;26;80820;155061;6469;10142;55501;5172;256979;346288;8976;5395;155435;2631;3912;221895;55340;64327;5814;7328;1750;85865;142685;11097;5154;7988;2861;285989;5478;84262;223082;7291;100271927;10552;10643;222234;5420;222950;285971;168433;114960;373156;51622;389524;5799;353345;57154;245812;5444;548644;441250;79027;378925;9601;1738;7559;221830;6804;30816;58498;3203;8887;6100;10156;8326;23145;84182;441272;93664;10071;84255;80727;1174;222229;23608;653857;43;90637;10898;64921;57189;7978;6424;3200;136647;4289;401427;9179;10926;338398;79846;29990;1595;1644;23242;55973;155006;221786;26024;100289187;254048;729438;84792;10980;55915;54504;24146;6863;168850;90956;154661;10512;54467;105375355;168374;155185;2692;11112;221937;27241;8468;223075;136288;375607;23386;10793;8910;136263;11281;2783;51608;375567;286006;92092;3361;28969;10551;90639;221823;835;23553;23161;7434;54103;113878;93408;393046;222223;1180;57001;65999;6733;474344;219557;10466;55695;135927;256130;340273;3486;6119;100506049;168667;135892;26261;800;346525;7965;27434;155382;64005;55610;93979;136259;83930;64951;4852;313;352954;140453;2056;1129;3638;219285;7697;54443;51351;84132;2768;7784;54664;253012;1523;29803;64434;259287;1364;10124;221927;168620;728194;5575;168455;79571;6671;392138;51412;54674;11033;55798;340267;115416;79017;11014;5982;26031;64816;378108;27153;3614;29887;222194;1804;10447;4223;29969;57670;23601;435;4951;3955;4584;6916;136227;81628;28996;5644;116988;3110;401409;8935;1365;346689;563;381;113763;83943;730291;64111;84310;9512;64409;28959;669;4189;273;57057;64753;55972;5723;9844;57037;6604;5425;1577;136332;2737;136853;55281;56975;387129;1278;9863;729597;57786;57639;51666;64599;50617;3475;57002;135886;100507507;202915;93432;9732;402569;401399;83787;26608;1358;11335;10652;11055;79690;2020;5919;2887;135924;50833;6369;6608;23366;81552;23080;285877;5439;6522;4846;441273;54556;611;109504726;1687;10842;84124;10734;25948;51373;56996;23072;5446;168451;27342,884
1,1,7,45130,7291696,7246566,9907;79034;9265;84629;155185;2852;55146;221937;55698;3955;100533952;55501;54905;27102;51608;392617;5395;54476;5879;84310;221955;29886;5154;221935;23288;90639;84262;4521;654231;56975;79778;84433;51622;57786;8662;8379;54753;202915;29960;7559;221938;222967;7965;221960;392862;402635;222962;80028;56913;100131017;80727;60;90637;84132;2768;54919;56903;115330;11033;23353;26173;221927;100310846;5575;340260;728194;6624;26100;7975;84792;11014,71
1,1,7,45130,25260784,25215654,3382;2115;392636;55536;27075;90693;9907;136895;79034;84629;155185;51678;2852;56164;221937;55698;729920;27102;51608;54476;1607;221955;29886;28969;221935;155465;23288;90639;4521;10551;221823;23161;9734;221806;84433;222894;8662;256130;256227;340273;8379;54753;6119;100506049;3569;222967;7965;392862;80028;4852;346389;4697;54543;100131017;60;84132;2768;55975;54919;54664;56903;9678;10124;26173;221927;100310846;5575;340260;728194;6671;29896;11033;340267;115416;11014;30010;26031;9265;25928;340277;4223;84668;55146;3955;8701;100533952;55501;54905;392617;196;5395;5879;10457;84310;11097;5154;84262;57037;7291;10643;221981;113263;654231;79778;51622;57786;729852;202915;29960;7559;221830;221938;221960;221833;402635;222962;56913;80727;90637;54468;115330;1687;85477;9771;23353;54205;6624;26100;7975;3696;84792;56975,132
1,-1,7,46494,65558,19064,,0
1,-1,7,54165,127214,73049,,0
-1,-1,7,54165,214573,160408,56975,1
-1,1,7,54165,764962,710797,5154;5575;56975,3
-1,1,7,54165,3298407,3244242,79778;84433;8662;8379;155185;202915;29960;2852;402635;3955;55501;54905;51608;80727;392617;90637;2768;84310;54919;29886;115330;5154;23288;90639;84262;23353;4521;26173;221927;5575;340260;7975;11033;56975,34
1,-1,7,54185,120272,66087,,0
1,-1,7,54185,170425,116240,,0
1,-1,7,54185,170425,116240,,0
-1,1,7,54185,1883220,1829035,392617;79778;90637;84310;54919;115330;8379;5154;202915;90639;84262;23353;2852;26173;5575;340260;54905;7975;11033;51608;56975,21
-1,1,7,54185,3363775,3309590,79778;84433;8662;8379;155185;202915;29960;2852;402635;3955;55501;54905;51608;80727;392617;90637;2768;84310;54919;29886;115330;5154;221935;23288;90639;84262;23353;4521;26173;221927;5575;340260;7975;11033;56975,35
1,1,7,54185,6677658,6623473,9907;79034;9265;84629;155185;2852;55146;221937;55698;3955;100533952;55501;54905;27102;51608;392617;5395;54476;5879;84310;221955;29886;5154;221935;23288;90639;84262;4521;654231;56975;79778;84433;51622;57786;8662;8379;54753;202915;29960;221938;222967;7965;392862;402635;222962;80028;100131017;80727;60;90637;84132;2768;54919;56903;115330;11033;23353;26173;221927;100310846;5575;340260;6624;26100;7975;84792;11014,67
1,1,7,54185,26867253,26813068,3382;2115;392636;55536;27075;90693;9907;136895;79034;84629;155185;51678;2852;56164;221937;55698;729920;27102;51608;54476;1607;221955;29886;28969;221935;155465;23288;90639;4521;10551;221823;23161;9734;221806;84433;222894;8662;256130;256227;340273;8379;54753;6119;100506049;3569;222967;7965;392862;80028;4852;346389;4697;54543;100131017;60;84132;2768;3181;55975;54919;54664;56903;9678;10124;26173;285941;221927;100310846;5575;340260;728194;6671;29896;11033;340267;115416;11014;30010;26031;9265;25928;340277;29887;4223;84668;55146;3955;8701;100533952;55501;54905;8935;392617;196;5395;5879;10457;64111;84310;11097;5154;84262;57037;7291;10643;221981;113263;654231;79778;51622;57786;729852;202915;29960;7559;221830;221938;221960;221833;402635;222962;11335;56913;80727;90637;54468;115330;1687;85477;9771;23353;54205;6624;26100;7975;3696;84792;9603;56975,139
-1,1,7,54185,159075079,159020894,3382;2115;2041;29923;50640;27075;136895;346562;84725;51593;7791;168537;27072;9296;51678;84691;10282;56164;257415;55698;60561;4708;57180;51384;27044;100861540;10320;857;5137;6717;729920;54809;26211;168507;948;23554;6718;3624;2913;346517;1607;221955;5054;441234;9988;168544;221935;4521;100128553;55112;55744;55971;100463482;10371;10467;1576;4232;58160;8427;55063;55365;91584;55069;23660;154790;222256;100507421;2128;51119;8379;389549;154791;7472;79706;57464;3202;7551;7458;4967;346389;11328;4697;54543;154743;2636;100130880;83637;3201;5898;7462;389541;222236;22853;51427;202865;51251;340260;25851;136371;29896;5118;155038;154907;246721;358;5304;140545;445347;81844;85025;1124;7979;80228;5243;10095;392843;8701;9031;165;11185;5764;222068;222183;54927;55503;222166;23480;23165;392617;196;5782;442590;799;5224;29881;64418;3792;83590;231;3364;5078;9715;136051;3082;23333;9069;222235;3751;4899;285973;221981;54784;728927;442721;654231;9805;285955;375593;10049;57488;858;781;23148;136541;340307;58508;346606;3199;10268;29062;80853;643641;10157;1357;8972;8454;11179;136991;27010;221938;1020;221960;1780;221833;402635;222962;56913;349149;26047;100287482;100289678;889;54468;50831;2146;170575;78996;107;64792;115330;9883;85477;100289561;2845;83605;100527949;2645;54205;54517;154872;155368;155066;84060;6624;23382;7975;3696;95681;60412;9263;25913;816;90693;84277;4885;64764;259285;8805;3952;221908;83992;647087;79989;494551;90827;5577;1811;10344;55607;100130705;22797;25798;9551;100310812;79872;84912;375612;63917;9275;54476;3484;10234;441294;653361;10603;23288;54606;51142;5001;27000;25870;222865;219578;27445;440;51530;285888;340348;50832;54892;23089;136319;767558;84433;222894;2918;81392;3198;168417;8985;3569;644150;8321;3209;79037;222967;442361;55033;5803;56302;80028;9586;51657;135946;100131017;402682;3181;11333;2050;223117;2791;51314;55253;11062;3757;51650;5260;10875;7980;8295;2990;6856;5244;29992;135948;5726;64101;100310846;55665;4034;100996928;54429;55131;8460;57541;1551;57016;255374;100130988;340277;55262;3268;79974;1080;10165;3207;51631;89122;55146;22976;100533952;2969;401387;64598;55904;3205;54905;6878;9238;28988;22932;26136;7586;830;6677;7589;5447;5879;29999;10457;441282;261729;3204;3315;83862;813;3206;9690;5649;7425;5445;389493;5189;113263;100316904;673;114049;1956;79778;349075;10392;729852;9162;9723;5218;221785;7378;22798;79689;346673;4176;29960;5294;389558;7461;56829;56311;26959;6009;81554;56257;7984;100142659;55750;23008;340351;2318;259286;285966;51667;4850;130075;135932;83451;5166;9771;136306;23353;64759;23658;9569;26100;2770;10248;9603;375616;445328;1395;392636;55536;222171;9907;221914;51691;79034;908;136242;442319;84629;135941;154664;2852;389602;11194;80099;4698;4233;57414;346528;168391;27102;6742;100101267;51422;2617;64224;100526740;154865;9747;55303;349136;155051;26266;27147;7036;3092;29886;101927655;117;26958;155465;10061;7982;402317;100134938;4897;401335;8621;730130;989;27297;26157;9734;79161;221806;26872;2006;100534592;94239;54480;1749;51085;154807;8662;5683;7532;57157;6561;256227;79783;64761;54753;155054;51619;1021;2086;53616;5701;3984;57798;392862;83698;105375396;60;9311;9865;63979;55975;54919;63974;56903;26053;7455;2792;7205;54677;51024;23534;9678;10922;10135;79020;402573;135935;26173;285941;2051;5506;7516;4191;93986;54749;340252;54329;346653;51200;375611;3663;30010;64983;222008;84163;222255;8896;84626;9265;25928;154881;84668;84928;644;26;80820;155061;6469;10142;55501;5172;256979;346288;8976;5395;155435;2631;3912;221895;55340;64327;5814;7328;1750;85865;142685;11097;5154;7988;2861;285989;5478;84262;223082;7291;100271927;10552;10643;222234;5420;222950;285971;168433;114960;373156;51622;389524;5799;353345;57154;245812;5444;548644;441250;79027;378925;9601;1738;7559;221830;6804;30816;58498;3203;8887;6100;10156;8326;23145;84182;441272;93664;10071;84255;80727;1174;222229;23608;653857;43;90637;10898;64921;57189;7978;6424;3200;136647;4289;401427;9179;10926;338398;79846;29990;1595;1644;23242;55973;155006;221786;26024;100289187;254048;729438;84792;10980;55915;54504;24146;6863;168850;90956;154661;10512;54467;105375355;168374;155185;2692;11112;221937;27241;8468;223075;136288;375607;23386;10793;8910;136263;11281;2783;51608;375567;286006;92092;3361;28969;10551;90639;221823;835;23553;23161;7434;54103;113878;93408;393046;222223;1180;57001;65999;6733;474344;219557;10466;55695;135927;256130;340273;3486;6119;100506049;168667;135892;26261;800;346525;7965;27434;155382;64005;55610;93979;136259;83930;64951;4852;313;352954;140453;2056;1129;3638;219285;7697;54443;51351;84132;2768;7784;54664;253012;1523;29803;64434;259287;1364;10124;221927;168620;728194;5575;168455;79571;6671;392138;51412;54674;11033;55798;340267;115416;79017;11014;5982;26031;64816;378108;27153;3614;29887;222194;1804;10447;4223;29969;57670;23601;435;4951;3955;4584;6916;136227;81628;28996;5644;116988;3110;401409;8935;1365;346689;563;381;113763;83943;730291;64111;84310;9512;64409;28959;669;4189;273;57057;64753;55972;5723;9844;57037;6604;5425;1577;136332;2737;136853;55281;56975;387129;1278;9863;729597;57786;57639;51666;64599;50617;3475;57002;135886;100507507;202915;93432;9732;402569;401399;83787;26608;1358;11335;10652;11055;79690;2020;5919;2887;135924;50833;6369;6608;23366;81552;23080;285877;5439;6522;4846;441273;54556;611;109504726;1687;10842;84124;10734;25948;51373;56996;23072;5446;168451;27342,884
1,-1,7,94063,109692,15629,,0
1,-1,7,101528,227833,126305,56975,1
1,-1,7,101528,227833,126305,56975,1
-1,-1,7,120242,180597,60355,,0
1,-1,7,127155,214573,87418,56975,1
1,1,7,183556,12746636,12563080,30010;3382;9907;79034;9265;84629;155185;2852;55146;221937;55698;3955;100533952;55501;54905;27102;51608;392617;5395;54476;5879;84310;84792;221955;29886;5154;221935;23288;90639;4521;84262;221981;221806;113263;654231;56975;79778;84433;51622;57786;729852;8662;8379;54753;202915;6119;29960;7559;221938;222967;7965;221960;392862;402635;222962;80028;56913;4697;100131017;80727;60;90637;84132;2768;54468;54919;54664;56903;115330;9678;85477;10124;23353;26173;221927;100310846;5575;340260;728194;6624;26100;7975;11033;340267;11014,85
1,-1,7,183570,229852,46282,56975,1
-1,-1,7,214514,229824,15310,56975,1
1,1,7,704573,29257946,28553373,54504;3382;2115;392636;55536;27075;90693;9907;136895;79034;84629;155185;51678;2852;11112;56164;221937;55698;729920;27102;51608;54476;1607;221955;29886;28969;221935;155465;23288;90639;4521;10551;221823;23161;9734;221806;84433;222894;8662;2128;3198;256130;256227;340273;8379;54753;6119;100506049;3569;3209;222967;7965;392862;3202;80028;4852;9586;346389;4697;54543;100131017;60;9865;84132;2768;3181;55975;3201;54919;54664;56903;9678;10124;26173;285941;221927;100310846;5575;340260;728194;6671;29896;11033;340267;115416;11014;30010;26031;9265;25928;340277;29887;1124;4223;84668;3207;55146;3955;8701;100533952;55501;3205;54905;8935;392617;196;5395;5879;10457;64111;84310;221895;3204;11097;84262;3206;57037;7291;10643;221981;113263;654231;79778;51622;57786;729852;3199;202915;29960;7559;221830;221938;221960;221833;402635;222962;3203;8887;11335;56913;80727;90637;54468;3200;115330;1687;85477;9771;23353;54205;6624;26100;7975;3696;84792;9603,156
1,-1,7,906574,988123,81549,23353;11033;51608,3
1,-1,7,930542,985083,54541,11033;51608,2
1,-1,7,930542,988123,57581,11033;51608,2
1,-1,7,930542,988123,57581,11033;51608,2
1,-1,7,930542,988123,57581,11033;51608,2
1,-1,7,930542,988123,57581,11033;51608,2
1,-1,7,930542,988123,57581,11033;51608,2
1,-1,7,930542,1030366,99824,11033;51608;54905;90639,4
1,-1,7,935913,980013,44100,11033;51608,2
1,-1,7,935913,1062016,126103,54905;11033;51608;84310;90639,5
-1,1,7,1201674,5175651,3973977,392617;79778;84433;2768;57786;9907;8662;56903;29886;155185;8379;202915;221935;23288;4521;84262;29960;221938;26173;221937;55698;221927;402635;3955;340260;100533952;55501;7975;80727,29
1,1,7,1737760,27246914,25509154,3382;2115;392636;55536;27075;90693;9907;136895;79034;84629;155185;51678;56164;221937;55698;729920;27102;54476;1607;221955;29886;28969;221935;155465;23288;4521;10551;221823;23161;9734;221806;84433;222894;8662;3198;256130;256227;340273;8379;54753;6119;100506049;3569;3209;222967;7965;392862;3202;80028;4852;346389;4697;54543;100131017;60;84132;2768;3181;55975;3201;54664;56903;9678;10124;285941;221927;100310846;728194;6671;29896;340267;115416;11014;30010;26031;9265;25928;340277;29887;4223;84668;3207;55146;3955;8701;100533952;55501;3205;8935;392617;196;5395;5879;10457;64111;3204;11097;3206;57037;7291;10643;221981;113263;654231;51622;57786;729852;3199;29960;7559;221830;221938;221960;221833;402635;222962;3203;11335;56913;80727;54468;3200;1687;85477;9771;54205;6624;26100;3696;84792;9603,131
-1,-1,7,1958233,2032641,74408,8379,1
-1,-1,7,2007359,2074962,67603,8379,1
-1,-1,7,2439312,2480542,41230,55501,1
-1,-1,7,3167411,3214077,46666,,0
1,-1,7,4374018,4519767,145749,,0
-1,-1,7,5488018,6316581,828563,60;5395;222967;7965;54476;51622;84132;100310846;80028;9265;6624;654231;27102,13
1,1,7,5721840,27269930,21548090,30010;26031;3382;2115;392636;55536;27075;90693;136895;79034;9265;25928;340277;29887;4223;84668;51678;3207;55146;56164;8701;3205;729920;27102;8935;196;5395;54476;5879;10457;64111;1607;221955;3204;11097;28969;155465;10551;3206;221823;57037;7291;23161;10643;221981;9734;221806;113263;654231;51622;222894;729852;3199;3198;256130;256227;340273;54753;6119;100506049;3569;3209;7559;221830;222967;7965;221960;392862;221833;3202;3203;11335;4852;56913;346389;4697;54543;100131017;84132;3181;55975;3201;54468;54664;3200;9678;1687;85477;9771;10124;340267;285941;54205;100310846;728194;6671;29896;3696;84792;115416;9603;11014,102
1,-1,7,5799660,5925847,126187,654231;54476,2
-1,-1,7,5862847,5944692,81845,51622;654231,2
1,-1,7,5864792,5925847,61055,654231,1
1,-1,7,6714553,6745510,30957,7559,1
1,-1,7,7274148,7422178,148030,340267;56913,2
-1,-1,7,7288899,7456695,167796,340267,1
-1,1,7,9023635,17395474,8371839,196;2115;392636;27075;54664;25928;1607;28969;9678;4223;100506049;155465;85477;10551;10124;57037;221981;221806;4697;729920,20
1,-1,7,9436795,9737394,300599,,0
1,-1,7,9673939,9737394,63455,,0
-1,1,7,10649696,25800180,15150484,26031;2115;392636;55536;27075;222894;90693;136895;25928;340277;256130;256227;340273;4223;3569;100506049;84668;51678;221830;56164;221833;8701;4852;346389;4697;54543;729920;196;55975;10457;64111;54664;1607;11097;28969;9678;1687;155465;85477;10551;9771;10124;57037;221823;7291;23161;54205;10643;221981;6671;29896;9734;221806;3696;115416,55
1,1,7,11048840,52863626,41814786,54504;9263;2115;392636;55536;1395;222171;816;27075;90693;136895;84725;2692;154664;27072;51678;11112;56164;27241;80099;223075;136288;23386;10320;5137;729920;11281;375567;168507;2617;64224;3624;3484;1607;117;28969;155465;10551;54606;401335;221823;8621;23161;55744;989;9734;221806;100534592;94239;222894;2128;5683;3198;256130;256227;340273;79783;3486;3569;100506049;168667;644150;51619;3209;27434;64005;55033;3202;83930;64951;4852;9586;313;4967;346389;11328;54543;54443;9865;3181;83637;63979;55975;3201;54664;63974;51314;5898;9678;79020;10124;285941;51251;6671;29896;54749;55665;115416;79017;26031;64983;358;100130988;25928;340277;445347;29887;1124;4223;84668;3207;644;80820;8701;165;11185;3205;222068;9238;28988;256979;222166;8935;196;10457;64111;221895;5224;29881;5814;3204;273;57057;11097;3364;5478;23333;9844;3206;57037;223082;7291;5425;10643;221981;2737;9805;285955;387129;23148;10392;353345;3199;10268;57002;7378;221830;58498;221833;3203;8887;6100;11335;10652;11055;84182;2887;23366;23080;107;6424;3200;136647;1687;85477;10842;9771;83605;25948;2645;54205;64759;1644;23242;23658;23072;3696;9603,188
-1,1,7,11162119,16518928,5356809,10124;2115;392636;54664;221981;25928;1607;221806;729920;4223;85477,11
1,1,7,11562624,36395416,24832792,54504;26031;2115;392636;55536;1395;222171;27075;90693;136895;358;84725;25928;340277;29887;1124;2692;4223;84668;51678;3207;11112;56164;80820;27241;223075;8701;11185;3205;5137;729920;222166;8935;196;2617;64224;10457;64111;221895;1607;3204;117;57057;28969;11097;155465;10551;23333;3206;79017;221823;57037;223082;7291;23161;989;221981;10643;9734;221806;9805;387129;10392;222894;2128;3199;3198;256130;256227;340273;3569;100506049;168667;644150;3209;221830;55033;221833;3202;3203;8887;6100;11335;4852;9586;346389;11328;84182;54543;9865;3181;55975;3201;54664;63974;23366;23080;3200;1687;85477;10842;9771;10124;285941;25948;54205;51251;6671;29896;23658;3696;115416;9603,113
1,-1,7,12148960,12693032,544072,221806;85477;54664,3
-1,-1,7,13156515,13302439,145924,,0
-1,-1,7,13239521,13327079,87558,,0
-1,1,7,14005822,18360977,4355155,196;2115;392636;27075;25928;1607;28969;4223;155465;100506049;10551;57037;221823;23161;9734;729920,16
-1,1,7,14944519,16964718,2020199,392636;57037;27075;25928;28969;155465;729920;4223;100506049;10551,10
-1,1,7,14944519,16964718,2020199,392636;57037;27075;25928;28969;155465;729920;4223;100506049;10551,10
-1,-1,7,15042234,15139429,97195,,0
-1,1,7,15573437,24891051,9317614,26031;392636;55536;27075;222894;90693;25928;340277;256130;256227;340273;4223;3569;100506049;84668;51678;221830;56164;221833;8701;4852;346389;54543;729920;196;55975;10457;11097;28969;1687;155465;10551;9771;57037;221823;7291;23161;10643;6671;29896;9734;3696;115416,43
-1,1,7,16161141,20647522,4486381,196;27075;222894;25928;256130;28969;155465;100506049;10551;221830;57037;221823;7291;23161;9734;346389;3696;729920,18
-1,-1,7,16364885,16441305,76420,729920,1
1,-1,7,16877677,17166445,288768,155465,1
1,-1,7,16921581,17378911,457330,196;155465,2
-1,-1,7,17116777,17188633,71856,,0
1,-1,7,17278312,17513703,235391,196,1
1,-1,7,17886672,18360918,474246,23161;221823;9734,3
-1,1,7,19142415,19178349,35934,7291,1
-1,1,7,19185335,22233331,3047996,221830;55536;221833;8701;6671;3696;346389;256130;340273;9771,10
-1,1,7,20250535,27889019,7638484,26031;55536;90693;136895;2128;340277;3199;29887;3198;256227;340273;84668;3569;51678;3207;3209;11112;56164;221833;3202;8701;3203;8887;11335;4852;3205;346389;54543;8935;3181;55975;10457;64111;3201;221895;3204;3200;11097;1687;9771;3206;285941;54205;10643;6671;29896;3696;115416;9603,49
-1,1,7,20601079,32044755,11443676,54504;26031;1395;55536;222171;90693;136895;358;340277;84725;29887;1124;2692;84668;51678;3207;115416;11112;56164;8701;223075;11185;3205;5137;222166;8935;2617;10457;64111;221895;3204;117;11097;3206;223082;10643;9805;10392;2128;3199;3198;256227;340273;3569;644150;3209;221833;55033;3202;3203;8887;11335;4852;9586;84182;54543;9865;3181;55975;3201;63974;3200;1687;10842;9771;285941;54205;6671;29896;79017;9603,71
-1,1,7,24344104,28879357,4535253,26031;3181;136895;3201;64111;2128;221895;3199;29887;3198;3204;3200;1687;51678;3207;3209;3206;11112;285941;54205;3202;3203;8887;11335;9586;3205;8935;9603,28
1,-1,7,29691278,29756786,65508,,0
-1,1,7,32718003,41084581,8366578,54443;387129;64224;353345;445347;23366;51314;5898;57002;6424;79783;273;57057;136647;168667;27072;23333;9844;25948;8621;80820;27241;83930;6100;51251;989;54749;313;11328;11281,30
-1,1,7,32911003,44576005,11665002,387129;64983;9263;816;353345;445347;5683;57002;79783;168667;27072;51619;644;27434;80820;27241;58498;83930;6100;64951;165;313;10652;23386;11328;28988;11281;54443;64224;100534592;5224;29881;3624;23366;51314;5898;6424;273;57057;136647;79020;23333;9844;25948;8621;2645;55744;5425;51251;989;2737;54749;55665;23072;285955,55
1,-1,7,33134559,33139024,4465,6100,1
1,-1,7,33150658,33171086,20428,27241,1
-1,1,7,35500386,42053399,6553013,54443;64224;3624;353345;445347;23366;51314;5898;57002;6424;79783;273;136647;27072;9844;8621;80820;83930;989;2737;54749;313;11281,23
-1,1,7,37343082,48700334,11357252,64983;9263;816;445347;154664;27072;644;80099;136288;165;23386;222068;9238;28988;11281;256979;168507;5224;29881;3624;5814;3484;3364;273;54606;5478;9844;401335;8621;55744;5425;2737;285955;100534592;94239;23148;5683;353345;10268;57002;7378;79783;3486;51619;27434;64005;58498;83930;64951;10652;4967;83637;51314;5898;107;6424;136647;79020;83605;2645;64759;54749;55665;23072,64
-1,1,7,38217601,45343699,7126098,64983;9263;816;23148;5683;445347;10268;57002;79783;27072;51619;644;27434;64005;58498;83930;64951;165;10652;23386;222068;4967;9238;28988;11281;83637;5224;29881;3624;5814;5898;273;136647;79020;54606;5478;83605;8621;2645;55744;5425;285955;2737;55665;23072;100534592;94239,47
-1,-1,7,38304447,38346405,41958,445347,1
-1,1,7,39103000,45402695,6299695,64983;9263;816;23148;5683;10268;57002;79783;51619;644;27434;64005;58498;64951;165;10652;23386;222068;4967;9238;28988;11281;83637;5224;29881;3624;5814;5898;136647;79020;54606;5478;83605;8621;2645;55744;5425;285955;2737;55665;23072;100534592;94239,43
-1,1,7,40060197,50611198,10551001,64983;9263;816;23148;100130988;5683;10268;7378;79783;3486;154664;51619;644;27434;64005;58498;64951;80099;136288;165;10652;11055;23386;222068;4967;9238;28988;256979;10320;375567;168507;83637;63979;5224;29881;3624;5814;3484;107;3364;136647;79020;54606;5478;83605;401335;8621;2645;55744;5425;64759;1644;285955;2737;55665;23072;100534592;94239,58
-1,1,7,40350383,47034422,6684039,64983;9263;816;23148;5683;10268;79783;3486;51619;644;27434;64005;58498;64951;165;10652;23386;222068;4967;9238;28988;83637;5224;29881;3624;5814;3484;107;79020;54606;5478;83605;2645;55744;5425;285955;2737;55665;23072;100534592;94239,41
-1,1,7,40573756,56174815,15601059,64983;9263;222008;816;100130988;908;154664;644;80099;136288;165;23386;222068;10320;9238;28988;256979;346288;375567;23480;168507;2631;5224;29881;3624;5814;3484;3364;54606;5478;5723;51142;401335;25870;55744;5425;2737;100534592;285955;94239;1956;349075;23148;5683;10268;7378;79783;3486;51619;27434;64005;58498;64951;10652;11055;4967;2887;83637;63979;81552;285877;107;5260;79020;83605;51373;2645;64759;1644;23242;55665;23072;55915,73
-1,1,7,41124364,42606116,1481752,3624;2737,2
-1,-1,7,41224437,41443498,219061,,0
-1,-1,7,41621198,41734290,113092,3624,1
1,-1,7,42226378,42239808,13430,2737,1
1,-1,7,42226378,42244825,18447,2737,1
1,-1,7,42226378,42244825,18447,2737,1
1,-1,7,44327417,44620720,293303,23386;816;222068;29881;54606,5
-1,1,7,44611548,53767453,9155905,23148;100130988;10268;7378;3486;154664;64005;80099;136288;11055;4967;222068;10320;9238;256979;375567;168507;2887;83637;63979;5814;3484;285877;107;3364;54606;5478;83605;401335;64759;1644;23242;94239,33
-1,1,7,45061454,45135918,74464,83605;23148,2
1,-1,7,52295077,52580630,285553,,0
-1,-1,7,53472041,53583125,111084,,0
-1,-1,7,53472041,53583125,111084,,0
-1,-1,7,53472041,53583125,111084,,0
-1,-1,7,53472041,53583125,111084,,0
-1,-1,7,53472041,53583125,111084,,0
-1,-1,7,53472041,53583125,111084,,0
-1,-1,7,53472041,53583125,111084,,0
-1,-1,7,53472041,53583125,111084,,0
-1,1,7,54972516,56172165,1199649,5723;1956;51142;349075;51373;2631;25870;81552;908;5260;346288;55915,12
-1,-1,7,55800753,56174888,374135,5723;51142;349075;2631;51373;25870;908;5260;346288,9
1,-1,7,55874737,56172165,297428,5723;51142;349075;2631;51373;25870;908;5260;346288,9
1,-1,7,55946528,55955695,9167,349075,1
1,-1,7,56794974,61056670,4261696,90827;441234,2
1,-1,7,57230344,61056670,3826326,441234,1
1,-1,7,57927493,62030701,4103208,,0
1,-1,7,57927493,62196740,4269247,,0
1,-1,7,61307485,62970686,1663201,,0
1,-1,7,61839194,62704320,865126,,0
1,-1,7,61839194,62704320,865126,,0
1,-1,7,61843888,62779622,935734,,0
1,-1,7,62030281,62675610,645329,,0
1,-1,7,62030281,62675610,645329,,0
1,-1,7,62030281,62704379,674098,,0
1,-1,7,62030665,62985503,954838,,0
1,-1,7,62196740,62704379,507639,,0
1,-1,7,62196742,62196801,59,,0
1,-1,7,62196742,62828654,631912,,0
-1,1,7,62196742,75061986,12865244,5982;84163;378108;51085;154807;389524;84277;442319;55695;168374;51119;168417;154881;441250;114049;135886;135892;6804;2086;7461;435;155382;3984;26608;8468;9031;81554;2969;83698;8326;7458;10793;1365;7697;51351;100101267;55069;9275;730291;64409;55253;26053;7462;653361;109504726;9883;83451;2990;51427;1364;155368;27297;9569;340252;728927;2006;729438;8460;375593;27342,60
1,1,7,62437463,75044630,12607167,5982;84163;378108;51085;154807;389524;84277;442319;55695;168374;51119;168417;154881;441250;114049;135886;135892;6804;2086;7461;435;155382;3984;26608;8468;9031;81554;2969;83698;8326;7458;10793;1365;7697;51351;55069;9275;730291;64409;55253;26053;7462;653361;109504726;9883;83451;2990;51427;1364;155368;27297;9569;340252;728927;2006;729438;8460;375593;27342,59
-1,-1,7,62694311,62732735,38424,,0
1,-1,7,63328472,63955286,626814,442319;730291;728927;168417,4
-1,1,7,63583563,71047246,7463683,51351;55069;154807;730291;64409;55253;26053;168374;51119;168417;154881;27342;109504726;2990;51427;2086;435;27297;340252;10793;728927;8460;7697,23
-1,-1,7,64567016,65157704,590688,168374,1
1,-1,7,64567016,65157704,590688,168374,1
1,-1,7,64567016,65157704,590688,168374,1
-1,-1,7,64567016,65157704,590688,168374,1
1,-1,7,64567016,65157704,590688,168374,1
-1,-1,7,64567016,65157704,590688,168374,1
1,-1,7,64567016,65176347,609331,168374,1
1,-1,7,64567016,65176347,609331,168374,1
1,-1,7,64567016,65176347,609331,168374,1
-1,-1,7,64567016,65191565,624549,168374,1
1,-1,7,64567016,65191565,624549,168374,1
1,-1,7,64567016,65191565,624549,168374,1
-1,-1,7,64609829,64895573,285744,168374,1
-1,-1,7,64609853,65012082,402229,168374,1
-1,-1,7,64610473,64927761,317288,168374,1
-1,-1,7,64609912,65157704,547792,168374,1
-1,-1,7,64609912,65191565,581653,168374,1
-1,-1,7,64679713,64927761,248048,168374,1
-1,-1,7,64679713,64927761,248048,168374,1
-1,-1,7,64679713,64927761,248048,168374,1
-1,-1,7,64679713,64927761,248048,168374,1
-1,-1,7,64665913,65157704,491791,168374,1
-1,-1,7,64665913,65157704,491791,168374,1
-1,-1,7,64701173,64895573,194400,168374,1
1,-1,7,66767652,67130617,362965,,0
-1,1,7,68465819,69709432,1243613,26053,1
-1,1,7,69053750,69230025,176275,26053,1
-1,1,7,69063905,69105486,41581,26053,1
-1,1,7,69130237,69736834,606597,26053,1
-1,1,7,69293697,69503431,209734,26053,1
-1,1,7,69325515,69644230,318715,26053,1
-1,1,7,69330737,69520566,189829,26053,1
-1,1,7,69351193,70257735,906542,26053,1
-1,1,7,69459746,70176827,717081,26053,1
-1,1,7,69671501,69958576,287075,26053,1
-1,1,7,69765424,69912439,147015,26053,1
-1,1,7,70257735,71909376,1651641,83698;26053;64409,3
-1,1,7,70926112,72806397,1880285,378108;8468;64409;83698;55695;441250;9883;135892,8
1,-1,7,71935722,72095795,160073,441250,1
-1,-1,7,72041404,72196404,155000,441250,1
1,-1,7,72196405,72286180,89775,441250,1
1,1,7,72408602,74193374,1784772,5982;378108;51085;9275;84277;7462;55695;135886;653361;9883;83451;1364;135892;6804;7461;155382;3984;26608;8468;9031;155368;2969;8326;7458;9569;2006;1365;114049,28
-1,1,7,72456604,76007380,3550776,5982;84163;51085;389524;84277;7532;55695;135886;135892;6804;7461;155382;3984;26608;10344;8468;9031;81554;2969;8326;7458;57414;51657;222183;1365;100101267;442590;9275;5447;6369;3092;7462;653361;83451;3315;1364;83862;155368;4191;9569;2006;729438;375593;114049,44
1,1,7,72472922,74259176,1786254,5982;84163;51085;9275;84277;7462;55695;135886;653361;83451;1364;135892;6804;7461;155382;3984;26608;8468;9031;155368;2969;8326;7458;9569;2006;1365;114049,27
-1,1,7,72536980,74629034,2092054,5982;84163;51085;9275;389524;84277;7462;55695;135886;653361;83451;1364;135892;6804;7461;155382;3984;26608;8468;9031;81554;2969;155368;8326;7458;9569;2006;729438;1365;114049,30
1,1,7,72577021,74197846,1620825,5982;51085;9275;84277;7462;55695;135886;653361;83451;1364;135892;6804;7461;155382;3984;26608;8468;9031;155368;2969;8326;7458;9569;2006;1365;114049,26
1,1,7,72589515,74154603,1565088,5982;51085;9275;84277;7462;55695;135886;83451;1364;135892;6804;7461;155382;3984;26608;8468;9031;155368;2969;8326;7458;9569;2006;1365;114049,25
1,1,7,72589515,74165401,1575886,5982;51085;9275;84277;7462;55695;135886;83451;1364;135892;6804;7461;155382;3984;26608;8468;9031;155368;2969;8326;7458;9569;2006;1365;114049,25
-1,1,7,72606409,74193403,1586994,5982;51085;9275;84277;7462;55695;135886;653361;83451;1364;135892;6804;7461;155382;3984;26608;8468;9031;155368;2969;8326;7458;9569;2006;1365;114049,26
1,1,7,72606409,74193403,1586994,5982;51085;9275;84277;7462;55695;135886;653361;83451;1364;135892;6804;7461;155382;3984;26608;8468;9031;155368;2969;8326;7458;9569;2006;1365;114049,26
-1,1,7,72606409,74193403,1586994,5982;51085;9275;84277;7462;55695;135886;653361;83451;1364;135892;6804;7461;155382;3984;26608;8468;9031;155368;2969;8326;7458;9569;2006;1365;114049,26
-1,1,7,72606409,74285345,1678936,5982;84163;51085;9275;84277;7462;55695;135886;653361;83451;1364;135892;6804;7461;155382;3984;26608;8468;9031;155368;2969;8326;7458;9569;2006;1365;114049,27
1,1,7,72606409,74300084,1693675,5982;84163;51085;9275;84277;7462;55695;135886;653361;83451;1364;135892;6804;7461;155382;3984;26608;8468;9031;155368;2969;8326;7458;9569;2006;1365;114049,27
-1,1,7,72636006,74339014,1703008,5982;84163;51085;9275;84277;7462;55695;135886;653361;83451;1364;135892;6804;7461;155382;3984;26608;8468;9031;155368;2969;8326;7458;9569;2006;1365;114049,27
-1,1,7,72637824,74203685,1565861,5982;51085;9275;84277;7462;55695;135886;653361;83451;1364;135892;6804;7461;155382;3984;26608;8468;9031;155368;2969;8326;7458;9569;2006;1365;114049,26
-1,1,7,72643631,74142190,1498559,5982;51085;9275;84277;7462;55695;135886;83451;1364;135892;6804;7461;155382;3984;26608;8468;9031;155368;2969;8326;7458;9569;2006;1365;114049,25
-1,1,7,72644631,74144422,1499791,5982;51085;9275;84277;7462;55695;135886;83451;1364;135892;6804;7461;155382;3984;26608;8468;9031;155368;2969;8326;7458;9569;2006;1365;114049,25
1,1,7,72650007,74188572,1538565,5982;51085;9275;84277;7462;55695;135886;653361;83451;1364;135892;6804;7461;155382;3984;26608;8468;9031;155368;2969;8326;7458;9569;2006;1365;114049,26
-1,1,7,72650120,74142256,1492136,5982;51085;9275;84277;7462;55695;135886;83451;1364;135892;6804;7461;155382;3984;26608;8468;9031;155368;2969;8326;7458;9569;2006;1365;114049,25
1,1,7,72659674,74143240,1483566,5982;51085;9275;84277;7462;55695;135886;83451;1364;135892;6804;7461;155382;3984;26608;8468;9031;155368;2969;8326;7458;9569;2006;1365;114049,25
1,1,7,72663962,74193403,1529441,5982;51085;9275;84277;7462;55695;135886;653361;83451;1364;135892;6804;7461;155382;3984;26608;8468;9031;155368;2969;8326;7458;9569;2006;1365;114049,26
1,1,7,72677173,74143140,1465967,5982;51085;9275;84277;7462;55695;135886;83451;1364;135892;6804;7461;155382;3984;26608;8468;9031;155368;2969;8326;7458;9569;2006;1365;114049,25
-1,1,7,72677237,74144422,1467185,5982;51085;9275;84277;7462;55695;135886;83451;1364;135892;6804;7461;155382;3984;26608;8468;9031;155368;2969;8326;7458;9569;2006;1365;114049,25
-1,1,7,72677237,74144422,1467185,5982;51085;9275;84277;7462;55695;135886;83451;1364;135892;6804;7461;155382;3984;26608;8468;9031;155368;2969;8326;7458;9569;2006;1365;114049,25
-1,1,7,72677237,74144422,1467185,5982;51085;9275;84277;7462;55695;135886;83451;1364;135892;6804;7461;155382;3984;26608;8468;9031;155368;2969;8326;7458;9569;2006;1365;114049,25
-1,1,7,72677237,74144422,1467185,5982;51085;9275;84277;7462;55695;135886;83451;1364;135892;6804;7461;155382;3984;26608;8468;9031;155368;2969;8326;7458;9569;2006;1365;114049,25
-1,1,7,72677237,74144422,1467185,5982;51085;9275;84277;7462;55695;135886;83451;1364;135892;6804;7461;155382;3984;26608;8468;9031;155368;2969;8326;7458;9569;2006;1365;114049,25
1,1,7,72677301,74143060,1465759,5982;51085;9275;84277;7462;55695;135886;83451;1364;135892;6804;7461;155382;3984;26608;8468;9031;155368;2969;8326;7458;9569;2006;1365;114049,25
1,1,7,72677301,74143240,1465939,5982;51085;9275;84277;7462;55695;135886;83451;1364;135892;6804;7461;155382;3984;26608;8468;9031;155368;2969;8326;7458;9569;2006;1365;114049,25
1,1,7,72685734,74142327,1456593,5982;51085;9275;84277;7462;55695;135886;83451;1364;135892;6804;7461;155382;3984;26608;8468;9031;155368;2969;8326;7458;9569;2006;1365;114049,25
1,1,7,72685734,74142327,1456593,5982;51085;9275;84277;7462;55695;135886;83451;1364;135892;6804;7461;155382;3984;26608;8468;9031;155368;2969;8326;7458;9569;2006;1365;114049,25
1,1,7,72685734,74142327,1456593,5982;51085;9275;84277;7462;55695;135886;83451;1364;135892;6804;7461;155382;3984;26608;8468;9031;155368;2969;8326;7458;9569;2006;1365;114049,25
-1,1,7,72685734,74142327,1456593,5982;51085;9275;84277;7462;55695;135886;83451;1364;135892;6804;7461;155382;3984;26608;8468;9031;155368;2969;8326;7458;9569;2006;1365;114049,25
-1,1,7,72685734,74142327,1456593,5982;51085;9275;84277;7462;55695;135886;83451;1364;135892;6804;7461;155382;3984;26608;8468;9031;155368;2969;8326;7458;9569;2006;1365;114049,25
-1,1,7,72685734,74142327,1456593,5982;51085;9275;84277;7462;55695;135886;83451;1364;135892;6804;7461;155382;3984;26608;8468;9031;155368;2969;8326;7458;9569;2006;1365;114049,25
1,1,7,72685763,74189674,1503911,5982;51085;9275;84277;7462;55695;135886;653361;83451;1364;135892;6804;7461;155382;3984;26608;8468;9031;155368;2969;8326;7458;9569;2006;1365;114049,26
1,1,7,72686958,74142190,1455232,5982;51085;9275;84277;7462;55695;135886;83451;1364;135892;6804;7461;155382;3984;26608;8468;9031;155368;2969;8326;7458;9569;2006;1365;114049,25
-1,1,7,72691242,74142190,1450948,5982;51085;9275;84277;7462;55695;135886;83451;1364;135892;6804;7461;155382;3984;26608;8468;9031;155368;2969;8326;7458;9569;2006;1365;114049,25
1,1,7,72692112,74141746,1449634,5982;51085;9275;84277;7462;55695;135886;83451;1364;135892;6804;7461;155382;3984;26608;8468;9031;155368;2969;8326;7458;9569;2006;1365;114049,25
1,1,7,72692112,74154497,1462385,5982;51085;9275;84277;7462;55695;135886;83451;1364;135892;6804;7461;155382;3984;26608;8468;9031;155368;2969;8326;7458;9569;2006;1365;114049,25
1,1,7,72700127,74143240,1443113,5982;51085;9275;84277;7462;55695;135886;83451;1364;135892;6804;7461;155382;3984;26608;8468;9031;155368;2969;8326;7458;9569;2006;1365;114049,25
1,1,7,72700127,74146858,1446731,5982;51085;9275;84277;7462;55695;135886;83451;1364;135892;6804;7461;155382;3984;26608;8468;9031;155368;2969;8326;7458;9569;2006;1365;114049,25
-1,1,7,72700414,74142327,1441913,5982;51085;9275;84277;7462;55695;135886;83451;1364;135892;6804;7461;155382;3984;26608;8468;9031;155368;2969;8326;7458;9569;2006;1365;114049,25
-1,1,7,72700414,74142327,1441913,5982;51085;9275;84277;7462;55695;135886;83451;1364;135892;6804;7461;155382;3984;26608;8468;9031;155368;2969;8326;7458;9569;2006;1365;114049,25
-1,1,7,72700414,74142327,1441913,5982;51085;9275;84277;7462;55695;135886;83451;1364;135892;6804;7461;155382;3984;26608;8468;9031;155368;2969;8326;7458;9569;2006;1365;114049,25
-1,1,7,72700414,74142327,1441913,5982;51085;9275;84277;7462;55695;135886;83451;1364;135892;6804;7461;155382;3984;26608;8468;9031;155368;2969;8326;7458;9569;2006;1365;114049,25
-1,1,7,72700414,74142327,1441913,5982;51085;9275;84277;7462;55695;135886;83451;1364;135892;6804;7461;155382;3984;26608;8468;9031;155368;2969;8326;7458;9569;2006;1365;114049,25
-1,1,7,72700414,74142327,1441913,5982;51085;9275;84277;7462;55695;135886;83451;1364;135892;6804;7461;155382;3984;26608;8468;9031;155368;2969;8326;7458;9569;2006;1365;114049,25
-1,1,7,72700414,74142327,1441913,5982;51085;9275;84277;7462;55695;135886;83451;1364;135892;6804;7461;155382;3984;26608;8468;9031;155368;2969;8326;7458;9569;2006;1365;114049,25
-1,1,7,72700414,74142327,1441913,5982;51085;9275;84277;7462;55695;135886;83451;1364;135892;6804;7461;155382;3984;26608;8468;9031;155368;2969;8326;7458;9569;2006;1365;114049,25
-1,1,7,72700414,74172913,1472499,5982;51085;9275;84277;7462;55695;135886;83451;1364;135892;6804;7461;155382;3984;26608;8468;9031;155368;2969;8326;7458;9569;2006;1365;114049,25
-1,1,7,72700414,74172913,1472499,5982;51085;9275;84277;7462;55695;135886;83451;1364;135892;6804;7461;155382;3984;26608;8468;9031;155368;2969;8326;7458;9569;2006;1365;114049,25
-1,1,7,72700414,74172913,1472499,5982;51085;9275;84277;7462;55695;135886;83451;1364;135892;6804;7461;155382;3984;26608;8468;9031;155368;2969;8326;7458;9569;2006;1365;114049,25
-1,1,7,72700414,74172913,1472499,5982;51085;9275;84277;7462;55695;135886;83451;1364;135892;6804;7461;155382;3984;26608;8468;9031;155368;2969;8326;7458;9569;2006;1365;114049,25
-1,1,7,72700414,74172913,1472499,5982;51085;9275;84277;7462;55695;135886;83451;1364;135892;6804;7461;155382;3984;26608;8468;9031;155368;2969;8326;7458;9569;2006;1365;114049,25
-1,1,7,72700414,74193403,1492989,5982;51085;9275;84277;7462;55695;135886;653361;83451;1364;135892;6804;7461;155382;3984;26608;8468;9031;155368;2969;8326;7458;9569;2006;1365;114049,26
-1,1,7,72700414,74285345,1584931,5982;84163;51085;9275;84277;7462;55695;135886;653361;83451;1364;135892;6804;7461;155382;3984;26608;8468;9031;155368;2969;8326;7458;9569;2006;1365;114049,27
-1,1,7,72700510,74142190,1441680,5982;51085;9275;84277;7462;55695;135886;83451;1364;135892;6804;7461;155382;3984;26608;8468;9031;155368;2969;8326;7458;9569;2006;1365;114049,25
-1,1,7,72700524,74141494,1440970,5982;51085;9275;84277;7462;55695;135886;83451;1364;135892;6804;7461;155382;3984;26608;8468;9031;155368;2969;8326;7458;9569;2006;1365;114049,25
-1,1,7,72700524,74142190,1441666,5982;51085;9275;84277;7462;55695;135886;83451;1364;135892;6804;7461;155382;3984;26608;8468;9031;155368;2969;8326;7458;9569;2006;1365;114049,25
1,1,7,72700524,74142256,1441732,5982;51085;9275;84277;7462;55695;135886;83451;1364;135892;6804;7461;155382;3984;26608;8468;9031;155368;2969;8326;7458;9569;2006;1365;114049,25
-1,1,7,72701018,74141493,1440475,5982;51085;9275;84277;7462;55695;135886;83451;1364;135892;6804;7461;155382;3984;26608;8468;9031;155368;2969;8326;7458;9569;2006;1365;114049,25
-1,1,7,72708237,74133273,1425036,5982;51085;9275;84277;7462;55695;135886;83451;1364;135892;6804;7461;155382;3984;26608;8468;9031;155368;2969;8326;7458;9569;2006;1365;114049,25
-1,1,7,72708237,74133273,1425036,5982;51085;9275;84277;7462;55695;135886;83451;1364;135892;6804;7461;155382;3984;26608;8468;9031;155368;2969;8326;7458;9569;2006;1365;114049,25
-1,1,7,72708237,74133273,1425036,5982;51085;9275;84277;7462;55695;135886;83451;1364;135892;6804;7461;155382;3984;26608;8468;9031;155368;2969;8326;7458;9569;2006;1365;114049,25
-1,1,7,72708237,74133273,1425036,5982;51085;9275;84277;7462;55695;135886;83451;1364;135892;6804;7461;155382;3984;26608;8468;9031;155368;2969;8326;7458;9569;2006;1365;114049,25
-1,1,7,72708237,74133273,1425036,5982;51085;9275;84277;7462;55695;135886;83451;1364;135892;6804;7461;155382;3984;26608;8468;9031;155368;2969;8326;7458;9569;2006;1365;114049,25
-1,1,7,72713253,74142256,1429003,5982;51085;9275;84277;7462;55695;135886;83451;1364;135892;6804;7461;155382;3984;26608;8468;9031;155368;2969;8326;7458;9569;2006;1365;114049,25
-1,1,7,72713253,74143030,1429777,5982;51085;9275;84277;7462;55695;135886;83451;1364;135892;6804;7461;155382;3984;26608;8468;9031;155368;2969;8326;7458;9569;2006;1365;114049,25
-1,1,7,72718123,74141746,1423623,5982;51085;9275;84277;7462;55695;135886;83451;1364;135892;6804;7461;155382;3984;26608;8468;9031;155368;2969;8326;7458;9569;2006;1365;114049,25
1,-1,7,72718252,72730551,12299,55695;135892,2
-1,1,7,72718252,74133273,1415021,5982;51085;9275;84277;7462;55695;135886;83451;1364;135892;6804;7461;155382;3984;26608;8468;9031;155368;2969;8326;7458;9569;2006;1365;114049,25
-1,1,7,72718252,74133273,1415021,5982;51085;9275;84277;7462;55695;135886;83451;1364;135892;6804;7461;155382;3984;26608;8468;9031;155368;2969;8326;7458;9569;2006;1365;114049,25
-1,1,7,72718252,74133273,1415021,5982;51085;9275;84277;7462;55695;135886;83451;1364;135892;6804;7461;155382;3984;26608;8468;9031;155368;2969;8326;7458;9569;2006;1365;114049,25
-1,1,7,72718277,73898515,1180238,5982;51085;9275;84277;7462;55695;135886;83451;1364;135892;6804;7461;155382;3984;26608;8468;9031;155368;8326;7458;9569;2006;1365;114049,24
-1,1,7,72718277,74141494,1423217,5982;51085;9275;84277;7462;55695;135886;83451;1364;135892;6804;7461;155382;3984;26608;8468;9031;155368;2969;8326;7458;9569;2006;1365;114049,25
-1,1,7,72718277,74141603,1423326,5982;51085;9275;84277;7462;55695;135886;83451;1364;135892;6804;7461;155382;3984;26608;8468;9031;155368;2969;8326;7458;9569;2006;1365;114049,25
-1,1,7,72718277,74141603,1423326,5982;51085;9275;84277;7462;55695;135886;83451;1364;135892;6804;7461;155382;3984;26608;8468;9031;155368;2969;8326;7458;9569;2006;1365;114049,25
-1,1,7,72718277,74141673,1423396,5982;51085;9275;84277;7462;55695;135886;83451;1364;135892;6804;7461;155382;3984;26608;8468;9031;155368;2969;8326;7458;9569;2006;1365;114049,25
-1,1,7,72718277,74141746,1423469,5982;51085;9275;84277;7462;55695;135886;83451;1364;135892;6804;7461;155382;3984;26608;8468;9031;155368;2969;8326;7458;9569;2006;1365;114049,25
-1,1,7,72718277,74141746,1423469,5982;51085;9275;84277;7462;55695;135886;83451;1364;135892;6804;7461;155382;3984;26608;8468;9031;155368;2969;8326;7458;9569;2006;1365;114049,25
-1,1,7,72718277,74141746,1423469,5982;51085;9275;84277;7462;55695;135886;83451;1364;135892;6804;7461;155382;3984;26608;8468;9031;155368;2969;8326;7458;9569;2006;1365;114049,25
-1,1,7,72718277,74141784,1423507,5982;51085;9275;84277;7462;55695;135886;83451;1364;135892;6804;7461;155382;3984;26608;8468;9031;155368;2969;8326;7458;9569;2006;1365;114049,25
-1,1,7,72718277,74142190,1423913,5982;51085;9275;84277;7462;55695;135886;83451;1364;135892;6804;7461;155382;3984;26608;8468;9031;155368;2969;8326;7458;9569;2006;1365;114049,25
-1,1,7,72718277,74142190,1423913,5982;51085;9275;84277;7462;55695;135886;83451;1364;135892;6804;7461;155382;3984;26608;8468;9031;155368;2969;8326;7458;9569;2006;1365;114049,25
-1,1,7,72718277,74142190,1423913,5982;51085;9275;84277;7462;55695;135886;83451;1364;135892;6804;7461;155382;3984;26608;8468;9031;155368;2969;8326;7458;9569;2006;1365;114049,25
-1,1,7,72718277,74142190,1423913,5982;51085;9275;84277;7462;55695;135886;83451;1364;135892;6804;7461;155382;3984;26608;8468;9031;155368;2969;8326;7458;9569;2006;1365;114049,25
-1,1,7,72718277,74142190,1423913,5982;51085;9275;84277;7462;55695;135886;83451;1364;135892;6804;7461;155382;3984;26608;8468;9031;155368;2969;8326;7458;9569;2006;1365;114049,25
-1,1,7,72718277,74142190,1423913,5982;51085;9275;84277;7462;55695;135886;83451;1364;135892;6804;7461;155382;3984;26608;8468;9031;155368;2969;8326;7458;9569;2006;1365;114049,25
-1,1,7,72718277,74142215,1423938,5982;51085;9275;84277;7462;55695;135886;83451;1364;135892;6804;7461;155382;3984;26608;8468;9031;155368;2969;8326;7458;9569;2006;1365;114049,25
-1,1,7,72718277,74142215,1423938,5982;51085;9275;84277;7462;55695;135886;83451;1364;135892;6804;7461;155382;3984;26608;8468;9031;155368;2969;8326;7458;9569;2006;1365;114049,25
-1,1,7,72718277,74142215,1423938,5982;51085;9275;84277;7462;55695;135886;83451;1364;135892;6804;7461;155382;3984;26608;8468;9031;155368;2969;8326;7458;9569;2006;1365;114049,25
-1,1,7,72718277,74146858,1428581,5982;51085;9275;84277;7462;55695;135886;83451;1364;135892;6804;7461;155382;3984;26608;8468;9031;155368;2969;8326;7458;9569;2006;1365;114049,25
-1,1,7,72718277,74146948,1428671,5982;51085;9275;84277;7462;55695;135886;83451;1364;135892;6804;7461;155382;3984;26608;8468;9031;155368;2969;8326;7458;9569;2006;1365;114049,25
-1,1,7,72718277,74259899,1541622,5982;84163;51085;9275;84277;7462;55695;135886;653361;83451;1364;135892;6804;7461;155382;3984;26608;8468;9031;155368;2969;8326;7458;9569;2006;1365;114049,27
-1,1,7,72718277,74287433,1569156,5982;84163;51085;9275;84277;7462;55695;135886;653361;83451;1364;135892;6804;7461;155382;3984;26608;8468;9031;155368;2969;8326;7458;9569;2006;1365;114049,27
-1,1,7,72726578,74139390,1412812,5982;51085;9275;84277;7462;135886;83451;1364;135892;6804;7461;155382;3984;26608;8468;9031;155368;2969;8326;7458;9569;2006;1365;114049,24
-1,1,7,72726578,74139390,1412812,5982;51085;9275;84277;7462;135886;83451;1364;135892;6804;7461;155382;3984;26608;8468;9031;155368;2969;8326;7458;9569;2006;1365;114049,24
1,-1,7,72738675,72766313,27638,8468;135892,2
-1,1,7,72766312,74133327,1367015,5982;51085;9275;84277;7462;135886;83451;1364;6804;7461;155382;3984;26608;8468;9031;155368;2969;8326;7458;9569;2006;1365;114049,23
-1,1,7,72766312,74133327,1367015,5982;51085;9275;84277;7462;135886;83451;1364;6804;7461;155382;3984;26608;8468;9031;155368;2969;8326;7458;9569;2006;1365;114049,23
-1,1,7,72766312,74133327,1367015,5982;51085;9275;84277;7462;135886;83451;1364;6804;7461;155382;3984;26608;8468;9031;155368;2969;8326;7458;9569;2006;1365;114049,23
1,1,7,72766312,74133327,1367015,5982;51085;9275;84277;7462;135886;83451;1364;6804;7461;155382;3984;26608;8468;9031;155368;2969;8326;7458;9569;2006;1365;114049,23
-1,1,7,72766312,74193397,1427085,5982;51085;9275;84277;7462;135886;653361;83451;1364;6804;7461;155382;3984;26608;8468;9031;155368;2969;8326;7458;9569;2006;1365;114049,24
-1,1,7,72766312,74193397,1427085,5982;51085;9275;84277;7462;135886;653361;83451;1364;6804;7461;155382;3984;26608;8468;9031;155368;2969;8326;7458;9569;2006;1365;114049,24
-1,1,7,72766312,74339030,1572718,5982;84163;51085;9275;84277;7462;135886;653361;83451;1364;6804;7461;155382;3984;26608;8468;9031;155368;2969;8326;7458;9569;2006;1365;114049,25
-1,1,7,72766312,74339030,1572718,5982;84163;51085;9275;84277;7462;135886;653361;83451;1364;6804;7461;155382;3984;26608;8468;9031;155368;2969;8326;7458;9569;2006;1365;114049,25
-1,1,7,72766313,74133332,1367019,5982;51085;9275;84277;7462;135886;83451;1364;6804;7461;155382;3984;26608;8468;9031;155368;2969;8326;7458;9569;2006;1365;114049,23
-1,1,7,72766313,74133332,1367019,5982;51085;9275;84277;7462;135886;83451;1364;6804;7461;155382;3984;26608;8468;9031;155368;2969;8326;7458;9569;2006;1365;114049,23
-1,1,7,72766313,74133332,1367019,5982;51085;9275;84277;7462;135886;83451;1364;6804;7461;155382;3984;26608;8468;9031;155368;2969;8326;7458;9569;2006;1365;114049,23
1,1,7,72766313,74133332,1367019,5982;51085;9275;84277;7462;135886;83451;1364;6804;7461;155382;3984;26608;8468;9031;155368;2969;8326;7458;9569;2006;1365;114049,23
-1,1,7,72766313,74133332,1367019,5982;51085;9275;84277;7462;135886;83451;1364;6804;7461;155382;3984;26608;8468;9031;155368;2969;8326;7458;9569;2006;1365;114049,23
1,1,7,72766313,74133332,1367019,5982;51085;9275;84277;7462;135886;83451;1364;6804;7461;155382;3984;26608;8468;9031;155368;2969;8326;7458;9569;2006;1365;114049,23
-1,1,7,72766313,74133332,1367019,5982;51085;9275;84277;7462;135886;83451;1364;6804;7461;155382;3984;26608;8468;9031;155368;2969;8326;7458;9569;2006;1365;114049,23
-1,1,7,72766313,74133332,1367019,5982;51085;9275;84277;7462;135886;83451;1364;6804;7461;155382;3984;26608;8468;9031;155368;2969;8326;7458;9569;2006;1365;114049,23
-1,1,7,72766313,74133332,1367019,5982;51085;9275;84277;7462;135886;83451;1364;6804;7461;155382;3984;26608;8468;9031;155368;2969;8326;7458;9569;2006;1365;114049,23
-1,1,7,72766313,74133332,1367019,5982;51085;9275;84277;7462;135886;83451;1364;6804;7461;155382;3984;26608;8468;9031;155368;2969;8326;7458;9569;2006;1365;114049,23
1,1,7,72766313,74133332,1367019,5982;51085;9275;84277;7462;135886;83451;1364;6804;7461;155382;3984;26608;8468;9031;155368;2969;8326;7458;9569;2006;1365;114049,23
-1,1,7,72766313,74133332,1367019,5982;51085;9275;84277;7462;135886;83451;1364;6804;7461;155382;3984;26608;8468;9031;155368;2969;8326;7458;9569;2006;1365;114049,23
-1,1,7,72766313,74133332,1367019,5982;51085;9275;84277;7462;135886;83451;1364;6804;7461;155382;3984;26608;8468;9031;155368;2969;8326;7458;9569;2006;1365;114049,23
1,1,7,72766313,74133332,1367019,5982;51085;9275;84277;7462;135886;83451;1364;6804;7461;155382;3984;26608;8468;9031;155368;2969;8326;7458;9569;2006;1365;114049,23
-1,1,7,72766313,74133332,1367019,5982;51085;9275;84277;7462;135886;83451;1364;6804;7461;155382;3984;26608;8468;9031;155368;2969;8326;7458;9569;2006;1365;114049,23
-1,1,7,72766313,74133332,1367019,5982;51085;9275;84277;7462;135886;83451;1364;6804;7461;155382;3984;26608;8468;9031;155368;2969;8326;7458;9569;2006;1365;114049,23
-1,1,7,72766313,74133332,1367019,5982;51085;9275;84277;7462;135886;83451;1364;6804;7461;155382;3984;26608;8468;9031;155368;2969;8326;7458;9569;2006;1365;114049,23
-1,1,7,72766313,74133332,1367019,5982;51085;9275;84277;7462;135886;83451;1364;6804;7461;155382;3984;26608;8468;9031;155368;2969;8326;7458;9569;2006;1365;114049,23
-1,1,7,72766313,74339044,1572731,5982;84163;51085;9275;84277;7462;135886;653361;83451;1364;6804;7461;155382;3984;26608;8468;9031;155368;2969;8326;7458;9569;2006;1365;114049,25
-1,1,7,72766313,74339044,1572731,5982;84163;51085;9275;84277;7462;135886;653361;83451;1364;6804;7461;155382;3984;26608;8468;9031;155368;2969;8326;7458;9569;2006;1365;114049,25
-1,1,7,72766313,74339044,1572731,5982;84163;51085;9275;84277;7462;135886;653361;83451;1364;6804;7461;155382;3984;26608;8468;9031;155368;2969;8326;7458;9569;2006;1365;114049,25
1,1,7,72766313,74481540,1715227,5982;84163;51085;9275;84277;7462;135886;653361;83451;1364;6804;7461;155382;3984;26608;8468;9031;81554;2969;155368;8326;7458;9569;2006;729438;1365;114049,27
-1,1,7,72766313,76351578,3585265,5982;84163;51085;389524;84277;7532;105375355;135886;6804;7461;155382;3984;26608;10344;8468;9031;81554;2969;8326;7458;57414;51657;222183;22932;1365;100101267;442590;9275;5447;7784;6369;3092;7462;653361;83451;3315;1364;83862;155368;4191;113878;9569;136853;2006;729438;375593;114049,47
-1,1,7,72766313,76351578,3585265,5982;84163;51085;389524;84277;7532;105375355;135886;6804;7461;155382;3984;26608;10344;8468;9031;81554;2969;8326;7458;57414;51657;222183;22932;1365;100101267;442590;9275;5447;7784;6369;3092;7462;653361;83451;3315;1364;83862;155368;4191;113878;9569;136853;2006;729438;375593;114049,47
-1,1,7,73170161,73545656,375495,2006;135886;3984;1365;155368;1364,6
-1,1,7,73461982,73992743,530761,5982;7458;7462;9569;7461;2006;3984,7
-1,1,7,73470470,73498327,27857,3984;2006,2
-1,-1,7,73630191,73633584,3393,7462,1
-1,1,7,73992744,81661058,7668314,84163;9863;781;389524;57639;7532;346562;57157;10512;105375355;222194;85025;10344;81554;2969;57414;51657;222183;22932;100101267;948;5782;442590;5447;7784;6369;3092;653361;10875;3315;3082;83862;4191;54103;113878;9569;136853;2770;729438;375593,40
1,-1,7,75034297,75053777,19480,375593;100101267,2
-1,1,7,75058408,77082896,2024488,442590;5447;7784;57639;6369;7532;3092;105375355;10875;3315;83862;10344;4191;54103;113878;57414;51657;136853;222183;22932;100101267,21
-1,1,7,75066351,76255805,1189454,442590;5447;7784;6369;7532;3092;105375355;3315;83862;10344;4191;113878;57414;51657;136853;222183;22932;100101267,18
1,-1,7,75125952,75145463,19511,442590,1
-1,1,7,75131839,76296318,1164479,442590;5447;7784;6369;7532;3092;105375355;3315;83862;10344;4191;113878;57414;51657;136853;222183;22932,17
-1,1,7,75159180,76240800,1081620,5447;7784;6369;7532;3092;105375355;3315;83862;10344;4191;113878;57414;51657;136853;222183;22932,16
-1,-1,7,75951410,76103081,151671,113878;136853;7532;7784,4
1,-1,7,76027481,76665055,637574,113878;136853;105375355;7784;22932,5
1,-1,7,76027481,76671218,643737,113878;136853;105375355;7784;22932,5
1,-1,7,76030503,76543138,512635,113878;136853;105375355;7784;22932,5
1,-1,7,76030503,76543138,512635,113878;136853;105375355;7784;22932,5
1,-1,7,76030503,76583970,553467,113878;136853;105375355;7784;22932,5
1,-1,7,76030503,76637482,606979,113878;136853;105375355;7784;22932,5
1,-1,7,76030503,76637482,606979,113878;136853;105375355;7784;22932,5
1,-1,7,76030503,76637482,606979,113878;136853;105375355;7784;22932,5
1,-1,7,76030503,76671218,640715,113878;136853;105375355;7784;22932,5
1,-1,7,76047559,76637482,589923,113878;22932;105375355;7784,4
1,-1,7,76047559,76671218,623659,113878;22932;105375355;7784,4
1,-1,7,76069915,76604381,534466,113878;22932;105375355;7784,4
1,-1,7,76069915,76623413,553498,113878;22932;105375355;7784,4
1,-1,7,76069915,76637482,567567,113878;22932;105375355;7784,4
1,-1,7,76069915,76671218,601303,113878;22932;105375355;7784,4
1,-1,7,76069874,76144695,74821,113878;105375355;7784,3
-1,-1,7,76072382,76604381,531999,113878;22932;105375355,3
-1,-1,7,76136289,76604381,468092,22932;105375355,2
-1,-1,7,76136289,76604381,468092,22932;105375355,2
1,-1,7,76136289,76637482,501193,22932;105375355,2
1,-1,7,76136289,76637482,501193,22932;105375355,2
1,-1,7,76123879,76144695,20816,113878;105375355,2
1,-1,7,76132879,76144695,11816,113878;105375355,2
1,-1,7,76132879,76144695,11816,113878;105375355,2
1,-1,7,76132879,76144695,11816,113878;105375355,2
1,-1,7,76132879,76144695,11816,113878;105375355,2
1,-1,7,76132879,76144695,11816,113878;105375355,2
1,-1,7,76132879,76144695,11816,113878;105375355,2
1,-1,7,76132879,76144695,11816,113878;105375355,2
1,-1,7,76132879,76144695,11816,113878;105375355,2
1,-1,7,76132879,76144695,11816,113878;105375355,2
1,-1,7,76132879,76144695,11816,113878;105375355,2
1,-1,7,76132879,76144695,11816,113878;105375355,2
1,-1,7,76132879,76144695,11816,113878;105375355,2
1,-1,7,76132879,76144695,11816,113878;105375355,2
1,-1,7,76132879,76144695,11816,113878;105375355,2
1,-1,7,76132879,76144695,11816,113878;105375355,2
1,-1,7,76132879,76144695,11816,113878;105375355,2
-1,-1,7,76139282,76558024,418742,22932;105375355,2
-1,-1,7,76139282,76558024,418742,22932;105375355,2
1,-1,7,76139282,76558024,418742,22932;105375355,2
1,-1,7,76139286,76557072,417786,22932;105375355,2
1,-1,7,76139286,76623413,484127,22932;105375355,2
1,-1,7,76188343,76787353,599010,22932;57639,2
-1,-1,7,76213818,76558165,344347,22932,1
1,-1,7,76214048,76623413,409365,22932,1
1,-1,7,76214048,76623413,409365,22932,1
1,-1,7,78072972,78118995,46023,9863,1
1,-1,7,78095241,78118995,23754,9863,1
1,-1,7,79337679,79393170,55491,,0
-1,1,7,80256737,80277776,21039,948,1
-1,1,7,80256737,80280613,23876,948,1
-1,1,7,80256737,80280613,23876,948,1
-1,1,7,80256737,80280613,23876,948,1
-1,1,7,80256737,80280613,23876,948,1
-1,1,7,80256737,80280613,23876,948,1
-1,1,7,80256737,80280613,23876,948,1
-1,1,7,80256737,80280613,23876,948,1
-1,1,7,80256737,80280613,23876,948,1
-1,1,7,80256737,80280613,23876,948,1
-1,1,7,83631950,94858195,11226245,222223;1278;154661;219557;54467;5218;79689;5243;8321;1021;10282;30816;53616;55610;257415;57798;55607;10142;401387;105375396;8910;6717;54809;219285;223117;889;799;64921;2913;2791;253012;2792;261729;54677;85865;9988;7978;55972;7980;10926;79846;9069;5244;1595;219578;10371;84060;79161;26872;5189;23089,51
-1,-1,7,84001059,84138511,137452,,0
1,1,7,88314811,89799946,1485135,219557;219578;26872,3
-1,-1,7,89571253,89695823,124570,,0
-1,-1,7,89571253,89695823,124570,,0
-1,1,7,92388458,97197958,4809500,1278;1749;51666;57001;799;64921;2791;253012;1750;5444;2792;7980;7979;5166;10165;1021;10282;55610;1780;55607;5445;5446;23089;8910;54809;219285,26
-1,1,7,92943158,94937906,1994748,1278;10282;55610;55607;799;64921;2791;2792;5444;8910;7980;23089,12
-1,1,7,94756382,97502799,2746417,1749;6863;1780;55607;51666;57001;440;5445;1750;5444;5446;7979;5166;10165,14
-1,1,7,96553465,96786580,233115,1750;1749;57001,3
1,1,7,97049164,158716453,61667289,2041;29923;50640;221914;51691;136242;135941;51593;7791;168537;9296;84691;389602;11194;60561;4708;57180;51384;4698;4233;27044;100861540;857;346528;168391;6742;26211;6718;23554;51422;100526740;154865;349136;9747;55303;155051;26266;27147;7036;346517;445328;5054;168544;101927655;26958;10061;100128553;7982;402317;100134938;4897;55112;100463482;55971;730130;26157;10467;4232;1576;55365;58160;8427;55063;91584;23660;154790;222256;54480;100507421;6561;64761;389549;155054;154791;7472;79706;5701;57464;7551;2636;154743;9311;100130880;51024;7455;389541;7205;23534;222236;10922;22853;10135;135935;402573;202865;2051;5506;7516;25851;93986;136371;346653;54329;51200;375611;5118;3663;155038;222255;8896;84626;154907;246721;140545;5304;81844;84928;80228;26;10095;392843;155061;6469;5172;5764;54927;55503;23165;8976;155435;3912;55340;83590;64418;3792;64327;7328;231;5078;9715;136051;142685;7988;2861;285989;222235;100271927;3751;4899;285973;54784;10552;222234;442721;5420;222950;285971;10049;57488;168433;858;114960;373156;340307;136541;58508;346606;5799;57154;80853;29062;245812;643641;548644;10157;1357;8972;8454;11179;136991;79027;378925;9601;27010;1738;1020;10156;23145;349149;93664;441272;26047;10071;100287482;84255;100289678;1174;653857;222229;23608;43;10898;50831;2146;170575;78996;57189;64792;401427;3110;4289;9179;338398;2845;100289561;100527949;29990;154872;54517;55973;155066;155006;23382;221786;26024;95681;254048;100289187;60412;10980;24146;25913;6863;168850;90956;4885;64764;259285;8805;3952;221908;83992;647087;79989;494551;5577;1811;375607;100130705;22797;25798;9551;136263;100310812;2783;79872;84912;375612;63917;286006;92092;3361;10234;441294;10603;5001;27000;835;23553;222865;440;51530;285888;340348;50832;93408;54892;393046;136319;767558;1180;65999;2918;6733;474344;81392;10466;135927;8985;26261;800;79037;346525;93979;442361;136259;5803;56302;352954;140453;135946;2056;402682;1129;3638;11333;2050;11062;3757;51650;1523;29803;64434;259287;8295;6856;29992;135948;5726;64101;168620;79571;168455;4034;392138;100996928;51412;54429;55131;54674;55798;64816;27153;57541;1551;57016;255374;3614;55262;3268;79974;1080;1804;10447;29969;57670;51631;89122;23601;22976;4951;5644;4584;6916;64598;136227;81628;28996;55904;6878;116988;401409;26136;7586;830;6677;346689;563;381;7589;113763;83943;29999;441282;9512;28959;669;4189;64753;813;9690;5649;6604;7425;1577;136332;55281;100316904;673;729597;64599;50617;9162;221785;22798;3475;100507507;93432;346673;9732;402569;4176;5294;389558;401399;56829;83787;56311;26959;6009;1358;56257;7984;79690;100142659;55750;2020;23008;340351;2318;259286;285966;51667;5919;135924;50833;4850;130075;6608;6522;5439;4846;441273;54556;611;135932;84124;136306;10734;56996;168451;10248;375616,443
-1,1,7,98793459,101718950,2925491,24146;64816;8896;1551;221914;255374;55262;81844;3268;221908;51593;10980;89122;10095;375607;4584;64598;81628;136227;100861540;9551;6878;2783;7586;100526740;563;7589;7036;5054;101927655;285989;7425;10552;1577;10467;1576;55063;93408;222950;100316904;23660;64599;346606;81392;245812;221785;8985;26261;79027;402569;4176;79037;7551;56257;352954;140453;79690;349149;441272;2056;402682;10071;1174;43;11333;2050;10898;51024;7455;389541;7205;64792;1523;9179;84124;402573;10734;29992;29990;56996;221786;4034;26024;100289187;51412;5118;10248,87
1,1,7,98969247,159119707,60150460,2041;29923;50640;221914;51691;136242;135941;51593;7791;168537;9296;84691;389602;11194;60561;4708;57180;51384;4698;4233;27044;100861540;857;346528;168391;6742;26211;6718;23554;51422;100526740;154865;349136;9747;55303;155051;26266;27147;7036;346517;445328;5054;168544;101927655;26958;10061;100128553;7982;402317;100134938;4897;55112;100463482;730130;26157;10467;4232;1576;55365;58160;8427;55063;91584;23660;154790;222256;54480;100507421;6561;64761;389549;155054;154791;7472;79706;5701;57464;7551;2636;154743;9311;100130880;51024;7455;389541;7205;23534;222236;10922;10135;135935;402573;202865;2051;5506;7516;93986;136371;346653;54329;51200;375611;5118;3663;155038;222255;8896;84626;154907;246721;140545;5304;81844;84928;80228;26;10095;392843;155061;6469;5172;5764;54927;55503;23165;8976;155435;3912;55340;83590;64418;3792;64327;7328;231;5078;9715;136051;142685;7988;2861;285989;222235;100271927;3751;4899;285973;54784;222234;442721;5420;222950;285971;10049;57488;168433;858;114960;373156;340307;136541;58508;346606;5799;80853;29062;245812;643641;548644;10157;1357;8972;8454;11179;136991;79027;378925;9601;27010;1738;1020;10156;23145;349149;93664;441272;26047;10071;100287482;84255;100289678;1174;653857;222229;23608;43;10898;50831;2146;170575;78996;57189;64792;401427;3110;4289;9179;338398;2845;100289561;100527949;29990;154872;54517;55973;155066;155006;23382;221786;26024;95681;254048;100289187;60412;10980;24146;25913;168850;90956;64764;259285;8805;3952;221908;83992;647087;79989;494551;5577;1811;375607;100130705;22797;9551;136263;100310812;2783;79872;84912;375612;63917;286006;92092;3361;10234;441294;10603;5001;27000;835;23553;7434;51530;285888;340348;50832;93408;54892;393046;136319;767558;1180;65999;2918;6733;474344;81392;10466;135927;8985;26261;800;79037;346525;93979;442361;136259;5803;56302;352954;140453;135946;2056;402682;1129;3638;11333;2050;11062;3757;51650;1523;29803;64434;259287;6856;29992;135948;5726;64101;79571;168455;4034;392138;100996928;51412;54429;55131;54674;55798;64816;27153;57541;1551;57016;255374;3614;55262;3268;79974;1080;1804;10447;29969;57670;51631;89122;23601;22976;5644;4584;6916;64598;136227;81628;28996;55904;6878;116988;401409;26136;7586;830;6677;346689;563;381;7589;113763;83943;29999;441282;9512;28959;669;4189;64753;813;9690;5649;6604;7425;1577;136332;55281;100316904;673;729597;64599;50617;9162;221785;22798;3475;100507507;93432;346673;9732;4176;5294;389558;401399;56829;83787;56311;26959;6009;1358;56257;7984;79690;100142659;55750;2020;23008;340351;2318;259286;285966;51667;5919;135924;50833;4850;130075;6608;6522;5439;4846;441273;54556;611;135932;84124;136306;10734;56996;168451;10248;375616,430
1,-1,7,100773842,100898909,125067,24146;7425;346606;375607;10467;51024;5054;8985;1174,9
-1,-1,7,100980697,101101497,120800,136227,1
1,-1,7,100980697,101101497,120800,136227,1
1,-1,7,100980697,101126335,145638,136227,1
-1,1,7,101912320,120918695,19006375,222255;154907;50640;246721;51691;79974;1080;83992;29969;80228;5577;1811;60561;4233;5172;22797;857;55904;100310812;26136;79872;830;23554;375612;286006;83943;3912;9512;64418;10234;4189;10603;7982;5001;100134938;27000;4897;222235;5649;100271927;3751;54784;58160;222234;858;222256;729597;6733;10466;548644;22798;3475;11179;136991;9732;5294;1738;7472;79706;83787;5701;56311;26959;10156;154743;222229;11062;5439;1523;441273;54556;222236;10135;6856;2845;100289561;5506;54517;55973;93986;168455;54329;168451;54674;375611,85
-1,-1,7,102335320,102359654,24334,,0
-1,1,7,107813198,123148768,15335570,858;154907;50640;51691;3475;79974;6561;1080;10157;83992;10447;11179;136991;389549;29969;9732;378925;7472;56311;5803;51384;4233;22797;857;93664;154743;26136;830;23554;154865;83943;286006;50833;64418;4189;54556;7982;4897;5506;3751;93986;54329;168451;54674;168433,45
-1,1,7,107830021,111587499,3757478,4897;154907;50640;83943;168451;4189;54674;9732,8
-1,-1,7,110814584,111105234,290650,83943,1
-1,-1,7,110814584,111105234,290650,83943,1
-1,-1,7,110839776,111049538,209762,83943,1
-1,-1,7,111110687,111281484,170797,83943,1
-1,-1,7,111227064,111333930,106866,,0
-1,1,7,111642645,115770275,4127630,5506;286006;64418;93986;3475;54329;22797;154743;11179;29969;9732,11
-1,-1,7,111732639,111784310,51671,9732,1
-1,-1,7,113125279,113209832,84553,,0
-1,1,7,113782532,125480435,11697903,858;25913;51691;79974;6561;1080;10157;83992;10447;389549;136991;378925;29969;7472;56311;5803;51384;4698;4233;22797;857;93664;26136;830;6677;8976;23554;154865;50833;54556;142685;2861;7982;23553;154872;3751;730130;93986;442721;168433,40
-1,1,7,114029450,116893795,2864345,858;7982;93986;4233;22797;857;26136;29969;830,9
-1,1,7,114538937,117430177,2891240,858;7982;7472;4233;22797;857;1080;83992;26136;136991;29969;830,12
1,1,7,115099069,159118507,44019438,2041;29923;51691;136242;135941;7791;168537;9296;84691;389602;11194;4708;57180;51384;4698;4233;27044;857;346528;168391;6742;26211;6718;23554;51422;154865;349136;9747;55303;155051;26266;27147;346517;168544;26958;10061;100128553;7982;402317;55112;100463482;730130;26157;4232;55365;8427;91584;54480;154790;100507421;6561;64761;389549;155054;154791;7472;57464;2636;9311;100130880;23534;10922;135935;202865;2051;7516;136371;346653;51200;3663;155038;84626;140545;5304;84928;26;155061;392843;6469;5764;54927;55503;23165;8976;155435;55340;83590;64327;3792;7328;231;142685;5078;9715;136051;7988;2861;3751;4899;285973;442721;5420;285971;10049;168433;57488;858;114960;373156;340307;136541;58508;5799;80853;29062;643641;10157;1357;8972;8454;136991;378925;9601;27010;1020;23145;93664;26047;84255;100287482;100289678;653857;23608;50831;57189;2146;78996;170575;401427;4289;338398;100527949;154872;155066;155006;23382;95681;254048;60412;25913;168850;90956;64764;259285;8805;3952;83992;647087;79989;494551;100130705;22797;136263;84912;63917;92092;3361;441294;835;23553;7434;51530;285888;340348;50832;54892;393046;136319;767558;1180;65999;2918;474344;135927;800;346525;93979;442361;136259;5803;56302;135946;1129;3638;3757;51650;29803;64434;259287;135948;5726;64101;79571;392138;100996928;54429;55131;55798;27153;57541;57016;3614;79974;1080;1804;10447;57670;51631;23601;22976;5644;3110;6916;28996;116988;401409;26136;830;6677;346689;381;113763;29999;441282;28959;669;64753;813;9690;6604;136332;55281;673;50617;9162;100507507;93432;346673;389558;401399;56829;56311;6009;1358;7984;100142659;55750;2020;23008;340351;2318;259286;285966;5919;51667;135924;50833;4850;6608;130075;6522;4846;54556;611;135932;136306;445328;375616,278
-1,1,7,116966859,134475440,17508581,25913;168850;29923;57016;51691;3614;79974;1080;3952;83992;10447;84928;9296;84691;51384;4698;100130705;27044;54927;136263;6677;8976;23554;84912;154865;381;29999;441282;7328;669;231;142685;26958;5078;64753;2861;813;23553;730130;3751;4899;4232;51530;136332;340348;442721;5420;91584;168433;114960;2918;6561;10157;1357;375616;389549;378925;136991;800;401399;93979;56311;57464;5803;136259;1358;93664;60412;55131;100287482;23008;2318;50833;6608;23534;54556;4289;611;64101;154872;79571;23382;346653;95681;51200;55798;3663,87
-1,-1,7,118866671,119014612,147941,,0
-1,-1,7,118866671,119025730,159059,,0
-1,-1,7,118866671,119025730,159059,,0
1,-1,7,118866671,119025730,159059,,0
-1,1,7,120435581,120482611,47030,23554,1
-1,-1,7,120667938,120887300,219362,79974,1
1,1,7,121503813,159128555,37624742,2041;29923;136242;135941;7791;168537;9296;84691;389602;11194;4708;57180;4698;27044;346528;168391;6742;26211;6718;51422;154865;349136;9747;55303;155051;26266;27147;346517;168544;26958;10061;100128553;402317;55112;100463482;730130;26157;4232;55365;8427;91584;54480;154790;100507421;6561;64761;389549;155054;154791;57464;2636;9311;100130880;23534;10922;135935;202865;2051;7516;136371;346653;51200;3663;155038;84626;140545;5304;84928;26;155061;392843;6469;5764;54927;55503;23165;8976;155435;55340;83590;64327;3792;7328;231;142685;5078;9715;136051;7988;2861;4899;285973;442721;5420;285971;10049;168433;57488;114960;373156;340307;136541;58508;5799;80853;29062;643641;10157;1357;8972;8454;378925;9601;27010;1020;23145;93664;26047;84255;100287482;100289678;653857;23608;50831;57189;2146;78996;170575;401427;4289;338398;100527949;154872;155066;155006;23382;95681;254048;60412;25913;168850;90956;64764;259285;8805;3952;647087;79989;494551;100130705;136263;84912;63917;92092;3361;441294;835;23553;7434;51530;285888;340348;50832;54892;393046;136319;767558;1180;65999;2918;474344;135927;800;346525;93979;442361;136259;5803;56302;135946;1129;3638;3757;51650;29803;64434;259287;135948;5726;64101;79571;392138;100996928;54429;55131;55798;27153;57541;57016;3614;1804;57670;51631;23601;22976;5644;3110;6916;28996;116988;401409;6677;346689;381;113763;29999;441282;28959;669;64753;813;9690;6604;136332;55281;673;50617;9162;100507507;93432;346673;389558;401399;56829;6009;1358;7984;100142659;55750;2020;23008;340351;2318;259286;285966;5919;51667;135924;50833;4850;6608;130075;6522;4846;611;135932;136306;445328;375616,259
-1,1,7,121658176,128547780,6889604,25913;168850;29923;2918;3614;6561;10157;3952;389549;378925;9296;84691;401399;5803;4698;100130705;27044;93664;6677;8976;2318;154865;381;29999;50833;142685;5078;611;64753;2861;813;168433;23553;154872;730130;79571;64101;346653;442721;55131;55798;375616,42
-1,1,7,123810711,133848346,10037635,114960;25913;168850;29923;2918;3614;3952;1357;84928;9296;84691;401399;93979;57464;136259;1358;100130705;27044;54927;136263;60412;100287482;23008;2318;381;29999;51200;6608;7328;23534;5078;26958;4289;611;64753;2861;3663;813;154872;64101;79571;4899;4232;51530;136332;23382;346653;340348;95681;5420;91584;55131;55798;375616,54
-1,-1,7,124607233,124673241,66008,,0
1,-1,7,125178203,125697584,519381,,0
1,-1,7,125178203,125790977,612774,,0
1,-1,7,125178203,125790977,612774,,0
-1,-1,7,125293124,125406088,112964,,0
-1,1,7,127295698,139524358,12228660,29923;57016;3614;64764;8805;3952;647087;84928;9296;79989;57670;84691;51631;6916;28996;100130705;27044;5764;54927;136263;23165;346689;6718;84912;92092;26266;441282;7328;669;231;26958;64753;813;4899;4232;51530;136332;55281;340348;5420;91584;136319;767558;154790;114960;50617;29062;9162;375616;1357;346673;800;154791;389558;401399;56829;93979;57464;136259;1358;60412;1129;55131;100287482;23008;340351;2318;254048;100130880;4850;6608;78996;23534;4289;611;136306;64101;155006;23382;346653;95681;100996928;51200;55798;3663,85
1,1,7,128276078,159119707,30843629,2041;90956;136242;64764;259285;135941;8805;647087;7791;168537;9296;79989;494551;84691;389602;11194;4708;57180;100130705;346528;136263;168391;6742;26211;6718;51422;84912;349136;9747;55303;155051;63917;92092;26266;27147;3361;346517;168544;441294;26958;10061;100128553;402317;55112;835;100463482;26157;4232;51530;55365;7434;285888;8427;340348;50832;91584;54892;393046;136319;767558;154790;54480;1180;100507421;65999;474344;135927;64761;155054;800;154791;346525;93979;442361;57464;136259;56302;135946;2636;1129;3638;9311;100130880;3757;23534;51650;29803;64434;259287;10922;135935;2020;135948;202865;2051;5726;7516;136371;346653;392138;100996928;54429;51200;3663;155038;27153;57541;84626;57016;140545;5304;1804;84928;57670;51631;23601;26;22976;155061;392843;5644;6469;6916;28996;116988;3110;5764;54927;401409;55503;23165;346689;155435;113763;441282;55340;28959;3792;83590;7328;669;64327;231;9715;136051;64753;7988;813;9690;6604;4899;285973;136332;55281;5420;285971;673;10049;57488;114960;373156;340307;136541;58508;5799;50617;80853;29062;9162;643641;1357;8972;8454;100507507;93432;9601;346673;389558;27010;56829;1020;6009;1358;23145;7984;100142659;55750;84255;100287482;26047;100289678;653857;23008;340351;2318;23608;259286;285966;5919;51667;135924;4850;6608;50831;57189;130075;78996;2146;170575;401427;4846;6522;4289;611;135932;338398;136306;100527949;155066;155006;23382;95681;254048;60412;445328;375616,226
1,1,7,130856237,159119707,28263470,2041;90956;136242;64764;259285;135941;8805;647087;7791;168537;79989;494551;389602;11194;4708;57180;346528;168391;6742;26211;6718;51422;84912;349136;9747;55303;155051;63917;92092;26266;27147;3361;346517;168544;441294;10061;100128553;402317;55112;835;100463482;26157;55365;7434;285888;8427;50832;91584;54892;393046;136319;767558;154790;54480;1180;100507421;65999;474344;135927;64761;155054;800;154791;346525;442361;56302;135946;2636;1129;3638;9311;100130880;3757;51650;29803;64434;259287;10922;135935;135948;202865;2051;5726;7516;136371;392138;100996928;54429;155038;27153;57541;84626;57016;140545;5304;1804;57670;51631;23601;26;22976;155061;392843;5644;6469;6916;28996;116988;3110;5764;54927;401409;55503;23165;346689;155435;113763;441282;55340;28959;3792;83590;64327;669;231;9715;136051;7988;9690;6604;285973;136332;55281;5420;285971;673;10049;57488;373156;340307;136541;58508;5799;50617;80853;29062;9162;643641;8972;8454;100507507;93432;9601;346673;389558;27010;56829;1020;6009;23145;7984;100142659;55750;84255;26047;2020;100289678;653857;340351;23608;259286;285966;5919;51667;135924;4850;50831;130075;57189;2146;78996;170575;6522;401427;4846;4289;135932;338398;136306;100527949;155066;155006;254048;60412;445328,195
1,1,7,130913523,159128556,28215033,2041;90956;136242;64764;259285;135941;8805;647087;7791;168537;79989;494551;389602;11194;4708;57180;346528;168391;6742;26211;6718;51422;84912;349136;9747;55303;155051;63917;92092;26266;27147;3361;346517;168544;441294;10061;100128553;402317;55112;835;100463482;26157;55365;7434;285888;8427;50832;91584;54892;393046;136319;767558;154790;54480;1180;100507421;65999;474344;135927;64761;155054;800;154791;346525;442361;56302;135946;2636;1129;3638;9311;100130880;3757;51650;29803;64434;259287;10922;135935;135948;202865;2051;5726;7516;136371;392138;100996928;54429;155038;27153;57541;84626;57016;140545;5304;1804;57670;51631;23601;26;22976;155061;392843;5644;6469;6916;28996;116988;3110;5764;54927;401409;55503;23165;346689;155435;113763;441282;55340;28959;3792;83590;64327;669;231;9715;136051;7988;9690;6604;285973;136332;55281;5420;285971;673;10049;57488;373156;340307;136541;58508;5799;50617;80853;29062;9162;643641;8972;8454;100507507;93432;9601;346673;389558;27010;56829;1020;6009;23145;7984;100142659;55750;84255;26047;2020;100289678;653857;340351;23608;259286;285966;5919;51667;135924;4850;50831;130075;57189;2146;78996;170575;6522;401427;4846;4289;135932;338398;136306;100527949;155066;155006;254048;60412;445328,195
-1,1,7,131642114,139107211,7465097,136319;767558;57016;50617;29062;9162;64764;8805;647087;346673;57670;79989;800;389558;51631;154791;56829;5764;54927;1129;23165;340351;6718;84912;100130880;92092;441282;4850;26266;669;78996;231;136306;100996928;136332;155006;55281;254048;91584;60412,40
1,1,7,132122831,159119707,26996876,2041;90956;136242;64764;259285;135941;8805;647087;7791;168537;79989;494551;389602;11194;4708;57180;346528;168391;6742;26211;6718;51422;84912;349136;9747;55303;155051;63917;92092;26266;27147;3361;346517;168544;441294;10061;100128553;402317;55112;835;100463482;26157;55365;7434;285888;8427;50832;91584;54892;393046;136319;767558;154790;54480;1180;100507421;65999;474344;135927;64761;155054;800;154791;346525;442361;56302;135946;2636;1129;3638;9311;100130880;3757;51650;29803;64434;259287;10922;135935;135948;202865;2051;5726;7516;136371;392138;100996928;54429;155038;27153;57541;84626;57016;140545;5304;1804;57670;51631;23601;26;22976;155061;392843;5644;6469;6916;28996;116988;3110;5764;54927;401409;55503;23165;346689;155435;113763;441282;55340;28959;3792;83590;64327;669;231;9715;136051;7988;9690;6604;285973;136332;55281;285971;673;10049;57488;373156;340307;136541;58508;5799;50617;80853;29062;9162;643641;8972;8454;100507507;93432;9601;346673;389558;27010;56829;1020;6009;23145;7984;100142659;55750;84255;26047;2020;100289678;653857;340351;23608;259286;285966;5919;51667;135924;4850;50831;130075;57189;2146;78996;170575;6522;401427;4846;135932;338398;136306;100527949;155066;155006;254048;60412;445328,193
1,1,7,132128854,159128556,26999702,2041;90956;136242;64764;259285;135941;8805;647087;7791;168537;79989;494551;389602;11194;4708;57180;346528;168391;6742;26211;6718;51422;84912;349136;9747;55303;155051;63917;92092;26266;27147;3361;346517;168544;441294;10061;100128553;402317;55112;835;100463482;26157;55365;7434;285888;8427;50832;91584;54892;393046;136319;767558;154790;54480;1180;100507421;65999;474344;135927;64761;155054;800;154791;346525;442361;56302;135946;2636;1129;3638;9311;100130880;3757;51650;29803;64434;259287;10922;135935;135948;202865;2051;5726;7516;136371;392138;100996928;54429;155038;27153;57541;84626;57016;140545;5304;1804;57670;51631;23601;26;22976;155061;392843;5644;6469;6916;28996;116988;3110;5764;54927;401409;55503;23165;346689;155435;113763;441282;55340;28959;3792;83590;64327;669;231;9715;136051;7988;9690;6604;285973;136332;55281;285971;673;10049;57488;373156;340307;136541;58508;5799;50617;80853;29062;9162;643641;8972;8454;100507507;93432;9601;346673;389558;27010;56829;1020;6009;23145;7984;100142659;55750;84255;26047;2020;100289678;653857;340351;23608;259286;285966;5919;51667;135924;4850;50831;130075;57189;2146;78996;170575;6522;401427;4846;135932;338398;136306;100527949;155066;155006;254048;60412;445328,193
-1,1,7,133799185,159119707,25320522,2041;90956;136242;64764;259285;135941;8805;647087;7791;168537;79989;494551;389602;11194;4708;57180;346528;168391;6742;26211;6718;51422;84912;349136;9747;55303;155051;63917;92092;26266;27147;3361;346517;168544;441294;10061;100128553;402317;55112;835;100463482;26157;55365;7434;285888;8427;50832;54892;393046;136319;767558;154790;54480;1180;100507421;65999;474344;135927;64761;155054;800;154791;346525;442361;56302;135946;2636;1129;3638;9311;100130880;3757;51650;29803;64434;259287;10922;135935;135948;202865;2051;5726;7516;136371;392138;100996928;54429;155038;27153;57541;84626;57016;140545;5304;1804;57670;51631;23601;26;22976;155061;392843;5644;6469;6916;28996;116988;3110;5764;401409;55503;23165;346689;155435;113763;441282;55340;28959;3792;83590;64327;669;231;9715;136051;7988;9690;6604;285973;136332;55281;285971;673;10049;57488;373156;340307;136541;58508;5799;50617;80853;29062;9162;643641;8972;8454;100507507;93432;9601;346673;389558;27010;56829;1020;6009;23145;7984;100142659;55750;84255;26047;2020;100289678;653857;340351;23608;259286;285966;5919;51667;135924;4850;50831;130075;57189;2146;78996;170575;6522;401427;4846;135932;338398;136306;100527949;155066;155006;254048;445328,190
-1,1,7,134351581,158384574,24032993,2041;90956;136242;64764;259285;135941;8805;647087;7791;168537;79989;494551;389602;11194;4708;57180;346528;168391;6742;26211;6718;51422;349136;9747;55303;155051;63917;92092;26266;27147;3361;346517;168544;441294;10061;100128553;402317;835;100463482;26157;55365;285888;8427;50832;393046;136319;767558;154790;54480;1180;100507421;65999;474344;135927;64761;155054;800;154791;346525;442361;56302;135946;2636;1129;3638;9311;100130880;3757;51650;29803;64434;259287;10922;135935;135948;202865;2051;5726;7516;136371;392138;100996928;54429;155038;27153;57541;84626;140545;5304;1804;57670;51631;23601;26;22976;155061;392843;5644;6469;6916;28996;116988;3110;5764;401409;55503;23165;346689;155435;113763;55340;83590;28959;3792;64327;669;9715;136051;7988;9690;6604;285973;55281;285971;673;10049;373156;340307;136541;58508;5799;50617;80853;29062;9162;643641;8972;8454;100507507;93432;9601;346673;389558;27010;56829;1020;6009;23145;7984;100142659;55750;84255;26047;2020;100289678;653857;340351;23608;259286;285966;5919;51667;135924;4850;50831;130075;57189;2146;78996;170575;6522;401427;4846;135932;338398;136306;100527949;155066;155006;254048;445328,181
-1,1,7,134702438,148504492,13802054,2041;90956;5304;136242;64764;259285;135941;8805;647087;7791;79989;494551;57670;51631;23601;4708;5644;6916;28996;346528;5764;401409;55503;6742;26211;23165;346689;6718;9747;92092;26266;27147;3792;346517;441294;9715;100128553;402317;835;100463482;55281;50832;673;393046;136319;767558;154790;373156;1180;340307;100507421;136541;50617;80853;135927;29062;9162;64761;8972;8454;100507507;93432;346673;389558;154791;27010;346525;56829;442361;56302;7984;135946;100142659;1129;55750;84255;26047;340351;23608;259286;285966;254048;100130880;135924;4850;50831;130075;57189;2146;78996;51650;401427;259287;135932;338398;135935;136306;135948;202865;2051;5726;155006;392138;100996928;54429;445328,106
1,1,7,136758593,159119707,22361114,2041;90956;136242;64764;259285;135941;8805;7791;168537;79989;494551;389602;11194;4708;57180;346528;168391;6742;26211;6718;51422;349136;9747;55303;155051;63917;92092;27147;3361;346517;168544;441294;10061;100128553;402317;55112;835;100463482;26157;55365;7434;285888;8427;50832;54892;393046;54480;154790;1180;100507421;65999;474344;135927;64761;155054;154791;346525;442361;56302;135946;2636;3638;9311;100130880;3757;51650;29803;64434;259287;10922;135935;135948;202865;2051;5726;7516;136371;392138;100996928;54429;155038;27153;57541;84626;140545;5304;1804;57670;51631;23601;26;22976;155061;392843;5644;6469;6916;28996;116988;3110;5764;401409;55503;346689;155435;113763;55340;83590;28959;3792;64327;9715;136051;7988;9690;6604;285973;285971;673;10049;57488;373156;340307;136541;58508;5799;50617;80853;9162;643641;8972;8454;100507507;93432;9601;27010;56829;1020;6009;23145;7984;100142659;55750;84255;26047;2020;100289678;653857;23608;285966;259286;5919;51667;135924;50831;130075;57189;2146;170575;6522;401427;4846;135932;338398;136306;100527949;155066;155006;254048;445328,170
1,1,7,137435946,154607292,17171346,2041;90956;136242;64764;259285;135941;8805;7791;168537;79989;494551;11194;4708;57180;346528;168391;6742;26211;6718;51422;349136;9747;55303;155051;63917;92092;27147;346517;168544;441294;10061;100128553;402317;835;100463482;26157;55365;8427;50832;393046;54480;154790;1180;100507421;65999;474344;135927;64761;155054;154791;346525;442361;56302;135946;2636;9311;100130880;3757;51650;29803;259287;10922;135935;135948;202865;2051;5726;7516;136371;392138;100996928;54429;155038;27153;57541;84626;5304;1804;57670;51631;23601;26;155061;392843;5644;6916;28996;116988;401409;55503;346689;113763;55340;83590;28959;3792;9715;136051;7988;6604;285973;285971;673;373156;340307;136541;58508;50617;80853;9162;643641;8972;8454;100507507;93432;9601;27010;56829;1020;6009;23145;7984;100142659;55750;84255;26047;100289678;653857;23608;285966;259286;5919;51667;135924;50831;130075;57189;2146;170575;6522;401427;4846;135932;338398;136306;100527949;155066;155006;254048;445328,150
1,1,7,137435946,154607292,17171346,2041;90956;136242;64764;259285;135941;8805;7791;168537;79989;494551;11194;4708;57180;346528;168391;6742;26211;6718;51422;349136;9747;55303;155051;63917;92092;27147;346517;168544;441294;10061;100128553;402317;835;100463482;26157;55365;8427;50832;393046;54480;154790;1180;100507421;65999;474344;135927;64761;155054;154791;346525;442361;56302;135946;2636;9311;100130880;3757;51650;29803;259287;10922;135935;135948;202865;2051;5726;7516;136371;392138;100996928;54429;155038;27153;57541;84626;5304;1804;57670;51631;23601;26;155061;392843;5644;6916;28996;116988;401409;55503;346689;113763;55340;83590;28959;3792;9715;136051;7988;6604;285973;285971;673;373156;340307;136541;58508;50617;80853;9162;643641;8972;8454;100507507;93432;9601;27010;56829;1020;6009;23145;7984;100142659;55750;84255;26047;100289678;653857;23608;285966;259286;5919;51667;135924;50831;130075;57189;2146;170575;6522;401427;4846;135932;338398;136306;100527949;155066;155006;254048;445328,150
1,1,7,137589621,159119707,21530086,2041;90956;136242;64764;259285;135941;8805;7791;168537;79989;494551;389602;11194;4708;57180;346528;168391;6742;26211;6718;51422;349136;9747;55303;155051;63917;92092;27147;3361;346517;168544;441294;10061;100128553;402317;55112;835;100463482;26157;55365;7434;285888;8427;50832;54892;393046;54480;154790;1180;100507421;65999;474344;135927;64761;155054;154791;346525;442361;56302;135946;2636;3638;9311;100130880;3757;51650;29803;64434;259287;10922;135935;135948;202865;2051;5726;7516;136371;392138;100996928;54429;155038;27153;57541;84626;140545;5304;1804;57670;51631;23601;26;22976;155061;392843;5644;6469;6916;28996;116988;3110;401409;55503;346689;155435;113763;55340;83590;28959;3792;64327;9715;136051;7988;9690;6604;285973;285971;673;10049;57488;373156;340307;136541;58508;5799;50617;80853;643641;8972;8454;100507507;93432;9601;27010;56829;1020;6009;23145;7984;100142659;55750;84255;26047;2020;100289678;653857;23608;285966;259286;5919;51667;135924;50831;130075;57189;2146;170575;6522;401427;4846;135932;338398;136306;100527949;155066;155006;254048;445328,168
-1,1,7,137917376,159119707,21202331,2041;90956;136242;259285;135941;8805;7791;168537;79989;494551;389602;11194;4708;57180;346528;168391;6742;26211;51422;349136;9747;55303;155051;63917;92092;27147;3361;346517;168544;441294;10061;100128553;402317;55112;835;100463482;26157;55365;7434;285888;8427;50832;54892;393046;54480;154790;1180;100507421;65999;474344;135927;64761;155054;154791;346525;442361;56302;135946;2636;3638;9311;3757;51650;29803;64434;259287;10922;135935;135948;202865;2051;5726;7516;136371;392138;100996928;54429;155038;27153;57541;84626;140545;5304;1804;57670;51631;23601;26;22976;155061;392843;5644;6469;6916;28996;116988;3110;401409;55503;346689;155435;113763;55340;83590;28959;3792;64327;9715;136051;7988;9690;6604;285973;285971;673;10049;57488;373156;340307;136541;58508;5799;50617;80853;643641;8972;8454;100507507;93432;9601;27010;56829;1020;6009;23145;7984;100142659;55750;84255;26047;2020;100289678;653857;23608;285966;259286;5919;51667;135924;50831;130075;57189;2146;170575;6522;401427;4846;135932;338398;136306;100527949;155066;155006;254048;445328,165
-1,1,7,140636858,159119707,18482849,2041;136242;259285;135941;7791;168537;494551;389602;11194;57180;346528;168391;6742;26211;51422;349136;9747;55303;155051;63917;3361;346517;168544;441294;10061;100128553;402317;55112;835;100463482;26157;55365;7434;285888;8427;50832;54892;393046;54480;1180;100507421;65999;474344;135927;155054;346525;442361;56302;135946;2636;3638;9311;3757;51650;29803;64434;259287;10922;135935;135948;202865;2051;5726;7516;136371;392138;54429;155038;27153;57541;84626;140545;5304;1804;23601;26;22976;155061;392843;5644;6469;3110;116988;55503;155435;113763;55340;83590;28959;3792;64327;9715;136051;7988;9690;6604;285973;285971;10049;57488;373156;340307;136541;58508;5799;643641;8972;8454;100507507;93432;9601;27010;1020;6009;23145;7984;100142659;55750;26047;2020;100289678;653857;285966;259286;5919;51667;135924;50831;130075;57189;2146;170575;6522;401427;4846;135932;338398;100527949;155066;445328,140
1,1,7,140826207,145349314,4523107,373156;2041;1180;340307;100507421;136541;5304;136242;135927;259285;135941;8972;7791;100507507;93432;494551;27010;23601;346525;442361;5644;56302;346528;135946;100142659;7984;55750;55503;6742;26211;285966;259286;9747;135924;50831;130075;3792;57189;346517;401427;441294;9715;259287;135932;338398;100128553;402317;135935;135948;2051;5726;835;100463482;392138;50832;54429;445328;393046,58
1,1,7,140826207,145349314,4523107,373156;2041;1180;340307;100507421;136541;5304;136242;135927;259285;135941;8972;7791;100507507;93432;494551;27010;23601;346525;442361;5644;56302;346528;135946;100142659;7984;55750;55503;6742;26211;285966;259286;9747;135924;50831;130075;3792;57189;346517;401427;441294;9715;259287;135932;338398;100128553;402317;135935;135948;2051;5726;835;100463482;392138;50832;54429;445328;393046,58
-1,-1,7,142098197,142215022,116825,,0
-1,-1,7,142098197,142276197,178000,,0
-1,-1,7,142098197,142276197,178000,,0
-1,-1,7,142098197,142276197,178000,,0
-1,-1,7,142098197,142276197,178000,,0
-1,-1,7,142098197,142276197,178000,,0
-1,-1,7,142328008,142455543,127535,100463482,1
-1,-1,7,142407731,142472658,64927,5644,1
-1,-1,7,142429334,142487154,57820,5644,1
-1,-1,7,142446048,142460444,14396,5644,1
-1,-1,7,142455572,142460250,4678,5644,1
1,-1,7,142458519,142460937,2418,5644,1
-1,-1,7,142458668,142460250,1582,5644,1
-1,-1,7,142458766,142460250,1484,5644,1
1,-1,7,142459205,142460451,1246,5644,1
-1,-1,7,142460910,142486383,25473,5644,1
-1,-1,7,142460910,142486383,25473,5644,1
-1,1,7,142528609,159128556,16599947,2041;27153;57541;84626;140545;5304;259285;135941;1804;7791;168537;389602;26;22976;11194;57180;155061;392843;6469;3110;116988;346528;168391;55503;26211;51422;349136;9747;55303;155051;63917;155435;113763;55340;3361;83590;28959;346517;3792;64327;168544;441294;9715;136051;7988;10061;100128553;402317;9690;55112;835;6604;285973;26157;55365;7434;285888;8427;54892;285971;10049;57488;393046;54480;373156;1180;340307;58508;65999;5799;474344;135927;643641;8454;100507507;9601;155054;27010;346525;1020;442361;6009;56302;23145;7984;135946;2636;100142659;26047;2020;3638;100289678;653857;285966;259286;5919;51667;9311;135924;2146;170575;6522;3757;401427;4846;29803;64434;259287;10922;135932;338398;135935;135948;202865;2051;100527949;7516;155066;136371;392138;445328;155038,122
-1,1,7,142528609,159128556,16599947,2041;27153;57541;84626;140545;5304;259285;135941;1804;7791;168537;389602;26;22976;11194;57180;155061;392843;6469;3110;116988;346528;168391;55503;26211;51422;349136;9747;55303;155051;63917;155435;113763;55340;3361;83590;28959;346517;3792;64327;168544;441294;9715;136051;7988;10061;100128553;402317;9690;55112;835;6604;285973;26157;55365;7434;285888;8427;54892;285971;10049;57488;393046;54480;373156;1180;340307;58508;65999;5799;474344;135927;643641;8454;100507507;9601;155054;27010;346525;1020;442361;6009;56302;23145;7984;135946;2636;100142659;26047;2020;3638;100289678;653857;285966;259286;5919;51667;9311;135924;2146;170575;6522;3757;401427;4846;29803;64434;259287;10922;135932;338398;135935;135948;202865;2051;100527949;7516;155066;136371;392138;445328;155038,122
-1,-1,7,142829167,142836798,7631,5304,1
-1,-1,7,142829167,142881336,52169,5304;259285,2
1,-1,7,143152944,143153565,621,,0
-1,-1,7,143212259,143581871,369612,285966;9747;441294;340307,4
-1,-1,7,143212259,143581871,369612,285966;9747;441294;340307,4
-1,-1,7,143212259,143581871,369612,285966;9747;441294;340307,4
-1,-1,7,143212259,143581871,369612,285966;9747;441294;340307,4
-1,-1,7,143212259,143581871,369612,285966;9747;441294;340307,4
-1,-1,7,143212259,143581871,369612,285966;9747;441294;340307,4
-1,-1,7,143212259,143581871,369612,285966;9747;441294;340307,4
-1,-1,7,143212259,143581871,369612,285966;9747;441294;340307,4
-1,-1,7,143212259,143581871,369612,285966;9747;441294;340307,4
-1,-1,7,143212259,143581871,369612,285966;9747;441294;340307,4
-1,-1,7,143212259,143581871,369612,285966;9747;441294;340307,4
-1,-1,7,143212259,143581871,369612,285966;9747;441294;340307,4
-1,-1,7,143212259,143581871,369612,285966;9747;441294;340307,4
-1,-1,7,143212259,143581871,369612,285966;9747;441294;340307,4
-1,-1,7,143212259,143581871,369612,285966;9747;441294;340307,4
-1,-1,7,143212259,143581871,369612,285966;9747;441294;340307,4
-1,-1,7,143212259,143581871,369612,285966;9747;441294;340307,4
-1,-1,7,143212259,143581871,369612,285966;9747;441294;340307,4
-1,-1,7,143430993,144051263,620270,9747;340307;135941;401427;100128553;402317;135948;346525;442361;392138;135946;100142659;346528;26211;445328;393046,16
-1,-1,7,143425418,143426039,621,285966,1
1,-1,7,143432832,143853032,420200,135948;346525;9747;340307;442361;392138;135946;135941;26211;393046,10
1,-1,7,143432832,143853032,420200,135948;346525;9747;340307;442361;392138;135946;135941;26211;393046,10
1,-1,7,143432832,143853032,420200,135948;346525;9747;340307;442361;392138;135946;135941;26211;393046,10
1,-1,7,143432832,143951990,519158,402317;135948;346525;9747;340307;442361;392138;135946;135941;26211;445328;100128553;393046,13
-1,-1,7,143951961,144051250,99289,401427;346528;100142659,3
-1,1,7,144947347,159128556,14181209,27153;57541;84626;140545;1804;168537;389602;26;22976;11194;57180;155061;392843;6469;3110;116988;168391;51422;349136;55303;155051;63917;155435;113763;55340;3361;83590;28959;64327;168544;136051;7988;10061;9690;55112;6604;285973;26157;55365;7434;285888;8427;54892;285971;10049;57488;54480;58508;65999;5799;474344;643641;8454;9601;155054;1020;6009;23145;2636;26047;2020;3638;100289678;653857;5919;51667;9311;2146;170575;6522;3757;4846;29803;64434;10922;202865;100527949;7516;155066;136371;155038,81
-1,1,7,145441216,145895268,454052,26047,1
-1,-1,7,145590958,145781576,190618,,0
-1,1,7,145744250,157314852,11570602,27153;57541;84626;140545;1804;168537;389602;26;22976;11194;155061;392843;57180;6469;3110;116988;168391;51422;349136;55303;155051;63917;113763;155435;55340;83590;28959;3361;64327;168544;136051;7988;10061;9690;6604;285973;26157;55365;285888;8427;285971;10049;54480;58508;65999;474344;643641;8454;9601;155054;1020;6009;23145;2636;26047;2020;100289678;653857;3638;5919;51667;9311;2146;170575;6522;3757;4846;29803;64434;10922;202865;100527949;7516;155066;136371;155038,76
-1,1,7,146440190,146663300,223110,26047,1
-1,1,7,146481738,159128663,12646925,27153;57541;84626;140545;1804;168537;389602;26;22976;11194;57180;155061;392843;6469;3110;116988;168391;51422;349136;55303;155051;63917;155435;113763;55340;3361;83590;28959;64327;168544;136051;7988;10061;9690;55112;6604;285973;26157;55365;7434;285888;8427;54892;285971;10049;57488;54480;58508;65999;5799;474344;643641;8454;9601;155054;1020;6009;23145;2636;26047;2020;3638;100289678;653857;5919;51667;9311;2146;170575;6522;3757;4846;29803;64434;10922;202865;100527949;7516;155066;136371;155038,81
-1,1,7,146841094,159119707,12278613,27153;57541;84626;140545;1804;168537;389602;26;22976;11194;57180;155061;392843;6469;3110;116988;168391;51422;349136;55303;155051;63917;155435;113763;55340;3361;83590;28959;64327;168544;136051;7988;10061;9690;55112;6604;285973;26157;55365;7434;285888;8427;54892;285971;10049;57488;54480;58508;65999;5799;474344;643641;8454;9601;155054;1020;6009;23145;2636;26047;2020;3638;100289678;653857;5919;51667;9311;2146;170575;6522;3757;4846;29803;64434;10922;202865;100527949;7516;155066;136371;155038,81
1,1,7,147042936,153530436,6487500,54480;27153;57541;84626;58508;65999;474344;643641;168537;8454;9601;155054;1020;26;11194;6009;155061;392843;57180;116988;23145;2636;26047;168391;100289678;653857;5919;51667;51422;9311;55303;349136;155051;113763;63917;55340;83590;28959;2146;170575;6522;3757;168544;29803;4846;136051;7988;10922;10061;202865;100527949;6604;285973;7516;155066;26157;55365;136371;8427;285971;155038,61
1,1,7,149261179,159075020,9813841,84626;140545;1804;168537;389602;26;22976;11194;392843;57180;6469;3110;116988;168391;51422;349136;55303;155051;63917;113763;155435;55340;83590;28959;3361;64327;168544;10061;9690;55112;6604;285973;26157;55365;7434;285888;54892;285971;10049;57488;54480;58508;65999;5799;474344;643641;1020;6009;23145;2636;2020;653857;3638;5919;51667;9311;170575;6522;3757;4846;29803;64434;10922;100527949;7516;155066;136371;155038,68
1,-1,7,149364045,149603148,239103,23145;643641;168544;84626;155066,5
1,-1,7,149561588,149572651,11063,643641;155066,2
1,-1,7,149561588,149576899,15311,643641;155066,2
1,-1,7,149561588,149576899,15311,643641;155066,2
-1,1,7,149957386,159118566,9161180,140545;1804;168537;389602;26;22976;11194;392843;57180;6469;3110;116988;168391;51422;349136;55303;155051;63917;113763;155435;55340;83590;28959;3361;64327;10061;9690;55112;6604;285973;26157;55365;7434;285888;54892;285971;10049;57488;54480;58508;65999;5799;474344;1020;6009;2636;2020;653857;3638;5919;51667;9311;170575;6522;3757;4846;29803;64434;10922;100527949;7516;136371;155038,63
-1,1,7,150183159,159128555,8945396,54480;58508;140545;5799;474344;1804;168537;1020;26;22976;11194;6009;392843;57180;6469;389602;3110;116988;2636;168391;2020;3638;51667;51422;9311;55303;349136;155051;63917;155435;55340;83590;28959;3361;170575;6522;64327;3757;4846;64434;10922;10061;9690;100527949;55112;6604;285973;7516;26157;55365;136371;7434;285888;54892;10049;57488,56
-1,1,7,150499889,159128556,8628667,54480;58508;140545;5799;1804;1020;26;22976;11194;6009;392843;57180;6469;389602;3110;116988;2636;168391;2020;3638;51667;51422;9311;349136;155051;63917;155435;83590;3361;64327;6522;3757;4846;64434;10922;10061;9690;55112;6604;285973;7516;7434;55365;136371;285888;54892;10049;57488,48
1,1,7,150801364,159118566,8317202,54480;58508;140545;5799;1804;389602;22976;6009;392843;57180;6469;3110;116988;2636;168391;2020;3638;51667;51422;349136;63917;155051;155435;3361;64327;64434;10061;9690;55112;6604;7516;7434;136371;285888;54892;10049;57488,37
-1,1,7,150911249,152884547,1973298,51667;51422;54480;349136;63917;155051;6604;6009;58508;7516;57180;168391;10061,13
-1,-1,7,151075965,158716453,7640488,51422;349136;63917;155051;155435;58508;140545;5799;3361;64327;1804;64434;10049;9690;389602;22976;55112;6009;57180;6469;3110;7516;54892;285888;168391;2020;3638;57488,28
-1,1,7,151167135,159119707,7952572,51422;155435;63917;58508;140545;5799;3361;64327;1804;64434;10049;9690;389602;22976;55112;6009;57180;6469;3110;7516;7434;54892;285888;168391;2020;3638;57488,27
1,1,7,151566053,159119707,7553654,51422;155435;63917;58508;140545;5799;3361;64327;1804;64434;10049;9690;389602;22976;55112;57180;6469;3110;7516;7434;54892;285888;168391;2020;3638;57488,26
1,1,7,152125937,159128555,7002618,155435;58508;140545;5799;3361;64327;1804;64434;10049;9690;389602;22976;55112;57180;6469;3110;7516;7434;285888;54892;2020;3638;57488,23
-1,1,7,152504290,159118566,6614276,155435;140545;5799;3361;64327;1804;64434;10049;9690;389602;22976;55112;57180;6469;3110;7434;285888;54892;2020;3638;57488,21
-1,1,7,152557661,159118566,6560905,155435;140545;5799;3361;64327;1804;64434;10049;9690;389602;22976;55112;6469;3110;7434;285888;54892;2020;3638;57488,20
1,-1,7,152848311,153316814,468503,,0
1,-1,7,152848311,153316814,468503,,0
-1,1,7,153007287,158090794,5083507,155435;140545;3361;64327;5799;1804;64434;10049;9690;389602;22976;6469;3110;285888;2020;3638,16
1,-1,7,153097168,153651508,554340,1804,1
1,-1,7,153097168,153670331,573163,1804,1
1,-1,7,153157388,153487263,329875,,0
1,-1,7,153487263,153651273,164010,1804,1
1,-1,7,153487263,153651273,164010,1804,1
1,-1,7,153578546,153721491,142945,1804,1
1,-1,7,153578546,153721491,142945,1804,1
1,-1,7,153578546,153823030,244484,1804,1
1,-1,7,153578546,153823030,244484,1804,1
-1,1,7,153605584,159118566,5512982,155435;140545;5799;3361;64327;1804;64434;10049;9690;389602;22976;55112;6469;3110;7434;285888;54892;2020;3638;57488,20
1,-1,7,153823030,153904470,81440,1804,1
-1,1,7,154731420,159118566,4387146,155435;140545;5799;3361;64327;64434;10049;9690;389602;22976;55112;6469;3110;7434;285888;54892;2020;3638;57488,19
-1,1,7,154731420,159118566,4387146,155435;140545;5799;3361;64327;64434;10049;9690;389602;22976;55112;6469;3110;7434;285888;54892;2020;3638;57488,19
-1,1,7,155054023,158909738,3855715,155435;140545;64327;5799;64434;10049;9690;389602;55112;6469;3110;7434;285888;54892;2020;3638;57488,17
-1,1,7,155293866,159118566,3824700,9690;155435;389602;55112;140545;6469;64327;3110;5799;7434;285888;64434;54892;10049;57488,15
-1,1,7,155367662,159128556,3760894,9690;155435;389602;55112;140545;6469;64327;3110;5799;7434;64434;54892;10049;57488,14
-1,1,7,155594374,156069411,475037,6469;389602,2
1,-1,7,155597511,155598135,624,6469,1
1,-1,7,155599758,155600358,600,6469,1
1,-1,7,155599758,155600358,600,6469,1
1,-1,7,155599758,155600358,600,6469,1
1,-1,7,155599758,155603986,4228,6469,1
1,1,7,156786858,156799542,12684,3110,1
-1,1,7,156821587,159128555,2306968,57488;9690;55112;54892;5799;7434;10049,7
1,1,7,157691388,159088636,1397248,55112;54892;5799;7434;57488,5
1,1,7,157691388,159088636,1397248,55112;54892;5799;7434;57488,5
-1,1,7,158430855,159119707,688852,54892;57488;7434;55112,4
1,-1,7,158464153,158920200,456047,54892;57488;7434;55112,4
1,-1,7,158651009,158928217,277208,7434;55112,2
1,-1,7,158850355,158935236,84881,7434,1
-1,-1,7,159046976,159058035,11059,,0
-1,-1,7,159049815,159057993,8178,,0
-1,-1,7,159049815,159057993,8178,,0
-1,-1,7,159049815,159058035,8220,,0
-1,-1,7,159049815,159058035,8220,,0
-1,-1,7,159049815,159058035,8220,,0
-1,-1,7,159049815,159058035,8220,,0
-1,-1,7,159049815,159058035,8220,,0
-1,-1,7,159049815,159058035,8220,,0
-1,-1,7,159049815,159058035,8220,,0
-1,-1,7,159049815,159058035,8220,,0
-1,-1,7,159049815,159058035,8220,,0
-1,-1,7,159089400,159125587,36187,,0
1,-1,7,159112702,159128555,15853,,0
-1,-1,7,159118528,159128555,10027,,0
-1,-1,7,159118528,159128555,10027,,0
-1,1,8,13938,6942280,6928342,389610;9172;441308;728358;1669;26260;1667;157697;64478;1671;9639;79648;1670;169270;285;157695;9228;55326;9920;1672;1668;2055,22
1,1,8,13938,146304022,146290084,377630;1508;1584;55806;51366;9166;137835;11156;767;137872;157724;137886;9070;4067;100289462;59339;4747;11059;862;6132;1135;79776;26233;10565;56704;65986;1936;51101;6101;23144;6591;116328;57509;79645;528;96764;81796;2515;613210;51125;22827;79698;7038;2738;10404;28998;157855;340441;79977;375686;389677;5462;23484;80005;6867;91147;65265;427;1191;55756;56892;79139;55872;4609;9420;54212;81551;157285;4986;138050;8629;84549;25960;64236;85002;51435;91694;137970;340359;137075;157697;4017;3646;9639;57094;5423;169270;169044;8793;4856;100130742;661;2039;7991;5168;5150;79845;29942;340371;203111;4715;23643;3620;761;203054;84988;55039;79848;8694;9530;392255;23414;81034;23221;157695;55790;5516;9920;85479;115111;51201;11212;80139;157657;26166;83482;83595;55284;286144;93594;653423;84675;619279;64089;5375;1673;2167;575;7553;7564;5324;23471;100130301;55656;54928;56169;245940;10499;649;2669;84232;10361;79752;8928;729330;4796;759;4061;29088;5569;10687;203100;7419;157769;79943;6674;79792;441381;526;80778;640;5862;432355;7264;8822;54714;56943;90362;203102;115908;116039;79870;84513;93100;26260;54793;389643;619373;245910;51669;9684;29967;4482;203074;114822;2137;55246;157777;27012;7994;28991;56154;79075;8836;79648;1670;50484;64168;645836;54968;92140;63898;81858;793;1585;85481;613209;646480;252969;389676;5157;23212;10987;94241;29028;148;23246;114926;5828;27085;5108;56260;100133267;10395;51571;286128;1052;64478;286046;79660;2222;29883;3174;55174;51001;28957;137392;54742;389649;9699;9796;90390;111188157;286077;203069;2675;137682;50626;286151;157680;54984;6575;389668;7163;9242;90459;23639;26281;8795;83877;137902;2831;11236;2339;23213;8797;23362;4824;8323;6503;8794;157773;11075;5885;84933;2171;63978;4603;79145;55909;80346;728358;389658;286133;727957;4325;100861412;91782;58500;55290;169355;10;401474;23514;7201;6921;157753;613211;55140;10221;9694;26986;3037;6713;113655;4147;79873;137814;55893;157378;66004;203190;100507341;114786;57604;8733;6917;54512;653333;94137;9791;51633;3297;64760;116447;83650;114569;504180;4683;84948;225689;286053;25879;286097;169200;492307;51059;2907;10434;23237;10671;245908;7976;25897;55093;642475;8754;1672;2875;3788;203062;83988;6482;4982;80728;51337;286075;2626;9650;9401;6156;55824;389690;286;8658;2267;414325;137868;90987;4481;11178;646486;138046;1669;203076;83648;23678;79618;57152;100533106;2260;340385;2961;51105;29894;100132396;6770;441376;64798;55636;1581;55529;100130274;105375787;140596;3551;6440;2936;2185;9108;1846;168975;79815;728957;100131608;10940;10584;6383;80243;85453;137735;9;65263;10947;157869;253943;3612;7486;55074;114907;157506;157848;642658;79666;100533105;157310;9312;55145;137994;340419;85444;137209;100127983;8895;57210;137492;23087;9172;503614;1807;4173;8439;286183;137797;23513;9788;51236;22882;8749;11160;414919;6129;2131;195814;10656;392197;138009;5591;389692;84955;9583;5747;23462;26873;6422;55894;80185;78986;27299;286148;10247;4741;64321;169166;50807;9046;1537;23039;25788;8840;245972;114;157638;157807;1671;9831;5327;51312;10407;2053;27257;8601;7381;8756;6788;7373;8767;8581;9705;2765;503618;155;27121;84197;9228;1960;6570;5179;340390;90990;654463;5533;137695;54704;541565;11244;645402;84294;2843;51050;83696;734;7227;51606;11030;9258;27067;4062;6224;2055;1875;389610;7071;25962;55638;6873;51123;7336;79581;1667;8000;83481;137964;114788;2138;84875;1142;312;54108;392188;64641;23516;92421;9134;1345;100132813;6781;5368;80124;9897;100133251;401466;4023;157567;1666;1015;84750;444;7013;157313;3786;54332;7993;503841;84985;1978;157574;54845;22898;100129654;7274;27161;55630;81790;245909;83690;338328;5520;10174;169026;55156;100131980;286187;340393;8667;55353;55124;66036;51582;3574;285;84296;5339;254778;51160;51110;4956;401447;115294;441308;10086;84376;6386;93035;4342;57805;2796;5440;1392;10863;157570;57623;665;81501;6641;9821;1668;284;347051;83940;23259;8973;51115;23303;760;3084;10397;137362;80223;377677;6542;27319;23167;51305;55326;9760;1808;7534;54904;8989,660
1,-1,8,16046,56814,40768,,0
1,-1,8,16046,73860,57814,,0
-1,-1,8,16046,73860,57814,,0
1,-1,8,20977,94623,73646,,0
1,-1,8,40247,56814,16567,,0
1,-1,8,40247,128199,87952,441308,1
1,-1,8,40247,145465,105218,441308,1
1,-1,8,87572,121006,33434,441308,1
-1,-1,8,87572,128199,40627,441308,1
1,-1,8,87572,128199,40627,441308,1
-1,1,8,158048,5474927,5316879,64478;9172;9639;169270;2055;157695;26260;9228;9920;157697,10
-1,1,8,158048,6004205,5846157,64478;9172;9639;169270;2055;157695;26260;9228;9920;157697,10
-1,1,8,158048,6460877,6302829,64478;9172;9639;79648;169270;285;2055;157695;26260;9228;9920;157697,12
-1,1,8,158048,6944233,6786185,389610;9172;728358;1669;26260;1667;157697;64478;1671;9639;79648;1670;169270;285;157695;9228;55326;9920;1672;1668;2055,21
-1,1,8,158048,6944774,6786726,389610;9172;728358;1669;26260;1667;157697;64478;1671;9639;79648;1670;169270;285;157695;9228;55326;9920;1672;1668;2055,21
-1,1,8,158048,6981988,6823940,389610;9172;728358;1669;26260;1667;157697;64478;1671;9639;79648;1670;169270;285;157695;9228;55326;9920;1672;1668;2055,21
-1,1,8,158048,6982980,6824932,389610;9172;728358;1669;26260;1667;157697;64478;1671;9639;79648;1670;169270;285;157695;9228;55326;9920;1672;1668;2055,21
-1,1,8,158048,6999114,6841066,389610;9172;728358;1669;26260;1667;157697;64478;1671;9639;79648;1670;169270;285;157695;9228;55326;9920;1672;1668;2055,21
-1,1,8,158048,6999114,6841066,389610;9172;728358;1669;26260;1667;157697;64478;1671;9639;79648;1670;169270;285;157695;9228;55326;9920;1672;1668;2055,21
-1,1,8,158048,6999114,6841066,389610;9172;728358;1669;26260;1667;157697;64478;1671;9639;79648;1670;169270;285;157695;9228;55326;9920;1672;1668;2055,21
-1,1,8,158048,6999114,6841066,389610;9172;728358;1669;26260;1667;157697;64478;1671;9639;79648;1670;169270;285;157695;9228;55326;9920;1672;1668;2055,21
-1,1,8,158048,6999114,6841066,389610;9172;728358;1669;26260;1667;157697;64478;1671;9639;79648;1670;169270;285;157695;9228;55326;9920;1672;1668;2055,21
-1,1,8,158048,6999114,6841066,389610;9172;728358;1669;26260;1667;157697;64478;1671;9639;79648;1670;169270;285;157695;9228;55326;9920;1672;1668;2055,21
-1,1,8,158048,6999114,6841066,389610;9172;728358;1669;26260;1667;157697;64478;1671;9639;79648;1670;169270;285;157695;9228;55326;9920;1672;1668;2055,21
1,1,8,158048,7044046,6885998,389610;9172;728358;1669;26260;1667;157697;64478;1671;9639;79648;1670;169270;285;157695;9228;55326;9920;1672;1668;2055,21
-1,1,8,158048,7044046,6885998,389610;9172;728358;1669;26260;1667;157697;64478;1671;9639;79648;1670;169270;285;157695;9228;55326;9920;1672;1668;2055,21
-1,1,8,158048,9749574,9591526,389610;401447;728358;503841;1669;504180;26260;55894;1667;245910;157285;245908;100132396;503618;392188;157695;100289462;9228;245909;90459;9920;1672;1668;9172;503614;140596;100133251;653423;645402;100131980;137075;157697;1673;64478;1671;9639;100131608;79648;1670;169270;285;79660;8658;9258;414325;55326;10407;645836;2055,49
1,1,8,158048,30262760,30104712,377630;1508;83650;2053;55806;504180;8756;26260;54793;286097;389643;619373;245910;10671;245908;51669;503618;100289462;4482;7976;203074;4747;9228;1960;6570;1135;55246;1672;2137;5533;541565;51312;57509;645402;2626;613210;79648;1670;11030;8658;9258;2267;414325;137868;645836;4481;2055;11178;389610;80005;23484;63898;1669;203076;427;1191;83648;55756;55872;79618;1667;613209;81551;157285;252969;100132396;392188;5157;64641;23516;148;5108;6781;5368;64236;140596;100133267;10395;100133251;85002;51435;6440;91694;2185;9108;4023;137075;157697;1846;4017;64478;728957;9639;100131608;169270;79660;286046;2222;8793;29883;661;2039;55174;7991;157313;9;503841;157574;9796;1808;203069;2675;157310;54984;23221;157695;55790;245909;90459;9920;5520;26281;137492;23087;10174;9172;51201;8795;503614;83595;653423;100131980;55124;23362;8797;1673;4824;66036;8794;285;157773;401447;392197;55909;80346;9583;728358;245940;286133;649;55894;10361;57805;91782;2796;10;27299;10863;613211;10687;157570;55140;665;4741;9046;1668;23039;79873;137814;55893;23303;526;203190;57604;1671;640;6542;8822;653333;55326;94137;10407;64760,183
1,1,8,158048,43786723,43628675,377630;203102;1508;83650;2053;27257;55806;504180;8756;84513;26260;54793;286097;389643;619373;245910;10671;245908;51669;503618;155;9070;100289462;4482;7976;203074;4747;59339;9228;1960;6570;1135;55246;1672;2137;8754;84197;5533;541565;51312;57509;645402;2626;2515;7994;613210;51125;56154;79698;79648;1670;157855;286;11030;340441;8658;9258;2267;414325;137868;645836;4481;2055;11178;389610;80005;23484;6867;63898;1669;203076;427;1191;83648;55756;56892;55872;79618;1667;2260;613209;81551;137964;157285;2961;252969;1142;100132396;6770;392188;5157;64641;138050;23516;148;84549;114926;5108;6781;5368;64236;25960;140596;100133267;10395;3551;100133251;85002;51435;6440;2936;91694;2185;9108;137970;4023;137075;157697;1846;4017;64478;728957;9639;100131608;27121;5423;169270;79660;286046;2222;8793;29883;84750;661;2039;55174;7991;157313;9;79845;29942;10947;7993;503841;389649;3620;1978;157574;9796;7486;1808;9530;203069;2675;157848;157310;54984;23221;157695;137994;6575;55145;55790;245909;81790;90459;5516;9920;5520;26281;137492;23087;10174;9172;51201;8795;11212;80139;503614;83877;83595;653423;100131980;2339;55124;23362;8797;1673;4824;66036;8794;285;84296;157773;8749;11160;401447;392197;55909;80346;9583;728358;245940;286133;84376;6422;649;55894;10361;57805;91782;2796;55290;169355;80185;10;78986;27299;10863;613211;10687;157570;55140;203100;665;4741;7419;9046;1668;23039;23259;8973;79873;137814;55893;23303;526;203190;100507341;57604;1671;3084;640;137362;80223;6542;5327;8822;653333;55326;94137;10407;54904;64760,254
1,1,8,158048,146295771,146137723,377630;1508;1584;55806;51366;9166;137835;11156;767;137872;157724;137886;9070;4067;100289462;59339;4747;11059;862;6132;1135;79776;26233;10565;56704;65986;1936;51101;6101;23144;6591;116328;57509;79645;528;96764;81796;2515;613210;51125;22827;79698;7038;2738;10404;28998;157855;340441;79977;375686;389677;5462;23484;80005;6867;91147;65265;427;1191;55756;56892;79139;55872;4609;9420;54212;81551;157285;4986;138050;8629;84549;25960;64236;85002;51435;91694;137970;340359;137075;157697;4017;3646;9639;57094;5423;169270;169044;8793;4856;100130742;661;2039;7991;5168;5150;79845;29942;340371;203111;4715;23643;3620;761;203054;84988;55039;79848;8694;9530;392255;23414;81034;23221;157695;55790;5516;9920;85479;115111;51201;11212;80139;157657;26166;83482;83595;55284;286144;93594;653423;84675;619279;64089;5375;1673;2167;575;7553;7564;5324;23471;100130301;55656;54928;56169;245940;10499;649;2669;84232;10361;79752;8928;729330;4796;759;4061;29088;5569;10687;203100;7419;157769;79943;6674;79792;441381;526;80778;640;5862;432355;7264;8822;54714;56943;90362;203102;115908;116039;79870;84513;93100;26260;54793;389643;619373;245910;51669;9684;29967;4482;203074;114822;2137;55246;157777;27012;7994;28991;56154;79075;8836;79648;1670;50484;64168;645836;54968;92140;63898;81858;793;1585;85481;613209;646480;252969;389676;5157;23212;10987;94241;29028;148;23246;114926;5828;27085;5108;56260;100133267;10395;51571;286128;1052;64478;286046;79660;2222;29883;3174;55174;51001;28957;137392;54742;389649;9699;9796;90390;111188157;286077;203069;2675;137682;50626;286151;157680;54984;6575;389668;7163;9242;90459;23639;26281;8795;83877;137902;2831;11236;2339;23213;8797;23362;4824;8323;6503;8794;157773;11075;5885;84933;2171;63978;4603;79145;55909;80346;728358;389658;286133;727957;4325;100861412;91782;58500;55290;169355;10;401474;23514;7201;6921;157753;613211;55140;10221;9694;26986;3037;6713;113655;4147;79873;137814;55893;157378;66004;203190;100507341;114786;57604;8733;6917;54512;653333;94137;9791;51633;3297;64760;116447;83650;114569;504180;4683;84948;225689;286053;25879;286097;169200;492307;51059;2907;10434;23237;10671;245908;7976;25897;55093;642475;8754;1672;2875;3788;203062;83988;6482;4982;80728;51337;286075;2626;9650;9401;6156;55824;389690;286;8658;2267;414325;137868;90987;4481;11178;646486;138046;1669;203076;83648;23678;79618;57152;100533106;2260;340385;2961;51105;29894;100132396;6770;441376;64798;55636;1581;55529;100130274;105375787;140596;3551;6440;2936;2185;9108;1846;168975;79815;728957;100131608;10940;10584;6383;80243;85453;137735;9;65263;10947;157869;253943;3612;7486;55074;114907;157506;157848;642658;79666;100533105;157310;9312;55145;137994;340419;85444;137209;100127983;8895;57210;137492;23087;9172;503614;1807;4173;8439;286183;137797;23513;9788;51236;22882;8749;11160;414919;6129;2131;195814;10656;392197;138009;5591;389692;84955;9583;5747;23462;26873;6422;55894;80185;78986;27299;286148;10247;4741;64321;169166;50807;9046;1537;23039;25788;8840;245972;114;157638;157807;1671;9831;5327;51312;10407;2053;27257;8601;7381;8756;6788;7373;8767;8581;9705;2765;503618;155;27121;84197;9228;1960;6570;5179;340390;90990;654463;5533;137695;54704;541565;11244;645402;84294;2843;51050;83696;734;7227;51606;11030;9258;27067;4062;6224;2055;1875;389610;7071;25962;55638;6873;51123;7336;79581;1667;8000;83481;137964;114788;2138;84875;1142;312;54108;392188;64641;23516;92421;9134;1345;100132813;6781;5368;80124;9897;100133251;401466;4023;157567;1666;1015;84750;444;7013;157313;3786;54332;7993;503841;84985;1978;157574;54845;22898;100129654;7274;27161;55630;81790;245909;83690;338328;5520;10174;169026;55156;100131980;286187;340393;8667;55353;55124;66036;51582;3574;285;84296;5339;254778;51160;51110;4956;401447;115294;10086;84376;6386;93035;4342;57805;2796;5440;1392;10863;157570;57623;665;81501;6641;9821;1668;284;347051;83940;23259;8973;51115;23303;760;3084;10397;137362;80223;377677;6542;27319;23167;51305;55326;9760;1808;7534;54904;8989,659
1,1,8,158049,146295771,146137722,377630;1508;1584;55806;51366;9166;137835;11156;767;137872;157724;137886;9070;4067;100289462;59339;4747;11059;862;6132;1135;79776;26233;10565;56704;65986;1936;51101;6101;23144;6591;116328;57509;79645;528;96764;81796;2515;613210;51125;22827;79698;7038;2738;10404;28998;157855;340441;79977;375686;389677;5462;23484;80005;6867;91147;65265;427;1191;55756;56892;79139;55872;4609;9420;54212;81551;157285;4986;138050;8629;84549;25960;64236;85002;51435;91694;137970;340359;137075;157697;4017;3646;9639;57094;5423;169270;169044;8793;4856;100130742;661;2039;7991;5168;5150;79845;29942;340371;203111;4715;23643;3620;761;203054;84988;55039;79848;8694;9530;392255;23414;81034;23221;157695;55790;5516;9920;85479;115111;51201;11212;80139;157657;26166;83482;83595;55284;286144;93594;653423;84675;619279;64089;5375;1673;2167;575;7553;7564;5324;23471;100130301;55656;54928;56169;245940;10499;649;2669;84232;10361;79752;8928;729330;4796;759;4061;29088;5569;10687;203100;7419;157769;79943;6674;79792;441381;526;80778;640;5862;432355;7264;8822;54714;56943;90362;203102;115908;116039;79870;84513;93100;26260;54793;389643;619373;245910;51669;9684;29967;4482;203074;114822;2137;55246;157777;27012;7994;28991;56154;79075;8836;79648;1670;50484;64168;645836;54968;92140;63898;81858;793;1585;85481;613209;646480;252969;389676;5157;23212;10987;94241;29028;148;23246;114926;5828;27085;5108;56260;100133267;10395;51571;286128;1052;64478;286046;79660;2222;29883;3174;55174;51001;28957;137392;54742;389649;9699;9796;90390;111188157;286077;203069;2675;137682;50626;286151;157680;54984;6575;389668;7163;9242;90459;23639;26281;8795;83877;137902;2831;11236;2339;23213;8797;23362;4824;8323;6503;8794;157773;11075;5885;84933;2171;63978;4603;79145;55909;80346;728358;389658;286133;727957;4325;100861412;91782;58500;55290;169355;10;401474;23514;7201;6921;157753;613211;55140;10221;9694;26986;3037;6713;113655;4147;79873;137814;55893;157378;66004;203190;100507341;114786;57604;8733;6917;54512;653333;94137;9791;51633;3297;64760;116447;83650;114569;504180;4683;84948;225689;286053;25879;286097;169200;492307;51059;2907;10434;23237;10671;245908;7976;25897;55093;642475;8754;1672;2875;3788;203062;83988;6482;4982;80728;51337;286075;2626;9650;9401;6156;55824;389690;286;8658;2267;414325;137868;90987;4481;11178;646486;138046;1669;203076;83648;23678;79618;57152;100533106;2260;340385;2961;51105;29894;100132396;6770;441376;64798;55636;1581;55529;100130274;105375787;140596;3551;6440;2936;2185;9108;1846;168975;79815;728957;100131608;10940;10584;6383;80243;85453;137735;9;65263;10947;157869;253943;3612;7486;55074;114907;157506;157848;642658;79666;100533105;157310;9312;55145;137994;340419;85444;137209;100127983;8895;57210;137492;23087;9172;503614;1807;4173;8439;286183;137797;23513;9788;51236;22882;8749;11160;414919;6129;2131;195814;10656;392197;138009;5591;389692;84955;9583;5747;23462;26873;6422;55894;80185;78986;27299;286148;10247;4741;64321;169166;50807;9046;1537;23039;25788;8840;245972;114;157638;157807;1671;9831;5327;51312;10407;2053;27257;8601;7381;8756;6788;7373;8767;8581;9705;2765;503618;155;27121;84197;9228;1960;6570;5179;340390;90990;654463;5533;137695;54704;541565;11244;645402;84294;2843;51050;83696;734;7227;51606;11030;9258;27067;4062;6224;2055;1875;389610;7071;25962;55638;6873;51123;7336;79581;1667;8000;83481;137964;114788;2138;84875;1142;312;54108;392188;64641;23516;92421;9134;1345;100132813;6781;5368;80124;9897;100133251;401466;4023;157567;1666;1015;84750;444;7013;157313;3786;54332;7993;503841;84985;1978;157574;54845;22898;100129654;7274;27161;55630;81790;245909;83690;338328;5520;10174;169026;55156;100131980;286187;340393;8667;55353;55124;66036;51582;3574;285;84296;5339;254778;51160;51110;4956;401447;115294;10086;84376;6386;93035;4342;57805;2796;5440;1392;10863;157570;57623;665;81501;6641;9821;1668;284;347051;83940;23259;8973;51115;23303;760;3084;10397;137362;80223;377677;6542;27319;23167;51305;55326;9760;1808;7534;54904;8989,659
1,1,8,158049,146295771,146137722,377630;1508;1584;55806;51366;9166;137835;11156;767;137872;157724;137886;9070;4067;100289462;59339;4747;11059;862;6132;1135;79776;26233;10565;56704;65986;1936;51101;6101;23144;6591;116328;57509;79645;528;96764;81796;2515;613210;51125;22827;79698;7038;2738;10404;28998;157855;340441;79977;375686;389677;5462;23484;80005;6867;91147;65265;427;1191;55756;56892;79139;55872;4609;9420;54212;81551;157285;4986;138050;8629;84549;25960;64236;85002;51435;91694;137970;340359;137075;157697;4017;3646;9639;57094;5423;169270;169044;8793;4856;100130742;661;2039;7991;5168;5150;79845;29942;340371;203111;4715;23643;3620;761;203054;84988;55039;79848;8694;9530;392255;23414;81034;23221;157695;55790;5516;9920;85479;115111;51201;11212;80139;157657;26166;83482;83595;55284;286144;93594;653423;84675;619279;64089;5375;1673;2167;575;7553;7564;5324;23471;100130301;55656;54928;56169;245940;10499;649;2669;84232;10361;79752;8928;729330;4796;759;4061;29088;5569;10687;203100;7419;157769;79943;6674;79792;441381;526;80778;640;5862;432355;7264;8822;54714;56943;90362;203102;115908;116039;79870;84513;93100;26260;54793;389643;619373;245910;51669;9684;29967;4482;203074;114822;2137;55246;157777;27012;7994;28991;56154;79075;8836;79648;1670;50484;64168;645836;54968;92140;63898;81858;793;1585;85481;613209;646480;252969;389676;5157;23212;10987;94241;29028;148;23246;114926;5828;27085;5108;56260;100133267;10395;51571;286128;1052;64478;286046;79660;2222;29883;3174;55174;51001;28957;137392;54742;389649;9699;9796;90390;111188157;286077;203069;2675;137682;50626;286151;157680;54984;6575;389668;7163;9242;90459;23639;26281;8795;83877;137902;2831;11236;2339;23213;8797;23362;4824;8323;6503;8794;157773;11075;5885;84933;2171;63978;4603;79145;55909;80346;728358;389658;286133;727957;4325;100861412;91782;58500;55290;169355;10;401474;23514;7201;6921;157753;613211;55140;10221;9694;26986;3037;6713;113655;4147;79873;137814;55893;157378;66004;203190;100507341;114786;57604;8733;6917;54512;653333;94137;9791;51633;3297;64760;116447;83650;114569;504180;4683;84948;225689;286053;25879;286097;169200;492307;51059;2907;10434;23237;10671;245908;7976;25897;55093;642475;8754;1672;2875;3788;203062;83988;6482;4982;80728;51337;286075;2626;9650;9401;6156;55824;389690;286;8658;2267;414325;137868;90987;4481;11178;646486;138046;1669;203076;83648;23678;79618;57152;100533106;2260;340385;2961;51105;29894;100132396;6770;441376;64798;55636;1581;55529;100130274;105375787;140596;3551;6440;2936;2185;9108;1846;168975;79815;728957;100131608;10940;10584;6383;80243;85453;137735;9;65263;10947;157869;253943;3612;7486;55074;114907;157506;157848;642658;79666;100533105;157310;9312;55145;137994;340419;85444;137209;100127983;8895;57210;137492;23087;9172;503614;1807;4173;8439;286183;137797;23513;9788;51236;22882;8749;11160;414919;6129;2131;195814;10656;392197;138009;5591;389692;84955;9583;5747;23462;26873;6422;55894;80185;78986;27299;286148;10247;4741;64321;169166;50807;9046;1537;23039;25788;8840;245972;114;157638;157807;1671;9831;5327;51312;10407;2053;27257;8601;7381;8756;6788;7373;8767;8581;9705;2765;503618;155;27121;84197;9228;1960;6570;5179;340390;90990;654463;5533;137695;54704;541565;11244;645402;84294;2843;51050;83696;734;7227;51606;11030;9258;27067;4062;6224;2055;1875;389610;7071;25962;55638;6873;51123;7336;79581;1667;8000;83481;137964;114788;2138;84875;1142;312;54108;392188;64641;23516;92421;9134;1345;100132813;6781;5368;80124;9897;100133251;401466;4023;157567;1666;1015;84750;444;7013;157313;3786;54332;7993;503841;84985;1978;157574;54845;22898;100129654;7274;27161;55630;81790;245909;83690;338328;5520;10174;169026;55156;100131980;286187;340393;8667;55353;55124;66036;51582;3574;285;84296;5339;254778;51160;51110;4956;401447;115294;10086;84376;6386;93035;4342;57805;2796;5440;1392;10863;157570;57623;665;81501;6641;9821;1668;284;347051;83940;23259;8973;51115;23303;760;3084;10397;137362;80223;377677;6542;27319;23167;51305;55326;9760;1808;7534;54904;8989,659
1,1,8,158049,146295771,146137722,377630;1508;1584;55806;51366;9166;137835;11156;767;137872;157724;137886;9070;4067;100289462;59339;4747;11059;862;6132;1135;79776;26233;10565;56704;65986;1936;51101;6101;23144;6591;116328;57509;79645;528;96764;81796;2515;613210;51125;22827;79698;7038;2738;10404;28998;157855;340441;79977;375686;389677;5462;23484;80005;6867;91147;65265;427;1191;55756;56892;79139;55872;4609;9420;54212;81551;157285;4986;138050;8629;84549;25960;64236;85002;51435;91694;137970;340359;137075;157697;4017;3646;9639;57094;5423;169270;169044;8793;4856;100130742;661;2039;7991;5168;5150;79845;29942;340371;203111;4715;23643;3620;761;203054;84988;55039;79848;8694;9530;392255;23414;81034;23221;157695;55790;5516;9920;85479;115111;51201;11212;80139;157657;26166;83482;83595;55284;286144;93594;653423;84675;619279;64089;5375;1673;2167;575;7553;7564;5324;23471;100130301;55656;54928;56169;245940;10499;649;2669;84232;10361;79752;8928;729330;4796;759;4061;29088;5569;10687;203100;7419;157769;79943;6674;79792;441381;526;80778;640;5862;432355;7264;8822;54714;56943;90362;203102;115908;116039;79870;84513;93100;26260;54793;389643;619373;245910;51669;9684;29967;4482;203074;114822;2137;55246;157777;27012;7994;28991;56154;79075;8836;79648;1670;50484;64168;645836;54968;92140;63898;81858;793;1585;85481;613209;646480;252969;389676;5157;23212;10987;94241;29028;148;23246;114926;5828;27085;5108;56260;100133267;10395;51571;286128;1052;64478;286046;79660;2222;29883;3174;55174;51001;28957;137392;54742;389649;9699;9796;90390;111188157;286077;203069;2675;137682;50626;286151;157680;54984;6575;389668;7163;9242;90459;23639;26281;8795;83877;137902;2831;11236;2339;23213;8797;23362;4824;8323;6503;8794;157773;11075;5885;84933;2171;63978;4603;79145;55909;80346;728358;389658;286133;727957;4325;100861412;91782;58500;55290;169355;10;401474;23514;7201;6921;157753;613211;55140;10221;9694;26986;3037;6713;113655;4147;79873;137814;55893;157378;66004;203190;100507341;114786;57604;8733;6917;54512;653333;94137;9791;51633;3297;64760;116447;83650;114569;504180;4683;84948;225689;286053;25879;286097;169200;492307;51059;2907;10434;23237;10671;245908;7976;25897;55093;642475;8754;1672;2875;3788;203062;83988;6482;4982;80728;51337;286075;2626;9650;9401;6156;55824;389690;286;8658;2267;414325;137868;90987;4481;11178;646486;138046;1669;203076;83648;23678;79618;57152;100533106;2260;340385;2961;51105;29894;100132396;6770;441376;64798;55636;1581;55529;100130274;105375787;140596;3551;6440;2936;2185;9108;1846;168975;79815;728957;100131608;10940;10584;6383;80243;85453;137735;9;65263;10947;157869;253943;3612;7486;55074;114907;157506;157848;642658;79666;100533105;157310;9312;55145;137994;340419;85444;137209;100127983;8895;57210;137492;23087;9172;503614;1807;4173;8439;286183;137797;23513;9788;51236;22882;8749;11160;414919;6129;2131;195814;10656;392197;138009;5591;389692;84955;9583;5747;23462;26873;6422;55894;80185;78986;27299;286148;10247;4741;64321;169166;50807;9046;1537;23039;25788;8840;245972;114;157638;157807;1671;9831;5327;51312;10407;2053;27257;8601;7381;8756;6788;7373;8767;8581;9705;2765;503618;155;27121;84197;9228;1960;6570;5179;340390;90990;654463;5533;137695;54704;541565;11244;645402;84294;2843;51050;83696;734;7227;51606;11030;9258;27067;4062;6224;2055;1875;389610;7071;25962;55638;6873;51123;7336;79581;1667;8000;83481;137964;114788;2138;84875;1142;312;54108;392188;64641;23516;92421;9134;1345;100132813;6781;5368;80124;9897;100133251;401466;4023;157567;1666;1015;84750;444;7013;157313;3786;54332;7993;503841;84985;1978;157574;54845;22898;100129654;7274;27161;55630;81790;245909;83690;338328;5520;10174;169026;55156;100131980;286187;340393;8667;55353;55124;66036;51582;3574;285;84296;5339;254778;51160;51110;4956;401447;115294;10086;84376;6386;93035;4342;57805;2796;5440;1392;10863;157570;57623;665;81501;6641;9821;1668;284;347051;83940;23259;8973;51115;23303;760;3084;10397;137362;80223;377677;6542;27319;23167;51305;55326;9760;1808;7534;54904;8989,659
1,1,8,158049,146295771,146137722,377630;1508;1584;55806;51366;9166;137835;11156;767;137872;157724;137886;9070;4067;100289462;59339;4747;11059;862;6132;1135;79776;26233;10565;56704;65986;1936;51101;6101;23144;6591;116328;57509;79645;528;96764;81796;2515;613210;51125;22827;79698;7038;2738;10404;28998;157855;340441;79977;375686;389677;5462;23484;80005;6867;91147;65265;427;1191;55756;56892;79139;55872;4609;9420;54212;81551;157285;4986;138050;8629;84549;25960;64236;85002;51435;91694;137970;340359;137075;157697;4017;3646;9639;57094;5423;169270;169044;8793;4856;100130742;661;2039;7991;5168;5150;79845;29942;340371;203111;4715;23643;3620;761;203054;84988;55039;79848;8694;9530;392255;23414;81034;23221;157695;55790;5516;9920;85479;115111;51201;11212;80139;157657;26166;83482;83595;55284;286144;93594;653423;84675;619279;64089;5375;1673;2167;575;7553;7564;5324;23471;100130301;55656;54928;56169;245940;10499;649;2669;84232;10361;79752;8928;729330;4796;759;4061;29088;5569;10687;203100;7419;157769;79943;6674;79792;441381;526;80778;640;5862;432355;7264;8822;54714;56943;90362;203102;115908;116039;79870;84513;93100;26260;54793;389643;619373;245910;51669;9684;29967;4482;203074;114822;2137;55246;157777;27012;7994;28991;56154;79075;8836;79648;1670;50484;64168;645836;54968;92140;63898;81858;793;1585;85481;613209;646480;252969;389676;5157;23212;10987;94241;29028;148;23246;114926;5828;27085;5108;56260;100133267;10395;51571;286128;1052;64478;286046;79660;2222;29883;3174;55174;51001;28957;137392;54742;389649;9699;9796;90390;111188157;286077;203069;2675;137682;50626;286151;157680;54984;6575;389668;7163;9242;90459;23639;26281;8795;83877;137902;2831;11236;2339;23213;8797;23362;4824;8323;6503;8794;157773;11075;5885;84933;2171;63978;4603;79145;55909;80346;728358;389658;286133;727957;4325;100861412;91782;58500;55290;169355;10;401474;23514;7201;6921;157753;613211;55140;10221;9694;26986;3037;6713;113655;4147;79873;137814;55893;157378;66004;203190;100507341;114786;57604;8733;6917;54512;653333;94137;9791;51633;3297;64760;116447;83650;114569;504180;4683;84948;225689;286053;25879;286097;169200;492307;51059;2907;10434;23237;10671;245908;7976;25897;55093;642475;8754;1672;2875;3788;203062;83988;6482;4982;80728;51337;286075;2626;9650;9401;6156;55824;389690;286;8658;2267;414325;137868;90987;4481;11178;646486;138046;1669;203076;83648;23678;79618;57152;100533106;2260;340385;2961;51105;29894;100132396;6770;441376;64798;55636;1581;55529;100130274;105375787;140596;3551;6440;2936;2185;9108;1846;168975;79815;728957;100131608;10940;10584;6383;80243;85453;137735;9;65263;10947;157869;253943;3612;7486;55074;114907;157506;157848;642658;79666;100533105;157310;9312;55145;137994;340419;85444;137209;100127983;8895;57210;137492;23087;9172;503614;1807;4173;8439;286183;137797;23513;9788;51236;22882;8749;11160;414919;6129;2131;195814;10656;392197;138009;5591;389692;84955;9583;5747;23462;26873;6422;55894;80185;78986;27299;286148;10247;4741;64321;169166;50807;9046;1537;23039;25788;8840;245972;114;157638;157807;1671;9831;5327;51312;10407;2053;27257;8601;7381;8756;6788;7373;8767;8581;9705;2765;503618;155;27121;84197;9228;1960;6570;5179;340390;90990;654463;5533;137695;54704;541565;11244;645402;84294;2843;51050;83696;734;7227;51606;11030;9258;27067;4062;6224;2055;1875;389610;7071;25962;55638;6873;51123;7336;79581;1667;8000;83481;137964;114788;2138;84875;1142;312;54108;392188;64641;23516;92421;9134;1345;100132813;6781;5368;80124;9897;100133251;401466;4023;157567;1666;1015;84750;444;7013;157313;3786;54332;7993;503841;84985;1978;157574;54845;22898;100129654;7274;27161;55630;81790;245909;83690;338328;5520;10174;169026;55156;100131980;286187;340393;8667;55353;55124;66036;51582;3574;285;84296;5339;254778;51160;51110;4956;401447;115294;10086;84376;6386;93035;4342;57805;2796;5440;1392;10863;157570;57623;665;81501;6641;9821;1668;284;347051;83940;23259;8973;51115;23303;760;3084;10397;137362;80223;377677;6542;27319;23167;51305;55326;9760;1808;7534;54904;8989,659
1,1,8,158049,146295771,146137722,377630;1508;1584;55806;51366;9166;137835;11156;767;137872;157724;137886;9070;4067;100289462;59339;4747;11059;862;6132;1135;79776;26233;10565;56704;65986;1936;51101;6101;23144;6591;116328;57509;79645;528;96764;81796;2515;613210;51125;22827;79698;7038;2738;10404;28998;157855;340441;79977;375686;389677;5462;23484;80005;6867;91147;65265;427;1191;55756;56892;79139;55872;4609;9420;54212;81551;157285;4986;138050;8629;84549;25960;64236;85002;51435;91694;137970;340359;137075;157697;4017;3646;9639;57094;5423;169270;169044;8793;4856;100130742;661;2039;7991;5168;5150;79845;29942;340371;203111;4715;23643;3620;761;203054;84988;55039;79848;8694;9530;392255;23414;81034;23221;157695;55790;5516;9920;85479;115111;51201;11212;80139;157657;26166;83482;83595;55284;286144;93594;653423;84675;619279;64089;5375;1673;2167;575;7553;7564;5324;23471;100130301;55656;54928;56169;245940;10499;649;2669;84232;10361;79752;8928;729330;4796;759;4061;29088;5569;10687;203100;7419;157769;79943;6674;79792;441381;526;80778;640;5862;432355;7264;8822;54714;56943;90362;203102;115908;116039;79870;84513;93100;26260;54793;389643;619373;245910;51669;9684;29967;4482;203074;114822;2137;55246;157777;27012;7994;28991;56154;79075;8836;79648;1670;50484;64168;645836;54968;92140;63898;81858;793;1585;85481;613209;646480;252969;389676;5157;23212;10987;94241;29028;148;23246;114926;5828;27085;5108;56260;100133267;10395;51571;286128;1052;64478;286046;79660;2222;29883;3174;55174;51001;28957;137392;54742;389649;9699;9796;90390;111188157;286077;203069;2675;137682;50626;286151;157680;54984;6575;389668;7163;9242;90459;23639;26281;8795;83877;137902;2831;11236;2339;23213;8797;23362;4824;8323;6503;8794;157773;11075;5885;84933;2171;63978;4603;79145;55909;80346;728358;389658;286133;727957;4325;100861412;91782;58500;55290;169355;10;401474;23514;7201;6921;157753;613211;55140;10221;9694;26986;3037;6713;113655;4147;79873;137814;55893;157378;66004;203190;100507341;114786;57604;8733;6917;54512;653333;94137;9791;51633;3297;64760;116447;83650;114569;504180;4683;84948;225689;286053;25879;286097;169200;492307;51059;2907;10434;23237;10671;245908;7976;25897;55093;642475;8754;1672;2875;3788;203062;83988;6482;4982;80728;51337;286075;2626;9650;9401;6156;55824;389690;286;8658;2267;414325;137868;90987;4481;11178;646486;138046;1669;203076;83648;23678;79618;57152;100533106;2260;340385;2961;51105;29894;100132396;6770;441376;64798;55636;1581;55529;100130274;105375787;140596;3551;6440;2936;2185;9108;1846;168975;79815;728957;100131608;10940;10584;6383;80243;85453;137735;9;65263;10947;157869;253943;3612;7486;55074;114907;157506;157848;642658;79666;100533105;157310;9312;55145;137994;340419;85444;137209;100127983;8895;57210;137492;23087;9172;503614;1807;4173;8439;286183;137797;23513;9788;51236;22882;8749;11160;414919;6129;2131;195814;10656;392197;138009;5591;389692;84955;9583;5747;23462;26873;6422;55894;80185;78986;27299;286148;10247;4741;64321;169166;50807;9046;1537;23039;25788;8840;245972;114;157638;157807;1671;9831;5327;51312;10407;2053;27257;8601;7381;8756;6788;7373;8767;8581;9705;2765;503618;155;27121;84197;9228;1960;6570;5179;340390;90990;654463;5533;137695;54704;541565;11244;645402;84294;2843;51050;83696;734;7227;51606;11030;9258;27067;4062;6224;2055;1875;389610;7071;25962;55638;6873;51123;7336;79581;1667;8000;83481;137964;114788;2138;84875;1142;312;54108;392188;64641;23516;92421;9134;1345;100132813;6781;5368;80124;9897;100133251;401466;4023;157567;1666;1015;84750;444;7013;157313;3786;54332;7993;503841;84985;1978;157574;54845;22898;100129654;7274;27161;55630;81790;245909;83690;338328;5520;10174;169026;55156;100131980;286187;340393;8667;55353;55124;66036;51582;3574;285;84296;5339;254778;51160;51110;4956;401447;115294;10086;84376;6386;93035;4342;57805;2796;5440;1392;10863;157570;57623;665;81501;6641;9821;1668;284;347051;83940;23259;8973;51115;23303;760;3084;10397;137362;80223;377677;6542;27319;23167;51305;55326;9760;1808;7534;54904;8989,659
1,1,8,158991,17536147,17377156,377630;1508;83650;504180;503841;10407;26260;286097;245910;245908;503618;54984;100289462;4482;157695;203074;9228;245909;90459;9920;1672;26281;137492;9172;51201;503614;83595;57509;653423;645402;2626;100131980;613210;1673;79648;1670;66036;285;157773;8658;9258;414325;137868;645836;4481;2055;389610;401447;392197;728358;1669;245940;203076;83648;55894;1667;613209;157285;252969;100132396;392188;5157;613211;1668;140596;100133267;10395;100133251;85002;91694;9108;137075;157697;57604;64478;728957;9639;100131608;1671;640;169270;79660;286046;2222;29883;6542;653333;7991;55326;94137,90
1,1,8,158991,146280828,146121837,377630;1508;1584;55806;51366;9166;137835;11156;767;137872;157724;137886;9070;4067;100289462;59339;4747;11059;862;6132;1135;79776;26233;10565;56704;65986;1936;51101;6101;23144;6591;116328;57509;79645;528;96764;81796;2515;613210;51125;22827;79698;7038;2738;10404;28998;157855;340441;79977;375686;389677;5462;23484;80005;6867;91147;65265;427;1191;55756;56892;79139;55872;4609;9420;54212;81551;157285;4986;138050;8629;84549;25960;64236;85002;51435;91694;137970;340359;137075;157697;4017;3646;9639;57094;5423;169270;169044;8793;4856;100130742;661;2039;7991;5168;5150;79845;29942;340371;203111;4715;23643;3620;761;203054;84988;55039;79848;8694;9530;392255;23414;81034;23221;157695;55790;5516;9920;85479;115111;51201;11212;80139;157657;26166;83482;83595;55284;286144;93594;653423;84675;619279;64089;5375;1673;2167;575;7553;7564;5324;23471;100130301;55656;54928;56169;245940;10499;649;2669;84232;10361;79752;8928;729330;4796;759;4061;29088;5569;10687;203100;7419;157769;79943;6674;79792;441381;526;80778;640;5862;432355;7264;8822;54714;56943;90362;203102;115908;116039;79870;84513;93100;26260;54793;389643;619373;245910;51669;9684;29967;4482;203074;114822;2137;55246;157777;27012;7994;28991;56154;79075;8836;79648;1670;50484;64168;645836;54968;92140;63898;81858;793;1585;85481;613209;646480;252969;389676;5157;23212;10987;94241;29028;148;23246;114926;5828;27085;5108;56260;100133267;10395;51571;286128;1052;64478;286046;79660;2222;29883;3174;55174;51001;28957;137392;54742;389649;9699;9796;90390;111188157;286077;203069;2675;137682;50626;286151;157680;54984;6575;389668;7163;9242;90459;23639;26281;8795;83877;137902;2831;11236;2339;23213;8797;23362;4824;8323;6503;8794;157773;11075;5885;84933;2171;63978;4603;79145;55909;80346;728358;389658;286133;727957;4325;100861412;91782;58500;55290;169355;10;401474;23514;7201;6921;157753;613211;55140;10221;9694;26986;3037;6713;113655;4147;79873;137814;55893;157378;66004;203190;100507341;114786;57604;8733;6917;54512;653333;94137;9791;51633;3297;64760;116447;83650;114569;504180;4683;84948;225689;286053;25879;286097;169200;492307;51059;2907;10434;23237;10671;245908;7976;25897;55093;642475;8754;1672;2875;3788;203062;83988;6482;4982;80728;51337;286075;2626;9650;9401;6156;55824;389690;286;8658;2267;414325;137868;90987;4481;11178;646486;138046;1669;203076;83648;23678;79618;57152;100533106;2260;340385;2961;51105;29894;100132396;6770;441376;64798;55636;1581;55529;100130274;105375787;140596;3551;6440;2936;2185;9108;1846;168975;79815;728957;100131608;10940;10584;6383;80243;85453;137735;9;65263;10947;157869;253943;3612;7486;55074;114907;157506;157848;642658;79666;100533105;157310;9312;55145;137994;340419;85444;137209;100127983;8895;57210;137492;23087;9172;503614;1807;4173;8439;286183;137797;23513;9788;51236;22882;8749;11160;414919;6129;2131;195814;10656;392197;138009;5591;389692;84955;9583;5747;23462;26873;6422;55894;80185;78986;27299;286148;10247;4741;64321;169166;50807;9046;1537;23039;25788;8840;245972;114;157638;157807;1671;9831;5327;51312;10407;2053;27257;8601;7381;8756;6788;7373;8767;8581;9705;2765;503618;155;27121;84197;9228;1960;6570;5179;340390;90990;654463;5533;137695;54704;541565;11244;645402;84294;2843;51050;83696;734;7227;51606;11030;9258;27067;4062;6224;2055;1875;389610;7071;25962;55638;6873;51123;7336;79581;1667;8000;83481;137964;114788;2138;84875;1142;312;54108;392188;64641;23516;92421;9134;1345;100132813;6781;5368;80124;9897;100133251;401466;4023;157567;1666;1015;84750;444;7013;157313;3786;54332;7993;503841;84985;1978;157574;54845;22898;100129654;7274;27161;55630;81790;245909;83690;338328;5520;10174;169026;55156;100131980;286187;340393;8667;55353;55124;66036;51582;3574;285;84296;5339;254778;51160;51110;4956;401447;115294;10086;84376;6386;93035;4342;57805;2796;5440;1392;10863;157570;57623;665;81501;6641;9821;1668;284;347051;83940;23259;8973;51115;23303;760;3084;10397;137362;80223;377677;6542;27319;23167;51305;55326;9760;1808;7534;54904;8989,659
1,-1,8,161472,402255,240783,26260;169270,2
-1,1,8,163166,6735327,6572161,389610;64478;9172;9639;79648;169270;285;2055;157695;26260;9228;55326;9920;1672;157697,15
-1,1,8,163682,6961161,6797479,389610;9172;728358;1669;26260;1667;157697;64478;1671;9639;79648;1670;169270;285;157695;9228;55326;9920;1672;1668;2055,21
1,1,8,163682,46938942,46775260,377630;203102;1508;83650;2053;27257;55806;504180;8756;84513;26260;54793;286097;389643;619373;245910;10671;245908;51669;503618;155;9070;100289462;4482;7976;203074;4747;59339;9228;1960;6570;1135;55246;1672;2137;8754;84197;5533;541565;51312;57509;645402;2626;2515;7994;613210;51125;56154;79698;79648;1670;157855;286;11030;340441;8658;9258;2267;414325;137868;645836;4481;2055;11178;389610;80005;23484;6867;63898;1669;203076;427;1191;83648;55756;56892;55872;79618;1667;2260;613209;81551;137964;157285;2961;252969;1142;100132396;6770;392188;5157;64641;138050;23516;148;84549;114926;5108;6781;5368;64236;25960;140596;100133267;10395;3551;100133251;85002;51435;6440;2936;91694;2185;9108;137970;4023;137075;157697;1846;4017;64478;728957;9639;100131608;27121;5423;169270;79660;286046;2222;8793;29883;84750;661;2039;55174;7991;157313;9;79845;29942;10947;7993;503841;389649;3620;1978;157574;9796;7486;1808;9530;203069;2675;157848;157310;54984;23221;157695;137994;6575;55145;55790;245909;81790;90459;5516;9920;5520;26281;137492;23087;10174;9172;51201;8795;11212;80139;503614;83877;83595;653423;100131980;2339;55124;23362;8797;1673;4824;66036;8794;285;84296;157773;8749;11160;401447;392197;55909;80346;9583;728358;245940;286133;84376;6422;649;55894;10361;57805;91782;2796;55290;169355;80185;10;78986;27299;10863;613211;10687;157570;55140;203100;665;4741;7419;9046;1668;23039;23259;8973;79873;137814;55893;23303;526;203190;100507341;57604;1671;3084;640;137362;80223;6542;5327;8822;653333;55326;94137;10407;54904;64760,254
-1,1,8,176452,1965389,1788937,9639;169270;2055;157695;26260;9228;9920;157697,8
-1,1,8,176452,6920273,6743821,389610;9172;728358;1669;26260;1667;157697;64478;1671;9639;79648;1670;169270;285;157695;9228;55326;9920;1672;1668;2055,21
-1,1,8,176452,6920273,6743821,389610;9172;728358;1669;26260;1667;157697;64478;1671;9639;79648;1670;169270;285;157695;9228;55326;9920;1672;1668;2055,21
-1,1,8,176452,6920273,6743821,389610;9172;728358;1669;26260;1667;157697;64478;1671;9639;79648;1670;169270;285;157695;9228;55326;9920;1672;1668;2055,21
-1,1,8,176452,6942337,6765885,389610;9172;728358;1669;26260;1667;157697;64478;1671;9639;79648;1670;169270;285;157695;9228;55326;9920;1672;1668;2055,21
1,1,8,176452,7838959,7662507,389610;401447;728358;503841;1669;504180;26260;55894;1667;245910;245908;100132396;503618;392188;157695;100289462;9228;245909;9920;1672;1668;9172;503614;140596;100133251;653423;645402;100131980;157697;1673;64478;1671;9639;100131608;79648;1670;169270;285;414325;55326;10407;645836;2055,43
1,1,8,176452,12556063,12379611,377630;1508;83650;504180;503841;26260;245910;245908;503618;54984;157695;100289462;4482;203074;9228;245909;90459;9920;1672;9172;503614;83595;653423;645402;100131980;2626;613210;1673;79648;1670;66036;285;8658;9258;414325;645836;2055;389610;401447;392197;728358;1669;245940;203076;83648;55894;1667;613209;157285;252969;100132396;392188;613211;1668;140596;100133267;100133251;85002;137075;157697;64478;728957;1671;9639;100131608;640;169270;79660;286046;2222;653333;55326;94137;10407,74
1,1,8,176452,12570496,12394044,377630;1508;83650;504180;503841;26260;245910;245908;503618;54984;157695;100289462;4482;203074;9228;245909;90459;9920;1672;9172;503614;83595;653423;645402;100131980;2626;613210;1673;79648;1670;66036;285;8658;9258;414325;645836;2055;389610;401447;392197;728358;1669;245940;203076;83648;55894;1667;613209;157285;252969;100132396;392188;613211;1668;140596;100133267;100133251;85002;137075;157697;64478;728957;1671;9639;100131608;640;169270;79660;286046;2222;653333;55326;94137;10407,74
1,1,8,176452,16137655,15961203,377630;1508;83650;504180;503841;10407;26260;245910;245908;503618;54984;100289462;4482;157695;203074;9228;245909;90459;9920;1672;9172;503614;83595;653423;645402;2626;100131980;613210;1673;79648;1670;66036;285;157773;8658;9258;414325;137868;645836;4481;2055;389610;401447;392197;728358;1669;245940;203076;83648;55894;1667;613209;157285;252969;100132396;392188;613211;1668;140596;100133267;10395;100133251;85002;91694;137075;157697;57604;64478;728957;9639;100131608;1671;640;169270;79660;286046;2222;653333;7991;55326;94137,81
1,1,8,176452,34349408,34172956,377630;1508;83650;2053;55806;504180;8756;26260;54793;286097;389643;619373;245910;10671;245908;51669;503618;100289462;4482;7976;203074;4747;9228;1960;6570;1135;55246;1672;2137;5533;541565;51312;57509;645402;2626;613210;56154;79648;1670;11030;8658;9258;2267;414325;137868;645836;4481;2055;11178;389610;80005;23484;63898;1669;203076;427;1191;83648;55756;55872;79618;1667;613209;81551;157285;2961;252969;100132396;392188;5157;64641;23516;148;84549;5108;6781;5368;64236;140596;100133267;10395;100133251;85002;51435;6440;2936;91694;2185;9108;4023;137075;157697;1846;4017;64478;728957;9639;100131608;169270;79660;286046;2222;8793;29883;84750;661;2039;55174;7991;157313;9;79845;29942;7993;503841;157574;9796;7486;1808;203069;2675;157310;54984;23221;157695;55790;245909;90459;5516;9920;5520;26281;137492;23087;10174;9172;51201;8795;503614;83595;653423;100131980;55124;23362;8797;1673;4824;66036;8794;285;157773;401447;392197;55909;80346;9583;728358;245940;286133;649;55894;10361;57805;91782;2796;80185;10;78986;27299;10863;613211;10687;157570;55140;665;4741;9046;1668;23039;79873;137814;55893;23303;526;203190;100507341;57604;1671;3084;640;6542;8822;653333;55326;94137;10407;64760,197
1,1,8,176452,37879246,37702794,377630;1508;83650;2053;55806;504180;8756;26260;54793;286097;389643;619373;245910;10671;245908;51669;503618;155;100289462;4482;7976;203074;4747;9228;1960;6570;1135;55246;1672;2137;5533;541565;51312;57509;645402;2626;613210;56154;79648;1670;157855;11030;8658;9258;2267;414325;137868;645836;4481;2055;11178;389610;80005;23484;63898;1669;203076;427;1191;83648;55756;55872;79618;1667;613209;81551;157285;2961;252969;100132396;392188;5157;64641;23516;148;84549;5108;6781;5368;64236;25960;140596;100133267;10395;100133251;85002;51435;6440;2936;91694;2185;9108;137970;4023;137075;157697;1846;4017;64478;728957;9639;100131608;169270;79660;286046;2222;8793;29883;84750;661;2039;55174;7991;157313;9;79845;29942;7993;503841;157574;9796;7486;1808;203069;2675;157310;54984;23221;157695;55790;245909;90459;5516;9920;5520;26281;137492;23087;10174;9172;51201;8795;11212;80139;503614;83595;653423;100131980;55124;23362;8797;1673;4824;66036;8794;285;157773;11160;401447;392197;55909;80346;9583;728358;245940;286133;649;55894;10361;57805;91782;2796;55290;80185;10;78986;27299;10863;613211;10687;157570;55140;665;4741;9046;1668;23039;79873;137814;55893;23303;526;203190;100507341;57604;1671;3084;640;137362;80223;6542;8822;653333;55326;94137;10407;64760,207
1,1,8,176452,146294098,146117646,377630;1508;1584;55806;51366;9166;137835;11156;767;137872;157724;137886;9070;4067;100289462;59339;4747;11059;862;6132;1135;79776;26233;10565;56704;65986;1936;51101;6101;23144;6591;116328;57509;79645;528;96764;81796;2515;613210;51125;22827;79698;7038;2738;10404;28998;157855;340441;79977;375686;389677;5462;23484;80005;6867;91147;65265;427;1191;55756;56892;79139;55872;4609;9420;54212;81551;157285;4986;138050;8629;84549;25960;64236;85002;51435;91694;137970;340359;137075;157697;4017;3646;9639;57094;5423;169270;169044;8793;4856;100130742;661;2039;7991;5168;5150;79845;29942;340371;203111;4715;23643;3620;761;203054;84988;55039;79848;8694;9530;392255;23414;81034;23221;157695;55790;5516;9920;85479;115111;51201;11212;80139;157657;26166;83482;83595;55284;286144;93594;653423;84675;619279;64089;5375;1673;2167;575;7553;7564;5324;23471;100130301;55656;54928;56169;245940;10499;649;2669;84232;10361;79752;8928;729330;4796;759;4061;29088;5569;10687;203100;7419;157769;79943;6674;79792;441381;526;80778;640;5862;432355;7264;8822;54714;56943;90362;203102;115908;116039;79870;84513;93100;26260;54793;389643;619373;245910;51669;9684;29967;4482;203074;114822;2137;55246;157777;27012;7994;28991;56154;79075;8836;79648;1670;50484;64168;645836;54968;92140;63898;81858;793;1585;85481;613209;646480;252969;389676;5157;23212;10987;94241;29028;148;23246;114926;5828;27085;5108;56260;100133267;10395;51571;286128;1052;64478;286046;79660;2222;29883;3174;55174;51001;28957;137392;54742;389649;9699;9796;90390;111188157;286077;203069;2675;137682;50626;286151;157680;54984;6575;389668;7163;9242;90459;23639;26281;8795;83877;137902;2831;11236;2339;23213;8797;23362;4824;8323;6503;8794;157773;11075;5885;84933;2171;63978;4603;79145;55909;80346;728358;389658;286133;727957;4325;100861412;91782;58500;55290;169355;10;401474;23514;7201;6921;157753;613211;55140;10221;9694;26986;3037;6713;113655;4147;79873;137814;55893;157378;66004;203190;100507341;114786;57604;8733;6917;54512;653333;94137;9791;51633;3297;64760;116447;83650;114569;504180;4683;84948;225689;286053;25879;286097;169200;492307;51059;2907;10434;23237;10671;245908;7976;25897;55093;642475;8754;1672;2875;3788;203062;83988;6482;4982;80728;51337;286075;2626;9650;9401;6156;55824;389690;286;8658;2267;414325;137868;90987;4481;11178;646486;138046;1669;203076;83648;23678;79618;57152;100533106;2260;340385;2961;51105;29894;100132396;6770;441376;64798;55636;1581;55529;100130274;105375787;140596;3551;6440;2936;2185;9108;1846;168975;79815;728957;100131608;10940;10584;6383;80243;85453;137735;9;65263;10947;157869;253943;3612;7486;55074;114907;157506;157848;642658;79666;100533105;157310;9312;55145;137994;340419;85444;137209;100127983;8895;57210;137492;23087;9172;503614;1807;4173;8439;286183;137797;23513;9788;51236;22882;8749;11160;414919;6129;2131;195814;10656;392197;138009;5591;389692;84955;9583;5747;23462;26873;6422;55894;80185;78986;27299;286148;10247;4741;64321;169166;50807;9046;1537;23039;25788;8840;245972;114;157638;157807;1671;9831;5327;51312;10407;2053;27257;8601;7381;8756;6788;7373;8767;8581;9705;2765;503618;155;27121;84197;9228;1960;6570;5179;340390;90990;654463;5533;137695;54704;541565;11244;645402;84294;2843;51050;83696;734;7227;51606;11030;9258;27067;4062;6224;2055;1875;389610;7071;25962;55638;6873;51123;7336;79581;1667;8000;83481;137964;114788;2138;84875;1142;312;54108;392188;64641;23516;92421;9134;1345;100132813;6781;5368;80124;9897;100133251;401466;4023;157567;1666;1015;84750;444;7013;157313;3786;54332;7993;503841;84985;1978;157574;54845;22898;100129654;7274;27161;55630;81790;245909;83690;338328;5520;10174;169026;55156;100131980;286187;340393;8667;55353;55124;66036;51582;3574;285;84296;5339;254778;51160;51110;4956;401447;115294;10086;84376;6386;93035;4342;57805;2796;5440;1392;10863;157570;57623;665;81501;6641;9821;1668;284;347051;83940;23259;8973;51115;23303;760;3084;10397;137362;80223;377677;6542;27319;23167;51305;55326;9760;1808;7534;54904;8989,659
1,1,8,176452,146294098,146117646,377630;1508;1584;55806;51366;9166;137835;11156;767;137872;157724;137886;9070;4067;100289462;59339;4747;11059;862;6132;1135;79776;26233;10565;56704;65986;1936;51101;6101;23144;6591;116328;57509;79645;528;96764;81796;2515;613210;51125;22827;79698;7038;2738;10404;28998;157855;340441;79977;375686;389677;5462;23484;80005;6867;91147;65265;427;1191;55756;56892;79139;55872;4609;9420;54212;81551;157285;4986;138050;8629;84549;25960;64236;85002;51435;91694;137970;340359;137075;157697;4017;3646;9639;57094;5423;169270;169044;8793;4856;100130742;661;2039;7991;5168;5150;79845;29942;340371;203111;4715;23643;3620;761;203054;84988;55039;79848;8694;9530;392255;23414;81034;23221;157695;55790;5516;9920;85479;115111;51201;11212;80139;157657;26166;83482;83595;55284;286144;93594;653423;84675;619279;64089;5375;1673;2167;575;7553;7564;5324;23471;100130301;55656;54928;56169;245940;10499;649;2669;84232;10361;79752;8928;729330;4796;759;4061;29088;5569;10687;203100;7419;157769;79943;6674;79792;441381;526;80778;640;5862;432355;7264;8822;54714;56943;90362;203102;115908;116039;79870;84513;93100;26260;54793;389643;619373;245910;51669;9684;29967;4482;203074;114822;2137;55246;157777;27012;7994;28991;56154;79075;8836;79648;1670;50484;64168;645836;54968;92140;63898;81858;793;1585;85481;613209;646480;252969;389676;5157;23212;10987;94241;29028;148;23246;114926;5828;27085;5108;56260;100133267;10395;51571;286128;1052;64478;286046;79660;2222;29883;3174;55174;51001;28957;137392;54742;389649;9699;9796;90390;111188157;286077;203069;2675;137682;50626;286151;157680;54984;6575;389668;7163;9242;90459;23639;26281;8795;83877;137902;2831;11236;2339;23213;8797;23362;4824;8323;6503;8794;157773;11075;5885;84933;2171;63978;4603;79145;55909;80346;728358;389658;286133;727957;4325;100861412;91782;58500;55290;169355;10;401474;23514;7201;6921;157753;613211;55140;10221;9694;26986;3037;6713;113655;4147;79873;137814;55893;157378;66004;203190;100507341;114786;57604;8733;6917;54512;653333;94137;9791;51633;3297;64760;116447;83650;114569;504180;4683;84948;225689;286053;25879;286097;169200;492307;51059;2907;10434;23237;10671;245908;7976;25897;55093;642475;8754;1672;2875;3788;203062;83988;6482;4982;80728;51337;286075;2626;9650;9401;6156;55824;389690;286;8658;2267;414325;137868;90987;4481;11178;646486;138046;1669;203076;83648;23678;79618;57152;100533106;2260;340385;2961;51105;29894;100132396;6770;441376;64798;55636;1581;55529;100130274;105375787;140596;3551;6440;2936;2185;9108;1846;168975;79815;728957;100131608;10940;10584;6383;80243;85453;137735;9;65263;10947;157869;253943;3612;7486;55074;114907;157506;157848;642658;79666;100533105;157310;9312;55145;137994;340419;85444;137209;100127983;8895;57210;137492;23087;9172;503614;1807;4173;8439;286183;137797;23513;9788;51236;22882;8749;11160;414919;6129;2131;195814;10656;392197;138009;5591;389692;84955;9583;5747;23462;26873;6422;55894;80185;78986;27299;286148;10247;4741;64321;169166;50807;9046;1537;23039;25788;8840;245972;114;157638;157807;1671;9831;5327;51312;10407;2053;27257;8601;7381;8756;6788;7373;8767;8581;9705;2765;503618;155;27121;84197;9228;1960;6570;5179;340390;90990;654463;5533;137695;54704;541565;11244;645402;84294;2843;51050;83696;734;7227;51606;11030;9258;27067;4062;6224;2055;1875;389610;7071;25962;55638;6873;51123;7336;79581;1667;8000;83481;137964;114788;2138;84875;1142;312;54108;392188;64641;23516;92421;9134;1345;100132813;6781;5368;80124;9897;100133251;401466;4023;157567;1666;1015;84750;444;7013;157313;3786;54332;7993;503841;84985;1978;157574;54845;22898;100129654;7274;27161;55630;81790;245909;83690;338328;5520;10174;169026;55156;100131980;286187;340393;8667;55353;55124;66036;51582;3574;285;84296;5339;254778;51160;51110;4956;401447;115294;10086;84376;6386;93035;4342;57805;2796;5440;1392;10863;157570;57623;665;81501;6641;9821;1668;284;347051;83940;23259;8973;51115;23303;760;3084;10397;137362;80223;377677;6542;27319;23167;51305;55326;9760;1808;7534;54904;8989,659
-1,1,8,190822,6735327,6544505,389610;64478;9172;9639;79648;169270;285;2055;157695;26260;9228;55326;9920;1672;157697,15
-1,1,8,191530,3070296,2878766,64478;9172;9639;169270;2055;157695;26260;9228;9920;157697,10
-1,1,8,191530,3189335,2997805,64478;9172;9639;169270;2055;157695;26260;9228;9920;157697,10
-1,1,8,191530,6880363,6688833,389610;9172;728358;1669;26260;1667;157697;64478;1671;9639;79648;169270;285;157695;9228;55326;9920;1672;1668;2055,20
-1,1,8,191530,6880363,6688833,389610;9172;728358;1669;26260;1667;157697;64478;1671;9639;79648;169270;285;157695;9228;55326;9920;1672;1668;2055,20
-1,1,8,191530,6880363,6688833,389610;9172;728358;1669;26260;1667;157697;64478;1671;9639;79648;169270;285;157695;9228;55326;9920;1672;1668;2055,20
-1,1,8,191530,6880363,6688833,389610;9172;728358;1669;26260;1667;157697;64478;1671;9639;79648;169270;285;157695;9228;55326;9920;1672;1668;2055,20
-1,1,8,191530,6880363,6688833,389610;9172;728358;1669;26260;1667;157697;64478;1671;9639;79648;169270;285;157695;9228;55326;9920;1672;1668;2055,20
1,1,8,191530,6880363,6688833,389610;9172;728358;1669;26260;1667;157697;64478;1671;9639;79648;169270;285;157695;9228;55326;9920;1672;1668;2055,20
-1,1,8,191530,6880363,6688833,389610;9172;728358;1669;26260;1667;157697;64478;1671;9639;79648;169270;285;157695;9228;55326;9920;1672;1668;2055,20
-1,1,8,191530,6880363,6688833,389610;9172;728358;1669;26260;1667;157697;64478;1671;9639;79648;169270;285;157695;9228;55326;9920;1672;1668;2055,20
-1,1,8,191530,6914076,6722546,389610;9172;728358;1669;26260;1667;157697;64478;1671;9639;79648;1670;169270;285;157695;9228;55326;9920;1672;1668;2055,21
-1,1,8,191530,7752586,7561056,389610;401447;728358;503841;1669;504180;26260;55894;1667;245910;245908;503618;157695;100289462;9228;245909;9920;1672;1668;9172;503614;140596;100133251;653423;645402;100131980;157697;1673;64478;1671;9639;100131608;79648;1670;169270;285;414325;55326;10407;2055,40
-1,1,8,191530,10049105,9857575,389610;401447;728358;503841;1669;504180;26260;55894;1667;245910;157285;245908;100132396;503618;392188;157695;100289462;4482;9228;245909;90459;9920;1672;1668;9172;503614;140596;100133251;653423;645402;100131980;137075;157697;1673;64478;1671;9639;100131608;79648;1670;169270;285;79660;8658;9258;414325;55326;10407;645836;2055,50
-1,1,8,191530,10315994,10124464,389610;401447;728358;503841;1669;504180;26260;55894;1667;245910;157285;245908;100132396;503618;392188;157695;100289462;4482;9228;245909;90459;9920;1672;1668;9172;503614;140596;100133251;653423;645402;100131980;137075;157697;1673;64478;1671;9639;100131608;79648;1670;169270;285;79660;8658;9258;414325;55326;10407;645836;2055,50
-1,1,8,191530,10724642,10533112,389610;401447;728358;503841;1669;504180;26260;203076;55894;1667;245910;157285;245908;100132396;503618;54984;392188;157695;100289462;4482;203074;9228;245909;90459;9920;1672;1668;9172;503614;140596;83595;100133251;653423;645402;100131980;137075;157697;1673;64478;1671;9639;100131608;79648;1670;169270;285;79660;8658;9258;414325;55326;94137;10407;645836;2055,55
1,1,8,191530,22404983,22213453,377630;1508;83650;55806;504180;503841;10407;64760;26260;9796;286097;245910;2675;245908;503618;54984;100289462;4482;157695;203074;55790;9228;245909;6570;90459;9920;1672;26281;137492;5533;9172;51201;503614;83595;57509;653423;645402;2626;100131980;613210;55124;23362;1673;79648;1670;66036;285;157773;8658;9258;2267;414325;137868;645836;4481;2055;11178;389610;401447;392197;80346;63898;728358;1669;245940;203076;427;649;83648;55894;10361;1667;613209;157285;10;252969;100132396;392188;5157;613211;23516;9046;1668;23039;5108;140596;79873;100133267;10395;100133251;85002;6440;526;203190;91694;9108;4023;137075;157697;57604;64478;728957;9639;100131608;1671;640;169270;286046;79660;2222;29883;6542;661;2039;55174;7991;8822;653333;55326;94137;9,121
1,1,8,191530,23055911,22864381,377630;1508;83650;55806;504180;26260;286097;245910;245908;503618;100289462;4482;203074;9228;1960;6570;1672;5533;541565;57509;645402;2626;613210;79648;1670;8658;9258;2267;414325;137868;645836;4481;2055;11178;389610;63898;1669;203076;427;83648;1667;613209;157285;252969;100132396;392188;5157;23516;5108;64236;140596;100133267;10395;100133251;85002;6440;91694;9108;4023;137075;157697;64478;728957;9639;100131608;169270;286046;79660;2222;8793;29883;661;2039;55174;7991;9;503841;9796;2675;157310;54984;23221;157695;55790;245909;90459;9920;26281;137492;10174;9172;51201;8795;503614;83595;653423;100131980;55124;23362;8797;1673;66036;8794;285;157773;401447;392197;55909;80346;728358;245940;649;55894;10361;57805;10;613211;9046;1668;23039;79873;526;203190;57604;1671;640;6542;8822;653333;55326;94137;10407;64760,133
1,1,8,191530,146280020,146088490,377630;1508;1584;55806;51366;9166;137835;11156;767;137872;157724;137886;9070;4067;100289462;59339;4747;11059;862;6132;1135;79776;26233;10565;56704;65986;1936;51101;6101;23144;6591;116328;57509;79645;528;96764;81796;2515;613210;51125;22827;79698;7038;2738;10404;28998;157855;340441;79977;375686;389677;5462;23484;80005;6867;91147;65265;427;1191;55756;56892;79139;55872;4609;9420;54212;81551;157285;4986;138050;8629;84549;25960;64236;85002;51435;91694;137970;340359;137075;157697;4017;3646;9639;57094;5423;169270;169044;8793;4856;100130742;661;2039;7991;5168;5150;79845;29942;340371;203111;4715;23643;3620;761;203054;84988;55039;79848;8694;9530;392255;23414;81034;23221;157695;55790;5516;9920;85479;115111;51201;11212;80139;157657;26166;83482;83595;55284;286144;93594;653423;84675;619279;64089;5375;1673;2167;575;7553;7564;5324;23471;100130301;55656;54928;56169;245940;10499;649;2669;84232;10361;79752;8928;729330;4796;759;4061;29088;5569;10687;203100;7419;157769;79943;6674;79792;441381;526;80778;640;5862;432355;7264;8822;54714;56943;90362;203102;115908;116039;79870;84513;93100;26260;54793;389643;619373;245910;51669;9684;29967;4482;203074;114822;2137;55246;157777;27012;7994;28991;56154;79075;8836;79648;1670;50484;64168;645836;54968;92140;63898;81858;793;1585;85481;613209;646480;252969;389676;5157;23212;10987;94241;29028;148;23246;114926;5828;27085;5108;56260;100133267;10395;51571;286128;1052;64478;286046;79660;2222;29883;3174;55174;51001;28957;137392;54742;389649;9699;9796;90390;111188157;286077;203069;2675;137682;50626;286151;157680;54984;6575;389668;7163;9242;90459;23639;26281;8795;83877;137902;2831;11236;2339;23213;8797;23362;4824;8323;6503;8794;157773;11075;5885;84933;2171;63978;4603;79145;55909;80346;728358;389658;286133;727957;4325;100861412;91782;58500;55290;169355;10;401474;23514;7201;6921;157753;613211;55140;10221;9694;26986;3037;6713;113655;4147;79873;137814;55893;157378;66004;203190;100507341;114786;57604;8733;6917;54512;653333;94137;9791;51633;3297;64760;116447;83650;114569;504180;4683;84948;225689;286053;25879;286097;169200;492307;51059;2907;10434;23237;10671;245908;7976;25897;55093;642475;8754;1672;2875;3788;203062;83988;6482;4982;80728;51337;286075;2626;9650;9401;6156;55824;389690;286;8658;2267;414325;137868;90987;4481;11178;646486;138046;1669;203076;83648;23678;79618;57152;100533106;2260;340385;2961;51105;29894;100132396;6770;441376;64798;55636;1581;55529;100130274;105375787;140596;3551;6440;2936;2185;9108;1846;168975;79815;728957;100131608;10940;10584;6383;80243;85453;137735;9;65263;10947;157869;253943;3612;7486;55074;114907;157506;157848;642658;79666;100533105;157310;9312;55145;137994;340419;85444;137209;100127983;8895;57210;137492;23087;9172;503614;1807;4173;8439;286183;137797;23513;9788;51236;22882;8749;11160;414919;6129;2131;195814;10656;392197;138009;5591;389692;84955;9583;5747;23462;26873;6422;55894;80185;78986;27299;286148;10247;4741;64321;169166;50807;9046;1537;23039;25788;8840;245972;114;157638;157807;1671;9831;5327;51312;10407;2053;27257;8601;7381;8756;6788;7373;8767;8581;9705;2765;503618;155;27121;84197;9228;1960;6570;5179;340390;90990;654463;5533;137695;54704;541565;11244;645402;84294;2843;51050;83696;734;7227;51606;11030;9258;27067;4062;6224;2055;1875;389610;7071;25962;55638;6873;51123;7336;79581;1667;8000;83481;137964;114788;2138;84875;1142;312;54108;392188;64641;23516;92421;9134;1345;100132813;6781;5368;80124;9897;100133251;401466;4023;157567;1666;1015;84750;444;7013;157313;3786;54332;7993;503841;84985;1978;157574;54845;22898;100129654;7274;27161;55630;81790;245909;83690;338328;5520;10174;169026;55156;100131980;286187;340393;8667;55353;55124;66036;51582;3574;285;84296;5339;254778;51160;51110;4956;401447;115294;10086;84376;6386;93035;4342;57805;2796;5440;1392;10863;157570;57623;665;81501;6641;9821;1668;284;347051;83940;23259;8973;51115;23303;760;3084;10397;137362;80223;377677;6542;27319;23167;51305;55326;9760;1808;7534;54904;8989,659
1,-1,8,191605,408761,217156,26260;169270,2
1,-1,8,191605,408761,217156,26260;169270,2
1,1,8,191605,6880346,6688741,389610;9172;728358;1669;26260;1667;157697;64478;1671;9639;79648;169270;285;157695;9228;55326;9920;1672;1668;2055,20
-1,1,8,191605,6880346,6688741,389610;9172;728358;1669;26260;1667;157697;64478;1671;9639;79648;169270;285;157695;9228;55326;9920;1672;1668;2055,20
-1,1,8,191605,6880346,6688741,389610;9172;728358;1669;26260;1667;157697;64478;1671;9639;79648;169270;285;157695;9228;55326;9920;1672;1668;2055,20
1,1,8,191605,24514484,24322879,377630;1508;83650;55806;504180;8756;26260;286097;245910;245908;503618;100289462;4482;203074;9228;1960;6570;1672;5533;541565;57509;645402;2626;613210;79648;1670;8658;9258;2267;414325;137868;645836;4481;2055;11178;389610;63898;1669;203076;427;83648;1667;613209;157285;252969;100132396;392188;5157;23516;5108;6781;64236;140596;100133267;10395;100133251;85002;6440;91694;9108;4023;137075;157697;4017;64478;728957;9639;100131608;169270;286046;79660;2222;8793;29883;661;2039;55174;7991;9;10407;503841;9796;203069;2675;157310;54984;23221;157695;55790;245909;90459;9920;26281;137492;10174;9172;51201;8795;503614;83595;653423;100131980;55124;23362;8797;1673;4824;66036;8794;285;157773;401447;392197;55909;80346;9583;728358;245940;649;55894;10361;57805;91782;10;27299;10863;613211;9046;1668;23039;79873;137814;526;203190;57604;1671;640;6542;8822;653333;55326;94137;51312;64760,144
1,1,8,191605,30948590,30756985,377630;1508;83650;2053;55806;504180;8756;26260;54793;286097;389643;619373;245910;10671;245908;51669;503618;100289462;4482;7976;203074;4747;9228;1960;6570;1135;55246;1672;2137;5533;541565;57509;645402;2626;613210;56154;79648;1670;11030;8658;9258;2267;414325;137868;645836;4481;2055;11178;389610;80005;23484;63898;1669;203076;427;1191;83648;55756;55872;79618;1667;613209;81551;157285;2961;252969;100132396;392188;5157;64641;23516;148;5108;6781;5368;64236;140596;100133267;10395;100133251;85002;51435;6440;2936;91694;2185;9108;4023;137075;157697;1846;4017;64478;728957;9639;100131608;169270;286046;79660;2222;8793;29883;661;2039;55174;7991;157313;9;29942;7993;503841;10407;157574;9796;7486;1808;203069;2675;157310;54984;23221;157695;55790;245909;90459;5516;9920;5520;26281;137492;23087;10174;9172;51201;8795;503614;83595;653423;100131980;55124;23362;8797;1673;4824;66036;8794;285;157773;401447;392197;55909;80346;9583;728358;245940;286133;649;55894;10361;57805;91782;2796;10;27299;10863;613211;10687;157570;55140;665;4741;9046;1668;23039;79873;137814;55893;23303;526;203190;100507341;57604;1671;640;6542;8822;653333;55326;94137;51312;64760,191
1,1,8,191605,146280167,146088562,377630;1508;1584;55806;51366;9166;137835;11156;767;137872;157724;137886;9070;4067;100289462;59339;4747;11059;862;6132;1135;79776;26233;10565;56704;65986;1936;51101;6101;23144;6591;116328;57509;79645;528;96764;81796;2515;613210;51125;22827;79698;7038;2738;10404;28998;157855;340441;79977;375686;389677;5462;23484;80005;6867;91147;65265;427;1191;55756;56892;79139;55872;4609;9420;54212;81551;157285;4986;138050;8629;84549;25960;64236;85002;51435;91694;137970;340359;137075;157697;4017;3646;9639;57094;5423;169270;169044;8793;4856;100130742;661;2039;7991;5168;5150;79845;29942;340371;203111;4715;23643;3620;761;203054;84988;55039;79848;8694;9530;392255;23414;81034;23221;157695;55790;5516;9920;85479;115111;51201;11212;80139;157657;26166;83482;83595;55284;286144;93594;653423;84675;619279;64089;5375;1673;2167;575;7553;7564;5324;23471;100130301;55656;54928;56169;245940;10499;649;2669;84232;10361;79752;8928;729330;4796;759;4061;29088;5569;10687;203100;7419;157769;79943;6674;79792;441381;526;80778;640;5862;432355;7264;8822;54714;56943;90362;203102;115908;116039;79870;84513;93100;26260;54793;389643;619373;245910;51669;9684;29967;4482;203074;114822;2137;55246;157777;27012;7994;28991;56154;79075;8836;79648;1670;50484;64168;645836;54968;92140;63898;81858;793;1585;85481;613209;646480;252969;389676;5157;23212;10987;94241;29028;148;23246;114926;5828;27085;5108;56260;100133267;10395;51571;286128;1052;64478;286046;79660;2222;29883;3174;55174;51001;28957;137392;54742;389649;9699;9796;90390;111188157;286077;203069;2675;137682;50626;286151;157680;54984;6575;389668;7163;9242;90459;23639;26281;8795;83877;137902;2831;11236;2339;23213;8797;23362;4824;8323;6503;8794;157773;11075;5885;84933;2171;63978;4603;79145;55909;80346;728358;389658;286133;727957;4325;100861412;91782;58500;55290;169355;10;401474;23514;7201;6921;157753;613211;55140;10221;9694;26986;3037;6713;113655;4147;79873;137814;55893;157378;66004;203190;100507341;114786;57604;8733;6917;54512;653333;94137;9791;51633;3297;64760;116447;83650;114569;504180;4683;84948;225689;286053;25879;286097;169200;492307;51059;2907;10434;23237;10671;245908;7976;25897;55093;642475;8754;1672;2875;3788;203062;83988;6482;4982;80728;51337;286075;2626;9650;9401;6156;55824;389690;286;8658;2267;414325;137868;90987;4481;11178;646486;138046;1669;203076;83648;23678;79618;57152;100533106;2260;340385;2961;51105;29894;100132396;6770;441376;64798;55636;1581;55529;100130274;105375787;140596;3551;6440;2936;2185;9108;1846;168975;79815;728957;100131608;10940;10584;6383;80243;85453;137735;9;65263;10947;157869;253943;3612;7486;55074;114907;157506;157848;642658;79666;100533105;157310;9312;55145;137994;340419;85444;137209;100127983;8895;57210;137492;23087;9172;503614;1807;4173;8439;286183;137797;23513;9788;51236;22882;8749;11160;414919;6129;2131;195814;10656;392197;138009;5591;389692;84955;9583;5747;23462;26873;6422;55894;80185;78986;27299;286148;10247;4741;64321;169166;50807;9046;1537;23039;25788;8840;245972;114;157638;157807;1671;9831;5327;51312;10407;2053;27257;8601;7381;8756;6788;7373;8767;8581;9705;2765;503618;155;27121;84197;9228;1960;6570;5179;340390;90990;654463;5533;137695;54704;541565;11244;645402;84294;2843;51050;83696;734;7227;51606;11030;9258;27067;4062;6224;2055;1875;389610;7071;25962;55638;6873;51123;7336;79581;1667;8000;83481;137964;114788;2138;84875;1142;312;54108;392188;64641;23516;92421;9134;1345;100132813;6781;5368;80124;9897;100133251;401466;4023;157567;1666;1015;84750;444;7013;157313;3786;54332;7993;503841;84985;1978;157574;54845;22898;100129654;7274;27161;55630;81790;245909;83690;338328;5520;10174;169026;55156;100131980;286187;340393;8667;55353;55124;66036;51582;3574;285;84296;5339;254778;51160;51110;4956;401447;115294;10086;84376;6386;93035;4342;57805;2796;5440;1392;10863;157570;57623;665;81501;6641;9821;1668;284;347051;83940;23259;8973;51115;23303;760;3084;10397;137362;80223;377677;6542;27319;23167;51305;55326;9760;1808;7534;54904;8989,659
-1,1,8,194617,1965389,1770772,9639;169270;2055;157695;26260;9228;9920;157697,8
-1,1,8,194617,1965389,1770772,9639;169270;2055;157695;26260;9228;9920;157697,8
1,-1,8,248209,406082,157873,26260,1
-1,1,8,360369,7334625,6974256,389610;401447;9172;728358;10407;1669;26260;645402;100131980;55894;1667;157697;64478;1671;9639;79648;1670;285;503618;157695;100289462;9228;55326;9920;1672;1668;2055,27
1,-1,8,401226,561272,160046,26260;157695,2
-1,-1,8,542299,561272,18973,,0
1,-1,8,732690,8079920,7347230,389610;401447;728358;503841;1669;504180;55894;1667;245910;245908;100132396;503618;392188;100289462;9228;245909;9920;1672;1668;9172;503614;140596;100133251;653423;645402;100131980;1673;64478;1671;9639;100131608;79648;1670;285;414325;55326;10407;645836;2055,39
1,1,8,1166068,12570914,11404846,377630;1508;83650;504180;503841;245910;245908;503618;54984;100289462;4482;203074;9228;245909;90459;9920;1672;9172;503614;83595;653423;645402;100131980;2626;613210;1673;79648;1670;66036;285;8658;9258;414325;645836;2055;389610;401447;392197;728358;1669;245940;203076;83648;55894;1667;613209;157285;252969;100132396;392188;613211;1668;140596;100133267;100133251;85002;137075;64478;728957;1671;9639;100131608;640;286046;79660;2222;653333;55326;94137;10407,70
-1,-1,8,2001733,2013802,12069,9172,1
1,-1,8,2133991,2349876,215885,,0
1,-1,8,2133991,2349876,215885,,0
1,-1,8,2158515,2308926,150411,,0
1,-1,8,2256252,2598857,342605,,0
-1,1,8,2292235,27361796,25069561,377630;1508;83650;2053;55806;504180;8756;54793;286097;245910;245908;503618;100289462;4482;203074;4747;1960;6570;1135;1672;5533;541565;51312;57509;645402;2626;613210;79648;1670;8658;9258;2267;414325;137868;645836;4481;11178;80005;389610;63898;1669;203076;427;83648;1667;613209;81551;157285;252969;100132396;392188;5157;64641;23516;148;5108;6781;64236;140596;100133267;10395;100133251;85002;6440;91694;2185;9108;4023;137075;4017;64478;728957;100131608;286046;79660;2222;8793;29883;661;2039;55174;7991;157313;9;503841;9796;1808;203069;2675;157310;54984;23221;55790;245909;90459;5520;26281;137492;23087;10174;8795;51201;503614;83595;653423;100131980;55124;23362;8797;1673;4824;66036;8794;285;157773;401447;392197;55909;80346;9583;728358;245940;649;55894;10361;57805;91782;2796;10;27299;10863;613211;10687;665;4741;9046;1668;23039;79873;137814;526;203190;57604;1671;640;6542;8822;653333;55326;94137;10407;64760,152
-1,1,8,2292235,27361796,25069561,377630;1508;83650;2053;55806;504180;8756;54793;286097;245910;245908;503618;100289462;4482;203074;4747;1960;6570;1135;1672;5533;541565;51312;57509;645402;2626;613210;79648;1670;8658;9258;2267;414325;137868;645836;4481;11178;80005;389610;63898;1669;203076;427;83648;1667;613209;81551;157285;252969;100132396;392188;5157;64641;23516;148;5108;6781;64236;140596;100133267;10395;100133251;85002;6440;91694;2185;9108;4023;137075;4017;64478;728957;100131608;286046;79660;2222;8793;29883;661;2039;55174;7991;157313;9;503841;9796;1808;203069;2675;157310;54984;23221;55790;245909;90459;5520;26281;137492;23087;10174;8795;51201;503614;83595;653423;100131980;55124;23362;8797;1673;4824;66036;8794;285;157773;401447;392197;55909;80346;9583;728358;245940;649;55894;10361;57805;91782;2796;10;27299;10863;613211;10687;665;4741;9046;1668;23039;79873;137814;526;203190;57604;1671;640;6542;8822;653333;55326;94137;10407;64760,152
1,-1,8,2349876,2559272,209396,,0
1,-1,8,2349876,2559272,209396,,0
1,-1,8,2349876,2559272,209396,,0
1,-1,8,2349876,2559272,209396,,0
1,-1,8,2349876,2559272,209396,,0
1,-1,8,2349876,2559272,209396,,0
1,-1,8,2349876,2559272,209396,,0
1,-1,8,2498609,2894273,395664,64478,1
1,1,8,2498609,6463100,3964491,285;64478;79648,3
1,-1,8,3689491,6062810,2373319,64478,1
-1,1,8,3791727,11384448,7592721,389610;401447;83650;728358;503841;1669;504180;203076;83648;55894;1667;245910;157285;245908;100132396;503618;54984;392188;100289462;4482;203074;245909;90459;1672;1668;503614;140596;83595;100133251;653423;645402;100131980;137075;1673;64478;1671;100131608;640;79648;1670;286046;285;79660;66036;8658;9258;414325;55326;94137;10407;645836,51
-1,-1,8,3988085,4069370,81285,64478,1
-1,-1,8,3989887,4069370,79483,64478,1
-1,-1,8,4328231,4406745,78514,64478,1
-1,-1,8,4328231,4406745,78514,64478,1
-1,-1,8,4336985,4414585,77600,64478,1
1,-1,8,4582816,4631792,48976,64478,1
-1,-1,8,4725109,4749269,24160,64478,1
-1,-1,8,4725168,4749269,24101,64478,1
-1,-1,8,5511047,5853505,342458,,0
-1,-1,8,5511047,5884114,373067,,0
-1,-1,8,6043200,6161430,118230,,0
1,-1,8,6589680,6680133,90453,389610;55326,2
1,-1,8,6621444,6680133,58689,389610,1
1,-1,8,6644159,8222024,1577865,389610;401447;503614;728358;503841;1669;504180;140596;10407;100133251;653423;645402;100131980;55894;1667;245910;1673;157285;1671;100131608;1670;245908;100132396;503618;392188;100289462;245909;414325;1672;645836;1668,31
-1,-1,8,6730517,6795070,64553,1672;1671;1669,3
1,-1,8,6823874,8130466,1306592,401447;503614;728358;503841;504180;140596;100133251;653423;645402;100131980;55894;1667;245910;1673;100131608;1670;245908;100132396;503618;392188;100289462;245909;414325;10407;645836;1668,26
1,-1,8,6880287,8079912,1199625,401447;503614;504180;503841;140596;100133251;653423;100131980;645402;55894;245910;1673;100131608;1670;245908;100132396;503618;392188;100289462;245909;414325;10407;645836,23
-1,-1,8,6880287,8079912,1199625,401447;503614;504180;503841;140596;100133251;653423;100131980;645402;55894;245910;1673;100131608;1670;245908;100132396;503618;392188;100289462;245909;414325;10407;645836,23
-1,-1,8,6880304,7752586,872282,401447;503614;504180;503841;140596;100133251;653423;100131980;645402;55894;245910;1673;100131608;1670;245908;503618;100289462;245909;414325;10407,20
-1,-1,8,6880304,7752586,872282,401447;503614;504180;503841;140596;100133251;653423;100131980;645402;55894;245910;1673;100131608;1670;245908;503618;100289462;245909;414325;10407,20
1,-1,8,6880304,8079920,1199616,401447;503614;504180;503841;140596;100133251;653423;100131980;645402;55894;245910;1673;100131608;1670;245908;100132396;503618;392188;100289462;245909;414325;10407;645836,23
1,-1,8,6880304,8079920,1199616,401447;503614;504180;503841;140596;100133251;653423;100131980;645402;55894;245910;1673;100131608;1670;245908;100132396;503618;392188;100289462;245909;414325;10407;645836,23
1,-1,8,6880304,8079920,1199616,401447;503614;504180;503841;140596;100133251;653423;100131980;645402;55894;245910;1673;100131608;1670;245908;100132396;503618;392188;100289462;245909;414325;10407;645836,23
1,-1,8,6880304,8079920,1199616,401447;503614;504180;503841;140596;100133251;653423;100131980;645402;55894;245910;1673;100131608;1670;245908;100132396;503618;392188;100289462;245909;414325;10407;645836,23
1,-1,8,6911521,8130466,1218945,401447;503614;504180;503841;140596;100133251;653423;100131980;645402;55894;245910;1673;100131608;1670;245908;100132396;503618;392188;100289462;245909;414325;10407;645836,23
1,-1,8,6911521,8130466,1218945,401447;503614;504180;503841;140596;100133251;653423;100131980;645402;55894;245910;1673;100131608;1670;245908;100132396;503618;392188;100289462;245909;414325;10407;645836,23
1,-1,8,6911521,8145238,1233717,401447;503614;504180;503841;140596;100133251;653423;100131980;645402;55894;245910;1673;100131608;1670;245908;100132396;503618;392188;100289462;245909;414325;10407;645836,23
1,-1,8,6920322,8130466,1210144,401447;503614;504180;503841;140596;100133251;653423;100131980;645402;55894;245910;1673;100131608;245908;100132396;503618;392188;100289462;245909;414325;10407;645836,22
1,-1,8,6920322,8130466,1210144,401447;503614;504180;503841;140596;100133251;653423;100131980;645402;55894;245910;1673;100131608;245908;100132396;503618;392188;100289462;245909;414325;10407;645836,22
1,-1,8,6920322,8130466,1210144,401447;503614;504180;503841;140596;100133251;653423;100131980;645402;55894;245910;1673;100131608;245908;100132396;503618;392188;100289462;245909;414325;10407;645836,22
1,-1,8,6920322,8130466,1210144,401447;503614;504180;503841;140596;100133251;653423;100131980;645402;55894;245910;1673;100131608;245908;100132396;503618;392188;100289462;245909;414325;10407;645836,22
1,-1,8,6920322,8130466,1210144,401447;503614;504180;503841;140596;100133251;653423;100131980;645402;55894;245910;1673;100131608;245908;100132396;503618;392188;100289462;245909;414325;10407;645836,22
1,-1,8,6920322,8130466,1210144,401447;503614;504180;503841;140596;100133251;653423;100131980;645402;55894;245910;1673;100131608;245908;100132396;503618;392188;100289462;245909;414325;10407;645836,22
1,-1,8,6920322,8130466,1210144,401447;503614;504180;503841;140596;100133251;653423;100131980;645402;55894;245910;1673;100131608;245908;100132396;503618;392188;100289462;245909;414325;10407;645836,22
1,-1,8,6920322,8130466,1210144,401447;503614;504180;503841;140596;100133251;653423;100131980;645402;55894;245910;1673;100131608;245908;100132396;503618;392188;100289462;245909;414325;10407;645836,22
1,-1,8,6920322,8130466,1210144,401447;503614;504180;503841;140596;100133251;653423;100131980;645402;55894;245910;1673;100131608;245908;100132396;503618;392188;100289462;245909;414325;10407;645836,22
1,-1,8,6920322,8130466,1210144,401447;503614;504180;503841;140596;100133251;653423;100131980;645402;55894;245910;1673;100131608;245908;100132396;503618;392188;100289462;245909;414325;10407;645836,22
1,-1,8,6920322,8130466,1210144,401447;503614;504180;503841;140596;100133251;653423;100131980;645402;55894;245910;1673;100131608;245908;100132396;503618;392188;100289462;245909;414325;10407;645836,22
1,-1,8,6920322,8130466,1210144,401447;503614;504180;503841;140596;100133251;653423;100131980;645402;55894;245910;1673;100131608;245908;100132396;503618;392188;100289462;245909;414325;10407;645836,22
1,-1,8,6942339,8130466,1188127,401447;503614;504180;503841;140596;100133251;653423;100131980;645402;55894;245910;1673;100131608;245908;100132396;503618;392188;100289462;245909;414325;10407;645836,22
1,-1,8,6942339,8130466,1188127,401447;503614;504180;503841;140596;100133251;653423;100131980;645402;55894;245910;1673;100131608;245908;100132396;503618;392188;100289462;245909;414325;10407;645836,22
1,-1,8,6942339,8130466,1188127,401447;503614;504180;503841;140596;100133251;653423;100131980;645402;55894;245910;1673;100131608;245908;100132396;503618;392188;100289462;245909;414325;10407;645836,22
1,-1,8,6942339,8130466,1188127,401447;503614;504180;503841;140596;100133251;653423;100131980;645402;55894;245910;1673;100131608;245908;100132396;503618;392188;100289462;245909;414325;10407;645836,22
1,-1,8,6942339,8130466,1188127,401447;503614;504180;503841;140596;100133251;653423;100131980;645402;55894;245910;1673;100131608;245908;100132396;503618;392188;100289462;245909;414325;10407;645836,22
1,-1,8,6942339,8130466,1188127,401447;503614;504180;503841;140596;100133251;653423;100131980;645402;55894;245910;1673;100131608;245908;100132396;503618;392188;100289462;245909;414325;10407;645836,22
1,-1,8,6942339,8130466,1188127,401447;503614;504180;503841;140596;100133251;653423;100131980;645402;55894;245910;1673;100131608;245908;100132396;503618;392188;100289462;245909;414325;10407;645836,22
1,-1,8,6942339,8130466,1188127,401447;503614;504180;503841;140596;100133251;653423;100131980;645402;55894;245910;1673;100131608;245908;100132396;503618;392188;100289462;245909;414325;10407;645836,22
1,-1,8,6942339,8130466,1188127,401447;503614;504180;503841;140596;100133251;653423;100131980;645402;55894;245910;1673;100131608;245908;100132396;503618;392188;100289462;245909;414325;10407;645836,22
1,-1,8,6942339,8130466,1188127,401447;503614;504180;503841;140596;100133251;653423;100131980;645402;55894;245910;1673;100131608;245908;100132396;503618;392188;100289462;245909;414325;10407;645836,22
1,-1,8,6942339,8130466,1188127,401447;503614;504180;503841;140596;100133251;653423;100131980;645402;55894;245910;1673;100131608;245908;100132396;503618;392188;100289462;245909;414325;10407;645836,22
1,-1,8,6942339,8130466,1188127,401447;503614;504180;503841;140596;100133251;653423;100131980;645402;55894;245910;1673;100131608;245908;100132396;503618;392188;100289462;245909;414325;10407;645836,22
1,-1,8,6942339,8130466,1188127,401447;503614;504180;503841;140596;100133251;653423;100131980;645402;55894;245910;1673;100131608;245908;100132396;503618;392188;100289462;245909;414325;10407;645836,22
1,-1,8,6942339,8130466,1188127,401447;503614;504180;503841;140596;100133251;653423;100131980;645402;55894;245910;1673;100131608;245908;100132396;503618;392188;100289462;245909;414325;10407;645836,22
1,-1,8,6942339,8130466,1188127,401447;503614;504180;503841;140596;100133251;653423;100131980;645402;55894;245910;1673;100131608;245908;100132396;503618;392188;100289462;245909;414325;10407;645836,22
1,-1,8,6942339,8130466,1188127,401447;503614;504180;503841;140596;100133251;653423;100131980;645402;55894;245910;1673;100131608;245908;100132396;503618;392188;100289462;245909;414325;10407;645836,22
1,-1,8,6942339,8130466,1188127,401447;503614;504180;503841;140596;100133251;653423;100131980;645402;55894;245910;1673;100131608;245908;100132396;503618;392188;100289462;245909;414325;10407;645836,22
1,-1,8,6942339,8130466,1188127,401447;503614;504180;503841;140596;100133251;653423;100131980;645402;55894;245910;1673;100131608;245908;100132396;503618;392188;100289462;245909;414325;10407;645836,22
1,-1,8,6942339,8130466,1188127,401447;503614;504180;503841;140596;100133251;653423;100131980;645402;55894;245910;1673;100131608;245908;100132396;503618;392188;100289462;245909;414325;10407;645836,22
1,-1,8,6942339,8130466,1188127,401447;503614;504180;503841;140596;100133251;653423;100131980;645402;55894;245910;1673;100131608;245908;100132396;503618;392188;100289462;245909;414325;10407;645836,22
1,-1,8,6942339,8130466,1188127,401447;503614;504180;503841;140596;100133251;653423;100131980;645402;55894;245910;1673;100131608;245908;100132396;503618;392188;100289462;245909;414325;10407;645836,22
1,-1,8,6942339,8130466,1188127,401447;503614;504180;503841;140596;100133251;653423;100131980;645402;55894;245910;1673;100131608;245908;100132396;503618;392188;100289462;245909;414325;10407;645836,22
1,-1,8,6942339,8130466,1188127,401447;503614;504180;503841;140596;100133251;653423;100131980;645402;55894;245910;1673;100131608;245908;100132396;503618;392188;100289462;245909;414325;10407;645836,22
1,-1,8,6942339,8130466,1188127,401447;503614;504180;503841;140596;100133251;653423;100131980;645402;55894;245910;1673;100131608;245908;100132396;503618;392188;100289462;245909;414325;10407;645836,22
1,-1,8,6942339,8130466,1188127,401447;503614;504180;503841;140596;100133251;653423;100131980;645402;55894;245910;1673;100131608;245908;100132396;503618;392188;100289462;245909;414325;10407;645836,22
1,-1,8,6942339,8130466,1188127,401447;503614;504180;503841;140596;100133251;653423;100131980;645402;55894;245910;1673;100131608;245908;100132396;503618;392188;100289462;245909;414325;10407;645836,22
1,-1,8,6942339,8130466,1188127,401447;503614;504180;503841;140596;100133251;653423;100131980;645402;55894;245910;1673;100131608;245908;100132396;503618;392188;100289462;245909;414325;10407;645836,22
1,-1,8,6942339,8130466,1188127,401447;503614;504180;503841;140596;100133251;653423;100131980;645402;55894;245910;1673;100131608;245908;100132396;503618;392188;100289462;245909;414325;10407;645836,22
1,-1,8,6942339,8130466,1188127,401447;503614;504180;503841;140596;100133251;653423;100131980;645402;55894;245910;1673;100131608;245908;100132396;503618;392188;100289462;245909;414325;10407;645836,22
1,-1,8,6942339,8130466,1188127,401447;503614;504180;503841;140596;100133251;653423;100131980;645402;55894;245910;1673;100131608;245908;100132396;503618;392188;100289462;245909;414325;10407;645836,22
1,-1,8,6942339,8130466,1188127,401447;503614;504180;503841;140596;100133251;653423;100131980;645402;55894;245910;1673;100131608;245908;100132396;503618;392188;100289462;245909;414325;10407;645836,22
1,-1,8,6942339,8130466,1188127,401447;503614;504180;503841;140596;100133251;653423;100131980;645402;55894;245910;1673;100131608;245908;100132396;503618;392188;100289462;245909;414325;10407;645836,22
1,-1,8,6942339,8130466,1188127,401447;503614;504180;503841;140596;100133251;653423;100131980;645402;55894;245910;1673;100131608;245908;100132396;503618;392188;100289462;245909;414325;10407;645836,22
1,-1,8,6942339,8130466,1188127,401447;503614;504180;503841;140596;100133251;653423;100131980;645402;55894;245910;1673;100131608;245908;100132396;503618;392188;100289462;245909;414325;10407;645836,22
1,-1,8,6942339,8130466,1188127,401447;503614;504180;503841;140596;100133251;653423;100131980;645402;55894;245910;1673;100131608;245908;100132396;503618;392188;100289462;245909;414325;10407;645836,22
1,-1,8,6942339,8130466,1188127,401447;503614;504180;503841;140596;100133251;653423;100131980;645402;55894;245910;1673;100131608;245908;100132396;503618;392188;100289462;245909;414325;10407;645836,22
1,-1,8,6942339,8130466,1188127,401447;503614;504180;503841;140596;100133251;653423;100131980;645402;55894;245910;1673;100131608;245908;100132396;503618;392188;100289462;245909;414325;10407;645836,22
1,-1,8,6942339,8130466,1188127,401447;503614;504180;503841;140596;100133251;653423;100131980;645402;55894;245910;1673;100131608;245908;100132396;503618;392188;100289462;245909;414325;10407;645836,22
1,-1,8,6942339,8130466,1188127,401447;503614;504180;503841;140596;100133251;653423;100131980;645402;55894;245910;1673;100131608;245908;100132396;503618;392188;100289462;245909;414325;10407;645836,22
1,-1,8,6942339,8130466,1188127,401447;503614;504180;503841;140596;100133251;653423;100131980;645402;55894;245910;1673;100131608;245908;100132396;503618;392188;100289462;245909;414325;10407;645836,22
1,-1,8,6942339,8130466,1188127,401447;503614;504180;503841;140596;100133251;653423;100131980;645402;55894;245910;1673;100131608;245908;100132396;503618;392188;100289462;245909;414325;10407;645836,22
1,-1,8,6942339,8130466,1188127,401447;503614;504180;503841;140596;100133251;653423;100131980;645402;55894;245910;1673;100131608;245908;100132396;503618;392188;100289462;245909;414325;10407;645836,22
1,-1,8,6942339,8130466,1188127,401447;503614;504180;503841;140596;100133251;653423;100131980;645402;55894;245910;1673;100131608;245908;100132396;503618;392188;100289462;245909;414325;10407;645836,22
1,-1,8,6942339,8130466,1188127,401447;503614;504180;503841;140596;100133251;653423;100131980;645402;55894;245910;1673;100131608;245908;100132396;503618;392188;100289462;245909;414325;10407;645836,22
1,-1,8,6942339,8130466,1188127,401447;503614;504180;503841;140596;100133251;653423;100131980;645402;55894;245910;1673;100131608;245908;100132396;503618;392188;100289462;245909;414325;10407;645836,22
1,-1,8,6942339,8130466,1188127,401447;503614;504180;503841;140596;100133251;653423;100131980;645402;55894;245910;1673;100131608;245908;100132396;503618;392188;100289462;245909;414325;10407;645836,22
1,-1,8,6942339,8130466,1188127,401447;503614;504180;503841;140596;100133251;653423;100131980;645402;55894;245910;1673;100131608;245908;100132396;503618;392188;100289462;245909;414325;10407;645836,22
1,-1,8,6942339,8130466,1188127,401447;503614;504180;503841;140596;100133251;653423;100131980;645402;55894;245910;1673;100131608;245908;100132396;503618;392188;100289462;245909;414325;10407;645836,22
1,-1,8,6942339,8130466,1188127,401447;503614;504180;503841;140596;100133251;653423;100131980;645402;55894;245910;1673;100131608;245908;100132396;503618;392188;100289462;245909;414325;10407;645836,22
1,-1,8,6942339,8130466,1188127,401447;503614;504180;503841;140596;100133251;653423;100131980;645402;55894;245910;1673;100131608;245908;100132396;503618;392188;100289462;245909;414325;10407;645836,22
1,-1,8,6942339,8130466,1188127,401447;503614;504180;503841;140596;100133251;653423;100131980;645402;55894;245910;1673;100131608;245908;100132396;503618;392188;100289462;245909;414325;10407;645836,22
1,-1,8,6942339,8130466,1188127,401447;503614;504180;503841;140596;100133251;653423;100131980;645402;55894;245910;1673;100131608;245908;100132396;503618;392188;100289462;245909;414325;10407;645836,22
1,-1,8,6942339,8130466,1188127,401447;503614;504180;503841;140596;100133251;653423;100131980;645402;55894;245910;1673;100131608;245908;100132396;503618;392188;100289462;245909;414325;10407;645836,22
1,-1,8,6942339,8130466,1188127,401447;503614;504180;503841;140596;100133251;653423;100131980;645402;55894;245910;1673;100131608;245908;100132396;503618;392188;100289462;245909;414325;10407;645836,22
1,-1,8,6942339,8130466,1188127,401447;503614;504180;503841;140596;100133251;653423;100131980;645402;55894;245910;1673;100131608;245908;100132396;503618;392188;100289462;245909;414325;10407;645836,22
1,-1,8,6942339,8130466,1188127,401447;503614;504180;503841;140596;100133251;653423;100131980;645402;55894;245910;1673;100131608;245908;100132396;503618;392188;100289462;245909;414325;10407;645836,22
1,-1,8,6942339,8130466,1188127,401447;503614;504180;503841;140596;100133251;653423;100131980;645402;55894;245910;1673;100131608;245908;100132396;503618;392188;100289462;245909;414325;10407;645836,22
1,-1,8,6942339,8130466,1188127,401447;503614;504180;503841;140596;100133251;653423;100131980;645402;55894;245910;1673;100131608;245908;100132396;503618;392188;100289462;245909;414325;10407;645836,22
1,-1,8,6942339,8130466,1188127,401447;503614;504180;503841;140596;100133251;653423;100131980;645402;55894;245910;1673;100131608;245908;100132396;503618;392188;100289462;245909;414325;10407;645836,22
1,-1,8,6942339,8130466,1188127,401447;503614;504180;503841;140596;100133251;653423;100131980;645402;55894;245910;1673;100131608;245908;100132396;503618;392188;100289462;245909;414325;10407;645836,22
1,-1,8,6942339,8130466,1188127,401447;503614;504180;503841;140596;100133251;653423;100131980;645402;55894;245910;1673;100131608;245908;100132396;503618;392188;100289462;245909;414325;10407;645836,22
1,-1,8,6942339,8130466,1188127,401447;503614;504180;503841;140596;100133251;653423;100131980;645402;55894;245910;1673;100131608;245908;100132396;503618;392188;100289462;245909;414325;10407;645836,22
1,-1,8,6942339,8130466,1188127,401447;503614;504180;503841;140596;100133251;653423;100131980;645402;55894;245910;1673;100131608;245908;100132396;503618;392188;100289462;245909;414325;10407;645836,22
1,-1,8,6942339,8130466,1188127,401447;503614;504180;503841;140596;100133251;653423;100131980;645402;55894;245910;1673;100131608;245908;100132396;503618;392188;100289462;245909;414325;10407;645836,22
1,-1,8,6942339,8130466,1188127,401447;503614;504180;503841;140596;100133251;653423;100131980;645402;55894;245910;1673;100131608;245908;100132396;503618;392188;100289462;245909;414325;10407;645836,22
1,-1,8,6942339,8130466,1188127,401447;503614;504180;503841;140596;100133251;653423;100131980;645402;55894;245910;1673;100131608;245908;100132396;503618;392188;100289462;245909;414325;10407;645836,22
1,-1,8,6942339,8130466,1188127,401447;503614;504180;503841;140596;100133251;653423;100131980;645402;55894;245910;1673;100131608;245908;100132396;503618;392188;100289462;245909;414325;10407;645836,22
1,-1,8,6942339,8130466,1188127,401447;503614;504180;503841;140596;100133251;653423;100131980;645402;55894;245910;1673;100131608;245908;100132396;503618;392188;100289462;245909;414325;10407;645836,22
1,-1,8,6942339,8130466,1188127,401447;503614;504180;503841;140596;100133251;653423;100131980;645402;55894;245910;1673;100131608;245908;100132396;503618;392188;100289462;245909;414325;10407;645836,22
1,-1,8,6942339,8130466,1188127,401447;503614;504180;503841;140596;100133251;653423;100131980;645402;55894;245910;1673;100131608;245908;100132396;503618;392188;100289462;245909;414325;10407;645836,22
1,-1,8,6942339,8130466,1188127,401447;503614;504180;503841;140596;100133251;653423;100131980;645402;55894;245910;1673;100131608;245908;100132396;503618;392188;100289462;245909;414325;10407;645836,22
1,-1,8,6942339,8130466,1188127,401447;503614;504180;503841;140596;100133251;653423;100131980;645402;55894;245910;1673;100131608;245908;100132396;503618;392188;100289462;245909;414325;10407;645836,22
1,-1,8,6942339,8130466,1188127,401447;503614;504180;503841;140596;100133251;653423;100131980;645402;55894;245910;1673;100131608;245908;100132396;503618;392188;100289462;245909;414325;10407;645836,22
1,-1,8,6942339,8130466,1188127,401447;503614;504180;503841;140596;100133251;653423;100131980;645402;55894;245910;1673;100131608;245908;100132396;503618;392188;100289462;245909;414325;10407;645836,22
1,-1,8,6942339,8130466,1188127,401447;503614;504180;503841;140596;100133251;653423;100131980;645402;55894;245910;1673;100131608;245908;100132396;503618;392188;100289462;245909;414325;10407;645836,22
1,-1,8,6942339,8130466,1188127,401447;503614;504180;503841;140596;100133251;653423;100131980;645402;55894;245910;1673;100131608;245908;100132396;503618;392188;100289462;245909;414325;10407;645836,22
1,-1,8,6942339,8130466,1188127,401447;503614;504180;503841;140596;100133251;653423;100131980;645402;55894;245910;1673;100131608;245908;100132396;503618;392188;100289462;245909;414325;10407;645836,22
1,-1,8,6942339,8130466,1188127,401447;503614;504180;503841;140596;100133251;653423;100131980;645402;55894;245910;1673;100131608;245908;100132396;503618;392188;100289462;245909;414325;10407;645836,22
1,-1,8,6942339,8130466,1188127,401447;503614;504180;503841;140596;100133251;653423;100131980;645402;55894;245910;1673;100131608;245908;100132396;503618;392188;100289462;245909;414325;10407;645836,22
1,-1,8,6942339,8130466,1188127,401447;503614;504180;503841;140596;100133251;653423;100131980;645402;55894;245910;1673;100131608;245908;100132396;503618;392188;100289462;245909;414325;10407;645836,22
1,-1,8,6942339,8130466,1188127,401447;503614;504180;503841;140596;100133251;653423;100131980;645402;55894;245910;1673;100131608;245908;100132396;503618;392188;100289462;245909;414325;10407;645836,22
1,-1,8,6942339,8130466,1188127,401447;503614;504180;503841;140596;100133251;653423;100131980;645402;55894;245910;1673;100131608;245908;100132396;503618;392188;100289462;245909;414325;10407;645836,22
1,-1,8,6942339,8130466,1188127,401447;503614;504180;503841;140596;100133251;653423;100131980;645402;55894;245910;1673;100131608;245908;100132396;503618;392188;100289462;245909;414325;10407;645836,22
1,-1,8,6942339,8130466,1188127,401447;503614;504180;503841;140596;100133251;653423;100131980;645402;55894;245910;1673;100131608;245908;100132396;503618;392188;100289462;245909;414325;10407;645836,22
1,-1,8,6942339,8130466,1188127,401447;503614;504180;503841;140596;100133251;653423;100131980;645402;55894;245910;1673;100131608;245908;100132396;503618;392188;100289462;245909;414325;10407;645836,22
1,-1,8,6942339,8130466,1188127,401447;503614;504180;503841;140596;100133251;653423;100131980;645402;55894;245910;1673;100131608;245908;100132396;503618;392188;100289462;245909;414325;10407;645836,22
1,-1,8,6942339,8130466,1188127,401447;503614;504180;503841;140596;100133251;653423;100131980;645402;55894;245910;1673;100131608;245908;100132396;503618;392188;100289462;245909;414325;10407;645836,22
1,-1,8,6942339,8130466,1188127,401447;503614;504180;503841;140596;100133251;653423;100131980;645402;55894;245910;1673;100131608;245908;100132396;503618;392188;100289462;245909;414325;10407;645836,22
1,-1,8,6942339,8130466,1188127,401447;503614;504180;503841;140596;100133251;653423;100131980;645402;55894;245910;1673;100131608;245908;100132396;503618;392188;100289462;245909;414325;10407;645836,22
1,-1,8,6942339,8130466,1188127,401447;503614;504180;503841;140596;100133251;653423;100131980;645402;55894;245910;1673;100131608;245908;100132396;503618;392188;100289462;245909;414325;10407;645836,22
1,-1,8,6942339,8130466,1188127,401447;503614;504180;503841;140596;100133251;653423;100131980;645402;55894;245910;1673;100131608;245908;100132396;503618;392188;100289462;245909;414325;10407;645836,22
1,-1,8,6942339,8130466,1188127,401447;503614;504180;503841;140596;100133251;653423;100131980;645402;55894;245910;1673;100131608;245908;100132396;503618;392188;100289462;245909;414325;10407;645836,22
1,-1,8,6942339,8130466,1188127,401447;503614;504180;503841;140596;100133251;653423;100131980;645402;55894;245910;1673;100131608;245908;100132396;503618;392188;100289462;245909;414325;10407;645836,22
1,-1,8,6942339,8130466,1188127,401447;503614;504180;503841;140596;100133251;653423;100131980;645402;55894;245910;1673;100131608;245908;100132396;503618;392188;100289462;245909;414325;10407;645836,22
1,-1,8,6942339,8130466,1188127,401447;503614;504180;503841;140596;100133251;653423;100131980;645402;55894;245910;1673;100131608;245908;100132396;503618;392188;100289462;245909;414325;10407;645836,22
1,-1,8,6942339,8130466,1188127,401447;503614;504180;503841;140596;100133251;653423;100131980;645402;55894;245910;1673;100131608;245908;100132396;503618;392188;100289462;245909;414325;10407;645836,22
1,-1,8,6942339,8130466,1188127,401447;503614;504180;503841;140596;100133251;653423;100131980;645402;55894;245910;1673;100131608;245908;100132396;503618;392188;100289462;245909;414325;10407;645836,22
1,-1,8,6942339,8130466,1188127,401447;503614;504180;503841;140596;100133251;653423;100131980;645402;55894;245910;1673;100131608;245908;100132396;503618;392188;100289462;245909;414325;10407;645836,22
1,-1,8,6942339,8130466,1188127,401447;503614;504180;503841;140596;100133251;653423;100131980;645402;55894;245910;1673;100131608;245908;100132396;503618;392188;100289462;245909;414325;10407;645836,22
1,-1,8,6942339,8130466,1188127,401447;503614;504180;503841;140596;100133251;653423;100131980;645402;55894;245910;1673;100131608;245908;100132396;503618;392188;100289462;245909;414325;10407;645836,22
1,-1,8,6942339,8130466,1188127,401447;503614;504180;503841;140596;100133251;653423;100131980;645402;55894;245910;1673;100131608;245908;100132396;503618;392188;100289462;245909;414325;10407;645836,22
1,-1,8,6942339,8130466,1188127,401447;503614;504180;503841;140596;100133251;653423;100131980;645402;55894;245910;1673;100131608;245908;100132396;503618;392188;100289462;245909;414325;10407;645836,22
1,-1,8,6942339,8130466,1188127,401447;503614;504180;503841;140596;100133251;653423;100131980;645402;55894;245910;1673;100131608;245908;100132396;503618;392188;100289462;245909;414325;10407;645836,22
1,-1,8,6942339,8130466,1188127,401447;503614;504180;503841;140596;100133251;653423;100131980;645402;55894;245910;1673;100131608;245908;100132396;503618;392188;100289462;245909;414325;10407;645836,22
1,-1,8,6942339,8130466,1188127,401447;503614;504180;503841;140596;100133251;653423;100131980;645402;55894;245910;1673;100131608;245908;100132396;503618;392188;100289462;245909;414325;10407;645836,22
1,-1,8,6942339,8130466,1188127,401447;503614;504180;503841;140596;100133251;653423;100131980;645402;55894;245910;1673;100131608;245908;100132396;503618;392188;100289462;245909;414325;10407;645836,22
1,-1,8,6942339,8130466,1188127,401447;503614;504180;503841;140596;100133251;653423;100131980;645402;55894;245910;1673;100131608;245908;100132396;503618;392188;100289462;245909;414325;10407;645836,22
1,-1,8,6942339,8130466,1188127,401447;503614;504180;503841;140596;100133251;653423;100131980;645402;55894;245910;1673;100131608;245908;100132396;503618;392188;100289462;245909;414325;10407;645836,22
1,-1,8,6942339,8130466,1188127,401447;503614;504180;503841;140596;100133251;653423;100131980;645402;55894;245910;1673;100131608;245908;100132396;503618;392188;100289462;245909;414325;10407;645836,22
1,-1,8,6942339,8130466,1188127,401447;503614;504180;503841;140596;100133251;653423;100131980;645402;55894;245910;1673;100131608;245908;100132396;503618;392188;100289462;245909;414325;10407;645836,22
1,-1,8,6942339,8130466,1188127,401447;503614;504180;503841;140596;100133251;653423;100131980;645402;55894;245910;1673;100131608;245908;100132396;503618;392188;100289462;245909;414325;10407;645836,22
1,-1,8,6942339,8130466,1188127,401447;503614;504180;503841;140596;100133251;653423;100131980;645402;55894;245910;1673;100131608;245908;100132396;503618;392188;100289462;245909;414325;10407;645836,22
1,-1,8,6942339,8130466,1188127,401447;503614;504180;503841;140596;100133251;653423;100131980;645402;55894;245910;1673;100131608;245908;100132396;503618;392188;100289462;245909;414325;10407;645836,22
1,-1,8,6942339,8130466,1188127,401447;503614;504180;503841;140596;100133251;653423;100131980;645402;55894;245910;1673;100131608;245908;100132396;503618;392188;100289462;245909;414325;10407;645836,22
1,-1,8,6942339,8130466,1188127,401447;503614;504180;503841;140596;100133251;653423;100131980;645402;55894;245910;1673;100131608;245908;100132396;503618;392188;100289462;245909;414325;10407;645836,22
1,-1,8,6942339,8130466,1188127,401447;503614;504180;503841;140596;100133251;653423;100131980;645402;55894;245910;1673;100131608;245908;100132396;503618;392188;100289462;245909;414325;10407;645836,22
1,-1,8,6942339,8130466,1188127,401447;503614;504180;503841;140596;100133251;653423;100131980;645402;55894;245910;1673;100131608;245908;100132396;503618;392188;100289462;245909;414325;10407;645836,22
1,-1,8,6942339,8130466,1188127,401447;503614;504180;503841;140596;100133251;653423;100131980;645402;55894;245910;1673;100131608;245908;100132396;503618;392188;100289462;245909;414325;10407;645836,22
1,-1,8,6942339,8130466,1188127,401447;503614;504180;503841;140596;100133251;653423;100131980;645402;55894;245910;1673;100131608;245908;100132396;503618;392188;100289462;245909;414325;10407;645836,22
1,-1,8,6942339,8130466,1188127,401447;503614;504180;503841;140596;100133251;653423;100131980;645402;55894;245910;1673;100131608;245908;100132396;503618;392188;100289462;245909;414325;10407;645836,22
1,-1,8,6942339,8130466,1188127,401447;503614;504180;503841;140596;100133251;653423;100131980;645402;55894;245910;1673;100131608;245908;100132396;503618;392188;100289462;245909;414325;10407;645836,22
1,-1,8,6942339,8130466,1188127,401447;503614;504180;503841;140596;100133251;653423;100131980;645402;55894;245910;1673;100131608;245908;100132396;503618;392188;100289462;245909;414325;10407;645836,22
1,-1,8,6942339,8130466,1188127,401447;503614;504180;503841;140596;100133251;653423;100131980;645402;55894;245910;1673;100131608;245908;100132396;503618;392188;100289462;245909;414325;10407;645836,22
1,-1,8,6942339,8130466,1188127,401447;503614;504180;503841;140596;100133251;653423;100131980;645402;55894;245910;1673;100131608;245908;100132396;503618;392188;100289462;245909;414325;10407;645836,22
1,-1,8,6942339,8130466,1188127,401447;503614;504180;503841;140596;100133251;653423;100131980;645402;55894;245910;1673;100131608;245908;100132396;503618;392188;100289462;245909;414325;10407;645836,22
1,-1,8,6942339,8130466,1188127,401447;503614;504180;503841;140596;100133251;653423;100131980;645402;55894;245910;1673;100131608;245908;100132396;503618;392188;100289462;245909;414325;10407;645836,22
1,-1,8,6942339,8130466,1188127,401447;503614;504180;503841;140596;100133251;653423;100131980;645402;55894;245910;1673;100131608;245908;100132396;503618;392188;100289462;245909;414325;10407;645836,22
1,-1,8,6942339,8130466,1188127,401447;503614;504180;503841;140596;100133251;653423;100131980;645402;55894;245910;1673;100131608;245908;100132396;503618;392188;100289462;245909;414325;10407;645836,22
1,-1,8,6942339,8130466,1188127,401447;503614;504180;503841;140596;100133251;653423;100131980;645402;55894;245910;1673;100131608;245908;100132396;503618;392188;100289462;245909;414325;10407;645836,22
1,-1,8,6942339,8130466,1188127,401447;503614;504180;503841;140596;100133251;653423;100131980;645402;55894;245910;1673;100131608;245908;100132396;503618;392188;100289462;245909;414325;10407;645836,22
1,-1,8,6942339,8130466,1188127,401447;503614;504180;503841;140596;100133251;653423;100131980;645402;55894;245910;1673;100131608;245908;100132396;503618;392188;100289462;245909;414325;10407;645836,22
1,-1,8,6942339,8130466,1188127,401447;503614;504180;503841;140596;100133251;653423;100131980;645402;55894;245910;1673;100131608;245908;100132396;503618;392188;100289462;245909;414325;10407;645836,22
1,-1,8,6942339,8130466,1188127,401447;503614;504180;503841;140596;100133251;653423;100131980;645402;55894;245910;1673;100131608;245908;100132396;503618;392188;100289462;245909;414325;10407;645836,22
1,-1,8,6942339,8130466,1188127,401447;503614;504180;503841;140596;100133251;653423;100131980;645402;55894;245910;1673;100131608;245908;100132396;503618;392188;100289462;245909;414325;10407;645836,22
1,-1,8,6942339,8130466,1188127,401447;503614;504180;503841;140596;100133251;653423;100131980;645402;55894;245910;1673;100131608;245908;100132396;503618;392188;100289462;245909;414325;10407;645836,22
1,-1,8,6942339,8130466,1188127,401447;503614;504180;503841;140596;100133251;653423;100131980;645402;55894;245910;1673;100131608;245908;100132396;503618;392188;100289462;245909;414325;10407;645836,22
1,-1,8,6942339,8130466,1188127,401447;503614;504180;503841;140596;100133251;653423;100131980;645402;55894;245910;1673;100131608;245908;100132396;503618;392188;100289462;245909;414325;10407;645836,22
1,-1,8,6942339,8130466,1188127,401447;503614;504180;503841;140596;100133251;653423;100131980;645402;55894;245910;1673;100131608;245908;100132396;503618;392188;100289462;245909;414325;10407;645836,22
1,-1,8,6942339,8130466,1188127,401447;503614;504180;503841;140596;100133251;653423;100131980;645402;55894;245910;1673;100131608;245908;100132396;503618;392188;100289462;245909;414325;10407;645836,22
1,-1,8,6942339,8130466,1188127,401447;503614;504180;503841;140596;100133251;653423;100131980;645402;55894;245910;1673;100131608;245908;100132396;503618;392188;100289462;245909;414325;10407;645836,22
1,-1,8,6942339,8130466,1188127,401447;503614;504180;503841;140596;100133251;653423;100131980;645402;55894;245910;1673;100131608;245908;100132396;503618;392188;100289462;245909;414325;10407;645836,22
1,-1,8,6942339,8130466,1188127,401447;503614;504180;503841;140596;100133251;653423;100131980;645402;55894;245910;1673;100131608;245908;100132396;503618;392188;100289462;245909;414325;10407;645836,22
1,-1,8,6942339,8130466,1188127,401447;503614;504180;503841;140596;100133251;653423;100131980;645402;55894;245910;1673;100131608;245908;100132396;503618;392188;100289462;245909;414325;10407;645836,22
1,-1,8,6942339,8130466,1188127,401447;503614;504180;503841;140596;100133251;653423;100131980;645402;55894;245910;1673;100131608;245908;100132396;503618;392188;100289462;245909;414325;10407;645836,22
1,-1,8,6942339,8130466,1188127,401447;503614;504180;503841;140596;100133251;653423;100131980;645402;55894;245910;1673;100131608;245908;100132396;503618;392188;100289462;245909;414325;10407;645836,22
1,-1,8,6942339,8130466,1188127,401447;503614;504180;503841;140596;100133251;653423;100131980;645402;55894;245910;1673;100131608;245908;100132396;503618;392188;100289462;245909;414325;10407;645836,22
1,-1,8,6942339,8130466,1188127,401447;503614;504180;503841;140596;100133251;653423;100131980;645402;55894;245910;1673;100131608;245908;100132396;503618;392188;100289462;245909;414325;10407;645836,22
1,-1,8,6942339,8130466,1188127,401447;503614;504180;503841;140596;100133251;653423;100131980;645402;55894;245910;1673;100131608;245908;100132396;503618;392188;100289462;245909;414325;10407;645836,22
1,-1,8,6942339,8130466,1188127,401447;503614;504180;503841;140596;100133251;653423;100131980;645402;55894;245910;1673;100131608;245908;100132396;503618;392188;100289462;245909;414325;10407;645836,22
1,-1,8,6942339,8130466,1188127,401447;503614;504180;503841;140596;100133251;653423;100131980;645402;55894;245910;1673;100131608;245908;100132396;503618;392188;100289462;245909;414325;10407;645836,22
1,-1,8,6942339,8130466,1188127,401447;503614;504180;503841;140596;100133251;653423;100131980;645402;55894;245910;1673;100131608;245908;100132396;503618;392188;100289462;245909;414325;10407;645836,22
1,-1,8,6942339,8130466,1188127,401447;503614;504180;503841;140596;100133251;653423;100131980;645402;55894;245910;1673;100131608;245908;100132396;503618;392188;100289462;245909;414325;10407;645836,22
1,-1,8,6942339,8130466,1188127,401447;503614;504180;503841;140596;100133251;653423;100131980;645402;55894;245910;1673;100131608;245908;100132396;503618;392188;100289462;245909;414325;10407;645836,22
1,-1,8,6942339,8130466,1188127,401447;503614;504180;503841;140596;100133251;653423;100131980;645402;55894;245910;1673;100131608;245908;100132396;503618;392188;100289462;245909;414325;10407;645836,22
1,-1,8,6942339,8130466,1188127,401447;503614;504180;503841;140596;100133251;653423;100131980;645402;55894;245910;1673;100131608;245908;100132396;503618;392188;100289462;245909;414325;10407;645836,22
1,-1,8,6942339,8130466,1188127,401447;503614;504180;503841;140596;100133251;653423;100131980;645402;55894;245910;1673;100131608;245908;100132396;503618;392188;100289462;245909;414325;10407;645836,22
1,-1,8,6942339,8130466,1188127,401447;503614;504180;503841;140596;100133251;653423;100131980;645402;55894;245910;1673;100131608;245908;100132396;503618;392188;100289462;245909;414325;10407;645836,22
1,-1,8,6942339,8130466,1188127,401447;503614;504180;503841;140596;100133251;653423;100131980;645402;55894;245910;1673;100131608;245908;100132396;503618;392188;100289462;245909;414325;10407;645836,22
1,-1,8,6942339,8130466,1188127,401447;503614;504180;503841;140596;100133251;653423;100131980;645402;55894;245910;1673;100131608;245908;100132396;503618;392188;100289462;245909;414325;10407;645836,22
1,-1,8,6942339,8130466,1188127,401447;503614;504180;503841;140596;100133251;653423;100131980;645402;55894;245910;1673;100131608;245908;100132396;503618;392188;100289462;245909;414325;10407;645836,22
1,-1,8,6942339,8130466,1188127,401447;503614;504180;503841;140596;100133251;653423;100131980;645402;55894;245910;1673;100131608;245908;100132396;503618;392188;100289462;245909;414325;10407;645836,22
1,-1,8,6942339,8130466,1188127,401447;503614;504180;503841;140596;100133251;653423;100131980;645402;55894;245910;1673;100131608;245908;100132396;503618;392188;100289462;245909;414325;10407;645836,22
1,-1,8,6942339,8130466,1188127,401447;503614;504180;503841;140596;100133251;653423;100131980;645402;55894;245910;1673;100131608;245908;100132396;503618;392188;100289462;245909;414325;10407;645836,22
1,-1,8,6942339,8130466,1188127,401447;503614;504180;503841;140596;100133251;653423;100131980;645402;55894;245910;1673;100131608;245908;100132396;503618;392188;100289462;245909;414325;10407;645836,22
1,-1,8,6942339,8130466,1188127,401447;503614;504180;503841;140596;100133251;653423;100131980;645402;55894;245910;1673;100131608;245908;100132396;503618;392188;100289462;245909;414325;10407;645836,22
1,-1,8,6942339,8130466,1188127,401447;503614;504180;503841;140596;100133251;653423;100131980;645402;55894;245910;1673;100131608;245908;100132396;503618;392188;100289462;245909;414325;10407;645836,22
1,-1,8,6942339,8130466,1188127,401447;503614;504180;503841;140596;100133251;653423;100131980;645402;55894;245910;1673;100131608;245908;100132396;503618;392188;100289462;245909;414325;10407;645836,22
1,-1,8,6942339,8130466,1188127,401447;503614;504180;503841;140596;100133251;653423;100131980;645402;55894;245910;1673;100131608;245908;100132396;503618;392188;100289462;245909;414325;10407;645836,22
1,-1,8,6942339,8130466,1188127,401447;503614;504180;503841;140596;100133251;653423;100131980;645402;55894;245910;1673;100131608;245908;100132396;503618;392188;100289462;245909;414325;10407;645836,22
1,-1,8,6942339,8130466,1188127,401447;503614;504180;503841;140596;100133251;653423;100131980;645402;55894;245910;1673;100131608;245908;100132396;503618;392188;100289462;245909;414325;10407;645836,22
1,-1,8,6942339,8145238,1202899,401447;503614;504180;503841;140596;100133251;653423;100131980;645402;55894;245910;1673;100131608;245908;100132396;503618;392188;100289462;245909;414325;10407;645836,22
1,-1,8,6942339,8145238,1202899,401447;503614;504180;503841;140596;100133251;653423;100131980;645402;55894;245910;1673;100131608;245908;100132396;503618;392188;100289462;245909;414325;10407;645836,22
1,-1,8,6942339,8145238,1202899,401447;503614;504180;503841;140596;100133251;653423;100131980;645402;55894;245910;1673;100131608;245908;100132396;503618;392188;100289462;245909;414325;10407;645836,22
1,-1,8,6942339,8145238,1202899,401447;503614;504180;503841;140596;100133251;653423;100131980;645402;55894;245910;1673;100131608;245908;100132396;503618;392188;100289462;245909;414325;10407;645836,22
1,-1,8,6942339,8145238,1202899,401447;503614;504180;503841;140596;100133251;653423;100131980;645402;55894;245910;1673;100131608;245908;100132396;503618;392188;100289462;245909;414325;10407;645836,22
1,-1,8,6942339,8167155,1224816,401447;503614;504180;503841;140596;100133251;653423;100131980;645402;55894;245910;1673;100131608;245908;100132396;503618;392188;100289462;245909;414325;10407;645836,22
1,-1,8,6942339,8167155,1224816,401447;503614;504180;503841;140596;100133251;653423;100131980;645402;55894;245910;1673;100131608;245908;100132396;503618;392188;100289462;245909;414325;10407;645836,22
1,-1,8,6942339,8167155,1224816,401447;503614;504180;503841;140596;100133251;653423;100131980;645402;55894;245910;1673;100131608;245908;100132396;503618;392188;100289462;245909;414325;10407;645836,22
1,-1,8,6942339,8167155,1224816,401447;503614;504180;503841;140596;100133251;653423;100131980;645402;55894;245910;1673;100131608;245908;100132396;503618;392188;100289462;245909;414325;10407;645836,22
1,-1,8,6942339,8167155,1224816,401447;503614;504180;503841;140596;100133251;653423;100131980;645402;55894;245910;1673;100131608;245908;100132396;503618;392188;100289462;245909;414325;10407;645836,22
1,1,8,6961183,12157391,5196208,401447;392197;1508;377630;83650;504180;503841;203076;83648;55894;245910;613209;157285;252969;245908;100132396;503618;54984;392188;100289462;4482;613211;203074;245909;90459;503614;140596;83595;100133267;100133251;653423;100131980;645402;2626;85002;613210;137075;1673;728957;100131608;640;66036;286046;79660;2222;8658;9258;414325;94137;10407;645836,51
1,-1,8,6961220,8145238,1184018,401447;503614;504180;503841;140596;100133251;653423;100131980;645402;55894;245910;1673;100131608;245908;100132396;503618;392188;100289462;245909;414325;10407;645836,22
1,-1,8,6961220,8145238,1184018,401447;503614;504180;503841;140596;100133251;653423;100131980;645402;55894;245910;1673;100131608;245908;100132396;503618;392188;100289462;245909;414325;10407;645836,22
1,-1,8,6961220,8145238,1184018,401447;503614;504180;503841;140596;100133251;653423;100131980;645402;55894;245910;1673;100131608;245908;100132396;503618;392188;100289462;245909;414325;10407;645836,22
1,-1,8,6961220,8167155,1205935,401447;503614;504180;503841;140596;100133251;653423;100131980;645402;55894;245910;1673;100131608;245908;100132396;503618;392188;100289462;245909;414325;10407;645836,22
1,1,8,6999219,38553064,31553845,377630;1508;83650;2053;27257;55806;504180;8756;84513;54793;286097;389643;619373;245910;10671;245908;51669;503618;155;9070;100289462;4482;7976;203074;4747;1960;2137;6570;1135;55246;5533;541565;51312;57509;645402;2626;613210;56154;157855;11030;8658;9258;2267;414325;137868;645836;4481;11178;80005;23484;63898;203076;427;1191;83648;55756;55872;79618;2260;613209;81551;157285;2961;252969;100132396;6770;392188;5157;64641;23516;148;84549;5108;6781;5368;64236;25960;140596;100133267;10395;100133251;85002;51435;6440;2936;91694;2185;9108;137970;4023;137075;1846;4017;728957;100131608;286046;79660;2222;8793;29883;84750;661;2039;55174;7991;157313;9;79845;29942;7993;503841;389649;1978;157574;9796;7486;1808;9530;203069;2675;157310;54984;23221;137994;55790;245909;90459;5516;5520;26281;137492;23087;10174;8795;51201;11212;80139;503614;83595;653423;100131980;55124;23362;8797;1673;4824;66036;8794;157773;11160;401447;392197;55909;80346;9583;245940;286133;649;55894;10361;57805;91782;2796;55290;80185;10;78986;27299;10863;613211;10687;157570;55140;665;4741;9046;23039;23259;79873;137814;55893;23303;526;203190;100507341;57604;3084;640;137362;80223;6542;8822;653333;94137;10407;54904;64760,197
1,-1,8,7000480,7752596,752116,401447;503614;504180;503841;140596;100133251;653423;100131980;645402;55894;245910;1673;100131608;245908;503618;100289462;245909;414325;10407,19
1,-1,8,7000481,8054556,1054075,401447;503614;504180;503841;140596;100133251;653423;100131980;645402;55894;245910;1673;100131608;245908;100132396;503618;392188;100289462;245909;414325;10407;645836,22
1,-1,8,7025440,7891743,866303,401447;503614;504180;503841;140596;100133251;653423;100131980;645402;55894;245910;1673;100131608;245908;100132396;503618;392188;100289462;245909;414325;10407;645836,22
1,-1,8,7025440,7927953,902513,401447;503614;504180;503841;140596;100133251;653423;100131980;645402;55894;245910;1673;100131608;245908;100132396;503618;392188;100289462;245909;414325;10407;645836,22
1,-1,8,7025440,7957093,931653,401447;503614;504180;503841;140596;100133251;653423;100131980;645402;55894;245910;1673;100131608;245908;100132396;503618;392188;100289462;245909;414325;10407;645836,22
1,-1,8,7025440,7957093,931653,401447;503614;504180;503841;140596;100133251;653423;100131980;645402;55894;245910;1673;100131608;245908;100132396;503618;392188;100289462;245909;414325;10407;645836,22
1,-1,8,7025440,7977100,951660,401447;503614;504180;503841;140596;100133251;653423;100131980;645402;55894;245910;1673;100131608;245908;100132396;503618;392188;100289462;245909;414325;10407;645836,22
1,-1,8,7025440,7977100,951660,401447;503614;504180;503841;140596;100133251;653423;100131980;645402;55894;245910;1673;100131608;245908;100132396;503618;392188;100289462;245909;414325;10407;645836,22
1,-1,8,7025440,7977100,951660,401447;503614;504180;503841;140596;100133251;653423;100131980;645402;55894;245910;1673;100131608;245908;100132396;503618;392188;100289462;245909;414325;10407;645836,22
1,-1,8,7025440,7977100,951660,401447;503614;504180;503841;140596;100133251;653423;100131980;645402;55894;245910;1673;100131608;245908;100132396;503618;392188;100289462;245909;414325;10407;645836,22
1,-1,8,7025440,7977100,951660,401447;503614;504180;503841;140596;100133251;653423;100131980;645402;55894;245910;1673;100131608;245908;100132396;503618;392188;100289462;245909;414325;10407;645836,22
1,-1,8,7025440,8054556,1029116,401447;503614;504180;503841;140596;100133251;653423;100131980;645402;55894;245910;1673;100131608;245908;100132396;503618;392188;100289462;245909;414325;10407;645836,22
1,-1,8,7025440,8079850,1054410,401447;503614;504180;503841;140596;100133251;653423;100131980;645402;55894;245910;1673;100131608;245908;100132396;503618;392188;100289462;245909;414325;10407;645836,22
1,-1,8,7025440,8079850,1054410,401447;503614;504180;503841;140596;100133251;653423;100131980;645402;55894;245910;1673;100131608;245908;100132396;503618;392188;100289462;245909;414325;10407;645836,22
1,-1,8,7025440,8079850,1054410,401447;503614;504180;503841;140596;100133251;653423;100131980;645402;55894;245910;1673;100131608;245908;100132396;503618;392188;100289462;245909;414325;10407;645836,22
1,-1,8,7025440,8079850,1054410,401447;503614;504180;503841;140596;100133251;653423;100131980;645402;55894;245910;1673;100131608;245908;100132396;503618;392188;100289462;245909;414325;10407;645836,22
1,-1,8,7025440,8079850,1054410,401447;503614;504180;503841;140596;100133251;653423;100131980;645402;55894;245910;1673;100131608;245908;100132396;503618;392188;100289462;245909;414325;10407;645836,22
1,-1,8,7025440,8094715,1069275,401447;503614;504180;503841;140596;100133251;653423;100131980;645402;55894;245910;1673;100131608;245908;100132396;503618;392188;100289462;245909;414325;10407;645836,22
1,-1,8,7025440,8094715,1069275,401447;503614;504180;503841;140596;100133251;653423;100131980;645402;55894;245910;1673;100131608;245908;100132396;503618;392188;100289462;245909;414325;10407;645836,22
1,-1,8,7025440,8094715,1069275,401447;503614;504180;503841;140596;100133251;653423;100131980;645402;55894;245910;1673;100131608;245908;100132396;503618;392188;100289462;245909;414325;10407;645836,22
1,-1,8,7025440,8094715,1069275,401447;503614;504180;503841;140596;100133251;653423;100131980;645402;55894;245910;1673;100131608;245908;100132396;503618;392188;100289462;245909;414325;10407;645836,22
1,-1,8,7025440,8111100,1085660,401447;503614;504180;503841;140596;100133251;653423;100131980;645402;55894;245910;1673;100131608;245908;100132396;503618;392188;100289462;245909;414325;10407;645836,22
1,-1,8,7025440,8111100,1085660,401447;503614;504180;503841;140596;100133251;653423;100131980;645402;55894;245910;1673;100131608;245908;100132396;503618;392188;100289462;245909;414325;10407;645836,22
1,-1,8,7025440,8167155,1141715,401447;503614;504180;503841;140596;100133251;653423;100131980;645402;55894;245910;1673;100131608;245908;100132396;503618;392188;100289462;245909;414325;10407;645836,22
-1,-1,8,7045386,8079912,1034526,401447;503614;504180;503841;140596;100133251;653423;100131980;645402;55894;245910;1673;100131608;245908;100132396;503618;392188;100289462;245909;414325;10407;645836,22
1,-1,8,7045454,7916703,871249,401447;503614;504180;503841;140596;100133251;653423;100131980;645402;55894;245910;1673;100131608;245908;100132396;503618;392188;100289462;245909;414325;10407;645836,22
1,-1,8,7045454,7927953,882499,401447;503614;504180;503841;140596;100133251;653423;100131980;645402;55894;245910;1673;100131608;245908;100132396;503618;392188;100289462;245909;414325;10407;645836,22
1,-1,8,7045454,7957093,911639,401447;503614;504180;503841;140596;100133251;653423;100131980;645402;55894;245910;1673;100131608;245908;100132396;503618;392188;100289462;245909;414325;10407;645836,22
1,-1,8,7045454,7957093,911639,401447;503614;504180;503841;140596;100133251;653423;100131980;645402;55894;245910;1673;100131608;245908;100132396;503618;392188;100289462;245909;414325;10407;645836,22
1,-1,8,7045454,7957093,911639,401447;503614;504180;503841;140596;100133251;653423;100131980;645402;55894;245910;1673;100131608;245908;100132396;503618;392188;100289462;245909;414325;10407;645836,22
1,-1,8,7045454,8079850,1034396,401447;503614;504180;503841;140596;100133251;653423;100131980;645402;55894;245910;1673;100131608;245908;100132396;503618;392188;100289462;245909;414325;10407;645836,22
1,-1,8,7045454,8079850,1034396,401447;503614;504180;503841;140596;100133251;653423;100131980;645402;55894;245910;1673;100131608;245908;100132396;503618;392188;100289462;245909;414325;10407;645836,22
-1,-1,8,7053186,7691960,638774,401447;100131608;503614;504180;503841;503618;245908;100289462;100133251;100131980;645402;245909;55894;10407;245910,15
-1,-1,8,7053186,7691960,638774,401447;100131608;503614;504180;503841;503618;245908;100289462;100133251;100131980;645402;245909;55894;10407;245910,15
-1,-1,8,7053186,7752586,699400,401447;503614;504180;503841;140596;100133251;653423;100131980;645402;55894;245910;1673;100131608;245908;503618;100289462;245909;414325;10407,19
-1,-1,8,7053186,7752586,699400,401447;503614;504180;503841;140596;100133251;653423;100131980;645402;55894;245910;1673;100131608;245908;503618;100289462;245909;414325;10407,19
-1,-1,8,7053186,7752586,699400,401447;503614;504180;503841;140596;100133251;653423;100131980;645402;55894;245910;1673;100131608;245908;503618;100289462;245909;414325;10407,19
-1,-1,8,7053186,7752586,699400,401447;503614;504180;503841;140596;100133251;653423;100131980;645402;55894;245910;1673;100131608;245908;503618;100289462;245909;414325;10407,19
-1,-1,8,7053186,7752586,699400,401447;503614;504180;503841;140596;100133251;653423;100131980;645402;55894;245910;1673;100131608;245908;503618;100289462;245909;414325;10407,19
-1,-1,8,7053186,7752586,699400,401447;503614;504180;503841;140596;100133251;653423;100131980;645402;55894;245910;1673;100131608;245908;503618;100289462;245909;414325;10407,19
-1,-1,8,7053186,7752586,699400,401447;503614;504180;503841;140596;100133251;653423;100131980;645402;55894;245910;1673;100131608;245908;503618;100289462;245909;414325;10407,19
-1,-1,8,7053186,7752586,699400,401447;503614;504180;503841;140596;100133251;653423;100131980;645402;55894;245910;1673;100131608;245908;503618;100289462;245909;414325;10407,19
-1,-1,8,7053186,7752586,699400,401447;503614;504180;503841;140596;100133251;653423;100131980;645402;55894;245910;1673;100131608;245908;503618;100289462;245909;414325;10407,19
-1,-1,8,7053186,7752586,699400,401447;503614;504180;503841;140596;100133251;653423;100131980;645402;55894;245910;1673;100131608;245908;503618;100289462;245909;414325;10407,19
-1,-1,8,7053186,7752586,699400,401447;503614;504180;503841;140596;100133251;653423;100131980;645402;55894;245910;1673;100131608;245908;503618;100289462;245909;414325;10407,19
-1,-1,8,7053186,7752586,699400,401447;503614;504180;503841;140596;100133251;653423;100131980;645402;55894;245910;1673;100131608;245908;503618;100289462;245909;414325;10407,19
-1,-1,8,7053186,7752586,699400,401447;503614;504180;503841;140596;100133251;653423;100131980;645402;55894;245910;1673;100131608;245908;503618;100289462;245909;414325;10407,19
-1,-1,8,7053186,7752586,699400,401447;503614;504180;503841;140596;100133251;653423;100131980;645402;55894;245910;1673;100131608;245908;503618;100289462;245909;414325;10407,19
-1,-1,8,7053186,7752586,699400,401447;503614;504180;503841;140596;100133251;653423;100131980;645402;55894;245910;1673;100131608;245908;503618;100289462;245909;414325;10407,19
-1,-1,8,7053186,7752586,699400,401447;503614;504180;503841;140596;100133251;653423;100131980;645402;55894;245910;1673;100131608;245908;503618;100289462;245909;414325;10407,19
-1,-1,8,7053186,7806229,753043,401447;503614;504180;503841;140596;100133251;653423;100131980;645402;55894;245910;1673;100131608;245908;100132396;503618;100289462;245909;414325;10407,20
-1,-1,8,7053186,7806229,753043,401447;503614;504180;503841;140596;100133251;653423;100131980;645402;55894;245910;1673;100131608;245908;100132396;503618;100289462;245909;414325;10407,20
-1,-1,8,7053186,7806229,753043,401447;503614;504180;503841;140596;100133251;653423;100131980;645402;55894;245910;1673;100131608;245908;100132396;503618;100289462;245909;414325;10407,20
-1,-1,8,7053186,8079920,1026734,401447;503614;504180;503841;140596;100133251;653423;100131980;645402;55894;245910;1673;100131608;245908;100132396;503618;392188;100289462;245909;414325;10407;645836,22
1,-1,8,7053186,8079920,1026734,401447;503614;504180;503841;140596;100133251;653423;100131980;645402;55894;245910;1673;100131608;245908;100132396;503618;392188;100289462;245909;414325;10407;645836,22
-1,-1,8,7053186,8079920,1026734,401447;503614;504180;503841;140596;100133251;653423;100131980;645402;55894;245910;1673;100131608;245908;100132396;503618;392188;100289462;245909;414325;10407;645836,22
-1,-1,8,7053186,8079920,1026734,401447;503614;504180;503841;140596;100133251;653423;100131980;645402;55894;245910;1673;100131608;245908;100132396;503618;392188;100289462;245909;414325;10407;645836,22
-1,-1,8,7053186,8079920,1026734,401447;503614;504180;503841;140596;100133251;653423;100131980;645402;55894;245910;1673;100131608;245908;100132396;503618;392188;100289462;245909;414325;10407;645836,22
-1,-1,8,7053186,8079920,1026734,401447;503614;504180;503841;140596;100133251;653423;100131980;645402;55894;245910;1673;100131608;245908;100132396;503618;392188;100289462;245909;414325;10407;645836,22
-1,-1,8,7053186,8079920,1026734,401447;503614;504180;503841;140596;100133251;653423;100131980;645402;55894;245910;1673;100131608;245908;100132396;503618;392188;100289462;245909;414325;10407;645836,22
-1,-1,8,7053186,8079920,1026734,401447;503614;504180;503841;140596;100133251;653423;100131980;645402;55894;245910;1673;100131608;245908;100132396;503618;392188;100289462;245909;414325;10407;645836,22
-1,-1,8,7053186,8079920,1026734,401447;503614;504180;503841;140596;100133251;653423;100131980;645402;55894;245910;1673;100131608;245908;100132396;503618;392188;100289462;245909;414325;10407;645836,22
-1,-1,8,7053186,8079920,1026734,401447;503614;504180;503841;140596;100133251;653423;100131980;645402;55894;245910;1673;100131608;245908;100132396;503618;392188;100289462;245909;414325;10407;645836,22
-1,-1,8,7053186,8079920,1026734,401447;503614;504180;503841;140596;100133251;653423;100131980;645402;55894;245910;1673;100131608;245908;100132396;503618;392188;100289462;245909;414325;10407;645836,22
-1,-1,8,7053186,8079920,1026734,401447;503614;504180;503841;140596;100133251;653423;100131980;645402;55894;245910;1673;100131608;245908;100132396;503618;392188;100289462;245909;414325;10407;645836,22
-1,-1,8,7053186,8079920,1026734,401447;503614;504180;503841;140596;100133251;653423;100131980;645402;55894;245910;1673;100131608;245908;100132396;503618;392188;100289462;245909;414325;10407;645836,22
-1,-1,8,7053186,8079920,1026734,401447;503614;504180;503841;140596;100133251;653423;100131980;645402;55894;245910;1673;100131608;245908;100132396;503618;392188;100289462;245909;414325;10407;645836,22
-1,-1,8,7053186,8079920,1026734,401447;503614;504180;503841;140596;100133251;653423;100131980;645402;55894;245910;1673;100131608;245908;100132396;503618;392188;100289462;245909;414325;10407;645836,22
-1,-1,8,7053186,8079920,1026734,401447;503614;504180;503841;140596;100133251;653423;100131980;645402;55894;245910;1673;100131608;245908;100132396;503618;392188;100289462;245909;414325;10407;645836,22
-1,-1,8,7053186,8079920,1026734,401447;503614;504180;503841;140596;100133251;653423;100131980;645402;55894;245910;1673;100131608;245908;100132396;503618;392188;100289462;245909;414325;10407;645836,22
-1,-1,8,7053186,8079920,1026734,401447;503614;504180;503841;140596;100133251;653423;100131980;645402;55894;245910;1673;100131608;245908;100132396;503618;392188;100289462;245909;414325;10407;645836,22
-1,-1,8,7053186,8079920,1026734,401447;503614;504180;503841;140596;100133251;653423;100131980;645402;55894;245910;1673;100131608;245908;100132396;503618;392188;100289462;245909;414325;10407;645836,22
-1,-1,8,7053186,8079920,1026734,401447;503614;504180;503841;140596;100133251;653423;100131980;645402;55894;245910;1673;100131608;245908;100132396;503618;392188;100289462;245909;414325;10407;645836,22
-1,-1,8,7053186,8079920,1026734,401447;503614;504180;503841;140596;100133251;653423;100131980;645402;55894;245910;1673;100131608;245908;100132396;503618;392188;100289462;245909;414325;10407;645836,22
-1,-1,8,7053186,8079920,1026734,401447;503614;504180;503841;140596;100133251;653423;100131980;645402;55894;245910;1673;100131608;245908;100132396;503618;392188;100289462;245909;414325;10407;645836,22
-1,-1,8,7053186,8079920,1026734,401447;503614;504180;503841;140596;100133251;653423;100131980;645402;55894;245910;1673;100131608;245908;100132396;503618;392188;100289462;245909;414325;10407;645836,22
-1,-1,8,7053186,8079920,1026734,401447;503614;504180;503841;140596;100133251;653423;100131980;645402;55894;245910;1673;100131608;245908;100132396;503618;392188;100289462;245909;414325;10407;645836,22
-1,-1,8,7053186,8130689,1077503,401447;503614;504180;503841;140596;100133251;653423;100131980;645402;55894;245910;1673;100131608;245908;100132396;503618;392188;100289462;245909;414325;10407;645836,22
-1,-1,8,7053186,8130689,1077503,401447;503614;504180;503841;140596;100133251;653423;100131980;645402;55894;245910;1673;100131608;245908;100132396;503618;392188;100289462;245909;414325;10407;645836,22
1,1,8,7053186,11805960,4752774,401447;1508;83650;504180;503841;203076;83648;55894;245910;157285;252969;245908;100132396;503618;54984;392188;100289462;4482;203074;245909;90459;503614;140596;83595;100133251;653423;100131980;645402;2626;137075;1673;100131608;640;66036;286046;79660;2222;8658;9258;414325;94137;10407;645836,43
-1,-1,8,7053196,7691845,638649,401447;100131608;503614;504180;503841;503618;245908;100289462;100133251;100131980;645402;245909;55894;10407;245910,15
-1,-1,8,7053196,7752596,699400,401447;503614;504180;503841;140596;100133251;653423;100131980;645402;55894;245910;1673;100131608;245908;503618;100289462;245909;414325;10407,19
-1,-1,8,7053196,7752596,699400,401447;503614;504180;503841;140596;100133251;653423;100131980;645402;55894;245910;1673;100131608;245908;503618;100289462;245909;414325;10407,19
-1,-1,8,7053196,7752596,699400,401447;503614;504180;503841;140596;100133251;653423;100131980;645402;55894;245910;1673;100131608;245908;503618;100289462;245909;414325;10407,19
-1,-1,8,7053196,7752596,699400,401447;503614;504180;503841;140596;100133251;653423;100131980;645402;55894;245910;1673;100131608;245908;503618;100289462;245909;414325;10407,19
-1,-1,8,7053196,7752596,699400,401447;503614;504180;503841;140596;100133251;653423;100131980;645402;55894;245910;1673;100131608;245908;503618;100289462;245909;414325;10407,19
-1,-1,8,7053196,7752596,699400,401447;503614;504180;503841;140596;100133251;653423;100131980;645402;55894;245910;1673;100131608;245908;503618;100289462;245909;414325;10407,19
-1,-1,8,7053196,7752596,699400,401447;503614;504180;503841;140596;100133251;653423;100131980;645402;55894;245910;1673;100131608;245908;503618;100289462;245909;414325;10407,19
-1,-1,8,7053196,7806227,753031,401447;503614;504180;503841;140596;100133251;653423;100131980;645402;55894;245910;1673;100131608;245908;100132396;503618;100289462;245909;414325;10407,20
-1,-1,8,7053196,7806227,753031,401447;503614;504180;503841;140596;100133251;653423;100131980;645402;55894;245910;1673;100131608;245908;100132396;503618;100289462;245909;414325;10407,20
-1,-1,8,7053196,7806227,753031,401447;503614;504180;503841;140596;100133251;653423;100131980;645402;55894;245910;1673;100131608;245908;100132396;503618;100289462;245909;414325;10407,20
-1,-1,8,7053196,7806227,753031,401447;503614;504180;503841;140596;100133251;653423;100131980;645402;55894;245910;1673;100131608;245908;100132396;503618;100289462;245909;414325;10407,20
-1,-1,8,7053196,7806227,753031,401447;503614;504180;503841;140596;100133251;653423;100131980;645402;55894;245910;1673;100131608;245908;100132396;503618;100289462;245909;414325;10407,20
-1,-1,8,7053196,7806227,753031,401447;503614;504180;503841;140596;100133251;653423;100131980;645402;55894;245910;1673;100131608;245908;100132396;503618;100289462;245909;414325;10407,20
-1,-1,8,7053196,7806227,753031,401447;503614;504180;503841;140596;100133251;653423;100131980;645402;55894;245910;1673;100131608;245908;100132396;503618;100289462;245909;414325;10407,20
-1,-1,8,7053196,7806227,753031,401447;503614;504180;503841;140596;100133251;653423;100131980;645402;55894;245910;1673;100131608;245908;100132396;503618;100289462;245909;414325;10407,20
-1,-1,8,7053196,7806227,753031,401447;503614;504180;503841;140596;100133251;653423;100131980;645402;55894;245910;1673;100131608;245908;100132396;503618;100289462;245909;414325;10407,20
-1,-1,8,7053196,8079912,1026716,401447;503614;504180;503841;140596;100133251;653423;100131980;645402;55894;245910;1673;100131608;245908;100132396;503618;392188;100289462;245909;414325;10407;645836,22
-1,-1,8,7053196,8079912,1026716,401447;503614;504180;503841;140596;100133251;653423;100131980;645402;55894;245910;1673;100131608;245908;100132396;503618;392188;100289462;245909;414325;10407;645836,22
-1,-1,8,7053196,8079912,1026716,401447;503614;504180;503841;140596;100133251;653423;100131980;645402;55894;245910;1673;100131608;245908;100132396;503618;392188;100289462;245909;414325;10407;645836,22
-1,-1,8,7053196,8079912,1026716,401447;503614;504180;503841;140596;100133251;653423;100131980;645402;55894;245910;1673;100131608;245908;100132396;503618;392188;100289462;245909;414325;10407;645836,22
-1,-1,8,7053196,8079912,1026716,401447;503614;504180;503841;140596;100133251;653423;100131980;645402;55894;245910;1673;100131608;245908;100132396;503618;392188;100289462;245909;414325;10407;645836,22
-1,-1,8,7053196,8079912,1026716,401447;503614;504180;503841;140596;100133251;653423;100131980;645402;55894;245910;1673;100131608;245908;100132396;503618;392188;100289462;245909;414325;10407;645836,22
-1,-1,8,7053196,8079912,1026716,401447;503614;504180;503841;140596;100133251;653423;100131980;645402;55894;245910;1673;100131608;245908;100132396;503618;392188;100289462;245909;414325;10407;645836,22
-1,-1,8,7053196,8079912,1026716,401447;503614;504180;503841;140596;100133251;653423;100131980;645402;55894;245910;1673;100131608;245908;100132396;503618;392188;100289462;245909;414325;10407;645836,22
-1,-1,8,7053196,8079912,1026716,401447;503614;504180;503841;140596;100133251;653423;100131980;645402;55894;245910;1673;100131608;245908;100132396;503618;392188;100289462;245909;414325;10407;645836,22
-1,-1,8,7053196,8079912,1026716,401447;503614;504180;503841;140596;100133251;653423;100131980;645402;55894;245910;1673;100131608;245908;100132396;503618;392188;100289462;245909;414325;10407;645836,22
-1,-1,8,7053196,8079912,1026716,401447;503614;504180;503841;140596;100133251;653423;100131980;645402;55894;245910;1673;100131608;245908;100132396;503618;392188;100289462;245909;414325;10407;645836,22
-1,-1,8,7053196,8130631,1077435,401447;503614;504180;503841;140596;100133251;653423;100131980;645402;55894;245910;1673;100131608;245908;100132396;503618;392188;100289462;245909;414325;10407;645836,22
1,-1,8,7053207,7806163,752956,401447;503614;504180;503841;140596;100133251;653423;100131980;645402;55894;245910;1673;100131608;245908;100132396;503618;100289462;245909;414325;10407,20
1,-1,8,7053207,7891743,838536,401447;503614;504180;503841;140596;100133251;653423;100131980;645402;55894;245910;1673;100131608;245908;100132396;503618;392188;100289462;245909;414325;10407;645836,22
1,-1,8,7053207,7891743,838536,401447;503614;504180;503841;140596;100133251;653423;100131980;645402;55894;245910;1673;100131608;245908;100132396;503618;392188;100289462;245909;414325;10407;645836,22
1,-1,8,7053207,7957093,903886,401447;503614;504180;503841;140596;100133251;653423;100131980;645402;55894;245910;1673;100131608;245908;100132396;503618;392188;100289462;245909;414325;10407;645836,22
1,-1,8,7053207,7977100,923893,401447;503614;504180;503841;140596;100133251;653423;100131980;645402;55894;245910;1673;100131608;245908;100132396;503618;392188;100289462;245909;414325;10407;645836,22
1,-1,8,7063187,7806223,743036,401447;503614;504180;503841;140596;100133251;653423;100131980;645402;55894;245910;1673;100131608;245908;100132396;503618;100289462;245909;414325;10407,20
-1,-1,8,7074596,7927992,853396,401447;503614;504180;503841;140596;100133251;653423;100131980;645402;55894;245910;1673;100131608;245908;100132396;503618;392188;100289462;245909;414325;10407;645836,22
-1,-1,8,7074596,8079912,1005316,401447;503614;504180;503841;140596;100133251;653423;100131980;645402;55894;245910;1673;100131608;245908;100132396;503618;392188;100289462;245909;414325;10407;645836,22
1,-1,8,7079732,7891743,812011,401447;503614;504180;503841;140596;100133251;653423;100131980;645402;55894;245910;1673;100131608;245908;100132396;503618;392188;100289462;245909;414325;10407;645836,22
1,-1,8,7079732,7916703,836971,401447;503614;504180;503841;140596;100133251;653423;100131980;645402;55894;245910;1673;100131608;245908;100132396;503618;392188;100289462;245909;414325;10407;645836,22
1,-1,8,7079732,7916703,836971,401447;503614;504180;503841;140596;100133251;653423;100131980;645402;55894;245910;1673;100131608;245908;100132396;503618;392188;100289462;245909;414325;10407;645836,22
1,-1,8,7079732,7916703,836971,401447;503614;504180;503841;140596;100133251;653423;100131980;645402;55894;245910;1673;100131608;245908;100132396;503618;392188;100289462;245909;414325;10407;645836,22
1,-1,8,7079732,7916703,836971,401447;503614;504180;503841;140596;100133251;653423;100131980;645402;55894;245910;1673;100131608;245908;100132396;503618;392188;100289462;245909;414325;10407;645836,22
1,-1,8,7079732,7916703,836971,401447;503614;504180;503841;140596;100133251;653423;100131980;645402;55894;245910;1673;100131608;245908;100132396;503618;392188;100289462;245909;414325;10407;645836,22
1,-1,8,7079732,7927953,848221,401447;503614;504180;503841;140596;100133251;653423;100131980;645402;55894;245910;1673;100131608;245908;100132396;503618;392188;100289462;245909;414325;10407;645836,22
1,-1,8,7079732,7957093,877361,401447;503614;504180;503841;140596;100133251;653423;100131980;645402;55894;245910;1673;100131608;245908;100132396;503618;392188;100289462;245909;414325;10407;645836,22
1,-1,8,7079732,7957093,877361,401447;503614;504180;503841;140596;100133251;653423;100131980;645402;55894;245910;1673;100131608;245908;100132396;503618;392188;100289462;245909;414325;10407;645836,22
1,-1,8,7079732,8054556,974824,401447;503614;504180;503841;140596;100133251;653423;100131980;645402;55894;245910;1673;100131608;245908;100132396;503618;392188;100289462;245909;414325;10407;645836,22
1,-1,8,7079732,8094715,1014983,401447;503614;504180;503841;140596;100133251;653423;100131980;645402;55894;245910;1673;100131608;245908;100132396;503618;392188;100289462;245909;414325;10407;645836,22
1,-1,8,7079732,8111100,1031368,401447;503614;504180;503841;140596;100133251;653423;100131980;645402;55894;245910;1673;100131608;245908;100132396;503618;392188;100289462;245909;414325;10407;645836,22
-1,-1,8,7110810,7430402,319592,401447;100131608;503614;504180;503841;503618;100289462;100131980;645402;55894;10407,11
-1,-1,8,7088174,7891743,803569,401447;503614;504180;503841;140596;100133251;653423;100131980;645402;55894;245910;1673;100131608;245908;100132396;503618;392188;100289462;245909;414325;10407;645836,22
1,-1,8,7088174,7891743,803569,401447;503614;504180;503841;140596;100133251;653423;100131980;645402;55894;245910;1673;100131608;245908;100132396;503618;392188;100289462;245909;414325;10407;645836,22
1,-1,8,7088174,7916703,828529,401447;503614;504180;503841;140596;100133251;653423;100131980;645402;55894;245910;1673;100131608;245908;100132396;503618;392188;100289462;245909;414325;10407;645836,22
1,-1,8,7088174,7916703,828529,401447;503614;504180;503841;140596;100133251;653423;100131980;645402;55894;245910;1673;100131608;245908;100132396;503618;392188;100289462;245909;414325;10407;645836,22
1,-1,8,7088174,8111100,1022926,401447;503614;504180;503841;140596;100133251;653423;100131980;645402;55894;245910;1673;100131608;245908;100132396;503618;392188;100289462;245909;414325;10407;645836,22
-1,-1,8,7110811,7881316,770505,401447;503614;504180;503841;140596;100133251;653423;100131980;645402;55894;245910;1673;100131608;245908;100132396;503618;392188;100289462;245909;414325;10407;645836,22
-1,-1,8,7110811,7891794,780983,401447;503614;504180;503841;140596;100133251;653423;100131980;645402;55894;245910;1673;100131608;245908;100132396;503618;392188;100289462;245909;414325;10407;645836,22
-1,-1,8,7110811,8079912,969101,401447;503614;504180;503841;140596;100133251;653423;100131980;645402;55894;245910;1673;100131608;245908;100132396;503618;392188;100289462;245909;414325;10407;645836,22
-1,-1,8,7113659,7430402,316743,401447;100131608;503614;504180;503841;503618;100289462;100131980;645402;55894;10407,11
-1,-1,8,7113659,7430402,316743,401447;100131608;503614;504180;503841;503618;100289462;100131980;645402;55894;10407,11
-1,-1,8,7113659,7430402,316743,401447;100131608;503614;504180;503841;503618;100289462;100131980;645402;55894;10407,11
-1,-1,8,7113659,7430402,316743,401447;100131608;503614;504180;503841;503618;100289462;100131980;645402;55894;10407,11
-1,-1,8,7113659,7430402,316743,401447;100131608;503614;504180;503841;503618;100289462;100131980;645402;55894;10407,11
-1,-1,8,7113659,7430402,316743,401447;100131608;503614;504180;503841;503618;100289462;100131980;645402;55894;10407,11
-1,-1,8,7113659,7430402,316743,401447;100131608;503614;504180;503841;503618;100289462;100131980;645402;55894;10407,11
-1,-1,8,7113659,7430402,316743,401447;100131608;503614;504180;503841;503618;100289462;100131980;645402;55894;10407,11
-1,-1,8,7113659,7430402,316743,401447;100131608;503614;504180;503841;503618;100289462;100131980;645402;55894;10407,11
-1,-1,8,7113659,7430402,316743,401447;100131608;503614;504180;503841;503618;100289462;100131980;645402;55894;10407,11
-1,-1,8,7113659,7430402,316743,401447;100131608;503614;504180;503841;503618;100289462;100131980;645402;55894;10407,11
-1,-1,8,7113659,7430402,316743,401447;100131608;503614;504180;503841;503618;100289462;100131980;645402;55894;10407,11
-1,-1,8,7113659,7430402,316743,401447;100131608;503614;504180;503841;503618;100289462;100131980;645402;55894;10407,11
-1,-1,8,7113659,7430402,316743,401447;100131608;503614;504180;503841;503618;100289462;100131980;645402;55894;10407,11
-1,-1,8,7113659,7430402,316743,401447;100131608;503614;504180;503841;503618;100289462;100131980;645402;55894;10407,11
-1,-1,8,7113659,7430402,316743,401447;100131608;503614;504180;503841;503618;100289462;100131980;645402;55894;10407,11
-1,-1,8,7113659,7430402,316743,401447;100131608;503614;504180;503841;503618;100289462;100131980;645402;55894;10407,11
-1,-1,8,7113659,7430402,316743,401447;100131608;503614;504180;503841;503618;100289462;100131980;645402;55894;10407,11
-1,-1,8,7113659,7430402,316743,401447;100131608;503614;504180;503841;503618;100289462;100131980;645402;55894;10407,11
-1,-1,8,7113659,7430402,316743,401447;100131608;503614;504180;503841;503618;100289462;100131980;645402;55894;10407,11
-1,-1,8,7113659,7430402,316743,401447;100131608;503614;504180;503841;503618;100289462;100131980;645402;55894;10407,11
-1,-1,8,7113659,7430402,316743,401447;100131608;503614;504180;503841;503618;100289462;100131980;645402;55894;10407,11
-1,-1,8,7113659,7430402,316743,401447;100131608;503614;504180;503841;503618;100289462;100131980;645402;55894;10407,11
-1,-1,8,7113659,7430402,316743,401447;100131608;503614;504180;503841;503618;100289462;100131980;645402;55894;10407,11
-1,-1,8,7113659,7430402,316743,401447;100131608;503614;504180;503841;503618;100289462;100131980;645402;55894;10407,11
-1,-1,8,7113659,7430402,316743,401447;100131608;503614;504180;503841;503618;100289462;100131980;645402;55894;10407,11
-1,-1,8,7113659,7430402,316743,401447;100131608;503614;504180;503841;503618;100289462;100131980;645402;55894;10407,11
-1,-1,8,7113659,7430402,316743,401447;100131608;503614;504180;503841;503618;100289462;100131980;645402;55894;10407,11
-1,-1,8,7113659,7430402,316743,401447;100131608;503614;504180;503841;503618;100289462;100131980;645402;55894;10407,11
-1,-1,8,7113659,7430402,316743,401447;100131608;503614;504180;503841;503618;100289462;100131980;645402;55894;10407,11
-1,-1,8,7113659,7430402,316743,401447;100131608;503614;504180;503841;503618;100289462;100131980;645402;55894;10407,11
-1,-1,8,7113659,7430402,316743,401447;100131608;503614;504180;503841;503618;100289462;100131980;645402;55894;10407,11
-1,-1,8,7113659,7430402,316743,401447;100131608;503614;504180;503841;503618;100289462;100131980;645402;55894;10407,11
-1,-1,8,7113659,7430402,316743,401447;100131608;503614;504180;503841;503618;100289462;100131980;645402;55894;10407,11
-1,-1,8,7113659,7430402,316743,401447;100131608;503614;504180;503841;503618;100289462;100131980;645402;55894;10407,11
-1,-1,8,7113659,7430402,316743,401447;100131608;503614;504180;503841;503618;100289462;100131980;645402;55894;10407,11
-1,-1,8,7113659,7430402,316743,401447;100131608;503614;504180;503841;503618;100289462;100131980;645402;55894;10407,11
-1,-1,8,7113659,7430402,316743,401447;100131608;503614;504180;503841;503618;100289462;100131980;645402;55894;10407,11
-1,-1,8,7113659,7430402,316743,401447;100131608;503614;504180;503841;503618;100289462;100131980;645402;55894;10407,11
-1,-1,8,7113659,7430402,316743,401447;100131608;503614;504180;503841;503618;100289462;100131980;645402;55894;10407,11
-1,-1,8,7113659,7430402,316743,401447;100131608;503614;504180;503841;503618;100289462;100131980;645402;55894;10407,11
-1,-1,8,7113659,7430402,316743,401447;100131608;503614;504180;503841;503618;100289462;100131980;645402;55894;10407,11
-1,-1,8,7113659,7430402,316743,401447;100131608;503614;504180;503841;503618;100289462;100131980;645402;55894;10407,11
-1,-1,8,7113659,7430402,316743,401447;100131608;503614;504180;503841;503618;100289462;100131980;645402;55894;10407,11
-1,-1,8,7113659,7430402,316743,401447;100131608;503614;504180;503841;503618;100289462;100131980;645402;55894;10407,11
-1,-1,8,7113659,7430402,316743,401447;100131608;503614;504180;503841;503618;100289462;100131980;645402;55894;10407,11
-1,-1,8,7113659,7430402,316743,401447;100131608;503614;504180;503841;503618;100289462;100131980;645402;55894;10407,11
-1,-1,8,7113659,7430402,316743,401447;100131608;503614;504180;503841;503618;100289462;100131980;645402;55894;10407,11
-1,-1,8,7113659,7430402,316743,401447;100131608;503614;504180;503841;503618;100289462;100131980;645402;55894;10407,11
-1,-1,8,7113659,7430402,316743,401447;100131608;503614;504180;503841;503618;100289462;100131980;645402;55894;10407,11
-1,-1,8,7113659,7430402,316743,401447;100131608;503614;504180;503841;503618;100289462;100131980;645402;55894;10407,11
-1,-1,8,7113659,7430402,316743,401447;100131608;503614;504180;503841;503618;100289462;100131980;645402;55894;10407,11
-1,-1,8,7113659,7430402,316743,401447;100131608;503614;504180;503841;503618;100289462;100131980;645402;55894;10407,11
-1,-1,8,7113659,7430402,316743,401447;100131608;503614;504180;503841;503618;100289462;100131980;645402;55894;10407,11
-1,-1,8,7113659,7430402,316743,401447;100131608;503614;504180;503841;503618;100289462;100131980;645402;55894;10407,11
-1,-1,8,7113659,7430402,316743,401447;100131608;503614;504180;503841;503618;100289462;100131980;645402;55894;10407,11
-1,-1,8,7113659,7430402,316743,401447;100131608;503614;504180;503841;503618;100289462;100131980;645402;55894;10407,11
-1,-1,8,7113659,7430402,316743,401447;100131608;503614;504180;503841;503618;100289462;100131980;645402;55894;10407,11
-1,-1,8,7113659,7430402,316743,401447;100131608;503614;504180;503841;503618;100289462;100131980;645402;55894;10407,11
-1,-1,8,7113659,7430402,316743,401447;100131608;503614;504180;503841;503618;100289462;100131980;645402;55894;10407,11
-1,-1,8,7113659,7430402,316743,401447;100131608;503614;504180;503841;503618;100289462;100131980;645402;55894;10407,11
-1,-1,8,7113659,7430402,316743,401447;100131608;503614;504180;503841;503618;100289462;100131980;645402;55894;10407,11
1,-1,8,7110870,7632386,521516,401447;100131608;503614;504180;503841;503618;100289462;100131980;645402;55894;10407,11
-1,-1,8,7110870,7891743,780873,401447;503614;504180;503841;140596;100133251;653423;100131980;645402;55894;245910;1673;100131608;245908;100132396;503618;392188;100289462;245909;414325;10407;645836,22
-1,-1,8,7110870,7891743,780873,401447;503614;504180;503841;140596;100133251;653423;100131980;645402;55894;245910;1673;100131608;245908;100132396;503618;392188;100289462;245909;414325;10407;645836,22
1,-1,8,7110870,7891743,780873,401447;503614;504180;503841;140596;100133251;653423;100131980;645402;55894;245910;1673;100131608;245908;100132396;503618;392188;100289462;245909;414325;10407;645836,22
1,-1,8,7110870,7891743,780873,401447;503614;504180;503841;140596;100133251;653423;100131980;645402;55894;245910;1673;100131608;245908;100132396;503618;392188;100289462;245909;414325;10407;645836,22
-1,-1,8,7110870,7891743,780873,401447;503614;504180;503841;140596;100133251;653423;100131980;645402;55894;245910;1673;100131608;245908;100132396;503618;392188;100289462;245909;414325;10407;645836,22
1,-1,8,7110870,7891743,780873,401447;503614;504180;503841;140596;100133251;653423;100131980;645402;55894;245910;1673;100131608;245908;100132396;503618;392188;100289462;245909;414325;10407;645836,22
1,-1,8,7110870,7891743,780873,401447;503614;504180;503841;140596;100133251;653423;100131980;645402;55894;245910;1673;100131608;245908;100132396;503618;392188;100289462;245909;414325;10407;645836,22
1,-1,8,7110870,7891743,780873,401447;503614;504180;503841;140596;100133251;653423;100131980;645402;55894;245910;1673;100131608;245908;100132396;503618;392188;100289462;245909;414325;10407;645836,22
1,-1,8,7110870,7891743,780873,401447;503614;504180;503841;140596;100133251;653423;100131980;645402;55894;245910;1673;100131608;245908;100132396;503618;392188;100289462;245909;414325;10407;645836,22
1,-1,8,7110870,7891743,780873,401447;503614;504180;503841;140596;100133251;653423;100131980;645402;55894;245910;1673;100131608;245908;100132396;503618;392188;100289462;245909;414325;10407;645836,22
1,-1,8,7110870,7891743,780873,401447;503614;504180;503841;140596;100133251;653423;100131980;645402;55894;245910;1673;100131608;245908;100132396;503618;392188;100289462;245909;414325;10407;645836,22
-1,-1,8,7110870,7891743,780873,401447;503614;504180;503841;140596;100133251;653423;100131980;645402;55894;245910;1673;100131608;245908;100132396;503618;392188;100289462;245909;414325;10407;645836,22
1,-1,8,7110870,7891743,780873,401447;503614;504180;503841;140596;100133251;653423;100131980;645402;55894;245910;1673;100131608;245908;100132396;503618;392188;100289462;245909;414325;10407;645836,22
1,-1,8,7110870,7891743,780873,401447;503614;504180;503841;140596;100133251;653423;100131980;645402;55894;245910;1673;100131608;245908;100132396;503618;392188;100289462;245909;414325;10407;645836,22
-1,-1,8,7110870,7891743,780873,401447;503614;504180;503841;140596;100133251;653423;100131980;645402;55894;245910;1673;100131608;245908;100132396;503618;392188;100289462;245909;414325;10407;645836,22
1,-1,8,7110870,7891743,780873,401447;503614;504180;503841;140596;100133251;653423;100131980;645402;55894;245910;1673;100131608;245908;100132396;503618;392188;100289462;245909;414325;10407;645836,22
1,-1,8,7110870,7891743,780873,401447;503614;504180;503841;140596;100133251;653423;100131980;645402;55894;245910;1673;100131608;245908;100132396;503618;392188;100289462;245909;414325;10407;645836,22
1,-1,8,7110870,7891743,780873,401447;503614;504180;503841;140596;100133251;653423;100131980;645402;55894;245910;1673;100131608;245908;100132396;503618;392188;100289462;245909;414325;10407;645836,22
-1,-1,8,7110870,7891743,780873,401447;503614;504180;503841;140596;100133251;653423;100131980;645402;55894;245910;1673;100131608;245908;100132396;503618;392188;100289462;245909;414325;10407;645836,22
1,-1,8,7110870,7891743,780873,401447;503614;504180;503841;140596;100133251;653423;100131980;645402;55894;245910;1673;100131608;245908;100132396;503618;392188;100289462;245909;414325;10407;645836,22
1,-1,8,7110870,7891743,780873,401447;503614;504180;503841;140596;100133251;653423;100131980;645402;55894;245910;1673;100131608;245908;100132396;503618;392188;100289462;245909;414325;10407;645836,22
1,-1,8,7110870,7891743,780873,401447;503614;504180;503841;140596;100133251;653423;100131980;645402;55894;245910;1673;100131608;245908;100132396;503618;392188;100289462;245909;414325;10407;645836,22
1,-1,8,7110870,7891743,780873,401447;503614;504180;503841;140596;100133251;653423;100131980;645402;55894;245910;1673;100131608;245908;100132396;503618;392188;100289462;245909;414325;10407;645836,22
1,-1,8,7110870,7891743,780873,401447;503614;504180;503841;140596;100133251;653423;100131980;645402;55894;245910;1673;100131608;245908;100132396;503618;392188;100289462;245909;414325;10407;645836,22
-1,-1,8,7110870,7891743,780873,401447;503614;504180;503841;140596;100133251;653423;100131980;645402;55894;245910;1673;100131608;245908;100132396;503618;392188;100289462;245909;414325;10407;645836,22
1,-1,8,7110870,7916703,805833,401447;503614;504180;503841;140596;100133251;653423;100131980;645402;55894;245910;1673;100131608;245908;100132396;503618;392188;100289462;245909;414325;10407;645836,22
1,-1,8,7110870,7916703,805833,401447;503614;504180;503841;140596;100133251;653423;100131980;645402;55894;245910;1673;100131608;245908;100132396;503618;392188;100289462;245909;414325;10407;645836,22
1,-1,8,7110870,7916703,805833,401447;503614;504180;503841;140596;100133251;653423;100131980;645402;55894;245910;1673;100131608;245908;100132396;503618;392188;100289462;245909;414325;10407;645836,22
1,-1,8,7110870,7916703,805833,401447;503614;504180;503841;140596;100133251;653423;100131980;645402;55894;245910;1673;100131608;245908;100132396;503618;392188;100289462;245909;414325;10407;645836,22
1,-1,8,7110870,7916703,805833,401447;503614;504180;503841;140596;100133251;653423;100131980;645402;55894;245910;1673;100131608;245908;100132396;503618;392188;100289462;245909;414325;10407;645836,22
1,-1,8,7110870,7916703,805833,401447;503614;504180;503841;140596;100133251;653423;100131980;645402;55894;245910;1673;100131608;245908;100132396;503618;392188;100289462;245909;414325;10407;645836,22
-1,-1,8,7110870,7927953,817083,401447;503614;504180;503841;140596;100133251;653423;100131980;645402;55894;245910;1673;100131608;245908;100132396;503618;392188;100289462;245909;414325;10407;645836,22
1,-1,8,7110870,7927953,817083,401447;503614;504180;503841;140596;100133251;653423;100131980;645402;55894;245910;1673;100131608;245908;100132396;503618;392188;100289462;245909;414325;10407;645836,22
1,-1,8,7110870,7957093,846223,401447;503614;504180;503841;140596;100133251;653423;100131980;645402;55894;245910;1673;100131608;245908;100132396;503618;392188;100289462;245909;414325;10407;645836,22
1,-1,8,7110870,7977100,866230,401447;503614;504180;503841;140596;100133251;653423;100131980;645402;55894;245910;1673;100131608;245908;100132396;503618;392188;100289462;245909;414325;10407;645836,22
1,-1,8,7110870,8111100,1000230,401447;503614;504180;503841;140596;100133251;653423;100131980;645402;55894;245910;1673;100131608;245908;100132396;503618;392188;100289462;245909;414325;10407;645836,22
1,-1,8,7110870,8167155,1056285,401447;503614;504180;503841;140596;100133251;653423;100131980;645402;55894;245910;1673;100131608;245908;100132396;503618;392188;100289462;245909;414325;10407;645836,22
1,-1,8,7113656,7151825,38169,,0
1,-1,8,7113656,7151825,38169,,0
-1,-1,8,7113656,7151825,38169,,0
-1,-1,8,7113656,7151825,38169,,0
1,-1,8,7113656,7151825,38169,,0
-1,-1,8,7113656,7881316,767660,401447;503614;504180;503841;140596;100133251;653423;100131980;645402;55894;245910;1673;100131608;245908;100132396;503618;392188;100289462;245909;414325;10407;645836,22
1,-1,8,7113656,7881316,767660,401447;503614;504180;503841;140596;100133251;653423;100131980;645402;55894;245910;1673;100131608;245908;100132396;503618;392188;100289462;245909;414325;10407;645836,22
-1,-1,8,7113656,7881316,767660,401447;503614;504180;503841;140596;100133251;653423;100131980;645402;55894;245910;1673;100131608;245908;100132396;503618;392188;100289462;245909;414325;10407;645836,22
1,-1,8,7113656,7881316,767660,401447;503614;504180;503841;140596;100133251;653423;100131980;645402;55894;245910;1673;100131608;245908;100132396;503618;392188;100289462;245909;414325;10407;645836,22
-1,-1,8,7113656,7881316,767660,401447;503614;504180;503841;140596;100133251;653423;100131980;645402;55894;245910;1673;100131608;245908;100132396;503618;392188;100289462;245909;414325;10407;645836,22
-1,-1,8,7113656,7881316,767660,401447;503614;504180;503841;140596;100133251;653423;100131980;645402;55894;245910;1673;100131608;245908;100132396;503618;392188;100289462;245909;414325;10407;645836,22
-1,-1,8,7113656,7881316,767660,401447;503614;504180;503841;140596;100133251;653423;100131980;645402;55894;245910;1673;100131608;245908;100132396;503618;392188;100289462;245909;414325;10407;645836,22
-1,-1,8,7113656,7881316,767660,401447;503614;504180;503841;140596;100133251;653423;100131980;645402;55894;245910;1673;100131608;245908;100132396;503618;392188;100289462;245909;414325;10407;645836,22
-1,-1,8,7113656,7881316,767660,401447;503614;504180;503841;140596;100133251;653423;100131980;645402;55894;245910;1673;100131608;245908;100132396;503618;392188;100289462;245909;414325;10407;645836,22
1,-1,8,7113656,7881316,767660,401447;503614;504180;503841;140596;100133251;653423;100131980;645402;55894;245910;1673;100131608;245908;100132396;503618;392188;100289462;245909;414325;10407;645836,22
-1,-1,8,7113656,8046312,932656,401447;503614;504180;503841;140596;100133251;653423;100131980;645402;55894;245910;1673;100131608;245908;100132396;503618;392188;100289462;245909;414325;10407;645836,22
-1,-1,8,7113656,8079912,966256,401447;503614;504180;503841;140596;100133251;653423;100131980;645402;55894;245910;1673;100131608;245908;100132396;503618;392188;100289462;245909;414325;10407;645836,22
-1,-1,8,7113659,7806223,692564,401447;503614;504180;503841;140596;100133251;653423;100131980;645402;55894;245910;1673;100131608;245908;100132396;503618;100289462;245909;414325;10407,20
1,-1,8,7113659,7806223,692564,401447;503614;504180;503841;140596;100133251;653423;100131980;645402;55894;245910;1673;100131608;245908;100132396;503618;100289462;245909;414325;10407,20
1,-1,8,7113659,7806223,692564,401447;503614;504180;503841;140596;100133251;653423;100131980;645402;55894;245910;1673;100131608;245908;100132396;503618;100289462;245909;414325;10407,20
-1,-1,8,7113659,7838937,725278,401447;503614;504180;503841;140596;100133251;653423;100131980;645402;55894;245910;1673;100131608;245908;100132396;503618;392188;100289462;245909;414325;10407;645836,22
-1,-1,8,7113659,7838937,725278,401447;503614;504180;503841;140596;100133251;653423;100131980;645402;55894;245910;1673;100131608;245908;100132396;503618;392188;100289462;245909;414325;10407;645836,22
-1,-1,8,7113661,8079920,966259,401447;503614;504180;503841;140596;100133251;653423;100131980;645402;55894;245910;1673;100131608;245908;100132396;503618;392188;100289462;245909;414325;10407;645836,22
-1,-1,8,7136520,7430402,293882,401447;100131608;503614;504180;503841;503618;100289462;100131980;645402;55894;10407,11
-1,-1,8,7136520,7430402,293882,401447;100131608;503614;504180;503841;503618;100289462;100131980;645402;55894;10407,11
-1,-1,8,7136520,7430402,293882,401447;100131608;503614;504180;503841;503618;100289462;100131980;645402;55894;10407,11
-1,-1,8,7136520,7430402,293882,401447;100131608;503614;504180;503841;503618;100289462;100131980;645402;55894;10407,11
-1,-1,8,7136520,7430402,293882,401447;100131608;503614;504180;503841;503618;100289462;100131980;645402;55894;10407,11
-1,-1,8,7136520,7430402,293882,401447;100131608;503614;504180;503841;503618;100289462;100131980;645402;55894;10407,11
-1,-1,8,7144115,7430402,286287,401447;100131608;503614;504180;503841;503618;100289462;100131980;645402;55894;10407,11
-1,-1,8,7144115,7430402,286287,401447;100131608;503614;504180;503841;503618;100289462;100131980;645402;55894;10407,11
-1,-1,8,7144115,7430402,286287,401447;100131608;503614;504180;503841;503618;100289462;100131980;645402;55894;10407,11
-1,-1,8,7144115,7430402,286287,401447;100131608;503614;504180;503841;503618;100289462;100131980;645402;55894;10407,11
-1,-1,8,7144115,7430402,286287,401447;100131608;503614;504180;503841;503618;100289462;100131980;645402;55894;10407,11
-1,-1,8,7144115,7430402,286287,401447;100131608;503614;504180;503841;503618;100289462;100131980;645402;55894;10407,11
-1,-1,8,7144115,7430402,286287,401447;100131608;503614;504180;503841;503618;100289462;100131980;645402;55894;10407,11
-1,-1,8,7144115,7430402,286287,401447;100131608;503614;504180;503841;503618;100289462;100131980;645402;55894;10407,11
-1,-1,8,7144115,7430402,286287,401447;100131608;503614;504180;503841;503618;100289462;100131980;645402;55894;10407,11
-1,-1,8,7144115,7430402,286287,401447;100131608;503614;504180;503841;503618;100289462;100131980;645402;55894;10407,11
-1,-1,8,7144115,7430402,286287,401447;100131608;503614;504180;503841;503618;100289462;100131980;645402;55894;10407,11
-1,-1,8,7144115,7430402,286287,401447;100131608;503614;504180;503841;503618;100289462;100131980;645402;55894;10407,11
-1,-1,8,7144115,7430402,286287,401447;100131608;503614;504180;503841;503618;100289462;100131980;645402;55894;10407,11
1,-1,8,7136579,7891743,755164,401447;503614;504180;503841;140596;100133251;653423;100131980;645402;55894;245910;1673;100131608;245908;100132396;503618;392188;100289462;245909;414325;10407;645836,22
-1,-1,8,7136579,7916703,780124,401447;503614;504180;503841;140596;100133251;653423;100131980;645402;55894;245910;1673;100131608;245908;100132396;503618;392188;100289462;245909;414325;10407;645836,22
-1,-1,8,7158248,7403699,245451,401447;100131608;503614;504180;503841;503618;100289462;100131980;645402;55894;10407,11
-1,-1,8,7158248,7408264,250016,401447;100131608;503614;504180;503841;503618;100289462;100131980;645402;55894;10407,11
-1,-1,8,7158248,7430402,272154,401447;100131608;503614;504180;503841;503618;100289462;100131980;645402;55894;10407,11
-1,-1,8,7158248,7430402,272154,401447;100131608;503614;504180;503841;503618;100289462;100131980;645402;55894;10407,11
-1,-1,8,7158248,7430402,272154,401447;100131608;503614;504180;503841;503618;100289462;100131980;645402;55894;10407,11
-1,-1,8,7158248,7430402,272154,401447;100131608;503614;504180;503841;503618;100289462;100131980;645402;55894;10407,11
-1,-1,8,7158248,7430402,272154,401447;100131608;503614;504180;503841;503618;100289462;100131980;645402;55894;10407,11
-1,-1,8,7158248,7430402,272154,401447;100131608;503614;504180;503841;503618;100289462;100131980;645402;55894;10407,11
-1,-1,8,7158248,7430402,272154,401447;100131608;503614;504180;503841;503618;100289462;100131980;645402;55894;10407,11
-1,-1,8,7158248,7430402,272154,401447;100131608;503614;504180;503841;503618;100289462;100131980;645402;55894;10407,11
-1,-1,8,7158248,7430402,272154,401447;100131608;503614;504180;503841;503618;100289462;100131980;645402;55894;10407,11
1,-1,8,7151823,8079850,928027,401447;503614;504180;503841;140596;100133251;653423;100131980;645402;55894;245910;1673;100131608;245908;100132396;503618;392188;100289462;245909;414325;10407;645836,22
1,-1,8,7151823,8079850,928027,401447;503614;504180;503841;140596;100133251;653423;100131980;645402;55894;245910;1673;100131608;245908;100132396;503618;392188;100289462;245909;414325;10407;645836,22
1,-1,8,7151823,8079850,928027,401447;503614;504180;503841;140596;100133251;653423;100131980;645402;55894;245910;1673;100131608;245908;100132396;503618;392188;100289462;245909;414325;10407;645836,22
1,-1,8,7151823,8111100,959277,401447;503614;504180;503841;140596;100133251;653423;100131980;645402;55894;245910;1673;100131608;245908;100132396;503618;392188;100289462;245909;414325;10407;645836,22
1,-1,8,7151823,8111100,959277,401447;503614;504180;503841;140596;100133251;653423;100131980;645402;55894;245910;1673;100131608;245908;100132396;503618;392188;100289462;245909;414325;10407;645836,22
-1,-1,8,7158253,7806223,647970,401447;503614;504180;503841;140596;100133251;653423;100131980;645402;55894;245910;1673;100131608;245908;100132396;503618;100289462;245909;414325;10407,20
1,-1,8,7158253,7838937,680684,401447;503614;504180;503841;140596;100133251;653423;100131980;645402;55894;245910;1673;100131608;245908;100132396;503618;392188;100289462;245909;414325;10407;645836,22
-1,-1,8,7169497,7403699,234202,401447;100131608;503614;504180;503841;503618;100289462;100131980;645402;55894;10407,11
-1,-1,8,7169497,7403699,234202,401447;100131608;503614;504180;503841;503618;100289462;100131980;645402;55894;10407,11
-1,-1,8,7169497,7403699,234202,401447;100131608;503614;504180;503841;503618;100289462;100131980;645402;55894;10407,11
-1,-1,8,7169497,7403699,234202,401447;100131608;503614;504180;503841;503618;100289462;100131980;645402;55894;10407,11
-1,-1,8,7169497,7403699,234202,401447;100131608;503614;504180;503841;503618;100289462;100131980;645402;55894;10407,11
-1,-1,8,7169497,7403699,234202,401447;100131608;503614;504180;503841;503618;100289462;100131980;645402;55894;10407,11
-1,-1,8,7169497,7403699,234202,401447;100131608;503614;504180;503841;503618;100289462;100131980;645402;55894;10407,11
-1,-1,8,7169497,7403699,234202,401447;100131608;503614;504180;503841;503618;100289462;100131980;645402;55894;10407,11
-1,-1,8,7169497,7403699,234202,401447;100131608;503614;504180;503841;503618;100289462;100131980;645402;55894;10407,11
-1,-1,8,7169497,7403699,234202,401447;100131608;503614;504180;503841;503618;100289462;100131980;645402;55894;10407,11
-1,-1,8,7169497,7403699,234202,401447;100131608;503614;504180;503841;503618;100289462;100131980;645402;55894;10407,11
-1,-1,8,7169497,7403699,234202,401447;100131608;503614;504180;503841;503618;100289462;100131980;645402;55894;10407,11
-1,-1,8,7169497,7408264,238767,401447;100131608;503614;504180;503841;503618;100289462;100131980;645402;55894;10407,11
1,-1,8,7169490,7403681,234191,401447;100131608;503614;504180;503841;503618;100289462;100131980;645402;55894;10407,11
1,-1,8,7169490,7403681,234191,401447;100131608;503614;504180;503841;503618;100289462;100131980;645402;55894;10407,11
-1,-1,8,7169490,7691960,522470,401447;100131608;503614;504180;503841;503618;245908;100289462;100133251;100131980;645402;245909;55894;10407;245910,15
1,-1,8,7169490,7691960,522470,401447;100131608;503614;504180;503841;503618;245908;100289462;100133251;100131980;645402;245909;55894;10407;245910,15
1,-1,8,7169490,7752586,583096,401447;503614;504180;503841;140596;100133251;653423;100131980;645402;55894;245910;1673;100131608;245908;503618;100289462;245909;414325;10407,19
-1,-1,8,7169490,7752586,583096,401447;503614;504180;503841;140596;100133251;653423;100131980;645402;55894;245910;1673;100131608;245908;503618;100289462;245909;414325;10407,19
-1,-1,8,7169490,7752586,583096,401447;503614;504180;503841;140596;100133251;653423;100131980;645402;55894;245910;1673;100131608;245908;503618;100289462;245909;414325;10407,19
-1,-1,8,7169490,7752586,583096,401447;503614;504180;503841;140596;100133251;653423;100131980;645402;55894;245910;1673;100131608;245908;503618;100289462;245909;414325;10407,19
1,-1,8,7169490,7752586,583096,401447;503614;504180;503841;140596;100133251;653423;100131980;645402;55894;245910;1673;100131608;245908;503618;100289462;245909;414325;10407,19
-1,-1,8,7169490,7752586,583096,401447;503614;504180;503841;140596;100133251;653423;100131980;645402;55894;245910;1673;100131608;245908;503618;100289462;245909;414325;10407,19
-1,-1,8,7169490,7752586,583096,401447;503614;504180;503841;140596;100133251;653423;100131980;645402;55894;245910;1673;100131608;245908;503618;100289462;245909;414325;10407,19
-1,-1,8,7169490,7806229,636739,401447;503614;504180;503841;140596;100133251;653423;100131980;645402;55894;245910;1673;100131608;245908;100132396;503618;100289462;245909;414325;10407,20
1,-1,8,7169490,7806229,636739,401447;503614;504180;503841;140596;100133251;653423;100131980;645402;55894;245910;1673;100131608;245908;100132396;503618;100289462;245909;414325;10407,20
-1,-1,8,7169490,7806229,636739,401447;503614;504180;503841;140596;100133251;653423;100131980;645402;55894;245910;1673;100131608;245908;100132396;503618;100289462;245909;414325;10407,20
-1,-1,8,7169490,7806229,636739,401447;503614;504180;503841;140596;100133251;653423;100131980;645402;55894;245910;1673;100131608;245908;100132396;503618;100289462;245909;414325;10407,20
-1,-1,8,7169490,7806229,636739,401447;503614;504180;503841;140596;100133251;653423;100131980;645402;55894;245910;1673;100131608;245908;100132396;503618;100289462;245909;414325;10407,20
1,-1,8,7169490,7806229,636739,401447;503614;504180;503841;140596;100133251;653423;100131980;645402;55894;245910;1673;100131608;245908;100132396;503618;100289462;245909;414325;10407,20
-1,-1,8,7169490,7806229,636739,401447;503614;504180;503841;140596;100133251;653423;100131980;645402;55894;245910;1673;100131608;245908;100132396;503618;100289462;245909;414325;10407,20
1,-1,8,7169490,7806229,636739,401447;503614;504180;503841;140596;100133251;653423;100131980;645402;55894;245910;1673;100131608;245908;100132396;503618;100289462;245909;414325;10407,20
-1,-1,8,7169490,7806229,636739,401447;503614;504180;503841;140596;100133251;653423;100131980;645402;55894;245910;1673;100131608;245908;100132396;503618;100289462;245909;414325;10407,20
1,-1,8,7169490,7806229,636739,401447;503614;504180;503841;140596;100133251;653423;100131980;645402;55894;245910;1673;100131608;245908;100132396;503618;100289462;245909;414325;10407,20
-1,-1,8,7169490,7806229,636739,401447;503614;504180;503841;140596;100133251;653423;100131980;645402;55894;245910;1673;100131608;245908;100132396;503618;100289462;245909;414325;10407,20
-1,-1,8,7169490,7806229,636739,401447;503614;504180;503841;140596;100133251;653423;100131980;645402;55894;245910;1673;100131608;245908;100132396;503618;100289462;245909;414325;10407,20
1,-1,8,7169490,7806229,636739,401447;503614;504180;503841;140596;100133251;653423;100131980;645402;55894;245910;1673;100131608;245908;100132396;503618;100289462;245909;414325;10407,20
-1,-1,8,7169490,7806229,636739,401447;503614;504180;503841;140596;100133251;653423;100131980;645402;55894;245910;1673;100131608;245908;100132396;503618;100289462;245909;414325;10407,20
-1,-1,8,7169490,8079920,910430,401447;503614;504180;503841;140596;100133251;653423;100131980;645402;55894;245910;1673;100131608;245908;100132396;503618;392188;100289462;245909;414325;10407;645836,22
1,-1,8,7169490,8079920,910430,401447;503614;504180;503841;140596;100133251;653423;100131980;645402;55894;245910;1673;100131608;245908;100132396;503618;392188;100289462;245909;414325;10407;645836,22
1,-1,8,7169490,8079920,910430,401447;503614;504180;503841;140596;100133251;653423;100131980;645402;55894;245910;1673;100131608;245908;100132396;503618;392188;100289462;245909;414325;10407;645836,22
-1,-1,8,7169490,8079920,910430,401447;503614;504180;503841;140596;100133251;653423;100131980;645402;55894;245910;1673;100131608;245908;100132396;503618;392188;100289462;245909;414325;10407;645836,22
-1,-1,8,7169490,8079920,910430,401447;503614;504180;503841;140596;100133251;653423;100131980;645402;55894;245910;1673;100131608;245908;100132396;503618;392188;100289462;245909;414325;10407;645836,22
-1,-1,8,7169490,8079920,910430,401447;503614;504180;503841;140596;100133251;653423;100131980;645402;55894;245910;1673;100131608;245908;100132396;503618;392188;100289462;245909;414325;10407;645836,22
1,-1,8,7169490,8079920,910430,401447;503614;504180;503841;140596;100133251;653423;100131980;645402;55894;245910;1673;100131608;245908;100132396;503618;392188;100289462;245909;414325;10407;645836,22
-1,-1,8,7169490,8079920,910430,401447;503614;504180;503841;140596;100133251;653423;100131980;645402;55894;245910;1673;100131608;245908;100132396;503618;392188;100289462;245909;414325;10407;645836,22
1,-1,8,7169490,8079920,910430,401447;503614;504180;503841;140596;100133251;653423;100131980;645402;55894;245910;1673;100131608;245908;100132396;503618;392188;100289462;245909;414325;10407;645836,22
1,-1,8,7169490,8079920,910430,401447;503614;504180;503841;140596;100133251;653423;100131980;645402;55894;245910;1673;100131608;245908;100132396;503618;392188;100289462;245909;414325;10407;645836,22
-1,-1,8,7169490,8094773,925283,401447;503614;504180;503841;140596;100133251;653423;100131980;645402;55894;245910;1673;100131608;245908;100132396;503618;392188;100289462;245909;414325;10407;645836,22
1,1,8,7169490,12404062,5234572,401447;392197;1508;377630;83650;504180;503841;245940;203076;83648;55894;245910;613209;157285;252969;245908;100132396;503618;54984;392188;100289462;4482;613211;203074;245909;90459;503614;140596;83595;100133267;100133251;653423;100131980;645402;2626;85002;613210;137075;1673;728957;100131608;640;66036;286046;79660;2222;8658;9258;414325;653333;94137;10407;645836,53
-1,1,8,7169490,12404062,5234572,401447;392197;1508;377630;83650;504180;503841;245940;203076;83648;55894;245910;613209;157285;252969;245908;100132396;503618;54984;392188;100289462;4482;613211;203074;245909;90459;503614;140596;83595;100133267;100133251;653423;100131980;645402;2626;85002;613210;137075;1673;728957;100131608;640;66036;286046;79660;2222;8658;9258;414325;653333;94137;10407;645836,53
-1,-1,8,7169510,7691845,522335,401447;100131608;503614;504180;503841;503618;245908;100289462;100133251;100131980;645402;245909;55894;10407;245910,15
-1,-1,8,7169510,7691845,522335,401447;100131608;503614;504180;503841;503618;245908;100289462;100133251;100131980;645402;245909;55894;10407;245910,15
-1,-1,8,7169510,7691845,522335,401447;100131608;503614;504180;503841;503618;245908;100289462;100133251;100131980;645402;245909;55894;10407;245910,15
-1,-1,8,7169510,7691845,522335,401447;100131608;503614;504180;503841;503618;245908;100289462;100133251;100131980;645402;245909;55894;10407;245910,15
-1,-1,8,7169510,7691845,522335,401447;100131608;503614;504180;503841;503618;245908;100289462;100133251;100131980;645402;245909;55894;10407;245910,15
-1,-1,8,7169510,7691845,522335,401447;100131608;503614;504180;503841;503618;245908;100289462;100133251;100131980;645402;245909;55894;10407;245910,15
1,-1,8,7169510,7691845,522335,401447;100131608;503614;504180;503841;503618;245908;100289462;100133251;100131980;645402;245909;55894;10407;245910,15
-1,-1,8,7169510,7691845,522335,401447;100131608;503614;504180;503841;503618;245908;100289462;100133251;100131980;645402;245909;55894;10407;245910,15
-1,-1,8,7169510,7691845,522335,401447;100131608;503614;504180;503841;503618;245908;100289462;100133251;100131980;645402;245909;55894;10407;245910,15
-1,-1,8,7169510,7691845,522335,401447;100131608;503614;504180;503841;503618;245908;100289462;100133251;100131980;645402;245909;55894;10407;245910,15
-1,-1,8,7169510,7691845,522335,401447;100131608;503614;504180;503841;503618;245908;100289462;100133251;100131980;645402;245909;55894;10407;245910,15
-1,-1,8,7169510,7691845,522335,401447;100131608;503614;504180;503841;503618;245908;100289462;100133251;100131980;645402;245909;55894;10407;245910,15
-1,-1,8,7169510,7691845,522335,401447;100131608;503614;504180;503841;503618;245908;100289462;100133251;100131980;645402;245909;55894;10407;245910,15
-1,-1,8,7169510,7691845,522335,401447;100131608;503614;504180;503841;503618;245908;100289462;100133251;100131980;645402;245909;55894;10407;245910,15
-1,-1,8,7169510,7691845,522335,401447;100131608;503614;504180;503841;503618;245908;100289462;100133251;100131980;645402;245909;55894;10407;245910,15
-1,-1,8,7169510,7691845,522335,401447;100131608;503614;504180;503841;503618;245908;100289462;100133251;100131980;645402;245909;55894;10407;245910,15
-1,-1,8,7169510,7691845,522335,401447;100131608;503614;504180;503841;503618;245908;100289462;100133251;100131980;645402;245909;55894;10407;245910,15
-1,-1,8,7169510,7691845,522335,401447;100131608;503614;504180;503841;503618;245908;100289462;100133251;100131980;645402;245909;55894;10407;245910,15
-1,-1,8,7169510,7691845,522335,401447;100131608;503614;504180;503841;503618;245908;100289462;100133251;100131980;645402;245909;55894;10407;245910,15
-1,-1,8,7169510,7691845,522335,401447;100131608;503614;504180;503841;503618;245908;100289462;100133251;100131980;645402;245909;55894;10407;245910,15
-1,-1,8,7169510,7691845,522335,401447;100131608;503614;504180;503841;503618;245908;100289462;100133251;100131980;645402;245909;55894;10407;245910,15
-1,-1,8,7169510,7691845,522335,401447;100131608;503614;504180;503841;503618;245908;100289462;100133251;100131980;645402;245909;55894;10407;245910,15
-1,-1,8,7169510,7691845,522335,401447;100131608;503614;504180;503841;503618;245908;100289462;100133251;100131980;645402;245909;55894;10407;245910,15
-1,-1,8,7169510,7691845,522335,401447;100131608;503614;504180;503841;503618;245908;100289462;100133251;100131980;645402;245909;55894;10407;245910,15
-1,-1,8,7169510,7691845,522335,401447;100131608;503614;504180;503841;503618;245908;100289462;100133251;100131980;645402;245909;55894;10407;245910,15
-1,-1,8,7169510,7752596,583086,401447;503614;504180;503841;140596;100133251;653423;100131980;645402;55894;245910;1673;100131608;245908;503618;100289462;245909;414325;10407,19
-1,-1,8,7169510,7752596,583086,401447;503614;504180;503841;140596;100133251;653423;100131980;645402;55894;245910;1673;100131608;245908;503618;100289462;245909;414325;10407,19
-1,-1,8,7169510,7752596,583086,401447;503614;504180;503841;140596;100133251;653423;100131980;645402;55894;245910;1673;100131608;245908;503618;100289462;245909;414325;10407,19
-1,-1,8,7169510,7752596,583086,401447;503614;504180;503841;140596;100133251;653423;100131980;645402;55894;245910;1673;100131608;245908;503618;100289462;245909;414325;10407,19
-1,-1,8,7169510,7752596,583086,401447;503614;504180;503841;140596;100133251;653423;100131980;645402;55894;245910;1673;100131608;245908;503618;100289462;245909;414325;10407,19
-1,-1,8,7169510,7752596,583086,401447;503614;504180;503841;140596;100133251;653423;100131980;645402;55894;245910;1673;100131608;245908;503618;100289462;245909;414325;10407,19
-1,-1,8,7169510,7752596,583086,401447;503614;504180;503841;140596;100133251;653423;100131980;645402;55894;245910;1673;100131608;245908;503618;100289462;245909;414325;10407,19
-1,-1,8,7169510,7752596,583086,401447;503614;504180;503841;140596;100133251;653423;100131980;645402;55894;245910;1673;100131608;245908;503618;100289462;245909;414325;10407,19
-1,-1,8,7169510,7752596,583086,401447;503614;504180;503841;140596;100133251;653423;100131980;645402;55894;245910;1673;100131608;245908;503618;100289462;245909;414325;10407,19
-1,-1,8,7169510,7752596,583086,401447;503614;504180;503841;140596;100133251;653423;100131980;645402;55894;245910;1673;100131608;245908;503618;100289462;245909;414325;10407,19
-1,-1,8,7169510,7752596,583086,401447;503614;504180;503841;140596;100133251;653423;100131980;645402;55894;245910;1673;100131608;245908;503618;100289462;245909;414325;10407,19
-1,-1,8,7169510,7752596,583086,401447;503614;504180;503841;140596;100133251;653423;100131980;645402;55894;245910;1673;100131608;245908;503618;100289462;245909;414325;10407,19
-1,-1,8,7169510,7752596,583086,401447;503614;504180;503841;140596;100133251;653423;100131980;645402;55894;245910;1673;100131608;245908;503618;100289462;245909;414325;10407,19
-1,-1,8,7169510,7752596,583086,401447;503614;504180;503841;140596;100133251;653423;100131980;645402;55894;245910;1673;100131608;245908;503618;100289462;245909;414325;10407,19
-1,-1,8,7169510,7752596,583086,401447;503614;504180;503841;140596;100133251;653423;100131980;645402;55894;245910;1673;100131608;245908;503618;100289462;245909;414325;10407,19
-1,-1,8,7169510,7752596,583086,401447;503614;504180;503841;140596;100133251;653423;100131980;645402;55894;245910;1673;100131608;245908;503618;100289462;245909;414325;10407,19
-1,-1,8,7169510,7752596,583086,401447;503614;504180;503841;140596;100133251;653423;100131980;645402;55894;245910;1673;100131608;245908;503618;100289462;245909;414325;10407,19
-1,-1,8,7169510,7752596,583086,401447;503614;504180;503841;140596;100133251;653423;100131980;645402;55894;245910;1673;100131608;245908;503618;100289462;245909;414325;10407,19
1,-1,8,7169510,7752596,583086,401447;503614;504180;503841;140596;100133251;653423;100131980;645402;55894;245910;1673;100131608;245908;503618;100289462;245909;414325;10407,19
-1,-1,8,7169510,7752596,583086,401447;503614;504180;503841;140596;100133251;653423;100131980;645402;55894;245910;1673;100131608;245908;503618;100289462;245909;414325;10407,19
-1,-1,8,7169510,7752596,583086,401447;503614;504180;503841;140596;100133251;653423;100131980;645402;55894;245910;1673;100131608;245908;503618;100289462;245909;414325;10407,19
1,-1,8,7169510,7752596,583086,401447;503614;504180;503841;140596;100133251;653423;100131980;645402;55894;245910;1673;100131608;245908;503618;100289462;245909;414325;10407,19
-1,-1,8,7169510,7752596,583086,401447;503614;504180;503841;140596;100133251;653423;100131980;645402;55894;245910;1673;100131608;245908;503618;100289462;245909;414325;10407,19
-1,-1,8,7169510,7752596,583086,401447;503614;504180;503841;140596;100133251;653423;100131980;645402;55894;245910;1673;100131608;245908;503618;100289462;245909;414325;10407,19
-1,-1,8,7169510,7752596,583086,401447;503614;504180;503841;140596;100133251;653423;100131980;645402;55894;245910;1673;100131608;245908;503618;100289462;245909;414325;10407,19
-1,-1,8,7169510,7752596,583086,401447;503614;504180;503841;140596;100133251;653423;100131980;645402;55894;245910;1673;100131608;245908;503618;100289462;245909;414325;10407,19
-1,-1,8,7169510,7752596,583086,401447;503614;504180;503841;140596;100133251;653423;100131980;645402;55894;245910;1673;100131608;245908;503618;100289462;245909;414325;10407,19
-1,-1,8,7169510,7752596,583086,401447;503614;504180;503841;140596;100133251;653423;100131980;645402;55894;245910;1673;100131608;245908;503618;100289462;245909;414325;10407,19
-1,-1,8,7169510,7752596,583086,401447;503614;504180;503841;140596;100133251;653423;100131980;645402;55894;245910;1673;100131608;245908;503618;100289462;245909;414325;10407,19
-1,-1,8,7169510,7752596,583086,401447;503614;504180;503841;140596;100133251;653423;100131980;645402;55894;245910;1673;100131608;245908;503618;100289462;245909;414325;10407,19
-1,-1,8,7169510,7752596,583086,401447;503614;504180;503841;140596;100133251;653423;100131980;645402;55894;245910;1673;100131608;245908;503618;100289462;245909;414325;10407,19
-1,-1,8,7169510,7752596,583086,401447;503614;504180;503841;140596;100133251;653423;100131980;645402;55894;245910;1673;100131608;245908;503618;100289462;245909;414325;10407,19
-1,-1,8,7169510,7752596,583086,401447;503614;504180;503841;140596;100133251;653423;100131980;645402;55894;245910;1673;100131608;245908;503618;100289462;245909;414325;10407,19
1,-1,8,7169510,7752596,583086,401447;503614;504180;503841;140596;100133251;653423;100131980;645402;55894;245910;1673;100131608;245908;503618;100289462;245909;414325;10407,19
-1,-1,8,7169510,7752596,583086,401447;503614;504180;503841;140596;100133251;653423;100131980;645402;55894;245910;1673;100131608;245908;503618;100289462;245909;414325;10407,19
-1,-1,8,7169510,7752596,583086,401447;503614;504180;503841;140596;100133251;653423;100131980;645402;55894;245910;1673;100131608;245908;503618;100289462;245909;414325;10407,19
-1,-1,8,7169510,7752596,583086,401447;503614;504180;503841;140596;100133251;653423;100131980;645402;55894;245910;1673;100131608;245908;503618;100289462;245909;414325;10407,19
-1,-1,8,7169510,7752596,583086,401447;503614;504180;503841;140596;100133251;653423;100131980;645402;55894;245910;1673;100131608;245908;503618;100289462;245909;414325;10407,19
-1,-1,8,7169510,7752596,583086,401447;503614;504180;503841;140596;100133251;653423;100131980;645402;55894;245910;1673;100131608;245908;503618;100289462;245909;414325;10407,19
-1,-1,8,7169510,7752596,583086,401447;503614;504180;503841;140596;100133251;653423;100131980;645402;55894;245910;1673;100131608;245908;503618;100289462;245909;414325;10407,19
-1,-1,8,7169510,7752596,583086,401447;503614;504180;503841;140596;100133251;653423;100131980;645402;55894;245910;1673;100131608;245908;503618;100289462;245909;414325;10407,19
-1,-1,8,7169510,7752596,583086,401447;503614;504180;503841;140596;100133251;653423;100131980;645402;55894;245910;1673;100131608;245908;503618;100289462;245909;414325;10407,19
-1,-1,8,7169510,7752596,583086,401447;503614;504180;503841;140596;100133251;653423;100131980;645402;55894;245910;1673;100131608;245908;503618;100289462;245909;414325;10407,19
-1,-1,8,7169510,7752596,583086,401447;503614;504180;503841;140596;100133251;653423;100131980;645402;55894;245910;1673;100131608;245908;503618;100289462;245909;414325;10407,19
-1,-1,8,7169510,7752596,583086,401447;503614;504180;503841;140596;100133251;653423;100131980;645402;55894;245910;1673;100131608;245908;503618;100289462;245909;414325;10407,19
-1,-1,8,7169510,7752596,583086,401447;503614;504180;503841;140596;100133251;653423;100131980;645402;55894;245910;1673;100131608;245908;503618;100289462;245909;414325;10407,19
-1,-1,8,7169510,7752596,583086,401447;503614;504180;503841;140596;100133251;653423;100131980;645402;55894;245910;1673;100131608;245908;503618;100289462;245909;414325;10407,19
1,-1,8,7169510,7752596,583086,401447;503614;504180;503841;140596;100133251;653423;100131980;645402;55894;245910;1673;100131608;245908;503618;100289462;245909;414325;10407,19
1,-1,8,7169510,7752596,583086,401447;503614;504180;503841;140596;100133251;653423;100131980;645402;55894;245910;1673;100131608;245908;503618;100289462;245909;414325;10407,19
-1,-1,8,7169510,7752596,583086,401447;503614;504180;503841;140596;100133251;653423;100131980;645402;55894;245910;1673;100131608;245908;503618;100289462;245909;414325;10407,19
1,-1,8,7169510,7752596,583086,401447;503614;504180;503841;140596;100133251;653423;100131980;645402;55894;245910;1673;100131608;245908;503618;100289462;245909;414325;10407,19
-1,-1,8,7169510,7752596,583086,401447;503614;504180;503841;140596;100133251;653423;100131980;645402;55894;245910;1673;100131608;245908;503618;100289462;245909;414325;10407,19
-1,-1,8,7169510,7752596,583086,401447;503614;504180;503841;140596;100133251;653423;100131980;645402;55894;245910;1673;100131608;245908;503618;100289462;245909;414325;10407,19
-1,-1,8,7169510,7752596,583086,401447;503614;504180;503841;140596;100133251;653423;100131980;645402;55894;245910;1673;100131608;245908;503618;100289462;245909;414325;10407,19
1,-1,8,7169510,7752596,583086,401447;503614;504180;503841;140596;100133251;653423;100131980;645402;55894;245910;1673;100131608;245908;503618;100289462;245909;414325;10407,19
-1,-1,8,7169510,7752596,583086,401447;503614;504180;503841;140596;100133251;653423;100131980;645402;55894;245910;1673;100131608;245908;503618;100289462;245909;414325;10407,19
-1,-1,8,7169510,7752596,583086,401447;503614;504180;503841;140596;100133251;653423;100131980;645402;55894;245910;1673;100131608;245908;503618;100289462;245909;414325;10407,19
-1,-1,8,7169510,7752596,583086,401447;503614;504180;503841;140596;100133251;653423;100131980;645402;55894;245910;1673;100131608;245908;503618;100289462;245909;414325;10407,19
-1,-1,8,7169510,7752596,583086,401447;503614;504180;503841;140596;100133251;653423;100131980;645402;55894;245910;1673;100131608;245908;503618;100289462;245909;414325;10407,19
-1,-1,8,7169510,7752596,583086,401447;503614;504180;503841;140596;100133251;653423;100131980;645402;55894;245910;1673;100131608;245908;503618;100289462;245909;414325;10407,19
-1,-1,8,7169510,7752596,583086,401447;503614;504180;503841;140596;100133251;653423;100131980;645402;55894;245910;1673;100131608;245908;503618;100289462;245909;414325;10407,19
-1,-1,8,7169510,7752596,583086,401447;503614;504180;503841;140596;100133251;653423;100131980;645402;55894;245910;1673;100131608;245908;503618;100289462;245909;414325;10407,19
-1,-1,8,7169510,7752596,583086,401447;503614;504180;503841;140596;100133251;653423;100131980;645402;55894;245910;1673;100131608;245908;503618;100289462;245909;414325;10407,19
-1,-1,8,7169510,7752596,583086,401447;503614;504180;503841;140596;100133251;653423;100131980;645402;55894;245910;1673;100131608;245908;503618;100289462;245909;414325;10407,19
-1,-1,8,7169510,7752596,583086,401447;503614;504180;503841;140596;100133251;653423;100131980;645402;55894;245910;1673;100131608;245908;503618;100289462;245909;414325;10407,19
-1,-1,8,7169510,7752596,583086,401447;503614;504180;503841;140596;100133251;653423;100131980;645402;55894;245910;1673;100131608;245908;503618;100289462;245909;414325;10407,19
-1,-1,8,7169510,7752596,583086,401447;503614;504180;503841;140596;100133251;653423;100131980;645402;55894;245910;1673;100131608;245908;503618;100289462;245909;414325;10407,19
-1,-1,8,7169510,7752596,583086,401447;503614;504180;503841;140596;100133251;653423;100131980;645402;55894;245910;1673;100131608;245908;503618;100289462;245909;414325;10407,19
-1,-1,8,7169510,7752596,583086,401447;503614;504180;503841;140596;100133251;653423;100131980;645402;55894;245910;1673;100131608;245908;503618;100289462;245909;414325;10407,19
-1,-1,8,7169510,7752596,583086,401447;503614;504180;503841;140596;100133251;653423;100131980;645402;55894;245910;1673;100131608;245908;503618;100289462;245909;414325;10407,19
1,-1,8,7169510,7752596,583086,401447;503614;504180;503841;140596;100133251;653423;100131980;645402;55894;245910;1673;100131608;245908;503618;100289462;245909;414325;10407,19
-1,-1,8,7169510,7752596,583086,401447;503614;504180;503841;140596;100133251;653423;100131980;645402;55894;245910;1673;100131608;245908;503618;100289462;245909;414325;10407,19
-1,-1,8,7169510,7752596,583086,401447;503614;504180;503841;140596;100133251;653423;100131980;645402;55894;245910;1673;100131608;245908;503618;100289462;245909;414325;10407,19
-1,-1,8,7169510,7752596,583086,401447;503614;504180;503841;140596;100133251;653423;100131980;645402;55894;245910;1673;100131608;245908;503618;100289462;245909;414325;10407,19
1,-1,8,7169510,7752596,583086,401447;503614;504180;503841;140596;100133251;653423;100131980;645402;55894;245910;1673;100131608;245908;503618;100289462;245909;414325;10407,19
-1,-1,8,7169510,7752596,583086,401447;503614;504180;503841;140596;100133251;653423;100131980;645402;55894;245910;1673;100131608;245908;503618;100289462;245909;414325;10407,19
-1,-1,8,7169510,7752596,583086,401447;503614;504180;503841;140596;100133251;653423;100131980;645402;55894;245910;1673;100131608;245908;503618;100289462;245909;414325;10407,19
-1,-1,8,7169510,7752596,583086,401447;503614;504180;503841;140596;100133251;653423;100131980;645402;55894;245910;1673;100131608;245908;503618;100289462;245909;414325;10407,19
-1,-1,8,7169510,7752596,583086,401447;503614;504180;503841;140596;100133251;653423;100131980;645402;55894;245910;1673;100131608;245908;503618;100289462;245909;414325;10407,19
-1,-1,8,7169510,7752596,583086,401447;503614;504180;503841;140596;100133251;653423;100131980;645402;55894;245910;1673;100131608;245908;503618;100289462;245909;414325;10407,19
-1,-1,8,7169510,7752596,583086,401447;503614;504180;503841;140596;100133251;653423;100131980;645402;55894;245910;1673;100131608;245908;503618;100289462;245909;414325;10407,19
-1,-1,8,7169510,7752596,583086,401447;503614;504180;503841;140596;100133251;653423;100131980;645402;55894;245910;1673;100131608;245908;503618;100289462;245909;414325;10407,19
-1,-1,8,7169510,7806227,636717,401447;503614;504180;503841;140596;100133251;653423;100131980;645402;55894;245910;1673;100131608;245908;100132396;503618;100289462;245909;414325;10407,20
-1,-1,8,7169510,7806227,636717,401447;503614;504180;503841;140596;100133251;653423;100131980;645402;55894;245910;1673;100131608;245908;100132396;503618;100289462;245909;414325;10407,20
-1,-1,8,7169510,7806227,636717,401447;503614;504180;503841;140596;100133251;653423;100131980;645402;55894;245910;1673;100131608;245908;100132396;503618;100289462;245909;414325;10407,20
-1,-1,8,7169510,7806227,636717,401447;503614;504180;503841;140596;100133251;653423;100131980;645402;55894;245910;1673;100131608;245908;100132396;503618;100289462;245909;414325;10407,20
-1,-1,8,7169510,7806227,636717,401447;503614;504180;503841;140596;100133251;653423;100131980;645402;55894;245910;1673;100131608;245908;100132396;503618;100289462;245909;414325;10407,20
-1,-1,8,7169510,7806227,636717,401447;503614;504180;503841;140596;100133251;653423;100131980;645402;55894;245910;1673;100131608;245908;100132396;503618;100289462;245909;414325;10407,20
-1,-1,8,7169510,7806227,636717,401447;503614;504180;503841;140596;100133251;653423;100131980;645402;55894;245910;1673;100131608;245908;100132396;503618;100289462;245909;414325;10407,20
-1,-1,8,7169510,7806227,636717,401447;503614;504180;503841;140596;100133251;653423;100131980;645402;55894;245910;1673;100131608;245908;100132396;503618;100289462;245909;414325;10407,20
1,-1,8,7169510,7806227,636717,401447;503614;504180;503841;140596;100133251;653423;100131980;645402;55894;245910;1673;100131608;245908;100132396;503618;100289462;245909;414325;10407,20
-1,-1,8,7169510,7806227,636717,401447;503614;504180;503841;140596;100133251;653423;100131980;645402;55894;245910;1673;100131608;245908;100132396;503618;100289462;245909;414325;10407,20
-1,-1,8,7169510,7806227,636717,401447;503614;504180;503841;140596;100133251;653423;100131980;645402;55894;245910;1673;100131608;245908;100132396;503618;100289462;245909;414325;10407,20
-1,-1,8,7169510,7806227,636717,401447;503614;504180;503841;140596;100133251;653423;100131980;645402;55894;245910;1673;100131608;245908;100132396;503618;100289462;245909;414325;10407,20
-1,-1,8,7169510,7806227,636717,401447;503614;504180;503841;140596;100133251;653423;100131980;645402;55894;245910;1673;100131608;245908;100132396;503618;100289462;245909;414325;10407,20
-1,-1,8,7169510,7806227,636717,401447;503614;504180;503841;140596;100133251;653423;100131980;645402;55894;245910;1673;100131608;245908;100132396;503618;100289462;245909;414325;10407,20
-1,-1,8,7169510,7806227,636717,401447;503614;504180;503841;140596;100133251;653423;100131980;645402;55894;245910;1673;100131608;245908;100132396;503618;100289462;245909;414325;10407,20
-1,-1,8,7169510,7806227,636717,401447;503614;504180;503841;140596;100133251;653423;100131980;645402;55894;245910;1673;100131608;245908;100132396;503618;100289462;245909;414325;10407,20
-1,-1,8,7169510,7806227,636717,401447;503614;504180;503841;140596;100133251;653423;100131980;645402;55894;245910;1673;100131608;245908;100132396;503618;100289462;245909;414325;10407,20
-1,-1,8,7169510,7806227,636717,401447;503614;504180;503841;140596;100133251;653423;100131980;645402;55894;245910;1673;100131608;245908;100132396;503618;100289462;245909;414325;10407,20
-1,-1,8,7169510,7806227,636717,401447;503614;504180;503841;140596;100133251;653423;100131980;645402;55894;245910;1673;100131608;245908;100132396;503618;100289462;245909;414325;10407,20
-1,-1,8,7169510,7806227,636717,401447;503614;504180;503841;140596;100133251;653423;100131980;645402;55894;245910;1673;100131608;245908;100132396;503618;100289462;245909;414325;10407,20
-1,-1,8,7169510,7806227,636717,401447;503614;504180;503841;140596;100133251;653423;100131980;645402;55894;245910;1673;100131608;245908;100132396;503618;100289462;245909;414325;10407,20
-1,-1,8,7169510,7806227,636717,401447;503614;504180;503841;140596;100133251;653423;100131980;645402;55894;245910;1673;100131608;245908;100132396;503618;100289462;245909;414325;10407,20
-1,-1,8,7169510,7806227,636717,401447;503614;504180;503841;140596;100133251;653423;100131980;645402;55894;245910;1673;100131608;245908;100132396;503618;100289462;245909;414325;10407,20
1,-1,8,7169510,7806227,636717,401447;503614;504180;503841;140596;100133251;653423;100131980;645402;55894;245910;1673;100131608;245908;100132396;503618;100289462;245909;414325;10407,20
-1,-1,8,7169510,7806227,636717,401447;503614;504180;503841;140596;100133251;653423;100131980;645402;55894;245910;1673;100131608;245908;100132396;503618;100289462;245909;414325;10407,20
-1,-1,8,7169510,7806227,636717,401447;503614;504180;503841;140596;100133251;653423;100131980;645402;55894;245910;1673;100131608;245908;100132396;503618;100289462;245909;414325;10407,20
-1,-1,8,7169510,7806227,636717,401447;503614;504180;503841;140596;100133251;653423;100131980;645402;55894;245910;1673;100131608;245908;100132396;503618;100289462;245909;414325;10407,20
-1,-1,8,7169510,7806227,636717,401447;503614;504180;503841;140596;100133251;653423;100131980;645402;55894;245910;1673;100131608;245908;100132396;503618;100289462;245909;414325;10407,20
1,-1,8,7169510,7806227,636717,401447;503614;504180;503841;140596;100133251;653423;100131980;645402;55894;245910;1673;100131608;245908;100132396;503618;100289462;245909;414325;10407,20
-1,-1,8,7169510,7806227,636717,401447;503614;504180;503841;140596;100133251;653423;100131980;645402;55894;245910;1673;100131608;245908;100132396;503618;100289462;245909;414325;10407,20
1,-1,8,7169510,7806227,636717,401447;503614;504180;503841;140596;100133251;653423;100131980;645402;55894;245910;1673;100131608;245908;100132396;503618;100289462;245909;414325;10407,20
-1,-1,8,7169510,7806227,636717,401447;503614;504180;503841;140596;100133251;653423;100131980;645402;55894;245910;1673;100131608;245908;100132396;503618;100289462;245909;414325;10407,20
-1,-1,8,7169510,7806227,636717,401447;503614;504180;503841;140596;100133251;653423;100131980;645402;55894;245910;1673;100131608;245908;100132396;503618;100289462;245909;414325;10407,20
1,-1,8,7169510,7806227,636717,401447;503614;504180;503841;140596;100133251;653423;100131980;645402;55894;245910;1673;100131608;245908;100132396;503618;100289462;245909;414325;10407,20
-1,-1,8,7169510,7806227,636717,401447;503614;504180;503841;140596;100133251;653423;100131980;645402;55894;245910;1673;100131608;245908;100132396;503618;100289462;245909;414325;10407,20
1,-1,8,7169510,7806227,636717,401447;503614;504180;503841;140596;100133251;653423;100131980;645402;55894;245910;1673;100131608;245908;100132396;503618;100289462;245909;414325;10407,20
-1,-1,8,7169510,7806227,636717,401447;503614;504180;503841;140596;100133251;653423;100131980;645402;55894;245910;1673;100131608;245908;100132396;503618;100289462;245909;414325;10407,20
-1,-1,8,7169510,7806227,636717,401447;503614;504180;503841;140596;100133251;653423;100131980;645402;55894;245910;1673;100131608;245908;100132396;503618;100289462;245909;414325;10407,20
-1,-1,8,7169510,7806227,636717,401447;503614;504180;503841;140596;100133251;653423;100131980;645402;55894;245910;1673;100131608;245908;100132396;503618;100289462;245909;414325;10407,20
-1,-1,8,7169510,7806227,636717,401447;503614;504180;503841;140596;100133251;653423;100131980;645402;55894;245910;1673;100131608;245908;100132396;503618;100289462;245909;414325;10407,20
-1,-1,8,7169510,7806227,636717,401447;503614;504180;503841;140596;100133251;653423;100131980;645402;55894;245910;1673;100131608;245908;100132396;503618;100289462;245909;414325;10407,20
-1,-1,8,7169510,7806227,636717,401447;503614;504180;503841;140596;100133251;653423;100131980;645402;55894;245910;1673;100131608;245908;100132396;503618;100289462;245909;414325;10407,20
1,-1,8,7169510,7806227,636717,401447;503614;504180;503841;140596;100133251;653423;100131980;645402;55894;245910;1673;100131608;245908;100132396;503618;100289462;245909;414325;10407,20
-1,-1,8,7169510,7806227,636717,401447;503614;504180;503841;140596;100133251;653423;100131980;645402;55894;245910;1673;100131608;245908;100132396;503618;100289462;245909;414325;10407,20
-1,-1,8,7169510,7806227,636717,401447;503614;504180;503841;140596;100133251;653423;100131980;645402;55894;245910;1673;100131608;245908;100132396;503618;100289462;245909;414325;10407,20
1,-1,8,7169510,7806227,636717,401447;503614;504180;503841;140596;100133251;653423;100131980;645402;55894;245910;1673;100131608;245908;100132396;503618;100289462;245909;414325;10407,20
-1,-1,8,7169510,7806227,636717,401447;503614;504180;503841;140596;100133251;653423;100131980;645402;55894;245910;1673;100131608;245908;100132396;503618;100289462;245909;414325;10407,20
-1,-1,8,7169510,7806227,636717,401447;503614;504180;503841;140596;100133251;653423;100131980;645402;55894;245910;1673;100131608;245908;100132396;503618;100289462;245909;414325;10407,20
-1,-1,8,7169510,7806227,636717,401447;503614;504180;503841;140596;100133251;653423;100131980;645402;55894;245910;1673;100131608;245908;100132396;503618;100289462;245909;414325;10407,20
-1,-1,8,7169510,7806227,636717,401447;503614;504180;503841;140596;100133251;653423;100131980;645402;55894;245910;1673;100131608;245908;100132396;503618;100289462;245909;414325;10407,20
1,-1,8,7169510,7806227,636717,401447;503614;504180;503841;140596;100133251;653423;100131980;645402;55894;245910;1673;100131608;245908;100132396;503618;100289462;245909;414325;10407,20
1,-1,8,7169510,7806227,636717,401447;503614;504180;503841;140596;100133251;653423;100131980;645402;55894;245910;1673;100131608;245908;100132396;503618;100289462;245909;414325;10407,20
-1,-1,8,7169510,7806227,636717,401447;503614;504180;503841;140596;100133251;653423;100131980;645402;55894;245910;1673;100131608;245908;100132396;503618;100289462;245909;414325;10407,20
-1,-1,8,7169510,7806227,636717,401447;503614;504180;503841;140596;100133251;653423;100131980;645402;55894;245910;1673;100131608;245908;100132396;503618;100289462;245909;414325;10407,20
-1,-1,8,7169510,7806227,636717,401447;503614;504180;503841;140596;100133251;653423;100131980;645402;55894;245910;1673;100131608;245908;100132396;503618;100289462;245909;414325;10407,20
-1,-1,8,7169510,7806227,636717,401447;503614;504180;503841;140596;100133251;653423;100131980;645402;55894;245910;1673;100131608;245908;100132396;503618;100289462;245909;414325;10407,20
-1,-1,8,7169510,7806227,636717,401447;503614;504180;503841;140596;100133251;653423;100131980;645402;55894;245910;1673;100131608;245908;100132396;503618;100289462;245909;414325;10407,20
-1,-1,8,7169510,7806227,636717,401447;503614;504180;503841;140596;100133251;653423;100131980;645402;55894;245910;1673;100131608;245908;100132396;503618;100289462;245909;414325;10407,20
-1,-1,8,7169510,7806227,636717,401447;503614;504180;503841;140596;100133251;653423;100131980;645402;55894;245910;1673;100131608;245908;100132396;503618;100289462;245909;414325;10407,20
1,-1,8,7169510,7806227,636717,401447;503614;504180;503841;140596;100133251;653423;100131980;645402;55894;245910;1673;100131608;245908;100132396;503618;100289462;245909;414325;10407,20
-1,-1,8,7169510,7806227,636717,401447;503614;504180;503841;140596;100133251;653423;100131980;645402;55894;245910;1673;100131608;245908;100132396;503618;100289462;245909;414325;10407,20
-1,-1,8,7169510,7806227,636717,401447;503614;504180;503841;140596;100133251;653423;100131980;645402;55894;245910;1673;100131608;245908;100132396;503618;100289462;245909;414325;10407,20
1,-1,8,7169510,7806227,636717,401447;503614;504180;503841;140596;100133251;653423;100131980;645402;55894;245910;1673;100131608;245908;100132396;503618;100289462;245909;414325;10407,20
1,-1,8,7169510,7806227,636717,401447;503614;504180;503841;140596;100133251;653423;100131980;645402;55894;245910;1673;100131608;245908;100132396;503618;100289462;245909;414325;10407,20
1,-1,8,7169510,7806227,636717,401447;503614;504180;503841;140596;100133251;653423;100131980;645402;55894;245910;1673;100131608;245908;100132396;503618;100289462;245909;414325;10407,20
-1,-1,8,7169510,7806227,636717,401447;503614;504180;503841;140596;100133251;653423;100131980;645402;55894;245910;1673;100131608;245908;100132396;503618;100289462;245909;414325;10407,20
-1,-1,8,7169510,7806227,636717,401447;503614;504180;503841;140596;100133251;653423;100131980;645402;55894;245910;1673;100131608;245908;100132396;503618;100289462;245909;414325;10407,20
-1,-1,8,7169510,7806227,636717,401447;503614;504180;503841;140596;100133251;653423;100131980;645402;55894;245910;1673;100131608;245908;100132396;503618;100289462;245909;414325;10407,20
1,-1,8,7169510,7806227,636717,401447;503614;504180;503841;140596;100133251;653423;100131980;645402;55894;245910;1673;100131608;245908;100132396;503618;100289462;245909;414325;10407,20
1,-1,8,7169510,7806227,636717,401447;503614;504180;503841;140596;100133251;653423;100131980;645402;55894;245910;1673;100131608;245908;100132396;503618;100289462;245909;414325;10407,20
-1,-1,8,7169510,7806227,636717,401447;503614;504180;503841;140596;100133251;653423;100131980;645402;55894;245910;1673;100131608;245908;100132396;503618;100289462;245909;414325;10407,20
1,-1,8,7169510,7806227,636717,401447;503614;504180;503841;140596;100133251;653423;100131980;645402;55894;245910;1673;100131608;245908;100132396;503618;100289462;245909;414325;10407,20
1,-1,8,7169510,7806227,636717,401447;503614;504180;503841;140596;100133251;653423;100131980;645402;55894;245910;1673;100131608;245908;100132396;503618;100289462;245909;414325;10407,20
-1,-1,8,7169510,7806227,636717,401447;503614;504180;503841;140596;100133251;653423;100131980;645402;55894;245910;1673;100131608;245908;100132396;503618;100289462;245909;414325;10407,20
1,-1,8,7169510,7806227,636717,401447;503614;504180;503841;140596;100133251;653423;100131980;645402;55894;245910;1673;100131608;245908;100132396;503618;100289462;245909;414325;10407,20
1,-1,8,7169510,7806227,636717,401447;503614;504180;503841;140596;100133251;653423;100131980;645402;55894;245910;1673;100131608;245908;100132396;503618;100289462;245909;414325;10407,20
-1,-1,8,7169510,7806227,636717,401447;503614;504180;503841;140596;100133251;653423;100131980;645402;55894;245910;1673;100131608;245908;100132396;503618;100289462;245909;414325;10407,20
1,-1,8,7169510,7806227,636717,401447;503614;504180;503841;140596;100133251;653423;100131980;645402;55894;245910;1673;100131608;245908;100132396;503618;100289462;245909;414325;10407,20
1,-1,8,7169510,7806227,636717,401447;503614;504180;503841;140596;100133251;653423;100131980;645402;55894;245910;1673;100131608;245908;100132396;503618;100289462;245909;414325;10407,20
-1,-1,8,7169510,7806227,636717,401447;503614;504180;503841;140596;100133251;653423;100131980;645402;55894;245910;1673;100131608;245908;100132396;503618;100289462;245909;414325;10407,20
-1,-1,8,7169510,7806227,636717,401447;503614;504180;503841;140596;100133251;653423;100131980;645402;55894;245910;1673;100131608;245908;100132396;503618;100289462;245909;414325;10407,20
1,-1,8,7169510,7806227,636717,401447;503614;504180;503841;140596;100133251;653423;100131980;645402;55894;245910;1673;100131608;245908;100132396;503618;100289462;245909;414325;10407,20
1,-1,8,7169510,7806227,636717,401447;503614;504180;503841;140596;100133251;653423;100131980;645402;55894;245910;1673;100131608;245908;100132396;503618;100289462;245909;414325;10407,20
-1,-1,8,7169510,7806227,636717,401447;503614;504180;503841;140596;100133251;653423;100131980;645402;55894;245910;1673;100131608;245908;100132396;503618;100289462;245909;414325;10407,20
1,-1,8,7169510,7806227,636717,401447;503614;504180;503841;140596;100133251;653423;100131980;645402;55894;245910;1673;100131608;245908;100132396;503618;100289462;245909;414325;10407,20
-1,-1,8,7169510,7806227,636717,401447;503614;504180;503841;140596;100133251;653423;100131980;645402;55894;245910;1673;100131608;245908;100132396;503618;100289462;245909;414325;10407,20
-1,-1,8,7169510,7806227,636717,401447;503614;504180;503841;140596;100133251;653423;100131980;645402;55894;245910;1673;100131608;245908;100132396;503618;100289462;245909;414325;10407,20
-1,-1,8,7169510,7806227,636717,401447;503614;504180;503841;140596;100133251;653423;100131980;645402;55894;245910;1673;100131608;245908;100132396;503618;100289462;245909;414325;10407,20
1,-1,8,7169510,7806227,636717,401447;503614;504180;503841;140596;100133251;653423;100131980;645402;55894;245910;1673;100131608;245908;100132396;503618;100289462;245909;414325;10407,20
-1,-1,8,7169510,7806227,636717,401447;503614;504180;503841;140596;100133251;653423;100131980;645402;55894;245910;1673;100131608;245908;100132396;503618;100289462;245909;414325;10407,20
1,-1,8,7169510,7806227,636717,401447;503614;504180;503841;140596;100133251;653423;100131980;645402;55894;245910;1673;100131608;245908;100132396;503618;100289462;245909;414325;10407,20
-1,-1,8,7169510,7806227,636717,401447;503614;504180;503841;140596;100133251;653423;100131980;645402;55894;245910;1673;100131608;245908;100132396;503618;100289462;245909;414325;10407,20
1,-1,8,7169510,7806227,636717,401447;503614;504180;503841;140596;100133251;653423;100131980;645402;55894;245910;1673;100131608;245908;100132396;503618;100289462;245909;414325;10407,20
1,-1,8,7169510,7806227,636717,401447;503614;504180;503841;140596;100133251;653423;100131980;645402;55894;245910;1673;100131608;245908;100132396;503618;100289462;245909;414325;10407,20
-1,-1,8,7169510,7806227,636717,401447;503614;504180;503841;140596;100133251;653423;100131980;645402;55894;245910;1673;100131608;245908;100132396;503618;100289462;245909;414325;10407,20
-1,-1,8,7169510,7806227,636717,401447;503614;504180;503841;140596;100133251;653423;100131980;645402;55894;245910;1673;100131608;245908;100132396;503618;100289462;245909;414325;10407,20
-1,-1,8,7169510,7806227,636717,401447;503614;504180;503841;140596;100133251;653423;100131980;645402;55894;245910;1673;100131608;245908;100132396;503618;100289462;245909;414325;10407,20
-1,-1,8,7169510,7806227,636717,401447;503614;504180;503841;140596;100133251;653423;100131980;645402;55894;245910;1673;100131608;245908;100132396;503618;100289462;245909;414325;10407,20
-1,-1,8,7169510,7806227,636717,401447;503614;504180;503841;140596;100133251;653423;100131980;645402;55894;245910;1673;100131608;245908;100132396;503618;100289462;245909;414325;10407,20
-1,-1,8,7169510,7806227,636717,401447;503614;504180;503841;140596;100133251;653423;100131980;645402;55894;245910;1673;100131608;245908;100132396;503618;100289462;245909;414325;10407,20
-1,-1,8,7169510,7806227,636717,401447;503614;504180;503841;140596;100133251;653423;100131980;645402;55894;245910;1673;100131608;245908;100132396;503618;100289462;245909;414325;10407,20
1,-1,8,7169510,7806227,636717,401447;503614;504180;503841;140596;100133251;653423;100131980;645402;55894;245910;1673;100131608;245908;100132396;503618;100289462;245909;414325;10407,20
-1,-1,8,7169510,7881316,711806,401447;503614;504180;503841;140596;100133251;653423;100131980;645402;55894;245910;1673;100131608;245908;100132396;503618;392188;100289462;245909;414325;10407;645836,22
-1,-1,8,7169510,8079912,910402,401447;503614;504180;503841;140596;100133251;653423;100131980;645402;55894;245910;1673;100131608;245908;100132396;503618;392188;100289462;245909;414325;10407;645836,22
-1,-1,8,7169510,8079912,910402,401447;503614;504180;503841;140596;100133251;653423;100131980;645402;55894;245910;1673;100131608;245908;100132396;503618;392188;100289462;245909;414325;10407;645836,22
-1,-1,8,7169510,8079912,910402,401447;503614;504180;503841;140596;100133251;653423;100131980;645402;55894;245910;1673;100131608;245908;100132396;503618;392188;100289462;245909;414325;10407;645836,22
-1,-1,8,7169510,8079912,910402,401447;503614;504180;503841;140596;100133251;653423;100131980;645402;55894;245910;1673;100131608;245908;100132396;503618;392188;100289462;245909;414325;10407;645836,22
-1,-1,8,7169510,8079912,910402,401447;503614;504180;503841;140596;100133251;653423;100131980;645402;55894;245910;1673;100131608;245908;100132396;503618;392188;100289462;245909;414325;10407;645836,22
-1,-1,8,7169510,8079912,910402,401447;503614;504180;503841;140596;100133251;653423;100131980;645402;55894;245910;1673;100131608;245908;100132396;503618;392188;100289462;245909;414325;10407;645836,22
-1,-1,8,7169510,8079912,910402,401447;503614;504180;503841;140596;100133251;653423;100131980;645402;55894;245910;1673;100131608;245908;100132396;503618;392188;100289462;245909;414325;10407;645836,22
-1,-1,8,7169510,8079912,910402,401447;503614;504180;503841;140596;100133251;653423;100131980;645402;55894;245910;1673;100131608;245908;100132396;503618;392188;100289462;245909;414325;10407;645836,22
-1,-1,8,7169510,8079912,910402,401447;503614;504180;503841;140596;100133251;653423;100131980;645402;55894;245910;1673;100131608;245908;100132396;503618;392188;100289462;245909;414325;10407;645836,22
-1,-1,8,7169510,8079912,910402,401447;503614;504180;503841;140596;100133251;653423;100131980;645402;55894;245910;1673;100131608;245908;100132396;503618;392188;100289462;245909;414325;10407;645836,22
-1,-1,8,7169510,8079912,910402,401447;503614;504180;503841;140596;100133251;653423;100131980;645402;55894;245910;1673;100131608;245908;100132396;503618;392188;100289462;245909;414325;10407;645836,22
-1,-1,8,7169510,8079912,910402,401447;503614;504180;503841;140596;100133251;653423;100131980;645402;55894;245910;1673;100131608;245908;100132396;503618;392188;100289462;245909;414325;10407;645836,22
1,-1,8,7169510,8079912,910402,401447;503614;504180;503841;140596;100133251;653423;100131980;645402;55894;245910;1673;100131608;245908;100132396;503618;392188;100289462;245909;414325;10407;645836,22
-1,-1,8,7169510,8079912,910402,401447;503614;504180;503841;140596;100133251;653423;100131980;645402;55894;245910;1673;100131608;245908;100132396;503618;392188;100289462;245909;414325;10407;645836,22
-1,-1,8,7169510,8079912,910402,401447;503614;504180;503841;140596;100133251;653423;100131980;645402;55894;245910;1673;100131608;245908;100132396;503618;392188;100289462;245909;414325;10407;645836,22
-1,-1,8,7169510,8079912,910402,401447;503614;504180;503841;140596;100133251;653423;100131980;645402;55894;245910;1673;100131608;245908;100132396;503618;392188;100289462;245909;414325;10407;645836,22
1,-1,8,7169510,8079912,910402,401447;503614;504180;503841;140596;100133251;653423;100131980;645402;55894;245910;1673;100131608;245908;100132396;503618;392188;100289462;245909;414325;10407;645836,22
-1,-1,8,7169510,8079912,910402,401447;503614;504180;503841;140596;100133251;653423;100131980;645402;55894;245910;1673;100131608;245908;100132396;503618;392188;100289462;245909;414325;10407;645836,22
-1,-1,8,7169510,8079912,910402,401447;503614;504180;503841;140596;100133251;653423;100131980;645402;55894;245910;1673;100131608;245908;100132396;503618;392188;100289462;245909;414325;10407;645836,22
-1,-1,8,7169510,8079912,910402,401447;503614;504180;503841;140596;100133251;653423;100131980;645402;55894;245910;1673;100131608;245908;100132396;503618;392188;100289462;245909;414325;10407;645836,22
-1,-1,8,7169510,8079912,910402,401447;503614;504180;503841;140596;100133251;653423;100131980;645402;55894;245910;1673;100131608;245908;100132396;503618;392188;100289462;245909;414325;10407;645836,22
-1,-1,8,7169510,8079912,910402,401447;503614;504180;503841;140596;100133251;653423;100131980;645402;55894;245910;1673;100131608;245908;100132396;503618;392188;100289462;245909;414325;10407;645836,22
-1,-1,8,7169510,8079912,910402,401447;503614;504180;503841;140596;100133251;653423;100131980;645402;55894;245910;1673;100131608;245908;100132396;503618;392188;100289462;245909;414325;10407;645836,22
1,-1,8,7169510,8079912,910402,401447;503614;504180;503841;140596;100133251;653423;100131980;645402;55894;245910;1673;100131608;245908;100132396;503618;392188;100289462;245909;414325;10407;645836,22
-1,-1,8,7169510,8079912,910402,401447;503614;504180;503841;140596;100133251;653423;100131980;645402;55894;245910;1673;100131608;245908;100132396;503618;392188;100289462;245909;414325;10407;645836,22
-1,-1,8,7169510,8079912,910402,401447;503614;504180;503841;140596;100133251;653423;100131980;645402;55894;245910;1673;100131608;245908;100132396;503618;392188;100289462;245909;414325;10407;645836,22
-1,-1,8,7169510,8079912,910402,401447;503614;504180;503841;140596;100133251;653423;100131980;645402;55894;245910;1673;100131608;245908;100132396;503618;392188;100289462;245909;414325;10407;645836,22
-1,-1,8,7169510,8079912,910402,401447;503614;504180;503841;140596;100133251;653423;100131980;645402;55894;245910;1673;100131608;245908;100132396;503618;392188;100289462;245909;414325;10407;645836,22
-1,-1,8,7169510,8079912,910402,401447;503614;504180;503841;140596;100133251;653423;100131980;645402;55894;245910;1673;100131608;245908;100132396;503618;392188;100289462;245909;414325;10407;645836,22
1,-1,8,7169510,8079912,910402,401447;503614;504180;503841;140596;100133251;653423;100131980;645402;55894;245910;1673;100131608;245908;100132396;503618;392188;100289462;245909;414325;10407;645836,22
-1,-1,8,7169510,8079912,910402,401447;503614;504180;503841;140596;100133251;653423;100131980;645402;55894;245910;1673;100131608;245908;100132396;503618;392188;100289462;245909;414325;10407;645836,22
1,-1,8,7169510,8079912,910402,401447;503614;504180;503841;140596;100133251;653423;100131980;645402;55894;245910;1673;100131608;245908;100132396;503618;392188;100289462;245909;414325;10407;645836,22
-1,-1,8,7169510,8079912,910402,401447;503614;504180;503841;140596;100133251;653423;100131980;645402;55894;245910;1673;100131608;245908;100132396;503618;392188;100289462;245909;414325;10407;645836,22
-1,-1,8,7169510,8079912,910402,401447;503614;504180;503841;140596;100133251;653423;100131980;645402;55894;245910;1673;100131608;245908;100132396;503618;392188;100289462;245909;414325;10407;645836,22
-1,-1,8,7169510,8079912,910402,401447;503614;504180;503841;140596;100133251;653423;100131980;645402;55894;245910;1673;100131608;245908;100132396;503618;392188;100289462;245909;414325;10407;645836,22
1,-1,8,7169510,8079912,910402,401447;503614;504180;503841;140596;100133251;653423;100131980;645402;55894;245910;1673;100131608;245908;100132396;503618;392188;100289462;245909;414325;10407;645836,22
1,-1,8,7169510,8079912,910402,401447;503614;504180;503841;140596;100133251;653423;100131980;645402;55894;245910;1673;100131608;245908;100132396;503618;392188;100289462;245909;414325;10407;645836,22
-1,-1,8,7169510,8079912,910402,401447;503614;504180;503841;140596;100133251;653423;100131980;645402;55894;245910;1673;100131608;245908;100132396;503618;392188;100289462;245909;414325;10407;645836,22
-1,-1,8,7169510,8079912,910402,401447;503614;504180;503841;140596;100133251;653423;100131980;645402;55894;245910;1673;100131608;245908;100132396;503618;392188;100289462;245909;414325;10407;645836,22
-1,-1,8,7169510,8079912,910402,401447;503614;504180;503841;140596;100133251;653423;100131980;645402;55894;245910;1673;100131608;245908;100132396;503618;392188;100289462;245909;414325;10407;645836,22
1,-1,8,7169510,8079912,910402,401447;503614;504180;503841;140596;100133251;653423;100131980;645402;55894;245910;1673;100131608;245908;100132396;503618;392188;100289462;245909;414325;10407;645836,22
-1,-1,8,7169510,8079912,910402,401447;503614;504180;503841;140596;100133251;653423;100131980;645402;55894;245910;1673;100131608;245908;100132396;503618;392188;100289462;245909;414325;10407;645836,22
-1,-1,8,7169510,8079912,910402,401447;503614;504180;503841;140596;100133251;653423;100131980;645402;55894;245910;1673;100131608;245908;100132396;503618;392188;100289462;245909;414325;10407;645836,22
-1,-1,8,7169510,8079912,910402,401447;503614;504180;503841;140596;100133251;653423;100131980;645402;55894;245910;1673;100131608;245908;100132396;503618;392188;100289462;245909;414325;10407;645836,22
1,-1,8,7169510,8079912,910402,401447;503614;504180;503841;140596;100133251;653423;100131980;645402;55894;245910;1673;100131608;245908;100132396;503618;392188;100289462;245909;414325;10407;645836,22
1,-1,8,7169510,8079912,910402,401447;503614;504180;503841;140596;100133251;653423;100131980;645402;55894;245910;1673;100131608;245908;100132396;503618;392188;100289462;245909;414325;10407;645836,22
-1,-1,8,7169510,8079912,910402,401447;503614;504180;503841;140596;100133251;653423;100131980;645402;55894;245910;1673;100131608;245908;100132396;503618;392188;100289462;245909;414325;10407;645836,22
-1,-1,8,7169510,8079912,910402,401447;503614;504180;503841;140596;100133251;653423;100131980;645402;55894;245910;1673;100131608;245908;100132396;503618;392188;100289462;245909;414325;10407;645836,22
-1,-1,8,7169510,8079912,910402,401447;503614;504180;503841;140596;100133251;653423;100131980;645402;55894;245910;1673;100131608;245908;100132396;503618;392188;100289462;245909;414325;10407;645836,22
-1,-1,8,7169510,8079912,910402,401447;503614;504180;503841;140596;100133251;653423;100131980;645402;55894;245910;1673;100131608;245908;100132396;503618;392188;100289462;245909;414325;10407;645836,22
1,-1,8,7169510,8079912,910402,401447;503614;504180;503841;140596;100133251;653423;100131980;645402;55894;245910;1673;100131608;245908;100132396;503618;392188;100289462;245909;414325;10407;645836,22
1,-1,8,7169510,8079912,910402,401447;503614;504180;503841;140596;100133251;653423;100131980;645402;55894;245910;1673;100131608;245908;100132396;503618;392188;100289462;245909;414325;10407;645836,22
1,-1,8,7169510,8079912,910402,401447;503614;504180;503841;140596;100133251;653423;100131980;645402;55894;245910;1673;100131608;245908;100132396;503618;392188;100289462;245909;414325;10407;645836,22
1,-1,8,7169510,8079912,910402,401447;503614;504180;503841;140596;100133251;653423;100131980;645402;55894;245910;1673;100131608;245908;100132396;503618;392188;100289462;245909;414325;10407;645836,22
-1,-1,8,7169510,8079912,910402,401447;503614;504180;503841;140596;100133251;653423;100131980;645402;55894;245910;1673;100131608;245908;100132396;503618;392188;100289462;245909;414325;10407;645836,22
1,-1,8,7169510,8079912,910402,401447;503614;504180;503841;140596;100133251;653423;100131980;645402;55894;245910;1673;100131608;245908;100132396;503618;392188;100289462;245909;414325;10407;645836,22
-1,-1,8,7169510,8079912,910402,401447;503614;504180;503841;140596;100133251;653423;100131980;645402;55894;245910;1673;100131608;245908;100132396;503618;392188;100289462;245909;414325;10407;645836,22
1,-1,8,7169510,8079912,910402,401447;503614;504180;503841;140596;100133251;653423;100131980;645402;55894;245910;1673;100131608;245908;100132396;503618;392188;100289462;245909;414325;10407;645836,22
-1,-1,8,7169510,8079912,910402,401447;503614;504180;503841;140596;100133251;653423;100131980;645402;55894;245910;1673;100131608;245908;100132396;503618;392188;100289462;245909;414325;10407;645836,22
-1,-1,8,7169510,8079912,910402,401447;503614;504180;503841;140596;100133251;653423;100131980;645402;55894;245910;1673;100131608;245908;100132396;503618;392188;100289462;245909;414325;10407;645836,22
1,-1,8,7169510,8079912,910402,401447;503614;504180;503841;140596;100133251;653423;100131980;645402;55894;245910;1673;100131608;245908;100132396;503618;392188;100289462;245909;414325;10407;645836,22
-1,-1,8,7169510,8079912,910402,401447;503614;504180;503841;140596;100133251;653423;100131980;645402;55894;245910;1673;100131608;245908;100132396;503618;392188;100289462;245909;414325;10407;645836,22
-1,-1,8,7169510,8079912,910402,401447;503614;504180;503841;140596;100133251;653423;100131980;645402;55894;245910;1673;100131608;245908;100132396;503618;392188;100289462;245909;414325;10407;645836,22
-1,-1,8,7169510,8079912,910402,401447;503614;504180;503841;140596;100133251;653423;100131980;645402;55894;245910;1673;100131608;245908;100132396;503618;392188;100289462;245909;414325;10407;645836,22
1,-1,8,7169510,8079912,910402,401447;503614;504180;503841;140596;100133251;653423;100131980;645402;55894;245910;1673;100131608;245908;100132396;503618;392188;100289462;245909;414325;10407;645836,22
1,-1,8,7169510,8079912,910402,401447;503614;504180;503841;140596;100133251;653423;100131980;645402;55894;245910;1673;100131608;245908;100132396;503618;392188;100289462;245909;414325;10407;645836,22
-1,-1,8,7169510,8079912,910402,401447;503614;504180;503841;140596;100133251;653423;100131980;645402;55894;245910;1673;100131608;245908;100132396;503618;392188;100289462;245909;414325;10407;645836,22
1,-1,8,7169510,8079912,910402,401447;503614;504180;503841;140596;100133251;653423;100131980;645402;55894;245910;1673;100131608;245908;100132396;503618;392188;100289462;245909;414325;10407;645836,22
-1,-1,8,7169510,8079912,910402,401447;503614;504180;503841;140596;100133251;653423;100131980;645402;55894;245910;1673;100131608;245908;100132396;503618;392188;100289462;245909;414325;10407;645836,22
-1,-1,8,7169510,8079912,910402,401447;503614;504180;503841;140596;100133251;653423;100131980;645402;55894;245910;1673;100131608;245908;100132396;503618;392188;100289462;245909;414325;10407;645836,22
1,-1,8,7169510,8079912,910402,401447;503614;504180;503841;140596;100133251;653423;100131980;645402;55894;245910;1673;100131608;245908;100132396;503618;392188;100289462;245909;414325;10407;645836,22
-1,-1,8,7169510,8079912,910402,401447;503614;504180;503841;140596;100133251;653423;100131980;645402;55894;245910;1673;100131608;245908;100132396;503618;392188;100289462;245909;414325;10407;645836,22
-1,-1,8,7169510,8079912,910402,401447;503614;504180;503841;140596;100133251;653423;100131980;645402;55894;245910;1673;100131608;245908;100132396;503618;392188;100289462;245909;414325;10407;645836,22
-1,-1,8,7169510,8079912,910402,401447;503614;504180;503841;140596;100133251;653423;100131980;645402;55894;245910;1673;100131608;245908;100132396;503618;392188;100289462;245909;414325;10407;645836,22
-1,-1,8,7169510,8079912,910402,401447;503614;504180;503841;140596;100133251;653423;100131980;645402;55894;245910;1673;100131608;245908;100132396;503618;392188;100289462;245909;414325;10407;645836,22
-1,-1,8,7169510,8079912,910402,401447;503614;504180;503841;140596;100133251;653423;100131980;645402;55894;245910;1673;100131608;245908;100132396;503618;392188;100289462;245909;414325;10407;645836,22
-1,-1,8,7169510,8079912,910402,401447;503614;504180;503841;140596;100133251;653423;100131980;645402;55894;245910;1673;100131608;245908;100132396;503618;392188;100289462;245909;414325;10407;645836,22
-1,-1,8,7169510,8079912,910402,401447;503614;504180;503841;140596;100133251;653423;100131980;645402;55894;245910;1673;100131608;245908;100132396;503618;392188;100289462;245909;414325;10407;645836,22
1,-1,8,7169510,8079912,910402,401447;503614;504180;503841;140596;100133251;653423;100131980;645402;55894;245910;1673;100131608;245908;100132396;503618;392188;100289462;245909;414325;10407;645836,22
-1,-1,8,7169510,8079912,910402,401447;503614;504180;503841;140596;100133251;653423;100131980;645402;55894;245910;1673;100131608;245908;100132396;503618;392188;100289462;245909;414325;10407;645836,22
1,-1,8,7169510,8079912,910402,401447;503614;504180;503841;140596;100133251;653423;100131980;645402;55894;245910;1673;100131608;245908;100132396;503618;392188;100289462;245909;414325;10407;645836,22
-1,-1,8,7169510,8079912,910402,401447;503614;504180;503841;140596;100133251;653423;100131980;645402;55894;245910;1673;100131608;245908;100132396;503618;392188;100289462;245909;414325;10407;645836,22
1,-1,8,7169510,8079912,910402,401447;503614;504180;503841;140596;100133251;653423;100131980;645402;55894;245910;1673;100131608;245908;100132396;503618;392188;100289462;245909;414325;10407;645836,22
1,-1,8,7169510,8079912,910402,401447;503614;504180;503841;140596;100133251;653423;100131980;645402;55894;245910;1673;100131608;245908;100132396;503618;392188;100289462;245909;414325;10407;645836,22
-1,-1,8,7169510,8079912,910402,401447;503614;504180;503841;140596;100133251;653423;100131980;645402;55894;245910;1673;100131608;245908;100132396;503618;392188;100289462;245909;414325;10407;645836,22
-1,-1,8,7169510,8079912,910402,401447;503614;504180;503841;140596;100133251;653423;100131980;645402;55894;245910;1673;100131608;245908;100132396;503618;392188;100289462;245909;414325;10407;645836,22
1,-1,8,7169510,8079912,910402,401447;503614;504180;503841;140596;100133251;653423;100131980;645402;55894;245910;1673;100131608;245908;100132396;503618;392188;100289462;245909;414325;10407;645836,22
-1,-1,8,7169510,8079912,910402,401447;503614;504180;503841;140596;100133251;653423;100131980;645402;55894;245910;1673;100131608;245908;100132396;503618;392188;100289462;245909;414325;10407;645836,22
1,-1,8,7169510,8079912,910402,401447;503614;504180;503841;140596;100133251;653423;100131980;645402;55894;245910;1673;100131608;245908;100132396;503618;392188;100289462;245909;414325;10407;645836,22
1,-1,8,7169510,8079912,910402,401447;503614;504180;503841;140596;100133251;653423;100131980;645402;55894;245910;1673;100131608;245908;100132396;503618;392188;100289462;245909;414325;10407;645836,22
1,-1,8,7169510,8079912,910402,401447;503614;504180;503841;140596;100133251;653423;100131980;645402;55894;245910;1673;100131608;245908;100132396;503618;392188;100289462;245909;414325;10407;645836,22
-1,-1,8,7169510,8079912,910402,401447;503614;504180;503841;140596;100133251;653423;100131980;645402;55894;245910;1673;100131608;245908;100132396;503618;392188;100289462;245909;414325;10407;645836,22
-1,-1,8,7169510,8079912,910402,401447;503614;504180;503841;140596;100133251;653423;100131980;645402;55894;245910;1673;100131608;245908;100132396;503618;392188;100289462;245909;414325;10407;645836,22
1,-1,8,7169510,8079912,910402,401447;503614;504180;503841;140596;100133251;653423;100131980;645402;55894;245910;1673;100131608;245908;100132396;503618;392188;100289462;245909;414325;10407;645836,22
-1,-1,8,7169510,8079912,910402,401447;503614;504180;503841;140596;100133251;653423;100131980;645402;55894;245910;1673;100131608;245908;100132396;503618;392188;100289462;245909;414325;10407;645836,22
-1,-1,8,7169510,8079912,910402,401447;503614;504180;503841;140596;100133251;653423;100131980;645402;55894;245910;1673;100131608;245908;100132396;503618;392188;100289462;245909;414325;10407;645836,22
1,-1,8,7169510,8079912,910402,401447;503614;504180;503841;140596;100133251;653423;100131980;645402;55894;245910;1673;100131608;245908;100132396;503618;392188;100289462;245909;414325;10407;645836,22
1,-1,8,7169510,8079912,910402,401447;503614;504180;503841;140596;100133251;653423;100131980;645402;55894;245910;1673;100131608;245908;100132396;503618;392188;100289462;245909;414325;10407;645836,22
1,-1,8,7169510,8079912,910402,401447;503614;504180;503841;140596;100133251;653423;100131980;645402;55894;245910;1673;100131608;245908;100132396;503618;392188;100289462;245909;414325;10407;645836,22
-1,-1,8,7169510,8079912,910402,401447;503614;504180;503841;140596;100133251;653423;100131980;645402;55894;245910;1673;100131608;245908;100132396;503618;392188;100289462;245909;414325;10407;645836,22
-1,-1,8,7169510,8079912,910402,401447;503614;504180;503841;140596;100133251;653423;100131980;645402;55894;245910;1673;100131608;245908;100132396;503618;392188;100289462;245909;414325;10407;645836,22
-1,-1,8,7169510,8079912,910402,401447;503614;504180;503841;140596;100133251;653423;100131980;645402;55894;245910;1673;100131608;245908;100132396;503618;392188;100289462;245909;414325;10407;645836,22
1,-1,8,7169510,8079912,910402,401447;503614;504180;503841;140596;100133251;653423;100131980;645402;55894;245910;1673;100131608;245908;100132396;503618;392188;100289462;245909;414325;10407;645836,22
-1,-1,8,7169510,8079912,910402,401447;503614;504180;503841;140596;100133251;653423;100131980;645402;55894;245910;1673;100131608;245908;100132396;503618;392188;100289462;245909;414325;10407;645836,22
1,-1,8,7169510,8130631,961121,401447;503614;504180;503841;140596;100133251;653423;100131980;645402;55894;245910;1673;100131608;245908;100132396;503618;392188;100289462;245909;414325;10407;645836,22
1,-1,8,7169510,8130631,961121,401447;503614;504180;503841;140596;100133251;653423;100131980;645402;55894;245910;1673;100131608;245908;100132396;503618;392188;100289462;245909;414325;10407;645836,22
1,-1,8,7169510,8130631,961121,401447;503614;504180;503841;140596;100133251;653423;100131980;645402;55894;245910;1673;100131608;245908;100132396;503618;392188;100289462;245909;414325;10407;645836,22
1,-1,8,7169510,8130631,961121,401447;503614;504180;503841;140596;100133251;653423;100131980;645402;55894;245910;1673;100131608;245908;100132396;503618;392188;100289462;245909;414325;10407;645836,22
1,-1,8,7169510,8130631,961121,401447;503614;504180;503841;140596;100133251;653423;100131980;645402;55894;245910;1673;100131608;245908;100132396;503618;392188;100289462;245909;414325;10407;645836,22
-1,-1,8,7169520,7659644,490124,401447;100131608;503614;504180;503841;503618;100289462;100133251;100131980;645402;55894;10407,12
1,-1,8,7169520,7779236,609716,401447;503614;504180;503841;140596;100133251;653423;100131980;645402;55894;245910;1673;100131608;245908;503618;100289462;245909;414325;10407,19
1,-1,8,7169520,7787415,617895,401447;503614;504180;503841;140596;100133251;653423;100131980;645402;55894;245910;1673;100131608;245908;100132396;503618;100289462;245909;414325;10407,20
1,-1,8,7169520,8079890,910370,401447;503614;504180;503841;140596;100133251;653423;100131980;645402;55894;245910;1673;100131608;245908;100132396;503618;392188;100289462;245909;414325;10407;645836,22
-1,-1,8,7169520,8079890,910370,401447;503614;504180;503841;140596;100133251;653423;100131980;645402;55894;245910;1673;100131608;245908;100132396;503618;392188;100289462;245909;414325;10407;645836,22
-1,-1,8,7169520,8079891,910371,401447;503614;504180;503841;140596;100133251;653423;100131980;645402;55894;245910;1673;100131608;245908;100132396;503618;392188;100289462;245909;414325;10407;645836,22
1,-1,8,7169557,8079850,910293,401447;503614;504180;503841;140596;100133251;653423;100131980;645402;55894;245910;1673;100131608;245908;100132396;503618;392188;100289462;245909;414325;10407;645836,22
1,-1,8,7187746,7881316,693570,401447;503614;504180;503841;140596;100133251;653423;100131980;645402;55894;245910;1673;100131608;245908;100132396;503618;392188;100289462;245909;414325;10407;645836,22
-1,-1,8,7214262,7418007,203745,100131608;503614;504180;503841;503618;100289462;100131980;55894;10407,9
-1,-1,8,7214262,7430402,216140,100131608;503614;504180;503841;503618;100289462;100131980;55894;10407,9
1,-1,8,7187795,8167155,979360,401447;503614;504180;503841;140596;100133251;653423;100131980;645402;55894;245910;1673;100131608;245908;100132396;503618;392188;100289462;245909;414325;10407;645836,22
1,-1,8,7187795,8167155,979360,401447;503614;504180;503841;140596;100133251;653423;100131980;645402;55894;245910;1673;100131608;245908;100132396;503618;392188;100289462;245909;414325;10407;645836,22
1,-1,8,7214322,7957093,742771,503614;504180;503841;140596;100133251;653423;100131980;55894;245910;1673;100131608;245908;100132396;503618;392188;100289462;245909;414325;10407;645836,20
-1,-1,8,7239470,7806223,566753,503614;504180;503841;140596;100133251;653423;55894;245910;1673;100131608;245908;100132396;503618;100289462;245909;414325;10407,17
1,-1,8,7239471,7403655,164184,100131608;503614;504180;503841;503618;100289462;55894;10407,8
-1,-1,8,7239471,7403655,164184,100131608;503614;504180;503841;503618;100289462;55894;10407,8
1,-1,8,7239471,7418030,178559,100131608;503614;504180;503841;503618;100289462;55894;10407,8
-1,-1,8,7239471,7691845,452374,100131608;503614;504180;503841;503618;245908;100289462;100133251;245909;55894;10407;245910,12
-1,-1,8,7239471,7691845,452374,100131608;503614;504180;503841;503618;245908;100289462;100133251;245909;55894;10407;245910,12
1,-1,8,7239471,7691845,452374,100131608;503614;504180;503841;503618;245908;100289462;100133251;245909;55894;10407;245910,12
-1,-1,8,7239471,7752596,513125,503614;504180;503841;140596;100133251;653423;55894;245910;1673;100131608;245908;503618;100289462;245909;414325;10407,16
1,-1,8,7239471,7752596,513125,503614;504180;503841;140596;100133251;653423;55894;245910;1673;100131608;245908;503618;100289462;245909;414325;10407,16
-1,-1,8,7239471,7752596,513125,503614;504180;503841;140596;100133251;653423;55894;245910;1673;100131608;245908;503618;100289462;245909;414325;10407,16
-1,-1,8,7239471,7752596,513125,503614;504180;503841;140596;100133251;653423;55894;245910;1673;100131608;245908;503618;100289462;245909;414325;10407,16
1,-1,8,7239471,7752596,513125,503614;504180;503841;140596;100133251;653423;55894;245910;1673;100131608;245908;503618;100289462;245909;414325;10407,16
-1,-1,8,7239471,7752596,513125,503614;504180;503841;140596;100133251;653423;55894;245910;1673;100131608;245908;503618;100289462;245909;414325;10407,16
-1,-1,8,7239471,7752596,513125,503614;504180;503841;140596;100133251;653423;55894;245910;1673;100131608;245908;503618;100289462;245909;414325;10407,16
-1,-1,8,7239471,7752596,513125,503614;504180;503841;140596;100133251;653423;55894;245910;1673;100131608;245908;503618;100289462;245909;414325;10407,16
-1,-1,8,7239471,7752596,513125,503614;504180;503841;140596;100133251;653423;55894;245910;1673;100131608;245908;503618;100289462;245909;414325;10407,16
-1,-1,8,7239471,7752596,513125,503614;504180;503841;140596;100133251;653423;55894;245910;1673;100131608;245908;503618;100289462;245909;414325;10407,16
-1,-1,8,7239471,7752596,513125,503614;504180;503841;140596;100133251;653423;55894;245910;1673;100131608;245908;503618;100289462;245909;414325;10407,16
-1,-1,8,7239471,7752596,513125,503614;504180;503841;140596;100133251;653423;55894;245910;1673;100131608;245908;503618;100289462;245909;414325;10407,16
-1,-1,8,7239471,7752596,513125,503614;504180;503841;140596;100133251;653423;55894;245910;1673;100131608;245908;503618;100289462;245909;414325;10407,16
-1,-1,8,7239471,7752596,513125,503614;504180;503841;140596;100133251;653423;55894;245910;1673;100131608;245908;503618;100289462;245909;414325;10407,16
1,-1,8,7239471,7752596,513125,503614;504180;503841;140596;100133251;653423;55894;245910;1673;100131608;245908;503618;100289462;245909;414325;10407,16
-1,-1,8,7239471,7752596,513125,503614;504180;503841;140596;100133251;653423;55894;245910;1673;100131608;245908;503618;100289462;245909;414325;10407,16
-1,-1,8,7239471,7752596,513125,503614;504180;503841;140596;100133251;653423;55894;245910;1673;100131608;245908;503618;100289462;245909;414325;10407,16
-1,-1,8,7239471,7752596,513125,503614;504180;503841;140596;100133251;653423;55894;245910;1673;100131608;245908;503618;100289462;245909;414325;10407,16
-1,-1,8,7239471,7752596,513125,503614;504180;503841;140596;100133251;653423;55894;245910;1673;100131608;245908;503618;100289462;245909;414325;10407,16
-1,-1,8,7239471,7752596,513125,503614;504180;503841;140596;100133251;653423;55894;245910;1673;100131608;245908;503618;100289462;245909;414325;10407,16
-1,-1,8,7239471,7752596,513125,503614;504180;503841;140596;100133251;653423;55894;245910;1673;100131608;245908;503618;100289462;245909;414325;10407,16
-1,-1,8,7239471,7752596,513125,503614;504180;503841;140596;100133251;653423;55894;245910;1673;100131608;245908;503618;100289462;245909;414325;10407,16
1,-1,8,7239471,7806227,566756,503614;504180;503841;140596;100133251;653423;55894;245910;1673;100131608;245908;100132396;503618;100289462;245909;414325;10407,17
-1,-1,8,7239471,7806227,566756,503614;504180;503841;140596;100133251;653423;55894;245910;1673;100131608;245908;100132396;503618;100289462;245909;414325;10407,17
1,-1,8,7239471,7806227,566756,503614;504180;503841;140596;100133251;653423;55894;245910;1673;100131608;245908;100132396;503618;100289462;245909;414325;10407,17
1,-1,8,7239471,7806227,566756,503614;504180;503841;140596;100133251;653423;55894;245910;1673;100131608;245908;100132396;503618;100289462;245909;414325;10407,17
1,-1,8,7239471,7806227,566756,503614;504180;503841;140596;100133251;653423;55894;245910;1673;100131608;245908;100132396;503618;100289462;245909;414325;10407,17
-1,-1,8,7239471,7806227,566756,503614;504180;503841;140596;100133251;653423;55894;245910;1673;100131608;245908;100132396;503618;100289462;245909;414325;10407,17
-1,-1,8,7239471,7806227,566756,503614;504180;503841;140596;100133251;653423;55894;245910;1673;100131608;245908;100132396;503618;100289462;245909;414325;10407,17
1,-1,8,7239471,7806227,566756,503614;504180;503841;140596;100133251;653423;55894;245910;1673;100131608;245908;100132396;503618;100289462;245909;414325;10407,17
1,-1,8,7239471,7806227,566756,503614;504180;503841;140596;100133251;653423;55894;245910;1673;100131608;245908;100132396;503618;100289462;245909;414325;10407,17
-1,-1,8,7239471,7806227,566756,503614;504180;503841;140596;100133251;653423;55894;245910;1673;100131608;245908;100132396;503618;100289462;245909;414325;10407,17
-1,-1,8,7239471,7806227,566756,503614;504180;503841;140596;100133251;653423;55894;245910;1673;100131608;245908;100132396;503618;100289462;245909;414325;10407,17
1,-1,8,7239471,7806227,566756,503614;504180;503841;140596;100133251;653423;55894;245910;1673;100131608;245908;100132396;503618;100289462;245909;414325;10407,17
1,-1,8,7239471,7806227,566756,503614;504180;503841;140596;100133251;653423;55894;245910;1673;100131608;245908;100132396;503618;100289462;245909;414325;10407,17
1,-1,8,7239471,7806227,566756,503614;504180;503841;140596;100133251;653423;55894;245910;1673;100131608;245908;100132396;503618;100289462;245909;414325;10407,17
-1,-1,8,7239471,7806227,566756,503614;504180;503841;140596;100133251;653423;55894;245910;1673;100131608;245908;100132396;503618;100289462;245909;414325;10407,17
1,-1,8,7239471,8079912,840441,503614;504180;503841;140596;100133251;653423;55894;245910;1673;100131608;245908;100132396;503618;392188;100289462;245909;414325;10407;645836,19
1,-1,8,7239471,8079912,840441,503614;504180;503841;140596;100133251;653423;55894;245910;1673;100131608;245908;100132396;503618;392188;100289462;245909;414325;10407;645836,19
1,-1,8,7239471,8079912,840441,503614;504180;503841;140596;100133251;653423;55894;245910;1673;100131608;245908;100132396;503618;392188;100289462;245909;414325;10407;645836,19
-1,-1,8,7239471,8079912,840441,503614;504180;503841;140596;100133251;653423;55894;245910;1673;100131608;245908;100132396;503618;392188;100289462;245909;414325;10407;645836,19
1,-1,8,7239471,8079912,840441,503614;504180;503841;140596;100133251;653423;55894;245910;1673;100131608;245908;100132396;503618;392188;100289462;245909;414325;10407;645836,19
1,-1,8,7239471,8079912,840441,503614;504180;503841;140596;100133251;653423;55894;245910;1673;100131608;245908;100132396;503618;392188;100289462;245909;414325;10407;645836,19
1,-1,8,7239471,8079912,840441,503614;504180;503841;140596;100133251;653423;55894;245910;1673;100131608;245908;100132396;503618;392188;100289462;245909;414325;10407;645836,19
1,-1,8,7239471,8079912,840441,503614;504180;503841;140596;100133251;653423;55894;245910;1673;100131608;245908;100132396;503618;392188;100289462;245909;414325;10407;645836,19
1,-1,8,7239471,8079912,840441,503614;504180;503841;140596;100133251;653423;55894;245910;1673;100131608;245908;100132396;503618;392188;100289462;245909;414325;10407;645836,19
-1,-1,8,7239471,8079912,840441,503614;504180;503841;140596;100133251;653423;55894;245910;1673;100131608;245908;100132396;503618;392188;100289462;245909;414325;10407;645836,19
1,-1,8,7239471,8079912,840441,503614;504180;503841;140596;100133251;653423;55894;245910;1673;100131608;245908;100132396;503618;392188;100289462;245909;414325;10407;645836,19
1,-1,8,7239471,8079912,840441,503614;504180;503841;140596;100133251;653423;55894;245910;1673;100131608;245908;100132396;503618;392188;100289462;245909;414325;10407;645836,19
1,-1,8,7239471,8079912,840441,503614;504180;503841;140596;100133251;653423;55894;245910;1673;100131608;245908;100132396;503618;392188;100289462;245909;414325;10407;645836,19
1,-1,8,7239471,8079912,840441,503614;504180;503841;140596;100133251;653423;55894;245910;1673;100131608;245908;100132396;503618;392188;100289462;245909;414325;10407;645836,19
1,-1,8,7239471,8079912,840441,503614;504180;503841;140596;100133251;653423;55894;245910;1673;100131608;245908;100132396;503618;392188;100289462;245909;414325;10407;645836,19
1,-1,8,7239471,8079912,840441,503614;504180;503841;140596;100133251;653423;55894;245910;1673;100131608;245908;100132396;503618;392188;100289462;245909;414325;10407;645836,19
1,-1,8,7239471,8079912,840441,503614;504180;503841;140596;100133251;653423;55894;245910;1673;100131608;245908;100132396;503618;392188;100289462;245909;414325;10407;645836,19
-1,-1,8,7239471,8079912,840441,503614;504180;503841;140596;100133251;653423;55894;245910;1673;100131608;245908;100132396;503618;392188;100289462;245909;414325;10407;645836,19
-1,-1,8,7239471,8079912,840441,503614;504180;503841;140596;100133251;653423;55894;245910;1673;100131608;245908;100132396;503618;392188;100289462;245909;414325;10407;645836,19
1,-1,8,7239471,8079912,840441,503614;504180;503841;140596;100133251;653423;55894;245910;1673;100131608;245908;100132396;503618;392188;100289462;245909;414325;10407;645836,19
1,-1,8,7239471,8079912,840441,503614;504180;503841;140596;100133251;653423;55894;245910;1673;100131608;245908;100132396;503618;392188;100289462;245909;414325;10407;645836,19
1,-1,8,7239471,8079912,840441,503614;504180;503841;140596;100133251;653423;55894;245910;1673;100131608;245908;100132396;503618;392188;100289462;245909;414325;10407;645836,19
1,-1,8,7239471,8079912,840441,503614;504180;503841;140596;100133251;653423;55894;245910;1673;100131608;245908;100132396;503618;392188;100289462;245909;414325;10407;645836,19
-1,-1,8,7239471,8079912,840441,503614;504180;503841;140596;100133251;653423;55894;245910;1673;100131608;245908;100132396;503618;392188;100289462;245909;414325;10407;645836,19
1,-1,8,7239471,8079912,840441,503614;504180;503841;140596;100133251;653423;55894;245910;1673;100131608;245908;100132396;503618;392188;100289462;245909;414325;10407;645836,19
1,-1,8,7239471,8079912,840441,503614;504180;503841;140596;100133251;653423;55894;245910;1673;100131608;245908;100132396;503618;392188;100289462;245909;414325;10407;645836,19
1,-1,8,7239471,8079912,840441,503614;504180;503841;140596;100133251;653423;55894;245910;1673;100131608;245908;100132396;503618;392188;100289462;245909;414325;10407;645836,19
1,-1,8,7239471,8079912,840441,503614;504180;503841;140596;100133251;653423;55894;245910;1673;100131608;245908;100132396;503618;392188;100289462;245909;414325;10407;645836,19
1,-1,8,7239471,8079912,840441,503614;504180;503841;140596;100133251;653423;55894;245910;1673;100131608;245908;100132396;503618;392188;100289462;245909;414325;10407;645836,19
-1,-1,8,7239471,8079912,840441,503614;504180;503841;140596;100133251;653423;55894;245910;1673;100131608;245908;100132396;503618;392188;100289462;245909;414325;10407;645836,19
1,-1,8,7239471,8079912,840441,503614;504180;503841;140596;100133251;653423;55894;245910;1673;100131608;245908;100132396;503618;392188;100289462;245909;414325;10407;645836,19
1,-1,8,7239471,8079912,840441,503614;504180;503841;140596;100133251;653423;55894;245910;1673;100131608;245908;100132396;503618;392188;100289462;245909;414325;10407;645836,19
1,-1,8,7239471,8079912,840441,503614;504180;503841;140596;100133251;653423;55894;245910;1673;100131608;245908;100132396;503618;392188;100289462;245909;414325;10407;645836,19
-1,-1,8,7239471,8079912,840441,503614;504180;503841;140596;100133251;653423;55894;245910;1673;100131608;245908;100132396;503618;392188;100289462;245909;414325;10407;645836,19
1,-1,8,7239471,8079912,840441,503614;504180;503841;140596;100133251;653423;55894;245910;1673;100131608;245908;100132396;503618;392188;100289462;245909;414325;10407;645836,19
1,-1,8,7239471,8079912,840441,503614;504180;503841;140596;100133251;653423;55894;245910;1673;100131608;245908;100132396;503618;392188;100289462;245909;414325;10407;645836,19
-1,-1,8,7239471,8079912,840441,503614;504180;503841;140596;100133251;653423;55894;245910;1673;100131608;245908;100132396;503618;392188;100289462;245909;414325;10407;645836,19
1,-1,8,7239471,8079912,840441,503614;504180;503841;140596;100133251;653423;55894;245910;1673;100131608;245908;100132396;503618;392188;100289462;245909;414325;10407;645836,19
1,-1,8,7239471,8079912,840441,503614;504180;503841;140596;100133251;653423;55894;245910;1673;100131608;245908;100132396;503618;392188;100289462;245909;414325;10407;645836,19
-1,-1,8,7239471,8079912,840441,503614;504180;503841;140596;100133251;653423;55894;245910;1673;100131608;245908;100132396;503618;392188;100289462;245909;414325;10407;645836,19
1,-1,8,7239471,8079912,840441,503614;504180;503841;140596;100133251;653423;55894;245910;1673;100131608;245908;100132396;503618;392188;100289462;245909;414325;10407;645836,19
-1,-1,8,7239471,8079912,840441,503614;504180;503841;140596;100133251;653423;55894;245910;1673;100131608;245908;100132396;503618;392188;100289462;245909;414325;10407;645836,19
1,-1,8,7239471,8079912,840441,503614;504180;503841;140596;100133251;653423;55894;245910;1673;100131608;245908;100132396;503618;392188;100289462;245909;414325;10407;645836,19
-1,-1,8,7239471,8079912,840441,503614;504180;503841;140596;100133251;653423;55894;245910;1673;100131608;245908;100132396;503618;392188;100289462;245909;414325;10407;645836,19
1,-1,8,7239471,8079912,840441,503614;504180;503841;140596;100133251;653423;55894;245910;1673;100131608;245908;100132396;503618;392188;100289462;245909;414325;10407;645836,19
1,-1,8,7239471,8079912,840441,503614;504180;503841;140596;100133251;653423;55894;245910;1673;100131608;245908;100132396;503618;392188;100289462;245909;414325;10407;645836,19
1,-1,8,7239471,8079912,840441,503614;504180;503841;140596;100133251;653423;55894;245910;1673;100131608;245908;100132396;503618;392188;100289462;245909;414325;10407;645836,19
1,-1,8,7239471,8079912,840441,503614;504180;503841;140596;100133251;653423;55894;245910;1673;100131608;245908;100132396;503618;392188;100289462;245909;414325;10407;645836,19
-1,-1,8,7239471,8079912,840441,503614;504180;503841;140596;100133251;653423;55894;245910;1673;100131608;245908;100132396;503618;392188;100289462;245909;414325;10407;645836,19
-1,-1,8,7239471,8079912,840441,503614;504180;503841;140596;100133251;653423;55894;245910;1673;100131608;245908;100132396;503618;392188;100289462;245909;414325;10407;645836,19
1,-1,8,7239471,8079912,840441,503614;504180;503841;140596;100133251;653423;55894;245910;1673;100131608;245908;100132396;503618;392188;100289462;245909;414325;10407;645836,19
1,-1,8,7239471,8079912,840441,503614;504180;503841;140596;100133251;653423;55894;245910;1673;100131608;245908;100132396;503618;392188;100289462;245909;414325;10407;645836,19
1,-1,8,7239471,8079912,840441,503614;504180;503841;140596;100133251;653423;55894;245910;1673;100131608;245908;100132396;503618;392188;100289462;245909;414325;10407;645836,19
1,-1,8,7239471,8079912,840441,503614;504180;503841;140596;100133251;653423;55894;245910;1673;100131608;245908;100132396;503618;392188;100289462;245909;414325;10407;645836,19
1,-1,8,7239471,8079912,840441,503614;504180;503841;140596;100133251;653423;55894;245910;1673;100131608;245908;100132396;503618;392188;100289462;245909;414325;10407;645836,19
1,-1,8,7239471,8079912,840441,503614;504180;503841;140596;100133251;653423;55894;245910;1673;100131608;245908;100132396;503618;392188;100289462;245909;414325;10407;645836,19
-1,-1,8,7239471,8079912,840441,503614;504180;503841;140596;100133251;653423;55894;245910;1673;100131608;245908;100132396;503618;392188;100289462;245909;414325;10407;645836,19
1,-1,8,7239471,8079912,840441,503614;504180;503841;140596;100133251;653423;55894;245910;1673;100131608;245908;100132396;503618;392188;100289462;245909;414325;10407;645836,19
1,-1,8,7239471,8130631,891160,503614;504180;503841;140596;100133251;653423;55894;245910;1673;100131608;245908;100132396;503618;392188;100289462;245909;414325;10407;645836,19
1,-1,8,7239471,8130631,891160,503614;504180;503841;140596;100133251;653423;55894;245910;1673;100131608;245908;100132396;503618;392188;100289462;245909;414325;10407;645836,19
1,-1,8,7239471,8130631,891160,503614;504180;503841;140596;100133251;653423;55894;245910;1673;100131608;245908;100132396;503618;392188;100289462;245909;414325;10407;645836,19
1,-1,8,7239471,8130631,891160,503614;504180;503841;140596;100133251;653423;55894;245910;1673;100131608;245908;100132396;503618;392188;100289462;245909;414325;10407;645836,19
1,-1,8,7239471,8222024,982553,503614;504180;503841;140596;100133251;653423;55894;245910;1673;157285;100131608;245908;100132396;503618;392188;100289462;245909;414325;10407;645836,20
1,-1,8,7239471,8222024,982553,503614;504180;503841;140596;100133251;653423;55894;245910;1673;157285;100131608;245908;100132396;503618;392188;100289462;245909;414325;10407;645836,20
-1,-1,8,7239491,7403681,164190,100131608;503614;504180;503841;503618;100289462;55894;10407,8
1,-1,8,7239491,7691960,452469,100131608;503614;504180;503841;503618;245908;100289462;100133251;245909;55894;10407;245910,12
-1,-1,8,7239491,7752586,513095,503614;504180;503841;140596;100133251;653423;55894;245910;1673;100131608;245908;503618;100289462;245909;414325;10407,16
-1,-1,8,7239491,7752586,513095,503614;504180;503841;140596;100133251;653423;55894;245910;1673;100131608;245908;503618;100289462;245909;414325;10407,16
-1,-1,8,7239491,7752586,513095,503614;504180;503841;140596;100133251;653423;55894;245910;1673;100131608;245908;503618;100289462;245909;414325;10407,16
-1,-1,8,7239491,7752586,513095,503614;504180;503841;140596;100133251;653423;55894;245910;1673;100131608;245908;503618;100289462;245909;414325;10407,16
1,-1,8,7239491,7752586,513095,503614;504180;503841;140596;100133251;653423;55894;245910;1673;100131608;245908;503618;100289462;245909;414325;10407,16
-1,-1,8,7239491,7752586,513095,503614;504180;503841;140596;100133251;653423;55894;245910;1673;100131608;245908;503618;100289462;245909;414325;10407,16
-1,-1,8,7239491,7752586,513095,503614;504180;503841;140596;100133251;653423;55894;245910;1673;100131608;245908;503618;100289462;245909;414325;10407,16
1,-1,8,7239491,7806229,566738,503614;504180;503841;140596;100133251;653423;55894;245910;1673;100131608;245908;100132396;503618;100289462;245909;414325;10407,17
-1,-1,8,7239491,7806229,566738,503614;504180;503841;140596;100133251;653423;55894;245910;1673;100131608;245908;100132396;503618;100289462;245909;414325;10407,17
-1,-1,8,7239491,7806229,566738,503614;504180;503841;140596;100133251;653423;55894;245910;1673;100131608;245908;100132396;503618;100289462;245909;414325;10407,17
1,-1,8,7239491,7806229,566738,503614;504180;503841;140596;100133251;653423;55894;245910;1673;100131608;245908;100132396;503618;100289462;245909;414325;10407,17
-1,-1,8,7239491,7806229,566738,503614;504180;503841;140596;100133251;653423;55894;245910;1673;100131608;245908;100132396;503618;100289462;245909;414325;10407,17
-1,-1,8,7239491,7806229,566738,503614;504180;503841;140596;100133251;653423;55894;245910;1673;100131608;245908;100132396;503618;100289462;245909;414325;10407,17
1,-1,8,7239491,7806229,566738,503614;504180;503841;140596;100133251;653423;55894;245910;1673;100131608;245908;100132396;503618;100289462;245909;414325;10407,17
1,-1,8,7239491,7806229,566738,503614;504180;503841;140596;100133251;653423;55894;245910;1673;100131608;245908;100132396;503618;100289462;245909;414325;10407,17
-1,-1,8,7239491,7806229,566738,503614;504180;503841;140596;100133251;653423;55894;245910;1673;100131608;245908;100132396;503618;100289462;245909;414325;10407,17
-1,-1,8,7239491,7806229,566738,503614;504180;503841;140596;100133251;653423;55894;245910;1673;100131608;245908;100132396;503618;100289462;245909;414325;10407,17
-1,-1,8,7239491,8079861,840370,503614;504180;503841;140596;100133251;653423;55894;245910;1673;100131608;245908;100132396;503618;392188;100289462;245909;414325;10407;645836,19
-1,-1,8,7239491,8079920,840429,503614;504180;503841;140596;100133251;653423;55894;245910;1673;100131608;245908;100132396;503618;392188;100289462;245909;414325;10407;645836,19
-1,-1,8,7239491,8079920,840429,503614;504180;503841;140596;100133251;653423;55894;245910;1673;100131608;245908;100132396;503618;392188;100289462;245909;414325;10407;645836,19
1,-1,8,7239491,8079920,840429,503614;504180;503841;140596;100133251;653423;55894;245910;1673;100131608;245908;100132396;503618;392188;100289462;245909;414325;10407;645836,19
-1,-1,8,7239491,8130689,891198,503614;504180;503841;140596;100133251;653423;55894;245910;1673;100131608;245908;100132396;503618;392188;100289462;245909;414325;10407;645836,19
-1,-1,8,7239520,7371660,132140,10407;55894;503614;504180;503841;503618;100289462,7
-1,-1,8,7239520,8079890,840370,503614;504180;503841;140596;100133251;653423;55894;245910;1673;100131608;245908;100132396;503618;392188;100289462;245909;414325;10407;645836,19
1,-1,8,7242978,7334654,91676,10407;503618;55894;100289462,4
-1,-1,8,7268619,7752727,484108,503614;504180;503841;140596;100133251;653423;55894;245910;1673;100131608;245908;503618;100289462;245909;414325;10407,16
1,-1,8,7268819,7752586,483767,503614;504180;503841;140596;100133251;653423;55894;245910;1673;100131608;245908;503618;100289462;245909;414325;10407,16
-1,-1,8,7268819,7752586,483767,503614;504180;503841;140596;100133251;653423;55894;245910;1673;100131608;245908;503618;100289462;245909;414325;10407,16
-1,-1,8,7268819,7752586,483767,503614;504180;503841;140596;100133251;653423;55894;245910;1673;100131608;245908;503618;100289462;245909;414325;10407,16
1,-1,8,7268819,7752586,483767,503614;504180;503841;140596;100133251;653423;55894;245910;1673;100131608;245908;503618;100289462;245909;414325;10407,16
-1,-1,8,7268819,7752586,483767,503614;504180;503841;140596;100133251;653423;55894;245910;1673;100131608;245908;503618;100289462;245909;414325;10407,16
-1,-1,8,7268819,7752586,483767,503614;504180;503841;140596;100133251;653423;55894;245910;1673;100131608;245908;503618;100289462;245909;414325;10407,16
-1,-1,8,7268819,7752586,483767,503614;504180;503841;140596;100133251;653423;55894;245910;1673;100131608;245908;503618;100289462;245909;414325;10407,16
-1,-1,8,7268819,7752586,483767,503614;504180;503841;140596;100133251;653423;55894;245910;1673;100131608;245908;503618;100289462;245909;414325;10407,16
-1,-1,8,7268819,7752586,483767,503614;504180;503841;140596;100133251;653423;55894;245910;1673;100131608;245908;503618;100289462;245909;414325;10407,16
-1,-1,8,7268819,7752586,483767,503614;504180;503841;140596;100133251;653423;55894;245910;1673;100131608;245908;503618;100289462;245909;414325;10407,16
-1,-1,8,7268819,7752586,483767,503614;504180;503841;140596;100133251;653423;55894;245910;1673;100131608;245908;503618;100289462;245909;414325;10407,16
-1,-1,8,7268819,7752586,483767,503614;504180;503841;140596;100133251;653423;55894;245910;1673;100131608;245908;503618;100289462;245909;414325;10407,16
-1,-1,8,7268819,7752586,483767,503614;504180;503841;140596;100133251;653423;55894;245910;1673;100131608;245908;503618;100289462;245909;414325;10407,16
-1,-1,8,7268819,7752586,483767,503614;504180;503841;140596;100133251;653423;55894;245910;1673;100131608;245908;503618;100289462;245909;414325;10407,16
1,-1,8,7268819,7752586,483767,503614;504180;503841;140596;100133251;653423;55894;245910;1673;100131608;245908;503618;100289462;245909;414325;10407,16
-1,-1,8,7268819,7752586,483767,503614;504180;503841;140596;100133251;653423;55894;245910;1673;100131608;245908;503618;100289462;245909;414325;10407,16
-1,-1,8,7268819,7752586,483767,503614;504180;503841;140596;100133251;653423;55894;245910;1673;100131608;245908;503618;100289462;245909;414325;10407,16
-1,-1,8,7268819,7752586,483767,503614;504180;503841;140596;100133251;653423;55894;245910;1673;100131608;245908;503618;100289462;245909;414325;10407,16
-1,-1,8,7268819,7752586,483767,503614;504180;503841;140596;100133251;653423;55894;245910;1673;100131608;245908;503618;100289462;245909;414325;10407,16
-1,-1,8,7268819,7752586,483767,503614;504180;503841;140596;100133251;653423;55894;245910;1673;100131608;245908;503618;100289462;245909;414325;10407,16
-1,-1,8,7268819,7752586,483767,503614;504180;503841;140596;100133251;653423;55894;245910;1673;100131608;245908;503618;100289462;245909;414325;10407,16
-1,-1,8,7268819,7752586,483767,503614;504180;503841;140596;100133251;653423;55894;245910;1673;100131608;245908;503618;100289462;245909;414325;10407,16
-1,-1,8,7268819,7752586,483767,503614;504180;503841;140596;100133251;653423;55894;245910;1673;100131608;245908;503618;100289462;245909;414325;10407,16
-1,-1,8,7268819,7752586,483767,503614;504180;503841;140596;100133251;653423;55894;245910;1673;100131608;245908;503618;100289462;245909;414325;10407,16
-1,-1,8,7268819,7752586,483767,503614;504180;503841;140596;100133251;653423;55894;245910;1673;100131608;245908;503618;100289462;245909;414325;10407,16
1,-1,8,7268819,7752586,483767,503614;504180;503841;140596;100133251;653423;55894;245910;1673;100131608;245908;503618;100289462;245909;414325;10407,16
-1,-1,8,7268819,7752586,483767,503614;504180;503841;140596;100133251;653423;55894;245910;1673;100131608;245908;503618;100289462;245909;414325;10407,16
1,-1,8,7268819,7752586,483767,503614;504180;503841;140596;100133251;653423;55894;245910;1673;100131608;245908;503618;100289462;245909;414325;10407,16
-1,-1,8,7268819,7752586,483767,503614;504180;503841;140596;100133251;653423;55894;245910;1673;100131608;245908;503618;100289462;245909;414325;10407,16
-1,-1,8,7268819,7752586,483767,503614;504180;503841;140596;100133251;653423;55894;245910;1673;100131608;245908;503618;100289462;245909;414325;10407,16
-1,-1,8,7268819,7752586,483767,503614;504180;503841;140596;100133251;653423;55894;245910;1673;100131608;245908;503618;100289462;245909;414325;10407,16
-1,-1,8,7268819,7752586,483767,503614;504180;503841;140596;100133251;653423;55894;245910;1673;100131608;245908;503618;100289462;245909;414325;10407,16
1,-1,8,7268819,7752586,483767,503614;504180;503841;140596;100133251;653423;55894;245910;1673;100131608;245908;503618;100289462;245909;414325;10407,16
-1,-1,8,7268819,7752586,483767,503614;504180;503841;140596;100133251;653423;55894;245910;1673;100131608;245908;503618;100289462;245909;414325;10407,16
1,-1,8,7268819,7752586,483767,503614;504180;503841;140596;100133251;653423;55894;245910;1673;100131608;245908;503618;100289462;245909;414325;10407,16
-1,-1,8,7268819,7752586,483767,503614;504180;503841;140596;100133251;653423;55894;245910;1673;100131608;245908;503618;100289462;245909;414325;10407,16
-1,-1,8,7268819,7752586,483767,503614;504180;503841;140596;100133251;653423;55894;245910;1673;100131608;245908;503618;100289462;245909;414325;10407,16
-1,-1,8,7268819,7752586,483767,503614;504180;503841;140596;100133251;653423;55894;245910;1673;100131608;245908;503618;100289462;245909;414325;10407,16
1,-1,8,7268819,7752586,483767,503614;504180;503841;140596;100133251;653423;55894;245910;1673;100131608;245908;503618;100289462;245909;414325;10407,16
-1,-1,8,7268819,7752586,483767,503614;504180;503841;140596;100133251;653423;55894;245910;1673;100131608;245908;503618;100289462;245909;414325;10407,16
-1,-1,8,7268819,7752586,483767,503614;504180;503841;140596;100133251;653423;55894;245910;1673;100131608;245908;503618;100289462;245909;414325;10407,16
-1,-1,8,7268819,7752586,483767,503614;504180;503841;140596;100133251;653423;55894;245910;1673;100131608;245908;503618;100289462;245909;414325;10407,16
-1,-1,8,7268819,7752586,483767,503614;504180;503841;140596;100133251;653423;55894;245910;1673;100131608;245908;503618;100289462;245909;414325;10407,16
1,-1,8,7268819,7752586,483767,503614;504180;503841;140596;100133251;653423;55894;245910;1673;100131608;245908;503618;100289462;245909;414325;10407,16
-1,-1,8,7268819,7752586,483767,503614;504180;503841;140596;100133251;653423;55894;245910;1673;100131608;245908;503618;100289462;245909;414325;10407,16
-1,-1,8,7268819,7752586,483767,503614;504180;503841;140596;100133251;653423;55894;245910;1673;100131608;245908;503618;100289462;245909;414325;10407,16
-1,-1,8,7268819,7752586,483767,503614;504180;503841;140596;100133251;653423;55894;245910;1673;100131608;245908;503618;100289462;245909;414325;10407,16
-1,-1,8,7268819,7752586,483767,503614;504180;503841;140596;100133251;653423;55894;245910;1673;100131608;245908;503618;100289462;245909;414325;10407,16
-1,-1,8,7268819,7752586,483767,503614;504180;503841;140596;100133251;653423;55894;245910;1673;100131608;245908;503618;100289462;245909;414325;10407,16
-1,-1,8,7268819,7752586,483767,503614;504180;503841;140596;100133251;653423;55894;245910;1673;100131608;245908;503618;100289462;245909;414325;10407,16
-1,-1,8,7268819,7752586,483767,503614;504180;503841;140596;100133251;653423;55894;245910;1673;100131608;245908;503618;100289462;245909;414325;10407,16
-1,-1,8,7268819,7752586,483767,503614;504180;503841;140596;100133251;653423;55894;245910;1673;100131608;245908;503618;100289462;245909;414325;10407,16
-1,-1,8,7268819,7752586,483767,503614;504180;503841;140596;100133251;653423;55894;245910;1673;100131608;245908;503618;100289462;245909;414325;10407,16
-1,-1,8,7268819,7752586,483767,503614;504180;503841;140596;100133251;653423;55894;245910;1673;100131608;245908;503618;100289462;245909;414325;10407,16
1,-1,8,7268819,7752586,483767,503614;504180;503841;140596;100133251;653423;55894;245910;1673;100131608;245908;503618;100289462;245909;414325;10407,16
-1,-1,8,7268819,7752586,483767,503614;504180;503841;140596;100133251;653423;55894;245910;1673;100131608;245908;503618;100289462;245909;414325;10407,16
-1,-1,8,7268819,7752586,483767,503614;504180;503841;140596;100133251;653423;55894;245910;1673;100131608;245908;503618;100289462;245909;414325;10407,16
-1,-1,8,7268819,7752586,483767,503614;504180;503841;140596;100133251;653423;55894;245910;1673;100131608;245908;503618;100289462;245909;414325;10407,16
1,-1,8,7268819,7752586,483767,503614;504180;503841;140596;100133251;653423;55894;245910;1673;100131608;245908;503618;100289462;245909;414325;10407,16
-1,-1,8,7268819,7752586,483767,503614;504180;503841;140596;100133251;653423;55894;245910;1673;100131608;245908;503618;100289462;245909;414325;10407,16
-1,-1,8,7268819,7752586,483767,503614;504180;503841;140596;100133251;653423;55894;245910;1673;100131608;245908;503618;100289462;245909;414325;10407,16
1,-1,8,7268819,7752586,483767,503614;504180;503841;140596;100133251;653423;55894;245910;1673;100131608;245908;503618;100289462;245909;414325;10407,16
1,-1,8,7268819,7752586,483767,503614;504180;503841;140596;100133251;653423;55894;245910;1673;100131608;245908;503618;100289462;245909;414325;10407,16
-1,-1,8,7268819,7752586,483767,503614;504180;503841;140596;100133251;653423;55894;245910;1673;100131608;245908;503618;100289462;245909;414325;10407,16
-1,-1,8,7268819,7752586,483767,503614;504180;503841;140596;100133251;653423;55894;245910;1673;100131608;245908;503618;100289462;245909;414325;10407,16
1,-1,8,7268819,7752586,483767,503614;504180;503841;140596;100133251;653423;55894;245910;1673;100131608;245908;503618;100289462;245909;414325;10407,16
-1,-1,8,7268819,7752586,483767,503614;504180;503841;140596;100133251;653423;55894;245910;1673;100131608;245908;503618;100289462;245909;414325;10407,16
-1,-1,8,7268819,7752586,483767,503614;504180;503841;140596;100133251;653423;55894;245910;1673;100131608;245908;503618;100289462;245909;414325;10407,16
-1,-1,8,7268819,7752586,483767,503614;504180;503841;140596;100133251;653423;55894;245910;1673;100131608;245908;503618;100289462;245909;414325;10407,16
-1,-1,8,7268819,7752586,483767,503614;504180;503841;140596;100133251;653423;55894;245910;1673;100131608;245908;503618;100289462;245909;414325;10407,16
-1,-1,8,7268819,7752586,483767,503614;504180;503841;140596;100133251;653423;55894;245910;1673;100131608;245908;503618;100289462;245909;414325;10407,16
-1,-1,8,7268819,7752586,483767,503614;504180;503841;140596;100133251;653423;55894;245910;1673;100131608;245908;503618;100289462;245909;414325;10407,16
-1,-1,8,7268819,7752586,483767,503614;504180;503841;140596;100133251;653423;55894;245910;1673;100131608;245908;503618;100289462;245909;414325;10407,16
-1,-1,8,7268819,7752586,483767,503614;504180;503841;140596;100133251;653423;55894;245910;1673;100131608;245908;503618;100289462;245909;414325;10407,16
-1,-1,8,7268819,7752586,483767,503614;504180;503841;140596;100133251;653423;55894;245910;1673;100131608;245908;503618;100289462;245909;414325;10407,16
-1,-1,8,7268819,7752586,483767,503614;504180;503841;140596;100133251;653423;55894;245910;1673;100131608;245908;503618;100289462;245909;414325;10407,16
-1,-1,8,7268819,7752586,483767,503614;504180;503841;140596;100133251;653423;55894;245910;1673;100131608;245908;503618;100289462;245909;414325;10407,16
-1,-1,8,7268819,7752586,483767,503614;504180;503841;140596;100133251;653423;55894;245910;1673;100131608;245908;503618;100289462;245909;414325;10407,16
1,-1,8,7268819,7752586,483767,503614;504180;503841;140596;100133251;653423;55894;245910;1673;100131608;245908;503618;100289462;245909;414325;10407,16
-1,-1,8,7268819,7752586,483767,503614;504180;503841;140596;100133251;653423;55894;245910;1673;100131608;245908;503618;100289462;245909;414325;10407,16
-1,-1,8,7268819,7752586,483767,503614;504180;503841;140596;100133251;653423;55894;245910;1673;100131608;245908;503618;100289462;245909;414325;10407,16
-1,-1,8,7268819,7752586,483767,503614;504180;503841;140596;100133251;653423;55894;245910;1673;100131608;245908;503618;100289462;245909;414325;10407,16
-1,-1,8,7268819,7752586,483767,503614;504180;503841;140596;100133251;653423;55894;245910;1673;100131608;245908;503618;100289462;245909;414325;10407,16
-1,-1,8,7268819,7752586,483767,503614;504180;503841;140596;100133251;653423;55894;245910;1673;100131608;245908;503618;100289462;245909;414325;10407,16
-1,-1,8,7268819,7752586,483767,503614;504180;503841;140596;100133251;653423;55894;245910;1673;100131608;245908;503618;100289462;245909;414325;10407,16
-1,-1,8,7268819,7752586,483767,503614;504180;503841;140596;100133251;653423;55894;245910;1673;100131608;245908;503618;100289462;245909;414325;10407,16
-1,-1,8,7268819,7752586,483767,503614;504180;503841;140596;100133251;653423;55894;245910;1673;100131608;245908;503618;100289462;245909;414325;10407,16
-1,-1,8,7268819,7752586,483767,503614;504180;503841;140596;100133251;653423;55894;245910;1673;100131608;245908;503618;100289462;245909;414325;10407,16
-1,-1,8,7268819,7752586,483767,503614;504180;503841;140596;100133251;653423;55894;245910;1673;100131608;245908;503618;100289462;245909;414325;10407,16
-1,-1,8,7268819,7752586,483767,503614;504180;503841;140596;100133251;653423;55894;245910;1673;100131608;245908;503618;100289462;245909;414325;10407,16
-1,-1,8,7268819,7752586,483767,503614;504180;503841;140596;100133251;653423;55894;245910;1673;100131608;245908;503618;100289462;245909;414325;10407,16
1,-1,8,7268819,7752586,483767,503614;504180;503841;140596;100133251;653423;55894;245910;1673;100131608;245908;503618;100289462;245909;414325;10407,16
-1,-1,8,7268819,7752586,483767,503614;504180;503841;140596;100133251;653423;55894;245910;1673;100131608;245908;503618;100289462;245909;414325;10407,16
-1,-1,8,7268819,7752586,483767,503614;504180;503841;140596;100133251;653423;55894;245910;1673;100131608;245908;503618;100289462;245909;414325;10407,16
-1,-1,8,7268819,7752586,483767,503614;504180;503841;140596;100133251;653423;55894;245910;1673;100131608;245908;503618;100289462;245909;414325;10407,16
1,-1,8,7268819,7752586,483767,503614;504180;503841;140596;100133251;653423;55894;245910;1673;100131608;245908;503618;100289462;245909;414325;10407,16
-1,-1,8,7268819,7752586,483767,503614;504180;503841;140596;100133251;653423;55894;245910;1673;100131608;245908;503618;100289462;245909;414325;10407,16
1,-1,8,7268819,7752586,483767,503614;504180;503841;140596;100133251;653423;55894;245910;1673;100131608;245908;503618;100289462;245909;414325;10407,16
-1,-1,8,7268819,7752586,483767,503614;504180;503841;140596;100133251;653423;55894;245910;1673;100131608;245908;503618;100289462;245909;414325;10407,16
1,-1,8,7268819,7752586,483767,503614;504180;503841;140596;100133251;653423;55894;245910;1673;100131608;245908;503618;100289462;245909;414325;10407,16
-1,-1,8,7268819,7752586,483767,503614;504180;503841;140596;100133251;653423;55894;245910;1673;100131608;245908;503618;100289462;245909;414325;10407,16
-1,-1,8,7268819,7752586,483767,503614;504180;503841;140596;100133251;653423;55894;245910;1673;100131608;245908;503618;100289462;245909;414325;10407,16
1,-1,8,7268819,7752586,483767,503614;504180;503841;140596;100133251;653423;55894;245910;1673;100131608;245908;503618;100289462;245909;414325;10407,16
-1,-1,8,7268819,7752586,483767,503614;504180;503841;140596;100133251;653423;55894;245910;1673;100131608;245908;503618;100289462;245909;414325;10407,16
-1,-1,8,7268819,7752586,483767,503614;504180;503841;140596;100133251;653423;55894;245910;1673;100131608;245908;503618;100289462;245909;414325;10407,16
-1,-1,8,7268819,7752586,483767,503614;504180;503841;140596;100133251;653423;55894;245910;1673;100131608;245908;503618;100289462;245909;414325;10407,16
-1,-1,8,7268819,7752586,483767,503614;504180;503841;140596;100133251;653423;55894;245910;1673;100131608;245908;503618;100289462;245909;414325;10407,16
-1,-1,8,7268819,7752586,483767,503614;504180;503841;140596;100133251;653423;55894;245910;1673;100131608;245908;503618;100289462;245909;414325;10407,16
-1,-1,8,7268819,7752586,483767,503614;504180;503841;140596;100133251;653423;55894;245910;1673;100131608;245908;503618;100289462;245909;414325;10407,16
-1,-1,8,7268819,7752586,483767,503614;504180;503841;140596;100133251;653423;55894;245910;1673;100131608;245908;503618;100289462;245909;414325;10407,16
-1,-1,8,7268819,7752586,483767,503614;504180;503841;140596;100133251;653423;55894;245910;1673;100131608;245908;503618;100289462;245909;414325;10407,16
-1,-1,8,7268819,7752586,483767,503614;504180;503841;140596;100133251;653423;55894;245910;1673;100131608;245908;503618;100289462;245909;414325;10407,16
1,-1,8,7268819,7752586,483767,503614;504180;503841;140596;100133251;653423;55894;245910;1673;100131608;245908;503618;100289462;245909;414325;10407,16
-1,-1,8,7268819,7752586,483767,503614;504180;503841;140596;100133251;653423;55894;245910;1673;100131608;245908;503618;100289462;245909;414325;10407,16
-1,-1,8,7268819,7752586,483767,503614;504180;503841;140596;100133251;653423;55894;245910;1673;100131608;245908;503618;100289462;245909;414325;10407,16
-1,-1,8,7268819,7752586,483767,503614;504180;503841;140596;100133251;653423;55894;245910;1673;100131608;245908;503618;100289462;245909;414325;10407,16
-1,-1,8,7268819,7752586,483767,503614;504180;503841;140596;100133251;653423;55894;245910;1673;100131608;245908;503618;100289462;245909;414325;10407,16
-1,-1,8,7268819,7752586,483767,503614;504180;503841;140596;100133251;653423;55894;245910;1673;100131608;245908;503618;100289462;245909;414325;10407,16
-1,-1,8,7268819,7752586,483767,503614;504180;503841;140596;100133251;653423;55894;245910;1673;100131608;245908;503618;100289462;245909;414325;10407,16
-1,-1,8,7268819,7752586,483767,503614;504180;503841;140596;100133251;653423;55894;245910;1673;100131608;245908;503618;100289462;245909;414325;10407,16
-1,-1,8,7268819,7752586,483767,503614;504180;503841;140596;100133251;653423;55894;245910;1673;100131608;245908;503618;100289462;245909;414325;10407,16
-1,-1,8,7268819,7752586,483767,503614;504180;503841;140596;100133251;653423;55894;245910;1673;100131608;245908;503618;100289462;245909;414325;10407,16
-1,-1,8,7268819,7752586,483767,503614;504180;503841;140596;100133251;653423;55894;245910;1673;100131608;245908;503618;100289462;245909;414325;10407,16
-1,-1,8,7268819,7752586,483767,503614;504180;503841;140596;100133251;653423;55894;245910;1673;100131608;245908;503618;100289462;245909;414325;10407,16
-1,-1,8,7268819,7752586,483767,503614;504180;503841;140596;100133251;653423;55894;245910;1673;100131608;245908;503618;100289462;245909;414325;10407,16
-1,-1,8,7268819,7752586,483767,503614;504180;503841;140596;100133251;653423;55894;245910;1673;100131608;245908;503618;100289462;245909;414325;10407,16
-1,-1,8,7268819,7752586,483767,503614;504180;503841;140596;100133251;653423;55894;245910;1673;100131608;245908;503618;100289462;245909;414325;10407,16
1,-1,8,7268819,7752586,483767,503614;504180;503841;140596;100133251;653423;55894;245910;1673;100131608;245908;503618;100289462;245909;414325;10407,16
-1,-1,8,7268819,7752586,483767,503614;504180;503841;140596;100133251;653423;55894;245910;1673;100131608;245908;503618;100289462;245909;414325;10407,16
-1,-1,8,7268819,7752586,483767,503614;504180;503841;140596;100133251;653423;55894;245910;1673;100131608;245908;503618;100289462;245909;414325;10407,16
-1,-1,8,7268819,7752586,483767,503614;504180;503841;140596;100133251;653423;55894;245910;1673;100131608;245908;503618;100289462;245909;414325;10407,16
-1,-1,8,7268819,7752586,483767,503614;504180;503841;140596;100133251;653423;55894;245910;1673;100131608;245908;503618;100289462;245909;414325;10407,16
-1,-1,8,7268819,7752586,483767,503614;504180;503841;140596;100133251;653423;55894;245910;1673;100131608;245908;503618;100289462;245909;414325;10407,16
-1,-1,8,7268819,7752586,483767,503614;504180;503841;140596;100133251;653423;55894;245910;1673;100131608;245908;503618;100289462;245909;414325;10407,16
-1,-1,8,7268819,7752586,483767,503614;504180;503841;140596;100133251;653423;55894;245910;1673;100131608;245908;503618;100289462;245909;414325;10407,16
-1,-1,8,7268819,7752586,483767,503614;504180;503841;140596;100133251;653423;55894;245910;1673;100131608;245908;503618;100289462;245909;414325;10407,16
-1,-1,8,7268819,7752586,483767,503614;504180;503841;140596;100133251;653423;55894;245910;1673;100131608;245908;503618;100289462;245909;414325;10407,16
-1,-1,8,7268819,7752586,483767,503614;504180;503841;140596;100133251;653423;55894;245910;1673;100131608;245908;503618;100289462;245909;414325;10407,16
-1,-1,8,7268819,7752586,483767,503614;504180;503841;140596;100133251;653423;55894;245910;1673;100131608;245908;503618;100289462;245909;414325;10407,16
-1,-1,8,7268819,7752586,483767,503614;504180;503841;140596;100133251;653423;55894;245910;1673;100131608;245908;503618;100289462;245909;414325;10407,16
-1,-1,8,7268819,7752586,483767,503614;504180;503841;140596;100133251;653423;55894;245910;1673;100131608;245908;503618;100289462;245909;414325;10407,16
1,-1,8,7268819,7752586,483767,503614;504180;503841;140596;100133251;653423;55894;245910;1673;100131608;245908;503618;100289462;245909;414325;10407,16
-1,-1,8,7268819,7752586,483767,503614;504180;503841;140596;100133251;653423;55894;245910;1673;100131608;245908;503618;100289462;245909;414325;10407,16
-1,-1,8,7268819,7752586,483767,503614;504180;503841;140596;100133251;653423;55894;245910;1673;100131608;245908;503618;100289462;245909;414325;10407,16
-1,-1,8,7268819,7752586,483767,503614;504180;503841;140596;100133251;653423;55894;245910;1673;100131608;245908;503618;100289462;245909;414325;10407,16
-1,-1,8,7268819,7752586,483767,503614;504180;503841;140596;100133251;653423;55894;245910;1673;100131608;245908;503618;100289462;245909;414325;10407,16
-1,-1,8,7268819,7752586,483767,503614;504180;503841;140596;100133251;653423;55894;245910;1673;100131608;245908;503618;100289462;245909;414325;10407,16
-1,-1,8,7268819,7752586,483767,503614;504180;503841;140596;100133251;653423;55894;245910;1673;100131608;245908;503618;100289462;245909;414325;10407,16
-1,-1,8,7268819,7752586,483767,503614;504180;503841;140596;100133251;653423;55894;245910;1673;100131608;245908;503618;100289462;245909;414325;10407,16
-1,-1,8,7268819,7752586,483767,503614;504180;503841;140596;100133251;653423;55894;245910;1673;100131608;245908;503618;100289462;245909;414325;10407,16
-1,-1,8,7268819,7752586,483767,503614;504180;503841;140596;100133251;653423;55894;245910;1673;100131608;245908;503618;100289462;245909;414325;10407,16
-1,-1,8,7268819,7752586,483767,503614;504180;503841;140596;100133251;653423;55894;245910;1673;100131608;245908;503618;100289462;245909;414325;10407,16
-1,-1,8,7268819,7752586,483767,503614;504180;503841;140596;100133251;653423;55894;245910;1673;100131608;245908;503618;100289462;245909;414325;10407,16
-1,-1,8,7268819,7752586,483767,503614;504180;503841;140596;100133251;653423;55894;245910;1673;100131608;245908;503618;100289462;245909;414325;10407,16
1,-1,8,7268819,7752586,483767,503614;504180;503841;140596;100133251;653423;55894;245910;1673;100131608;245908;503618;100289462;245909;414325;10407,16
-1,-1,8,7268819,7752586,483767,503614;504180;503841;140596;100133251;653423;55894;245910;1673;100131608;245908;503618;100289462;245909;414325;10407,16
-1,-1,8,7268819,7752586,483767,503614;504180;503841;140596;100133251;653423;55894;245910;1673;100131608;245908;503618;100289462;245909;414325;10407,16
-1,-1,8,7268819,7752586,483767,503614;504180;503841;140596;100133251;653423;55894;245910;1673;100131608;245908;503618;100289462;245909;414325;10407,16
-1,-1,8,7268819,7752586,483767,503614;504180;503841;140596;100133251;653423;55894;245910;1673;100131608;245908;503618;100289462;245909;414325;10407,16
-1,-1,8,7268819,7752586,483767,503614;504180;503841;140596;100133251;653423;55894;245910;1673;100131608;245908;503618;100289462;245909;414325;10407,16
-1,-1,8,7268819,7752586,483767,503614;504180;503841;140596;100133251;653423;55894;245910;1673;100131608;245908;503618;100289462;245909;414325;10407,16
-1,-1,8,7268819,7752586,483767,503614;504180;503841;140596;100133251;653423;55894;245910;1673;100131608;245908;503618;100289462;245909;414325;10407,16
-1,-1,8,7268819,7752586,483767,503614;504180;503841;140596;100133251;653423;55894;245910;1673;100131608;245908;503618;100289462;245909;414325;10407,16
-1,-1,8,7268819,7752586,483767,503614;504180;503841;140596;100133251;653423;55894;245910;1673;100131608;245908;503618;100289462;245909;414325;10407,16
-1,-1,8,7268819,7752586,483767,503614;504180;503841;140596;100133251;653423;55894;245910;1673;100131608;245908;503618;100289462;245909;414325;10407,16
-1,-1,8,7268819,7752586,483767,503614;504180;503841;140596;100133251;653423;55894;245910;1673;100131608;245908;503618;100289462;245909;414325;10407,16
1,-1,8,7268819,7752586,483767,503614;504180;503841;140596;100133251;653423;55894;245910;1673;100131608;245908;503618;100289462;245909;414325;10407,16
-1,-1,8,7268819,7752586,483767,503614;504180;503841;140596;100133251;653423;55894;245910;1673;100131608;245908;503618;100289462;245909;414325;10407,16
-1,-1,8,7268819,7752586,483767,503614;504180;503841;140596;100133251;653423;55894;245910;1673;100131608;245908;503618;100289462;245909;414325;10407,16
-1,-1,8,7268819,7752586,483767,503614;504180;503841;140596;100133251;653423;55894;245910;1673;100131608;245908;503618;100289462;245909;414325;10407,16
-1,-1,8,7268819,7752586,483767,503614;504180;503841;140596;100133251;653423;55894;245910;1673;100131608;245908;503618;100289462;245909;414325;10407,16
-1,-1,8,7268819,7752586,483767,503614;504180;503841;140596;100133251;653423;55894;245910;1673;100131608;245908;503618;100289462;245909;414325;10407,16
1,-1,8,7268819,7752586,483767,503614;504180;503841;140596;100133251;653423;55894;245910;1673;100131608;245908;503618;100289462;245909;414325;10407,16
-1,-1,8,7268819,7752586,483767,503614;504180;503841;140596;100133251;653423;55894;245910;1673;100131608;245908;503618;100289462;245909;414325;10407,16
-1,-1,8,7268819,7752586,483767,503614;504180;503841;140596;100133251;653423;55894;245910;1673;100131608;245908;503618;100289462;245909;414325;10407,16
-1,-1,8,7268819,7752586,483767,503614;504180;503841;140596;100133251;653423;55894;245910;1673;100131608;245908;503618;100289462;245909;414325;10407,16
-1,-1,8,7268819,7752586,483767,503614;504180;503841;140596;100133251;653423;55894;245910;1673;100131608;245908;503618;100289462;245909;414325;10407,16
1,-1,8,7268819,7752586,483767,503614;504180;503841;140596;100133251;653423;55894;245910;1673;100131608;245908;503618;100289462;245909;414325;10407,16
-1,-1,8,7268819,7752586,483767,503614;504180;503841;140596;100133251;653423;55894;245910;1673;100131608;245908;503618;100289462;245909;414325;10407,16
-1,-1,8,7268819,7752586,483767,503614;504180;503841;140596;100133251;653423;55894;245910;1673;100131608;245908;503618;100289462;245909;414325;10407,16
-1,-1,8,7268819,7752586,483767,503614;504180;503841;140596;100133251;653423;55894;245910;1673;100131608;245908;503618;100289462;245909;414325;10407,16
-1,-1,8,7268819,7752586,483767,503614;504180;503841;140596;100133251;653423;55894;245910;1673;100131608;245908;503618;100289462;245909;414325;10407,16
-1,-1,8,7268819,7752586,483767,503614;504180;503841;140596;100133251;653423;55894;245910;1673;100131608;245908;503618;100289462;245909;414325;10407,16
-1,-1,8,7268819,7752586,483767,503614;504180;503841;140596;100133251;653423;55894;245910;1673;100131608;245908;503618;100289462;245909;414325;10407,16
-1,-1,8,7268819,7752586,483767,503614;504180;503841;140596;100133251;653423;55894;245910;1673;100131608;245908;503618;100289462;245909;414325;10407,16
-1,-1,8,7268819,7752586,483767,503614;504180;503841;140596;100133251;653423;55894;245910;1673;100131608;245908;503618;100289462;245909;414325;10407,16
-1,-1,8,7268819,7752586,483767,503614;504180;503841;140596;100133251;653423;55894;245910;1673;100131608;245908;503618;100289462;245909;414325;10407,16
-1,-1,8,7268819,7752586,483767,503614;504180;503841;140596;100133251;653423;55894;245910;1673;100131608;245908;503618;100289462;245909;414325;10407,16
1,-1,8,7268819,7752586,483767,503614;504180;503841;140596;100133251;653423;55894;245910;1673;100131608;245908;503618;100289462;245909;414325;10407,16
1,-1,8,7268819,7752586,483767,503614;504180;503841;140596;100133251;653423;55894;245910;1673;100131608;245908;503618;100289462;245909;414325;10407,16
-1,-1,8,7268819,7752586,483767,503614;504180;503841;140596;100133251;653423;55894;245910;1673;100131608;245908;503618;100289462;245909;414325;10407,16
-1,-1,8,7268819,7752586,483767,503614;504180;503841;140596;100133251;653423;55894;245910;1673;100131608;245908;503618;100289462;245909;414325;10407,16
-1,-1,8,7268819,7752586,483767,503614;504180;503841;140596;100133251;653423;55894;245910;1673;100131608;245908;503618;100289462;245909;414325;10407,16
-1,-1,8,7268819,7752586,483767,503614;504180;503841;140596;100133251;653423;55894;245910;1673;100131608;245908;503618;100289462;245909;414325;10407,16
1,-1,8,7268819,7752586,483767,503614;504180;503841;140596;100133251;653423;55894;245910;1673;100131608;245908;503618;100289462;245909;414325;10407,16
-1,-1,8,7268819,7752586,483767,503614;504180;503841;140596;100133251;653423;55894;245910;1673;100131608;245908;503618;100289462;245909;414325;10407,16
1,-1,8,7268819,7752586,483767,503614;504180;503841;140596;100133251;653423;55894;245910;1673;100131608;245908;503618;100289462;245909;414325;10407,16
-1,-1,8,7268819,7752586,483767,503614;504180;503841;140596;100133251;653423;55894;245910;1673;100131608;245908;503618;100289462;245909;414325;10407,16
1,-1,8,7268819,7752586,483767,503614;504180;503841;140596;100133251;653423;55894;245910;1673;100131608;245908;503618;100289462;245909;414325;10407,16
-1,-1,8,7268819,8079920,811101,503614;504180;503841;140596;100133251;653423;55894;245910;1673;100131608;245908;100132396;503618;392188;100289462;245909;414325;10407;645836,19
-1,-1,8,7268819,8079920,811101,503614;504180;503841;140596;100133251;653423;55894;245910;1673;100131608;245908;100132396;503618;392188;100289462;245909;414325;10407;645836,19
1,-1,8,7268819,8079920,811101,503614;504180;503841;140596;100133251;653423;55894;245910;1673;100131608;245908;100132396;503618;392188;100289462;245909;414325;10407;645836,19
-1,-1,8,7268819,8079920,811101,503614;504180;503841;140596;100133251;653423;55894;245910;1673;100131608;245908;100132396;503618;392188;100289462;245909;414325;10407;645836,19
-1,-1,8,7268819,8079920,811101,503614;504180;503841;140596;100133251;653423;55894;245910;1673;100131608;245908;100132396;503618;392188;100289462;245909;414325;10407;645836,19
-1,-1,8,7268819,8079920,811101,503614;504180;503841;140596;100133251;653423;55894;245910;1673;100131608;245908;100132396;503618;392188;100289462;245909;414325;10407;645836,19
-1,-1,8,7268819,8079920,811101,503614;504180;503841;140596;100133251;653423;55894;245910;1673;100131608;245908;100132396;503618;392188;100289462;245909;414325;10407;645836,19
-1,-1,8,7268819,8079920,811101,503614;504180;503841;140596;100133251;653423;55894;245910;1673;100131608;245908;100132396;503618;392188;100289462;245909;414325;10407;645836,19
-1,-1,8,7268819,8079920,811101,503614;504180;503841;140596;100133251;653423;55894;245910;1673;100131608;245908;100132396;503618;392188;100289462;245909;414325;10407;645836,19
-1,-1,8,7268819,8079920,811101,503614;504180;503841;140596;100133251;653423;55894;245910;1673;100131608;245908;100132396;503618;392188;100289462;245909;414325;10407;645836,19
-1,-1,8,7268819,8079920,811101,503614;504180;503841;140596;100133251;653423;55894;245910;1673;100131608;245908;100132396;503618;392188;100289462;245909;414325;10407;645836,19
-1,-1,8,7268819,8079920,811101,503614;504180;503841;140596;100133251;653423;55894;245910;1673;100131608;245908;100132396;503618;392188;100289462;245909;414325;10407;645836,19
-1,-1,8,7268819,8079920,811101,503614;504180;503841;140596;100133251;653423;55894;245910;1673;100131608;245908;100132396;503618;392188;100289462;245909;414325;10407;645836,19
1,-1,8,7268819,8079920,811101,503614;504180;503841;140596;100133251;653423;55894;245910;1673;100131608;245908;100132396;503618;392188;100289462;245909;414325;10407;645836,19
-1,-1,8,7268819,8079920,811101,503614;504180;503841;140596;100133251;653423;55894;245910;1673;100131608;245908;100132396;503618;392188;100289462;245909;414325;10407;645836,19
-1,-1,8,7268819,8079920,811101,503614;504180;503841;140596;100133251;653423;55894;245910;1673;100131608;245908;100132396;503618;392188;100289462;245909;414325;10407;645836,19
-1,-1,8,7268819,8079920,811101,503614;504180;503841;140596;100133251;653423;55894;245910;1673;100131608;245908;100132396;503618;392188;100289462;245909;414325;10407;645836,19
-1,-1,8,7268819,8079920,811101,503614;504180;503841;140596;100133251;653423;55894;245910;1673;100131608;245908;100132396;503618;392188;100289462;245909;414325;10407;645836,19
-1,-1,8,7268819,8079920,811101,503614;504180;503841;140596;100133251;653423;55894;245910;1673;100131608;245908;100132396;503618;392188;100289462;245909;414325;10407;645836,19
-1,-1,8,7268819,8079920,811101,503614;504180;503841;140596;100133251;653423;55894;245910;1673;100131608;245908;100132396;503618;392188;100289462;245909;414325;10407;645836,19
1,-1,8,7268819,8079920,811101,503614;504180;503841;140596;100133251;653423;55894;245910;1673;100131608;245908;100132396;503618;392188;100289462;245909;414325;10407;645836,19
-1,-1,8,7268819,8079920,811101,503614;504180;503841;140596;100133251;653423;55894;245910;1673;100131608;245908;100132396;503618;392188;100289462;245909;414325;10407;645836,19
-1,-1,8,7268819,8079920,811101,503614;504180;503841;140596;100133251;653423;55894;245910;1673;100131608;245908;100132396;503618;392188;100289462;245909;414325;10407;645836,19
-1,-1,8,7268819,8079920,811101,503614;504180;503841;140596;100133251;653423;55894;245910;1673;100131608;245908;100132396;503618;392188;100289462;245909;414325;10407;645836,19
-1,-1,8,7268819,8079920,811101,503614;504180;503841;140596;100133251;653423;55894;245910;1673;100131608;245908;100132396;503618;392188;100289462;245909;414325;10407;645836,19
-1,-1,8,7268819,8079920,811101,503614;504180;503841;140596;100133251;653423;55894;245910;1673;100131608;245908;100132396;503618;392188;100289462;245909;414325;10407;645836,19
-1,-1,8,7268819,8079920,811101,503614;504180;503841;140596;100133251;653423;55894;245910;1673;100131608;245908;100132396;503618;392188;100289462;245909;414325;10407;645836,19
-1,-1,8,7268819,8079920,811101,503614;504180;503841;140596;100133251;653423;55894;245910;1673;100131608;245908;100132396;503618;392188;100289462;245909;414325;10407;645836,19
-1,-1,8,7268819,8079920,811101,503614;504180;503841;140596;100133251;653423;55894;245910;1673;100131608;245908;100132396;503618;392188;100289462;245909;414325;10407;645836,19
-1,-1,8,7268819,8079920,811101,503614;504180;503841;140596;100133251;653423;55894;245910;1673;100131608;245908;100132396;503618;392188;100289462;245909;414325;10407;645836,19
-1,-1,8,7268819,8079920,811101,503614;504180;503841;140596;100133251;653423;55894;245910;1673;100131608;245908;100132396;503618;392188;100289462;245909;414325;10407;645836,19
-1,-1,8,7268819,8079920,811101,503614;504180;503841;140596;100133251;653423;55894;245910;1673;100131608;245908;100132396;503618;392188;100289462;245909;414325;10407;645836,19
-1,-1,8,7268819,8079920,811101,503614;504180;503841;140596;100133251;653423;55894;245910;1673;100131608;245908;100132396;503618;392188;100289462;245909;414325;10407;645836,19
1,-1,8,7268819,8079920,811101,503614;504180;503841;140596;100133251;653423;55894;245910;1673;100131608;245908;100132396;503618;392188;100289462;245909;414325;10407;645836,19
1,-1,8,7268819,8079920,811101,503614;504180;503841;140596;100133251;653423;55894;245910;1673;100131608;245908;100132396;503618;392188;100289462;245909;414325;10407;645836,19
1,-1,8,7268819,8079920,811101,503614;504180;503841;140596;100133251;653423;55894;245910;1673;100131608;245908;100132396;503618;392188;100289462;245909;414325;10407;645836,19
-1,-1,8,7268819,8079920,811101,503614;504180;503841;140596;100133251;653423;55894;245910;1673;100131608;245908;100132396;503618;392188;100289462;245909;414325;10407;645836,19
-1,-1,8,7268819,8079920,811101,503614;504180;503841;140596;100133251;653423;55894;245910;1673;100131608;245908;100132396;503618;392188;100289462;245909;414325;10407;645836,19
-1,-1,8,7268819,8079920,811101,503614;504180;503841;140596;100133251;653423;55894;245910;1673;100131608;245908;100132396;503618;392188;100289462;245909;414325;10407;645836,19
1,-1,8,7268819,8079920,811101,503614;504180;503841;140596;100133251;653423;55894;245910;1673;100131608;245908;100132396;503618;392188;100289462;245909;414325;10407;645836,19
1,-1,8,7268819,8079920,811101,503614;504180;503841;140596;100133251;653423;55894;245910;1673;100131608;245908;100132396;503618;392188;100289462;245909;414325;10407;645836,19
-1,-1,8,7268819,8079920,811101,503614;504180;503841;140596;100133251;653423;55894;245910;1673;100131608;245908;100132396;503618;392188;100289462;245909;414325;10407;645836,19
-1,-1,8,7268819,8079920,811101,503614;504180;503841;140596;100133251;653423;55894;245910;1673;100131608;245908;100132396;503618;392188;100289462;245909;414325;10407;645836,19
-1,-1,8,7268819,8079920,811101,503614;504180;503841;140596;100133251;653423;55894;245910;1673;100131608;245908;100132396;503618;392188;100289462;245909;414325;10407;645836,19
-1,-1,8,7268819,8079920,811101,503614;504180;503841;140596;100133251;653423;55894;245910;1673;100131608;245908;100132396;503618;392188;100289462;245909;414325;10407;645836,19
-1,-1,8,7268819,8079920,811101,503614;504180;503841;140596;100133251;653423;55894;245910;1673;100131608;245908;100132396;503618;392188;100289462;245909;414325;10407;645836,19
-1,-1,8,7268819,8079920,811101,503614;504180;503841;140596;100133251;653423;55894;245910;1673;100131608;245908;100132396;503618;392188;100289462;245909;414325;10407;645836,19
1,-1,8,7268819,8079920,811101,503614;504180;503841;140596;100133251;653423;55894;245910;1673;100131608;245908;100132396;503618;392188;100289462;245909;414325;10407;645836,19
-1,-1,8,7268819,8079920,811101,503614;504180;503841;140596;100133251;653423;55894;245910;1673;100131608;245908;100132396;503618;392188;100289462;245909;414325;10407;645836,19
-1,-1,8,7268819,8079920,811101,503614;504180;503841;140596;100133251;653423;55894;245910;1673;100131608;245908;100132396;503618;392188;100289462;245909;414325;10407;645836,19
1,-1,8,7268819,8079920,811101,503614;504180;503841;140596;100133251;653423;55894;245910;1673;100131608;245908;100132396;503618;392188;100289462;245909;414325;10407;645836,19
-1,-1,8,7268819,8079920,811101,503614;504180;503841;140596;100133251;653423;55894;245910;1673;100131608;245908;100132396;503618;392188;100289462;245909;414325;10407;645836,19
-1,-1,8,7268819,8079920,811101,503614;504180;503841;140596;100133251;653423;55894;245910;1673;100131608;245908;100132396;503618;392188;100289462;245909;414325;10407;645836,19
-1,-1,8,7268819,8079920,811101,503614;504180;503841;140596;100133251;653423;55894;245910;1673;100131608;245908;100132396;503618;392188;100289462;245909;414325;10407;645836,19
1,-1,8,7268819,8079920,811101,503614;504180;503841;140596;100133251;653423;55894;245910;1673;100131608;245908;100132396;503618;392188;100289462;245909;414325;10407;645836,19
1,-1,8,7268819,8079920,811101,503614;504180;503841;140596;100133251;653423;55894;245910;1673;100131608;245908;100132396;503618;392188;100289462;245909;414325;10407;645836,19
1,-1,8,7268819,8079920,811101,503614;504180;503841;140596;100133251;653423;55894;245910;1673;100131608;245908;100132396;503618;392188;100289462;245909;414325;10407;645836,19
-1,-1,8,7268819,8079920,811101,503614;504180;503841;140596;100133251;653423;55894;245910;1673;100131608;245908;100132396;503618;392188;100289462;245909;414325;10407;645836,19
-1,-1,8,7268819,8079920,811101,503614;504180;503841;140596;100133251;653423;55894;245910;1673;100131608;245908;100132396;503618;392188;100289462;245909;414325;10407;645836,19
1,-1,8,7268819,8079920,811101,503614;504180;503841;140596;100133251;653423;55894;245910;1673;100131608;245908;100132396;503618;392188;100289462;245909;414325;10407;645836,19
-1,-1,8,7268819,8079920,811101,503614;504180;503841;140596;100133251;653423;55894;245910;1673;100131608;245908;100132396;503618;392188;100289462;245909;414325;10407;645836,19
-1,-1,8,7268819,8079920,811101,503614;504180;503841;140596;100133251;653423;55894;245910;1673;100131608;245908;100132396;503618;392188;100289462;245909;414325;10407;645836,19
-1,-1,8,7268819,8079920,811101,503614;504180;503841;140596;100133251;653423;55894;245910;1673;100131608;245908;100132396;503618;392188;100289462;245909;414325;10407;645836,19
-1,-1,8,7268819,8079920,811101,503614;504180;503841;140596;100133251;653423;55894;245910;1673;100131608;245908;100132396;503618;392188;100289462;245909;414325;10407;645836,19
1,-1,8,7268819,8079920,811101,503614;504180;503841;140596;100133251;653423;55894;245910;1673;100131608;245908;100132396;503618;392188;100289462;245909;414325;10407;645836,19
1,-1,8,7268819,8079920,811101,503614;504180;503841;140596;100133251;653423;55894;245910;1673;100131608;245908;100132396;503618;392188;100289462;245909;414325;10407;645836,19
-1,-1,8,7268819,8079920,811101,503614;504180;503841;140596;100133251;653423;55894;245910;1673;100131608;245908;100132396;503618;392188;100289462;245909;414325;10407;645836,19
1,-1,8,7268819,8079920,811101,503614;504180;503841;140596;100133251;653423;55894;245910;1673;100131608;245908;100132396;503618;392188;100289462;245909;414325;10407;645836,19
1,-1,8,7268819,8079920,811101,503614;504180;503841;140596;100133251;653423;55894;245910;1673;100131608;245908;100132396;503618;392188;100289462;245909;414325;10407;645836,19
-1,-1,8,7268819,8079920,811101,503614;504180;503841;140596;100133251;653423;55894;245910;1673;100131608;245908;100132396;503618;392188;100289462;245909;414325;10407;645836,19
-1,-1,8,7268819,8079920,811101,503614;504180;503841;140596;100133251;653423;55894;245910;1673;100131608;245908;100132396;503618;392188;100289462;245909;414325;10407;645836,19
-1,-1,8,7268819,8079920,811101,503614;504180;503841;140596;100133251;653423;55894;245910;1673;100131608;245908;100132396;503618;392188;100289462;245909;414325;10407;645836,19
-1,-1,8,7268819,8079920,811101,503614;504180;503841;140596;100133251;653423;55894;245910;1673;100131608;245908;100132396;503618;392188;100289462;245909;414325;10407;645836,19
-1,-1,8,7268819,8079920,811101,503614;504180;503841;140596;100133251;653423;55894;245910;1673;100131608;245908;100132396;503618;392188;100289462;245909;414325;10407;645836,19
-1,-1,8,7268819,8079920,811101,503614;504180;503841;140596;100133251;653423;55894;245910;1673;100131608;245908;100132396;503618;392188;100289462;245909;414325;10407;645836,19
-1,-1,8,7268819,8079920,811101,503614;504180;503841;140596;100133251;653423;55894;245910;1673;100131608;245908;100132396;503618;392188;100289462;245909;414325;10407;645836,19
-1,-1,8,7268819,8079920,811101,503614;504180;503841;140596;100133251;653423;55894;245910;1673;100131608;245908;100132396;503618;392188;100289462;245909;414325;10407;645836,19
-1,-1,8,7268819,8079920,811101,503614;504180;503841;140596;100133251;653423;55894;245910;1673;100131608;245908;100132396;503618;392188;100289462;245909;414325;10407;645836,19
-1,-1,8,7268819,8079920,811101,503614;504180;503841;140596;100133251;653423;55894;245910;1673;100131608;245908;100132396;503618;392188;100289462;245909;414325;10407;645836,19
-1,-1,8,7268819,8079920,811101,503614;504180;503841;140596;100133251;653423;55894;245910;1673;100131608;245908;100132396;503618;392188;100289462;245909;414325;10407;645836,19
1,-1,8,7268819,8079920,811101,503614;504180;503841;140596;100133251;653423;55894;245910;1673;100131608;245908;100132396;503618;392188;100289462;245909;414325;10407;645836,19
-1,-1,8,7268819,8079920,811101,503614;504180;503841;140596;100133251;653423;55894;245910;1673;100131608;245908;100132396;503618;392188;100289462;245909;414325;10407;645836,19
-1,-1,8,7268819,8079920,811101,503614;504180;503841;140596;100133251;653423;55894;245910;1673;100131608;245908;100132396;503618;392188;100289462;245909;414325;10407;645836,19
-1,-1,8,7268819,8079920,811101,503614;504180;503841;140596;100133251;653423;55894;245910;1673;100131608;245908;100132396;503618;392188;100289462;245909;414325;10407;645836,19
-1,-1,8,7268819,8079920,811101,503614;504180;503841;140596;100133251;653423;55894;245910;1673;100131608;245908;100132396;503618;392188;100289462;245909;414325;10407;645836,19
-1,-1,8,7268819,8079920,811101,503614;504180;503841;140596;100133251;653423;55894;245910;1673;100131608;245908;100132396;503618;392188;100289462;245909;414325;10407;645836,19
1,-1,8,7268819,8079920,811101,503614;504180;503841;140596;100133251;653423;55894;245910;1673;100131608;245908;100132396;503618;392188;100289462;245909;414325;10407;645836,19
1,-1,8,7268819,8079920,811101,503614;504180;503841;140596;100133251;653423;55894;245910;1673;100131608;245908;100132396;503618;392188;100289462;245909;414325;10407;645836,19
-1,-1,8,7268819,8079920,811101,503614;504180;503841;140596;100133251;653423;55894;245910;1673;100131608;245908;100132396;503618;392188;100289462;245909;414325;10407;645836,19
-1,-1,8,7268819,8079920,811101,503614;504180;503841;140596;100133251;653423;55894;245910;1673;100131608;245908;100132396;503618;392188;100289462;245909;414325;10407;645836,19
1,-1,8,7268819,8079920,811101,503614;504180;503841;140596;100133251;653423;55894;245910;1673;100131608;245908;100132396;503618;392188;100289462;245909;414325;10407;645836,19
-1,-1,8,7268819,8079920,811101,503614;504180;503841;140596;100133251;653423;55894;245910;1673;100131608;245908;100132396;503618;392188;100289462;245909;414325;10407;645836,19
-1,-1,8,7268819,8079920,811101,503614;504180;503841;140596;100133251;653423;55894;245910;1673;100131608;245908;100132396;503618;392188;100289462;245909;414325;10407;645836,19
-1,-1,8,7268819,8079920,811101,503614;504180;503841;140596;100133251;653423;55894;245910;1673;100131608;245908;100132396;503618;392188;100289462;245909;414325;10407;645836,19
-1,-1,8,7268819,8079920,811101,503614;504180;503841;140596;100133251;653423;55894;245910;1673;100131608;245908;100132396;503618;392188;100289462;245909;414325;10407;645836,19
1,-1,8,7268819,8079920,811101,503614;504180;503841;140596;100133251;653423;55894;245910;1673;100131608;245908;100132396;503618;392188;100289462;245909;414325;10407;645836,19
-1,-1,8,7268819,8079920,811101,503614;504180;503841;140596;100133251;653423;55894;245910;1673;100131608;245908;100132396;503618;392188;100289462;245909;414325;10407;645836,19
-1,-1,8,7268819,8079920,811101,503614;504180;503841;140596;100133251;653423;55894;245910;1673;100131608;245908;100132396;503618;392188;100289462;245909;414325;10407;645836,19
-1,-1,8,7268819,8079920,811101,503614;504180;503841;140596;100133251;653423;55894;245910;1673;100131608;245908;100132396;503618;392188;100289462;245909;414325;10407;645836,19
1,-1,8,7268819,8079920,811101,503614;504180;503841;140596;100133251;653423;55894;245910;1673;100131608;245908;100132396;503618;392188;100289462;245909;414325;10407;645836,19
-1,-1,8,7268819,8079920,811101,503614;504180;503841;140596;100133251;653423;55894;245910;1673;100131608;245908;100132396;503618;392188;100289462;245909;414325;10407;645836,19
-1,-1,8,7268819,8079920,811101,503614;504180;503841;140596;100133251;653423;55894;245910;1673;100131608;245908;100132396;503618;392188;100289462;245909;414325;10407;645836,19
-1,-1,8,7268819,8079920,811101,503614;504180;503841;140596;100133251;653423;55894;245910;1673;100131608;245908;100132396;503618;392188;100289462;245909;414325;10407;645836,19
-1,-1,8,7268819,8079920,811101,503614;504180;503841;140596;100133251;653423;55894;245910;1673;100131608;245908;100132396;503618;392188;100289462;245909;414325;10407;645836,19
-1,-1,8,7268819,8079920,811101,503614;504180;503841;140596;100133251;653423;55894;245910;1673;100131608;245908;100132396;503618;392188;100289462;245909;414325;10407;645836,19
-1,-1,8,7268819,8079920,811101,503614;504180;503841;140596;100133251;653423;55894;245910;1673;100131608;245908;100132396;503618;392188;100289462;245909;414325;10407;645836,19
-1,-1,8,7268819,8079920,811101,503614;504180;503841;140596;100133251;653423;55894;245910;1673;100131608;245908;100132396;503618;392188;100289462;245909;414325;10407;645836,19
-1,-1,8,7268819,8079920,811101,503614;504180;503841;140596;100133251;653423;55894;245910;1673;100131608;245908;100132396;503618;392188;100289462;245909;414325;10407;645836,19
-1,-1,8,7268819,8079920,811101,503614;504180;503841;140596;100133251;653423;55894;245910;1673;100131608;245908;100132396;503618;392188;100289462;245909;414325;10407;645836,19
1,-1,8,7268819,8079920,811101,503614;504180;503841;140596;100133251;653423;55894;245910;1673;100131608;245908;100132396;503618;392188;100289462;245909;414325;10407;645836,19
-1,-1,8,7268819,8079920,811101,503614;504180;503841;140596;100133251;653423;55894;245910;1673;100131608;245908;100132396;503618;392188;100289462;245909;414325;10407;645836,19
1,-1,8,7268819,8079920,811101,503614;504180;503841;140596;100133251;653423;55894;245910;1673;100131608;245908;100132396;503618;392188;100289462;245909;414325;10407;645836,19
1,-1,8,7268819,8079920,811101,503614;504180;503841;140596;100133251;653423;55894;245910;1673;100131608;245908;100132396;503618;392188;100289462;245909;414325;10407;645836,19
-1,-1,8,7268819,8079920,811101,503614;504180;503841;140596;100133251;653423;55894;245910;1673;100131608;245908;100132396;503618;392188;100289462;245909;414325;10407;645836,19
-1,-1,8,7268819,8079920,811101,503614;504180;503841;140596;100133251;653423;55894;245910;1673;100131608;245908;100132396;503618;392188;100289462;245909;414325;10407;645836,19
-1,-1,8,7268819,8079920,811101,503614;504180;503841;140596;100133251;653423;55894;245910;1673;100131608;245908;100132396;503618;392188;100289462;245909;414325;10407;645836,19
-1,-1,8,7268819,8079920,811101,503614;504180;503841;140596;100133251;653423;55894;245910;1673;100131608;245908;100132396;503618;392188;100289462;245909;414325;10407;645836,19
-1,-1,8,7268819,8079920,811101,503614;504180;503841;140596;100133251;653423;55894;245910;1673;100131608;245908;100132396;503618;392188;100289462;245909;414325;10407;645836,19
-1,-1,8,7268819,8079920,811101,503614;504180;503841;140596;100133251;653423;55894;245910;1673;100131608;245908;100132396;503618;392188;100289462;245909;414325;10407;645836,19
1,-1,8,7268819,8079920,811101,503614;504180;503841;140596;100133251;653423;55894;245910;1673;100131608;245908;100132396;503618;392188;100289462;245909;414325;10407;645836,19
1,-1,8,7268819,8079920,811101,503614;504180;503841;140596;100133251;653423;55894;245910;1673;100131608;245908;100132396;503618;392188;100289462;245909;414325;10407;645836,19
-1,-1,8,7268819,8079920,811101,503614;504180;503841;140596;100133251;653423;55894;245910;1673;100131608;245908;100132396;503618;392188;100289462;245909;414325;10407;645836,19
1,-1,8,7268819,8079920,811101,503614;504180;503841;140596;100133251;653423;55894;245910;1673;100131608;245908;100132396;503618;392188;100289462;245909;414325;10407;645836,19
-1,-1,8,7268819,8079920,811101,503614;504180;503841;140596;100133251;653423;55894;245910;1673;100131608;245908;100132396;503618;392188;100289462;245909;414325;10407;645836,19
-1,-1,8,7268819,8079920,811101,503614;504180;503841;140596;100133251;653423;55894;245910;1673;100131608;245908;100132396;503618;392188;100289462;245909;414325;10407;645836,19
-1,-1,8,7268819,8079920,811101,503614;504180;503841;140596;100133251;653423;55894;245910;1673;100131608;245908;100132396;503618;392188;100289462;245909;414325;10407;645836,19
1,-1,8,7268819,8079920,811101,503614;504180;503841;140596;100133251;653423;55894;245910;1673;100131608;245908;100132396;503618;392188;100289462;245909;414325;10407;645836,19
-1,-1,8,7268819,8079920,811101,503614;504180;503841;140596;100133251;653423;55894;245910;1673;100131608;245908;100132396;503618;392188;100289462;245909;414325;10407;645836,19
-1,-1,8,7268819,8079920,811101,503614;504180;503841;140596;100133251;653423;55894;245910;1673;100131608;245908;100132396;503618;392188;100289462;245909;414325;10407;645836,19
-1,-1,8,7268819,8079920,811101,503614;504180;503841;140596;100133251;653423;55894;245910;1673;100131608;245908;100132396;503618;392188;100289462;245909;414325;10407;645836,19
-1,-1,8,7268819,8079920,811101,503614;504180;503841;140596;100133251;653423;55894;245910;1673;100131608;245908;100132396;503618;392188;100289462;245909;414325;10407;645836,19
1,-1,8,7268819,8079920,811101,503614;504180;503841;140596;100133251;653423;55894;245910;1673;100131608;245908;100132396;503618;392188;100289462;245909;414325;10407;645836,19
1,-1,8,7268819,8079920,811101,503614;504180;503841;140596;100133251;653423;55894;245910;1673;100131608;245908;100132396;503618;392188;100289462;245909;414325;10407;645836,19
1,-1,8,7268819,8079920,811101,503614;504180;503841;140596;100133251;653423;55894;245910;1673;100131608;245908;100132396;503618;392188;100289462;245909;414325;10407;645836,19
-1,-1,8,7268819,8079920,811101,503614;504180;503841;140596;100133251;653423;55894;245910;1673;100131608;245908;100132396;503618;392188;100289462;245909;414325;10407;645836,19
1,-1,8,7268819,8079920,811101,503614;504180;503841;140596;100133251;653423;55894;245910;1673;100131608;245908;100132396;503618;392188;100289462;245909;414325;10407;645836,19
-1,-1,8,7268819,8079920,811101,503614;504180;503841;140596;100133251;653423;55894;245910;1673;100131608;245908;100132396;503618;392188;100289462;245909;414325;10407;645836,19
-1,-1,8,7268819,8079920,811101,503614;504180;503841;140596;100133251;653423;55894;245910;1673;100131608;245908;100132396;503618;392188;100289462;245909;414325;10407;645836,19
-1,-1,8,7268819,8079920,811101,503614;504180;503841;140596;100133251;653423;55894;245910;1673;100131608;245908;100132396;503618;392188;100289462;245909;414325;10407;645836,19
-1,-1,8,7268819,8287295,1018476,503614;504180;503841;140596;100133251;653423;55894;245910;1673;157285;100131608;245908;100132396;503618;392188;100289462;245909;414325;10407;645836,20
-1,1,8,7268819,11805960,4537141,1508;83650;504180;503841;203076;83648;55894;245910;157285;252969;245908;100132396;503618;54984;392188;100289462;4482;203074;245909;90459;503614;140596;83595;100133251;653423;2626;137075;1673;100131608;640;66036;286046;79660;2222;8658;9258;414325;94137;10407;645836,40
-1,-1,8,7268825,7752596,483771,503614;504180;503841;140596;100133251;653423;55894;245910;1673;100131608;245908;503618;100289462;245909;414325;10407,16
-1,-1,8,7268825,7752596,483771,503614;504180;503841;140596;100133251;653423;55894;245910;1673;100131608;245908;503618;100289462;245909;414325;10407,16
1,-1,8,7268825,7806227,537402,503614;504180;503841;140596;100133251;653423;55894;245910;1673;100131608;245908;100132396;503618;100289462;245909;414325;10407,17
1,-1,8,7268825,7806227,537402,503614;504180;503841;140596;100133251;653423;55894;245910;1673;100131608;245908;100132396;503618;100289462;245909;414325;10407,17
1,-1,8,7268825,7806227,537402,503614;504180;503841;140596;100133251;653423;55894;245910;1673;100131608;245908;100132396;503618;100289462;245909;414325;10407,17
1,-1,8,7268825,7806227,537402,503614;504180;503841;140596;100133251;653423;55894;245910;1673;100131608;245908;100132396;503618;100289462;245909;414325;10407,17
1,-1,8,7268825,7806227,537402,503614;504180;503841;140596;100133251;653423;55894;245910;1673;100131608;245908;100132396;503618;100289462;245909;414325;10407,17
1,-1,8,7268825,8079912,811087,503614;504180;503841;140596;100133251;653423;55894;245910;1673;100131608;245908;100132396;503618;392188;100289462;245909;414325;10407;645836,19
1,-1,8,7268825,8079912,811087,503614;504180;503841;140596;100133251;653423;55894;245910;1673;100131608;245908;100132396;503618;392188;100289462;245909;414325;10407;645836,19
1,-1,8,7268825,8079912,811087,503614;504180;503841;140596;100133251;653423;55894;245910;1673;100131608;245908;100132396;503618;392188;100289462;245909;414325;10407;645836,19
1,-1,8,7268825,8079912,811087,503614;504180;503841;140596;100133251;653423;55894;245910;1673;100131608;245908;100132396;503618;392188;100289462;245909;414325;10407;645836,19
1,-1,8,7268825,8079912,811087,503614;504180;503841;140596;100133251;653423;55894;245910;1673;100131608;245908;100132396;503618;392188;100289462;245909;414325;10407;645836,19
1,-1,8,7268825,8079912,811087,503614;504180;503841;140596;100133251;653423;55894;245910;1673;100131608;245908;100132396;503618;392188;100289462;245909;414325;10407;645836,19
1,-1,8,7268825,8079912,811087,503614;504180;503841;140596;100133251;653423;55894;245910;1673;100131608;245908;100132396;503618;392188;100289462;245909;414325;10407;645836,19
1,-1,8,7268825,8079912,811087,503614;504180;503841;140596;100133251;653423;55894;245910;1673;100131608;245908;100132396;503618;392188;100289462;245909;414325;10407;645836,19
1,-1,8,7268825,8130631,861806,503614;504180;503841;140596;100133251;653423;55894;245910;1673;100131608;245908;100132396;503618;392188;100289462;245909;414325;10407;645836,19
1,-1,8,7268825,8222024,953199,503614;504180;503841;140596;100133251;653423;55894;245910;1673;157285;100131608;245908;100132396;503618;392188;100289462;245909;414325;10407;645836,20
1,-1,8,7268825,8222024,953199,503614;504180;503841;140596;100133251;653423;55894;245910;1673;157285;100131608;245908;100132396;503618;392188;100289462;245909;414325;10407;645836,20
-1,-1,8,7328610,7659644,331034,100131608;503614;504180;503841;503618;100133251,6
-1,-1,8,7328610,7664406,335796,100131608;503614;504180;503841;503618;100133251,6
-1,-1,8,7328610,7691930,363320,100131608;503614;504180;503841;503618;245908;100133251;245909;245910,9
-1,-1,8,7370178,7752596,382418,100131608;140596;245908;100133251;653423;245909;414325;245910;1673,9
-1,-1,8,7370178,7752596,382418,100131608;140596;245908;100133251;653423;245909;414325;245910;1673,9
-1,-1,8,7370178,7752596,382418,100131608;140596;245908;100133251;653423;245909;414325;245910;1673,9
-1,-1,8,7370178,7806227,436049,100131608;140596;245908;100132396;100133251;653423;245909;414325;245910;1673,10
1,-1,8,7370178,8079912,709734,645836;100131608;140596;245908;100132396;392188;100133251;653423;245909;414325;245910;1673,12
-1,-1,8,7370178,8079912,709734,645836;100131608;140596;245908;100132396;392188;100133251;653423;245909;414325;245910;1673,12
1,-1,8,7370178,8079912,709734,645836;100131608;140596;245908;100132396;392188;100133251;653423;245909;414325;245910;1673,12
-1,-1,8,7371630,7752586,380956,100131608;140596;245908;100133251;653423;245909;414325;245910;1673,9
1,-1,8,7371630,7806229,434599,100131608;140596;245908;100132396;100133251;653423;245909;414325;245910;1673,10
-1,-1,8,7371630,8079920,708290,645836;100131608;140596;245908;100132396;392188;100133251;653423;245909;414325;245910;1673,12
-1,-1,8,7371630,8079920,708290,645836;100131608;140596;245908;100132396;392188;100133251;653423;245909;414325;245910;1673,12
-1,-1,8,7371630,8079920,708290,645836;100131608;140596;245908;100132396;392188;100133251;653423;245909;414325;245910;1673,12
-1,-1,8,7371630,8079920,708290,645836;100131608;140596;245908;100132396;392188;100133251;653423;245909;414325;245910;1673,12
-1,-1,8,7371630,8079920,708290,645836;100131608;140596;245908;100132396;392188;100133251;653423;245909;414325;245910;1673,12
-1,-1,8,7371630,8079920,708290,645836;100131608;140596;245908;100132396;392188;100133251;653423;245909;414325;245910;1673,12
-1,-1,8,7371630,8079920,708290,645836;100131608;140596;245908;100132396;392188;100133251;653423;245909;414325;245910;1673,12
-1,-1,8,7371630,8079920,708290,645836;100131608;140596;245908;100132396;392188;100133251;653423;245909;414325;245910;1673,12
-1,-1,8,7371630,8079920,708290,645836;100131608;140596;245908;100132396;392188;100133251;653423;245909;414325;245910;1673,12
-1,-1,8,7371630,8079920,708290,645836;100131608;140596;245908;100132396;392188;100133251;653423;245909;414325;245910;1673,12
-1,-1,8,7371630,8079920,708290,645836;100131608;140596;245908;100132396;392188;100133251;653423;245909;414325;245910;1673,12
-1,-1,8,7371630,8079920,708290,645836;100131608;140596;245908;100132396;392188;100133251;653423;245909;414325;245910;1673,12
-1,-1,8,7371630,8079920,708290,645836;100131608;140596;245908;100132396;392188;100133251;653423;245909;414325;245910;1673,12
1,-1,8,7371660,7691931,320271,100131608;245909;245908;245910;100133251,5
1,-1,8,7403596,8079912,676316,645836;140596;245908;100132396;392188;100133251;653423;245909;414325;245910;1673,11
-1,-1,8,7403622,7806229,402607,140596;245908;100132396;100133251;653423;245909;414325;245910;1673,9
-1,-1,8,7403622,8079920,676298,645836;140596;245908;100132396;392188;100133251;653423;245909;414325;245910;1673,11
-1,-1,8,7569294,7891802,322508,645836;140596;245908;100132396;392188;100133251;653423;245909;414325;245910;1673,11
-1,-1,8,7569294,7891802,322508,645836;140596;245908;100132396;392188;100133251;653423;245909;414325;245910;1673,11
-1,-1,8,7569354,7881293,311939,645836;140596;245908;100132396;392188;100133251;653423;245909;414325;245910;1673,11
1,-1,8,7569354,8094774,525420,645836;140596;245908;100132396;392188;100133251;653423;245909;414325;245910;1673,11
-1,-1,8,7572193,7881293,309100,645836;140596;245908;100132396;392188;100133251;653423;245909;414325;245910;1673,11
-1,-1,8,7572193,7881293,309100,645836;140596;245908;100132396;392188;100133251;653423;245909;414325;245910;1673,11
-1,-1,8,7572193,7881293,309100,645836;140596;245908;100132396;392188;100133251;653423;245909;414325;245910;1673,11
-1,-1,8,7572193,7881293,309100,645836;140596;245908;100132396;392188;100133251;653423;245909;414325;245910;1673,11
-1,-1,8,7572193,7881293,309100,645836;140596;245908;100132396;392188;100133251;653423;245909;414325;245910;1673,11
-1,-1,8,7572193,7881293,309100,645836;140596;245908;100132396;392188;100133251;653423;245909;414325;245910;1673,11
-1,-1,8,7572193,7881293,309100,645836;140596;245908;100132396;392188;100133251;653423;245909;414325;245910;1673,11
-1,-1,8,7572193,7881293,309100,645836;140596;245908;100132396;392188;100133251;653423;245909;414325;245910;1673,11
-1,-1,8,7572193,7881293,309100,645836;140596;245908;100132396;392188;100133251;653423;245909;414325;245910;1673,11
-1,-1,8,7572193,7881293,309100,645836;140596;245908;100132396;392188;100133251;653423;245909;414325;245910;1673,11
-1,-1,8,7572193,7881293,309100,645836;140596;245908;100132396;392188;100133251;653423;245909;414325;245910;1673,11
-1,-1,8,7572193,7881293,309100,645836;140596;245908;100132396;392188;100133251;653423;245909;414325;245910;1673,11
-1,-1,8,7572193,7881293,309100,645836;140596;245908;100132396;392188;100133251;653423;245909;414325;245910;1673,11
-1,-1,8,7572193,7881293,309100,645836;140596;245908;100132396;392188;100133251;653423;245909;414325;245910;1673,11
-1,-1,8,7572193,7881293,309100,645836;140596;245908;100132396;392188;100133251;653423;245909;414325;245910;1673,11
-1,-1,8,7572193,7881293,309100,645836;140596;245908;100132396;392188;100133251;653423;245909;414325;245910;1673,11
-1,-1,8,7572193,7881293,309100,645836;140596;245908;100132396;392188;100133251;653423;245909;414325;245910;1673,11
-1,-1,8,7572193,7881293,309100,645836;140596;245908;100132396;392188;100133251;653423;245909;414325;245910;1673,11
-1,-1,8,7572193,7881293,309100,645836;140596;245908;100132396;392188;100133251;653423;245909;414325;245910;1673,11
-1,-1,8,7572193,7881293,309100,645836;140596;245908;100132396;392188;100133251;653423;245909;414325;245910;1673,11
-1,-1,8,7572193,7881293,309100,645836;140596;245908;100132396;392188;100133251;653423;245909;414325;245910;1673,11
-1,-1,8,7572193,7881293,309100,645836;140596;245908;100132396;392188;100133251;653423;245909;414325;245910;1673,11
-1,-1,8,7572193,7881293,309100,645836;140596;245908;100132396;392188;100133251;653423;245909;414325;245910;1673,11
-1,-1,8,7572193,7881293,309100,645836;140596;245908;100132396;392188;100133251;653423;245909;414325;245910;1673,11
-1,-1,8,7572193,7881293,309100,645836;140596;245908;100132396;392188;100133251;653423;245909;414325;245910;1673,11
-1,-1,8,7572193,7881293,309100,645836;140596;245908;100132396;392188;100133251;653423;245909;414325;245910;1673,11
-1,-1,8,7572193,7881293,309100,645836;140596;245908;100132396;392188;100133251;653423;245909;414325;245910;1673,11
-1,-1,8,7572193,7881293,309100,645836;140596;245908;100132396;392188;100133251;653423;245909;414325;245910;1673,11
-1,-1,8,7572193,7881293,309100,645836;140596;245908;100132396;392188;100133251;653423;245909;414325;245910;1673,11
-1,-1,8,7572193,7881293,309100,645836;140596;245908;100132396;392188;100133251;653423;245909;414325;245910;1673,11
-1,-1,8,7572193,7881293,309100,645836;140596;245908;100132396;392188;100133251;653423;245909;414325;245910;1673,11
-1,-1,8,7572193,7881293,309100,645836;140596;245908;100132396;392188;100133251;653423;245909;414325;245910;1673,11
-1,-1,8,7572193,7881293,309100,645836;140596;245908;100132396;392188;100133251;653423;245909;414325;245910;1673,11
-1,-1,8,7572193,7881293,309100,645836;140596;245908;100132396;392188;100133251;653423;245909;414325;245910;1673,11
-1,-1,8,7572193,7881293,309100,645836;140596;245908;100132396;392188;100133251;653423;245909;414325;245910;1673,11
-1,-1,8,7572193,7881293,309100,645836;140596;245908;100132396;392188;100133251;653423;245909;414325;245910;1673,11
-1,-1,8,7572193,7881293,309100,645836;140596;245908;100132396;392188;100133251;653423;245909;414325;245910;1673,11
-1,-1,8,7572193,7881293,309100,645836;140596;245908;100132396;392188;100133251;653423;245909;414325;245910;1673,11
-1,-1,8,7572193,7881293,309100,645836;140596;245908;100132396;392188;100133251;653423;245909;414325;245910;1673,11
-1,-1,8,7572193,7881293,309100,645836;140596;245908;100132396;392188;100133251;653423;245909;414325;245910;1673,11
-1,-1,8,7572193,7881293,309100,645836;140596;245908;100132396;392188;100133251;653423;245909;414325;245910;1673,11
-1,-1,8,7572193,7881293,309100,645836;140596;245908;100132396;392188;100133251;653423;245909;414325;245910;1673,11
-1,-1,8,7572193,7881293,309100,645836;140596;245908;100132396;392188;100133251;653423;245909;414325;245910;1673,11
-1,-1,8,7572193,7881293,309100,645836;140596;245908;100132396;392188;100133251;653423;245909;414325;245910;1673,11
-1,-1,8,7572193,7881293,309100,645836;140596;245908;100132396;392188;100133251;653423;245909;414325;245910;1673,11
-1,-1,8,7572193,7881293,309100,645836;140596;245908;100132396;392188;100133251;653423;245909;414325;245910;1673,11
-1,-1,8,7572193,7881293,309100,645836;140596;245908;100132396;392188;100133251;653423;245909;414325;245910;1673,11
-1,-1,8,7572193,7881293,309100,645836;140596;245908;100132396;392188;100133251;653423;245909;414325;245910;1673,11
-1,-1,8,7572193,7881293,309100,645836;140596;245908;100132396;392188;100133251;653423;245909;414325;245910;1673,11
-1,-1,8,7572193,7881293,309100,645836;140596;245908;100132396;392188;100133251;653423;245909;414325;245910;1673,11
-1,-1,8,7572193,7881293,309100,645836;140596;245908;100132396;392188;100133251;653423;245909;414325;245910;1673,11
-1,-1,8,7572193,7881293,309100,645836;140596;245908;100132396;392188;100133251;653423;245909;414325;245910;1673,11
-1,-1,8,7572193,7881293,309100,645836;140596;245908;100132396;392188;100133251;653423;245909;414325;245910;1673,11
-1,-1,8,7572193,7881293,309100,645836;140596;245908;100132396;392188;100133251;653423;245909;414325;245910;1673,11
-1,-1,8,7572193,7881293,309100,645836;140596;245908;100132396;392188;100133251;653423;245909;414325;245910;1673,11
-1,-1,8,7572193,7881293,309100,645836;140596;245908;100132396;392188;100133251;653423;245909;414325;245910;1673,11
-1,-1,8,7572193,7881293,309100,645836;140596;245908;100132396;392188;100133251;653423;245909;414325;245910;1673,11
-1,-1,8,7572193,7881293,309100,645836;140596;245908;100132396;392188;100133251;653423;245909;414325;245910;1673,11
-1,-1,8,7572193,7881293,309100,645836;140596;245908;100132396;392188;100133251;653423;245909;414325;245910;1673,11
-1,-1,8,7572193,7881293,309100,645836;140596;245908;100132396;392188;100133251;653423;245909;414325;245910;1673,11
-1,-1,8,7572193,7881293,309100,645836;140596;245908;100132396;392188;100133251;653423;245909;414325;245910;1673,11
-1,-1,8,7572193,7881293,309100,645836;140596;245908;100132396;392188;100133251;653423;245909;414325;245910;1673,11
-1,-1,8,7572193,7881293,309100,645836;140596;245908;100132396;392188;100133251;653423;245909;414325;245910;1673,11
-1,-1,8,7572193,7881293,309100,645836;140596;245908;100132396;392188;100133251;653423;245909;414325;245910;1673,11
-1,-1,8,7572193,7881293,309100,645836;140596;245908;100132396;392188;100133251;653423;245909;414325;245910;1673,11
-1,-1,8,7572193,7881293,309100,645836;140596;245908;100132396;392188;100133251;653423;245909;414325;245910;1673,11
-1,-1,8,7572193,7881293,309100,645836;140596;245908;100132396;392188;100133251;653423;245909;414325;245910;1673,11
-1,-1,8,7572193,7881293,309100,645836;140596;245908;100132396;392188;100133251;653423;245909;414325;245910;1673,11
-1,-1,8,7572193,7881293,309100,645836;140596;245908;100132396;392188;100133251;653423;245909;414325;245910;1673,11
-1,-1,8,7572193,7881293,309100,645836;140596;245908;100132396;392188;100133251;653423;245909;414325;245910;1673,11
-1,-1,8,7572193,7881293,309100,645836;140596;245908;100132396;392188;100133251;653423;245909;414325;245910;1673,11
-1,-1,8,7572193,7881293,309100,645836;140596;245908;100132396;392188;100133251;653423;245909;414325;245910;1673,11
-1,-1,8,7572193,7881293,309100,645836;140596;245908;100132396;392188;100133251;653423;245909;414325;245910;1673,11
-1,-1,8,7572193,7881293,309100,645836;140596;245908;100132396;392188;100133251;653423;245909;414325;245910;1673,11
1,-1,8,7572193,8130525,558332,645836;140596;245908;100132396;392188;100133251;653423;245909;414325;245910;1673,11
-1,-1,8,7572195,7618142,45947,,0
-1,-1,8,7572195,7618142,45947,,0
-1,-1,8,7572195,7618142,45947,,0
-1,-1,8,7572195,7618142,45947,,0
1,-1,8,7572195,7618142,45947,,0
1,-1,8,7572195,7618142,45947,,0
-1,-1,8,7579841,7806222,226381,140596;245908;100132396;100133251;653423;245909;414325;245910;1673,9
-1,-1,8,7579841,7806222,226381,140596;245908;100132396;100133251;653423;245909;414325;245910;1673,9
-1,-1,8,7579841,7806222,226381,140596;245908;100132396;100133251;653423;245909;414325;245910;1673,9
-1,-1,8,7579841,7806222,226381,140596;245908;100132396;100133251;653423;245909;414325;245910;1673,9
-1,-1,8,7579841,7806222,226381,140596;245908;100132396;100133251;653423;245909;414325;245910;1673,9
-1,-1,8,7579841,7867163,287322,645836;140596;245908;100132396;392188;100133251;653423;245909;414325;245910;1673,11
-1,-1,8,7579841,7881293,301452,645836;140596;245908;100132396;392188;100133251;653423;245909;414325;245910;1673,11
-1,-1,8,7579841,7881293,301452,645836;140596;245908;100132396;392188;100133251;653423;245909;414325;245910;1673,11
-1,-1,8,7579841,7881293,301452,645836;140596;245908;100132396;392188;100133251;653423;245909;414325;245910;1673,11
-1,-1,8,7579841,7881293,301452,645836;140596;245908;100132396;392188;100133251;653423;245909;414325;245910;1673,11
-1,-1,8,7579841,7881293,301452,645836;140596;245908;100132396;392188;100133251;653423;245909;414325;245910;1673,11
-1,-1,8,7579841,7881293,301452,645836;140596;245908;100132396;392188;100133251;653423;245909;414325;245910;1673,11
-1,-1,8,7579841,7881293,301452,645836;140596;245908;100132396;392188;100133251;653423;245909;414325;245910;1673,11
-1,-1,8,7579841,7881293,301452,645836;140596;245908;100132396;392188;100133251;653423;245909;414325;245910;1673,11
-1,-1,8,7579841,7881293,301452,645836;140596;245908;100132396;392188;100133251;653423;245909;414325;245910;1673,11
-1,-1,8,7579841,7881293,301452,645836;140596;245908;100132396;392188;100133251;653423;245909;414325;245910;1673,11
-1,-1,8,7579841,7881293,301452,645836;140596;245908;100132396;392188;100133251;653423;245909;414325;245910;1673,11
-1,-1,8,7579841,7881293,301452,645836;140596;245908;100132396;392188;100133251;653423;245909;414325;245910;1673,11
-1,-1,8,7579841,7881293,301452,645836;140596;245908;100132396;392188;100133251;653423;245909;414325;245910;1673,11
-1,-1,8,7579841,7881293,301452,645836;140596;245908;100132396;392188;100133251;653423;245909;414325;245910;1673,11
-1,-1,8,7579841,7881293,301452,645836;140596;245908;100132396;392188;100133251;653423;245909;414325;245910;1673,11
-1,-1,8,7579841,7881293,301452,645836;140596;245908;100132396;392188;100133251;653423;245909;414325;245910;1673,11
-1,-1,8,7579841,7881293,301452,645836;140596;245908;100132396;392188;100133251;653423;245909;414325;245910;1673,11
-1,-1,8,7579841,7881293,301452,645836;140596;245908;100132396;392188;100133251;653423;245909;414325;245910;1673,11
-1,-1,8,7579841,7881293,301452,645836;140596;245908;100132396;392188;100133251;653423;245909;414325;245910;1673,11
-1,-1,8,7579841,7881293,301452,645836;140596;245908;100132396;392188;100133251;653423;245909;414325;245910;1673,11
-1,-1,8,7579841,7881293,301452,645836;140596;245908;100132396;392188;100133251;653423;245909;414325;245910;1673,11
-1,-1,8,7579841,7881293,301452,645836;140596;245908;100132396;392188;100133251;653423;245909;414325;245910;1673,11
-1,-1,8,7579841,7881293,301452,645836;140596;245908;100132396;392188;100133251;653423;245909;414325;245910;1673,11
-1,-1,8,7579841,7881293,301452,645836;140596;245908;100132396;392188;100133251;653423;245909;414325;245910;1673,11
-1,-1,8,7579841,7881293,301452,645836;140596;245908;100132396;392188;100133251;653423;245909;414325;245910;1673,11
-1,-1,8,7579841,7881293,301452,645836;140596;245908;100132396;392188;100133251;653423;245909;414325;245910;1673,11
-1,-1,8,7579841,7881293,301452,645836;140596;245908;100132396;392188;100133251;653423;245909;414325;245910;1673,11
-1,-1,8,7579841,7881293,301452,645836;140596;245908;100132396;392188;100133251;653423;245909;414325;245910;1673,11
-1,-1,8,7579841,7881293,301452,645836;140596;245908;100132396;392188;100133251;653423;245909;414325;245910;1673,11
-1,-1,8,7579841,7881293,301452,645836;140596;245908;100132396;392188;100133251;653423;245909;414325;245910;1673,11
-1,-1,8,7579841,7881293,301452,645836;140596;245908;100132396;392188;100133251;653423;245909;414325;245910;1673,11
-1,-1,8,7579841,7881293,301452,645836;140596;245908;100132396;392188;100133251;653423;245909;414325;245910;1673,11
-1,-1,8,7579841,7881293,301452,645836;140596;245908;100132396;392188;100133251;653423;245909;414325;245910;1673,11
-1,-1,8,7579841,7881293,301452,645836;140596;245908;100132396;392188;100133251;653423;245909;414325;245910;1673,11
-1,-1,8,7579816,7618142,38326,,0
1,-1,8,7579816,7618142,38326,,0
-1,-1,8,7579816,7752596,172780,140596;245908;100133251;653423;245909;414325;245910;1673,8
1,-1,8,7579816,7752596,172780,140596;245908;100133251;653423;245909;414325;245910;1673,8
-1,-1,8,7595137,7806222,211085,140596;245908;100132396;100133251;653423;245909;414325;245910;1673,9
-1,-1,8,7632386,7838942,206556,645836;140596;245908;100132396;392188;100133251;653423;245909;414325;245910;1673,11
-1,-1,8,7632386,7838942,206556,645836;140596;245908;100132396;392188;100133251;653423;245909;414325;245910;1673,11
-1,-1,8,7632386,7838942,206556,645836;140596;245908;100132396;392188;100133251;653423;245909;414325;245910;1673,11
-1,-1,8,7632386,7838942,206556,645836;140596;245908;100132396;392188;100133251;653423;245909;414325;245910;1673,11
-1,-1,8,7632386,7838942,206556,645836;140596;245908;100132396;392188;100133251;653423;245909;414325;245910;1673,11
-1,-1,8,7632386,7838942,206556,645836;140596;245908;100132396;392188;100133251;653423;245909;414325;245910;1673,11
-1,-1,8,7632386,7838942,206556,645836;140596;245908;100132396;392188;100133251;653423;245909;414325;245910;1673,11
-1,-1,8,7632386,7838942,206556,645836;140596;245908;100132396;392188;100133251;653423;245909;414325;245910;1673,11
-1,-1,8,7632386,7838942,206556,645836;140596;245908;100132396;392188;100133251;653423;245909;414325;245910;1673,11
-1,-1,8,7632386,7838942,206556,645836;140596;245908;100132396;392188;100133251;653423;245909;414325;245910;1673,11
-1,-1,8,7632386,7838942,206556,645836;140596;245908;100132396;392188;100133251;653423;245909;414325;245910;1673,11
-1,-1,8,7632386,7838942,206556,645836;140596;245908;100132396;392188;100133251;653423;245909;414325;245910;1673,11
-1,-1,8,7632386,7867163,234777,645836;140596;245908;100132396;392188;100133251;653423;245909;414325;245910;1673,11
1,1,8,7691901,12039974,4348073,392197;377630;1508;83650;203076;83648;613209;157285;252969;100132396;54984;392188;613211;4482;203074;90459;140596;83595;100133267;653423;85002;2626;613210;137075;1673;728957;640;66036;286046;79660;2222;8658;9258;414325;94137;645836,36
-1,1,8,7881293,11886164,4004871,1508;83650;83595;203076;2626;83648;613210;137075;613209;157285;640;66036;252969;286046;79660;2222;54984;613211;4482;8658;203074;9258;90459;94137,24
-1,1,8,8079861,11841842,3761981,1508;83650;83595;203076;2626;83648;613210;137075;613209;157285;640;66036;252969;286046;79660;2222;54984;4482;8658;203074;9258;90459;94137,23
-1,1,8,8079861,12039974,3960113,392197;377630;1508;83650;83595;100133267;85002;203076;2626;83648;613210;137075;613209;157285;728957;640;66036;252969;286046;79660;2222;54984;613211;4482;8658;203074;9258;90459;94137,29
1,1,8,8093066,11945856,3852790,1508;83650;83595;100133267;203076;2626;83648;613210;137075;613209;157285;640;66036;252969;286046;79660;2222;54984;613211;4482;8658;203074;9258;90459;94137,25
1,1,8,8093066,11945856,3852790,1508;83650;83595;100133267;203076;2626;83648;613210;137075;613209;157285;640;66036;252969;286046;79660;2222;54984;613211;4482;8658;203074;9258;90459;94137,25
1,1,8,8093066,11945856,3852790,1508;83650;83595;100133267;203076;2626;83648;613210;137075;613209;157285;640;66036;252969;286046;79660;2222;54984;613211;4482;8658;203074;9258;90459;94137,25
1,1,8,8093066,11945856,3852790,1508;83650;83595;100133267;203076;2626;83648;613210;137075;613209;157285;640;66036;252969;286046;79660;2222;54984;613211;4482;8658;203074;9258;90459;94137,25
1,1,8,8093066,11945856,3852790,1508;83650;83595;100133267;203076;2626;83648;613210;137075;613209;157285;640;66036;252969;286046;79660;2222;54984;613211;4482;8658;203074;9258;90459;94137,25
1,1,8,8093066,11945856,3852790,1508;83650;83595;100133267;203076;2626;83648;613210;137075;613209;157285;640;66036;252969;286046;79660;2222;54984;613211;4482;8658;203074;9258;90459;94137,25
1,1,8,8093169,11845219,3752050,1508;83650;83595;203076;2626;83648;613210;137075;613209;157285;640;66036;252969;286046;79660;2222;54984;4482;8658;203074;9258;90459;94137,23
-1,1,8,8093169,11881742,3788573,1508;83650;83595;203076;2626;83648;613210;137075;613209;157285;640;66036;252969;286046;79660;2222;54984;613211;4482;8658;203074;9258;90459;94137,24
-1,1,8,8093169,11888779,3795610,1508;83650;83595;203076;2626;83648;613210;137075;613209;157285;640;66036;252969;286046;79660;2222;54984;613211;4482;8658;203074;9258;90459;94137,24
-1,1,8,8093169,11895232,3802063,1508;83650;83595;203076;2626;83648;613210;137075;613209;157285;640;66036;252969;286046;79660;2222;54984;613211;4482;8658;203074;9258;90459;94137,24
-1,1,8,8093169,11935465,3842296,1508;83650;83595;100133267;203076;2626;83648;613210;137075;613209;157285;640;66036;252969;286046;79660;2222;54984;613211;4482;8658;203074;9258;90459;94137,25
-1,1,8,8111027,11280142,3169115,83650;83595;203076;83648;137075;157285;66036;286046;79660;54984;4482;8658;9258;203074;90459;94137,16
-1,1,8,8111027,11860569,3749542,1508;83650;83595;203076;2626;83648;613210;137075;613209;157285;640;66036;252969;286046;79660;2222;54984;613211;4482;8658;203074;9258;90459;94137,24
-1,1,8,8111027,12467543,4356516,392197;377630;1508;83650;245940;83595;100133267;85002;203076;2626;83648;613210;137075;613209;157285;728957;640;66036;252969;286046;79660;2222;54984;613211;4482;8658;203074;9258;90459;653333;94137,31
-1,1,8,8130630,9544529,1413899,9258;157285;90459;79660;137075;8658,6
-1,1,8,8130630,11805960,3675330,1508;83650;83595;203076;2626;83648;137075;157285;640;66036;252969;286046;79660;2222;54984;4482;8658;203074;9258;90459;94137,21
-1,1,8,8130630,11805960,3675330,1508;83650;83595;203076;2626;83648;137075;157285;640;66036;252969;286046;79660;2222;54984;4482;8658;203074;9258;90459;94137,21
-1,1,8,8130630,12241152,4110522,392197;377630;1508;83650;245940;83595;100133267;85002;203076;2626;83648;613210;137075;613209;157285;728957;640;66036;252969;286046;79660;2222;54984;613211;4482;8658;203074;9258;90459;94137,30
1,1,8,8130630,12404062,4273432,392197;377630;1508;83650;245940;83595;100133267;85002;203076;2626;83648;613210;137075;613209;157285;728957;640;66036;252969;286046;79660;2222;54984;613211;4482;8658;203074;9258;90459;653333;94137,31
-1,1,8,8130630,12467543,4336913,392197;377630;1508;83650;245940;83595;100133267;85002;203076;2626;83648;613210;137075;613209;157285;728957;640;66036;252969;286046;79660;2222;54984;613211;4482;8658;203074;9258;90459;653333;94137,31
-1,-1,8,8145191,8175312,30121,157285,1
-1,1,8,8403353,11671979,3268626,83650;83595;203076;2626;83648;137075;640;66036;252969;286046;79660;2222;54984;4482;8658;203074;9258;90459;94137,19
-1,-1,8,8569504,8621658,52154,,0
1,1,8,8621688,10921074,2299386,286046;79660;83595;54984;4482;8658;9258;203074;203076;90459;94137,11
-1,-1,8,8952910,8982291,29381,,0
-1,-1,8,9038508,9112322,73814,,0
-1,-1,8,9043929,9112322,68393,,0
-1,1,8,9313740,10871128,1557388,286046;83595;54984;4482;8658;203074;203076;94137,8
1,1,8,11298481,11841842,543361,1508;640;252969;2222;2626;83648;613210;613209,8
1,-1,8,11391786,11419616,27830,640,1
-1,1,8,11596744,11660943,64199,2222;2626;252969,3
-1,1,8,11608214,11683083,74869,2222;2626;252969,3
-1,-1,8,11660943,11860171,199228,1508;2222;613210;613211;613209,5
1,1,8,11708622,37073851,25365229,377630;1508;2053;55806;8756;54793;286097;389643;619373;10671;51669;7976;4747;1960;2137;6570;1135;55246;5533;541565;51312;57509;613210;56154;157855;11030;2267;137868;23484;11178;4481;80005;63898;427;1191;55756;55872;79618;613209;81551;2961;5157;64641;23516;148;84549;5108;6781;5368;64236;100133267;10395;85002;51435;6440;2936;91694;2185;9108;137970;4023;1846;4017;728957;8793;29883;84750;661;2039;55174;7991;157313;9;79845;29942;7993;157574;9796;7486;203069;2675;157310;23221;55790;5516;5520;26281;137492;23087;10174;8795;51201;55124;23362;8797;4824;8794;157773;392197;55909;80346;9583;245940;286133;649;10361;57805;91782;2796;80185;10;78986;27299;10863;613211;10687;157570;55140;665;4741;9046;23039;79873;137814;55893;23303;526;203190;100507341;57604;3084;6542;8822;653333;1808;64760,136
-1,-1,8,11758865,12467543,708678,392197;377630;728957;100133267;245940;613211;85002;653333;613210;613209,10
-1,-1,8,11758865,12467543,708678,392197;377630;728957;100133267;245940;613211;85002;653333;613210;613209,10
1,-1,8,11805761,12404066,598305,392197;377630;728957;100133267;245940;613211;85002;653333;613210;613209,10
1,-1,8,11860379,12522676,662297,392197;377630;728957;85002;653333;100133267;245940,7
1,-1,8,11860379,12522676,662297,392197;377630;728957;85002;653333;100133267;245940,7
1,-1,8,11860379,12522676,662297,392197;377630;728957;85002;653333;100133267;245940,7
1,-1,8,11860379,12522676,662297,392197;377630;728957;85002;653333;100133267;245940,7
1,-1,8,11860379,12555985,695606,392197;377630;728957;85002;653333;100133267;245940,7
1,-1,8,11860379,12555985,695606,392197;377630;728957;85002;653333;100133267;245940,7
1,-1,8,11860379,12555985,695606,392197;377630;728957;85002;653333;100133267;245940,7
1,-1,8,11860379,12555985,695606,392197;377630;728957;85002;653333;100133267;245940,7
1,-1,8,11860379,12555985,695606,392197;377630;728957;85002;653333;100133267;245940,7
1,-1,8,11860379,12555985,695606,392197;377630;728957;85002;653333;100133267;245940,7
1,-1,8,11860379,12555985,695606,392197;377630;728957;85002;653333;100133267;245940,7
1,-1,8,11860379,12585330,724951,392197;377630;728957;100133267;245940;85002;653333;91694,8
1,-1,8,11860379,12585330,724951,392197;377630;728957;100133267;245940;85002;653333;91694,8
1,-1,8,11886223,12454045,567822,392197;377630;728957;85002;653333;100133267;245940,7
1,-1,8,11886223,12465238,579015,392197;377630;728957;85002;653333;100133267;245940,7
1,-1,8,11886223,12522676,636453,392197;377630;728957;85002;653333;100133267;245940,7
1,-1,8,11886223,12522676,636453,392197;377630;728957;85002;653333;100133267;245940,7
1,-1,8,11906296,12465238,558942,392197;377630;728957;85002;653333;100133267;245940,7
1,-1,8,11906296,12522676,616380,392197;377630;728957;85002;653333;100133267;245940,7
1,-1,8,11906296,12522676,616380,392197;377630;728957;85002;653333;100133267;245940,7
1,-1,8,11906296,12522676,616380,392197;377630;728957;85002;653333;100133267;245940,7
1,-1,8,11906296,12555985,649689,392197;377630;728957;85002;653333;100133267;245940,7
1,-1,8,11906296,12555985,649689,392197;377630;728957;85002;653333;100133267;245940,7
1,-1,8,11906296,12555985,649689,392197;377630;728957;85002;653333;100133267;245940,7
1,-1,8,11906296,12555985,649689,392197;377630;728957;85002;653333;100133267;245940,7
1,-1,8,11907792,12467484,559692,392197;377630;728957;85002;653333;100133267;245940,7
1,-1,8,11907792,12467484,559692,392197;377630;728957;85002;653333;100133267;245940,7
1,-1,8,11907792,12467484,559692,392197;377630;728957;85002;653333;100133267;245940,7
1,-1,8,11907792,12490843,583051,392197;377630;728957;85002;653333;100133267;245940,7
1,-1,8,11907792,12522676,614884,392197;377630;728957;85002;653333;100133267;245940,7
1,-1,8,11907792,12522676,614884,392197;377630;728957;85002;653333;100133267;245940,7
1,-1,8,11907792,12522676,614884,392197;377630;728957;85002;653333;100133267;245940,7
1,-1,8,11907792,12522676,614884,392197;377630;728957;85002;653333;100133267;245940,7
1,-1,8,11907792,12522676,614884,392197;377630;728957;85002;653333;100133267;245940,7
1,-1,8,11907792,12522676,614884,392197;377630;728957;85002;653333;100133267;245940,7
1,-1,8,11907792,12555985,648193,392197;377630;728957;85002;653333;100133267;245940,7
1,-1,8,11925007,12465238,540231,392197;377630;728957;85002;653333;100133267;245940,7
1,-1,8,11925007,12465238,540231,392197;377630;728957;85002;653333;100133267;245940,7
1,-1,8,11925007,12465238,540231,392197;377630;728957;85002;653333;100133267;245940,7
1,-1,8,11925007,12465238,540231,392197;377630;728957;85002;653333;100133267;245940,7
1,-1,8,11925007,12465238,540231,392197;377630;728957;85002;653333;100133267;245940,7
1,-1,8,11925007,12465238,540231,392197;377630;728957;85002;653333;100133267;245940,7
1,-1,8,11925007,12465238,540231,392197;377630;728957;85002;653333;100133267;245940,7
1,-1,8,11925007,12465238,540231,392197;377630;728957;85002;653333;100133267;245940,7
1,-1,8,11925007,12465238,540231,392197;377630;728957;85002;653333;100133267;245940,7
1,-1,8,11925007,12465238,540231,392197;377630;728957;85002;653333;100133267;245940,7
1,-1,8,11925007,12465238,540231,392197;377630;728957;85002;653333;100133267;245940,7
1,-1,8,11925007,12467484,542477,392197;377630;728957;85002;653333;100133267;245940,7
1,-1,8,11925007,12467484,542477,392197;377630;728957;85002;653333;100133267;245940,7
1,-1,8,11925007,12467484,542477,392197;377630;728957;85002;653333;100133267;245940,7
1,-1,8,11925007,12522676,597669,392197;377630;728957;85002;653333;100133267;245940,7
1,-1,8,11925007,12522676,597669,392197;377630;728957;85002;653333;100133267;245940,7
1,-1,8,11925007,12522676,597669,392197;377630;728957;85002;653333;100133267;245940,7
1,-1,8,11925007,12522676,597669,392197;377630;728957;85002;653333;100133267;245940,7
1,-1,8,11925007,12522676,597669,392197;377630;728957;85002;653333;100133267;245940,7
1,-1,8,11925007,12522676,597669,392197;377630;728957;85002;653333;100133267;245940,7
1,-1,8,11925007,12522676,597669,392197;377630;728957;85002;653333;100133267;245940,7
1,-1,8,11925007,12522676,597669,392197;377630;728957;85002;653333;100133267;245940,7
1,-1,8,11925007,12522676,597669,392197;377630;728957;85002;653333;100133267;245940,7
1,-1,8,11925007,12522676,597669,392197;377630;728957;85002;653333;100133267;245940,7
1,-1,8,11925007,12522676,597669,392197;377630;728957;85002;653333;100133267;245940,7
1,-1,8,11925007,12522676,597669,392197;377630;728957;85002;653333;100133267;245940,7
1,-1,8,11925007,12522676,597669,392197;377630;728957;85002;653333;100133267;245940,7
1,-1,8,11925007,12522676,597669,392197;377630;728957;85002;653333;100133267;245940,7
1,-1,8,11925007,12522676,597669,392197;377630;728957;85002;653333;100133267;245940,7
1,-1,8,11925007,12522676,597669,392197;377630;728957;85002;653333;100133267;245940,7
1,-1,8,11925007,12522676,597669,392197;377630;728957;85002;653333;100133267;245940,7
1,-1,8,11925007,12522676,597669,392197;377630;728957;85002;653333;100133267;245940,7
1,-1,8,11925007,12522676,597669,392197;377630;728957;85002;653333;100133267;245940,7
1,-1,8,11925007,12522676,597669,392197;377630;728957;85002;653333;100133267;245940,7
1,-1,8,11925007,12522676,597669,392197;377630;728957;85002;653333;100133267;245940,7
1,-1,8,11925007,12522676,597669,392197;377630;728957;85002;653333;100133267;245940,7
1,-1,8,11925007,12522676,597669,392197;377630;728957;85002;653333;100133267;245940,7
1,-1,8,11925007,12522676,597669,392197;377630;728957;85002;653333;100133267;245940,7
1,-1,8,11925007,12522676,597669,392197;377630;728957;85002;653333;100133267;245940,7
1,-1,8,11925007,12522676,597669,392197;377630;728957;85002;653333;100133267;245940,7
1,-1,8,11925007,12522676,597669,392197;377630;728957;85002;653333;100133267;245940,7
1,-1,8,11925007,12535805,610798,392197;377630;728957;85002;653333;100133267;245940,7
1,-1,8,11925007,12555985,630978,392197;377630;728957;85002;653333;100133267;245940,7
1,-1,8,11925007,12555985,630978,392197;377630;728957;85002;653333;100133267;245940,7
1,-1,8,11925007,12555985,630978,392197;377630;728957;85002;653333;100133267;245940,7
1,-1,8,11925007,12555985,630978,392197;377630;728957;85002;653333;100133267;245940,7
1,-1,8,11925007,12555985,630978,392197;377630;728957;85002;653333;100133267;245940,7
1,-1,8,11925007,12555985,630978,392197;377630;728957;85002;653333;100133267;245940,7
1,-1,8,11925007,12555985,630978,392197;377630;728957;85002;653333;100133267;245940,7
1,-1,8,11925007,12555985,630978,392197;377630;728957;85002;653333;100133267;245940,7
1,-1,8,11925007,12555985,630978,392197;377630;728957;85002;653333;100133267;245940,7
1,-1,8,11925007,12555985,630978,392197;377630;728957;85002;653333;100133267;245940,7
1,-1,8,11925007,12555985,630978,392197;377630;728957;85002;653333;100133267;245940,7
1,-1,8,11925007,12555985,630978,392197;377630;728957;85002;653333;100133267;245940,7
1,-1,8,11925007,12555985,630978,392197;377630;728957;85002;653333;100133267;245940,7
1,-1,8,11925007,12555985,630978,392197;377630;728957;85002;653333;100133267;245940,7
1,-1,8,11925007,12555985,630978,392197;377630;728957;85002;653333;100133267;245940,7
1,-1,8,11925007,12555985,630978,392197;377630;728957;85002;653333;100133267;245940,7
1,-1,8,11925007,12555985,630978,392197;377630;728957;85002;653333;100133267;245940,7
1,-1,8,11925007,12555985,630978,392197;377630;728957;85002;653333;100133267;245940,7
1,-1,8,11925007,12555985,630978,392197;377630;728957;85002;653333;100133267;245940,7
1,-1,8,11925007,12555985,630978,392197;377630;728957;85002;653333;100133267;245940,7
1,-1,8,11925007,12555985,630978,392197;377630;728957;85002;653333;100133267;245940,7
1,-1,8,11925007,12555985,630978,392197;377630;728957;85002;653333;100133267;245940,7
1,-1,8,11925007,12555985,630978,392197;377630;728957;85002;653333;100133267;245940,7
1,-1,8,11925007,12555985,630978,392197;377630;728957;85002;653333;100133267;245940,7
1,-1,8,11925007,12555985,630978,392197;377630;728957;85002;653333;100133267;245940,7
1,-1,8,11925007,12555985,630978,392197;377630;728957;85002;653333;100133267;245940,7
1,-1,8,11925007,12555985,630978,392197;377630;728957;85002;653333;100133267;245940,7
1,-1,8,11925007,12555985,630978,392197;377630;728957;85002;653333;100133267;245940,7
1,-1,8,11925007,12555985,630978,392197;377630;728957;85002;653333;100133267;245940,7
1,-1,8,11925007,12555985,630978,392197;377630;728957;85002;653333;100133267;245940,7
1,-1,8,11925007,12555985,630978,392197;377630;728957;85002;653333;100133267;245940,7
1,-1,8,11925007,12555985,630978,392197;377630;728957;85002;653333;100133267;245940,7
1,-1,8,11925007,12555985,630978,392197;377630;728957;85002;653333;100133267;245940,7
1,-1,8,11925007,12555985,630978,392197;377630;728957;85002;653333;100133267;245940,7
1,-1,8,11925007,12555985,630978,392197;377630;728957;85002;653333;100133267;245940,7
1,-1,8,11925007,12555985,630978,392197;377630;728957;85002;653333;100133267;245940,7
1,-1,8,11925007,12555985,630978,392197;377630;728957;85002;653333;100133267;245940,7
1,-1,8,11925007,12555985,630978,392197;377630;728957;85002;653333;100133267;245940,7
1,-1,8,11925007,12555985,630978,392197;377630;728957;85002;653333;100133267;245940,7
1,-1,8,11925007,12555985,630978,392197;377630;728957;85002;653333;100133267;245940,7
1,-1,8,11925007,12555985,630978,392197;377630;728957;85002;653333;100133267;245940,7
1,-1,8,11925007,12555985,630978,392197;377630;728957;85002;653333;100133267;245940,7
1,-1,8,11925007,12555985,630978,392197;377630;728957;85002;653333;100133267;245940,7
1,-1,8,11925007,12555985,630978,392197;377630;728957;85002;653333;100133267;245940,7
1,-1,8,11925007,12585330,660323,392197;377630;728957;100133267;245940;85002;653333;91694,8
1,-1,8,11925007,12585330,660323,392197;377630;728957;100133267;245940;85002;653333;91694,8
1,-1,8,11925007,12585330,660323,392197;377630;728957;100133267;245940;85002;653333;91694,8
1,-1,8,11925007,12585330,660323,392197;377630;728957;100133267;245940;85002;653333;91694,8
1,-1,8,11925007,12585330,660323,392197;377630;728957;100133267;245940;85002;653333;91694,8
1,-1,8,11925007,12585330,660323,392197;377630;728957;100133267;245940;85002;653333;91694,8
1,-1,8,11925007,12585330,660323,392197;377630;728957;100133267;245940;85002;653333;91694,8
1,-1,8,11925007,12585330,660323,392197;377630;728957;100133267;245940;85002;653333;91694,8
1,-1,8,11925007,12585330,660323,392197;377630;728957;100133267;245940;85002;653333;91694,8
1,1,8,11935023,43824035,31889012,377630;203102;2053;27257;55806;8756;84513;54793;286097;389643;619373;10671;51669;155;9070;7976;59339;27121;4747;84197;1960;2137;6570;1135;55246;8754;5533;541565;57509;2515;7994;51125;56154;79698;157855;286;11030;340441;2267;137868;23484;11178;4481;80005;6867;63898;427;1191;55756;56892;55872;79618;2260;81551;137964;2961;1142;6770;5157;64641;138050;23516;148;84549;114926;5108;6781;5368;64236;25960;10395;3551;85002;51435;6440;2936;91694;2185;9108;137970;4023;1846;4017;728957;5423;8793;29883;84750;661;2039;55174;7991;157313;9;79845;29942;10947;7993;389649;3620;1978;157574;9796;7486;1808;9530;203069;2675;157848;157310;23221;6575;137994;55145;55790;81790;5516;5520;137492;26281;23087;10174;8795;51201;83877;11212;80139;2339;55124;23362;8797;4824;8794;84296;157773;8749;11160;392197;55909;80346;9583;245940;286133;84376;6422;649;10361;57805;91782;2796;55290;169355;80185;10;78986;27299;10863;10687;157570;55140;203100;665;4741;7419;9046;23039;23259;8973;79873;137814;55893;23303;526;203190;100507341;57604;3084;137362;80223;6542;5327;8822;653333;51312;54904;64760,186
1,1,8,11945855,34875355,22929500,377630;2053;55806;8756;54793;286097;389643;619373;10671;51669;7976;4747;1960;2137;6570;1135;55246;5533;541565;57509;56154;11030;2267;137868;23484;11178;4481;80005;63898;427;1191;55756;55872;79618;81551;2961;5157;64641;23516;148;84549;5108;6781;5368;64236;10395;85002;51435;6440;2936;91694;2185;9108;4023;1846;4017;728957;8793;29883;84750;661;2039;55174;7991;157313;9;79845;29942;7993;157574;9796;7486;1808;203069;2675;157310;23221;55790;5516;5520;137492;26281;23087;10174;8795;51201;55124;23362;8797;4824;8794;157773;392197;55909;80346;9583;245940;286133;649;10361;57805;91782;2796;80185;10;78986;27299;10863;10687;157570;55140;665;4741;9046;23039;79873;137814;55893;23303;526;203190;100507341;57604;3084;6542;8822;653333;51312;64760,129
1,-1,8,11952847,12442767,489920,392197;377630;728957;653333;245940;85002,6
-1,-1,8,11952907,12282677,329770,392197;377630;728957;245940;85002,5
-1,-1,8,11952907,12309456,356549,392197;377630;728957;653333;245940;85002,6
-1,-1,8,11952907,12309456,356549,392197;377630;728957;653333;245940;85002,6
-1,-1,8,11952907,12309456,356549,392197;377630;728957;653333;245940;85002,6
1,-1,8,11952907,12467484,514577,392197;377630;728957;653333;245940;85002,6
1,-1,8,11952907,12467484,514577,392197;377630;728957;653333;245940;85002,6
1,-1,8,11952907,12467484,514577,392197;377630;728957;653333;245940;85002,6
1,-1,8,11952907,12467484,514577,392197;377630;728957;653333;245940;85002,6
1,-1,8,11952907,12467484,514577,392197;377630;728957;653333;245940;85002,6
1,-1,8,11952907,12467484,514577,392197;377630;728957;653333;245940;85002,6
1,-1,8,11952907,12467484,514577,392197;377630;728957;653333;245940;85002,6
1,-1,8,11952907,12467484,514577,392197;377630;728957;653333;245940;85002,6
1,-1,8,11952907,12522676,569769,392197;377630;728957;653333;245940;85002,6
1,-1,8,11952907,12522676,569769,392197;377630;728957;653333;245940;85002,6
1,-1,8,11952907,12522676,569769,392197;377630;728957;653333;245940;85002,6
1,-1,8,11952907,12522676,569769,392197;377630;728957;653333;245940;85002,6
1,-1,8,11952907,12535805,582898,392197;377630;728957;653333;245940;85002,6
1,-1,8,11952907,12535805,582898,392197;377630;728957;653333;245940;85002,6
1,-1,8,11952907,12535805,582898,392197;377630;728957;653333;245940;85002,6
1,-1,8,11952907,12535805,582898,392197;377630;728957;653333;245940;85002,6
1,-1,8,11952907,12555985,603078,392197;377630;728957;653333;245940;85002,6
1,-1,8,11952907,12555985,603078,392197;377630;728957;653333;245940;85002,6
1,-1,8,11952907,12555985,603078,392197;377630;728957;653333;245940;85002,6
1,-1,8,11967834,12555985,588151,392197;377630;728957;653333;245940;85002,6
-1,-1,8,12039930,12467543,427613,245940;653333;85002,3
-1,-1,8,12039930,12467543,427613,245940;653333;85002,3
-1,-1,8,12039930,12467543,427613,245940;653333;85002,3
-1,-1,8,12039930,12467543,427613,245940;653333;85002,3
-1,-1,8,12039930,12467543,427613,245940;653333;85002,3
-1,-1,8,12039930,12467543,427613,245940;653333;85002,3
1,1,8,12039930,43528350,31488420,203102;2053;27257;55806;8756;84513;54793;286097;389643;619373;10671;51669;155;9070;7976;59339;27121;4747;84197;1960;2137;6570;1135;55246;8754;5533;541565;51312;57509;2515;7994;51125;56154;79698;157855;286;11030;340441;2267;137868;23484;11178;4481;80005;6867;63898;427;1191;55756;56892;55872;79618;2260;81551;137964;2961;1142;6770;5157;64641;138050;23516;148;84549;114926;5108;6781;5368;64236;25960;10395;3551;85002;51435;6440;2936;91694;2185;9108;137970;4023;1846;4017;5423;8793;29883;84750;661;2039;55174;7991;157313;9;79845;29942;10947;7993;389649;3620;1978;157574;9796;7486;9530;203069;2675;157848;157310;23221;6575;137994;55145;55790;81790;5516;5520;137492;26281;23087;10174;8795;51201;83877;11212;80139;2339;55124;23362;8797;4824;8794;84296;157773;8749;11160;55909;80346;9583;245940;286133;84376;6422;649;10361;57805;91782;2796;55290;169355;80185;10;78986;27299;10863;10687;157570;55140;203100;665;4741;7419;9046;23039;23259;8973;79873;137814;55893;23303;526;203190;100507341;57604;3084;137362;80223;6542;5327;8822;653333;1808;54904;64760,183
1,-1,8,12220281,12241123,20842,,0
1,1,8,12240353,28483081,16242728,2053;55806;64760;8756;157574;54793;9796;286097;389643;203069;2675;157310;23221;7976;4747;55790;1960;6570;1135;55246;5520;137492;26281;5533;23087;10174;8795;51201;541565;51312;57509;55124;23362;8797;4824;8794;157773;2267;137868;11178;4481;80005;55909;80346;9583;63898;286133;427;1191;649;55872;10361;57805;91782;2796;81551;10;27299;10863;5157;10687;64641;157570;23516;55140;665;4741;148;9046;23039;5108;6781;5368;64236;79873;137814;10395;55893;51435;6440;526;203190;91694;2185;9108;4023;57604;4017;8793;29883;6542;661;2039;55174;7991;8822;1808;653333;157313;9,100
-1,1,8,12241093,28891463,16650370,2053;55806;64760;8756;157574;54793;9796;286097;389643;203069;2675;157310;23221;7976;4747;55790;1960;2137;6570;1135;55246;5520;137492;26281;5533;23087;10174;8795;51201;541565;51312;57509;55124;23362;8797;4824;8794;157773;2267;137868;11178;4481;80005;55909;80346;9583;63898;286133;427;1191;55756;649;55872;10361;79618;57805;91782;2796;81551;10;27299;10863;5157;10687;64641;157570;23516;55140;665;4741;148;9046;23039;5108;6781;5368;64236;79873;137814;10395;55893;51435;6440;526;203190;91694;2185;9108;4023;57604;4017;8793;29883;6542;661;2039;55174;7991;8822;1808;653333;157313;9,103
1,1,8,12241093,43528350,31287257,203102;2053;27257;55806;8756;84513;54793;286097;389643;619373;10671;51669;155;9070;7976;59339;27121;4747;84197;1960;2137;6570;1135;55246;8754;5533;541565;57509;2515;7994;51125;56154;79698;157855;286;11030;340441;2267;137868;23484;11178;4481;80005;6867;63898;427;1191;55756;56892;55872;79618;2260;81551;137964;2961;1142;6770;5157;64641;138050;23516;148;84549;114926;5108;6781;5368;64236;25960;10395;3551;51435;6440;2936;91694;2185;9108;137970;4023;1846;4017;5423;8793;29883;84750;661;2039;55174;7991;157313;9;79845;29942;10947;7993;389649;3620;1978;157574;9796;7486;1808;9530;203069;2675;157848;157310;23221;6575;137994;55145;55790;81790;5516;5520;137492;26281;23087;10174;8795;51201;83877;11212;80139;2339;55124;23362;8797;4824;8794;84296;157773;8749;11160;55909;80346;9583;286133;84376;6422;649;10361;57805;91782;2796;55290;169355;80185;10;78986;27299;10863;10687;157570;55140;203100;665;4741;7419;9046;23039;23259;8973;79873;137814;55893;23303;526;203190;100507341;57604;3084;137362;80223;6542;5327;8822;653333;51312;54904;64760,181
1,1,8,12467484,41943221,29475737,203102;2053;27257;55806;8756;84513;54793;286097;389643;619373;10671;51669;155;9070;7976;59339;4747;1960;2137;6570;1135;55246;8754;5533;541565;57509;2515;7994;51125;56154;79698;157855;286;11030;2267;137868;23484;11178;4481;80005;6867;63898;427;1191;55756;56892;55872;79618;2260;81551;137964;2961;6770;5157;64641;23516;148;84549;5108;6781;5368;64236;25960;10395;51435;6440;2936;91694;2185;9108;137970;4023;1846;4017;8793;29883;84750;661;2039;55174;7991;157313;9;79845;29942;7993;389649;3620;1978;157574;9796;7486;1808;9530;203069;2675;157848;157310;23221;137994;55790;5516;5520;137492;26281;23087;10174;8795;51201;83877;11212;80139;55124;23362;8797;4824;8794;84296;157773;8749;11160;55909;80346;9583;286133;6422;649;10361;57805;91782;2796;55290;169355;80185;10;78986;27299;10863;10687;157570;55140;203100;665;4741;9046;23039;23259;79873;137814;55893;23303;526;203190;100507341;57604;3084;137362;80223;6542;8822;51312;54904;64760,163
1,1,8,12467484,41943221,29475737,203102;2053;27257;55806;8756;84513;54793;286097;389643;619373;10671;51669;155;9070;7976;59339;4747;1960;2137;6570;1135;55246;8754;5533;541565;57509;2515;7994;51125;56154;79698;157855;286;11030;2267;137868;23484;11178;4481;80005;6867;63898;427;1191;55756;56892;55872;79618;2260;81551;137964;2961;6770;5157;64641;23516;148;84549;5108;6781;5368;64236;25960;10395;51435;6440;2936;91694;2185;9108;137970;4023;1846;4017;8793;29883;84750;661;2039;55174;7991;157313;9;79845;29942;7993;389649;3620;1978;157574;9796;7486;1808;9530;203069;2675;157848;157310;23221;137994;55790;5516;5520;137492;26281;23087;10174;8795;51201;83877;11212;80139;55124;23362;8797;4824;8794;84296;157773;8749;11160;55909;80346;9583;286133;6422;649;10361;57805;91782;2796;55290;169355;80185;10;78986;27299;10863;10687;157570;55140;203100;665;4741;9046;23039;23259;79873;137814;55893;23303;526;203190;100507341;57604;3084;137362;80223;6542;8822;51312;54904;64760,163
1,1,8,12467484,43528350,31060866,203102;2053;27257;55806;8756;84513;54793;286097;389643;619373;10671;51669;155;9070;7976;59339;27121;4747;84197;1960;2137;6570;1135;55246;8754;5533;541565;57509;2515;7994;51125;56154;79698;157855;286;11030;340441;2267;137868;23484;11178;4481;80005;6867;63898;427;1191;55756;56892;55872;79618;2260;81551;137964;2961;1142;6770;5157;64641;138050;23516;148;84549;114926;5108;6781;5368;64236;25960;10395;3551;51435;6440;2936;91694;2185;9108;137970;4023;1846;4017;5423;8793;29883;84750;661;2039;55174;7991;157313;9;79845;29942;10947;7993;389649;3620;1978;157574;9796;7486;1808;9530;203069;2675;157848;157310;23221;6575;137994;55145;55790;81790;5516;5520;137492;26281;23087;10174;8795;51201;83877;11212;80139;2339;55124;23362;8797;4824;8794;84296;157773;8749;11160;55909;80346;9583;286133;84376;6422;649;10361;57805;91782;2796;55290;169355;80185;10;78986;27299;10863;10687;157570;55140;203100;665;4741;7419;9046;23039;23259;8973;79873;137814;55893;23303;526;203190;100507341;57604;3084;137362;80223;6542;5327;8822;51312;54904;64760,180
1,1,8,12490998,16397340,3906342,137868;7991;91694;157773;4481;10395;57604,7
1,1,8,12490999,40543052,28052053,203102;2053;27257;55806;8756;84513;54793;286097;389643;619373;10671;51669;155;9070;7976;59339;4747;1960;2137;6570;1135;55246;8754;5533;541565;57509;2515;56154;79698;157855;11030;2267;137868;23484;11178;4481;80005;6867;63898;427;1191;55756;56892;55872;79618;2260;81551;2961;6770;5157;64641;23516;148;84549;5108;6781;5368;64236;25960;10395;51435;6440;2936;91694;2185;9108;137970;4023;1846;4017;8793;29883;84750;661;2039;55174;7991;157313;9;79845;29942;7993;389649;3620;1978;157574;9796;7486;1808;9530;203069;2675;157310;23221;137994;55790;5516;5520;137492;26281;23087;10174;8795;51201;83877;11212;80139;55124;23362;8797;4824;8794;157773;8749;11160;55909;80346;9583;286133;649;10361;57805;91782;2796;55290;169355;80185;10;78986;27299;10863;10687;157570;55140;203100;665;4741;9046;23039;23259;79873;137814;55893;23303;526;203190;100507341;57604;3084;137362;80223;6542;8822;51312;54904;64760,156
1,1,8,12490999,146295771,133804772,1584;55806;51366;9166;137835;11156;767;137872;157724;137886;9070;4067;59339;4747;11059;862;6132;1135;79776;26233;10565;56704;65986;1936;51101;6101;23144;6591;116328;57509;79645;528;96764;81796;2515;51125;22827;79698;7038;2738;10404;28998;157855;340441;79977;375686;389677;5462;23484;80005;6867;91147;65265;427;1191;55756;56892;79139;55872;4609;9420;54212;81551;4986;138050;8629;84549;25960;64236;51435;91694;137970;340359;4017;3646;57094;5423;169044;8793;4856;100130742;661;2039;7991;5168;5150;79845;29942;340371;203111;4715;23643;3620;761;203054;84988;55039;79848;8694;9530;392255;23414;81034;23221;55790;5516;115111;85479;51201;11212;80139;157657;26166;83482;286144;55284;93594;84675;619279;64089;5375;2167;575;7553;7564;5324;23471;100130301;55656;54928;56169;10499;649;2669;84232;10361;79752;8928;729330;4796;759;4061;29088;5569;10687;203100;7419;157769;79943;6674;79792;441381;526;80778;5862;432355;7264;8822;54714;56943;90362;203102;115908;116039;79870;84513;93100;54793;389643;619373;51669;9684;29967;114822;2137;55246;157777;27012;7994;28991;56154;79075;8836;50484;64168;54968;92140;63898;81858;793;1585;85481;646480;389676;5157;23212;10987;94241;29028;148;23246;114926;5828;27085;5108;56260;10395;51571;286128;1052;29883;3174;55174;51001;28957;137392;54742;389649;9699;9796;90390;111188157;286077;203069;2675;137682;50626;286151;157680;6575;389668;7163;9242;23639;26281;8795;83877;137902;2831;11236;2339;23213;8797;23362;4824;8323;6503;8794;157773;11075;5885;84933;2171;63978;4603;79145;55909;80346;389658;727957;286133;4325;100861412;91782;58500;55290;169355;10;401474;23514;7201;6921;157753;55140;10221;9694;26986;3037;6713;113655;4147;79873;137814;55893;157378;66004;203190;100507341;114786;57604;8733;6917;54512;9791;51633;3297;64760;116447;114569;4683;84948;225689;286053;25879;286097;169200;492307;51059;2907;10434;23237;10671;7976;25897;55093;642475;8754;2875;3788;203062;83988;6482;4982;80728;51337;286075;9650;9401;6156;55824;389690;286;2267;137868;90987;11178;4481;646486;138046;23678;79618;57152;100533106;2260;340385;2961;51105;29894;6770;441376;64798;55636;1581;55529;100130274;105375787;3551;6440;2936;2185;9108;1846;168975;79815;10940;10584;6383;80243;85453;137735;9;65263;10947;157869;253943;3612;7486;55074;114907;157506;157848;642658;79666;100533105;157310;9312;55145;137994;340419;85444;137209;100127983;8895;57210;137492;23087;1807;4173;8439;286183;137797;23513;9788;51236;22882;8749;11160;414919;6129;2131;195814;10656;138009;5591;389692;84955;9583;5747;23462;26873;6422;80185;78986;27299;286148;10247;4741;64321;169166;50807;9046;1537;23039;25788;8840;245972;114;157638;157807;9831;5327;51312;2053;27257;8601;7381;8756;6788;7373;8767;8581;9705;2765;155;27121;84197;1960;5179;6570;340390;90990;654463;5533;137695;54704;541565;11244;84294;2843;51050;83696;734;7227;51606;11030;27067;4062;6224;1875;7071;25962;55638;6873;51123;7336;79581;8000;83481;137964;114788;2138;84875;1142;312;54108;64641;23516;92421;9134;1345;100132813;6781;5368;80124;9897;401466;4023;157567;1666;1015;84750;444;7013;157313;3786;54332;7993;84985;1978;157574;54845;22898;100129654;7274;27161;55630;81790;83690;338328;5520;10174;169026;55156;286187;340393;8667;55353;55124;51582;3574;84296;5339;254778;51160;51110;4956;115294;10086;84376;6386;93035;4342;57805;2796;5440;1392;10863;157570;57623;665;81501;6641;9821;284;347051;83940;23259;8973;51115;23303;760;3084;10397;137362;80223;377677;6542;27319;23167;51305;9760;1808;7534;54904;8989,585
1,1,8,12503632,43541986,31038354,203102;2053;27257;55806;8756;84513;54793;286097;389643;619373;10671;51669;155;9070;7976;59339;27121;4747;84197;1960;2137;6570;1135;55246;8754;5533;541565;57509;2515;7994;51125;56154;79698;157855;286;11030;340441;2267;137868;23484;11178;4481;80005;6867;63898;427;1191;55756;56892;55872;79618;2260;81551;137964;2961;1142;6770;5157;64641;138050;23516;148;84549;114926;5108;6781;5368;64236;25960;10395;3551;51435;6440;2936;91694;2185;9108;137970;4023;1846;4017;5423;8793;29883;84750;661;2039;55174;7991;157313;9;79845;29942;10947;7993;389649;3620;1978;157574;9796;7486;1808;9530;203069;2675;157848;157310;23221;6575;137994;55145;55790;81790;5516;5520;137492;26281;23087;10174;8795;51201;83877;11212;80139;2339;55124;23362;8797;4824;8794;84296;157773;8749;11160;55909;80346;9583;286133;84376;6422;649;10361;57805;91782;2796;55290;169355;80185;10;78986;27299;10863;10687;157570;55140;203100;665;4741;7419;9046;23039;23259;8973;79873;137814;55893;23303;526;203190;100507341;57604;3084;137362;80223;6542;5327;8822;51312;54904;64760,180
1,1,8,12522735,36880414,24357679,29942;2053;55806;7993;64760;8756;157574;54793;9796;7486;286097;389643;619373;203069;2675;10671;51669;157310;23221;7976;4747;55790;1960;2137;6570;1135;55246;5516;5520;137492;26281;5533;23087;10174;8795;51201;541565;51312;57509;55124;23362;8797;56154;4824;8794;157855;157773;11030;2267;137868;23484;11178;4481;80005;55909;80346;9583;63898;286133;427;1191;55756;649;55872;10361;79618;57805;91782;2796;80185;81551;2961;10;78986;27299;10863;5157;10687;64641;157570;23516;55140;665;4741;148;84549;9046;23039;5108;6781;5368;64236;79873;137814;10395;55893;23303;51435;6440;2936;526;203190;91694;2185;9108;137970;4023;1846;100507341;57604;4017;3084;8793;79845;29883;84750;6542;661;2039;55174;7991;8822;1808;157313;9,125
1,1,8,12528482,33684786,21156304,29942;2053;55806;7993;64760;8756;157574;54793;9796;7486;286097;389643;619373;203069;2675;10671;51669;157310;23221;7976;4747;55790;1960;2137;6570;1135;55246;5516;5520;137492;26281;5533;23087;10174;8795;51201;541565;51312;57509;55124;23362;8797;56154;4824;8794;157773;11030;2267;137868;23484;11178;4481;80005;55909;80346;9583;63898;286133;427;1191;55756;649;55872;10361;79618;57805;91782;2796;80185;81551;2961;10;78986;27299;10863;5157;10687;64641;157570;23516;55140;665;4741;148;84549;9046;23039;5108;6781;5368;64236;79873;137814;10395;55893;23303;51435;6440;2936;526;203190;91694;2185;9108;4023;1846;100507341;57604;4017;3084;8793;79845;29883;84750;6542;661;2039;55174;7991;8822;1808;157313;9,123
1,1,8,12528482,39593802,27065320,203102;2053;27257;55806;8756;84513;54793;286097;389643;619373;10671;51669;155;9070;7976;59339;4747;1960;2137;6570;1135;55246;8754;5533;541565;57509;56154;157855;11030;2267;137868;23484;11178;4481;80005;6867;63898;427;1191;55756;55872;79618;2260;81551;2961;6770;5157;64641;23516;148;84549;5108;6781;5368;64236;25960;10395;51435;6440;2936;91694;2185;9108;137970;4023;1846;4017;8793;29883;84750;661;2039;55174;7991;157313;9;79845;29942;7993;389649;1978;157574;9796;7486;1808;9530;203069;2675;157310;23221;137994;55790;5516;5520;137492;26281;23087;10174;8795;51201;83877;11212;80139;55124;23362;8797;4824;8794;157773;8749;11160;55909;80346;9583;286133;649;10361;57805;91782;2796;55290;80185;10;78986;27299;10863;10687;157570;55140;203100;665;4741;9046;23039;23259;79873;137814;55893;23303;526;203190;100507341;57604;3084;137362;80223;6542;8822;51312;54904;64760,151
1,1,8,12535865,41717221,29181356,203102;2053;27257;55806;8756;84513;54793;286097;389643;619373;10671;51669;155;9070;7976;59339;4747;1960;2137;6570;1135;55246;8754;5533;541565;57509;2515;51125;56154;79698;157855;286;11030;2267;137868;23484;11178;4481;80005;6867;63898;427;1191;55756;56892;55872;79618;2260;81551;137964;2961;6770;5157;64641;23516;148;84549;5108;6781;5368;64236;25960;10395;51435;6440;2936;91694;2185;9108;137970;4023;1846;4017;8793;29883;84750;661;2039;55174;7991;157313;9;79845;29942;7993;389649;3620;1978;157574;9796;7486;1808;9530;203069;2675;157848;157310;23221;137994;55790;5516;5520;137492;26281;23087;10174;8795;51201;83877;11212;80139;55124;23362;8797;4824;8794;84296;157773;8749;11160;55909;80346;9583;286133;6422;649;10361;57805;91782;2796;55290;169355;80185;10;78986;27299;10863;10687;157570;55140;203100;665;4741;9046;23039;23259;79873;137814;55893;23303;526;203190;100507341;57604;3084;137362;80223;6542;8822;51312;54904;64760,162
1,1,8,12556004,35333600,22777596,29942;2053;55806;7993;64760;8756;157574;54793;9796;7486;286097;389643;619373;203069;2675;10671;51669;157310;23221;7976;4747;55790;1960;2137;6570;1135;55246;5516;5520;137492;26281;5533;23087;10174;8795;51201;541565;51312;57509;55124;23362;8797;56154;4824;8794;157773;11030;2267;137868;23484;11178;4481;80005;55909;80346;9583;63898;286133;427;1191;55756;649;55872;10361;79618;57805;91782;2796;80185;81551;2961;10;78986;27299;10863;5157;10687;64641;157570;23516;55140;665;4741;148;84549;9046;23039;5108;6781;5368;64236;79873;137814;10395;55893;23303;51435;6440;2936;526;203190;91694;2185;9108;137970;4023;1846;100507341;57604;4017;3084;8793;79845;29883;84750;6542;661;2039;55174;7991;8822;1808;157313;9,124
1,1,8,12580132,14293267,1713135,137868;91694;157773;10395;57604,5
1,1,8,12580132,43388233,30808101,203102;2053;27257;55806;8756;84513;54793;286097;389643;619373;10671;51669;155;9070;7976;59339;27121;4747;84197;1960;2137;6570;1135;55246;8754;5533;541565;51312;57509;2515;7994;51125;56154;79698;157855;286;11030;340441;2267;137868;23484;11178;4481;80005;6867;63898;427;1191;55756;56892;55872;79618;2260;81551;137964;2961;1142;6770;5157;64641;138050;23516;148;84549;114926;5108;6781;5368;64236;25960;10395;3551;51435;6440;2936;91694;2185;9108;137970;4023;1846;4017;5423;8793;29883;84750;661;2039;55174;7991;157313;9;79845;29942;10947;7993;389649;3620;1978;157574;9796;7486;9530;203069;2675;157848;157310;23221;6575;137994;55145;55790;81790;5516;5520;137492;26281;23087;10174;8795;51201;83877;11212;80139;2339;55124;23362;8797;4824;8794;84296;157773;8749;11160;55909;80346;9583;286133;84376;6422;649;10361;57805;91782;2796;55290;169355;80185;10;78986;27299;10863;10687;157570;55140;203100;665;4741;7419;9046;23039;23259;8973;79873;137814;55893;23303;526;203190;100507341;57604;3084;137362;80223;6542;5327;8822;1808;54904;64760,180
1,1,8,12583259,30038037,17454778,2053;55806;64760;8756;157574;54793;9796;286097;389643;619373;203069;2675;10671;51669;157310;23221;7976;4747;55790;1960;2137;6570;1135;55246;5520;137492;26281;5533;23087;10174;8795;51201;541565;51312;57509;55124;23362;8797;4824;8794;157773;2267;137868;23484;11178;4481;80005;55909;80346;9583;63898;286133;427;1191;55756;649;55872;10361;79618;57805;91782;2796;81551;10;27299;10863;5157;10687;64641;157570;23516;55140;665;4741;148;9046;23039;5108;6781;5368;64236;79873;137814;10395;55893;23303;51435;6440;526;203190;91694;2185;9108;4023;1846;57604;4017;8793;29883;6542;661;2039;55174;7991;8822;1808;157313;9,108
1,1,8,12586413,40026713,27440300,203102;2053;27257;55806;8756;84513;54793;286097;389643;619373;10671;51669;155;9070;7976;59339;4747;1960;2137;6570;1135;55246;8754;5533;541565;51312;57509;2515;56154;157855;11030;2267;137868;23484;11178;4481;80005;6867;63898;427;1191;55756;56892;55872;79618;2260;81551;2961;6770;5157;64641;23516;148;84549;5108;6781;5368;64236;25960;10395;51435;6440;2936;91694;2185;9108;137970;4023;1846;4017;8793;29883;84750;661;2039;55174;7991;157313;9;79845;29942;7993;389649;3620;1978;157574;9796;7486;9530;203069;2675;157310;23221;137994;55790;5516;5520;137492;26281;23087;10174;8795;51201;83877;11212;80139;55124;23362;8797;4824;8794;157773;8749;11160;55909;80346;9583;286133;649;10361;57805;91782;2796;55290;169355;80185;10;78986;27299;10863;10687;157570;55140;203100;665;4741;9046;23039;23259;79873;137814;55893;23303;526;203190;100507341;57604;3084;137362;80223;6542;8822;1808;54904;64760,155
1,1,8,12586413,43528350,30941937,203102;2053;27257;55806;8756;84513;54793;286097;389643;619373;10671;51669;155;9070;7976;59339;27121;4747;84197;1960;2137;6570;1135;55246;8754;5533;541565;51312;57509;2515;7994;51125;56154;79698;157855;286;11030;340441;2267;137868;23484;11178;4481;80005;6867;63898;427;1191;55756;56892;55872;79618;2260;81551;137964;2961;1142;6770;5157;64641;138050;23516;148;84549;114926;5108;6781;5368;64236;25960;10395;3551;51435;6440;2936;91694;2185;9108;137970;4023;1846;4017;5423;8793;29883;84750;661;2039;55174;7991;157313;9;79845;29942;10947;7993;389649;3620;1978;157574;9796;7486;9530;203069;2675;157848;157310;23221;6575;137994;55145;55790;81790;5516;5520;137492;26281;23087;10174;8795;51201;83877;11212;80139;2339;55124;23362;8797;4824;8794;84296;157773;8749;11160;55909;80346;9583;286133;84376;6422;649;10361;57805;91782;2796;55290;169355;80185;10;78986;27299;10863;10687;157570;55140;203100;665;4741;7419;9046;23039;23259;8973;79873;137814;55893;23303;526;203190;100507341;57604;3084;137362;80223;6542;5327;8822;1808;54904;64760,180
1,1,8,12586532,39093453,26506921,203102;2053;27257;55806;8756;84513;54793;286097;389643;619373;10671;51669;155;9070;7976;59339;4747;1960;2137;6570;1135;55246;8754;5533;541565;51312;57509;56154;157855;11030;2267;137868;23484;11178;4481;80005;6867;63898;427;1191;55756;55872;79618;2260;81551;2961;6770;5157;64641;23516;148;84549;5108;6781;5368;64236;25960;10395;51435;6440;2936;91694;2185;9108;137970;4023;1846;4017;8793;29883;84750;661;2039;55174;7991;157313;9;79845;29942;7993;389649;1978;157574;9796;7486;9530;203069;2675;157310;23221;137994;55790;5516;5520;137492;26281;23087;10174;8795;51201;83877;11212;80139;55124;23362;8797;4824;8794;157773;11160;55909;80346;9583;286133;649;10361;57805;91782;2796;55290;80185;10;78986;27299;10863;10687;157570;55140;203100;665;4741;9046;23039;23259;79873;137814;55893;23303;526;203190;100507341;57604;3084;137362;80223;6542;8822;1808;54904;64760,150
1,1,8,12590039,20294393,7704354,5108;51201;26281;63898;10395;57509;427;286097;526;4481;91694;9108;23362;4023;57604;10;157773;5157;29883;6542;2267;55790;137868;6570;55174;7991;9;137492;11178,29
-1,1,8,13091530,24483615,11392085,55806;8756;9;9796;286097;203069;2675;157310;23221;55790;1960;6570;137492;26281;5533;10174;8795;51201;541565;57509;55124;23362;8797;4824;8794;157773;2267;137868;11178;4481;55909;80346;9583;63898;427;649;10361;57805;91782;10;27299;10863;5157;23516;9046;23039;5108;6781;64236;79873;137814;10395;6440;526;203190;9108;4023;4017;8793;29883;6542;661;8822;55174;7991;2039;51312;64760,68
1,-1,8,13401766,13558053,156287,157773;10395,2
1,-1,8,13604086,13935111,331025,,0
1,-1,8,13905443,13961302,55859,137868,1
-1,-1,8,14572311,14615181,42870,137868,1
1,-1,8,14797620,14834086,36466,137868,1
-1,1,8,15093351,32246732,17153381,29942;2053;55806;7993;64760;8756;157574;54793;9796;7486;286097;389643;1808;619373;203069;2675;10671;51669;157310;23221;7976;4747;55790;1960;2137;6570;1135;55246;5516;5520;137492;26281;5533;23087;10174;8795;51201;541565;57509;55124;23362;8797;56154;4824;8794;11030;2267;137868;23484;11178;4481;80005;55909;80346;9583;63898;286133;427;1191;55756;649;55872;10361;79618;57805;91782;2796;81551;2961;10;27299;10863;5157;10687;64641;157570;23516;55140;665;4741;148;9046;23039;5108;6781;5368;64236;79873;137814;55893;23303;51435;6440;2936;526;203190;2185;9108;4023;1846;100507341;4017;3084;8793;29883;6542;661;2039;55174;7991;8822;51312;157313;9,114
-1,-1,8,15403439,15409173,5734,7991,1
-1,-1,8,15421661,15431325,9664,7991,1
-1,-1,8,15421661,15431325,9664,7991,1
-1,-1,8,15421661,15431325,9664,7991,1
-1,-1,8,15952011,16021685,69674,4481,1
-1,-1,8,15952011,16021685,69674,4481,1
-1,-1,8,16240968,16353094,112126,,0
-1,1,8,18830506,33476782,14646276,29942;2053;55806;7993;8756;157574;54793;9796;7486;389643;1808;619373;203069;2675;10671;51669;157310;23221;7976;4747;55790;1960;2137;6570;1135;55246;5516;5520;23087;5533;10174;8795;541565;55124;23362;8797;56154;4824;8794;11030;23484;11178;80005;55909;80346;9583;63898;286133;1191;55756;649;55872;10361;79618;57805;91782;2796;80185;81551;2961;78986;27299;10863;10687;64641;157570;23516;55140;665;4741;148;84549;9046;23039;6781;5368;64236;79873;137814;55893;23303;51435;6440;2936;526;203190;2185;4023;1846;100507341;4017;3084;8793;79845;84750;661;2039;55174;8822;51312;157313;64760,102
1,-1,8,18845845,19456780,610935,63898;55790;23362,3
1,1,8,21149033,146295771,125146738,1584;55806;51366;9166;137835;11156;767;137872;157724;137886;9070;4067;59339;4747;11059;862;6132;1135;79776;26233;10565;56704;65986;1936;51101;6101;23144;6591;116328;528;79645;96764;81796;2515;51125;22827;79698;7038;2738;10404;28998;157855;340441;79977;375686;389677;5462;23484;80005;6867;91147;65265;79139;1191;55756;56892;55872;4609;9420;54212;81551;4986;138050;8629;84549;25960;64236;51435;137970;340359;4017;3646;57094;5423;169044;8793;4856;100130742;661;2039;5168;5150;79845;29942;340371;203111;4715;23643;3620;761;203054;84988;55039;79848;8694;9530;392255;23414;81034;23221;5516;115111;85479;11212;80139;157657;26166;83482;286144;55284;93594;84675;619279;64089;5375;2167;575;7553;7564;5324;23471;100130301;55656;54928;56169;10499;649;2669;84232;10361;79752;8928;729330;4796;759;4061;29088;5569;10687;203100;7419;157769;79943;6674;79792;441381;80778;5862;432355;7264;8822;54714;56943;90362;203102;115908;116039;79870;84513;93100;54793;389643;619373;51669;9684;29967;114822;2137;55246;157777;27012;7994;28991;56154;79075;8836;50484;64168;54968;92140;81858;793;1585;85481;646480;389676;23212;10987;94241;29028;148;23246;114926;5828;27085;56260;51571;286128;1052;3174;51001;28957;137392;54742;389649;9699;9796;90390;111188157;286077;203069;2675;137682;50626;286151;157680;6575;389668;7163;9242;23639;8795;83877;137902;2831;11236;2339;23213;8797;4824;8323;6503;8794;11075;5885;84933;2171;63978;4603;79145;55909;80346;389658;727957;286133;4325;100861412;91782;58500;55290;169355;401474;23514;7201;6921;157753;55140;10221;9694;26986;3037;6713;113655;4147;79873;137814;55893;157378;66004;203190;100507341;114786;8733;6917;54512;9791;51633;3297;64760;116447;114569;4683;84948;225689;286053;25879;169200;492307;51059;2907;10434;23237;10671;7976;25897;55093;642475;8754;2875;3788;203062;83988;6482;4982;80728;51337;286075;9650;9401;6156;55824;389690;286;90987;646486;138046;23678;79618;57152;100533106;2260;340385;2961;51105;29894;6770;441376;64798;55636;1581;55529;100130274;105375787;3551;6440;2936;2185;1846;168975;79815;10940;10584;6383;80243;85453;137735;65263;10947;157869;253943;3612;7486;55074;114907;157506;157848;642658;79666;100533105;157310;9312;55145;137994;340419;85444;137209;100127983;8895;57210;23087;1807;4173;8439;286183;137797;23513;9788;51236;22882;8749;11160;414919;6129;2131;195814;10656;138009;5591;389692;84955;9583;5747;23462;26873;6422;80185;78986;27299;286148;10247;4741;64321;169166;50807;9046;1537;23039;25788;8840;245972;114;157638;157807;9831;5327;51312;2053;27257;8601;7381;8756;6788;7373;8767;8581;9705;2765;155;27121;84197;1960;5179;340390;90990;654463;5533;137695;54704;541565;11244;84294;2843;51050;83696;734;7227;51606;11030;27067;4062;6224;1875;7071;25962;55638;6873;51123;7336;79581;8000;83481;137964;114788;2138;84875;1142;312;54108;64641;23516;92421;9134;1345;100132813;6781;5368;80124;9897;401466;157567;1666;1015;84750;444;7013;157313;3786;54332;7993;84985;1978;157574;54845;22898;100129654;7274;27161;55630;81790;83690;338328;5520;10174;169026;55156;286187;340393;8667;55353;55124;51582;3574;84296;5339;254778;51160;51110;4956;115294;10086;84376;6386;93035;4342;57805;2796;5440;1392;10863;157570;57623;665;81501;6641;9821;284;347051;83940;23259;8973;51115;23303;760;3084;10397;137362;80223;377677;27319;23167;51305;9760;1808;7534;54904;8989,556
1,-1,8,22901199,22938085,36886,8795,1
-1,1,8,23643335,27383767,3740432,6781;2053;8756;54793;5520;2185;2796;81551;27299;10863;10687;64641;4747;665;4741;1135;1808;148;157313;23087;80005,21
1,1,8,24514488,34808438,10293950,29942;2053;7993;286133;157574;54793;1191;55756;7486;55872;389643;79618;619373;2796;80185;81551;2961;78986;10671;51669;10687;64641;157570;55140;4747;665;7976;4741;1135;55246;2137;5516;148;5520;84549;23087;5368;55893;23303;51435;2936;2185;1846;100507341;56154;3084;79845;11030;84750;1808;157313;23484;80005,53
-1,1,8,24767877,31053873,6285996,29942;2053;7993;286133;157574;54793;1191;55756;7486;55872;389643;79618;619373;2796;81551;2961;10671;51669;10687;64641;157570;55140;4747;665;7976;4741;1135;55246;2137;5516;148;5520;23087;5368;55893;23303;51435;2936;2185;1846;100507341;56154;11030;1808;157313;23484;80005,47
-1,1,8,25028618,31608116,6579498,29942;2053;7993;286133;157574;54793;1191;55756;7486;55872;389643;79618;619373;2796;81551;2961;10671;51669;10687;64641;157570;55140;7976;665;2137;1135;55246;5516;148;5520;23087;5368;55893;23303;51435;2936;2185;1846;100507341;56154;3084;11030;1808;157313;23484;80005,46
-1,1,8,29219614,40089227,10869613,6867;203102;29942;27257;7993;389649;3620;1978;84513;7486;56892;619373;55290;9530;2260;169355;80185;2961;78986;10671;51669;6770;155;9070;137994;59339;203100;5516;8754;84549;83877;25960;11212;80139;23259;2936;2515;137970;100507341;56154;54904;3084;157855;137362;11030;84750;11160;80223;8749;79845;23484,51
1,-1,8,29420806,29476272,55466,,0
1,1,8,33845065,46938942,13093877,6867;203102;10947;27257;389649;3620;1978;84513;6422;84376;56892;9530;55290;2260;169355;137964;157848;1142;6770;155;9070;6575;137994;59339;203100;27121;55145;81790;7419;84197;138050;8754;114926;83877;25960;11212;80139;23259;8973;3551;2339;2515;7994;137970;51125;79698;5423;84296;157855;137362;8749;11160;80223;286;340441;5327;54904,57
-1,1,8,35358115,36227536,869421,137970,1
1,1,8,36437621,60531557,24093936,203102;10947;8601;27257;389649;3620;1978;84513;492307;9530;137886;10434;157848;9705;155;9070;4067;59339;6575;27121;55145;84197;137994;5179;81790;8754;137695;83877;11212;80139;6101;6591;4173;8439;79645;137902;2831;96764;2339;2515;7994;51125;79698;84296;157855;286;340441;51606;8749;5324;11160;195814;6224;6867;79145;5591;115294;54928;389658;84376;6422;7336;56892;6386;4342;55290;2260;169355;54212;137964;1142;23514;29088;6770;4986;138050;203100;7419;64321;9821;114926;25960;1581;23259;8973;3551;1052;114786;5423;6917;137362;80223;5327;9760;54904;90362,96
-1,1,8,37309453,46938942,9629489,6867;203102;10947;27257;389649;3620;1978;84513;6422;84376;56892;9530;55290;2260;169355;137964;157848;1142;6770;155;9070;6575;137994;59339;203100;27121;55145;81790;7419;84197;138050;8754;114926;83877;25960;11212;80139;23259;8973;3551;2339;2515;7994;51125;79698;5423;84296;340441;137362;8749;11160;80223;286;5327;54904,55
-1,1,8,37903880,39029772,1125892,6867;203102;83877;27257;23259;389649;1978;84513;9530;2260;6770;9070;137994;59339;203100;8754;54904,17
-1,1,8,37923445,40199169,2275724,6867;203102;83877;27257;23259;389649;3620;84513;56892;2515;9530;2260;169355;6770;9070;8749;137994;59339;203100;8754;54904,21
1,-1,8,39237467,39309471,72004,,0
1,-1,8,39237467,39309471,72004,,0
-1,-1,8,39237467,39385871,148404,,0
-1,-1,8,39237467,39385871,148404,,0
-1,-1,8,39237467,39385871,148404,,0
-1,-1,8,39237467,39385871,148404,,0
-1,-1,8,39237467,39385871,148404,,0
-1,-1,8,39237467,39385871,148404,,0
1,-1,8,39237468,39380625,143157,,0
-1,-1,8,39258894,39386158,127264,,0
1,-1,8,39258894,39386158,127264,,0
-1,-1,8,39258894,39386158,127264,,0
1,-1,8,39258894,39386158,127264,,0
-1,-1,8,39258894,39386158,127264,,0
1,-1,8,39258894,39386158,127264,,0
1,-1,8,39258894,39386158,127264,,0
-1,-1,8,39258894,39386158,127264,,0
1,-1,8,39258894,39386158,127264,,0
-1,-1,8,39258924,39309619,50695,,0
-1,-1,8,39258924,39345450,86526,,0
-1,-1,8,39258924,39345450,86526,,0
1,-1,8,39259089,39332501,73412,,0
1,-1,8,39259089,39332501,73412,,0
1,-1,8,39259089,39332501,73412,,0
1,-1,8,39259089,39362857,103768,,0
1,-1,8,39259089,39385871,126782,,0
1,-1,8,39259089,39385871,126782,,0
1,1,8,39818050,43528350,3710300,10947;8973;84376;6422;3551;2339;56892;7994;51125;169355;137964;157848;79698;5423;1142;84296;340441;6575;55145;138050;286;27121;81790;84197;7419;5327;114926,27
1,1,8,40690198,43388233,2698035,10947;8973;84376;6422;3551;2339;7994;51125;137964;79698;157848;5423;1142;84296;340441;6575;55145;138050;286;27121;81790;84197;7419;5327;114926,25
1,-1,8,42776939,46938942,4162003,84197;2339;340441;84376;138050,5
1,-1,8,42858611,43541984,683373,84197;2339;340441;84376;138050,5
1,-1,8,42933206,46938942,4005736,84197;2339;138050;340441,4
1,-1,8,42933206,46938942,4005736,84197;2339;138050;340441,4
1,-1,8,42952655,43211923,259268,84197;340441;138050,3
1,-1,8,42952655,43388233,435578,84197;340441;138050,3
1,-1,8,42952655,43388233,435578,84197;340441;138050,3
1,-1,8,42958427,43388233,429806,84197;340441;138050,3
1,-1,8,42958427,43388233,429806,84197;340441;138050,3
1,-1,8,42958427,43388233,429806,84197;340441;138050,3
1,-1,8,42958427,43388233,429806,84197;340441;138050,3
1,-1,8,42970273,43529733,559460,84197;340441;138050,3
1,-1,8,43371443,43383203,11760,,0
-1,-1,8,43541970,47722045,4180075,,0
-1,-1,8,43541970,47761111,4219141,,0
-1,-1,8,43541970,47761111,4219141,,0
1,-1,8,43541970,47954816,4412846,,0
-1,-1,8,46942956,47574071,631115,,0
-1,-1,8,46942956,47574071,631115,,0
-1,-1,8,46942956,47574071,631115,,0
-1,-1,8,46942956,47703687,760731,,0
-1,-1,8,46942956,47703687,760731,,0
1,1,8,46942956,70216022,23273066,8601;253943;767;79848;100129654;7274;137872;492307;137886;10434;9705;100533105;4067;5179;85479;157777;10565;137695;6101;4173;6591;8439;79645;137902;2831;286183;55156;96764;9650;286187;84675;8836;51606;5324;254778;116328;195814;6224;4603;79145;5591;115294;54928;389658;7336;6386;23678;4342;9420;54212;23514;1392;29088;4986;23212;10987;64321;55636;9821;56260;1581;80124;1052;157807;114786;57094;5862;6917;80243;444;27319;9760;5150;90362,74
1,1,8,46942956,70216022,23273066,8601;253943;767;79848;100129654;7274;137872;492307;137886;10434;9705;100533105;4067;5179;85479;157777;10565;137695;6101;4173;6591;8439;79645;137902;2831;286183;55156;96764;9650;286187;84675;8836;51606;5324;254778;116328;195814;6224;4603;79145;5591;115294;54928;389658;7336;6386;23678;4342;9420;54212;23514;1392;29088;4986;23212;10987;64321;55636;9821;56260;1581;80124;1052;157807;114786;57094;5862;6917;80243;444;27319;9760;5150;90362,74
-1,-1,8,46942962,47703693,760731,,0
1,1,8,46942962,140297737,93354775,114569;4683;51366;9166;137835;286053;25879;767;169200;137872;492307;51059;157724;137886;10434;4067;25897;55093;11059;862;79776;10565;56704;65986;3788;83988;6482;4982;51101;6101;6591;116328;528;79645;96764;9650;81796;6156;55824;7038;10404;28998;79977;389677;5462;646486;91147;138046;79139;23678;4609;9420;100533106;54212;51105;4986;441376;64798;55636;1581;55529;340359;168975;79815;3646;57094;10940;10584;169044;6383;80243;85453;100130742;137735;4856;5168;5150;203111;4715;23643;157869;761;253943;3612;55039;55074;79848;114907;157506;392255;23414;79666;100533105;9312;81034;340419;85444;115111;85479;100127983;8895;137209;157657;1807;26166;4173;8439;286183;55284;286144;93594;9788;84675;619279;64089;5375;22882;2167;5324;6129;2131;195814;23471;100130301;10656;138009;5591;54928;55656;56169;84955;23462;10499;2669;79752;729330;759;29088;5569;286148;10247;50807;64321;169166;157769;6674;25788;8840;245972;114;157638;157807;5862;54714;56943;90362;115908;8601;116039;7381;79870;6788;7373;8767;9705;29967;5179;157777;654463;137695;54704;27012;11244;84294;51050;79075;8836;50484;734;7227;51606;27067;64168;6224;54968;1875;7071;92140;25962;55638;6873;51123;793;7336;85481;114788;646480;2138;312;389676;23212;10987;92421;94241;29028;9134;1345;5828;100132813;27085;56260;80124;51571;9897;401466;1052;157567;1666;1015;444;3174;7013;51001;28957;137392;3786;54332;9699;84985;54845;90390;100129654;7274;137682;286151;157680;389668;7163;9242;83690;23639;169026;137902;55156;2831;11236;286187;23213;8667;55353;8323;51582;3574;6503;11075;254778;5885;84933;51110;2171;63978;4956;4603;79145;115294;10086;389658;4325;6386;100861412;93035;4342;401474;23514;1392;6921;5440;157753;7201;10221;57623;81501;9694;6641;9821;26986;51633;284;347051;3037;83940;6713;4147;157378;51115;760;114786;10397;6917;377677;27319;23167;9760;9791;7534;8989,306
-1,-1,8,46953844,47703693,749849,,0
-1,-1,8,46953844,47703693,749849,,0
-1,-1,8,46953844,47738885,785041,,0
-1,-1,8,46953844,47738809,784965,,0
-1,-1,8,47458519,47738885,280366,,0
1,-1,8,48174652,48223809,49157,23514,1
-1,-1,8,48326590,48522545,195955,23514,1
-1,-1,8,50360365,50558946,198581,,0
-1,1,8,50384337,58738029,8353692,79145;54928;115294;8601;6101;389658;137902;2831;96764;4342;114786;54212;10434;9705;29088;6917;4986;4067;51606;5324;5179;64321;9821;195814;6224;137695,26
-1,-1,8,50875711,50932681,56970,54212,1
1,-1,8,53823071,53942924,119853,2831,1
-1,1,8,54237949,62775577,8537628,79145;54928;1581;8601;6101;8439;96764;767;6386;4342;157807;114786;137886;10434;90362;5862;29088;6917;4067;51606;5324;444;5179;64321;55636;9760;195814;6224;137695,29
-1,1,8,54407101,58403572,3996471,79145;54928;8601;6101;96764;4342;114786;10434;29088;6917;51606;4067;5324;5179;64321;195814;6224;137695,18
-1,1,8,55677510,57697858,2020348,79145;6224;4067;5324;96764;5179;4342;195814;114786;137695,10
-1,1,8,55733917,62058861,6324944,79145;54928;1581;8439;96764;767;6386;4342;114786;137886;90362;5862;4067;5324;5179;55636;9760;195814;6224;137695,20
1,1,8,56228414,65864987,9636573,79145;54928;1581;8439;286183;253943;96764;767;6386;4342;7274;9420;157807;114786;137886;8836;90362;5862;4067;5324;444;27319;5179;55636;9760;195814;6224;137695,28
1,-1,8,56725646,56879608,153962,96764;4067,2
-1,-1,8,58027779,58832685,804906,,0
-1,1,8,60099786,62021382,1921596,767;55636;5862,3
-1,1,8,61431756,61605551,173795,55636;5862,2
1,1,8,61431781,67571260,6139479,80124;286183;55156;253943;9650;84675;7274;137872;9420;157807;5150;8836;5862;1392;23212;444;27319;254778;55636;85479;4603,21
-1,1,8,61728952,66029297,4300345,8836;286183;253943;444;27319;55636;7274;9420;157807,9
-1,1,8,61728952,66029297,4300345,8836;286183;253943;444;27319;55636;7274;9420;157807,9
-1,1,8,65194424,68570319,3375895,56260;80124;55156;9650;23678;286187;79848;100129654;84675;137872;9420;10565;5150;57094;100533105;1392;23212;10987;27319;254778;85479;157777;4603,23
1,1,8,67083904,94517737,27433833,54332;4683;23643;157869;761;3612;169200;79848;100129654;8767;137872;157506;157724;100533105;9312;389668;7163;11059;9242;862;83690;85444;79776;115111;10565;157777;56704;65986;100127983;8895;51101;116328;286144;55284;81796;286187;23213;84675;619279;64089;5375;51050;55824;2167;3574;734;11075;254778;27067;6129;64168;2171;51110;63978;54968;1875;646486;23471;100130301;138046;4603;138009;23462;10499;793;4325;23678;79752;85481;646480;2138;759;1392;389676;6921;5569;23212;10987;92421;5828;347051;56260;55529;80124;51115;401466;245972;760;168975;57094;1666;80243;100130742;377677;3174;7013;54714;51633;28957;8989,100
1,1,8,67546080,81012324,13466244,54332;23462;23643;157869;10499;23678;79848;100129654;157506;23471;2138;100533105;6921;9312;5569;389668;10987;7163;9242;83690;79776;10565;157777;56704;5828;56260;51101;80124;116328;55284;81796;286187;23213;51050;57094;3574;80243;11075;6129;7013;27067;3174;51110;28957;63978;54968;100130301;8989,48
-1,1,8,69899336,72597645,2698309,2138;10499;389668;81796;23213;51110;63978;23471,8
-1,1,8,69899336,72597645,2698309,2138;10499;389668;81796;23213;51110;63978;23471,8
-1,1,8,69899336,72597645,2698309,2138;10499;389668;81796;23213;51110;63978;23471,8
-1,1,8,69900070,72575701,2675631,2138;10499;389668;81796;23213;51110;63978;23471,8
-1,1,8,69900116,72552263,2652147,2138;10499;389668;81796;23213;51110;63978;23471,8
-1,1,8,72099108,72340784,241676,2138,1
-1,1,8,72314204,72924788,610584,9242,1
1,-1,8,73596927,73635634,38707,9312,1
1,-1,8,73596927,73635634,38707,9312,1
1,-1,8,73596927,73635634,38707,9312,1
1,-1,8,73596927,73635634,38707,9312,1
-1,1,8,75197438,81685526,6488088,51101;54332;23462;619279;51050;3574;5569;11075;7163;3174;83690;79776;56704;65986;28957;5828,16
-1,1,8,75817543,82252186,6434643,51101;55824;3574;23462;5569;11075;7163;3174;83690;2171;79776;619279;65986;28957;5828,15
-1,1,8,75817543,82252186,6434643,51101;55824;3574;23462;5569;11075;7163;3174;83690;2171;79776;619279;65986;28957;5828,15
-1,1,8,76630644,78612790,1982146,5828;79776,2
-1,1,8,77751515,83516216,5764701,347051;51101;23462;3612;619279;79752;64089;5375;55824;2167;646480;3574;5569;11075;7163;92421;2171;79776;65986;28957;646486;5828,22
1,1,8,78392286,146294098,67901812,1584;114569;4683;51366;9166;137835;84948;11156;225689;286053;25879;169200;51059;2907;157724;23237;25897;55093;11059;642475;862;6132;26233;65986;2875;3788;203062;83988;6482;4982;51101;1936;80728;51337;23144;286075;528;9401;6156;22827;55824;7038;389690;2738;10404;28998;79977;375686;389677;90987;5462;646486;91147;138046;65265;79139;4609;100533106;57152;340385;51105;29894;441376;64798;8629;55529;100130274;105375787;340359;168975;79815;3646;10940;10584;6383;85453;4856;169044;100130742;137735;5168;65263;340371;203111;4715;761;3612;203054;84988;55039;55074;114907;8694;392255;23414;642658;79666;81034;340419;85444;115111;137209;100127983;8895;57210;157657;1807;26166;23513;286144;83482;137797;93594;9788;619279;51236;64089;5375;22882;2167;575;7553;7564;414919;2131;10656;138009;55656;56169;389692;84955;5747;26873;23462;2669;84232;79752;8928;729330;4796;759;4061;286148;5569;10247;50807;169166;157769;79943;1537;6674;25788;8840;79792;245972;114;441381;157638;80778;432355;9831;7264;54714;56943;115908;116039;7381;79870;93100;6788;7373;8767;8581;2765;9684;29967;114822;340390;90990;654463;54704;27012;11244;84294;28991;2843;79075;83696;50484;734;7227;64168;4062;1875;7071;92140;81858;25962;55638;6873;51123;793;79581;1585;85481;8000;83481;114788;646480;84875;312;389676;54108;92421;94241;29028;9134;1345;23246;100132813;27085;51571;9897;286128;401466;157567;1666;1015;51001;28957;137392;3786;54742;9699;84985;54845;90390;22898;111188157;27161;286077;137682;50626;286151;157680;55630;7163;338328;23639;169026;11236;340393;8667;55353;8323;51582;3574;6503;11075;5339;5885;84933;51160;2171;4956;10086;727957;4325;100861412;93035;58500;401474;5440;7201;157753;10221;57623;81501;9694;6641;26986;51633;284;347051;3037;83940;6713;113655;4147;157378;51115;66004;760;8733;10397;377677;54512;23167;51305;9791;7534;3297;116447,303
-1,1,8,79472080,84521307,5049227,347051;51101;23462;3612;619279;79752;64089;5375;55824;2167;646480;3574;5569;11075;7163;92421;65986;28957;646486;2171,20
1,1,8,79526312,146280020,66753708,1584;114569;4683;51366;9166;137835;84948;11156;225689;286053;25879;169200;51059;2907;157724;23237;25897;55093;11059;642475;862;6132;26233;65986;2875;3788;203062;83988;6482;4982;51101;1936;80728;51337;23144;286075;528;9401;6156;22827;55824;7038;389690;2738;10404;28998;79977;375686;389677;90987;5462;646486;91147;138046;65265;79139;4609;100533106;57152;340385;51105;29894;441376;64798;8629;55529;100130274;105375787;340359;168975;79815;3646;10940;10584;6383;85453;4856;169044;100130742;137735;5168;65263;340371;203111;4715;761;3612;203054;84988;55039;55074;114907;8694;392255;23414;642658;79666;81034;340419;85444;115111;137209;100127983;8895;57210;157657;1807;26166;23513;286144;83482;137797;93594;9788;619279;51236;64089;5375;22882;2167;575;7553;7564;414919;2131;10656;138009;55656;56169;389692;84955;5747;26873;23462;2669;84232;79752;8928;729330;4796;759;4061;286148;10247;50807;169166;157769;79943;1537;6674;25788;8840;79792;245972;114;441381;157638;80778;432355;9831;7264;54714;56943;115908;116039;7381;79870;93100;6788;7373;8767;8581;2765;9684;29967;114822;340390;90990;654463;54704;27012;11244;84294;28991;2843;79075;83696;50484;734;7227;64168;4062;1875;7071;92140;81858;25962;55638;6873;51123;793;79581;1585;85481;8000;83481;114788;646480;84875;312;389676;54108;92421;94241;29028;9134;1345;23246;100132813;27085;51571;9897;286128;401466;157567;1666;1015;51001;28957;137392;3786;54742;9699;84985;54845;90390;22898;111188157;27161;286077;137682;50626;286151;157680;55630;7163;338328;23639;169026;11236;340393;8667;55353;8323;51582;3574;6503;11075;5339;5885;84933;51160;2171;4956;10086;727957;4325;100861412;93035;58500;401474;5440;7201;157753;10221;57623;81501;9694;6641;26986;51633;284;347051;3037;83940;6713;113655;4147;157378;51115;66004;760;8733;10397;377677;54512;23167;51305;9791;7534;3297;116447,302
1,-1,8,84732613,85047388,314775,,0
1,1,8,86778228,146295771,59517543,1584;114569;4683;51366;9166;137835;84948;11156;225689;286053;25879;169200;51059;2907;157724;23237;25897;55093;11059;642475;862;6132;26233;2875;3788;203062;83988;6482;4982;1936;80728;51337;23144;286075;528;9401;6156;22827;7038;389690;2738;10404;28998;79977;375686;389677;90987;5462;91147;65265;79139;4609;100533106;57152;340385;51105;29894;441376;64798;8629;55529;100130274;105375787;340359;168975;79815;3646;10940;10584;6383;85453;4856;169044;100130742;137735;5168;65263;340371;203111;4715;203054;84988;55039;55074;114907;8694;392255;23414;642658;79666;81034;340419;115111;137209;100127983;8895;57210;157657;1807;26166;23513;286144;83482;137797;93594;9788;51236;22882;575;7553;7564;414919;2131;10656;138009;55656;56169;389692;84955;5747;26873;2669;84232;8928;729330;4796;7534;4061;286148;10247;50807;169166;157769;79943;1537;6674;25788;8840;79792;245972;114;441381;157638;80778;432355;9831;7264;54714;56943;115908;116039;7381;79870;93100;6788;7373;8767;8581;2765;9684;29967;114822;340390;90990;654463;54704;27012;11244;84294;28991;2843;79075;83696;50484;734;7227;64168;4062;7071;92140;81858;25962;55638;6873;51123;793;79581;1585;85481;8000;83481;114788;84875;312;389676;54108;94241;29028;9134;1345;23246;100132813;27085;51571;9897;286128;157567;1666;1015;51001;137392;3786;54742;9699;84985;54845;90390;22898;111188157;27161;286077;137682;50626;286151;157680;55630;338328;23639;169026;11236;340393;8667;55353;8323;51582;6503;5339;5885;84933;51160;4956;10086;727957;4325;100861412;93035;58500;401474;5440;7201;157753;10221;57623;81501;9694;6641;26986;284;3037;83940;6713;113655;4147;157378;51115;66004;8733;10397;54512;23167;51305;9791;51633;3297;116447,275
1,1,8,86841154,146295771,59454617,1584;114569;4683;51366;9166;137835;84948;11156;225689;286053;25879;169200;51059;2907;157724;23237;25897;55093;11059;642475;862;6132;26233;2875;3788;203062;83988;6482;4982;1936;80728;51337;23144;286075;528;9401;6156;22827;7038;389690;2738;10404;28998;79977;375686;389677;90987;5462;91147;65265;79139;4609;100533106;57152;340385;51105;29894;441376;64798;8629;55529;100130274;105375787;340359;168975;79815;3646;10940;10584;6383;85453;4856;169044;100130742;137735;5168;65263;340371;203111;4715;203054;84988;55039;55074;114907;8694;392255;23414;642658;79666;81034;340419;115111;137209;100127983;8895;57210;157657;1807;26166;23513;286144;83482;137797;93594;9788;51236;22882;575;7553;7564;414919;2131;10656;138009;55656;56169;389692;84955;5747;26873;2669;84232;8928;729330;4796;7534;4061;286148;10247;50807;169166;157769;79943;1537;6674;25788;8840;79792;245972;114;441381;157638;80778;432355;9831;7264;54714;56943;115908;116039;7381;79870;93100;6788;7373;8767;8581;2765;9684;29967;114822;340390;90990;654463;54704;27012;11244;84294;28991;2843;79075;83696;50484;734;7227;64168;4062;7071;92140;81858;25962;55638;6873;51123;793;79581;1585;85481;8000;83481;114788;84875;312;389676;54108;94241;29028;9134;1345;23246;100132813;27085;51571;9897;286128;157567;1666;1015;51001;137392;3786;54742;9699;84985;54845;90390;22898;111188157;27161;286077;137682;50626;286151;157680;55630;338328;23639;169026;11236;340393;8667;55353;8323;51582;6503;5339;5885;84933;51160;4956;10086;727957;4325;100861412;93035;58500;401474;5440;7201;157753;10221;57623;81501;9694;6641;26986;284;3037;83940;6713;113655;4147;157378;51115;66004;8733;10397;54512;23167;51305;9791;51633;3297;116447,275
1,1,8,86841228,142689874,55848646,115908;114569;4683;116039;7381;51366;79870;9166;137835;11156;6788;25879;286053;7373;169200;8767;51059;157724;29967;25897;55093;11059;862;654463;3788;83988;6482;54704;4982;27012;11244;528;84294;6156;2843;79075;7038;83696;50484;389690;734;10404;7227;28998;79977;389677;5462;64168;91147;7071;92140;25962;55638;6873;51123;793;79139;4609;100533106;85481;114788;51105;312;389676;54108;441376;64798;94241;29028;9134;1345;100132813;27085;55529;105375787;51571;9897;340359;168975;79815;3646;10940;157567;1666;10584;6383;85453;1015;4856;100130742;137735;169044;51001;5168;137392;3786;203111;4715;9699;84985;54845;55039;90390;55074;22898;114907;27161;392255;23414;137682;79666;286151;157680;81034;340419;115111;137209;100127983;8895;23639;57210;157657;1807;26166;169026;286144;93594;11236;9788;8667;55353;22882;8323;51582;6503;5885;84933;2131;4956;10656;138009;55656;56169;84955;10086;5747;4325;2669;100861412;93035;729330;401474;5440;7201;286148;10247;157753;10221;57623;81501;9694;169166;6641;50807;26986;157769;51633;284;3037;6674;83940;6713;4147;25788;157378;8840;51115;245972;114;157638;10397;23167;51305;9791;54714;7534;56943,187
1,1,8,87312813,138034830,50722017,115908;114569;4683;116039;7381;51366;79870;9166;137835;6788;25879;286053;7373;169200;8767;29967;25897;55093;11059;862;654463;3788;83988;6482;54704;4982;27012;11244;528;84294;6156;79075;7038;50484;734;10404;7227;28998;79977;389677;5462;64168;91147;7071;92140;25962;55638;6873;51123;793;79139;4609;100533106;114788;51105;312;389676;441376;64798;94241;29028;9134;1345;100132813;27085;55529;51571;9897;340359;168975;79815;3646;10940;157567;1666;10584;6383;85453;1015;4856;100130742;137735;51001;5168;137392;3786;203111;4715;9699;84985;54845;55039;90390;55074;114907;392255;23414;137682;79666;286151;157680;81034;340419;115111;137209;100127983;8895;23639;157657;1807;26166;169026;286144;93594;11236;9788;8667;55353;22882;8323;51582;6503;5885;84933;2131;4956;10656;138009;55656;56169;84955;10086;4325;2669;100861412;93035;729330;401474;5440;7201;286148;10247;157753;10221;57623;81501;9694;169166;6641;50807;26986;157769;51633;284;3037;6674;83940;6713;4147;25788;157378;8840;51115;114;157638;10397;23167;9791;54714;7534;56943,171
1,1,8,88943380,146294098,57350718,1584;114569;4683;51366;9166;137835;84948;11156;225689;286053;25879;169200;51059;2907;23237;25897;55093;642475;862;6132;26233;2875;3788;203062;83988;6482;4982;1936;80728;51337;23144;286075;528;9401;6156;22827;7038;389690;2738;10404;28998;79977;375686;389677;90987;5462;91147;65265;79139;4609;100533106;57152;340385;51105;29894;441376;64798;8629;55529;100130274;105375787;340359;79815;3646;10940;10584;6383;85453;4856;169044;100130742;137735;5168;65263;340371;203111;4715;203054;84988;55039;55074;114907;8694;392255;23414;642658;79666;81034;340419;115111;137209;100127983;57210;157657;1807;26166;23513;286144;83482;137797;93594;9788;51236;22882;575;7553;7564;414919;2131;10656;55656;56169;389692;84955;5747;26873;2669;84232;8928;729330;4796;7534;4061;286148;10247;50807;169166;157769;79943;1537;6674;25788;8840;79792;441381;114;157638;80778;432355;9831;7264;56943;115908;116039;7381;79870;93100;6788;7373;8767;8581;2765;9684;29967;114822;340390;90990;654463;54704;27012;11244;84294;28991;2843;79075;83696;50484;734;7227;64168;4062;7071;92140;81858;25962;55638;6873;51123;793;79581;1585;8000;83481;114788;84875;312;389676;54108;94241;29028;9134;1345;23246;100132813;27085;51571;9897;286128;157567;1666;1015;51001;137392;3786;54742;9699;84985;54845;90390;22898;111188157;27161;286077;137682;50626;286151;157680;55630;338328;23639;169026;11236;340393;8667;55353;8323;51582;6503;5339;5885;84933;51160;4956;10086;727957;4325;100861412;93035;58500;401474;5440;7201;157753;10221;57623;81501;9694;6641;26986;284;3037;83940;6713;113655;4147;157378;66004;8733;10397;54512;23167;51305;9791;51633;3297;116447,266
-1,-1,8,89673491,89832250,158759,,0
-1,-1,8,92115979,92144331,28352,100130742,1
-1,-1,8,92116009,92175700,59691,100130742,1
1,1,8,93047482,141355635,48308153,115908;114569;51366;116039;7381;9166;79870;137835;6788;25879;286053;7373;51059;29967;25897;55093;862;654463;3788;83988;6482;54704;4982;27012;11244;528;84294;6156;79075;7038;83696;50484;10404;7227;28998;79977;389677;5462;91147;7071;92140;25962;55638;6873;51123;79139;4609;100533106;114788;51105;312;389676;441376;64798;94241;29028;9134;1345;100132813;27085;51571;9897;340359;79815;3646;10940;157567;10584;6383;85453;1015;4856;137735;169044;51001;5168;137392;3786;203111;4715;9699;84985;54845;55039;90390;55074;114907;392255;23414;137682;79666;286151;157680;81034;340419;137209;23639;157657;1807;26166;169026;286144;93594;11236;9788;8667;55353;22882;8323;51582;6503;5885;84933;2131;4956;10656;55656;56169;84955;10086;2669;100861412;93035;729330;401474;5440;7201;286148;10247;157753;10221;57623;81501;9694;169166;6641;50807;26986;157769;284;3037;6674;83940;6713;4147;25788;157378;8840;114;157638;10397;23167;51305;9791;7534;56943,156
1,-1,8,94002514,94085487,82973,,0
-1,1,8,94050403,96680010,2629607,54704;91147;55656;157657;25788;25962;54845;2669;100861412;137682;79666;389676;286148;1015;389677;94241;9134;137392,18
1,1,8,95694382,146294042,50599660,115908;1584;114569;51366;116039;7381;9166;79870;137835;11156;93100;6788;25879;286053;7373;225689;8581;51059;2907;23237;2765;9684;29967;25897;55093;114822;642475;340390;6132;26233;90990;2875;654463;3788;203062;83988;6482;4982;1936;80728;51337;27012;11244;23144;286075;528;84294;6156;9401;28991;2843;22827;79075;7038;83696;50484;389690;2738;10404;7227;28998;79977;375686;90987;5462;4062;7071;65265;92140;81858;55638;6873;51123;79139;79581;1585;4609;100533106;57152;340385;8000;83481;114788;51105;84875;29894;312;54108;441376;64798;94241;29028;8629;9134;1345;23246;100132813;27085;100130274;105375787;51571;9897;84948;286128;340359;79815;3646;10940;157567;10584;6383;85453;4856;169044;137735;51001;5168;3786;54742;65263;340371;203111;4715;9699;84985;54845;203054;84988;55039;90390;55074;22898;114907;111188157;8694;27161;286077;392255;23414;137682;642658;50626;79666;286151;157680;81034;55630;340419;338328;137209;23639;57210;157657;1807;26166;169026;23513;83482;137797;93594;11236;9788;51236;8667;340393;55353;22882;575;8323;51582;6503;7553;7564;5339;414919;5885;84933;51160;2131;4956;10656;55656;56169;389692;84955;10086;5747;26873;727957;84232;93035;58500;8928;729330;4796;401474;5440;7201;286148;4061;10247;157753;10221;57623;81501;9694;169166;6641;50807;26986;157769;79943;1537;284;3037;6674;83940;6713;113655;4147;157378;8840;66004;79792;441381;114;157638;80778;8733;432355;10397;9831;7264;54512;23167;51305;9791;7534;3297;56943;116447,241
1,1,8,98395101,146295771,47900670,115908;1584;114569;51366;116039;9166;137835;79870;84948;11156;93100;6788;25879;286053;7373;225689;8581;51059;2907;23237;2765;9684;29967;25897;55093;114822;642475;340390;6132;26233;90990;2875;654463;3788;203062;83988;6482;4982;1936;80728;51337;27012;11244;23144;286075;528;84294;6156;9401;28991;2843;22827;79075;7038;83696;50484;389690;2738;28998;7227;79977;375686;90987;5462;4062;7071;65265;92140;81858;55638;6873;51123;79139;79581;1585;4609;100533106;57152;340385;8000;83481;114788;51105;84875;29894;312;54108;441376;64798;29028;8629;1345;23246;100132813;27085;100130274;105375787;51571;9897;286128;340359;79815;3646;10940;157567;10584;169044;4856;137735;5168;3786;54742;65263;340371;203111;4715;9699;84985;203054;84988;55039;90390;55074;22898;114907;111188157;8694;27161;286077;23414;642658;50626;286151;157680;81034;55630;340419;338328;137209;23639;57210;1807;26166;169026;23513;83482;137797;93594;11236;9788;51236;8667;340393;55353;22882;575;8323;51582;6503;7553;7564;5339;414919;5885;84933;51160;2131;4956;10656;56169;389692;84955;10086;5747;26873;727957;84232;93035;58500;8928;729330;4796;401474;5440;7201;4061;10247;157753;10221;57623;81501;9694;169166;6641;50807;26986;157769;79943;1537;284;3037;6674;83940;6713;113655;4147;157378;8840;66004;79792;441381;114;157638;80778;8733;432355;10397;9831;7264;54512;23167;51305;7534;3297;56943;116447,226
1,1,8,98432250,146222672,47790422,115908;1584;114569;51366;116039;9166;137835;79870;84948;11156;93100;6788;25879;286053;7373;225689;8581;51059;2907;23237;2765;9684;29967;25897;55093;114822;642475;340390;6132;26233;90990;2875;654463;3788;203062;83988;6482;4982;1936;80728;51337;27012;11244;23144;286075;528;84294;6156;9401;28991;2843;22827;79075;7038;83696;50484;389690;2738;28998;7227;79977;375686;90987;5462;4062;7071;92140;81858;55638;6873;51123;79139;79581;1585;4609;100533106;57152;340385;8000;83481;114788;51105;84875;29894;312;54108;441376;64798;29028;8629;1345;23246;100132813;27085;100130274;105375787;51571;9897;286128;340359;79815;3646;10940;157567;10584;169044;4856;137735;5168;3786;54742;65263;340371;203111;4715;9699;84985;203054;84988;55039;90390;55074;22898;114907;111188157;8694;27161;286077;23414;642658;50626;286151;157680;81034;55630;340419;338328;137209;23639;57210;1807;26166;169026;23513;83482;137797;93594;11236;9788;51236;8667;340393;55353;22882;575;8323;51582;6503;7553;7564;5339;414919;5885;84933;51160;2131;4956;10656;56169;389692;84955;10086;5747;26873;727957;84232;93035;58500;8928;729330;4796;401474;5440;7201;4061;10247;157753;10221;57623;81501;9694;169166;6641;50807;26986;157769;79943;1537;284;3037;6674;83940;6713;113655;4147;157378;8840;66004;79792;441381;114;157638;80778;8733;432355;10397;9831;7264;54512;23167;51305;7534;3297;56943;116447,225
1,-1,8,100221586,100222054,468,157680,1
1,-1,8,100221586,100222054,468,157680,1
1,-1,8,100286775,100287625,850,157680,1
-1,1,8,101191636,107536895,6345259,6674;7071;115908;1807;51366;528;79870;9699;51123;25879;55074;7534;23414;50484;157567;51582;8323;81034;29967;25897;79977;81501;169166;26986;4956;83988,26
1,1,8,101879571,146295771,44416200,115908;1584;114569;51366;9166;84948;137835;79870;11156;93100;286053;25879;225689;7373;8581;51059;2907;23237;2765;9684;29967;55093;114822;642475;340390;6132;26233;90990;2875;654463;203062;83988;6482;4982;1936;80728;51337;27012;11244;23144;286075;528;84294;9401;28991;2843;22827;79075;7038;83696;50484;389690;2738;28998;7227;79977;375686;90987;5462;4062;7071;65265;81858;55638;6873;51123;79139;79581;1585;4609;100533106;57152;340385;8000;83481;114788;51105;84875;29894;312;54108;441376;64798;29028;8629;23246;100132813;27085;100130274;105375787;51571;9897;286128;340359;3646;10584;169044;4856;137735;5168;3786;54742;65263;340371;4715;9699;84985;203054;84988;55039;90390;55074;22898;114907;111188157;8694;27161;286077;23414;642658;50626;81034;55630;340419;338328;137209;23639;57210;1807;169026;23513;83482;137797;93594;11236;9788;51236;8667;340393;22882;575;8323;51582;6503;7553;7564;5339;414919;5885;84933;51160;2131;4956;10656;56169;389692;84955;10086;5747;26873;727957;84232;93035;58500;8928;729330;4796;401474;4061;7201;157753;10221;57623;81501;9694;6641;50807;157769;79943;1537;284;3037;83940;6713;113655;157378;8840;66004;79792;441381;114;157638;80778;8733;432355;10397;9831;7264;54512;23167;51305;7534;3297;56943;116447,205
-1,1,8,102183491,110139893,7956402,7071;115908;1807;51366;528;79870;9699;51123;25879;55074;23414;3646;50484;51582;8323;7201;81034;157753;29967;137735;340419;79977;81501;9694;284;4956;83988,27
-1,1,8,102212054,106814326,4602272,7071;115908;1807;51366;528;79870;9699;51123;25879;23414;50484;51582;8323;81034;29967;79977;81501;4956;83988,19
-1,1,8,102897047,108368371,5471324,7071;115908;1807;51366;528;79870;9699;25879;55074;23414;50484;51582;8323;81034;29967;137735;81501;284;4956;83988,20
1,-1,8,103563857,103589862,26005,4956,1
1,1,8,104318564,146294098,41975534,115908;1584;114569;9166;84948;137835;11156;93100;286053;25879;225689;7373;8581;51059;2907;23237;2765;9684;29967;55093;114822;642475;340390;6132;26233;90990;2875;654463;203062;1936;6482;4982;80728;51337;27012;11244;23144;286075;84294;9401;28991;2843;22827;79075;7038;83696;389690;2738;28998;7227;375686;90987;5462;4062;65265;81858;55638;6873;79139;79581;1585;4609;100533106;57152;340385;8000;83481;114788;51105;84875;29894;312;54108;441376;64798;29028;8629;23246;100132813;27085;100130274;105375787;51571;9897;286128;340359;3646;10584;169044;4856;137735;5168;3786;54742;65263;340371;4715;9699;84985;203054;84988;55039;90390;55074;22898;114907;111188157;8694;27161;286077;23414;642658;50626;81034;55630;340419;338328;137209;23639;57210;1807;169026;23513;83482;137797;93594;11236;9788;51236;8667;340393;22882;575;8323;6503;7553;7564;5339;414919;5885;84933;51160;2131;10656;56169;389692;84955;10086;5747;26873;727957;84232;93035;58500;8928;729330;4796;401474;4061;7201;157753;10221;57623;81501;9694;6641;50807;157769;79943;1537;284;3037;83940;6713;113655;157378;8840;66004;79792;441381;114;157638;80778;8733;432355;10397;9831;7264;54512;23167;51305;3297;56943;116447,194
-1,1,8,107032887,120742018,13709131,4982;114569;84955;27012;9166;55638;169026;90390;55074;93035;84294;8667;114788;3646;401474;7201;10584;7227;157753;4856;441376;137735;340419;9694;5885;5168;2131;284;56943;100132813,30
1,-1,8,107307812,107670002,362190,55074,1
1,-1,8,107307812,107670002,362190,55074,1
-1,1,8,111137305,119897611,8760306,114788;401474;169026;7227;441376;8667;90390;5885;84294;2131,10
1,-1,8,111730471,113110025,1379554,,0
-1,1,8,113540571,121095280,7554709,4982;114569;169026;6873;90390;8667;84294;114788;79075;401474;10584;7227;4856;441376;64798;5885;5168;2131,18
1,-1,8,114199992,114338391,138399,114788,1
1,-1,8,114199992,114338391,138399,114788,1
1,-1,8,114236551,114327680,91129,114788,1
-1,1,8,114430289,121987545,7557256,4982;114569;169026;6873;90390;7373;8667;84294;114788;79075;401474;10584;7227;4856;28998;441376;64798;6641;5885;5168;2131;27085,22
1,1,8,114853126,146295771,31442645,1584;114569;84948;137835;11156;93100;286053;225689;7373;8581;51059;2907;23237;2765;9684;55093;114822;642475;340390;6132;26233;90990;2875;654463;203062;1936;6482;4982;80728;51337;11244;23144;286075;84294;9401;28991;2843;22827;79075;7038;83696;389690;2738;28998;7227;375686;90987;5462;4062;65265;81858;6873;79139;79581;1585;4609;100533106;57152;340385;8000;83481;51105;84875;29894;312;54108;441376;64798;29028;8629;23246;27085;100130274;105375787;51571;9897;286128;340359;10584;169044;4856;5168;3786;54742;65263;340371;4715;84985;203054;84988;55039;90390;22898;111188157;114907;8694;27161;286077;642658;50626;55630;338328;137209;23639;57210;169026;23513;83482;137797;93594;11236;9788;51236;8667;340393;22882;575;6503;7553;7564;5339;414919;5885;84933;51160;2131;10656;56169;389692;10086;5747;26873;727957;84232;58500;8928;729330;4796;401474;4061;10221;57623;6641;50807;157769;79943;1537;3037;83940;6713;113655;157378;8840;66004;79792;441381;114;157638;80778;8733;432355;10397;9831;7264;54512;23167;51305;3297;116447,169
-1,1,8,114945534,123633980,8688446,4982;114569;169026;6873;90390;7373;8667;84294;3037;79075;401474;10584;7227;4856;28998;441376;64798;6641;5885;5168;2131;27085,22
1,-1,8,115343313,116112199,768886,,0
-1,1,8,115573009,123606341,8033332,4982;114569;169026;6873;90390;7373;8667;84294;3037;79075;401474;10584;7227;4856;28998;441376;64798;6641;5885;5168;2131;27085,22
-1,1,8,115656140,116918407,1262267,7227,1
-1,1,8,116413559,116514256,100697,7227,1
-1,1,8,116902507,118942698,2040191,90390;5885;84294;169026;2131;441376;8667,7
-1,1,8,118421576,118892037,470461,2131;90390,2
-1,1,8,118796828,118890987,94159,2131,1
1,-1,8,122910974,123398080,487106,,0
1,1,8,123466631,129525322,6058691,83940;6713;11244;4715;157378;84985;9897;93594;286053;79139;55039;11236;9788;114907;157638;4609;100533106;340359;22882;312;55093;10221;29028;84933;5462;137209;157769;654463,28
1,1,8,123466631,129525322,6058691,83940;6713;11244;4715;157378;84985;9897;93594;286053;79139;55039;11236;9788;114907;157638;4609;100533106;340359;22882;312;55093;10221;29028;84933;5462;137209;157769;654463,28
1,1,8,125510739,146294098,20783359,1584;84948;137835;11156;93100;286053;225689;8581;51059;2907;23237;2765;9684;114822;642475;340390;6132;26233;90990;2875;203062;1936;6482;80728;51337;23144;286075;9401;28991;2843;22827;7038;83696;389690;2738;375686;90987;5462;4062;65265;81858;79581;1585;4609;57152;340385;8000;83481;51105;84875;29894;54108;8629;23246;100130274;105375787;51571;9897;286128;169044;54742;3786;65263;340371;4715;203054;84988;22898;111188157;8694;27161;286077;642658;50626;55630;338328;23639;137209;57210;23513;83482;137797;9788;51236;340393;575;6503;7553;7564;5339;414919;51160;10656;56169;389692;10086;5747;26873;727957;84232;58500;8928;729330;4796;4061;10221;57623;50807;79943;1537;83940;6713;113655;8840;66004;79792;441381;114;157638;80778;8733;432355;10397;9831;7264;54512;23167;51305;3297;116447,130
1,1,8,125526331,146280020,20753689,1584;84948;137835;11156;93100;286053;225689;8581;51059;2907;23237;2765;9684;114822;642475;340390;6132;26233;90990;2875;203062;1936;6482;80728;51337;23144;286075;9401;28991;2843;22827;7038;83696;389690;2738;375686;90987;5462;4062;65265;81858;79581;1585;4609;57152;340385;8000;83481;51105;84875;29894;54108;8629;23246;100130274;105375787;51571;9897;286128;169044;54742;3786;65263;340371;4715;203054;84988;22898;111188157;8694;27161;286077;642658;50626;55630;338328;23639;137209;57210;23513;83482;137797;9788;51236;340393;575;6503;7553;7564;5339;414919;51160;10656;56169;389692;10086;5747;26873;727957;84232;58500;8928;729330;4796;4061;10221;57623;50807;79943;1537;83940;6713;113655;8840;66004;79792;441381;114;157638;80778;8733;432355;10397;9831;7264;54512;23167;51305;3297;116447,130
-1,1,8,127638606,144388560,16749954,1584;56169;10086;5747;137835;11156;22898;111188157;1585;4609;27161;57152;729330;51059;8000;8581;51105;23237;4061;2765;54108;57623;50807;338328;8629;23639;57210;79943;203062;6482;51337;105375787;8840;51571;137797;66004;286128;54742;114;2843;7038;83696;575;6503;389690;10397;10656;169044;432355;2738;23167;51305;5462;4062;3786,55
1,1,8,131127764,142238309,11110545,6482;10086;5747;8840;137835;22898;114;27161;729330;51059;7038;83696;51105;6503;10397;10656;169044;54108;57623;23167;50807;51305;23639;57210;3786,25
1,1,8,131127764,142238309,11110545,6482;10086;5747;8840;137835;22898;114;27161;729330;51059;7038;83696;51105;6503;10397;10656;169044;54108;57623;23167;50807;51305;23639;57210;3786,25
1,1,8,131651428,146294098,14642670,65263;1584;340371;84948;137835;11156;93100;225689;203054;84988;22898;111188157;8694;8581;27161;286077;51059;2907;642658;50626;23237;2765;9684;55630;114822;642475;340390;6132;26233;338328;23639;90990;2875;57210;203062;1936;6482;80728;51337;23144;286075;23513;83482;137797;340393;51236;9401;28991;2843;22827;7038;83696;575;389690;2738;6503;7553;7564;5339;414919;375686;90987;3786;51160;4062;10656;65265;389692;10086;81858;5747;26873;727957;84232;79581;1585;57152;58500;8928;340385;8000;729330;4796;83481;116447;51105;84875;29894;4061;54108;57623;8629;79943;23246;1537;113655;100130274;105375787;8840;66004;79792;286128;441381;114;80778;8733;432355;10397;169044;9831;7264;54512;23167;51305;3297;54742,116
1,1,8,131651428,146294098,14642670,65263;1584;340371;84948;137835;11156;93100;225689;203054;84988;22898;111188157;8694;8581;27161;286077;51059;2907;642658;50626;23237;2765;9684;55630;114822;642475;340390;6132;26233;338328;23639;90990;2875;57210;203062;1936;6482;80728;51337;23144;286075;23513;83482;137797;340393;51236;9401;28991;2843;22827;7038;83696;575;389690;2738;6503;7553;7564;5339;414919;375686;90987;3786;51160;4062;10656;65265;389692;10086;81858;5747;26873;727957;84232;79581;1585;57152;58500;8928;340385;8000;729330;4796;83481;116447;51105;84875;29894;4061;54108;57623;8629;79943;23246;1537;113655;100130274;105375787;8840;66004;79792;286128;441381;114;80778;8733;432355;10397;169044;9831;7264;54512;23167;51305;3297;54742,116
1,1,8,131682563,146280020,14597457,65263;1584;340371;84948;137835;11156;93100;225689;203054;84988;22898;111188157;8694;8581;27161;286077;51059;2907;642658;50626;23237;2765;9684;55630;114822;642475;340390;6132;26233;338328;23639;90990;2875;57210;203062;1936;6482;80728;51337;23144;286075;23513;83482;137797;340393;51236;9401;28991;2843;22827;7038;83696;575;389690;2738;6503;7553;7564;5339;414919;375686;90987;3786;51160;4062;10656;65265;389692;10086;81858;5747;26873;727957;84232;79581;1585;57152;58500;8928;340385;8000;729330;4796;83481;116447;51105;84875;29894;4061;54108;57623;8629;79943;23246;1537;113655;100130274;105375787;8840;66004;79792;286128;441381;114;80778;8733;432355;10397;169044;9831;7264;54512;23167;51305;3297;54742,116
1,-1,8,132479568,132691028,211460,,0
1,-1,8,132495510,132566500,70990,,0
1,1,8,134825277,146280828,11455551,65263;1584;340371;84948;11156;93100;225689;203054;84988;22898;111188157;8694;8581;27161;286077;51059;2907;642658;50626;23237;2765;9684;55630;114822;642475;340390;6132;26233;338328;90990;2875;57210;203062;1936;80728;51337;23144;286075;23513;83482;137797;340393;51236;9401;28991;2843;22827;83696;575;389690;2738;7553;7564;5339;414919;375686;90987;51160;4062;10656;65265;389692;5747;81858;26873;727957;84232;79581;1585;57152;58500;8928;340385;8000;4796;116447;83481;84875;29894;4061;54108;57623;8629;79943;23246;1537;113655;100130274;105375787;66004;79792;286128;441381;80778;8733;432355;169044;9831;7264;54512;51305;3297;54742,103
-1,-1,8,137693266,137862182,168916,,0
1,-1,8,140323438,140399311,75873,,0
-1,1,8,142764538,145195510,2430972,65263;1584;389692;340371;26873;84948;81858;93100;225689;84232;111188157;1585;57152;8581;116447;286077;8000;2907;83481;23237;84875;4061;2765;114822;642475;340390;338328;8629;79943;1537;203062;1936;51337;100130274;23144;286075;23513;137797;66004;79792;286128;51236;22827;8733;575;432355;2738;9831;7264;5339;54512;375686;4062;54742,54
-1,1,8,143282829,145076898,1794069,65263;1584;389692;340371;84948;93100;225689;111188157;1585;57152;8581;116447;286077;8000;2907;83481;23237;84875;4061;2765;114822;642475;338328;8629;79943;203062;1936;51337;100130274;23144;286075;23513;137797;66004;79792;286128;22827;575;432355;2738;9831;7264;5339;4062;54742,45
-1,-1,8,144589991,144645202,55211,79792;23144,2
1,-1,8,145319810,145493555,173745,642658;23246,2
1,-1,8,145319810,145493555,173745,642658;23246,2
-1,-1,8,145319810,145893555,573745,80728;3297;113655;83482;203054;84988;441381;79581;340393;9401;8694;8928;4796;642658;50626;29894;9684;55630;414919;26233;51160;90990;2875;23246,24
1,-1,8,145694369,145760629,66260,80728;113655;9684;84988;414919;441381;9401;90990;2875;8928,10
-1,-1,8,146151358,146280020,128662,65265;7564,2
-1,-1,8,146151358,146280020,128662,65265;7564,2
1,-1,8,146161039,146274835,113796,7564,1
-1,-1,8,146193902,146218230,24328,,0
-1,-1,8,146197628,146222731,25103,,0
-1,-1,8,146218173,146274890,56717,,0
-1,-1,8,146222563,146235420,12857,,0
-1,-1,8,146222672,146231912,9240,,0
-1,-1,8,146222672,146231912,9240,,0
-1,-1,8,146222672,146231912,9240,,0
-1,-1,8,146222672,146231912,9240,,0
-1,-1,8,146222672,146231912,9240,,0
-1,-1,8,146222672,146231912,9240,,0
-1,-1,8,146222672,146231912,9240,,0
-1,-1,8,146222672,146231912,9240,,0
-1,-1,8,146222672,146231912,9240,,0
-1,-1,8,146222672,146231912,9240,,0
-1,-1,8,146222672,146231912,9240,,0
-1,-1,8,146224004,146231912,7908,,0
-1,1,9,12934,2790382,2777448,100287171;58524;81704;23189;169522;55871;6595;10655;7436;1761;2298;157983,12
1,1,9,12934,19777918,19764984,58524;10171;23081;55664;50808;158358;100287171;203238;23189;5789;54796;286343;55667;158326;55064;29126;2315;5991;6456;340481;26953;90865;3717;123;157983;3641;7306;403313;169522;158219;6595;79956;2731;92949;10670;89882;9350;340485;2298;6619;81704;158297;6194;6019;1761;169792;6505;54801;4781;100129385;11168;8777;7436;90871;54875;6013;25769;57589;55871;115426;9933;55848;11172;10655;80380,65
1,1,9,12934,65482544,65469610,58524;10171;55664;23586;92014;3439;100129669;51754;100287171;79269;10210;2189;6461;79937;25853;7094;54796;158326;55064;4712;84688;2315;6366;5991;6456;51510;1211;26953;3717;10488;2592;3444;55833;971;157983;3641;7306;23349;25822;158219;286319;79956;55958;3443;64922;2731;253650;1271;10280;79886;27240;100129969;7415;84720;56656;10020;27290;7016;5646;4300;9350;54914;340485;6363;10850;730112;2298;26267;11258;3442;881;81704;3452;158038;7169;347252;6019;347240;169792;6505;26149;203259;138715;54801;10497;4781;3447;727830;728577;441430;8777;51271;158234;7436;90871;3448;3590;25769;338376;646962;573;647060;360;3456;55848;768;152006;10655;80380;27019;30968;2683;54926;203260;23081;50808;57462;56832;389730;259308;5079;158358;401494;392309;401505;203238;54586;23189;730098;9853;5789;3301;54840;80256;286343;55667;1993;29126;340481;3441;90865;123;63951;138716;3449;55234;403313;169522;1030;9373;6595;3467;65083;441459;219;92949;3445;1029;4882;10670;4799;89882;8434;4507;364;9380;375704;203228;84904;727905;9925;6619;26206;7010;51010;441425;9827;158297;3440;6194;3446;64425;1761;100129385;11168;392307;3451;54875;57704;9833;6013;138724;138474;57589;80173;48;55871;115426;158376;84186;79817;9933;692094;84681;11172;152007;22844;318;401498,209
1,1,9,12934,141153431,141140497,10171;29952;10422;158293;54863;84960;360203;92014;138240;54886;2220;441478;79937;81605;1164;644019;2800;55064;7743;399665;56654;138241;2395;4686;89891;2315;79695;5991;389792;389761;643596;51510;195828;2733;80709;10488;1056;375748;971;286362;10927;157983;392390;140459;286319;79956;114987;25;79886;6709;100129969;7415;7088;7185;27290;7016;5646;81873;10773;8022;83549;6256;6363;6621;57864;55342;375775;138804;26267;23230;3442;84929;81704;8021;6019;169792;9719;153090;29989;10497;4781;2040;51271;158234;653427;4783;84895;90871;10244;1384;3590;25769;158471;65268;54829;552891;7091;347148;3456;195827;10555;203197;80380;1955;51104;50808;8727;229;5887;259308;3190;51531;392309;158131;114789;23424;5537;10507;9853;158046;8395;7633;286343;548645;286336;100132403;7186;11092;441476;3441;94107;445571;5524;55234;169522;883;8518;728747;64855;5774;1029;56254;89882;6835;23137;54881;9380;11064;11091;375704;84270;5069;25920;9925;5900;79048;9615;138311;9827;80142;84302;23413;84131;79813;1761;7357;138429;401546;138805;10439;1757;64768;51280;54875;116225;9833;3293;26130;11093;210;115426;158376;79817;84681;4593;203286;23446;25792;642968;138162;401498;58524;9328;55664;8577;138151;728489;3439;84263;29988;51754;83543;286257;254956;5535;7094;90678;4712;27158;389762;220869;7539;26248;10558;401563;3444;22845;7306;6838;100526694;55958;3443;203328;64922;1515;301;51116;138883;254973;51450;23637;2356;10585;730112;22927;9022;27348;84814;54566;158405;116443;56623;7248;203259;54801;728577;3447;4702;727830;81932;55582;26737;23203;54534;91373;58499;727800;85365;92714;647060;360;169611;768;152006;401548;28989;85014;29991;10912;80010;203260;158399;57171;7295;158062;25934;389730;5079;158358;286204;84641;203238;54107;392392;57706;89853;730098;645961;9329;54840;5568;23731;2649;2902;29126;55312;11046;445815;6887;401565;90865;83744;2844;123;9830;3449;23511;26995;9373;3467;441457;55357;10952;441459;286256;157927;59335;92949;91283;51552;158135;9550;57720;10319;4799;8434;7410;2176;1025;2790;203228;727905;56033;51117;254295;1612;26206;6850;733;441425;29085;5082;7111;9991;53358;90120;3446;5998;100129385;286365;158056;11168;26301;2776;445;56751;57704;54187;570;6013;23245;57589;80173;92400;392399;22954;55871;402381;9933;54932;23196;9314;3371;2218;347273;7099;23071;11217;6136;375743;55151;2889;116224;10592;158067;23299;389799;26578;286380;100287171;79269;10210;4915;1759;51148;2189;6461;54796;9536;158248;1842;10444;158326;6096;84688;10541;158431;727;3309;23452;6456;1211;27130;3717;9919;389812;140803;2592;55833;259;23349;320;158219;2731;253650;1271;10280;27090;27240;10020;56656;216;9568;54461;1903;9350;1306;340485;10850;2298;881;100499483;2934;8721;7169;158038;55363;158427;84726;79987;64420;26149;255220;375759;653404;8555;401562;441430;441452;8777;55335;6837;7436;392391;338376;138065;573;25861;10807;55848;23099;2021;51759;55014;64975;10868;158158;27019;30968;2683;54926;9413;22869;774;5695;158055;401494;2650;5711;401505;23189;26735;138802;246184;687;80256;9414;26012;1993;203245;286207;169693;401551;80036;54942;83856;54542;138716;138881;549;100505993;403313;10880;9128;401541;6595;84253;65083;347168;169714;219;442425;84210;27433;138428;50514;10783;10670;26190;954;138255;5005;60560;8939;23064;401535;114299;2022;11224;51162;64078;4969;26147;158297;3440;9442;2619;286205;389816;23670;5047;5727;92715;203;3934;11182;3451;158401;9630;84909;5090;256691;6130;375791;5730;11172;152007;22844;389763;5253;389766;4851;138199;5004;10881;23586;138803;57109;3933;54754;100129669;3376;1317;26219;23307;8636;55071;81689;54769;8013;9355;25853;85301;5239;84628;2801;89958;6812;23392;6366;2516;56262;11253;26953;56904;11094;138799;3641;25822;7507;1318;389813;114991;84267;58493;157922;6836;84720;117531;26165;4300;445577;80318;23287;5742;54914;100505478;4958;169834;11258;8328;3452;257019;23552;55755;347252;4920;347240;9858;6505;2219;138715;256158;138307;20;29941;10044;3448;79670;7464;7046;138639;8818;646962;142680;375757;392376;1620;10655;79109;64794;23081;414328;6834;57462;64170;56832;6418;92399;347169;55035;9649;54586;84885;5789;3301;55667;349334;5125;286262;7270;89846;2529;26740;29968;29882;340481;8789;2304;23048;51490;113220;63951;414332;286234;26468;28;389827;1030;57684;4957;2203;54662;7763;3445;169436;1902;79095;4882;4814;22949;10811;1514;4507;364;29979;138882;54836;1621;84904;19;6619;7010;51010;54981;8019;23732;6194;10999;30815;1289;377841;1539;64425;169841;55684;403341;10383;944;26086;392307;57582;1861;138724;138474;286223;257169;4010;23404;48;84186;692094;9966;318,754
-1,1,9,12993,9904905,9891912,58524;10171;23081;55664;89882;50808;158358;2298;100287171;81704;23189;5789;6019;1761;169792;55064;6505;29126;2315;5991;26953;90865;7436;3717;90871;6013;57589;157983;3641;403313;169522;55871;115426;6595;79956;9933;2731;55848;11172;10655;80380,41
1,-1,9,13997,118241,104244,100287171;2298,2
1,1,9,13997,70919878,70905881,58524;10171;55664;23586;92014;3439;100129669;51754;286380;100287171;79269;10210;2189;6461;79937;25853;7094;54796;644019;158326;55064;4712;84688;2315;6366;220869;5991;6456;51510;1211;26953;3717;10488;2592;3444;55833;971;157983;3641;7306;23349;25822;158219;286319;79956;55958;3443;64922;2731;253650;1271;10280;79886;27240;100129969;7415;84720;56656;10020;27290;7016;5646;26165;4300;9350;54914;340485;6363;10850;730112;2298;26267;11258;3442;881;81704;3452;158038;7169;347252;6019;347240;169792;6505;26149;203259;138715;54801;10497;4781;3447;727830;728577;653404;441430;8777;51271;158234;653427;7436;90871;3448;3590;25769;338376;646962;573;647060;360;3456;55848;768;152006;10655;80380;27019;30968;2683;54926;203260;23081;50808;57462;56832;389730;259308;5079;158358;401494;392309;401505;203238;54586;23189;730098;9853;5789;3301;54840;80256;286343;55667;349334;1993;29126;340481;3441;90865;123;445571;63951;138716;3449;55234;403313;169522;1030;9373;6595;3467;65083;441459;728747;219;92949;3445;1029;84210;4882;10670;4799;89882;8434;4507;364;9380;375704;203228;84904;727905;9925;6619;26206;7010;51010;441425;9827;158297;3440;6194;3446;64425;1761;100129385;11168;392307;3451;54875;57704;9833;6013;138724;138474;57589;80173;48;55871;115426;158376;84186;79817;9933;692094;84681;11172;152007;22844;318;401498,219
1,1,9,13997,71015981,71001984,58524;10171;55664;23586;92014;3439;100129669;51754;286380;100287171;79269;10210;2189;6461;79937;25853;7094;54796;5239;644019;158326;55064;4712;84688;2315;6366;220869;5991;6456;51510;1211;26953;3717;10488;2592;3444;55833;971;157983;3641;7306;23349;25822;158219;286319;79956;55958;3443;64922;2731;253650;1271;10280;79886;27240;100129969;7415;84720;56656;10020;27290;7016;5646;26165;4300;9350;54914;340485;6363;10850;730112;2298;26267;11258;3442;881;81704;3452;158038;7169;347252;6019;347240;169792;6505;26149;203259;138715;54801;10497;4781;3447;727830;728577;653404;441430;8777;51271;158234;653427;7436;90871;3448;3590;25769;338376;646962;573;647060;360;3456;55848;768;152006;10655;80380;27019;30968;2683;54926;203260;23081;50808;57462;56832;389730;259308;5079;158358;401494;392309;401505;203238;54586;23189;730098;9853;5789;3301;54840;80256;286343;55667;349334;1993;29126;340481;3441;90865;123;445571;63951;138716;3449;55234;403313;169522;1030;9373;6595;3467;65083;441459;728747;219;92949;3445;1029;84210;4882;10670;4799;89882;8434;4507;364;9380;375704;203228;84904;727905;9925;6619;26206;7010;51010;441425;9827;158297;3440;6194;3446;64425;1761;100129385;11168;392307;3451;54875;57704;9833;6013;138724;138474;57589;80173;48;55871;115426;158376;84186;79817;9933;692094;84681;11172;152007;22844;318;401498,220
1,1,9,32396,39140211,39107815,58524;10171;55664;23586;92014;3439;100129669;51754;79269;10210;2189;6461;79937;25853;7094;54796;158326;55064;4712;84688;2315;6366;5991;6456;51510;1211;26953;3717;10488;2592;3444;55833;971;157983;3641;7306;23349;25822;158219;286319;79956;55958;3443;64922;2731;253650;1271;10280;79886;27240;100129969;7415;84720;56656;10020;27290;7016;5646;4300;9350;54914;340485;6363;10850;730112;2298;26267;11258;3442;881;81704;3452;158038;7169;347252;6019;347240;169792;6505;203259;138715;54801;10497;4781;3447;8777;51271;158234;7436;90871;3448;3590;25769;338376;646962;573;360;3456;55848;768;152006;10655;80380;27019;30968;2683;54926;203260;23081;50808;57462;56832;259308;5079;158358;401494;392309;401505;203238;54586;23189;730098;9853;5789;3301;54840;80256;286343;55667;1993;29126;340481;3441;90865;123;63951;138716;3449;55234;403313;169522;1030;9373;6595;3467;65083;441459;219;92949;3445;1029;4882;10670;4799;89882;8434;4507;364;9380;375704;203228;84904;9925;6619;26206;7010;51010;9827;158297;3440;6194;3446;64425;1761;100129385;11168;392307;3451;54875;57704;9833;6013;138724;138474;57589;80173;48;55871;115426;158376;84186;79817;9933;692094;84681;11172;152007;22844;318;401498,200
1,1,9,62525,141006407,140943882,10171;29952;10422;158293;54863;84960;360203;92014;138240;54886;2220;441478;79937;81605;1164;644019;2800;55064;7743;399665;56654;138241;2395;4686;89891;2315;79695;5991;389792;389761;643596;51510;195828;2733;80709;10488;1056;375748;971;286362;10927;157983;392390;140459;286319;79956;114987;25;79886;6709;100129969;7415;7088;7185;27290;7016;5646;81873;10773;8022;83549;6256;6363;6621;57864;55342;375775;138804;26267;23230;3442;84929;81704;8021;6019;169792;9719;153090;29989;10497;4781;2040;51271;158234;653427;4783;84895;90871;10244;1384;3590;25769;158471;65268;54829;552891;7091;347148;3456;195827;10555;203197;80380;1955;51104;50808;8727;229;5887;259308;3190;51531;392309;158131;114789;23424;5537;10507;9853;158046;8395;7633;286343;548645;286336;7186;11092;441476;3441;94107;445571;5524;55234;169522;883;8518;728747;64855;5774;1029;56254;89882;6835;23137;54881;9380;11064;11091;375704;84270;5069;25920;9925;5900;79048;9615;138311;9827;80142;84302;23413;84131;79813;1761;7357;138429;401546;138805;10439;1757;64768;51280;54875;116225;9833;3293;26130;11093;210;115426;158376;79817;84681;4593;203286;23446;25792;642968;138162;401498;58524;9328;55664;8577;138151;728489;3439;84263;29988;51754;83543;286257;254956;5535;7094;90678;4712;27158;389762;220869;7539;26248;10558;401563;3444;22845;7306;6838;100526694;55958;3443;203328;64922;1515;301;51116;138883;254973;51450;23637;2356;10585;730112;22927;9022;27348;84814;54566;158405;116443;56623;7248;203259;54801;728577;3447;4702;727830;81932;55582;26737;23203;54534;91373;58499;727800;85365;92714;647060;360;169611;768;152006;401548;28989;85014;29991;10912;80010;203260;158399;57171;7295;158062;25934;389730;5079;158358;286204;84641;203238;54107;392392;57706;89853;730098;645961;9329;54840;5568;23731;2649;2902;29126;55312;11046;445815;6887;401565;90865;83744;2844;123;9830;3449;23511;26995;9373;3467;441457;55357;10952;441459;286256;157927;59335;92949;91283;51552;158135;9550;57720;10319;4799;8434;7410;2176;1025;2790;203228;727905;56033;51117;254295;1612;26206;6850;733;441425;29085;5082;7111;9991;53358;90120;3446;5998;100129385;286365;158056;11168;26301;2776;445;56751;57704;54187;570;6013;23245;57589;80173;92400;392399;22954;55871;402381;9933;54932;23196;9314;3371;2218;347273;7099;23071;11217;6136;375743;55151;2889;116224;10592;158067;23299;389799;26578;286380;79269;10210;4915;1759;51148;2189;6461;54796;9536;158248;1842;10444;158326;6096;84688;10541;158431;727;3309;23452;6456;1211;27130;3717;9919;389812;140803;2592;55833;259;23349;320;158219;2731;253650;1271;10280;27090;27240;10020;56656;216;9568;54461;1903;9350;1306;340485;10850;2298;881;100499483;2934;8721;7169;158038;55363;158427;84726;79987;64420;26149;255220;375759;653404;8555;401562;441430;441452;8777;55335;6837;7436;392391;338376;138065;573;25861;10807;55848;23099;2021;51759;55014;64975;10868;158158;27019;30968;2683;54926;9413;22869;774;5695;158055;401494;2650;5711;401505;23189;26735;138802;246184;687;80256;9414;26012;1993;203245;286207;169693;401551;80036;54942;83856;54542;138716;138881;549;100505993;403313;10880;9128;401541;6595;84253;65083;347168;169714;219;442425;84210;27433;138428;50514;10783;10670;26190;954;138255;5005;60560;8939;23064;401535;114299;2022;11224;51162;64078;4969;26147;158297;3440;9442;2619;286205;389816;23670;5047;5727;92715;203;3934;11182;3451;158401;9630;84909;5090;256691;6130;375791;5730;11172;152007;22844;389763;5253;389766;4851;138199;5004;10881;23586;138803;57109;3933;54754;100129669;3376;1317;26219;23307;8636;55071;81689;54769;8013;9355;25853;85301;5239;84628;2801;89958;6812;23392;6366;2516;56262;11253;26953;56904;11094;138799;3641;25822;7507;1318;389813;114991;84267;58493;157922;6836;84720;117531;26165;4300;445577;80318;23287;5742;54914;100505478;4958;169834;11258;8328;3452;257019;23552;55755;347252;4920;347240;9858;6505;2219;138715;256158;138307;20;29941;10044;3448;79670;7464;7046;138639;8818;646962;142680;375757;392376;1620;10655;79109;64794;23081;414328;6834;57462;64170;56832;6418;92399;347169;55035;9649;54586;84885;5789;3301;55667;349334;5125;286262;7270;89846;2529;26740;29968;29882;340481;8789;2304;23048;51490;113220;63951;414332;286234;26468;28;389827;1030;57684;4957;2203;54662;7763;3445;169436;1902;79095;4882;4814;22949;10811;1514;4507;364;29979;138882;54836;1621;84904;19;6619;7010;51010;54981;8019;23732;6194;10999;30815;1289;377841;1539;64425;169841;55684;403341;10383;944;26086;392307;57582;1861;138724;138474;286223;257169;4010;23404;48;84186;692094;9966;318,752
1,-1,9,118241,166977,48736,2298;55871,2
-1,-1,9,118241,166977,48736,2298;55871,2
-1,-1,9,118241,166977,48736,2298;55871,2
-1,-1,9,118241,166977,48736,2298;55871,2
1,-1,9,118241,166977,48736,2298;55871,2
-1,-1,9,118241,213161,94920,2298;55871;157983,3
1,-1,9,163131,271257,108126,81704;157983;55871,3
-1,1,9,185579,7635806,7450227,58524;10171;23081;55664;89882;50808;158358;81704;23189;6019;1761;169792;55064;6505;29126;2315;5991;26953;90865;7436;3717;6013;57589;157983;3641;403313;169522;115426;6595;79956;9933;2731;55848;11172;10655;80380,36
-1,1,9,204090,4681722,4477632,58524;55664;5991;7436;6505;157983;81704;23189;169522;403313;1761;6595;9933;10655;169792;55064,16
1,1,9,203861,378086,174225,81704;157983,2
-1,1,9,203861,4585050,4381189,58524;81704;23189;169522;5991;6595;9933;10655;7436;1761;169792;6505;157983,13
-1,1,9,203861,5081516,4877655,58524;10171;55664;5991;50808;10655;7436;3717;6505;157983;81704;23189;403313;169522;6595;9933;1761;169792;55064,19
-1,1,9,203861,5094461,4890600,58524;10171;55664;5991;50808;10655;7436;3717;6505;157983;81704;23189;403313;169522;6595;9933;1761;169792;55064,19
-1,1,9,203861,5909152,5705291,58524;10171;29126;2315;55664;5991;50808;10655;7436;3717;6505;6013;57589;157983;3641;81704;23189;403313;169522;6595;79956;9933;6019;55848;11172;1761;169792;55064;80380,29
-1,1,9,203861,8172957,7969096,58524;10171;23081;55664;89882;50808;158358;81704;23189;6019;1761;169792;55064;6505;29126;2315;5991;26953;90865;7436;3717;90871;6013;57589;157983;3641;403313;169522;115426;6595;79956;9933;2731;55848;11172;10655;80380,37
-1,1,9,203861,8735462,8531601,58524;10171;23081;55664;89882;50808;158358;81704;23189;5789;6019;1761;169792;55064;6505;29126;2315;5991;26953;90865;7436;3717;90871;6013;57589;157983;3641;403313;169522;115426;6595;79956;9933;2731;55848;11172;10655;80380,38
-1,1,9,203861,11414732,11210871,58524;10171;23081;55664;89882;50808;158358;81704;23189;5789;6019;1761;169792;55064;6505;29126;2315;5991;26953;90865;7436;3717;90871;6013;57589;157983;3641;403313;169522;115426;6595;79956;9933;2731;55848;11172;10655;80380,38
-1,1,9,203861,13486759,13282898,58524;10171;23081;55664;89882;50808;158358;81704;23189;5789;6019;286343;1761;169792;55064;6505;29126;2315;5991;8777;26953;90865;7436;3717;90871;6013;57589;157983;3641;7306;403313;169522;115426;6595;79956;9933;2731;55848;11172;10655;80380,41
-1,1,9,203861,14322268,14118407,58524;10171;23081;55664;89882;50808;158358;81704;23189;5789;6019;286343;1761;169792;55064;6505;29126;2315;4781;5991;8777;26953;90865;7436;3717;90871;6013;57589;157983;3641;7306;403313;169522;115426;6595;79956;9933;2731;55848;11172;10655;80380,42
-1,1,9,203861,15211277,15007416,58524;10171;23081;55664;89882;9350;50808;158358;81704;23189;5789;6019;286343;158326;1761;169792;55064;6505;29126;2315;4781;5991;8777;340481;26953;90865;7436;3717;90871;6013;57589;157983;3641;7306;403313;169522;158219;115426;6595;79956;9933;2731;55848;11172;10655;80380,46
-1,1,9,203861,16670878,16467017,58524;10171;23081;55664;89882;9350;50808;158358;6619;203238;81704;23189;5789;6019;54796;286343;158326;1761;169792;55064;6505;29126;2315;4781;11168;5991;100129385;8777;340481;26953;90865;7436;3717;90871;6013;57589;157983;3641;7306;403313;169522;158219;115426;6595;79956;9933;2731;55848;11172;10655;80380,51
-1,1,9,203861,16856907,16653046,58524;10171;23081;55664;89882;9350;50808;158358;6619;203238;81704;23189;5789;6019;54796;286343;158326;1761;169792;55064;6505;29126;2315;4781;11168;5991;100129385;8777;340481;26953;90865;7436;3717;90871;6013;57589;157983;3641;7306;403313;169522;158219;115426;6595;79956;9933;2731;55848;11172;10655;80380,51
-1,1,9,203861,16925108,16721247,58524;10171;23081;55664;89882;9350;50808;158358;6619;203238;81704;23189;5789;6019;54796;286343;158326;1761;169792;55064;6505;29126;2315;4781;11168;5991;100129385;8777;340481;26953;90865;7436;3717;90871;6013;57589;157983;3641;7306;403313;169522;158219;115426;6595;79956;9933;2731;55848;11172;10655;80380,51
-1,1,9,203861,17125893,16922032,58524;10171;23081;55664;89882;9350;50808;158358;6619;203238;81704;23189;5789;6019;54796;286343;158326;1761;169792;55064;6505;29126;2315;4781;11168;5991;100129385;8777;340481;26953;90865;7436;3717;90871;6013;57589;157983;3641;7306;403313;169522;158219;115426;6595;79956;9933;2731;55848;11172;10655;80380,51
-1,1,9,203861,17655298,17451437,58524;10171;23081;55664;89882;9350;50808;158358;6619;203238;81704;23189;5789;6019;54796;286343;158326;1761;169792;55064;6505;29126;2315;4781;11168;5991;100129385;8777;6456;340481;26953;90865;7436;3717;90871;54875;6013;57589;157983;3641;7306;403313;169522;158219;115426;6595;79956;9933;2731;55848;11172;10655;80380,53
1,1,9,203861,31423871,31220010,58524;10171;23081;55664;50808;56832;3439;100129669;158358;401494;203238;54586;23189;5789;54796;286343;55667;158326;55064;1993;29126;2315;5991;6456;340481;26953;3441;3717;90865;123;3444;63951;3449;157983;3641;7306;158219;403313;169522;1030;9373;286319;6595;79956;55958;3443;3467;64922;2731;79886;92949;3445;1029;4300;10670;89882;9350;4507;54914;340485;203228;3442;6619;7010;81704;3452;158038;158297;3440;6194;6019;3446;1761;169792;6505;54801;4781;3447;100129385;11168;8777;3451;7436;90871;3448;54875;6013;25769;338376;57589;80173;115426;79817;3456;9933;55848;11172;10655;80380,99
1,1,9,203861,38381639,38177778,58524;10171;55664;23586;92014;3439;100129669;51754;79269;10210;2189;6461;25853;7094;54796;158326;55064;4712;84688;2315;6366;5991;6456;51510;1211;26953;3717;10488;2592;3444;55833;971;157983;3641;7306;23349;25822;158219;286319;79956;55958;3443;64922;2731;1271;10280;79886;27240;100129969;7415;84720;56656;10020;27290;7016;5646;4300;9350;54914;340485;6363;10850;730112;26267;11258;3442;881;81704;3452;158038;7169;6019;347240;169792;6505;203259;138715;54801;10497;4781;3447;8777;51271;158234;7436;90871;3448;3590;25769;338376;646962;573;360;3456;55848;768;152006;10655;80380;27019;30968;2683;54926;203260;23081;50808;57462;56832;259308;5079;158358;401494;392309;401505;203238;54586;23189;730098;9853;5789;3301;54840;80256;286343;55667;1993;29126;340481;3441;90865;123;63951;138716;3449;55234;403313;169522;1030;9373;6595;3467;65083;441459;92949;3445;1029;4882;10670;4799;89882;8434;4507;364;9380;375704;203228;84904;9925;6619;26206;7010;51010;9827;158297;3440;6194;3446;64425;1761;100129385;11168;392307;3451;54875;57704;9833;6013;138724;138474;57589;80173;48;115426;158376;84186;79817;9933;692094;84681;11172;152007;22844;318;401498,194
1,1,9,203861,38787480,38583619,58524;10171;55664;23586;92014;3439;100129669;51754;79269;10210;2189;6461;25853;7094;54796;158326;55064;4712;84688;2315;6366;5991;6456;51510;1211;26953;3717;10488;2592;3444;55833;971;157983;3641;7306;23349;25822;158219;286319;79956;55958;3443;64922;2731;253650;1271;10280;79886;27240;100129969;7415;84720;56656;10020;27290;7016;5646;4300;9350;54914;340485;6363;10850;730112;26267;11258;3442;881;81704;3452;158038;7169;347252;6019;347240;169792;6505;203259;138715;54801;10497;4781;3447;8777;51271;158234;7436;90871;3448;3590;25769;338376;646962;573;360;3456;55848;768;152006;10655;80380;27019;30968;2683;54926;203260;23081;50808;57462;56832;259308;5079;158358;401494;392309;401505;203238;54586;23189;730098;9853;5789;3301;54840;80256;286343;55667;1993;29126;340481;3441;90865;123;63951;138716;3449;55234;403313;169522;1030;9373;6595;3467;65083;441459;219;92949;3445;1029;4882;10670;4799;89882;8434;4507;364;9380;375704;203228;84904;9925;6619;26206;7010;51010;9827;158297;3440;6194;3446;64425;1761;100129385;11168;392307;3451;54875;57704;9833;6013;138724;138474;57589;80173;48;115426;158376;84186;79817;9933;692094;84681;11172;152007;22844;318;401498,197
1,1,9,203861,38787480,38583619,58524;10171;55664;23586;92014;3439;100129669;51754;79269;10210;2189;6461;25853;7094;54796;158326;55064;4712;84688;2315;6366;5991;6456;51510;1211;26953;3717;10488;2592;3444;55833;971;157983;3641;7306;23349;25822;158219;286319;79956;55958;3443;64922;2731;253650;1271;10280;79886;27240;100129969;7415;84720;56656;10020;27290;7016;5646;4300;9350;54914;340485;6363;10850;730112;26267;11258;3442;881;81704;3452;158038;7169;347252;6019;347240;169792;6505;203259;138715;54801;10497;4781;3447;8777;51271;158234;7436;90871;3448;3590;25769;338376;646962;573;360;3456;55848;768;152006;10655;80380;27019;30968;2683;54926;203260;23081;50808;57462;56832;259308;5079;158358;401494;392309;401505;203238;54586;23189;730098;9853;5789;3301;54840;80256;286343;55667;1993;29126;340481;3441;90865;123;63951;138716;3449;55234;403313;169522;1030;9373;6595;3467;65083;441459;219;92949;3445;1029;4882;10670;4799;89882;8434;4507;364;9380;375704;203228;84904;9925;6619;26206;7010;51010;9827;158297;3440;6194;3446;64425;1761;100129385;11168;392307;3451;54875;57704;9833;6013;138724;138474;57589;80173;48;115426;158376;84186;79817;9933;692094;84681;11172;152007;22844;318;401498,197
1,1,9,203861,67983174,67779313,58524;10171;55664;23586;92014;3439;100129669;51754;79269;10210;2189;6461;79937;25853;7094;54796;158326;55064;4712;84688;2315;6366;5991;6456;51510;1211;26953;3717;10488;2592;3444;55833;971;157983;3641;7306;23349;25822;158219;286319;79956;55958;3443;64922;2731;253650;1271;10280;79886;27240;100129969;7415;84720;56656;10020;27290;7016;5646;26165;4300;9350;54914;340485;6363;10850;730112;26267;11258;3442;881;81704;3452;158038;7169;347252;6019;347240;169792;6505;26149;203259;138715;54801;10497;4781;3447;727830;728577;441430;8777;51271;158234;7436;90871;3448;3590;25769;338376;646962;573;647060;360;3456;55848;768;152006;10655;80380;27019;30968;2683;54926;203260;23081;50808;57462;56832;389730;259308;5079;158358;401494;392309;401505;203238;54586;23189;730098;9853;5789;3301;54840;80256;286343;55667;1993;29126;340481;3441;90865;123;63951;138716;3449;55234;403313;169522;1030;9373;6595;3467;65083;441459;219;92949;3445;1029;84210;4882;10670;4799;89882;8434;4507;364;9380;375704;203228;84904;727905;9925;6619;26206;7010;51010;441425;9827;158297;3440;6194;3446;64425;1761;100129385;11168;392307;3451;54875;57704;9833;6013;138724;138474;57589;80173;48;115426;158376;84186;79817;9933;692094;84681;11172;152007;22844;318;401498,208
1,1,9,203861,68188391,67984530,58524;10171;55664;23586;92014;3439;100129669;51754;79269;10210;2189;6461;79937;25853;7094;54796;158326;55064;4712;84688;2315;6366;5991;6456;51510;1211;26953;3717;10488;2592;3444;55833;971;157983;3641;7306;23349;25822;158219;286319;79956;55958;3443;64922;2731;253650;1271;10280;79886;27240;100129969;7415;84720;56656;10020;27290;7016;5646;26165;4300;9350;54914;340485;6363;10850;730112;26267;11258;3442;881;81704;3452;158038;7169;347252;6019;347240;169792;6505;26149;203259;138715;54801;10497;4781;3447;727830;728577;441430;8777;51271;158234;7436;90871;3448;3590;25769;338376;646962;573;647060;360;3456;55848;768;152006;10655;80380;27019;30968;2683;54926;203260;23081;50808;57462;56832;389730;259308;5079;158358;401494;392309;401505;203238;54586;23189;730098;9853;5789;3301;54840;80256;286343;55667;1993;29126;340481;3441;90865;123;63951;138716;3449;55234;403313;169522;1030;9373;6595;3467;65083;441459;219;92949;3445;1029;84210;4882;10670;4799;89882;8434;4507;364;9380;375704;203228;84904;727905;9925;6619;26206;7010;51010;441425;9827;158297;3440;6194;3446;64425;1761;100129385;11168;392307;3451;54875;57704;9833;6013;138724;138474;57589;80173;48;115426;158376;84186;79817;9933;692094;84681;11172;152007;22844;318;401498,208
1,1,9,203861,69002883,68799022,58524;10171;55664;23586;92014;3439;100129669;51754;79269;10210;2189;6461;79937;25853;7094;54796;158326;55064;4712;84688;2315;6366;5991;6456;51510;1211;26953;3717;10488;2592;3444;55833;971;157983;3641;7306;23349;25822;158219;286319;79956;55958;3443;64922;2731;253650;1271;10280;79886;27240;100129969;7415;84720;56656;10020;27290;7016;5646;26165;4300;9350;54914;340485;6363;10850;730112;26267;11258;3442;881;81704;3452;158038;7169;347252;6019;347240;169792;6505;26149;203259;138715;54801;10497;4781;3447;727830;728577;441430;8777;51271;158234;7436;90871;3448;3590;25769;338376;646962;573;647060;360;3456;55848;768;152006;10655;80380;27019;30968;2683;54926;203260;23081;50808;57462;56832;389730;259308;5079;158358;401494;392309;401505;203238;54586;23189;730098;9853;5789;3301;54840;80256;286343;55667;1993;29126;340481;3441;90865;123;63951;138716;3449;55234;403313;169522;1030;9373;6595;3467;65083;441459;219;92949;3445;1029;84210;4882;10670;4799;89882;8434;4507;364;9380;375704;203228;84904;727905;9925;6619;26206;7010;51010;441425;9827;158297;3440;6194;3446;64425;1761;100129385;11168;392307;3451;54875;57704;9833;6013;138724;138474;57589;80173;48;115426;158376;84186;79817;9933;692094;84681;11172;152007;22844;318;401498,208
1,1,9,203861,69002883,68799022,58524;10171;55664;23586;92014;3439;100129669;51754;79269;10210;2189;6461;79937;25853;7094;54796;158326;55064;4712;84688;2315;6366;5991;6456;51510;1211;26953;3717;10488;2592;3444;55833;971;157983;3641;7306;23349;25822;158219;286319;79956;55958;3443;64922;2731;253650;1271;10280;79886;27240;100129969;7415;84720;56656;10020;27290;7016;5646;26165;4300;9350;54914;340485;6363;10850;730112;26267;11258;3442;881;81704;3452;158038;7169;347252;6019;347240;169792;6505;26149;203259;138715;54801;10497;4781;3447;727830;728577;441430;8777;51271;158234;7436;90871;3448;3590;25769;338376;646962;573;647060;360;3456;55848;768;152006;10655;80380;27019;30968;2683;54926;203260;23081;50808;57462;56832;389730;259308;5079;158358;401494;392309;401505;203238;54586;23189;730098;9853;5789;3301;54840;80256;286343;55667;1993;29126;340481;3441;90865;123;63951;138716;3449;55234;403313;169522;1030;9373;6595;3467;65083;441459;219;92949;3445;1029;84210;4882;10670;4799;89882;8434;4507;364;9380;375704;203228;84904;727905;9925;6619;26206;7010;51010;441425;9827;158297;3440;6194;3446;64425;1761;100129385;11168;392307;3451;54875;57704;9833;6013;138724;138474;57589;80173;48;115426;158376;84186;79817;9933;692094;84681;11172;152007;22844;318;401498,208
1,1,9,203861,88189913,87986052,10171;375743;116224;92014;138240;26578;286380;79269;10210;4915;2189;6461;79937;54796;644019;158326;6096;55064;138241;2395;84688;2315;5991;389761;6456;51510;1211;3717;140803;10488;2592;55833;971;157983;23349;320;158219;286319;79956;2731;253650;1271;10280;79886;27240;100129969;7415;7088;10020;56656;216;27290;7016;5646;9350;340485;6363;10850;26267;881;3442;23230;81704;7169;158038;6019;169792;26149;10497;4781;653404;441430;8777;51271;158234;653427;7436;90871;3590;25769;338376;158471;573;7091;3456;55848;80380;158158;27019;30968;2683;54926;9413;51104;50808;259308;3190;401494;2650;392309;401505;23189;9853;687;8395;80256;9414;286343;1993;169693;3441;80036;445571;138716;55234;403313;169522;6595;65083;728747;219;442425;1029;84210;10670;89882;23137;138255;9380;375704;9925;64078;9615;9827;158297;3440;84131;1761;23670;3451;54875;9833;9630;256691;115426;158376;79817;84681;11172;152007;22844;389763;401498;58524;138199;55664;23586;3439;100129669;51754;55071;25853;7094;5239;4712;389762;220869;6366;26953;3444;3641;7306;25822;55958;3443;64922;84267;301;84720;117531;26165;4300;80318;23287;54914;730112;11258;3452;257019;347252;347240;6505;203259;138715;54801;728577;3447;727830;55582;3448;646962;647060;360;768;152006;10655;80010;203260;23081;414328;57462;56832;389730;5079;158358;203238;54586;730098;5789;3301;54840;55667;349334;5568;5125;29126;55312;29968;340481;90865;123;63951;3449;9373;1030;3467;441459;7763;92949;3445;4882;4799;8434;29979;4507;364;203228;84904;727905;6619;26206;7010;51010;441425;54981;6194;3446;64425;100129385;11168;2776;392307;57704;6013;138724;138474;57589;80173;48;84186;9933;692094;318,273
1,1,9,203861,90745359,90541498,10171;375743;116224;92014;138240;26578;286380;79269;10210;4915;2189;6461;79937;54796;644019;158326;6096;55064;138241;2395;84688;2315;5991;389761;6456;51510;1211;3717;140803;10488;2592;55833;971;157983;23349;320;158219;286319;79956;2731;253650;1271;10280;79886;27240;100129969;7415;7088;10020;56656;216;27290;7016;5646;9350;340485;6363;10850;26267;881;3442;23230;81704;7169;158038;6019;169792;26149;10497;4781;653404;441430;441452;8777;51271;158234;653427;7436;90871;3590;25769;338376;158471;573;7091;3456;55848;80380;158158;27019;30968;2683;54926;9413;51104;50808;259308;3190;401494;2650;392309;401505;23189;9853;687;8395;80256;9414;286343;1993;169693;3441;80036;445571;138716;55234;403313;169522;6595;65083;728747;219;442425;1029;84210;10670;89882;23137;138255;9380;60560;375704;9925;401535;64078;9615;9827;158297;3440;84131;2619;1761;23670;51280;3451;54875;9833;9630;256691;115426;158376;79817;84681;11172;152007;22844;389763;389766;401498;58524;138199;55664;23586;3439;100129669;51754;55071;81689;25853;7094;5239;4712;389762;220869;6366;26953;3444;3641;7306;25822;55958;3443;64922;84267;301;84720;117531;26165;4300;80318;23287;54914;730112;11258;3452;257019;23552;347252;347240;6505;203259;138715;54801;728577;3447;727830;55582;3448;79670;646962;647060;360;768;152006;10655;80010;203260;23081;414328;57462;56832;389730;5079;158358;203238;54586;730098;645961;5789;3301;54840;55667;349334;5568;5125;29126;55312;29968;340481;90865;123;63951;3449;286234;9373;1030;3467;441459;7763;92949;3445;4882;4799;8434;1514;4507;364;29979;203228;84904;727905;1612;6619;26206;7010;51010;441425;54981;6194;3446;64425;100129385;11168;2776;392307;57704;6013;138724;138474;57589;80173;48;84186;9933;692094;318,286
1,1,9,203861,141020389,140816528,10171;29952;10422;158293;54863;84960;360203;92014;138240;54886;2220;441478;79937;81605;1164;644019;2800;55064;7743;399665;56654;138241;2395;4686;89891;2315;79695;5991;389792;389761;643596;51510;195828;2733;80709;10488;1056;375748;971;286362;10927;157983;392390;140459;286319;79956;114987;25;79886;6709;100129969;7415;7088;7185;27290;7016;5646;81873;10773;8022;83549;6256;6363;6621;57864;55342;375775;138804;26267;23230;3442;84929;81704;8021;6019;169792;9719;153090;29989;10497;4781;2040;51271;158234;653427;4783;84895;90871;10244;1384;3590;25769;158471;65268;54829;552891;7091;347148;3456;195827;10555;203197;80380;1955;51104;50808;8727;229;5887;259308;3190;51531;392309;158131;114789;23424;5537;10507;9853;158046;8395;7633;286343;548645;286336;7186;11092;441476;3441;94107;445571;5524;55234;169522;883;8518;728747;64855;5774;1029;56254;89882;6835;23137;54881;9380;11064;11091;375704;84270;5069;25920;9925;5900;79048;9615;138311;9827;80142;84302;23413;84131;79813;1761;7357;138429;401546;138805;10439;1757;64768;51280;54875;116225;9833;3293;26130;11093;210;115426;158376;79817;84681;4593;203286;23446;25792;642968;138162;401498;58524;9328;55664;8577;138151;728489;3439;84263;29988;51754;83543;286257;254956;5535;7094;90678;4712;27158;389762;220869;7539;26248;10558;401563;3444;22845;7306;6838;100526694;55958;3443;203328;64922;1515;301;51116;138883;254973;51450;23637;2356;10585;730112;22927;9022;27348;84814;54566;158405;116443;56623;7248;203259;54801;728577;3447;4702;727830;81932;55582;26737;23203;54534;91373;58499;727800;85365;92714;647060;360;169611;768;152006;401548;28989;85014;29991;10912;80010;203260;158399;57171;7295;158062;25934;389730;5079;158358;286204;84641;203238;54107;392392;57706;89853;730098;645961;9329;54840;5568;23731;2649;2902;29126;55312;11046;445815;6887;401565;90865;83744;2844;123;9830;3449;23511;26995;9373;3467;441457;55357;10952;441459;286256;157927;59335;92949;91283;51552;158135;9550;57720;10319;4799;8434;7410;2176;1025;2790;203228;727905;56033;51117;254295;1612;26206;6850;733;441425;29085;5082;7111;9991;53358;90120;3446;5998;100129385;286365;158056;11168;26301;2776;445;56751;57704;54187;570;6013;23245;57589;80173;92400;392399;22954;402381;9933;54932;23196;9314;3371;2218;347273;7099;23071;11217;6136;375743;55151;2889;116224;10592;158067;23299;389799;26578;286380;79269;10210;4915;1759;51148;2189;6461;54796;9536;158248;1842;10444;158326;6096;84688;10541;158431;727;3309;23452;6456;1211;27130;3717;9919;389812;140803;2592;55833;259;23349;320;158219;2731;253650;1271;10280;27090;27240;10020;56656;216;9568;54461;1903;9350;1306;340485;10850;881;100499483;2934;8721;7169;158038;55363;158427;84726;79987;64420;26149;255220;375759;653404;8555;401562;441430;441452;8777;55335;6837;7436;392391;338376;138065;573;25861;10807;55848;23099;2021;51759;55014;64975;10868;158158;27019;30968;2683;54926;9413;22869;774;5695;158055;401494;2650;5711;401505;23189;26735;138802;246184;687;80256;9414;26012;1993;203245;286207;169693;401551;80036;54942;83856;54542;138716;138881;549;100505993;403313;10880;9128;401541;6595;84253;65083;347168;169714;219;442425;84210;27433;138428;50514;10783;10670;26190;954;138255;5005;60560;8939;23064;401535;114299;2022;11224;51162;64078;4969;26147;158297;3440;9442;2619;286205;389816;23670;5047;5727;92715;203;3934;11182;3451;158401;9630;84909;5090;256691;6130;375791;5730;11172;152007;22844;389763;5253;389766;4851;138199;5004;10881;23586;138803;57109;3933;54754;100129669;3376;1317;26219;23307;8636;55071;81689;54769;8013;9355;25853;85301;5239;84628;2801;89958;6812;23392;6366;2516;56262;11253;26953;56904;11094;138799;3641;25822;7507;1318;389813;114991;84267;58493;157922;6836;84720;117531;26165;4300;445577;80318;23287;5742;54914;100505478;4958;169834;11258;8328;3452;257019;23552;55755;347252;4920;347240;9858;6505;2219;138715;256158;138307;20;29941;10044;3448;79670;7464;7046;138639;8818;646962;142680;375757;392376;1620;10655;79109;64794;23081;414328;6834;57462;64170;56832;6418;92399;347169;55035;9649;54586;84885;5789;3301;55667;349334;5125;286262;7270;89846;2529;26740;29968;29882;340481;8789;2304;23048;51490;113220;63951;414332;286234;26468;28;389827;1030;57684;4957;2203;54662;7763;3445;169436;1902;79095;4882;4814;22949;10811;1514;4507;364;29979;138882;54836;1621;84904;19;6619;7010;51010;54981;8019;23732;6194;10999;30815;1289;377841;1539;64425;169841;55684;403341;10383;944;26086;392307;57582;1861;138724;138474;286223;257169;4010;23404;48;84186;692094;9966;318,750
1,1,9,203861,141020389,140816528,10171;29952;10422;158293;54863;84960;360203;92014;138240;54886;2220;441478;79937;81605;1164;644019;2800;55064;7743;399665;56654;138241;2395;4686;89891;2315;79695;5991;389792;389761;643596;51510;195828;2733;80709;10488;1056;375748;971;286362;10927;157983;392390;140459;286319;79956;114987;25;79886;6709;100129969;7415;7088;7185;27290;7016;5646;81873;10773;8022;83549;6256;6363;6621;57864;55342;375775;138804;26267;23230;3442;84929;81704;8021;6019;169792;9719;153090;29989;10497;4781;2040;51271;158234;653427;4783;84895;90871;10244;1384;3590;25769;158471;65268;54829;552891;7091;347148;3456;195827;10555;203197;80380;1955;51104;50808;8727;229;5887;259308;3190;51531;392309;158131;114789;23424;5537;10507;9853;158046;8395;7633;286343;548645;286336;7186;11092;441476;3441;94107;445571;5524;55234;169522;883;8518;728747;64855;5774;1029;56254;89882;6835;23137;54881;9380;11064;11091;375704;84270;5069;25920;9925;5900;79048;9615;138311;9827;80142;84302;23413;84131;79813;1761;7357;138429;401546;138805;10439;1757;64768;51280;54875;116225;9833;3293;26130;11093;210;115426;158376;79817;84681;4593;203286;23446;25792;642968;138162;401498;58524;9328;55664;8577;138151;728489;3439;84263;29988;51754;83543;286257;254956;5535;7094;90678;4712;27158;389762;220869;7539;26248;10558;401563;3444;22845;7306;6838;100526694;55958;3443;203328;64922;1515;301;51116;138883;254973;51450;23637;2356;10585;730112;22927;9022;27348;84814;54566;158405;116443;56623;7248;203259;54801;728577;3447;4702;727830;81932;55582;26737;23203;54534;91373;58499;727800;85365;92714;647060;360;169611;768;152006;401548;28989;85014;29991;10912;80010;203260;158399;57171;7295;158062;25934;389730;5079;158358;286204;84641;203238;54107;392392;57706;89853;730098;645961;9329;54840;5568;23731;2649;2902;29126;55312;11046;445815;6887;401565;90865;83744;2844;123;9830;3449;23511;26995;9373;3467;441457;55357;10952;441459;286256;157927;59335;92949;91283;51552;158135;9550;57720;10319;4799;8434;7410;2176;1025;2790;203228;727905;56033;51117;254295;1612;26206;6850;733;441425;29085;5082;7111;9991;53358;90120;3446;5998;100129385;286365;158056;11168;26301;2776;445;56751;57704;54187;570;6013;23245;57589;80173;92400;392399;22954;402381;9933;54932;23196;9314;3371;2218;347273;7099;23071;11217;6136;375743;55151;2889;116224;10592;158067;23299;389799;26578;286380;79269;10210;4915;1759;51148;2189;6461;54796;9536;158248;1842;10444;158326;6096;84688;10541;158431;727;3309;23452;6456;1211;27130;3717;9919;389812;140803;2592;55833;259;23349;320;158219;2731;253650;1271;10280;27090;27240;10020;56656;216;9568;54461;1903;9350;1306;340485;10850;881;100499483;2934;8721;7169;158038;55363;158427;84726;79987;64420;26149;255220;375759;653404;8555;401562;441430;441452;8777;55335;6837;7436;392391;338376;138065;573;25861;10807;55848;23099;2021;51759;55014;64975;10868;158158;27019;30968;2683;54926;9413;22869;774;5695;158055;401494;2650;5711;401505;23189;26735;138802;246184;687;80256;9414;26012;1993;203245;286207;169693;401551;80036;54942;83856;54542;138716;138881;549;100505993;403313;10880;9128;401541;6595;84253;65083;347168;169714;219;442425;84210;27433;138428;50514;10783;10670;26190;954;138255;5005;60560;8939;23064;401535;114299;2022;11224;51162;64078;4969;26147;158297;3440;9442;2619;286205;389816;23670;5047;5727;92715;203;3934;11182;3451;158401;9630;84909;5090;256691;6130;375791;5730;11172;152007;22844;389763;5253;389766;4851;138199;5004;10881;23586;138803;57109;3933;54754;100129669;3376;1317;26219;23307;8636;55071;81689;54769;8013;9355;25853;85301;5239;84628;2801;89958;6812;23392;6366;2516;56262;11253;26953;56904;11094;138799;3641;25822;7507;1318;389813;114991;84267;58493;157922;6836;84720;117531;26165;4300;445577;80318;23287;5742;54914;100505478;4958;169834;11258;8328;3452;257019;23552;55755;347252;4920;347240;9858;6505;2219;138715;256158;138307;20;29941;10044;3448;79670;7464;7046;138639;8818;646962;142680;375757;392376;1620;10655;79109;64794;23081;414328;6834;57462;64170;56832;6418;92399;347169;55035;9649;54586;84885;5789;3301;55667;349334;5125;286262;7270;89846;2529;26740;29968;29882;340481;8789;2304;23048;51490;113220;63951;414332;286234;26468;28;389827;1030;57684;4957;2203;54662;7763;3445;169436;1902;79095;4882;4814;22949;10811;1514;4507;364;29979;138882;54836;1621;84904;19;6619;7010;51010;54981;8019;23732;6194;10999;30815;1289;377841;1539;64425;169841;55684;403341;10383;944;26086;392307;57582;1861;138724;138474;286223;257169;4010;23404;48;84186;692094;9966;318,750
1,1,9,203861,141020389,140816528,10171;29952;10422;158293;54863;84960;360203;92014;138240;54886;2220;441478;79937;81605;1164;644019;2800;55064;7743;399665;56654;138241;2395;4686;89891;2315;79695;5991;389792;389761;643596;51510;195828;2733;80709;10488;1056;375748;971;286362;10927;157983;392390;140459;286319;79956;114987;25;79886;6709;100129969;7415;7088;7185;27290;7016;5646;81873;10773;8022;83549;6256;6363;6621;57864;55342;375775;138804;26267;23230;3442;84929;81704;8021;6019;169792;9719;153090;29989;10497;4781;2040;51271;158234;653427;4783;84895;90871;10244;1384;3590;25769;158471;65268;54829;552891;7091;347148;3456;195827;10555;203197;80380;1955;51104;50808;8727;229;5887;259308;3190;51531;392309;158131;114789;23424;5537;10507;9853;158046;8395;7633;286343;548645;286336;7186;11092;441476;3441;94107;445571;5524;55234;169522;883;8518;728747;64855;5774;1029;56254;89882;6835;23137;54881;9380;11064;11091;375704;84270;5069;25920;9925;5900;79048;9615;138311;9827;80142;84302;23413;84131;79813;1761;7357;138429;401546;138805;10439;1757;64768;51280;54875;116225;9833;3293;26130;11093;210;115426;158376;79817;84681;4593;203286;23446;25792;642968;138162;401498;58524;9328;55664;8577;138151;728489;3439;84263;29988;51754;83543;286257;254956;5535;7094;90678;4712;27158;389762;220869;7539;26248;10558;401563;3444;22845;7306;6838;100526694;55958;3443;203328;64922;1515;301;51116;138883;254973;51450;23637;2356;10585;730112;22927;9022;27348;84814;54566;158405;116443;56623;7248;203259;54801;728577;3447;4702;727830;81932;55582;26737;23203;54534;91373;58499;727800;85365;92714;647060;360;169611;768;152006;401548;28989;85014;29991;10912;80010;203260;158399;57171;7295;158062;25934;389730;5079;158358;286204;84641;203238;54107;392392;57706;89853;730098;645961;9329;54840;5568;23731;2649;2902;29126;55312;11046;445815;6887;401565;90865;83744;2844;123;9830;3449;23511;26995;9373;3467;441457;55357;10952;441459;286256;157927;59335;92949;91283;51552;158135;9550;57720;10319;4799;8434;7410;2176;1025;2790;203228;727905;56033;51117;254295;1612;26206;6850;733;441425;29085;5082;7111;9991;53358;90120;3446;5998;100129385;286365;158056;11168;26301;2776;445;56751;57704;54187;570;6013;23245;57589;80173;92400;392399;22954;402381;9933;54932;23196;9314;3371;2218;347273;7099;23071;11217;6136;375743;55151;2889;116224;10592;158067;23299;389799;26578;286380;79269;10210;4915;1759;51148;2189;6461;54796;9536;158248;1842;10444;158326;6096;84688;10541;158431;727;3309;23452;6456;1211;27130;3717;9919;389812;140803;2592;55833;259;23349;320;158219;2731;253650;1271;10280;27090;27240;10020;56656;216;9568;54461;1903;9350;1306;340485;10850;881;100499483;2934;8721;7169;158038;55363;158427;84726;79987;64420;26149;255220;375759;653404;8555;401562;441430;441452;8777;55335;6837;7436;392391;338376;138065;573;25861;10807;55848;23099;2021;51759;55014;64975;10868;158158;27019;30968;2683;54926;9413;22869;774;5695;158055;401494;2650;5711;401505;23189;26735;138802;246184;687;80256;9414;26012;1993;203245;286207;169693;401551;80036;54942;83856;54542;138716;138881;549;100505993;403313;10880;9128;401541;6595;84253;65083;347168;169714;219;442425;84210;27433;138428;50514;10783;10670;26190;954;138255;5005;60560;8939;23064;401535;114299;2022;11224;51162;64078;4969;26147;158297;3440;9442;2619;286205;389816;23670;5047;5727;92715;203;3934;11182;3451;158401;9630;84909;5090;256691;6130;375791;5730;11172;152007;22844;389763;5253;389766;4851;138199;5004;10881;23586;138803;57109;3933;54754;100129669;3376;1317;26219;23307;8636;55071;81689;54769;8013;9355;25853;85301;5239;84628;2801;89958;6812;23392;6366;2516;56262;11253;26953;56904;11094;138799;3641;25822;7507;1318;389813;114991;84267;58493;157922;6836;84720;117531;26165;4300;445577;80318;23287;5742;54914;100505478;4958;169834;11258;8328;3452;257019;23552;55755;347252;4920;347240;9858;6505;2219;138715;256158;138307;20;29941;10044;3448;79670;7464;7046;138639;8818;646962;142680;375757;392376;1620;10655;79109;64794;23081;414328;6834;57462;64170;56832;6418;92399;347169;55035;9649;54586;84885;5789;3301;55667;349334;5125;286262;7270;89846;2529;26740;29968;29882;340481;8789;2304;23048;51490;113220;63951;414332;286234;26468;28;389827;1030;57684;4957;2203;54662;7763;3445;169436;1902;79095;4882;4814;22949;10811;1514;4507;364;29979;138882;54836;1621;84904;19;6619;7010;51010;54981;8019;23732;6194;10999;30815;1289;377841;1539;64425;169841;55684;403341;10383;944;26086;392307;57582;1861;138724;138474;286223;257169;4010;23404;48;84186;692094;9966;318,750
1,1,9,203862,141020389,140816527,10171;29952;10422;158293;54863;84960;360203;92014;138240;54886;2220;441478;79937;81605;1164;644019;2800;55064;7743;399665;56654;138241;2395;4686;89891;2315;79695;5991;389792;389761;643596;51510;195828;2733;80709;10488;1056;375748;971;286362;10927;157983;392390;140459;286319;79956;114987;25;79886;6709;100129969;7415;7088;7185;27290;7016;5646;81873;10773;8022;83549;6256;6363;6621;57864;55342;375775;138804;26267;23230;3442;84929;81704;8021;6019;169792;9719;153090;29989;10497;4781;2040;51271;158234;653427;4783;84895;90871;10244;1384;3590;25769;158471;65268;54829;552891;7091;347148;3456;195827;10555;203197;80380;1955;51104;50808;8727;229;5887;259308;3190;51531;392309;158131;114789;23424;5537;10507;9853;158046;8395;7633;286343;548645;286336;7186;11092;441476;3441;94107;445571;5524;55234;169522;883;8518;728747;64855;5774;1029;56254;89882;6835;23137;54881;9380;11064;11091;375704;84270;5069;25920;9925;5900;79048;9615;138311;9827;80142;84302;23413;84131;79813;1761;7357;138429;401546;138805;10439;1757;64768;51280;54875;116225;9833;3293;26130;11093;210;115426;158376;79817;84681;4593;203286;23446;25792;642968;138162;401498;58524;9328;55664;8577;138151;728489;3439;84263;29988;51754;83543;286257;254956;5535;7094;90678;4712;27158;389762;220869;7539;26248;10558;401563;3444;22845;7306;6838;100526694;55958;3443;203328;64922;1515;301;51116;138883;254973;51450;23637;2356;10585;730112;22927;9022;27348;84814;54566;158405;116443;56623;7248;203259;54801;728577;3447;4702;727830;81932;55582;26737;23203;54534;91373;58499;727800;85365;92714;647060;360;169611;768;152006;401548;28989;85014;29991;10912;80010;203260;158399;57171;7295;158062;25934;389730;5079;158358;286204;84641;203238;54107;392392;57706;89853;730098;645961;9329;54840;5568;23731;2649;2902;29126;55312;11046;445815;6887;401565;90865;83744;2844;123;9830;3449;23511;26995;9373;3467;441457;55357;10952;441459;286256;157927;59335;92949;91283;51552;158135;9550;57720;10319;4799;8434;7410;2176;1025;2790;203228;727905;56033;51117;254295;1612;26206;6850;733;441425;29085;5082;7111;9991;53358;90120;3446;5998;100129385;286365;158056;11168;26301;2776;445;56751;57704;54187;570;6013;23245;57589;80173;92400;392399;22954;402381;9933;54932;23196;9314;3371;2218;347273;7099;23071;11217;6136;375743;55151;2889;116224;10592;158067;23299;389799;26578;286380;79269;10210;4915;1759;51148;2189;6461;54796;9536;158248;1842;10444;158326;6096;84688;10541;158431;727;3309;23452;6456;1211;27130;3717;9919;389812;140803;2592;55833;259;23349;320;158219;2731;253650;1271;10280;27090;27240;10020;56656;216;9568;54461;1903;9350;1306;340485;10850;881;100499483;2934;8721;7169;158038;55363;158427;84726;79987;64420;26149;255220;375759;653404;8555;401562;441430;441452;8777;55335;6837;7436;392391;338376;138065;573;25861;10807;55848;23099;2021;51759;55014;64975;10868;158158;27019;30968;2683;54926;9413;22869;774;5695;158055;401494;2650;5711;401505;23189;26735;138802;246184;687;80256;9414;26012;1993;203245;286207;169693;401551;80036;54942;83856;54542;138716;138881;549;100505993;403313;10880;9128;401541;6595;84253;65083;347168;169714;219;442425;84210;27433;138428;50514;10783;10670;26190;954;138255;5005;60560;8939;23064;401535;114299;2022;11224;51162;64078;4969;26147;158297;3440;9442;2619;286205;389816;23670;5047;5727;92715;203;3934;11182;3451;158401;9630;84909;5090;256691;6130;375791;5730;11172;152007;22844;389763;5253;389766;4851;138199;5004;10881;23586;138803;57109;3933;54754;100129669;3376;1317;26219;23307;8636;55071;81689;54769;8013;9355;25853;85301;5239;84628;2801;89958;6812;23392;6366;2516;56262;11253;26953;56904;11094;138799;3641;25822;7507;1318;389813;114991;84267;58493;157922;6836;84720;117531;26165;4300;445577;80318;23287;5742;54914;100505478;4958;169834;11258;8328;3452;257019;23552;55755;347252;4920;347240;9858;6505;2219;138715;256158;138307;20;29941;10044;3448;79670;7464;7046;138639;8818;646962;142680;375757;392376;1620;10655;79109;64794;23081;414328;6834;57462;64170;56832;6418;92399;347169;55035;9649;54586;84885;5789;3301;55667;349334;5125;286262;7270;89846;2529;26740;29968;29882;340481;8789;2304;23048;51490;113220;63951;414332;286234;26468;28;389827;1030;57684;4957;2203;54662;7763;3445;169436;1902;79095;4882;4814;22949;10811;1514;4507;364;29979;138882;54836;1621;84904;19;6619;7010;51010;54981;8019;23732;6194;10999;30815;1289;377841;1539;64425;169841;55684;403341;10383;944;26086;392307;57582;1861;138724;138474;286223;257169;4010;23404;48;84186;692094;9966;318,750
1,1,9,203862,141020389,140816527,10171;29952;10422;158293;54863;84960;360203;92014;138240;54886;2220;441478;79937;81605;1164;644019;2800;55064;7743;399665;56654;138241;2395;4686;89891;2315;79695;5991;389792;389761;643596;51510;195828;2733;80709;10488;1056;375748;971;286362;10927;157983;392390;140459;286319;79956;114987;25;79886;6709;100129969;7415;7088;7185;27290;7016;5646;81873;10773;8022;83549;6256;6363;6621;57864;55342;375775;138804;26267;23230;3442;84929;81704;8021;6019;169792;9719;153090;29989;10497;4781;2040;51271;158234;653427;4783;84895;90871;10244;1384;3590;25769;158471;65268;54829;552891;7091;347148;3456;195827;10555;203197;80380;1955;51104;50808;8727;229;5887;259308;3190;51531;392309;158131;114789;23424;5537;10507;9853;158046;8395;7633;286343;548645;286336;7186;11092;441476;3441;94107;445571;5524;55234;169522;883;8518;728747;64855;5774;1029;56254;89882;6835;23137;54881;9380;11064;11091;375704;84270;5069;25920;9925;5900;79048;9615;138311;9827;80142;84302;23413;84131;79813;1761;7357;138429;401546;138805;10439;1757;64768;51280;54875;116225;9833;3293;26130;11093;210;115426;158376;79817;84681;4593;203286;23446;25792;642968;138162;401498;58524;9328;55664;8577;138151;728489;3439;84263;29988;51754;83543;286257;254956;5535;7094;90678;4712;27158;389762;220869;7539;26248;10558;401563;3444;22845;7306;6838;100526694;55958;3443;203328;64922;1515;301;51116;138883;254973;51450;23637;2356;10585;730112;22927;9022;27348;84814;54566;158405;116443;56623;7248;203259;54801;728577;3447;4702;727830;81932;55582;26737;23203;54534;91373;58499;727800;85365;92714;647060;360;169611;768;152006;401548;28989;85014;29991;10912;80010;203260;158399;57171;7295;158062;25934;389730;5079;158358;286204;84641;203238;54107;392392;57706;89853;730098;645961;9329;54840;5568;23731;2649;2902;29126;55312;11046;445815;6887;401565;90865;83744;2844;123;9830;3449;23511;26995;9373;3467;441457;55357;10952;441459;286256;157927;59335;92949;91283;51552;158135;9550;57720;10319;4799;8434;7410;2176;1025;2790;203228;727905;56033;51117;254295;1612;26206;6850;733;441425;29085;5082;7111;9991;53358;90120;3446;5998;100129385;286365;158056;11168;26301;2776;445;56751;57704;54187;570;6013;23245;57589;80173;92400;392399;22954;402381;9933;54932;23196;9314;3371;2218;347273;7099;23071;11217;6136;375743;55151;2889;116224;10592;158067;23299;389799;26578;286380;79269;10210;4915;1759;51148;2189;6461;54796;9536;158248;1842;10444;158326;6096;84688;10541;158431;727;3309;23452;6456;1211;27130;3717;9919;389812;140803;2592;55833;259;23349;320;158219;2731;253650;1271;10280;27090;27240;10020;56656;216;9568;54461;1903;9350;1306;340485;10850;881;100499483;2934;8721;7169;158038;55363;158427;84726;79987;64420;26149;255220;375759;653404;8555;401562;441430;441452;8777;55335;6837;7436;392391;338376;138065;573;25861;10807;55848;23099;2021;51759;55014;64975;10868;158158;27019;30968;2683;54926;9413;22869;774;5695;158055;401494;2650;5711;401505;23189;26735;138802;246184;687;80256;9414;26012;1993;203245;286207;169693;401551;80036;54942;83856;54542;138716;138881;549;100505993;403313;10880;9128;401541;6595;84253;65083;347168;169714;219;442425;84210;27433;138428;50514;10783;10670;26190;954;138255;5005;60560;8939;23064;401535;114299;2022;11224;51162;64078;4969;26147;158297;3440;9442;2619;286205;389816;23670;5047;5727;92715;203;3934;11182;3451;158401;9630;84909;5090;256691;6130;375791;5730;11172;152007;22844;389763;5253;389766;4851;138199;5004;10881;23586;138803;57109;3933;54754;100129669;3376;1317;26219;23307;8636;55071;81689;54769;8013;9355;25853;85301;5239;84628;2801;89958;6812;23392;6366;2516;56262;11253;26953;56904;11094;138799;3641;25822;7507;1318;389813;114991;84267;58493;157922;6836;84720;117531;26165;4300;445577;80318;23287;5742;54914;100505478;4958;169834;11258;8328;3452;257019;23552;55755;347252;4920;347240;9858;6505;2219;138715;256158;138307;20;29941;10044;3448;79670;7464;7046;138639;8818;646962;142680;375757;392376;1620;10655;79109;64794;23081;414328;6834;57462;64170;56832;6418;92399;347169;55035;9649;54586;84885;5789;3301;55667;349334;5125;286262;7270;89846;2529;26740;29968;29882;340481;8789;2304;23048;51490;113220;63951;414332;286234;26468;28;389827;1030;57684;4957;2203;54662;7763;3445;169436;1902;79095;4882;4814;22949;10811;1514;4507;364;29979;138882;54836;1621;84904;19;6619;7010;51010;54981;8019;23732;6194;10999;30815;1289;377841;1539;64425;169841;55684;403341;10383;944;26086;392307;57582;1861;138724;138474;286223;257169;4010;23404;48;84186;692094;9966;318,750
1,1,9,203862,141020389,140816527,10171;29952;10422;158293;54863;84960;360203;92014;138240;54886;2220;441478;79937;81605;1164;644019;2800;55064;7743;399665;56654;138241;2395;4686;89891;2315;79695;5991;389792;389761;643596;51510;195828;2733;80709;10488;1056;375748;971;286362;10927;157983;392390;140459;286319;79956;114987;25;79886;6709;100129969;7415;7088;7185;27290;7016;5646;81873;10773;8022;83549;6256;6363;6621;57864;55342;375775;138804;26267;23230;3442;84929;81704;8021;6019;169792;9719;153090;29989;10497;4781;2040;51271;158234;653427;4783;84895;90871;10244;1384;3590;25769;158471;65268;54829;552891;7091;347148;3456;195827;10555;203197;80380;1955;51104;50808;8727;229;5887;259308;3190;51531;392309;158131;114789;23424;5537;10507;9853;158046;8395;7633;286343;548645;286336;7186;11092;441476;3441;94107;445571;5524;55234;169522;883;8518;728747;64855;5774;1029;56254;89882;6835;23137;54881;9380;11064;11091;375704;84270;5069;25920;9925;5900;79048;9615;138311;9827;80142;84302;23413;84131;79813;1761;7357;138429;401546;138805;10439;1757;64768;51280;54875;116225;9833;3293;26130;11093;210;115426;158376;79817;84681;4593;203286;23446;25792;642968;138162;401498;58524;9328;55664;8577;138151;728489;3439;84263;29988;51754;83543;286257;254956;5535;7094;90678;4712;27158;389762;220869;7539;26248;10558;401563;3444;22845;7306;6838;100526694;55958;3443;203328;64922;1515;301;51116;138883;254973;51450;23637;2356;10585;730112;22927;9022;27348;84814;54566;158405;116443;56623;7248;203259;54801;728577;3447;4702;727830;81932;55582;26737;23203;54534;91373;58499;727800;85365;92714;647060;360;169611;768;152006;401548;28989;85014;29991;10912;80010;203260;158399;57171;7295;158062;25934;389730;5079;158358;286204;84641;203238;54107;392392;57706;89853;730098;645961;9329;54840;5568;23731;2649;2902;29126;55312;11046;445815;6887;401565;90865;83744;2844;123;9830;3449;23511;26995;9373;3467;441457;55357;10952;441459;286256;157927;59335;92949;91283;51552;158135;9550;57720;10319;4799;8434;7410;2176;1025;2790;203228;727905;56033;51117;254295;1612;26206;6850;733;441425;29085;5082;7111;9991;53358;90120;3446;5998;100129385;286365;158056;11168;26301;2776;445;56751;57704;54187;570;6013;23245;57589;80173;92400;392399;22954;402381;9933;54932;23196;9314;3371;2218;347273;7099;23071;11217;6136;375743;55151;2889;116224;10592;158067;23299;389799;26578;286380;79269;10210;4915;1759;51148;2189;6461;54796;9536;158248;1842;10444;158326;6096;84688;10541;158431;727;3309;23452;6456;1211;27130;3717;9919;389812;140803;2592;55833;259;23349;320;158219;2731;253650;1271;10280;27090;27240;10020;56656;216;9568;54461;1903;9350;1306;340485;10850;881;100499483;2934;8721;7169;158038;55363;158427;84726;79987;64420;26149;255220;375759;653404;8555;401562;441430;441452;8777;55335;6837;7436;392391;338376;138065;573;25861;10807;55848;23099;2021;51759;55014;64975;10868;158158;27019;30968;2683;54926;9413;22869;774;5695;158055;401494;2650;5711;401505;23189;26735;138802;246184;687;80256;9414;26012;1993;203245;286207;169693;401551;80036;54942;83856;54542;138716;138881;549;100505993;403313;10880;9128;401541;6595;84253;65083;347168;169714;219;442425;84210;27433;138428;50514;10783;10670;26190;954;138255;5005;60560;8939;23064;401535;114299;2022;11224;51162;64078;4969;26147;158297;3440;9442;2619;286205;389816;23670;5047;5727;92715;203;3934;11182;3451;158401;9630;84909;5090;256691;6130;375791;5730;11172;152007;22844;389763;5253;389766;4851;138199;5004;10881;23586;138803;57109;3933;54754;100129669;3376;1317;26219;23307;8636;55071;81689;54769;8013;9355;25853;85301;5239;84628;2801;89958;6812;23392;6366;2516;56262;11253;26953;56904;11094;138799;3641;25822;7507;1318;389813;114991;84267;58493;157922;6836;84720;117531;26165;4300;445577;80318;23287;5742;54914;100505478;4958;169834;11258;8328;3452;257019;23552;55755;347252;4920;347240;9858;6505;2219;138715;256158;138307;20;29941;10044;3448;79670;7464;7046;138639;8818;646962;142680;375757;392376;1620;10655;79109;64794;23081;414328;6834;57462;64170;56832;6418;92399;347169;55035;9649;54586;84885;5789;3301;55667;349334;5125;286262;7270;89846;2529;26740;29968;29882;340481;8789;2304;23048;51490;113220;63951;414332;286234;26468;28;389827;1030;57684;4957;2203;54662;7763;3445;169436;1902;79095;4882;4814;22949;10811;1514;4507;364;29979;138882;54836;1621;84904;19;6619;7010;51010;54981;8019;23732;6194;10999;30815;1289;377841;1539;64425;169841;55684;403341;10383;944;26086;392307;57582;1861;138724;138474;286223;257169;4010;23404;48;84186;692094;9966;318,750
1,1,9,203862,141020389,140816527,10171;29952;10422;158293;54863;84960;360203;92014;138240;54886;2220;441478;79937;81605;1164;644019;2800;55064;7743;399665;56654;138241;2395;4686;89891;2315;79695;5991;389792;389761;643596;51510;195828;2733;80709;10488;1056;375748;971;286362;10927;157983;392390;140459;286319;79956;114987;25;79886;6709;100129969;7415;7088;7185;27290;7016;5646;81873;10773;8022;83549;6256;6363;6621;57864;55342;375775;138804;26267;23230;3442;84929;81704;8021;6019;169792;9719;153090;29989;10497;4781;2040;51271;158234;653427;4783;84895;90871;10244;1384;3590;25769;158471;65268;54829;552891;7091;347148;3456;195827;10555;203197;80380;1955;51104;50808;8727;229;5887;259308;3190;51531;392309;158131;114789;23424;5537;10507;9853;158046;8395;7633;286343;548645;286336;7186;11092;441476;3441;94107;445571;5524;55234;169522;883;8518;728747;64855;5774;1029;56254;89882;6835;23137;54881;9380;11064;11091;375704;84270;5069;25920;9925;5900;79048;9615;138311;9827;80142;84302;23413;84131;79813;1761;7357;138429;401546;138805;10439;1757;64768;51280;54875;116225;9833;3293;26130;11093;210;115426;158376;79817;84681;4593;203286;23446;25792;642968;138162;401498;58524;9328;55664;8577;138151;728489;3439;84263;29988;51754;83543;286257;254956;5535;7094;90678;4712;27158;389762;220869;7539;26248;10558;401563;3444;22845;7306;6838;100526694;55958;3443;203328;64922;1515;301;51116;138883;254973;51450;23637;2356;10585;730112;22927;9022;27348;84814;54566;158405;116443;56623;7248;203259;54801;728577;3447;4702;727830;81932;55582;26737;23203;54534;91373;58499;727800;85365;92714;647060;360;169611;768;152006;401548;28989;85014;29991;10912;80010;203260;158399;57171;7295;158062;25934;389730;5079;158358;286204;84641;203238;54107;392392;57706;89853;730098;645961;9329;54840;5568;23731;2649;2902;29126;55312;11046;445815;6887;401565;90865;83744;2844;123;9830;3449;23511;26995;9373;3467;441457;55357;10952;441459;286256;157927;59335;92949;91283;51552;158135;9550;57720;10319;4799;8434;7410;2176;1025;2790;203228;727905;56033;51117;254295;1612;26206;6850;733;441425;29085;5082;7111;9991;53358;90120;3446;5998;100129385;286365;158056;11168;26301;2776;445;56751;57704;54187;570;6013;23245;57589;80173;92400;392399;22954;402381;9933;54932;23196;9314;3371;2218;347273;7099;23071;11217;6136;375743;55151;2889;116224;10592;158067;23299;389799;26578;286380;79269;10210;4915;1759;51148;2189;6461;54796;9536;158248;1842;10444;158326;6096;84688;10541;158431;727;3309;23452;6456;1211;27130;3717;9919;389812;140803;2592;55833;259;23349;320;158219;2731;253650;1271;10280;27090;27240;10020;56656;216;9568;54461;1903;9350;1306;340485;10850;881;100499483;2934;8721;7169;158038;55363;158427;84726;79987;64420;26149;255220;375759;653404;8555;401562;441430;441452;8777;55335;6837;7436;392391;338376;138065;573;25861;10807;55848;23099;2021;51759;55014;64975;10868;158158;27019;30968;2683;54926;9413;22869;774;5695;158055;401494;2650;5711;401505;23189;26735;138802;246184;687;80256;9414;26012;1993;203245;286207;169693;401551;80036;54942;83856;54542;138716;138881;549;100505993;403313;10880;9128;401541;6595;84253;65083;347168;169714;219;442425;84210;27433;138428;50514;10783;10670;26190;954;138255;5005;60560;8939;23064;401535;114299;2022;11224;51162;64078;4969;26147;158297;3440;9442;2619;286205;389816;23670;5047;5727;92715;203;3934;11182;3451;158401;9630;84909;5090;256691;6130;375791;5730;11172;152007;22844;389763;5253;389766;4851;138199;5004;10881;23586;138803;57109;3933;54754;100129669;3376;1317;26219;23307;8636;55071;81689;54769;8013;9355;25853;85301;5239;84628;2801;89958;6812;23392;6366;2516;56262;11253;26953;56904;11094;138799;3641;25822;7507;1318;389813;114991;84267;58493;157922;6836;84720;117531;26165;4300;445577;80318;23287;5742;54914;100505478;4958;169834;11258;8328;3452;257019;23552;55755;347252;4920;347240;9858;6505;2219;138715;256158;138307;20;29941;10044;3448;79670;7464;7046;138639;8818;646962;142680;375757;392376;1620;10655;79109;64794;23081;414328;6834;57462;64170;56832;6418;92399;347169;55035;9649;54586;84885;5789;3301;55667;349334;5125;286262;7270;89846;2529;26740;29968;29882;340481;8789;2304;23048;51490;113220;63951;414332;286234;26468;28;389827;1030;57684;4957;2203;54662;7763;3445;169436;1902;79095;4882;4814;22949;10811;1514;4507;364;29979;138882;54836;1621;84904;19;6619;7010;51010;54981;8019;23732;6194;10999;30815;1289;377841;1539;64425;169841;55684;403341;10383;944;26086;392307;57582;1861;138724;138474;286223;257169;4010;23404;48;84186;692094;9966;318,750
1,1,9,203862,141020389,140816527,10171;29952;10422;158293;54863;84960;360203;92014;138240;54886;2220;441478;79937;81605;1164;644019;2800;55064;7743;399665;56654;138241;2395;4686;89891;2315;79695;5991;389792;389761;643596;51510;195828;2733;80709;10488;1056;375748;971;286362;10927;157983;392390;140459;286319;79956;114987;25;79886;6709;100129969;7415;7088;7185;27290;7016;5646;81873;10773;8022;83549;6256;6363;6621;57864;55342;375775;138804;26267;23230;3442;84929;81704;8021;6019;169792;9719;153090;29989;10497;4781;2040;51271;158234;653427;4783;84895;90871;10244;1384;3590;25769;158471;65268;54829;552891;7091;347148;3456;195827;10555;203197;80380;1955;51104;50808;8727;229;5887;259308;3190;51531;392309;158131;114789;23424;5537;10507;9853;158046;8395;7633;286343;548645;286336;7186;11092;441476;3441;94107;445571;5524;55234;169522;883;8518;728747;64855;5774;1029;56254;89882;6835;23137;54881;9380;11064;11091;375704;84270;5069;25920;9925;5900;79048;9615;138311;9827;80142;84302;23413;84131;79813;1761;7357;138429;401546;138805;10439;1757;64768;51280;54875;116225;9833;3293;26130;11093;210;115426;158376;79817;84681;4593;203286;23446;25792;642968;138162;401498;58524;9328;55664;8577;138151;728489;3439;84263;29988;51754;83543;286257;254956;5535;7094;90678;4712;27158;389762;220869;7539;26248;10558;401563;3444;22845;7306;6838;100526694;55958;3443;203328;64922;1515;301;51116;138883;254973;51450;23637;2356;10585;730112;22927;9022;27348;84814;54566;158405;116443;56623;7248;203259;54801;728577;3447;4702;727830;81932;55582;26737;23203;54534;91373;58499;727800;85365;92714;647060;360;169611;768;152006;401548;28989;85014;29991;10912;80010;203260;158399;57171;7295;158062;25934;389730;5079;158358;286204;84641;203238;54107;392392;57706;89853;730098;645961;9329;54840;5568;23731;2649;2902;29126;55312;11046;445815;6887;401565;90865;83744;2844;123;9830;3449;23511;26995;9373;3467;441457;55357;10952;441459;286256;157927;59335;92949;91283;51552;158135;9550;57720;10319;4799;8434;7410;2176;1025;2790;203228;727905;56033;51117;254295;1612;26206;6850;733;441425;29085;5082;7111;9991;53358;90120;3446;5998;100129385;286365;158056;11168;26301;2776;445;56751;57704;54187;570;6013;23245;57589;80173;92400;392399;22954;402381;9933;54932;23196;9314;3371;2218;347273;7099;23071;11217;6136;375743;55151;2889;116224;10592;158067;23299;389799;26578;286380;79269;10210;4915;1759;51148;2189;6461;54796;9536;158248;1842;10444;158326;6096;84688;10541;158431;727;3309;23452;6456;1211;27130;3717;9919;389812;140803;2592;55833;259;23349;320;158219;2731;253650;1271;10280;27090;27240;10020;56656;216;9568;54461;1903;9350;1306;340485;10850;881;100499483;2934;8721;7169;158038;55363;158427;84726;79987;64420;26149;255220;375759;653404;8555;401562;441430;441452;8777;55335;6837;7436;392391;338376;138065;573;25861;10807;55848;23099;2021;51759;55014;64975;10868;158158;27019;30968;2683;54926;9413;22869;774;5695;158055;401494;2650;5711;401505;23189;26735;138802;246184;687;80256;9414;26012;1993;203245;286207;169693;401551;80036;54942;83856;54542;138716;138881;549;100505993;403313;10880;9128;401541;6595;84253;65083;347168;169714;219;442425;84210;27433;138428;50514;10783;10670;26190;954;138255;5005;60560;8939;23064;401535;114299;2022;11224;51162;64078;4969;26147;158297;3440;9442;2619;286205;389816;23670;5047;5727;92715;203;3934;11182;3451;158401;9630;84909;5090;256691;6130;375791;5730;11172;152007;22844;389763;5253;389766;4851;138199;5004;10881;23586;138803;57109;3933;54754;100129669;3376;1317;26219;23307;8636;55071;81689;54769;8013;9355;25853;85301;5239;84628;2801;89958;6812;23392;6366;2516;56262;11253;26953;56904;11094;138799;3641;25822;7507;1318;389813;114991;84267;58493;157922;6836;84720;117531;26165;4300;445577;80318;23287;5742;54914;100505478;4958;169834;11258;8328;3452;257019;23552;55755;347252;4920;347240;9858;6505;2219;138715;256158;138307;20;29941;10044;3448;79670;7464;7046;138639;8818;646962;142680;375757;392376;1620;10655;79109;64794;23081;414328;6834;57462;64170;56832;6418;92399;347169;55035;9649;54586;84885;5789;3301;55667;349334;5125;286262;7270;89846;2529;26740;29968;29882;340481;8789;2304;23048;51490;113220;63951;414332;286234;26468;28;389827;1030;57684;4957;2203;54662;7763;3445;169436;1902;79095;4882;4814;22949;10811;1514;4507;364;29979;138882;54836;1621;84904;19;6619;7010;51010;54981;8019;23732;6194;10999;30815;1289;377841;1539;64425;169841;55684;403341;10383;944;26086;392307;57582;1861;138724;138474;286223;257169;4010;23404;48;84186;692094;9966;318,750
1,1,9,203862,141020389,140816527,10171;29952;10422;158293;54863;84960;360203;92014;138240;54886;2220;441478;79937;81605;1164;644019;2800;55064;7743;399665;56654;138241;2395;4686;89891;2315;79695;5991;389792;389761;643596;51510;195828;2733;80709;10488;1056;375748;971;286362;10927;157983;392390;140459;286319;79956;114987;25;79886;6709;100129969;7415;7088;7185;27290;7016;5646;81873;10773;8022;83549;6256;6363;6621;57864;55342;375775;138804;26267;23230;3442;84929;81704;8021;6019;169792;9719;153090;29989;10497;4781;2040;51271;158234;653427;4783;84895;90871;10244;1384;3590;25769;158471;65268;54829;552891;7091;347148;3456;195827;10555;203197;80380;1955;51104;50808;8727;229;5887;259308;3190;51531;392309;158131;114789;23424;5537;10507;9853;158046;8395;7633;286343;548645;286336;7186;11092;441476;3441;94107;445571;5524;55234;169522;883;8518;728747;64855;5774;1029;56254;89882;6835;23137;54881;9380;11064;11091;375704;84270;5069;25920;9925;5900;79048;9615;138311;9827;80142;84302;23413;84131;79813;1761;7357;138429;401546;138805;10439;1757;64768;51280;54875;116225;9833;3293;26130;11093;210;115426;158376;79817;84681;4593;203286;23446;25792;642968;138162;401498;58524;9328;55664;8577;138151;728489;3439;84263;29988;51754;83543;286257;254956;5535;7094;90678;4712;27158;389762;220869;7539;26248;10558;401563;3444;22845;7306;6838;100526694;55958;3443;203328;64922;1515;301;51116;138883;254973;51450;23637;2356;10585;730112;22927;9022;27348;84814;54566;158405;116443;56623;7248;203259;54801;728577;3447;4702;727830;81932;55582;26737;23203;54534;91373;58499;727800;85365;92714;647060;360;169611;768;152006;401548;28989;85014;29991;10912;80010;203260;158399;57171;7295;158062;25934;389730;5079;158358;286204;84641;203238;54107;392392;57706;89853;730098;645961;9329;54840;5568;23731;2649;2902;29126;55312;11046;445815;6887;401565;90865;83744;2844;123;9830;3449;23511;26995;9373;3467;441457;55357;10952;441459;286256;157927;59335;92949;91283;51552;158135;9550;57720;10319;4799;8434;7410;2176;1025;2790;203228;727905;56033;51117;254295;1612;26206;6850;733;441425;29085;5082;7111;9991;53358;90120;3446;5998;100129385;286365;158056;11168;26301;2776;445;56751;57704;54187;570;6013;23245;57589;80173;92400;392399;22954;402381;9933;54932;23196;9314;3371;2218;347273;7099;23071;11217;6136;375743;55151;2889;116224;10592;158067;23299;389799;26578;286380;79269;10210;4915;1759;51148;2189;6461;54796;9536;158248;1842;10444;158326;6096;84688;10541;158431;727;3309;23452;6456;1211;27130;3717;9919;389812;140803;2592;55833;259;23349;320;158219;2731;253650;1271;10280;27090;27240;10020;56656;216;9568;54461;1903;9350;1306;340485;10850;881;100499483;2934;8721;7169;158038;55363;158427;84726;79987;64420;26149;255220;375759;653404;8555;401562;441430;441452;8777;55335;6837;7436;392391;338376;138065;573;25861;10807;55848;23099;2021;51759;55014;64975;10868;158158;27019;30968;2683;54926;9413;22869;774;5695;158055;401494;2650;5711;401505;23189;26735;138802;246184;687;80256;9414;26012;1993;203245;286207;169693;401551;80036;54942;83856;54542;138716;138881;549;100505993;403313;10880;9128;401541;6595;84253;65083;347168;169714;219;442425;84210;27433;138428;50514;10783;10670;26190;954;138255;5005;60560;8939;23064;401535;114299;2022;11224;51162;64078;4969;26147;158297;3440;9442;2619;286205;389816;23670;5047;5727;92715;203;3934;11182;3451;158401;9630;84909;5090;256691;6130;375791;5730;11172;152007;22844;389763;5253;389766;4851;138199;5004;10881;23586;138803;57109;3933;54754;100129669;3376;1317;26219;23307;8636;55071;81689;54769;8013;9355;25853;85301;5239;84628;2801;89958;6812;23392;6366;2516;56262;11253;26953;56904;11094;138799;3641;25822;7507;1318;389813;114991;84267;58493;157922;6836;84720;117531;26165;4300;445577;80318;23287;5742;54914;100505478;4958;169834;11258;8328;3452;257019;23552;55755;347252;4920;347240;9858;6505;2219;138715;256158;138307;20;29941;10044;3448;79670;7464;7046;138639;8818;646962;142680;375757;392376;1620;10655;79109;64794;23081;414328;6834;57462;64170;56832;6418;92399;347169;55035;9649;54586;84885;5789;3301;55667;349334;5125;286262;7270;89846;2529;26740;29968;29882;340481;8789;2304;23048;51490;113220;63951;414332;286234;26468;28;389827;1030;57684;4957;2203;54662;7763;3445;169436;1902;79095;4882;4814;22949;10811;1514;4507;364;29979;138882;54836;1621;84904;19;6619;7010;51010;54981;8019;23732;6194;10999;30815;1289;377841;1539;64425;169841;55684;403341;10383;944;26086;392307;57582;1861;138724;138474;286223;257169;4010;23404;48;84186;692094;9966;318,750
1,1,9,203862,141020389,140816527,10171;29952;10422;158293;54863;84960;360203;92014;138240;54886;2220;441478;79937;81605;1164;644019;2800;55064;7743;399665;56654;138241;2395;4686;89891;2315;79695;5991;389792;389761;643596;51510;195828;2733;80709;10488;1056;375748;971;286362;10927;157983;392390;140459;286319;79956;114987;25;79886;6709;100129969;7415;7088;7185;27290;7016;5646;81873;10773;8022;83549;6256;6363;6621;57864;55342;375775;138804;26267;23230;3442;84929;81704;8021;6019;169792;9719;153090;29989;10497;4781;2040;51271;158234;653427;4783;84895;90871;10244;1384;3590;25769;158471;65268;54829;552891;7091;347148;3456;195827;10555;203197;80380;1955;51104;50808;8727;229;5887;259308;3190;51531;392309;158131;114789;23424;5537;10507;9853;158046;8395;7633;286343;548645;286336;7186;11092;441476;3441;94107;445571;5524;55234;169522;883;8518;728747;64855;5774;1029;56254;89882;6835;23137;54881;9380;11064;11091;375704;84270;5069;25920;9925;5900;79048;9615;138311;9827;80142;84302;23413;84131;79813;1761;7357;138429;401546;138805;10439;1757;64768;51280;54875;116225;9833;3293;26130;11093;210;115426;158376;79817;84681;4593;203286;23446;25792;642968;138162;401498;58524;9328;55664;8577;138151;728489;3439;84263;29988;51754;83543;286257;254956;5535;7094;90678;4712;27158;389762;220869;7539;26248;10558;401563;3444;22845;7306;6838;100526694;55958;3443;203328;64922;1515;301;51116;138883;254973;51450;23637;2356;10585;730112;22927;9022;27348;84814;54566;158405;116443;56623;7248;203259;54801;728577;3447;4702;727830;81932;55582;26737;23203;54534;91373;58499;727800;85365;92714;647060;360;169611;768;152006;401548;28989;85014;29991;10912;80010;203260;158399;57171;7295;158062;25934;389730;5079;158358;286204;84641;203238;54107;392392;57706;89853;730098;645961;9329;54840;5568;23731;2649;2902;29126;55312;11046;445815;6887;401565;90865;83744;2844;123;9830;3449;23511;26995;9373;3467;441457;55357;10952;441459;286256;157927;59335;92949;91283;51552;158135;9550;57720;10319;4799;8434;7410;2176;1025;2790;203228;727905;56033;51117;254295;1612;26206;6850;733;441425;29085;5082;7111;9991;53358;90120;3446;5998;100129385;286365;158056;11168;26301;2776;445;56751;57704;54187;570;6013;23245;57589;80173;92400;392399;22954;402381;9933;54932;23196;9314;3371;2218;347273;7099;23071;11217;6136;375743;55151;2889;116224;10592;158067;23299;389799;26578;286380;79269;10210;4915;1759;51148;2189;6461;54796;9536;158248;1842;10444;158326;6096;84688;10541;158431;727;3309;23452;6456;1211;27130;3717;9919;389812;140803;2592;55833;259;23349;320;158219;2731;253650;1271;10280;27090;27240;10020;56656;216;9568;54461;1903;9350;1306;340485;10850;881;100499483;2934;8721;7169;158038;55363;158427;84726;79987;64420;26149;255220;375759;653404;8555;401562;441430;441452;8777;55335;6837;7436;392391;338376;138065;573;25861;10807;55848;23099;2021;51759;55014;64975;10868;158158;27019;30968;2683;54926;9413;22869;774;5695;158055;401494;2650;5711;401505;23189;26735;138802;246184;687;80256;9414;26012;1993;203245;286207;169693;401551;80036;54942;83856;54542;138716;138881;549;100505993;403313;10880;9128;401541;6595;84253;65083;347168;169714;219;442425;84210;27433;138428;50514;10783;10670;26190;954;138255;5005;60560;8939;23064;401535;114299;2022;11224;51162;64078;4969;26147;158297;3440;9442;2619;286205;389816;23670;5047;5727;92715;203;3934;11182;3451;158401;9630;84909;5090;256691;6130;375791;5730;11172;152007;22844;389763;5253;389766;4851;138199;5004;10881;23586;138803;57109;3933;54754;100129669;3376;1317;26219;23307;8636;55071;81689;54769;8013;9355;25853;85301;5239;84628;2801;89958;6812;23392;6366;2516;56262;11253;26953;56904;11094;138799;3641;25822;7507;1318;389813;114991;84267;58493;157922;6836;84720;117531;26165;4300;445577;80318;23287;5742;54914;100505478;4958;169834;11258;8328;3452;257019;23552;55755;347252;4920;347240;9858;6505;2219;138715;256158;138307;20;29941;10044;3448;79670;7464;7046;138639;8818;646962;142680;375757;392376;1620;10655;79109;64794;23081;414328;6834;57462;64170;56832;6418;92399;347169;55035;9649;54586;84885;5789;3301;55667;349334;5125;286262;7270;89846;2529;26740;29968;29882;340481;8789;2304;23048;51490;113220;63951;414332;286234;26468;28;389827;1030;57684;4957;2203;54662;7763;3445;169436;1902;79095;4882;4814;22949;10811;1514;4507;364;29979;138882;54836;1621;84904;19;6619;7010;51010;54981;8019;23732;6194;10999;30815;1289;377841;1539;64425;169841;55684;403341;10383;944;26086;392307;57582;1861;138724;138474;286223;257169;4010;23404;48;84186;692094;9966;318,750
1,1,9,203862,141020389,140816527,10171;29952;10422;158293;54863;84960;360203;92014;138240;54886;2220;441478;79937;81605;1164;644019;2800;55064;7743;399665;56654;138241;2395;4686;89891;2315;79695;5991;389792;389761;643596;51510;195828;2733;80709;10488;1056;375748;971;286362;10927;157983;392390;140459;286319;79956;114987;25;79886;6709;100129969;7415;7088;7185;27290;7016;5646;81873;10773;8022;83549;6256;6363;6621;57864;55342;375775;138804;26267;23230;3442;84929;81704;8021;6019;169792;9719;153090;29989;10497;4781;2040;51271;158234;653427;4783;84895;90871;10244;1384;3590;25769;158471;65268;54829;552891;7091;347148;3456;195827;10555;203197;80380;1955;51104;50808;8727;229;5887;259308;3190;51531;392309;158131;114789;23424;5537;10507;9853;158046;8395;7633;286343;548645;286336;7186;11092;441476;3441;94107;445571;5524;55234;169522;883;8518;728747;64855;5774;1029;56254;89882;6835;23137;54881;9380;11064;11091;375704;84270;5069;25920;9925;5900;79048;9615;138311;9827;80142;84302;23413;84131;79813;1761;7357;138429;401546;138805;10439;1757;64768;51280;54875;116225;9833;3293;26130;11093;210;115426;158376;79817;84681;4593;203286;23446;25792;642968;138162;401498;58524;9328;55664;8577;138151;728489;3439;84263;29988;51754;83543;286257;254956;5535;7094;90678;4712;27158;389762;220869;7539;26248;10558;401563;3444;22845;7306;6838;100526694;55958;3443;203328;64922;1515;301;51116;138883;254973;51450;23637;2356;10585;730112;22927;9022;27348;84814;54566;158405;116443;56623;7248;203259;54801;728577;3447;4702;727830;81932;55582;26737;23203;54534;91373;58499;727800;85365;92714;647060;360;169611;768;152006;401548;28989;85014;29991;10912;80010;203260;158399;57171;7295;158062;25934;389730;5079;158358;286204;84641;203238;54107;392392;57706;89853;730098;645961;9329;54840;5568;23731;2649;2902;29126;55312;11046;445815;6887;401565;90865;83744;2844;123;9830;3449;23511;26995;9373;3467;441457;55357;10952;441459;286256;157927;59335;92949;91283;51552;158135;9550;57720;10319;4799;8434;7410;2176;1025;2790;203228;727905;56033;51117;254295;1612;26206;6850;733;441425;29085;5082;7111;9991;53358;90120;3446;5998;100129385;286365;158056;11168;26301;2776;445;56751;57704;54187;570;6013;23245;57589;80173;92400;392399;22954;402381;9933;54932;23196;9314;3371;2218;347273;7099;23071;11217;6136;375743;55151;2889;116224;10592;158067;23299;389799;26578;286380;79269;10210;4915;1759;51148;2189;6461;54796;9536;158248;1842;10444;158326;6096;84688;10541;158431;727;3309;23452;6456;1211;27130;3717;9919;389812;140803;2592;55833;259;23349;320;158219;2731;253650;1271;10280;27090;27240;10020;56656;216;9568;54461;1903;9350;1306;340485;10850;881;100499483;2934;8721;7169;158038;55363;158427;84726;79987;64420;26149;255220;375759;653404;8555;401562;441430;441452;8777;55335;6837;7436;392391;338376;138065;573;25861;10807;55848;23099;2021;51759;55014;64975;10868;158158;27019;30968;2683;54926;9413;22869;774;5695;158055;401494;2650;5711;401505;23189;26735;138802;246184;687;80256;9414;26012;1993;203245;286207;169693;401551;80036;54942;83856;54542;138716;138881;549;100505993;403313;10880;9128;401541;6595;84253;65083;347168;169714;219;442425;84210;27433;138428;50514;10783;10670;26190;954;138255;5005;60560;8939;23064;401535;114299;2022;11224;51162;64078;4969;26147;158297;3440;9442;2619;286205;389816;23670;5047;5727;92715;203;3934;11182;3451;158401;9630;84909;5090;256691;6130;375791;5730;11172;152007;22844;389763;5253;389766;4851;138199;5004;10881;23586;138803;57109;3933;54754;100129669;3376;1317;26219;23307;8636;55071;81689;54769;8013;9355;25853;85301;5239;84628;2801;89958;6812;23392;6366;2516;56262;11253;26953;56904;11094;138799;3641;25822;7507;1318;389813;114991;84267;58493;157922;6836;84720;117531;26165;4300;445577;80318;23287;5742;54914;100505478;4958;169834;11258;8328;3452;257019;23552;55755;347252;4920;347240;9858;6505;2219;138715;256158;138307;20;29941;10044;3448;79670;7464;7046;138639;8818;646962;142680;375757;392376;1620;10655;79109;64794;23081;414328;6834;57462;64170;56832;6418;92399;347169;55035;9649;54586;84885;5789;3301;55667;349334;5125;286262;7270;89846;2529;26740;29968;29882;340481;8789;2304;23048;51490;113220;63951;414332;286234;26468;28;389827;1030;57684;4957;2203;54662;7763;3445;169436;1902;79095;4882;4814;22949;10811;1514;4507;364;29979;138882;54836;1621;84904;19;6619;7010;51010;54981;8019;23732;6194;10999;30815;1289;377841;1539;64425;169841;55684;403341;10383;944;26086;392307;57582;1861;138724;138474;286223;257169;4010;23404;48;84186;692094;9966;318,750
1,1,9,203862,141020389,140816527,10171;29952;10422;158293;54863;84960;360203;92014;138240;54886;2220;441478;79937;81605;1164;644019;2800;55064;7743;399665;56654;138241;2395;4686;89891;2315;79695;5991;389792;389761;643596;51510;195828;2733;80709;10488;1056;375748;971;286362;10927;157983;392390;140459;286319;79956;114987;25;79886;6709;100129969;7415;7088;7185;27290;7016;5646;81873;10773;8022;83549;6256;6363;6621;57864;55342;375775;138804;26267;23230;3442;84929;81704;8021;6019;169792;9719;153090;29989;10497;4781;2040;51271;158234;653427;4783;84895;90871;10244;1384;3590;25769;158471;65268;54829;552891;7091;347148;3456;195827;10555;203197;80380;1955;51104;50808;8727;229;5887;259308;3190;51531;392309;158131;114789;23424;5537;10507;9853;158046;8395;7633;286343;548645;286336;7186;11092;441476;3441;94107;445571;5524;55234;169522;883;8518;728747;64855;5774;1029;56254;89882;6835;23137;54881;9380;11064;11091;375704;84270;5069;25920;9925;5900;79048;9615;138311;9827;80142;84302;23413;84131;79813;1761;7357;138429;401546;138805;10439;1757;64768;51280;54875;116225;9833;3293;26130;11093;210;115426;158376;79817;84681;4593;203286;23446;25792;642968;138162;401498;58524;9328;55664;8577;138151;728489;3439;84263;29988;51754;83543;286257;254956;5535;7094;90678;4712;27158;389762;220869;7539;26248;10558;401563;3444;22845;7306;6838;100526694;55958;3443;203328;64922;1515;301;51116;138883;254973;51450;23637;2356;10585;730112;22927;9022;27348;84814;54566;158405;116443;56623;7248;203259;54801;728577;3447;4702;727830;81932;55582;26737;23203;54534;91373;58499;727800;85365;92714;647060;360;169611;768;152006;401548;28989;85014;29991;10912;80010;203260;158399;57171;7295;158062;25934;389730;5079;158358;286204;84641;203238;54107;392392;57706;89853;730098;645961;9329;54840;5568;23731;2649;2902;29126;55312;11046;445815;6887;401565;90865;83744;2844;123;9830;3449;23511;26995;9373;3467;441457;55357;10952;441459;286256;157927;59335;92949;91283;51552;158135;9550;57720;10319;4799;8434;7410;2176;1025;2790;203228;727905;56033;51117;254295;1612;26206;6850;733;441425;29085;5082;7111;9991;53358;90120;3446;5998;100129385;286365;158056;11168;26301;2776;445;56751;57704;54187;570;6013;23245;57589;80173;92400;392399;22954;402381;9933;54932;23196;9314;3371;2218;347273;7099;23071;11217;6136;375743;55151;2889;116224;10592;158067;23299;389799;26578;286380;79269;10210;4915;1759;51148;2189;6461;54796;9536;158248;1842;10444;158326;6096;84688;10541;158431;727;3309;23452;6456;1211;27130;3717;9919;389812;140803;2592;55833;259;23349;320;158219;2731;253650;1271;10280;27090;27240;10020;56656;216;9568;54461;1903;9350;1306;340485;10850;881;100499483;2934;8721;7169;158038;55363;158427;84726;79987;64420;26149;255220;375759;653404;8555;401562;441430;441452;8777;55335;6837;7436;392391;338376;138065;573;25861;10807;55848;23099;2021;51759;55014;64975;10868;158158;27019;30968;2683;54926;9413;22869;774;5695;158055;401494;2650;5711;401505;23189;26735;138802;246184;687;80256;9414;26012;1993;203245;286207;169693;401551;80036;54942;83856;54542;138716;138881;549;100505993;403313;10880;9128;401541;6595;84253;65083;347168;169714;219;442425;84210;27433;138428;50514;10783;10670;26190;954;138255;5005;60560;8939;23064;401535;114299;2022;11224;51162;64078;4969;26147;158297;3440;9442;2619;286205;389816;23670;5047;5727;92715;203;3934;11182;3451;158401;9630;84909;5090;256691;6130;375791;5730;11172;152007;22844;389763;5253;389766;4851;138199;5004;10881;23586;138803;57109;3933;54754;100129669;3376;1317;26219;23307;8636;55071;81689;54769;8013;9355;25853;85301;5239;84628;2801;89958;6812;23392;6366;2516;56262;11253;26953;56904;11094;138799;3641;25822;7507;1318;389813;114991;84267;58493;157922;6836;84720;117531;26165;4300;445577;80318;23287;5742;54914;100505478;4958;169834;11258;8328;3452;257019;23552;55755;347252;4920;347240;9858;6505;2219;138715;256158;138307;20;29941;10044;3448;79670;7464;7046;138639;8818;646962;142680;375757;392376;1620;10655;79109;64794;23081;414328;6834;57462;64170;56832;6418;92399;347169;55035;9649;54586;84885;5789;3301;55667;349334;5125;286262;7270;89846;2529;26740;29968;29882;340481;8789;2304;23048;51490;113220;63951;414332;286234;26468;28;389827;1030;57684;4957;2203;54662;7763;3445;169436;1902;79095;4882;4814;22949;10811;1514;4507;364;29979;138882;54836;1621;84904;19;6619;7010;51010;54981;8019;23732;6194;10999;30815;1289;377841;1539;64425;169841;55684;403341;10383;944;26086;392307;57582;1861;138724;138474;286223;257169;4010;23404;48;84186;692094;9966;318,750
1,1,9,203864,141020389,140816525,10171;29952;10422;158293;54863;84960;360203;92014;138240;54886;2220;441478;79937;81605;1164;644019;2800;55064;7743;399665;56654;138241;2395;4686;89891;2315;79695;5991;389792;389761;643596;51510;195828;2733;80709;10488;1056;375748;971;286362;10927;157983;392390;140459;286319;79956;114987;25;79886;6709;100129969;7415;7088;7185;27290;7016;5646;81873;10773;8022;83549;6256;6363;6621;57864;55342;375775;138804;26267;23230;3442;84929;81704;8021;6019;169792;9719;153090;29989;10497;4781;2040;51271;158234;653427;4783;84895;90871;10244;1384;3590;25769;158471;65268;54829;552891;7091;347148;3456;195827;10555;203197;80380;1955;51104;50808;8727;229;5887;259308;3190;51531;392309;158131;114789;23424;5537;10507;9853;158046;8395;7633;286343;548645;286336;7186;11092;441476;3441;94107;445571;5524;55234;169522;883;8518;728747;64855;5774;1029;56254;89882;6835;23137;54881;9380;11064;11091;375704;84270;5069;25920;9925;5900;79048;9615;138311;9827;80142;84302;23413;84131;79813;1761;7357;138429;401546;138805;10439;1757;64768;51280;54875;116225;9833;3293;26130;11093;210;115426;158376;79817;84681;4593;203286;23446;25792;642968;138162;401498;58524;9328;55664;8577;138151;728489;3439;84263;29988;51754;83543;286257;254956;5535;7094;90678;4712;27158;389762;220869;7539;26248;10558;401563;3444;22845;7306;6838;100526694;55958;3443;203328;64922;1515;301;51116;138883;254973;51450;23637;2356;10585;730112;22927;9022;27348;84814;54566;158405;116443;56623;7248;203259;54801;728577;3447;4702;727830;81932;55582;26737;23203;54534;91373;58499;727800;85365;92714;647060;360;169611;768;152006;401548;28989;85014;29991;10912;80010;203260;158399;57171;7295;158062;25934;389730;5079;158358;286204;84641;203238;54107;392392;57706;89853;730098;645961;9329;54840;5568;23731;2649;2902;29126;55312;11046;445815;6887;401565;90865;83744;2844;123;9830;3449;23511;26995;9373;3467;441457;55357;10952;441459;286256;157927;59335;92949;91283;51552;158135;9550;57720;10319;4799;8434;7410;2176;1025;2790;203228;727905;56033;51117;254295;1612;26206;6850;733;441425;29085;5082;7111;9991;53358;90120;3446;5998;100129385;286365;158056;11168;26301;2776;445;56751;57704;54187;570;6013;23245;57589;80173;92400;392399;22954;402381;9933;54932;23196;9314;3371;2218;347273;7099;23071;11217;6136;375743;55151;2889;116224;10592;158067;23299;389799;26578;286380;79269;10210;4915;1759;51148;2189;6461;54796;9536;158248;1842;10444;158326;6096;84688;10541;158431;727;3309;23452;6456;1211;27130;3717;9919;389812;140803;2592;55833;259;23349;320;158219;2731;253650;1271;10280;27090;27240;10020;56656;216;9568;54461;1903;9350;1306;340485;10850;881;100499483;2934;8721;7169;158038;55363;158427;84726;79987;64420;26149;255220;375759;653404;8555;401562;441430;441452;8777;55335;6837;7436;392391;338376;138065;573;25861;10807;55848;23099;2021;51759;55014;64975;10868;158158;27019;30968;2683;54926;9413;22869;774;5695;158055;401494;2650;5711;401505;23189;26735;138802;246184;687;80256;9414;26012;1993;203245;286207;169693;401551;80036;54942;83856;54542;138716;138881;549;100505993;403313;10880;9128;401541;6595;84253;65083;347168;169714;219;442425;84210;27433;138428;50514;10783;10670;26190;954;138255;5005;60560;8939;23064;401535;114299;2022;11224;51162;64078;4969;26147;158297;3440;9442;2619;286205;389816;23670;5047;5727;92715;203;3934;11182;3451;158401;9630;84909;5090;256691;6130;375791;5730;11172;152007;22844;389763;5253;389766;4851;138199;5004;10881;23586;138803;57109;3933;54754;100129669;3376;1317;26219;23307;8636;55071;81689;54769;8013;9355;25853;85301;5239;84628;2801;89958;6812;23392;6366;2516;56262;11253;26953;56904;11094;138799;3641;25822;7507;1318;389813;114991;84267;58493;157922;6836;84720;117531;26165;4300;445577;80318;23287;5742;54914;100505478;4958;169834;11258;8328;3452;257019;23552;55755;347252;4920;347240;9858;6505;2219;138715;256158;138307;20;29941;10044;3448;79670;7464;7046;138639;8818;646962;142680;375757;392376;1620;10655;79109;64794;23081;414328;6834;57462;64170;56832;6418;92399;347169;55035;9649;54586;84885;5789;3301;55667;349334;5125;286262;7270;89846;2529;26740;29968;29882;340481;8789;2304;23048;51490;113220;63951;414332;286234;26468;28;389827;1030;57684;4957;2203;54662;7763;3445;169436;1902;79095;4882;4814;22949;10811;1514;4507;364;29979;138882;54836;1621;84904;19;6619;7010;51010;54981;8019;23732;6194;10999;30815;1289;377841;1539;64425;169841;55684;403341;10383;944;26086;392307;57582;1861;138724;138474;286223;257169;4010;23404;48;84186;692094;9966;318,750
1,-1,9,203993,381630,177637,81704;157983,2
1,-1,9,204090,280321,76231,81704;157983,2
1,-1,9,204090,318901,114811,81704;157983,2
1,-1,9,204090,381572,177482,81704;157983,2
-1,1,9,204090,416321,212231,81704;157983,2
1,-1,9,204090,639077,434987,81704;23189;157983,3
1,1,9,204090,4970154,4766064,58524;10171;55664;5991;50808;7436;6505;157983;81704;23189;169522;403313;1761;6595;9933;10655;169792;55064,18
-1,1,9,204090,9282864,9078774,58524;10171;23081;55664;89882;50808;158358;81704;23189;5789;6019;1761;169792;55064;6505;29126;2315;5991;26953;90865;7436;3717;90871;6013;57589;157983;3641;403313;169522;115426;6595;79956;9933;2731;55848;11172;10655;80380,38
-1,1,9,204090,13146845,12942755,58524;10171;23081;55664;89882;50808;158358;81704;23189;5789;6019;286343;1761;169792;55064;6505;29126;2315;5991;8777;26953;90865;7436;3717;90871;6013;57589;157983;3641;7306;403313;169522;115426;6595;79956;9933;2731;55848;11172;10655;80380,41
-1,1,9,204090,15260598,15056508,58524;10171;23081;55664;89882;9350;50808;158358;81704;23189;5789;6019;286343;158326;1761;169792;55064;6505;29126;2315;4781;5991;8777;340481;26953;90865;7436;3717;90871;6013;57589;157983;3641;7306;403313;169522;158219;115426;6595;79956;9933;2731;55848;11172;10655;80380,46
1,1,9,204090,141018976,140814886,10171;29952;10422;158293;54863;84960;360203;92014;138240;54886;2220;441478;79937;81605;1164;644019;2800;55064;7743;399665;56654;138241;2395;4686;89891;2315;79695;5991;389792;389761;643596;51510;195828;2733;80709;10488;1056;375748;971;286362;10927;157983;392390;140459;286319;79956;114987;25;79886;6709;100129969;7415;7088;7185;27290;7016;5646;81873;10773;8022;83549;6256;6363;6621;57864;55342;375775;138804;26267;23230;3442;84929;81704;8021;6019;169792;9719;153090;29989;10497;4781;2040;51271;158234;653427;4783;84895;90871;10244;1384;3590;25769;158471;65268;54829;552891;7091;347148;3456;195827;10555;203197;80380;1955;51104;50808;8727;229;5887;259308;3190;51531;392309;158131;114789;23424;5537;10507;9853;158046;8395;7633;286343;548645;286336;7186;11092;441476;3441;94107;445571;5524;55234;169522;883;8518;728747;64855;5774;1029;56254;89882;6835;23137;54881;9380;11064;11091;375704;84270;5069;25920;9925;5900;79048;9615;138311;9827;80142;84302;23413;84131;79813;1761;7357;138429;401546;138805;10439;1757;64768;51280;54875;116225;9833;3293;26130;11093;210;115426;158376;79817;84681;4593;203286;23446;25792;642968;138162;401498;58524;9328;55664;8577;138151;728489;3439;84263;29988;51754;83543;286257;254956;5535;7094;90678;4712;27158;389762;220869;7539;26248;10558;401563;3444;22845;7306;6838;100526694;55958;3443;203328;64922;1515;301;51116;138883;254973;51450;23637;2356;10585;730112;22927;9022;27348;84814;54566;158405;116443;56623;7248;203259;54801;728577;3447;4702;727830;81932;55582;26737;23203;54534;91373;58499;727800;85365;92714;647060;360;169611;768;152006;401548;28989;85014;29991;10912;80010;203260;158399;57171;7295;158062;25934;389730;5079;158358;286204;84641;203238;54107;392392;57706;89853;730098;645961;9329;54840;5568;23731;2649;2902;29126;55312;11046;445815;6887;401565;90865;83744;2844;123;9830;3449;23511;26995;9373;3467;441457;55357;10952;441459;286256;157927;59335;92949;91283;51552;158135;9550;57720;10319;4799;8434;7410;2176;1025;2790;203228;727905;56033;51117;254295;1612;26206;6850;733;441425;29085;5082;7111;9991;53358;90120;3446;5998;100129385;286365;158056;11168;26301;2776;445;56751;57704;54187;570;6013;23245;57589;80173;92400;392399;22954;402381;9933;54932;23196;9314;3371;2218;347273;7099;23071;11217;6136;375743;55151;2889;116224;10592;158067;23299;389799;26578;286380;79269;10210;4915;1759;51148;2189;6461;54796;9536;158248;1842;10444;158326;6096;84688;10541;158431;727;3309;23452;6456;1211;27130;3717;9919;389812;140803;2592;55833;259;23349;320;158219;2731;253650;1271;10280;27090;27240;10020;56656;216;9568;54461;1903;9350;1306;340485;10850;881;100499483;2934;8721;7169;158038;55363;158427;84726;79987;64420;26149;255220;375759;653404;8555;401562;441430;441452;8777;55335;6837;7436;392391;338376;138065;573;25861;10807;55848;23099;2021;51759;55014;64975;10868;158158;27019;30968;2683;54926;9413;22869;774;5695;158055;401494;2650;5711;401505;23189;26735;138802;246184;687;80256;9414;26012;1993;203245;286207;169693;401551;80036;54942;83856;54542;138716;138881;549;100505993;403313;10880;9128;401541;6595;84253;65083;347168;169714;219;442425;84210;27433;138428;50514;10783;10670;26190;954;138255;5005;60560;8939;23064;401535;114299;2022;11224;51162;64078;4969;26147;158297;3440;9442;2619;286205;389816;23670;5047;5727;92715;203;3934;11182;3451;158401;9630;84909;5090;256691;6130;375791;5730;11172;152007;22844;389763;5253;389766;4851;138199;5004;10881;23586;138803;57109;3933;54754;100129669;3376;1317;26219;23307;8636;55071;81689;54769;8013;9355;25853;85301;5239;84628;2801;89958;6812;23392;6366;2516;56262;11253;26953;56904;11094;138799;3641;25822;7507;1318;389813;114991;84267;58493;157922;6836;84720;117531;26165;4300;445577;80318;23287;5742;54914;100505478;4958;169834;11258;8328;3452;257019;23552;55755;347252;4920;347240;9858;6505;2219;138715;256158;138307;20;29941;10044;3448;79670;7464;7046;138639;8818;646962;142680;375757;392376;1620;10655;79109;64794;23081;414328;6834;57462;64170;56832;6418;92399;347169;55035;9649;54586;84885;5789;3301;55667;349334;5125;286262;7270;89846;2529;26740;29968;29882;340481;8789;2304;23048;51490;113220;63951;414332;286234;26468;28;389827;1030;57684;4957;2203;54662;7763;3445;169436;1902;79095;4882;4814;22949;10811;1514;4507;364;29979;138882;54836;1621;84904;19;6619;7010;51010;54981;8019;23732;6194;10999;30815;1289;377841;1539;64425;169841;55684;403341;10383;944;26086;392307;57582;1861;138724;138474;286223;257169;4010;23404;48;84186;692094;9966;318,750
-1,1,9,204104,3367760,3163656,58524;81704;23189;169522;5991;6595;9933;10655;7436;1761;157983,11
-1,1,9,204104,3755031,3550927,58524;81704;23189;169522;5991;6595;9933;10655;7436;1761;157983,11
1,1,9,204104,5426099,5221995,58524;10171;55664;5991;50808;10655;7436;3717;6505;6013;157983;3641;81704;23189;403313;169522;6595;9933;6019;55848;11172;1761;169792;55064,24
-1,1,9,204104,5657733,5453629,58524;10171;29126;55664;5991;50808;10655;7436;3717;6505;6013;57589;157983;3641;81704;23189;403313;169522;6595;9933;6019;55848;11172;1761;169792;55064;80380,27
-1,1,9,204104,5695507,5491403,58524;10171;29126;55664;5991;50808;10655;7436;3717;6505;6013;57589;157983;3641;81704;23189;403313;169522;6595;9933;6019;55848;11172;1761;169792;55064;80380,27
-1,1,9,204104,6322471,6118367,58524;10171;55664;50808;158358;81704;23189;6019;1761;169792;55064;6505;29126;2315;5991;26953;90865;7436;3717;6013;57589;157983;3641;403313;169522;6595;79956;9933;55848;11172;10655;80380,32
-1,1,9,204104,7133443,6929339,58524;10171;23081;55664;89882;50808;158358;81704;23189;6019;1761;169792;55064;6505;29126;2315;5991;26953;90865;7436;3717;6013;57589;157983;3641;403313;169522;115426;6595;79956;9933;2731;55848;11172;10655;80380,36
-1,1,9,204104,8266492,8062388,58524;10171;23081;55664;89882;50808;158358;81704;23189;6019;1761;169792;55064;6505;29126;2315;5991;26953;90865;7436;3717;90871;6013;57589;157983;3641;403313;169522;115426;6595;79956;9933;2731;55848;11172;10655;80380,37
-1,1,9,204104,10023901,9819797,58524;10171;23081;55664;89882;50808;158358;81704;23189;5789;6019;1761;169792;55064;6505;29126;2315;5991;26953;90865;7436;3717;90871;6013;57589;157983;3641;403313;169522;115426;6595;79956;9933;2731;55848;11172;10655;80380,38
-1,1,9,204104,11298187,11094083,58524;10171;23081;55664;89882;50808;158358;81704;23189;5789;6019;1761;169792;55064;6505;29126;2315;5991;26953;90865;7436;3717;90871;6013;57589;157983;3641;403313;169522;115426;6595;79956;9933;2731;55848;11172;10655;80380,38
1,1,9,204104,11610300,11406196,58524;10171;23081;55664;89882;50808;158358;81704;23189;5789;6019;1761;169792;55064;6505;29126;2315;5991;26953;90865;7436;3717;90871;6013;57589;157983;3641;403313;169522;115426;6595;79956;9933;2731;55848;11172;10655;80380,38
-1,1,9,204104,14182667,13978563,58524;10171;23081;55664;89882;50808;158358;81704;23189;5789;6019;286343;1761;169792;55064;6505;29126;2315;4781;5991;8777;26953;90865;7436;3717;90871;6013;57589;157983;3641;7306;403313;169522;115426;6595;79956;9933;2731;55848;11172;10655;80380,42
-1,1,9,204104,18882279,18678175,58524;10171;23081;55664;89882;9350;50808;158358;6619;203238;81704;23189;5789;6019;54796;286343;158326;1761;169792;55064;6505;29126;2315;4781;11168;5991;100129385;8777;6456;340481;26953;90865;7436;3717;90871;54875;6013;57589;157983;3641;7306;403313;169522;158219;115426;6595;79956;9933;2731;55848;11172;10655;92949;80380,54
1,1,9,204104,27963367,27759263,58524;10171;23081;55664;50808;56832;3439;100129669;158358;401494;203238;54586;23189;5789;54796;286343;55667;158326;55064;1993;29126;2315;5991;6456;340481;26953;3441;3717;90865;123;3444;63951;3449;157983;3641;7306;158219;403313;169522;1030;9373;286319;6595;79956;55958;3443;3467;64922;2731;79886;92949;3445;1029;4300;10670;89882;9350;4507;54914;340485;203228;3442;6619;7010;81704;3452;158038;158297;3440;6194;6019;3446;1761;169792;6505;54801;4781;3447;100129385;11168;8777;3451;7436;90871;3448;54875;6013;25769;338376;57589;80173;115426;79817;3456;9933;55848;11172;10655;80380,99
1,1,9,204104,34151474,33947370,58524;10171;2683;54926;23081;55664;50808;23586;56832;3439;100129669;158358;401494;203238;54586;10210;23189;25853;5789;3301;54796;54840;286343;55667;158326;55064;4712;1993;29126;2315;5991;6456;51510;340481;26953;3441;3717;90865;123;3444;55833;63951;157983;3641;7306;3449;55234;158219;403313;169522;1030;9373;286319;6595;79956;55958;3443;3467;64922;2731;65083;441459;79886;92949;3445;1029;27290;5646;4300;10670;4799;89882;9350;4507;364;54914;340485;203228;3442;6619;7010;81704;3452;158038;158297;3440;6194;6019;3446;1761;169792;6505;54801;4781;3447;100129385;11168;8777;3451;7436;90871;3448;54875;6013;25769;338376;138474;57589;80173;573;48;115426;79817;360;3456;9933;55848;11172;10655;80380;401498,121
1,1,9,204104,38768291,38564187,58524;10171;55664;23586;92014;3439;100129669;51754;79269;10210;2189;6461;25853;7094;54796;158326;55064;4712;84688;2315;6366;5991;6456;51510;1211;26953;3717;10488;2592;3444;55833;971;157983;3641;7306;23349;25822;158219;286319;79956;55958;3443;64922;2731;253650;1271;10280;79886;27240;100129969;7415;84720;56656;10020;27290;7016;5646;4300;9350;54914;340485;6363;10850;730112;26267;11258;3442;881;81704;3452;158038;7169;347252;6019;347240;169792;6505;203259;138715;54801;10497;4781;3447;8777;51271;158234;7436;90871;3448;3590;25769;338376;646962;573;360;3456;55848;768;152006;10655;80380;27019;30968;2683;54926;203260;23081;50808;57462;56832;259308;5079;158358;401494;392309;401505;203238;54586;23189;730098;9853;5789;3301;54840;80256;286343;55667;1993;29126;340481;3441;90865;123;63951;138716;3449;55234;403313;169522;1030;9373;6595;3467;65083;441459;219;92949;3445;1029;4882;10670;4799;89882;8434;4507;364;9380;375704;203228;84904;9925;6619;26206;7010;51010;9827;158297;3440;6194;3446;64425;1761;100129385;11168;392307;3451;54875;57704;9833;6013;138724;138474;57589;80173;48;115426;158376;84186;79817;9933;692094;84681;11172;152007;22844;318;401498,197
1,1,9,204104,47212321,47008217,58524;10171;55664;23586;92014;3439;100129669;51754;79269;10210;2189;6461;79937;25853;7094;54796;158326;55064;4712;84688;2315;6366;5991;6456;51510;1211;26953;3717;10488;2592;3444;55833;971;157983;3641;7306;23349;25822;158219;286319;79956;55958;3443;64922;2731;253650;1271;10280;79886;27240;100129969;7415;84720;56656;10020;27290;7016;5646;4300;9350;54914;340485;6363;10850;730112;26267;11258;3442;881;81704;3452;158038;7169;347252;6019;347240;169792;6505;26149;203259;138715;54801;10497;4781;3447;727830;728577;441430;8777;51271;158234;7436;90871;3448;3590;25769;338376;646962;573;647060;360;3456;55848;768;152006;10655;80380;27019;30968;2683;54926;203260;23081;50808;57462;56832;389730;259308;5079;158358;401494;392309;401505;203238;54586;23189;730098;9853;5789;3301;54840;80256;286343;55667;1993;29126;340481;3441;90865;123;63951;138716;3449;55234;403313;169522;1030;9373;6595;3467;65083;441459;219;92949;3445;1029;4882;10670;4799;89882;8434;4507;364;9380;375704;203228;84904;727905;9925;6619;26206;7010;51010;441425;9827;158297;3440;6194;3446;64425;1761;100129385;11168;392307;3451;54875;57704;9833;6013;138724;138474;57589;80173;48;115426;158376;84186;79817;9933;692094;84681;11172;152007;22844;318;401498,206
1,1,9,204104,47212321,47008217,58524;10171;55664;23586;92014;3439;100129669;51754;79269;10210;2189;6461;79937;25853;7094;54796;158326;55064;4712;84688;2315;6366;5991;6456;51510;1211;26953;3717;10488;2592;3444;55833;971;157983;3641;7306;23349;25822;158219;286319;79956;55958;3443;64922;2731;253650;1271;10280;79886;27240;100129969;7415;84720;56656;10020;27290;7016;5646;4300;9350;54914;340485;6363;10850;730112;26267;11258;3442;881;81704;3452;158038;7169;347252;6019;347240;169792;6505;26149;203259;138715;54801;10497;4781;3447;727830;728577;441430;8777;51271;158234;7436;90871;3448;3590;25769;338376;646962;573;647060;360;3456;55848;768;152006;10655;80380;27019;30968;2683;54926;203260;23081;50808;57462;56832;389730;259308;5079;158358;401494;392309;401505;203238;54586;23189;730098;9853;5789;3301;54840;80256;286343;55667;1993;29126;340481;3441;90865;123;63951;138716;3449;55234;403313;169522;1030;9373;6595;3467;65083;441459;219;92949;3445;1029;4882;10670;4799;89882;8434;4507;364;9380;375704;203228;84904;727905;9925;6619;26206;7010;51010;441425;9827;158297;3440;6194;3446;64425;1761;100129385;11168;392307;3451;54875;57704;9833;6013;138724;138474;57589;80173;48;115426;158376;84186;79817;9933;692094;84681;11172;152007;22844;318;401498,206
1,1,9,204104,66516698,66312594,58524;10171;55664;23586;92014;3439;100129669;51754;79269;10210;2189;6461;79937;25853;7094;54796;158326;55064;4712;84688;2315;6366;5991;6456;51510;1211;26953;3717;10488;2592;3444;55833;971;157983;3641;7306;23349;25822;158219;286319;79956;55958;3443;64922;2731;253650;1271;10280;79886;27240;100129969;7415;84720;56656;10020;27290;7016;5646;26165;4300;9350;54914;340485;6363;10850;730112;26267;11258;3442;881;81704;3452;158038;7169;347252;6019;347240;169792;6505;26149;203259;138715;54801;10497;4781;3447;727830;728577;441430;8777;51271;158234;7436;90871;3448;3590;25769;338376;646962;573;647060;360;3456;55848;768;152006;10655;80380;27019;30968;2683;54926;203260;23081;50808;57462;56832;389730;259308;5079;158358;401494;392309;401505;203238;54586;23189;730098;9853;5789;3301;54840;80256;286343;55667;1993;29126;340481;3441;90865;123;63951;138716;3449;55234;403313;169522;1030;9373;6595;3467;65083;441459;219;92949;3445;1029;4882;10670;4799;89882;8434;4507;364;9380;375704;203228;84904;727905;9925;6619;26206;7010;51010;441425;9827;158297;3440;6194;3446;64425;1761;100129385;11168;392307;3451;54875;57704;9833;6013;138724;138474;57589;80173;48;115426;158376;84186;79817;9933;692094;84681;11172;152007;22844;318;401498,207
1,1,9,204104,82492731,82288627,10171;375743;116224;92014;138240;26578;286380;79269;10210;2189;6461;79937;54796;644019;158326;6096;55064;138241;2395;84688;2315;5991;6456;51510;1211;3717;140803;10488;2592;55833;971;157983;23349;320;158219;286319;79956;2731;253650;1271;10280;79886;27240;100129969;7415;10020;56656;216;27290;7016;5646;9350;340485;6363;10850;26267;881;3442;23230;81704;7169;158038;6019;169792;26149;10497;4781;653404;441430;8777;51271;158234;653427;7436;90871;3590;25769;338376;158471;573;7091;3456;55848;80380;27019;30968;2683;54926;9413;51104;50808;259308;401494;2650;392309;401505;23189;9853;687;8395;80256;9414;286343;1993;169693;3441;80036;445571;138716;55234;403313;169522;6595;65083;728747;219;442425;1029;84210;10670;89882;23137;138255;9380;375704;9925;9615;9827;158297;3440;84131;1761;23670;3451;54875;9833;9630;256691;115426;158376;79817;84681;11172;152007;22844;401498;58524;138199;55664;23586;3439;100129669;51754;55071;25853;7094;5239;4712;220869;6366;26953;3444;3641;7306;25822;55958;3443;64922;301;84720;117531;26165;4300;54914;730112;11258;3452;347252;347240;6505;203259;138715;54801;728577;3447;727830;3448;646962;647060;360;768;152006;10655;203260;23081;57462;56832;389730;5079;158358;203238;54586;730098;5789;3301;54840;55667;349334;5568;5125;29126;55312;29968;340481;90865;123;63951;3449;9373;1030;3467;441459;7763;92949;3445;4882;4799;8434;4507;364;203228;84904;727905;6619;26206;7010;51010;441425;54981;6194;3446;64425;100129385;11168;2776;392307;57704;6013;138724;138474;57589;80173;48;84186;9933;692094;318,257
1,1,9,204104,141053525,140849421,10171;29952;10422;158293;54863;84960;360203;92014;138240;54886;2220;441478;79937;81605;1164;644019;2800;55064;7743;399665;56654;138241;2395;4686;89891;2315;79695;5991;389792;389761;643596;51510;195828;2733;80709;10488;1056;375748;971;286362;10927;157983;392390;140459;286319;79956;114987;25;79886;6709;100129969;7415;7088;7185;27290;7016;5646;81873;10773;8022;83549;6256;6363;6621;57864;55342;375775;138804;26267;23230;3442;84929;81704;8021;6019;169792;9719;153090;29989;10497;4781;2040;51271;158234;653427;4783;84895;90871;10244;1384;3590;25769;158471;65268;54829;552891;7091;347148;3456;195827;10555;203197;80380;1955;51104;50808;8727;229;5887;259308;3190;51531;392309;158131;114789;23424;5537;10507;9853;158046;8395;7633;286343;548645;286336;7186;11092;441476;3441;94107;445571;5524;55234;169522;883;8518;728747;64855;5774;1029;56254;89882;6835;23137;54881;9380;11064;11091;375704;84270;5069;25920;9925;5900;79048;9615;138311;9827;80142;84302;23413;84131;79813;1761;7357;138429;401546;138805;10439;1757;64768;51280;54875;116225;9833;3293;26130;11093;210;115426;158376;79817;84681;4593;203286;23446;25792;642968;138162;401498;58524;9328;55664;8577;138151;728489;3439;84263;29988;51754;83543;286257;254956;5535;7094;90678;4712;27158;389762;220869;7539;26248;10558;401563;3444;22845;7306;6838;100526694;55958;3443;203328;64922;1515;301;51116;138883;254973;51450;23637;2356;10585;730112;22927;9022;27348;84814;54566;158405;116443;56623;7248;203259;54801;728577;3447;4702;727830;81932;55582;26737;23203;54534;91373;58499;727800;85365;92714;647060;360;169611;768;152006;401548;28989;85014;29991;10912;80010;203260;158399;57171;7295;158062;25934;389730;5079;158358;286204;84641;203238;54107;392392;57706;89853;730098;645961;9329;54840;5568;23731;2649;2902;29126;55312;11046;445815;6887;401565;90865;83744;2844;123;9830;3449;23511;26995;9373;3467;441457;55357;10952;441459;286256;157927;59335;92949;91283;51552;158135;9550;57720;10319;4799;8434;7410;2176;1025;2790;203228;727905;56033;51117;254295;1612;26206;6850;733;441425;29085;5082;7111;9991;53358;90120;3446;5998;100129385;286365;158056;11168;26301;2776;445;56751;57704;54187;570;6013;23245;57589;80173;92400;392399;22954;402381;9933;54932;23196;9314;3371;2218;347273;7099;23071;11217;6136;375743;55151;2889;116224;10592;158067;23299;389799;26578;286380;79269;10210;4915;1759;51148;2189;6461;54796;9536;158248;1842;10444;158326;6096;84688;10541;158431;727;3309;23452;6456;1211;27130;3717;9919;389812;140803;2592;55833;259;23349;320;158219;2731;253650;1271;10280;27090;27240;10020;56656;216;9568;54461;1903;9350;1306;340485;10850;881;100499483;2934;8721;7169;158038;55363;158427;84726;79987;64420;26149;255220;375759;653404;8555;401562;441430;441452;8777;55335;6837;7436;392391;338376;138065;573;25861;10807;55848;23099;2021;51759;55014;64975;10868;158158;27019;30968;2683;54926;9413;22869;774;5695;158055;401494;2650;5711;401505;23189;26735;138802;246184;687;80256;9414;26012;1993;203245;286207;169693;401551;80036;54942;83856;54542;138716;138881;549;100505993;403313;10880;9128;401541;6595;84253;65083;347168;169714;219;442425;84210;27433;138428;50514;10783;10670;26190;954;138255;5005;60560;8939;23064;401535;114299;2022;11224;51162;64078;4969;26147;158297;3440;9442;2619;286205;389816;23670;5047;5727;92715;203;3934;11182;3451;158401;9630;84909;5090;256691;6130;375791;5730;11172;152007;22844;389763;5253;389766;4851;138199;5004;10881;23586;138803;57109;3933;54754;100129669;3376;1317;26219;23307;8636;55071;81689;54769;8013;9355;25853;85301;5239;84628;2801;89958;6812;23392;6366;2516;56262;11253;26953;56904;11094;138799;3641;25822;7507;1318;389813;114991;84267;58493;157922;6836;84720;117531;26165;4300;445577;80318;23287;5742;54914;100505478;4958;169834;11258;8328;3452;257019;23552;55755;347252;4920;347240;9858;6505;2219;138715;256158;138307;20;29941;10044;3448;79670;7464;7046;138639;8818;646962;142680;375757;392376;1620;10655;79109;64794;23081;414328;6834;57462;64170;56832;6418;92399;347169;55035;9649;54586;84885;5789;3301;55667;349334;5125;286262;7270;89846;2529;26740;29968;29882;340481;8789;2304;23048;51490;113220;63951;414332;286234;26468;28;389827;1030;57684;4957;2203;54662;7763;3445;169436;1902;79095;4882;4814;22949;10811;1514;4507;364;29979;138882;54836;1621;84904;19;6619;7010;51010;54981;8019;23732;6194;10999;30815;1289;377841;1539;64425;169841;55684;403341;10383;944;26086;392307;57582;1861;138724;138474;286223;257169;4010;23404;48;84186;692094;9966;318,750
1,1,9,204104,141053525,140849421,10171;29952;10422;158293;54863;84960;360203;92014;138240;54886;2220;441478;79937;81605;1164;644019;2800;55064;7743;399665;56654;138241;2395;4686;89891;2315;79695;5991;389792;389761;643596;51510;195828;2733;80709;10488;1056;375748;971;286362;10927;157983;392390;140459;286319;79956;114987;25;79886;6709;100129969;7415;7088;7185;27290;7016;5646;81873;10773;8022;83549;6256;6363;6621;57864;55342;375775;138804;26267;23230;3442;84929;81704;8021;6019;169792;9719;153090;29989;10497;4781;2040;51271;158234;653427;4783;84895;90871;10244;1384;3590;25769;158471;65268;54829;552891;7091;347148;3456;195827;10555;203197;80380;1955;51104;50808;8727;229;5887;259308;3190;51531;392309;158131;114789;23424;5537;10507;9853;158046;8395;7633;286343;548645;286336;7186;11092;441476;3441;94107;445571;5524;55234;169522;883;8518;728747;64855;5774;1029;56254;89882;6835;23137;54881;9380;11064;11091;375704;84270;5069;25920;9925;5900;79048;9615;138311;9827;80142;84302;23413;84131;79813;1761;7357;138429;401546;138805;10439;1757;64768;51280;54875;116225;9833;3293;26130;11093;210;115426;158376;79817;84681;4593;203286;23446;25792;642968;138162;401498;58524;9328;55664;8577;138151;728489;3439;84263;29988;51754;83543;286257;254956;5535;7094;90678;4712;27158;389762;220869;7539;26248;10558;401563;3444;22845;7306;6838;100526694;55958;3443;203328;64922;1515;301;51116;138883;254973;51450;23637;2356;10585;730112;22927;9022;27348;84814;54566;158405;116443;56623;7248;203259;54801;728577;3447;4702;727830;81932;55582;26737;23203;54534;91373;58499;727800;85365;92714;647060;360;169611;768;152006;401548;28989;85014;29991;10912;80010;203260;158399;57171;7295;158062;25934;389730;5079;158358;286204;84641;203238;54107;392392;57706;89853;730098;645961;9329;54840;5568;23731;2649;2902;29126;55312;11046;445815;6887;401565;90865;83744;2844;123;9830;3449;23511;26995;9373;3467;441457;55357;10952;441459;286256;157927;59335;92949;91283;51552;158135;9550;57720;10319;4799;8434;7410;2176;1025;2790;203228;727905;56033;51117;254295;1612;26206;6850;733;441425;29085;5082;7111;9991;53358;90120;3446;5998;100129385;286365;158056;11168;26301;2776;445;56751;57704;54187;570;6013;23245;57589;80173;92400;392399;22954;402381;9933;54932;23196;9314;3371;2218;347273;7099;23071;11217;6136;375743;55151;2889;116224;10592;158067;23299;389799;26578;286380;79269;10210;4915;1759;51148;2189;6461;54796;9536;158248;1842;10444;158326;6096;84688;10541;158431;727;3309;23452;6456;1211;27130;3717;9919;389812;140803;2592;55833;259;23349;320;158219;2731;253650;1271;10280;27090;27240;10020;56656;216;9568;54461;1903;9350;1306;340485;10850;881;100499483;2934;8721;7169;158038;55363;158427;84726;79987;64420;26149;255220;375759;653404;8555;401562;441430;441452;8777;55335;6837;7436;392391;338376;138065;573;25861;10807;55848;23099;2021;51759;55014;64975;10868;158158;27019;30968;2683;54926;9413;22869;774;5695;158055;401494;2650;5711;401505;23189;26735;138802;246184;687;80256;9414;26012;1993;203245;286207;169693;401551;80036;54942;83856;54542;138716;138881;549;100505993;403313;10880;9128;401541;6595;84253;65083;347168;169714;219;442425;84210;27433;138428;50514;10783;10670;26190;954;138255;5005;60560;8939;23064;401535;114299;2022;11224;51162;64078;4969;26147;158297;3440;9442;2619;286205;389816;23670;5047;5727;92715;203;3934;11182;3451;158401;9630;84909;5090;256691;6130;375791;5730;11172;152007;22844;389763;5253;389766;4851;138199;5004;10881;23586;138803;57109;3933;54754;100129669;3376;1317;26219;23307;8636;55071;81689;54769;8013;9355;25853;85301;5239;84628;2801;89958;6812;23392;6366;2516;56262;11253;26953;56904;11094;138799;3641;25822;7507;1318;389813;114991;84267;58493;157922;6836;84720;117531;26165;4300;445577;80318;23287;5742;54914;100505478;4958;169834;11258;8328;3452;257019;23552;55755;347252;4920;347240;9858;6505;2219;138715;256158;138307;20;29941;10044;3448;79670;7464;7046;138639;8818;646962;142680;375757;392376;1620;10655;79109;64794;23081;414328;6834;57462;64170;56832;6418;92399;347169;55035;9649;54586;84885;5789;3301;55667;349334;5125;286262;7270;89846;2529;26740;29968;29882;340481;8789;2304;23048;51490;113220;63951;414332;286234;26468;28;389827;1030;57684;4957;2203;54662;7763;3445;169436;1902;79095;4882;4814;22949;10811;1514;4507;364;29979;138882;54836;1621;84904;19;6619;7010;51010;54981;8019;23732;6194;10999;30815;1289;377841;1539;64425;169841;55684;403341;10383;944;26086;392307;57582;1861;138724;138474;286223;257169;4010;23404;48;84186;692094;9966;318,750
1,1,9,204104,141053525,140849421,10171;29952;10422;158293;54863;84960;360203;92014;138240;54886;2220;441478;79937;81605;1164;644019;2800;55064;7743;399665;56654;138241;2395;4686;89891;2315;79695;5991;389792;389761;643596;51510;195828;2733;80709;10488;1056;375748;971;286362;10927;157983;392390;140459;286319;79956;114987;25;79886;6709;100129969;7415;7088;7185;27290;7016;5646;81873;10773;8022;83549;6256;6363;6621;57864;55342;375775;138804;26267;23230;3442;84929;81704;8021;6019;169792;9719;153090;29989;10497;4781;2040;51271;158234;653427;4783;84895;90871;10244;1384;3590;25769;158471;65268;54829;552891;7091;347148;3456;195827;10555;203197;80380;1955;51104;50808;8727;229;5887;259308;3190;51531;392309;158131;114789;23424;5537;10507;9853;158046;8395;7633;286343;548645;286336;7186;11092;441476;3441;94107;445571;5524;55234;169522;883;8518;728747;64855;5774;1029;56254;89882;6835;23137;54881;9380;11064;11091;375704;84270;5069;25920;9925;5900;79048;9615;138311;9827;80142;84302;23413;84131;79813;1761;7357;138429;401546;138805;10439;1757;64768;51280;54875;116225;9833;3293;26130;11093;210;115426;158376;79817;84681;4593;203286;23446;25792;642968;138162;401498;58524;9328;55664;8577;138151;728489;3439;84263;29988;51754;83543;286257;254956;5535;7094;90678;4712;27158;389762;220869;7539;26248;10558;401563;3444;22845;7306;6838;100526694;55958;3443;203328;64922;1515;301;51116;138883;254973;51450;23637;2356;10585;730112;22927;9022;27348;84814;54566;158405;116443;56623;7248;203259;54801;728577;3447;4702;727830;81932;55582;26737;23203;54534;91373;58499;727800;85365;92714;647060;360;169611;768;152006;401548;28989;85014;29991;10912;80010;203260;158399;57171;7295;158062;25934;389730;5079;158358;286204;84641;203238;54107;392392;57706;89853;730098;645961;9329;54840;5568;23731;2649;2902;29126;55312;11046;445815;6887;401565;90865;83744;2844;123;9830;3449;23511;26995;9373;3467;441457;55357;10952;441459;286256;157927;59335;92949;91283;51552;158135;9550;57720;10319;4799;8434;7410;2176;1025;2790;203228;727905;56033;51117;254295;1612;26206;6850;733;441425;29085;5082;7111;9991;53358;90120;3446;5998;100129385;286365;158056;11168;26301;2776;445;56751;57704;54187;570;6013;23245;57589;80173;92400;392399;22954;402381;9933;54932;23196;9314;3371;2218;347273;7099;23071;11217;6136;375743;55151;2889;116224;10592;158067;23299;389799;26578;286380;79269;10210;4915;1759;51148;2189;6461;54796;9536;158248;1842;10444;158326;6096;84688;10541;158431;727;3309;23452;6456;1211;27130;3717;9919;389812;140803;2592;55833;259;23349;320;158219;2731;253650;1271;10280;27090;27240;10020;56656;216;9568;54461;1903;9350;1306;340485;10850;881;100499483;2934;8721;7169;158038;55363;158427;84726;79987;64420;26149;255220;375759;653404;8555;401562;441430;441452;8777;55335;6837;7436;392391;338376;138065;573;25861;10807;55848;23099;2021;51759;55014;64975;10868;158158;27019;30968;2683;54926;9413;22869;774;5695;158055;401494;2650;5711;401505;23189;26735;138802;246184;687;80256;9414;26012;1993;203245;286207;169693;401551;80036;54942;83856;54542;138716;138881;549;100505993;403313;10880;9128;401541;6595;84253;65083;347168;169714;219;442425;84210;27433;138428;50514;10783;10670;26190;954;138255;5005;60560;8939;23064;401535;114299;2022;11224;51162;64078;4969;26147;158297;3440;9442;2619;286205;389816;23670;5047;5727;92715;203;3934;11182;3451;158401;9630;84909;5090;256691;6130;375791;5730;11172;152007;22844;389763;5253;389766;4851;138199;5004;10881;23586;138803;57109;3933;54754;100129669;3376;1317;26219;23307;8636;55071;81689;54769;8013;9355;25853;85301;5239;84628;2801;89958;6812;23392;6366;2516;56262;11253;26953;56904;11094;138799;3641;25822;7507;1318;389813;114991;84267;58493;157922;6836;84720;117531;26165;4300;445577;80318;23287;5742;54914;100505478;4958;169834;11258;8328;3452;257019;23552;55755;347252;4920;347240;9858;6505;2219;138715;256158;138307;20;29941;10044;3448;79670;7464;7046;138639;8818;646962;142680;375757;392376;1620;10655;79109;64794;23081;414328;6834;57462;64170;56832;6418;92399;347169;55035;9649;54586;84885;5789;3301;55667;349334;5125;286262;7270;89846;2529;26740;29968;29882;340481;8789;2304;23048;51490;113220;63951;414332;286234;26468;28;389827;1030;57684;4957;2203;54662;7763;3445;169436;1902;79095;4882;4814;22949;10811;1514;4507;364;29979;138882;54836;1621;84904;19;6619;7010;51010;54981;8019;23732;6194;10999;30815;1289;377841;1539;64425;169841;55684;403341;10383;944;26086;392307;57582;1861;138724;138474;286223;257169;4010;23404;48;84186;692094;9966;318,750
1,1,9,204104,141053525,140849421,10171;29952;10422;158293;54863;84960;360203;92014;138240;54886;2220;441478;79937;81605;1164;644019;2800;55064;7743;399665;56654;138241;2395;4686;89891;2315;79695;5991;389792;389761;643596;51510;195828;2733;80709;10488;1056;375748;971;286362;10927;157983;392390;140459;286319;79956;114987;25;79886;6709;100129969;7415;7088;7185;27290;7016;5646;81873;10773;8022;83549;6256;6363;6621;57864;55342;375775;138804;26267;23230;3442;84929;81704;8021;6019;169792;9719;153090;29989;10497;4781;2040;51271;158234;653427;4783;84895;90871;10244;1384;3590;25769;158471;65268;54829;552891;7091;347148;3456;195827;10555;203197;80380;1955;51104;50808;8727;229;5887;259308;3190;51531;392309;158131;114789;23424;5537;10507;9853;158046;8395;7633;286343;548645;286336;7186;11092;441476;3441;94107;445571;5524;55234;169522;883;8518;728747;64855;5774;1029;56254;89882;6835;23137;54881;9380;11064;11091;375704;84270;5069;25920;9925;5900;79048;9615;138311;9827;80142;84302;23413;84131;79813;1761;7357;138429;401546;138805;10439;1757;64768;51280;54875;116225;9833;3293;26130;11093;210;115426;158376;79817;84681;4593;203286;23446;25792;642968;138162;401498;58524;9328;55664;8577;138151;728489;3439;84263;29988;51754;83543;286257;254956;5535;7094;90678;4712;27158;389762;220869;7539;26248;10558;401563;3444;22845;7306;6838;100526694;55958;3443;203328;64922;1515;301;51116;138883;254973;51450;23637;2356;10585;730112;22927;9022;27348;84814;54566;158405;116443;56623;7248;203259;54801;728577;3447;4702;727830;81932;55582;26737;23203;54534;91373;58499;727800;85365;92714;647060;360;169611;768;152006;401548;28989;85014;29991;10912;80010;203260;158399;57171;7295;158062;25934;389730;5079;158358;286204;84641;203238;54107;392392;57706;89853;730098;645961;9329;54840;5568;23731;2649;2902;29126;55312;11046;445815;6887;401565;90865;83744;2844;123;9830;3449;23511;26995;9373;3467;441457;55357;10952;441459;286256;157927;59335;92949;91283;51552;158135;9550;57720;10319;4799;8434;7410;2176;1025;2790;203228;727905;56033;51117;254295;1612;26206;6850;733;441425;29085;5082;7111;9991;53358;90120;3446;5998;100129385;286365;158056;11168;26301;2776;445;56751;57704;54187;570;6013;23245;57589;80173;92400;392399;22954;402381;9933;54932;23196;9314;3371;2218;347273;7099;23071;11217;6136;375743;55151;2889;116224;10592;158067;23299;389799;26578;286380;79269;10210;4915;1759;51148;2189;6461;54796;9536;158248;1842;10444;158326;6096;84688;10541;158431;727;3309;23452;6456;1211;27130;3717;9919;389812;140803;2592;55833;259;23349;320;158219;2731;253650;1271;10280;27090;27240;10020;56656;216;9568;54461;1903;9350;1306;340485;10850;881;100499483;2934;8721;7169;158038;55363;158427;84726;79987;64420;26149;255220;375759;653404;8555;401562;441430;441452;8777;55335;6837;7436;392391;338376;138065;573;25861;10807;55848;23099;2021;51759;55014;64975;10868;158158;27019;30968;2683;54926;9413;22869;774;5695;158055;401494;2650;5711;401505;23189;26735;138802;246184;687;80256;9414;26012;1993;203245;286207;169693;401551;80036;54942;83856;54542;138716;138881;549;100505993;403313;10880;9128;401541;6595;84253;65083;347168;169714;219;442425;84210;27433;138428;50514;10783;10670;26190;954;138255;5005;60560;8939;23064;401535;114299;2022;11224;51162;64078;4969;26147;158297;3440;9442;2619;286205;389816;23670;5047;5727;92715;203;3934;11182;3451;158401;9630;84909;5090;256691;6130;375791;5730;11172;152007;22844;389763;5253;389766;4851;138199;5004;10881;23586;138803;57109;3933;54754;100129669;3376;1317;26219;23307;8636;55071;81689;54769;8013;9355;25853;85301;5239;84628;2801;89958;6812;23392;6366;2516;56262;11253;26953;56904;11094;138799;3641;25822;7507;1318;389813;114991;84267;58493;157922;6836;84720;117531;26165;4300;445577;80318;23287;5742;54914;100505478;4958;169834;11258;8328;3452;257019;23552;55755;347252;4920;347240;9858;6505;2219;138715;256158;138307;20;29941;10044;3448;79670;7464;7046;138639;8818;646962;142680;375757;392376;1620;10655;79109;64794;23081;414328;6834;57462;64170;56832;6418;92399;347169;55035;9649;54586;84885;5789;3301;55667;349334;5125;286262;7270;89846;2529;26740;29968;29882;340481;8789;2304;23048;51490;113220;63951;414332;286234;26468;28;389827;1030;57684;4957;2203;54662;7763;3445;169436;1902;79095;4882;4814;22949;10811;1514;4507;364;29979;138882;54836;1621;84904;19;6619;7010;51010;54981;8019;23732;6194;10999;30815;1289;377841;1539;64425;169841;55684;403341;10383;944;26086;392307;57582;1861;138724;138474;286223;257169;4010;23404;48;84186;692094;9966;318,750
1,-1,9,204193,295405,91212,81704;157983,2
1,-1,9,204193,381489,177296,81704;157983,2
1,-1,9,204193,381489,177296,81704;157983,2
1,-1,9,204193,381489,177296,81704;157983,2
-1,1,9,204193,1592365,1388172,58524;81704;23189;1761;10655;157983,6
-1,1,9,204193,4210335,4006142,58524;81704;23189;169522;5991;6595;9933;10655;7436;1761;169792;157983,12
-1,1,9,204193,6968724,6764531,58524;10171;23081;55664;89882;50808;158358;81704;23189;6019;1761;169792;55064;6505;29126;2315;5991;26953;90865;7436;3717;6013;57589;157983;3641;403313;169522;115426;6595;79956;9933;2731;55848;11172;10655;80380,36
-1,1,9,204193,10164955,9960762,58524;10171;23081;55664;89882;50808;158358;81704;23189;5789;6019;1761;169792;55064;6505;29126;2315;5991;26953;90865;7436;3717;90871;6013;57589;157983;3641;403313;169522;115426;6595;79956;9933;2731;55848;11172;10655;80380,38
-1,1,9,204193,10164955,9960762,58524;10171;23081;55664;89882;50808;158358;81704;23189;5789;6019;1761;169792;55064;6505;29126;2315;5991;26953;90865;7436;3717;90871;6013;57589;157983;3641;403313;169522;115426;6595;79956;9933;2731;55848;11172;10655;80380,38
-1,1,9,204193,10473327,10269134,58524;10171;23081;55664;89882;50808;158358;81704;23189;5789;6019;1761;169792;55064;6505;29126;2315;5991;26953;90865;7436;3717;90871;6013;57589;157983;3641;403313;169522;115426;6595;79956;9933;2731;55848;11172;10655;80380,38
-1,1,9,204193,10852686,10648493,58524;10171;23081;55664;89882;50808;158358;81704;23189;5789;6019;1761;169792;55064;6505;29126;2315;5991;26953;90865;7436;3717;90871;6013;57589;157983;3641;403313;169522;115426;6595;79956;9933;2731;55848;11172;10655;80380,38
-1,1,9,204193,11277770,11073577,58524;10171;23081;55664;89882;50808;158358;81704;23189;5789;6019;1761;169792;55064;6505;29126;2315;5991;26953;90865;7436;3717;90871;6013;57589;157983;3641;403313;169522;115426;6595;79956;9933;2731;55848;11172;10655;80380,38
-1,1,9,204193,11435662,11231469,58524;10171;23081;55664;89882;50808;158358;81704;23189;5789;6019;1761;169792;55064;6505;29126;2315;5991;26953;90865;7436;3717;90871;6013;57589;157983;3641;403313;169522;115426;6595;79956;9933;2731;55848;11172;10655;80380,38
-1,1,9,204193,16897578,16693385,58524;10171;23081;55664;89882;9350;50808;158358;6619;203238;81704;23189;5789;6019;54796;286343;158326;1761;169792;55064;6505;29126;2315;4781;11168;5991;100129385;8777;340481;26953;90865;7436;3717;90871;6013;57589;157983;3641;7306;403313;169522;158219;115426;6595;79956;9933;2731;55848;11172;10655;80380,51
-1,1,9,204193,18073357,17869164,58524;10171;23081;55664;89882;9350;50808;158358;6619;203238;81704;23189;5789;6019;54796;286343;158326;1761;169792;55064;6505;29126;2315;4781;11168;5991;100129385;8777;6456;340481;26953;90865;7436;3717;90871;54875;6013;57589;157983;3641;7306;403313;169522;158219;115426;6595;79956;9933;2731;55848;11172;10655;80380,53
1,1,9,204193,38815475,38611282,58524;10171;55664;23586;92014;3439;100129669;51754;79269;10210;2189;6461;25853;7094;54796;158326;55064;4712;84688;2315;6366;5991;6456;51510;1211;26953;3717;10488;2592;3444;55833;971;157983;3641;7306;23349;25822;158219;286319;79956;55958;3443;64922;2731;253650;1271;10280;79886;27240;100129969;7415;84720;56656;10020;27290;7016;5646;4300;9350;54914;340485;6363;10850;730112;26267;11258;3442;881;81704;3452;158038;7169;347252;6019;347240;169792;6505;203259;138715;54801;10497;4781;3447;8777;51271;158234;7436;90871;3448;3590;25769;338376;646962;573;360;3456;55848;768;152006;10655;80380;27019;30968;2683;54926;203260;23081;50808;57462;56832;259308;5079;158358;401494;392309;401505;203238;54586;23189;730098;9853;5789;3301;54840;80256;286343;55667;1993;29126;340481;3441;90865;123;63951;138716;3449;55234;403313;169522;1030;9373;6595;3467;65083;441459;219;92949;3445;1029;4882;10670;4799;89882;8434;4507;364;9380;375704;203228;84904;9925;6619;26206;7010;51010;9827;158297;3440;6194;3446;64425;1761;100129385;11168;392307;3451;54875;57704;9833;6013;138724;138474;57589;80173;48;115426;158376;84186;79817;9933;692094;84681;11172;152007;22844;318;401498,197
1,1,9,204193,38815475,38611282,58524;10171;55664;23586;92014;3439;100129669;51754;79269;10210;2189;6461;25853;7094;54796;158326;55064;4712;84688;2315;6366;5991;6456;51510;1211;26953;3717;10488;2592;3444;55833;971;157983;3641;7306;23349;25822;158219;286319;79956;55958;3443;64922;2731;253650;1271;10280;79886;27240;100129969;7415;84720;56656;10020;27290;7016;5646;4300;9350;54914;340485;6363;10850;730112;26267;11258;3442;881;81704;3452;158038;7169;347252;6019;347240;169792;6505;203259;138715;54801;10497;4781;3447;8777;51271;158234;7436;90871;3448;3590;25769;338376;646962;573;360;3456;55848;768;152006;10655;80380;27019;30968;2683;54926;203260;23081;50808;57462;56832;259308;5079;158358;401494;392309;401505;203238;54586;23189;730098;9853;5789;3301;54840;80256;286343;55667;1993;29126;340481;3441;90865;123;63951;138716;3449;55234;403313;169522;1030;9373;6595;3467;65083;441459;219;92949;3445;1029;4882;10670;4799;89882;8434;4507;364;9380;375704;203228;84904;9925;6619;26206;7010;51010;9827;158297;3440;6194;3446;64425;1761;100129385;11168;392307;3451;54875;57704;9833;6013;138724;138474;57589;80173;48;115426;158376;84186;79817;9933;692094;84681;11172;152007;22844;318;401498,197
1,1,9,204193,77230829,77026636,58524;10171;55664;375743;23586;116224;92014;3439;138240;100129669;51754;286380;79269;10210;2189;6461;79937;25853;7094;54796;5239;644019;158326;6096;55064;4712;2395;84688;138241;2315;6366;220869;5991;6456;51510;1211;26953;3717;10488;2592;3444;55833;971;157983;3641;7306;23349;25822;158219;320;286319;79956;55958;3443;64922;2731;253650;1271;10280;301;79886;27240;100129969;7415;84720;56656;10020;117531;27290;7016;5646;26165;216;4300;9350;54914;340485;6363;10850;730112;26267;11258;3442;881;81704;3452;158038;7169;347252;6019;347240;169792;6505;26149;203259;138715;54801;10497;4781;3447;727830;728577;653404;441430;8777;51271;158234;653427;7436;90871;3448;3590;25769;338376;646962;573;647060;360;3456;55848;768;152006;10655;80380;27019;30968;2683;54926;203260;9413;23081;51104;50808;57462;56832;389730;259308;5079;158358;401494;392309;401505;203238;54586;23189;730098;9853;687;8395;5789;3301;54840;80256;9414;286343;55667;349334;5568;1993;29126;169693;340481;3441;90865;80036;123;445571;63951;138716;3449;55234;403313;169522;1030;9373;6595;3467;65083;441459;728747;219;7763;92949;3445;1029;84210;4882;10670;4799;89882;8434;23137;138255;4507;364;9380;375704;203228;84904;727905;9925;6619;26206;7010;51010;9615;441425;9827;158297;3440;6194;3446;64425;1761;23670;100129385;11168;392307;3451;54875;57704;9833;6013;138724;138474;57589;80173;256691;48;115426;158376;84186;79817;9933;692094;84681;11172;152007;22844;318;401498,241
1,1,9,204193,141073897,140869704,10171;29952;10422;158293;54863;84960;360203;92014;138240;54886;2220;441478;79937;81605;1164;644019;2800;55064;7743;399665;56654;138241;2395;4686;89891;2315;79695;5991;389792;389761;643596;51510;195828;2733;80709;10488;1056;375748;971;286362;10927;157983;392390;140459;286319;79956;114987;25;79886;6709;100129969;7415;7088;7185;27290;7016;5646;81873;10773;8022;83549;6256;6363;6621;57864;55342;375775;138804;26267;23230;3442;84929;81704;8021;6019;169792;9719;153090;29989;10497;4781;2040;51271;158234;653427;4783;84895;90871;10244;1384;3590;25769;158471;65268;54829;552891;7091;347148;3456;195827;10555;203197;80380;1955;51104;50808;8727;229;5887;259308;3190;51531;392309;158131;114789;23424;5537;10507;9853;158046;8395;7633;286343;548645;286336;7186;11092;441476;3441;94107;445571;5524;55234;169522;883;8518;728747;64855;5774;1029;56254;89882;6835;23137;54881;9380;11064;11091;375704;84270;5069;25920;9925;5900;79048;9615;138311;9827;80142;84302;23413;84131;79813;1761;7357;138429;401546;138805;10439;1757;64768;51280;54875;116225;9833;3293;26130;11093;210;115426;158376;79817;84681;4593;203286;23446;25792;642968;138162;401498;58524;9328;55664;8577;138151;728489;3439;84263;29988;51754;83543;286257;254956;5535;7094;90678;4712;27158;389762;220869;7539;26248;10558;401563;3444;22845;7306;6838;100526694;55958;3443;203328;64922;1515;301;51116;138883;254973;51450;23637;2356;10585;730112;22927;9022;27348;84814;54566;158405;116443;56623;7248;203259;54801;728577;3447;4702;727830;81932;55582;26737;23203;54534;91373;58499;727800;85365;92714;647060;360;169611;768;152006;401548;28989;85014;29991;10912;80010;203260;158399;57171;7295;158062;25934;389730;5079;158358;286204;84641;203238;54107;392392;57706;89853;730098;645961;9329;54840;5568;23731;2649;2902;29126;55312;11046;445815;6887;401565;90865;83744;2844;123;9830;3449;23511;26995;9373;3467;441457;55357;10952;441459;286256;157927;59335;92949;91283;51552;158135;9550;57720;10319;4799;8434;7410;2176;1025;2790;203228;727905;56033;51117;254295;1612;26206;6850;733;441425;29085;5082;7111;9991;53358;90120;3446;5998;100129385;286365;158056;11168;26301;2776;445;56751;57704;54187;570;6013;23245;57589;80173;92400;392399;22954;402381;9933;54932;23196;9314;3371;2218;347273;7099;23071;11217;6136;375743;55151;2889;116224;10592;158067;23299;389799;26578;286380;79269;10210;4915;1759;51148;2189;6461;54796;9536;158248;1842;10444;158326;6096;84688;10541;158431;727;3309;23452;6456;1211;27130;3717;9919;389812;140803;2592;55833;259;23349;320;158219;2731;253650;1271;10280;27090;27240;10020;56656;216;9568;54461;1903;9350;1306;340485;10850;881;100499483;2934;8721;7169;158038;55363;158427;84726;79987;64420;26149;255220;375759;653404;8555;401562;441430;441452;8777;55335;6837;7436;392391;338376;138065;573;25861;10807;55848;23099;2021;51759;55014;64975;10868;158158;27019;30968;2683;54926;9413;22869;774;5695;158055;401494;2650;5711;401505;23189;26735;138802;246184;687;80256;9414;26012;1993;203245;286207;169693;401551;80036;54942;83856;54542;138716;138881;549;100505993;403313;10880;9128;401541;6595;84253;65083;347168;169714;219;442425;84210;27433;138428;50514;10783;10670;26190;954;138255;5005;60560;8939;23064;401535;114299;2022;11224;51162;64078;4969;26147;158297;3440;9442;2619;286205;389816;23670;5047;5727;92715;203;3934;11182;3451;158401;9630;84909;5090;256691;6130;375791;5730;11172;152007;22844;389763;5253;389766;4851;138199;5004;10881;23586;138803;57109;3933;54754;100129669;3376;1317;26219;23307;8636;55071;81689;54769;8013;9355;25853;85301;5239;84628;2801;89958;6812;23392;6366;2516;56262;11253;26953;56904;11094;138799;3641;25822;7507;1318;389813;114991;84267;58493;157922;6836;84720;117531;26165;4300;445577;80318;23287;5742;54914;100505478;4958;169834;11258;8328;3452;257019;23552;55755;347252;4920;347240;9858;6505;2219;138715;256158;138307;20;29941;10044;3448;79670;7464;7046;138639;8818;646962;142680;375757;392376;1620;10655;79109;64794;23081;414328;6834;57462;64170;56832;6418;92399;347169;55035;9649;54586;84885;5789;3301;55667;349334;5125;286262;7270;89846;2529;26740;29968;29882;340481;8789;2304;23048;51490;113220;63951;414332;286234;26468;28;389827;1030;57684;4957;2203;54662;7763;3445;169436;1902;79095;4882;4814;22949;10811;1514;4507;364;29979;138882;54836;1621;84904;19;6619;7010;51010;54981;8019;23732;6194;10999;30815;1289;377841;1539;64425;169841;55684;403341;10383;944;26086;392307;57582;1861;138724;138474;286223;257169;4010;23404;48;84186;692094;9966;318,750
1,1,9,204193,141073897,140869704,10171;29952;10422;158293;54863;84960;360203;92014;138240;54886;2220;441478;79937;81605;1164;644019;2800;55064;7743;399665;56654;138241;2395;4686;89891;2315;79695;5991;389792;389761;643596;51510;195828;2733;80709;10488;1056;375748;971;286362;10927;157983;392390;140459;286319;79956;114987;25;79886;6709;100129969;7415;7088;7185;27290;7016;5646;81873;10773;8022;83549;6256;6363;6621;57864;55342;375775;138804;26267;23230;3442;84929;81704;8021;6019;169792;9719;153090;29989;10497;4781;2040;51271;158234;653427;4783;84895;90871;10244;1384;3590;25769;158471;65268;54829;552891;7091;347148;3456;195827;10555;203197;80380;1955;51104;50808;8727;229;5887;259308;3190;51531;392309;158131;114789;23424;5537;10507;9853;158046;8395;7633;286343;548645;286336;7186;11092;441476;3441;94107;445571;5524;55234;169522;883;8518;728747;64855;5774;1029;56254;89882;6835;23137;54881;9380;11064;11091;375704;84270;5069;25920;9925;5900;79048;9615;138311;9827;80142;84302;23413;84131;79813;1761;7357;138429;401546;138805;10439;1757;64768;51280;54875;116225;9833;3293;26130;11093;210;115426;158376;79817;84681;4593;203286;23446;25792;642968;138162;401498;58524;9328;55664;8577;138151;728489;3439;84263;29988;51754;83543;286257;254956;5535;7094;90678;4712;27158;389762;220869;7539;26248;10558;401563;3444;22845;7306;6838;100526694;55958;3443;203328;64922;1515;301;51116;138883;254973;51450;23637;2356;10585;730112;22927;9022;27348;84814;54566;158405;116443;56623;7248;203259;54801;728577;3447;4702;727830;81932;55582;26737;23203;54534;91373;58499;727800;85365;92714;647060;360;169611;768;152006;401548;28989;85014;29991;10912;80010;203260;158399;57171;7295;158062;25934;389730;5079;158358;286204;84641;203238;54107;392392;57706;89853;730098;645961;9329;54840;5568;23731;2649;2902;29126;55312;11046;445815;6887;401565;90865;83744;2844;123;9830;3449;23511;26995;9373;3467;441457;55357;10952;441459;286256;157927;59335;92949;91283;51552;158135;9550;57720;10319;4799;8434;7410;2176;1025;2790;203228;727905;56033;51117;254295;1612;26206;6850;733;441425;29085;5082;7111;9991;53358;90120;3446;5998;100129385;286365;158056;11168;26301;2776;445;56751;57704;54187;570;6013;23245;57589;80173;92400;392399;22954;402381;9933;54932;23196;9314;3371;2218;347273;7099;23071;11217;6136;375743;55151;2889;116224;10592;158067;23299;389799;26578;286380;79269;10210;4915;1759;51148;2189;6461;54796;9536;158248;1842;10444;158326;6096;84688;10541;158431;727;3309;23452;6456;1211;27130;3717;9919;389812;140803;2592;55833;259;23349;320;158219;2731;253650;1271;10280;27090;27240;10020;56656;216;9568;54461;1903;9350;1306;340485;10850;881;100499483;2934;8721;7169;158038;55363;158427;84726;79987;64420;26149;255220;375759;653404;8555;401562;441430;441452;8777;55335;6837;7436;392391;338376;138065;573;25861;10807;55848;23099;2021;51759;55014;64975;10868;158158;27019;30968;2683;54926;9413;22869;774;5695;158055;401494;2650;5711;401505;23189;26735;138802;246184;687;80256;9414;26012;1993;203245;286207;169693;401551;80036;54942;83856;54542;138716;138881;549;100505993;403313;10880;9128;401541;6595;84253;65083;347168;169714;219;442425;84210;27433;138428;50514;10783;10670;26190;954;138255;5005;60560;8939;23064;401535;114299;2022;11224;51162;64078;4969;26147;158297;3440;9442;2619;286205;389816;23670;5047;5727;92715;203;3934;11182;3451;158401;9630;84909;5090;256691;6130;375791;5730;11172;152007;22844;389763;5253;389766;4851;138199;5004;10881;23586;138803;57109;3933;54754;100129669;3376;1317;26219;23307;8636;55071;81689;54769;8013;9355;25853;85301;5239;84628;2801;89958;6812;23392;6366;2516;56262;11253;26953;56904;11094;138799;3641;25822;7507;1318;389813;114991;84267;58493;157922;6836;84720;117531;26165;4300;445577;80318;23287;5742;54914;100505478;4958;169834;11258;8328;3452;257019;23552;55755;347252;4920;347240;9858;6505;2219;138715;256158;138307;20;29941;10044;3448;79670;7464;7046;138639;8818;646962;142680;375757;392376;1620;10655;79109;64794;23081;414328;6834;57462;64170;56832;6418;92399;347169;55035;9649;54586;84885;5789;3301;55667;349334;5125;286262;7270;89846;2529;26740;29968;29882;340481;8789;2304;23048;51490;113220;63951;414332;286234;26468;28;389827;1030;57684;4957;2203;54662;7763;3445;169436;1902;79095;4882;4814;22949;10811;1514;4507;364;29979;138882;54836;1621;84904;19;6619;7010;51010;54981;8019;23732;6194;10999;30815;1289;377841;1539;64425;169841;55684;403341;10383;944;26086;392307;57582;1861;138724;138474;286223;257169;4010;23404;48;84186;692094;9966;318,750
1,-1,9,207437,416351,208914,81704;157983,2
1,-1,9,211086,314969,103883,81704;157983,2
1,-1,9,211086,356079,144993,81704;157983,2
-1,1,9,211086,7444397,7233311,58524;10171;23081;55664;89882;50808;158358;81704;23189;6019;1761;169792;55064;6505;29126;2315;5991;26953;90865;7436;3717;6013;57589;157983;3641;403313;169522;115426;6595;79956;9933;2731;55848;11172;10655;80380,36
-1,1,9,211086,11457340,11246254,58524;10171;23081;55664;89882;50808;158358;81704;23189;5789;6019;1761;169792;55064;6505;29126;2315;5991;26953;90865;7436;3717;90871;6013;57589;157983;3641;403313;169522;115426;6595;79956;9933;2731;55848;11172;10655;80380,38
-1,1,9,213161,3497920,3284759,58524;81704;23189;169522;1761;5991;6595;9933;7436;10655;157983,11
-1,1,9,213161,17496750,17283589,58524;10171;23081;55664;89882;9350;50808;158358;6619;203238;81704;23189;5789;6019;54796;286343;158326;1761;169792;55064;6505;29126;2315;4781;11168;5991;100129385;8777;340481;26953;90865;7436;3717;90871;54875;6013;57589;157983;3641;7306;403313;169522;158219;115426;6595;79956;9933;2731;55848;11172;10655;80380,52
-1,1,9,214367,16307942,16093575,58524;10171;23081;55664;89882;9350;50808;158358;6619;203238;81704;23189;5789;6019;286343;158326;1761;169792;55064;6505;29126;2315;4781;11168;5991;100129385;8777;340481;26953;90865;7436;3717;90871;6013;57589;157983;3641;7306;403313;169522;158219;115426;6595;79956;9933;2731;55848;11172;10655;80380,50
1,-1,9,220253,332515,112262,81704,1
1,-1,9,220253,381489,161236,81704,1
-1,1,9,220253,7733826,7513573,58524;10171;23081;55664;89882;50808;158358;81704;23189;6019;1761;169792;55064;6505;29126;2315;5991;26953;90865;7436;3717;6013;57589;3641;403313;169522;115426;6595;79956;9933;2731;55848;11172;10655;80380,35
-1,1,9,220253,8866675,8646422,58524;10171;23081;55664;89882;50808;158358;81704;23189;5789;6019;1761;169792;55064;6505;29126;2315;5991;26953;90865;7436;3717;90871;6013;57589;3641;403313;169522;115426;6595;79956;9933;2731;55848;11172;10655;80380,37
-1,1,9,220253,18708803,18488550,58524;10171;23081;55664;89882;9350;50808;158358;6619;203238;81704;23189;5789;6019;54796;286343;158326;1761;169792;55064;6505;29126;2315;4781;11168;5991;100129385;8777;6456;340481;26953;90865;7436;3717;90871;54875;6013;57589;3641;7306;403313;169522;158219;115426;6595;79956;9933;2731;55848;11172;10655;92949;80380,53
1,1,9,220253,73245647,73025394,58524;10171;55664;375743;23586;116224;92014;3439;100129669;51754;286380;79269;10210;2189;6461;79937;25853;7094;54796;5239;644019;158326;55064;4712;2395;84688;2315;6366;220869;5991;6456;51510;1211;26953;3717;10488;2592;3444;55833;971;23349;3641;7306;25822;320;158219;286319;79956;55958;3443;64922;2731;253650;1271;10280;79886;27240;100129969;7415;84720;56656;10020;27290;7016;5646;26165;4300;9350;54914;340485;6363;10850;730112;26267;11258;3442;881;81704;3452;158038;7169;347252;6019;347240;169792;6505;26149;203259;138715;54801;10497;4781;3447;727830;728577;653404;441430;8777;51271;158234;653427;7436;90871;3448;3590;25769;338376;646962;573;647060;360;3456;55848;768;152006;10655;80380;27019;30968;2683;54926;203260;9413;23081;50808;57462;56832;389730;259308;5079;158358;401494;392309;401505;203238;54586;23189;730098;9853;687;8395;5789;3301;54840;80256;9414;286343;55667;349334;5568;1993;29126;169693;340481;3441;90865;80036;123;445571;63951;138716;3449;55234;403313;169522;1030;9373;6595;3467;65083;441459;728747;219;92949;3445;1029;84210;4882;10670;4799;89882;8434;23137;138255;4507;364;9380;375704;203228;84904;727905;9925;6619;26206;7010;51010;441425;9827;158297;3440;6194;3446;64425;1761;100129385;11168;392307;3451;54875;57704;9833;6013;138724;138474;57589;80173;256691;48;115426;158376;84186;79817;9933;692094;84681;11172;152007;22844;318;401498,230
1,1,9,220257,29424846,29204589,58524;10171;23081;55664;50808;56832;3439;100129669;158358;401494;203238;54586;23189;5789;54796;286343;55667;158326;55064;1993;29126;2315;5991;6456;340481;26953;3441;3717;90865;123;3444;63951;3449;3641;7306;158219;403313;169522;1030;9373;286319;6595;79956;55958;3443;3467;64922;2731;79886;92949;3445;1029;4300;10670;89882;9350;4507;54914;340485;203228;3442;6619;7010;81704;3452;158038;158297;3440;6194;6019;3446;1761;169792;6505;54801;4781;3447;100129385;11168;8777;3451;7436;90871;3448;54875;6013;25769;338376;57589;80173;115426;79817;3456;9933;55848;11172;10655;80380,98
1,-1,9,239426,315028,75602,81704,1
1,-1,9,245823,295405,49582,81704,1
1,-1,9,254654,329684,75030,81704,1
-1,1,9,266045,3346702,3080657,58524;81704;23189;169522;1761;5991;6595;9933;7436;10655,10
1,-1,9,271257,314969,43712,81704,1
1,-1,9,304377,639010,334633,81704;23189,2
-1,1,9,322690,16401654,16078964,58524;10171;23081;55664;89882;9350;50808;158358;6619;203238;81704;23189;5789;6019;286343;158326;1761;169792;55064;6505;29126;2315;4781;11168;5991;100129385;8777;340481;26953;90865;7436;3717;90871;6013;57589;3641;7306;403313;169522;158219;115426;6595;79956;9933;2731;55848;11172;10655;80380,49
1,-1,9,325759,500607,174848,81704;23189,2
1,-1,9,329684,500525,170841,81704;23189,2
1,-1,9,459131,862833,403702,1761;81704;23189,3
1,1,9,459131,24207892,23748761,58524;10171;23081;55664;50808;3439;158358;401494;203238;23189;5789;54796;286343;55667;158326;55064;1993;29126;2315;5991;6456;340481;26953;3441;3717;90865;123;3444;63951;3449;3641;7306;158219;403313;169522;1030;6595;3467;79956;55958;3443;2731;92949;3445;1029;4300;10670;89882;9350;4507;54914;340485;3442;6619;81704;3452;158297;3440;6194;6019;3446;1761;169792;6505;54801;4781;3447;100129385;11168;8777;3451;7436;90871;3448;54875;6013;25769;338376;57589;115426;3456;9933;55848;11172;10655;80380,86
-1,1,9,556625,703693,147068,23189,1
1,-1,9,579739,753199,173460,23189,1
-1,1,9,635338,685819,50481,23189,1
-1,-1,9,1611053,1703711,92658,,0
1,-1,9,2413996,2711186,297190,7436,1
1,1,9,3591159,9361786,5770627,10171;29126;23081;55664;2315;89882;50808;26953;90865;3717;90871;6505;158358;6013;57589;3641;403313;115426;79956;5789;2731;6019;55848;11172;169792;55064;80380,27
-1,1,9,4152060,8518353,4366293,10171;29126;23081;55664;2315;89882;50808;26953;90865;3717;90871;6505;158358;6013;57589;3641;403313;115426;79956;5789;2731;6019;55848;11172;169792;55064;80380,27
-1,1,9,4581369,14848338,10266969,10171;23081;55664;89882;9350;50808;158358;5789;6019;286343;158326;6505;55064;29126;2315;4781;8777;340481;26953;90865;3717;90871;6013;57589;3641;7306;403313;115426;79956;2731;55848;11172;80380,33
-1,-1,9,4627565,4724294,96729,403313;55664;55064;50808,4
1,1,9,4661872,27661570,22999698,10171;23081;55664;50808;56832;3439;100129669;158358;401494;203238;54586;5789;54796;286343;55667;158326;55064;1993;29126;2315;6456;340481;26953;3441;3717;90865;123;3444;63951;3449;3641;7306;158219;403313;9373;1030;286319;3467;79956;55958;3443;64922;2731;79886;92949;3445;1029;4300;10670;89882;9350;4507;54914;340485;203228;3442;6619;7010;3452;158297;3440;6194;6019;3446;54801;4781;3447;100129385;11168;8777;3451;90871;3448;54875;6013;25769;338376;57589;80173;115426;79817;3456;55848;11172;80380,85
1,-1,9,5126597,5185255,58658,3717;11172,2
-1,-1,9,5231467,5233791,2324,3641,1
1,-1,9,5304531,5335597,31066,6019;6013,2
-1,-1,9,5304531,5335597,31066,6019;6013,2
-1,-1,9,5304531,5335597,31066,6019;6013,2
-1,-1,9,5304531,5335597,31066,6019;6013,2
1,-1,9,5304531,5335597,31066,6019;6013,2
-1,-1,9,5304531,5335597,31066,6019;6013,2
-1,-1,9,5304531,5335597,31066,6019;6013,2
1,1,9,5900425,30008330,24107905,23081;56832;3439;158358;401494;100129669;203238;54586;5789;54796;286343;55667;158326;1993;2315;6456;340481;26953;90865;3441;123;3444;63951;3449;7306;158219;9373;1030;3467;286319;55958;3443;64922;2731;79886;92949;3445;1029;4300;10670;89882;9350;4507;54914;340485;203228;6619;3442;7010;3452;158038;158297;3440;6194;3446;54801;4781;100129385;3447;11168;8777;3451;90871;54875;3448;25769;338376;80173;115426;79817;3456,71
1,-1,9,6558442,6838207,279765,2731;23081,2
1,-1,9,6672380,6714941,42561,,0
1,-1,9,6672380,6906978,234598,23081,1
1,1,9,7162304,37038768,29876464,23586;3439;100129669;51754;10210;2189;25853;7094;54796;158326;4712;84688;6366;6456;51510;1211;10488;2592;3444;55833;971;23349;7306;25822;158219;286319;55958;3443;64922;1271;10280;79886;27240;100129969;7415;84720;56656;10020;27290;7016;5646;4300;9350;54914;340485;6363;10850;730112;11258;3442;881;3452;158038;7169;347240;203259;138715;54801;10497;4781;3447;8777;51271;90871;3448;3590;25769;338376;646962;573;360;3456;768;152006;27019;30968;2683;54926;203260;23081;57462;56832;259308;5079;401494;392309;203238;54586;730098;9853;5789;3301;54840;80256;286343;55667;1993;340481;3441;123;63951;138716;3449;55234;9373;1030;3467;65083;441459;92949;3445;1029;4882;10670;4799;8434;4507;364;375704;203228;84904;6619;26206;7010;9827;158297;3440;6194;3446;100129385;11168;392307;3451;54875;57704;9833;138724;138474;80173;48;158376;79817;692094;84681;152007;318;401498,147
-1,-1,9,7493709,7733797,240088,,0
-1,-1,9,8039875,8157531,117656,,0
-1,-1,9,8065133,8187842,122709,,0
-1,-1,9,8284068,8331541,47473,5789,1
-1,-1,9,8903382,9014802,111420,5789,1
-1,-1,9,9400269,9486593,86324,5789,1
-1,-1,9,9782827,9872073,89246,5789,1
1,-1,9,10249116,10340720,91604,5789,1
1,1,9,10527668,13276052,2748384,7306;286343;8777;5789,4
1,-1,9,11172890,12196342,1023452,,0
-1,-1,9,11298130,11530555,232425,,0
-1,-1,9,11573531,11713632,140101,,0
-1,-1,9,11573531,11868524,294993,,0
-1,-1,9,11659096,11904449,245353,,0
-1,-1,9,11659296,11927681,268385,,0
-1,-1,9,11659296,11927681,268385,,0
-1,-1,9,11713632,11868524,154892,,0
-1,-1,9,11780648,12114519,333871,,0
1,-1,9,11780402,12074235,293833,,0
-1,-1,9,11818286,12074236,255950,,0
-1,-1,9,11851575,12074236,222661,,0
-1,-1,9,11868524,11952522,83998,,0
-1,-1,9,11868524,12007047,138523,,0
-1,-1,9,11904249,11981564,77315,,0
-1,-1,9,11952416,12180177,227761,,0
-1,-1,9,11952416,12180177,227761,,0
-1,-1,9,11927681,12007047,79366,,0
-1,-1,9,11927681,12007047,79366,,0
-1,-1,9,12031727,12114297,82570,,0
1,1,9,17132123,35567051,18434928,2683;54926;23586;57462;56832;3439;259308;100129669;401494;30968;10210;54586;2189;730098;9853;25853;3301;54840;80256;55667;4712;84688;1993;6366;6456;51510;3441;123;2592;3444;55833;63951;23349;25822;138716;3449;55234;9373;1030;286319;3467;55958;3443;65083;64922;441459;1271;10280;79886;92949;100129969;7415;3445;84720;1029;27290;5646;4300;10670;4799;4507;364;54914;340485;6363;375704;203228;10850;730112;11258;3442;7010;3452;158038;158297;3440;6194;347240;3446;203259;138715;54801;10497;3447;51271;3451;54875;3448;3590;138724;25769;338376;138474;80173;573;48;79817;360;3456;318;401498;27019,102
1,1,9,17502885,18681089,1178204,92949;54875;6456,3
1,1,9,17684434,30889762,13205328,4300;10670;4507;54914;340485;56832;203228;3439;100129669;401494;3442;7010;54586;3452;158038;158297;3440;6194;55667;3446;54801;1993;3447;6456;3441;3451;3448;123;3444;25769;3449;338376;63951;80173;9373;1030;3467;286319;55958;79817;3443;3456;64922;79886;92949;3445;1029,47
1,1,9,18344603,68995221,50650618,23586;92014;3439;100129669;51754;79269;10210;2189;6461;79937;25853;7094;4712;84688;6366;51510;1211;10488;2592;3444;55833;971;23349;25822;286319;55958;3443;64922;253650;1271;10280;79886;27240;100129969;7415;84720;56656;10020;27290;7016;5646;26165;4300;54914;340485;6363;10850;730112;26267;11258;3442;881;3452;158038;7169;347252;347240;26149;203259;138715;54801;10497;3447;728577;727830;441430;51271;158234;3448;3590;25769;338376;646962;573;647060;360;3456;768;152006;27019;30968;2683;54926;203260;57462;56832;389730;259308;5079;401494;392309;401505;54586;730098;9853;3301;54840;80256;55667;1993;3441;123;63951;138716;3449;55234;9373;1030;3467;65083;441459;219;92949;3445;1029;84210;4882;10670;4799;8434;4507;364;9380;375704;203228;84904;727905;9925;26206;7010;51010;441425;9827;158297;3440;6194;3446;64425;392307;3451;57704;9833;138724;138474;80173;48;158376;84186;79817;692094;84681;152007;22844;318;401498,155
1,-1,9,19096648,19096707,59,54801,1
-1,1,9,19564273,28106620,8542347,4300;4507;54914;56832;203228;3439;100129669;401494;3442;7010;54586;3452;158038;3440;3446;1993;3447;3441;3451;3448;3444;25769;63951;3449;338376;80173;9373;1030;3467;286319;55958;79817;3443;3456;64922;79886;3445;1029,38
-1,1,9,20951885,22447709,1495824,3447;4507;3441;54914;3451;3448;3439;401494;3444;63951;338376;3442;3449;3452;1030;3467;3440;55958;3443;3456;3446;3445;1029,23
-1,-1,9,21201443,21206896,5453,3444;3446,2
-1,-1,9,22212553,22326165,113612,,0
-1,-1,9,24083476,24349363,265887,,0
-1,-1,9,25259013,25346912,87899,,0
-1,-1,9,25259013,25346912,87899,,0
-1,-1,9,25259013,25346912,87899,,0
-1,-1,9,25259013,25346912,87899,,0
-1,-1,9,25259013,25346912,87899,,0
-1,-1,9,25259013,25346912,87899,,0
-1,-1,9,25259013,25346912,87899,,0
-1,-1,9,25527395,25616019,88624,,0
-1,-1,9,26274518,26405992,131474,,0
-1,-1,9,28191461,28320731,129270,158038,1
-1,-1,9,28191461,28320731,129270,158038,1
-1,-1,9,28191461,28320731,129270,158038,1
-1,-1,9,28531365,28733362,201997,158038,1
-1,-1,9,28531365,28733362,201997,158038,1
-1,-1,9,28604406,28849041,244635,158038,1
-1,-1,9,28604283,28718395,114112,158038,1
-1,-1,9,28604283,28718395,114112,158038,1
-1,-1,9,28604283,28718395,114112,158038,1
-1,-1,9,28670178,28745046,74868,158038,1
-1,-1,9,29963344,30247394,284050,,0
-1,-1,9,30357226,30660176,302950,,0
-1,-1,9,30424069,30520898,96829,,0
-1,-1,9,30424069,30520898,96829,,0
1,1,9,31426825,68330127,36903302,2683;54926;203260;23586;57462;92014;389730;259308;5079;51754;392309;401505;79269;10210;2189;6461;79937;730098;25853;7094;9853;3301;54840;80256;4712;84688;22844;6366;51510;1211;10488;2592;55833;971;138716;23349;25822;55234;65083;441459;253650;1271;10280;219;27240;7415;100129969;84210;84720;56656;10020;27290;7016;5646;26165;4882;4799;8434;9380;364;6363;375704;84904;727905;10850;9925;730112;26267;11258;881;26206;51010;7169;441425;9827;347252;347240;64425;26149;203259;138715;10497;728577;727830;441430;51271;158234;392307;57704;3590;9833;138724;138474;646962;573;27019;48;647060;158376;84186;360;692094;84681;768;152006;152007;318;401498;30968,109
-1,-1,9,31567894,31642030,74136,,0
-1,1,9,32865025,32996644,131619,54840,1
1,-1,9,33165444,33259483,94039,2683;27290;573,3
1,-1,9,33165444,33259483,94039,2683;27290;573,3
1,1,9,33225728,38529810,5304082,54926;203260;57462;92014;259308;5079;51754;392309;401505;79269;2189;6461;730098;9853;25853;7094;80256;84688;22844;6366;51510;1211;10488;2592;55833;971;138716;23349;25822;65083;441459;1271;10280;219;27240;7415;100129969;10020;84720;56656;27290;7016;5646;4882;4799;8434;9380;364;6363;375704;84904;10850;9925;730112;26267;11258;881;26206;51010;7169;9827;347252;347240;64425;203259;138715;10497;51271;158234;392307;57704;3590;9833;138724;646962;573;27019;158376;84186;360;692094;84681;768;152006;152007;318;30968,87
1,1,9,33333162,71534501,38201339,54926;203260;57462;116224;92014;389730;259308;5079;51754;286380;392309;401505;79269;2189;6461;79937;730098;25853;7094;9853;8395;5239;80256;644019;349334;84688;22844;220869;6366;169693;1211;10488;445571;2592;55833;971;138716;23349;25822;441459;65083;253650;728747;1271;10280;219;27240;7415;100129969;84210;10020;84720;56656;7016;5646;26165;4882;4799;8434;9380;364;6363;375704;84904;727905;10850;9925;730112;26267;11258;881;26206;51010;7169;441425;9827;347252;347240;64425;26149;203259;138715;10497;728577;727830;653404;441430;51271;158234;653427;392307;57704;3590;9833;138724;646962;27019;647060;158376;84186;360;692094;84681;768;152006;152007;318;30968,108
-1,1,9,33572679,36782012,3209333,54926;203260;57462;259308;51754;392309;2189;730098;9853;25853;7094;80256;84688;6366;1211;10488;2592;138716;55833;971;23349;25822;441459;1271;10280;27240;7415;100129969;10020;84720;56656;7016;5646;4882;8434;375704;6363;84904;10850;730112;11258;26206;881;7169;9827;347240;203259;138715;10497;51271;392307;57704;3590;9833;138724;646962;27019;158376;692094;84681;768;152007;152006;318;30968,65
1,1,9,35623497,38815471,3191974,203260;4882;8434;9380;92014;84904;5079;9925;51754;26267;392309;26206;881;401505;51010;79269;7169;9827;6461;347252;7094;64425;22844;392307;1211;158234;57704;10488;9833;646962;158376;84186;692094;253650;84681;768;152007;152006;27240;219;10020;56656,42
1,-1,9,38409052,43610709,5201657,727830;647060;441425;347252;441430;79937;253650;727905;26149,9
1,-1,9,38422969,65482544,27059575,728577;727830;647060;441425;347252;441430;79937;253650;389730;727905;26149,11
1,-1,9,38536895,44265200,5728305,728577;727830;647060;441425;441430;79937;253650;389730;727905;26149,10
1,-1,9,38536895,44265200,5728305,728577;727830;647060;441425;441430;79937;253650;389730;727905;26149,10
1,-1,9,38741597,44259405,5517808,728577;727830;647060;441425;441430;79937;389730;727905;26149,9
1,-1,9,38741597,45667381,6925784,728577;727830;647060;441425;441430;79937;389730;727905;26149,9
1,-1,9,38741597,65482544,26740947,728577;727830;647060;441425;441430;79937;389730;727905;26149,9
1,-1,9,38755084,45429384,6674300,728577;727830;647060;441425;441430;79937;389730;727905;26149,9
1,-1,9,38755084,46656999,7901915,728577;727830;647060;441425;441430;79937;389730;727905;26149,9
-1,-1,9,38768412,39141842,373430,79937,1
1,-1,9,38764616,45364733,6600117,728577;727830;647060;441425;441430;79937;389730;727905;26149,9
-1,-1,9,38764616,65482544,26717928,728577;727830;647060;441425;441430;79937;389730;727905;26149,9
1,-1,9,38868468,39407645,539177,79937;647060,2
1,-1,9,38789216,39407645,618429,79937;647060,2
1,-1,9,38768471,40375071,1606600,79937;647060,2
1,-1,9,38768471,42000733,3232262,26149;727830;647060;727905;79937,5
1,-1,9,38768471,43606290,4837819,26149;727830;647060;441425;727905;441430;79937,7
1,-1,9,38768471,44245546,5477075,728577;727830;647060;441425;441430;79937;389730;727905;26149,9
1,-1,9,38768471,44259405,5490934,728577;727830;647060;441425;441430;79937;389730;727905;26149,9
1,-1,9,38768471,44259405,5490934,728577;727830;647060;441425;441430;79937;389730;727905;26149,9
1,-1,9,38768471,44259405,5490934,728577;727830;647060;441425;441430;79937;389730;727905;26149,9
1,-1,9,38768471,44259405,5490934,728577;727830;647060;441425;441430;79937;389730;727905;26149,9
1,-1,9,38768471,45352054,6583583,728577;727830;647060;441425;441430;79937;389730;727905;26149,9
1,-1,9,38768471,45378350,6609879,728577;727830;647060;441425;441430;79937;389730;727905;26149,9
1,-1,9,38768471,46656999,7888528,728577;727830;647060;441425;441430;79937;389730;727905;26149,9
1,-1,9,38768471,47199215,8430744,728577;727830;647060;441425;441430;79937;389730;727905;26149,9
1,-1,9,38768471,65482544,26714073,728577;727830;647060;441425;441430;79937;389730;727905;26149,9
1,-1,9,38768471,65482544,26714073,728577;727830;647060;441425;441430;79937;389730;727905;26149,9
1,-1,9,38768471,65482544,26714073,728577;727830;647060;441425;441430;79937;389730;727905;26149,9
1,-1,9,38768471,65482544,26714073,728577;727830;647060;441425;441430;79937;389730;727905;26149,9
1,-1,9,38768471,65482544,26714073,728577;727830;647060;441425;441430;79937;389730;727905;26149,9
-1,-1,9,38768471,65482544,26714073,728577;727830;647060;441425;441430;79937;389730;727905;26149,9
1,-1,9,38768471,65482544,26714073,728577;727830;647060;441425;441430;79937;389730;727905;26149,9
1,-1,9,38768471,65482544,26714073,728577;727830;647060;441425;441430;79937;389730;727905;26149,9
1,-1,9,38768471,65482544,26714073,728577;727830;647060;441425;441430;79937;389730;727905;26149,9
1,-1,9,38768471,65482544,26714073,728577;727830;647060;441425;441430;79937;389730;727905;26149,9
-1,-1,9,38768471,65482544,26714073,728577;727830;647060;441425;441430;79937;389730;727905;26149,9
1,-1,9,38768471,65482544,26714073,728577;727830;647060;441425;441430;79937;389730;727905;26149,9
1,-1,9,38768471,65482544,26714073,728577;727830;647060;441425;441430;79937;389730;727905;26149,9
1,-1,9,38790887,65482544,26691657,728577;727830;647060;441425;441430;79937;389730;727905;26149,9
-1,-1,9,38810497,45733296,6922799,728577;727830;647060;441425;441430;79937;389730;727905;26149,9
1,-1,9,38835046,65482544,26647498,728577;727830;647060;441425;441430;79937;389730;727905;26149,9
1,-1,9,38847760,47312281,8464521,728577;727830;647060;441425;441430;79937;389730;727905;26149,9
-1,-1,9,38951316,39407645,456329,79937;647060,2
1,-1,9,38868527,44245546,5377019,728577;727830;647060;441425;441430;79937;389730;727905;26149,9
1,-1,9,38868527,44245546,5377019,728577;727830;647060;441425;441430;79937;389730;727905;26149,9
-1,-1,9,38868527,44654170,5785643,728577;727830;647060;441425;441430;79937;389730;727905;26149,9
-1,-1,9,38868527,44729482,5860955,728577;727830;647060;441425;441430;79937;389730;727905;26149,9
-1,-1,9,38868527,65482544,26614017,728577;727830;647060;441425;441430;79937;389730;727905;26149,9
1,-1,9,38906126,44245546,5339420,728577;727830;647060;441425;441430;79937;389730;727905;26149,9
-1,-1,9,38929129,44245546,5316417,728577;727830;647060;441425;441430;79937;389730;727905;26149,9
-1,-1,9,38929129,45149342,6220213,728577;727830;647060;441425;441430;79937;389730;727905;26149,9
-1,-1,9,38976049,39407645,431596,79937;647060,2
1,-1,9,38951376,40066335,1114959,79937;647060,2
1,-1,9,38951376,42312058,3360682,26149;727830;647060;727905;79937,5
1,-1,9,38951376,44245546,5294170,728577;727830;647060;441425;441430;79937;389730;727905;26149,9
1,-1,9,38951376,44265200,5313824,728577;727830;647060;441425;441430;79937;389730;727905;26149,9
1,-1,9,38951376,45248958,6297582,728577;727830;647060;441425;441430;79937;389730;727905;26149,9
1,-1,9,38951376,46019594,7068218,728577;727830;647060;441425;441430;79937;389730;727905;26149,9
1,-1,9,38951376,65482544,26531168,728577;727830;647060;441425;441430;79937;389730;727905;26149,9
1,-1,9,38951376,65482544,26531168,728577;727830;647060;441425;441430;79937;389730;727905;26149,9
1,-1,9,38951376,65482544,26531168,728577;727830;647060;441425;441430;79937;389730;727905;26149,9
1,-1,9,38951376,65482544,26531168,728577;727830;647060;441425;441430;79937;389730;727905;26149,9
1,-1,9,38951376,65482544,26531168,728577;727830;647060;441425;441430;79937;389730;727905;26149,9
1,-1,9,38951376,65482544,26531168,728577;727830;647060;441425;441430;79937;389730;727905;26149,9
1,-1,9,38951376,65482544,26531168,728577;727830;647060;441425;441430;79937;389730;727905;26149,9
-1,-1,9,38951376,65482544,26531168,728577;727830;647060;441425;441430;79937;389730;727905;26149,9
1,-1,9,38951376,65482544,26531168,728577;727830;647060;441425;441430;79937;389730;727905;26149,9
1,-1,9,39059536,65482544,26423008,728577;727830;647060;441425;441430;79937;389730;727905;26149,9
1,-1,9,39059536,65482544,26423008,728577;727830;647060;441425;441430;79937;389730;727905;26149,9
-1,-1,9,39059898,44729482,5669584,728577;727830;647060;441425;441430;79937;389730;727905;26149,9
-1,-1,9,39059898,44729482,5669584,728577;727830;647060;441425;441430;79937;389730;727905;26149,9
-1,-1,9,39083058,39317161,234103,79937,1
1,-1,9,39116729,44259405,5142676,728577;727830;647060;441425;441430;79937;389730;727905;26149,9
-1,-1,9,39140222,40940341,1800119,26149;79937;727830;647060,4
1,-1,9,39267719,65482544,26214825,728577;727830;647060;441425;441430;79937;389730;727905;26149,9
-1,-1,9,39500661,40049174,548513,,0
-1,-1,9,39500661,40140466,639805,,0
1,-1,9,39500661,40477283,976622,,0
1,-1,9,39500661,40771162,1270501,727830,1
-1,-1,9,39500661,40771162,1270501,727830,1
-1,-1,9,39500661,65482544,25981883,728577;389730;441425;727830;727905;441430;26149,7
1,-1,9,39796990,43468813,3671823,441425;727830;727905;441430;26149,5
-1,-1,9,39892100,40477283,585183,,0
1,-1,9,40031488,40848455,816967,26149;727830,2
-1,-1,9,40226329,40771162,544833,727830,1
1,-1,9,40375130,65482544,25107414,728577;389730;441425;727830;727905;441430;26149,7
1,-1,9,40390407,43606290,3215883,441425;727830;727905;441430;26149,5
-1,-1,9,40396988,40632420,235432,,0
-1,-1,9,40396988,40661509,264521,,0
-1,-1,9,40396988,40661509,264521,,0
-1,-1,9,40411303,40661509,250206,,0
1,-1,9,40422818,65482544,25059726,728577;389730;441425;727830;727905;441430;26149,7
1,-1,9,40553281,42312058,1758777,727905;26149;727830,3
1,-1,9,40553281,47199215,6645934,728577;389730;441425;727830;727905;441430;26149,7
1,-1,9,40632480,65482544,24850064,728577;389730;441425;727830;727905;441430;26149,7
-1,-1,9,40816545,41461551,645006,,0
-1,-1,9,40816545,41591861,775316,727905,1
-1,-1,9,40816545,41591861,775316,727905,1
-1,-1,9,40816545,41591861,775316,727905,1
1,-1,9,40816545,41591861,775316,727905,1
-1,-1,9,40816545,41591861,775316,727905,1
1,-1,9,40848514,41591861,743347,727905,1
1,-1,9,40848514,42000733,1152219,727905,1
1,-1,9,40848514,42036225,1187711,727905,1
1,-1,9,40865224,41591861,726637,727905,1
1,-1,9,40865224,41591861,726637,727905,1
1,-1,9,40865224,41897543,1032319,727905,1
1,-1,9,40991681,41897543,905862,727905,1
1,-1,9,41014028,65482544,24468516,728577;389730;441425;727905;441430,5
-1,-1,9,41671278,42024128,352850,,0
-1,-1,9,41645686,42246954,601268,,0
1,-1,9,41645686,42450701,805015,441430,1
-1,-1,9,41645686,65482544,23836858,728577;441430;389730;441425,4
-1,-1,9,41645686,65482544,23836858,728577;441430;389730;441425,4
-1,-1,9,41645686,65482544,23836858,728577;441430;389730;441425,4
1,-1,9,41863355,47041045,5177690,728577;441430;389730;441425,4
1,-1,9,41863355,47199215,5335860,728577;441430;389730;441425,4
1,-1,9,41865572,65482544,23616972,728577;441430;389730;441425,4
-1,-1,9,41980488,42264205,283717,,0
1,-1,9,42000792,65482544,23481752,728577;441430;389730;441425,4
1,-1,9,42000792,65482544,23481752,728577;441430;389730;441425,4
1,-1,9,42313138,45080228,2767090,728577;441430;389730;441425,4
1,-1,9,42456974,43044929,587955,,0
1,-1,9,43320862,43997639,676777,728577;389730,2
-1,-1,9,43349394,43578724,229330,,0
-1,-1,9,43349394,43606349,256955,,0
-1,-1,9,43349394,43610769,261375,,0
-1,-1,9,43349394,43659703,310309,389730,1
-1,-1,9,43349394,43923120,573726,728577;389730,2
-1,-1,9,43349394,43934857,585463,728577;389730,2
-1,-1,9,43333308,44743838,1410530,728577;389730,2
1,-1,9,43386522,43686949,300427,728577;389730,2
-1,-1,9,43386522,43704940,318418,728577;389730,2
-1,-1,9,43423683,43686957,263274,728577;389730,2
-1,-1,9,43423683,43923120,499437,728577;389730,2
-1,-1,9,43411181,43997639,586458,728577;389730,2
-1,-1,9,43411181,43997639,586458,728577;389730,2
-1,-1,9,43441986,43842486,400500,728577;389730,2
-1,-1,9,43441986,43884354,442368,728577;389730,2
-1,-1,9,43468813,43842486,373673,728577;389730,2
-1,-1,9,43468813,43842486,373673,728577;389730,2
-1,-1,9,43468813,43842486,373673,728577;389730,2
-1,-1,9,43491081,43997639,506558,728577;389730,2
-1,-1,9,43590075,43842486,252411,728577;389730,2
-1,-1,9,43590075,43842486,252411,728577;389730,2
-1,-1,9,43590075,43842486,252411,728577;389730,2
-1,-1,9,43590075,43842486,252411,728577;389730,2
-1,-1,9,43590075,43842486,252411,728577;389730,2
-1,-1,9,43590075,43842486,252411,728577;389730,2
-1,-1,9,43590075,43842486,252411,728577;389730,2
-1,-1,9,43590075,43842486,252411,728577;389730,2
-1,-1,9,43590075,43842486,252411,728577;389730,2
-1,-1,9,43590075,43842486,252411,728577;389730,2
-1,-1,9,43590075,43842486,252411,728577;389730,2
-1,-1,9,43606290,43842486,236196,728577;389730,2
-1,-1,9,43606290,43842486,236196,728577;389730,2
-1,-1,9,43606290,43907711,301421,728577;389730,2
-1,-1,9,43610709,43842486,231777,728577;389730,2
-1,-1,9,43610709,43842486,231777,728577;389730,2
-1,-1,9,43610709,43842486,231777,728577;389730,2
-1,-1,9,43610709,43842486,231777,728577;389730,2
-1,-1,9,43610709,43842486,231777,728577;389730,2
-1,-1,9,43610709,43842486,231777,728577;389730,2
-1,-1,9,43610709,43842486,231777,728577;389730,2
-1,-1,9,43610709,43842486,231777,728577;389730,2
-1,-1,9,43610709,43842486,231777,728577;389730,2
-1,-1,9,43610709,43842486,231777,728577;389730,2
-1,-1,9,43610709,43842486,231777,728577;389730,2
-1,-1,9,43610709,43842486,231777,728577;389730,2
-1,-1,9,43610709,43842486,231777,728577;389730,2
-1,-1,9,43610709,43842486,231777,728577;389730,2
-1,-1,9,43610709,43842486,231777,728577;389730,2
-1,-1,9,43610709,43842486,231777,728577;389730,2
-1,-1,9,43610709,43842486,231777,728577;389730,2
-1,-1,9,43610709,43842486,231777,728577;389730,2
-1,-1,9,43610709,43842486,231777,728577;389730,2
-1,-1,9,43610709,43842486,231777,728577;389730,2
-1,-1,9,43610709,43842486,231777,728577;389730,2
-1,-1,9,43610709,43842486,231777,728577;389730,2
-1,-1,9,43610709,43842486,231777,728577;389730,2
-1,-1,9,43610709,43842486,231777,728577;389730,2
-1,-1,9,43610709,43842486,231777,728577;389730,2
-1,-1,9,43610709,43842486,231777,728577;389730,2
-1,-1,9,43610709,43842486,231777,728577;389730,2
-1,-1,9,43610709,43842486,231777,728577;389730,2
-1,-1,9,43610709,43842486,231777,728577;389730,2
-1,-1,9,43610709,43842486,231777,728577;389730,2
-1,-1,9,43610709,43842486,231777,728577;389730,2
-1,-1,9,43610709,43842486,231777,728577;389730,2
-1,-1,9,43610709,43842486,231777,728577;389730,2
-1,-1,9,43610709,43842486,231777,728577;389730,2
-1,-1,9,43610709,43842486,231777,728577;389730,2
-1,-1,9,43610709,43842486,231777,728577;389730,2
-1,-1,9,43610709,43842486,231777,728577;389730,2
-1,-1,9,43610709,43842486,231777,728577;389730,2
-1,-1,9,43610709,43842486,231777,728577;389730,2
-1,-1,9,43610709,43842486,231777,728577;389730,2
-1,-1,9,43610709,43842486,231777,728577;389730,2
-1,-1,9,43610709,43842486,231777,728577;389730,2
-1,-1,9,43610709,43842486,231777,728577;389730,2
-1,-1,9,43610709,43842486,231777,728577;389730,2
-1,-1,9,43610709,43842486,231777,728577;389730,2
-1,-1,9,43610709,43842486,231777,728577;389730,2
-1,-1,9,43610709,43842486,231777,728577;389730,2
-1,-1,9,43610709,43842486,231777,728577;389730,2
-1,-1,9,43610709,43842486,231777,728577;389730,2
-1,-1,9,43610709,43842486,231777,728577;389730,2
-1,-1,9,43610709,43842486,231777,728577;389730,2
-1,-1,9,43610709,43842486,231777,728577;389730,2
-1,-1,9,43610709,43842486,231777,728577;389730,2
-1,-1,9,43610709,43842486,231777,728577;389730,2
-1,-1,9,43610709,43842486,231777,728577;389730,2
-1,-1,9,43610709,43842486,231777,728577;389730,2
-1,-1,9,43610709,43842486,231777,728577;389730,2
-1,-1,9,43610709,43842486,231777,728577;389730,2
-1,-1,9,43610709,43842486,231777,728577;389730,2
-1,-1,9,43610709,43842486,231777,728577;389730,2
-1,-1,9,43610709,43842486,231777,728577;389730,2
-1,-1,9,43610709,43842486,231777,728577;389730,2
-1,-1,9,43610709,43842486,231777,728577;389730,2
-1,-1,9,43610709,43842486,231777,728577;389730,2
-1,-1,9,43610709,43842486,231777,728577;389730,2
-1,-1,9,43610709,43842486,231777,728577;389730,2
-1,-1,9,43610709,43842486,231777,728577;389730,2
-1,-1,9,43610709,43842486,231777,728577;389730,2
-1,-1,9,43610709,43842486,231777,728577;389730,2
-1,-1,9,43610709,43842486,231777,728577;389730,2
-1,-1,9,43610709,43884354,273645,728577;389730,2
-1,-1,9,43610709,43884354,273645,728577;389730,2
-1,-1,9,43610709,43884354,273645,728577;389730,2
-1,-1,9,43610709,43884354,273645,728577;389730,2
-1,-1,9,43610709,43884354,273645,728577;389730,2
1,-1,9,43610769,44265200,654431,728577;389730,2
1,-1,9,43610769,65482544,21871775,728577;389730,2
-1,-1,9,43632698,43921414,288716,728577,1
1,-1,9,43623672,65482544,21858872,728577;389730,2
-1,-1,9,43659483,43840040,180557,728577,1
1,-1,9,44228410,45248958,1020548,,0
-1,-1,9,44259434,44870148,610714,,0
-1,-1,9,44259464,44743838,484374,,0
1,-1,9,44276242,44732257,456015,,0
1,-1,9,44371689,46670223,2298534,,0
1,-1,9,44392878,46682916,2290038,,0
1,-1,9,44419139,45248958,829819,,0
1,-1,9,44654229,45352054,697825,,0
1,-1,9,44654229,45364733,710504,,0
1,-1,9,44676637,45352054,675417,,0
1,-1,9,44676637,45352054,675417,,0
-1,-1,9,44729490,45469360,739870,,0
1,-1,9,45378410,46656999,1278589,,0
-1,-1,9,45447463,45709141,261678,,0
1,-1,9,46133307,65482544,19349237,,0
-1,-1,9,46446830,65482544,19035714,,0
1,-1,9,46446830,65482544,19035714,,0
-1,-1,9,46582126,65482544,18900418,,0
-1,-1,9,46656999,46881479,224480,,0
1,-1,9,46682975,65482544,18799569,,0
1,-1,9,46682975,65482544,18799569,,0
1,-1,9,46682975,65482544,18799569,,0
-1,-1,9,46682975,65482544,18799569,,0
-1,-1,9,46682975,65482544,18799569,,0
1,-1,9,46697061,65482544,18785483,,0
1,-1,9,46706058,65482544,18776486,,0
-1,-1,9,46933222,65482544,18549322,,0
-1,-1,9,47312281,65695693,18383412,26165,1
-1,-1,9,47312281,65695693,18383412,26165,1
-1,-1,9,47312281,65695693,18383412,26165,1
-1,-1,9,47312281,65713185,18400904,26165,1
-1,-1,9,47312281,65793789,18481508,26165,1
1,-1,9,47312281,66084663,18772382,26165,1
1,-1,9,47312281,66084663,18772382,26165,1
1,-1,9,47312281,66101651,18789370,26165,1
1,-1,9,47312281,66101651,18789370,26165,1
1,-1,9,47312281,66130568,18818287,26165,1
1,-1,9,47312281,66130568,18818287,26165,1
1,-1,9,47312281,66243053,18930772,26165,1
1,-1,9,47312281,66243053,18930772,26165,1
1,-1,9,47312281,66243053,18930772,26165,1
1,-1,9,47312281,66243053,18930772,26165,1
1,-1,9,47312281,66243053,18930772,26165,1
1,-1,9,47312281,66243053,18930772,26165,1
1,-1,9,47312281,66243053,18930772,26165,1
1,-1,9,47312281,66243053,18930772,26165,1
1,-1,9,47312281,66243053,18930772,26165,1
1,-1,9,47312281,66243053,18930772,26165,1
1,-1,9,47312281,66243053,18930772,26165,1
1,-1,9,47312281,66243053,18930772,26165,1
1,-1,9,47312281,66243053,18930772,26165,1
-1,-1,9,47312281,66370107,19057826,26165,1
1,-1,9,47312281,68148786,20836505,84210;26165,2
1,-1,9,47312281,70871931,23559650,26165;220869;653404;445571;728747;653427;644019;349334;84210,9
1,-1,9,47312281,70871931,23559650,26165;220869;653404;445571;728747;653427;644019;349334;84210,9
1,-1,9,47312281,70871931,23559650,26165;220869;653404;445571;728747;653427;644019;349334;84210,9
1,-1,9,47312281,70871931,23559650,26165;220869;653404;445571;728747;653427;644019;349334;84210,9
1,-1,9,47312281,70871931,23559650,26165;220869;653404;445571;728747;653427;644019;349334;84210,9
1,-1,9,47312281,70871931,23559650,26165;220869;653404;445571;728747;653427;644019;349334;84210,9
1,-1,9,47312281,70871931,23559650,26165;220869;653404;445571;728747;653427;644019;349334;84210,9
1,-1,9,65548448,66243053,694605,,0
1,-1,9,65578641,70871931,5293290,220869;653404;445571;728747;653427;644019;349334;84210,8
-1,-1,9,65917469,66260109,342640,,0
-1,-1,9,65917469,66309252,391783,,0
1,-1,9,66914663,67799280,884617,,0
-1,-1,9,68397616,68490444,92828,,0
1,1,9,68420641,141053525,72632884,29952;10422;158293;54863;84960;360203;138240;54886;2220;441478;81605;1164;644019;2800;7743;399665;56654;138241;2395;4686;89891;79695;643596;389792;389761;195828;2733;80709;1056;375748;286362;10927;392390;140459;114987;25;6709;7088;7185;81873;10773;8022;83549;6256;6621;57864;55342;375775;138804;23230;84929;8021;9719;153090;29989;2040;653427;4783;84895;1384;10244;158471;65268;54829;552891;7091;347148;195827;10555;203197;1955;51104;8727;229;5887;3190;51531;158131;114789;23424;5537;10507;158046;8395;7633;548645;286336;7186;11092;441476;94107;445571;5524;883;8518;728747;64855;5774;56254;6835;23137;54881;11064;11091;84270;5069;25920;5900;79048;9615;138311;80142;84302;23413;84131;79813;7357;138429;401546;138805;10439;1757;64768;51280;116225;3293;26130;11093;210;4593;203286;23446;25792;642968;138162;9328;8577;138151;728489;84263;29988;83543;286257;254956;5535;90678;27158;389762;220869;7539;26248;10558;401563;22845;6838;100526694;203328;1515;301;51116;138883;254973;51450;23637;2356;10585;22927;9022;27348;84814;54566;158405;116443;56623;7248;4702;81932;55582;26737;23203;54534;91373;58499;727800;85365;92714;169611;401548;28989;85014;29991;10912;80010;158399;57171;7295;158062;25934;286204;84641;54107;392392;57706;89853;645961;9329;5568;23731;2649;2902;55312;11046;445815;6887;401565;2844;83744;9830;23511;26995;55357;441457;10952;286256;157927;59335;91283;51552;158135;9550;57720;10319;7410;2176;1025;2790;254295;56033;51117;1612;6850;733;29085;5082;7111;9991;53358;90120;5998;286365;158056;26301;2776;445;56751;54187;570;23245;92400;392399;22954;402381;54932;23196;9314;3371;2218;347273;7099;23071;11217;6136;375743;55151;2889;116224;10592;158067;23299;389799;26578;286380;4915;1759;51148;158248;1842;10444;6096;10541;158431;727;3309;23452;27130;9919;389812;140803;259;320;27090;216;9568;54461;1903;1306;100499483;2934;8721;55363;158427;84726;79987;64420;255220;375759;653404;8555;401562;441452;55335;6837;392391;138065;25861;10807;23099;2021;51759;55014;64975;10868;158158;22869;9413;774;5695;158055;2650;5711;26735;138802;246184;687;9414;26012;203245;286207;169693;401551;80036;54942;83856;54542;138881;549;100505993;10880;9128;401541;84253;347168;169714;442425;27433;138428;50514;10783;26190;954;138255;5005;60560;8939;23064;401535;114299;2022;11224;51162;64078;4969;26147;9442;2619;286205;389816;23670;5047;5727;92715;203;3934;11182;158401;9630;84909;5090;256691;6130;375791;5730;5253;389763;389766;4851;138199;5004;10881;57109;138803;3933;54754;3376;1317;26219;23307;8636;55071;81689;54769;8013;9355;85301;5239;84628;2801;89958;6812;23392;2516;56262;11253;56904;11094;138799;7507;1318;389813;114991;84267;58493;157922;6836;117531;445577;80318;23287;5742;100505478;4958;169834;8328;257019;23552;55755;4920;9858;2219;256158;138307;20;29941;10044;79670;7464;7046;138639;8818;142680;375757;392376;1620;79109;64794;414328;6834;64170;6418;92399;347169;55035;9649;84885;349334;5125;286262;7270;89846;2529;26740;29968;29882;8789;2304;23048;51490;113220;414332;286234;26468;28;389827;57684;4957;2203;54662;7763;169436;1902;79095;4814;22949;10811;29979;1514;138882;1621;54836;19;54981;8019;23732;10999;1289;30815;377841;1539;169841;55684;403341;10383;944;26086;57582;1861;257169;286223;23404;4010;9966;9536,542
1,1,9,68734571,83557267,14822696,9413;138199;51104;375743;23137;138255;116224;138240;2650;26578;286380;23230;9615;55071;54981;687;8395;84131;5239;9414;644019;6096;349334;5568;23670;5125;138241;2395;220869;55312;653404;29968;169693;2776;653427;80036;140803;9630;445571;158471;320;256691;7091;728747;7763;301;442425;216;117531,49
1,1,9,70966262,90761254,19794992,80010;9413;138199;51104;414328;375743;116224;138240;3190;2650;26578;4915;55071;81689;687;645961;8395;5239;9414;6096;5568;5125;138241;2395;389762;55312;29968;389761;169693;80036;140803;286234;320;84267;7763;301;442425;7088;216;117531;80318;23137;138255;29979;23287;60560;1514;401535;23230;1612;64078;9615;54981;257019;23552;84131;2619;23670;55582;441452;2776;51280;79670;9630;158471;256691;7091;389763;389766;158158,70
-1,1,9,71130848,78867779,7736931,9413;138199;51104;375743;23137;138255;169693;80036;116224;216;140803;138240;26578;9615;320;256691;55071;54981;117531;687;8395;5239;9414;7763;6096;301;23670;5568;5125;138241;2395,31
-1,1,9,71130848,78867779,7736931,9413;138199;51104;375743;23137;138255;169693;80036;116224;216;140803;138240;26578;9615;320;256691;55071;54981;117531;687;8395;5239;9414;7763;6096;301;23670;5568;5125;138241;2395,31
-1,1,9,71130848,86285142,15154294,9413;138199;51104;414328;375743;23137;138255;29979;116224;216;138240;2650;26578;23230;9615;55071;54981;257019;687;8395;84131;5239;9414;6096;23670;5568;5125;138241;2395;389762;55312;29968;389761;169693;2776;80036;140803;9630;158471;320;256691;7091;7763;301;389763;442425;7088;158158;117531,49
1,1,9,71130848,109341774,38210926,138199;158293;23071;375743;8577;55151;116224;10592;138803;23299;138240;3376;54754;26578;54886;5535;4915;55071;81689;54769;8013;5239;1164;1842;6096;7743;138241;2395;10541;4686;389762;158431;79695;389761;195828;27130;140803;10558;375748;138799;286362;10927;320;100526694;7507;203328;1515;84267;301;7088;216;117531;9568;1903;445577;80318;23287;1306;4958;22927;138804;23230;100499483;257019;23552;55363;116443;158427;4920;8555;55582;441452;55335;4783;79670;7464;7046;54534;138639;158471;65268;85365;54829;7091;392376;195827;55014;158158;10912;80010;22869;9413;51104;414328;25934;229;3190;2650;84641;51531;55035;23424;138802;10507;687;645961;8395;158046;9414;5568;5125;89846;55312;11046;29968;169693;6887;80036;8789;83744;2304;83856;9830;286234;549;401541;55357;441457;10952;2203;7763;442425;91283;56254;4814;23137;138255;29979;60560;1514;2176;54881;84270;56033;19;401535;79048;1612;64078;9615;6850;4969;54981;84302;84131;2619;7111;53358;1539;2218;169841;23670;5727;138805;286365;389763;64768;2776;51280;54187;570;9630;84909;3293;286223;256691;23196;5253;203286;23446;389766;347273,182
1,1,9,72242558,114216584,41974026,138199;158293;23071;11217;375743;8577;55151;10881;10592;138803;23299;138240;3376;54754;26578;54886;5535;4915;55071;81689;54769;8013;1164;1842;6096;7743;138241;10541;4686;389762;158431;23392;79695;389761;195828;27130;26248;140803;10558;375748;138799;286362;10927;320;100526694;7507;203328;1515;84267;301;7088;216;117531;9568;1903;445577;80318;23287;1306;4958;22927;138804;23230;100499483;54566;257019;23552;55363;116443;158427;4920;79987;255220;8555;55582;441452;55335;4783;79670;7464;7046;54534;138639;58499;158471;65268;85365;54829;7091;392376;195827;55014;158158;10912;80010;22869;51104;414328;7295;25934;8727;229;5887;3190;2650;84641;51531;55035;23424;138802;10507;687;645961;158046;23731;5125;89846;55312;11046;29968;445815;6887;80036;8789;83744;2304;54942;83856;9830;286234;549;10880;401541;55357;441457;10952;8518;2203;7763;5774;442425;91283;1902;56254;4814;23137;138255;29979;60560;1514;2176;54881;84270;56033;19;401535;79048;114299;1612;64078;9615;6850;4969;54981;84302;23732;84131;2619;7111;53358;1539;2218;169841;23670;401546;5727;138805;286365;389763;64768;2776;51280;54187;570;9630;84909;3293;286223;256691;23196;4593;9314;5253;203286;23446;389766;347273,197
-1,-1,9,80443049,80460752,17703,2776,1
1,-1,9,86456737,86570533,113796,84267;55582,2
-1,1,9,88694766,94589503,5894737,1903;441452;1514;51280;4783;79670;79048;401535;286223;1612;286234;6850;10927;549;81689;23552;10507;645961;158046;54769;2619;4920;53358;1164;389766;10912,26
1,-1,9,90503773,90538211,34438,441452;286234,2
1,-1,9,95262129,95290097,27968,401541;1842,2
-1,1,9,96732332,100175689,3443357,22869;158431;11046;8555;2176;195828;8789;54754;22927;84909;375748;3293;84641;100499483;138639;23424;441457;1515;2203;195827;169841;5727,22
-1,1,9,97355862,99805480,2449618,22869;158431;11046;8555;2176;195828;8789;3293;22927;84909;375748;441457;1515;2203;195827;5727,16
-1,1,9,97476174,100883468,3407294,22869;10541;4686;158431;11046;8555;2176;195828;2304;54187;7464;22927;3293;84909;375748;51531;100499483;9830;23424;7507;441457;55363;1515;158427;7111;195827;5727,27
-1,1,9,97823312,111457849,13634537,22869;23071;8577;55151;25934;10592;229;138803;5887;51531;54886;23424;5535;138802;8013;7743;10541;4686;158431;79695;11046;6887;195828;27130;2304;83856;375748;9830;138799;286362;100526694;7507;55357;441457;10952;1515;91283;56254;9568;2176;54881;1306;19;22927;138804;100499483;55363;84302;116443;158427;7111;1539;5727;138805;286365;8555;55335;54187;7464;7046;84909;3293;570;54534;58499;85365;392376;195827;9314;55014;2218;203286;23446;347273,74
1,-1,9,98239022,98239146,124,5727,1
1,-1,9,98239051,98239146,95,5727,1
1,-1,9,98270240,98270408,168,5727,1
-1,1,9,100625192,102129138,1503946,10541;9568;85365;79695;55357;7046;10952;55363;1306;54187;7464;203286;9830;51531,14
-1,1,9,101786487,112710170,10923683,23071;8577;55151;25934;10881;54881;1306;8727;10592;229;138803;5887;19;138804;114299;54886;5535;54566;138802;8013;84302;116443;23732;1539;7743;23731;138805;286365;445815;55335;27130;6887;54942;54534;7046;570;83856;58499;138799;286362;85365;10880;100526694;10952;8518;392376;9314;55014;2218;5774;23446;91283;347273;56254,54
-1,1,9,101900330,117773312,15872982,158399;5004;23071;11217;7295;8577;55151;25934;10881;8727;10592;138803;229;5887;84263;1317;23307;54886;5535;54107;138802;246184;8013;85301;548645;7743;23731;23392;445815;6887;27130;54942;7539;26248;80709;83856;113220;138799;286362;259;10880;100526694;9128;1318;10952;114991;8518;114987;58493;5774;1902;91283;56254;9550;22949;54881;5005;2790;54836;100505478;57864;19;138804;169834;114299;54566;158405;116443;84302;23732;9991;79987;64420;1539;7357;55014;401546;138805;5998;286365;255220;81932;944;55335;54534;7046;570;158401;58499;257169;138065;85365;210;552891;25861;392376;4593;9314;401548;2218;9966;23446;203197;347273,104
-1,1,9,101900330,117773312,15872982,158399;5004;23071;11217;7295;8577;55151;25934;10881;8727;10592;138803;229;5887;84263;1317;23307;54886;5535;54107;138802;246184;8013;85301;548645;7743;23731;23392;445815;6887;27130;54942;7539;26248;80709;83856;113220;138799;286362;259;10880;100526694;9128;1318;10952;114991;8518;114987;58493;5774;1902;91283;56254;9550;22949;54881;5005;2790;54836;100505478;57864;19;138804;169834;114299;54566;158405;116443;84302;23732;9991;79987;64420;1539;7357;55014;401546;138805;5998;286365;255220;81932;944;55335;54534;7046;570;158401;58499;257169;138065;85365;210;552891;25861;392376;4593;9314;401548;2218;9966;23446;203197;347273,104
-1,1,9,103271401,113948226,10676825,11217;7295;8577;55151;25934;10881;8727;10592;229;138803;5887;19;138804;114299;54886;5535;54566;138802;116443;84302;23732;79987;1539;7743;23731;401546;138805;286365;255220;445815;55335;6887;54942;54534;83856;570;58499;138799;286362;10880;100526694;8518;392376;4593;9314;2218;5774;23446;1902;347273;56254,51
-1,1,9,104604851,126253089,21648238,5004;7099;11217;55151;10881;138803;10592;84263;1317;26219;23307;254956;85301;727;23392;7539;26248;80709;286362;138799;259;392390;1318;114991;114987;58493;7185;138883;254973;23637;10773;5742;100505478;57864;55342;138804;169834;2934;54566;158405;55755;79987;64420;153090;2040;255220;4702;81932;55335;26737;392391;58499;138065;552891;25861;392376;1620;401548;203197;1955;158399;7295;25934;8727;5887;92399;5711;347169;286204;158131;54107;392392;57706;26735;138802;246184;548645;23731;26740;445815;6887;54942;2844;83856;113220;54542;138881;26468;10880;9128;57684;8518;347168;5774;1902;51552;158135;9550;50514;22949;26190;11064;5005;138882;2790;54836;5069;19;114299;26147;5082;23732;9991;1539;7357;401546;138805;5998;286365;944;158401;23245;257169;92400;210;22954;4593;9314;3371;2218;9966;23446,132
-1,1,9,106529701,115747074,9217373,158399;11217;22949;7295;55151;25934;10881;8727;138803;10592;2790;5887;57864;19;84263;138804;114299;54566;158405;138802;401548;23732;9991;79987;548645;64420;7357;23731;401546;138805;286365;255220;23392;445815;55335;6887;54942;26248;83856;158401;58499;286362;138799;10880;552891;8518;392376;4593;9314;58493;2218;5774;23446;1902,54
-1,1,9,108484180,108503578,19398,55151,1
1,-1,9,108697403,109009314,311911,,0
-1,1,9,110292595,120728222,10435627,158399;5004;7099;11217;7295;10881;8727;84263;1317;23307;54107;246184;85301;548645;23731;23392;445815;54942;7539;26248;80709;113220;259;10880;9128;1318;8518;114991;114987;58493;5774;1902;9550;50514;22949;5005;2790;54836;100505478;5069;57864;114299;169834;54566;158405;23732;9991;79987;64420;7357;401546;5998;255220;81932;944;158401;23245;257169;138065;210;22954;552891;25861;4593;3371;401548;9966;203197,68
-1,1,9,111348809,118687200,7338391,158399;5004;11217;7295;10881;8727;84263;1317;23307;54107;246184;85301;548645;23731;23392;445815;54942;7539;26248;80709;113220;259;10880;9128;1318;8518;114991;114987;58493;5774;1902;9550;50514;22949;5005;2790;54836;100505478;57864;114299;169834;54566;158405;23732;9991;79987;64420;7357;401546;5998;255220;81932;944;158401;257169;138065;210;552891;25861;4593;3371;401548;9966;203197,64
-1,1,9,114299780,123267736,8967956,158399;9550;50514;5004;7099;22949;5005;2790;54836;100505478;5069;57864;84263;1317;169834;23307;54107;158405;55755;246184;401548;85301;9991;64420;548645;7357;5998;81932;944;7539;80709;158401;113220;23245;257169;259;138065;9128;210;22954;1318;552891;114991;25861;114987;1620;3371;58493;9966;203197,50
1,-1,9,115379506,115588317,208811,58493;158405;401548,3
1,-1,9,115379506,115588317,208811,58493;158405;401548,3
1,-1,9,115379506,115588317,208811,58493;158405;401548,3
1,-1,9,115379506,115588317,208811,58493;158405;401548,3
1,-1,9,115379600,115588349,208749,58493;158405;401548,3
1,-1,9,116822389,116859863,37474,113220;259,2
1,-1,9,116956006,117439745,483739,9550;5004;25861;85301;5005;100505478;80709;203197,8
1,1,9,122644898,141012393,18367495,29952;10422;54863;6136;84960;360203;2889;158067;389799;2220;1759;51148;441478;81605;158248;10444;2800;399665;56654;727;3309;23452;89891;643596;389792;2733;9919;389812;1056;392390;140459;27090;25;6709;7185;54461;81873;10773;8022;83549;6256;6621;375775;55342;84929;2934;8721;8021;84726;9719;153090;29989;2040;375759;401562;6837;84895;1384;10244;392391;347148;10807;23099;2021;51759;10555;64975;10868;1955;774;5695;158055;5711;158131;114789;26735;5537;7633;26012;286336;7186;11092;203245;441476;286207;401551;94107;54542;5524;138881;100505993;883;84253;347168;64855;169714;27433;138428;10783;26190;954;6835;11091;11064;8939;25920;23064;5900;2022;11224;51162;138311;80142;26147;9442;23413;286205;389816;79813;138429;5047;10439;92715;203;1757;3934;11182;116225;5090;26130;11093;6130;375791;5730;25792;642968;138162;4851;9328;138151;57109;3933;728489;29988;83543;26219;286257;254956;8636;9355;84628;90678;2801;89958;27158;6812;2516;56262;11253;56904;11094;401563;22845;6838;389813;157922;51116;6836;138883;254973;51450;23637;2356;5742;10585;9022;27348;84814;8328;55755;56623;7248;9858;2219;256158;138307;20;29941;4702;26737;10044;23203;91373;8818;727800;142680;92714;375757;169611;28989;85014;29991;79109;64794;57171;6834;158062;64170;6418;92399;347169;286204;9649;392392;57706;84885;89853;9329;286262;7270;2649;2902;2529;26740;29882;401565;2844;23048;51490;414332;26468;23511;28;26995;389827;57684;4957;54662;286256;157927;59335;169436;51552;158135;79095;10319;57720;7410;10811;1025;138882;1621;254295;51117;733;29085;8019;5082;10999;1289;30815;377841;90120;55684;403341;158056;10383;26301;26086;445;57582;56751;1861;23404;92400;4010;392399;402381;54932;9536,280
1,1,9,123835380,141073897,17238517,29952;10422;54863;6136;84960;360203;2889;158067;389799;2220;1759;51148;441478;81605;158248;10444;2800;399665;56654;727;3309;23452;89891;643596;389792;2733;9919;389812;1056;392390;140459;27090;25;6709;54461;81873;10773;8022;83549;6256;6621;375775;55342;84929;2934;8721;8021;84726;9719;153090;29989;2040;375759;401562;6837;84895;1384;10244;392391;347148;10807;23099;2021;51759;10555;64975;10868;774;5695;158055;158131;114789;26735;5537;7633;26012;286336;7186;11092;203245;441476;286207;401551;94107;54542;5524;138881;100505993;883;84253;347168;64855;169714;27433;138428;10783;954;6835;11091;11064;8939;25920;23064;5900;2022;11224;51162;138311;80142;9442;23413;286205;389816;79813;138429;5047;10439;92715;203;1757;3934;11182;116225;5090;26130;11093;6130;375791;5730;25792;642968;138162;4851;9328;138151;57109;3933;728489;29988;83543;26219;286257;254956;8636;9355;84628;90678;2801;89958;27158;6812;2516;56262;11253;56904;11094;401563;22845;6838;389813;157922;51116;6836;138883;254973;51450;23637;2356;5742;10585;9022;27348;84814;8328;56623;7248;9858;2219;256158;138307;20;29941;4702;26737;10044;23203;91373;8818;727800;142680;92714;375757;169611;28989;85014;29991;79109;64794;57171;6834;158062;64170;6418;92399;347169;286204;9649;392392;57706;84885;89853;9329;286262;7270;2649;2902;2529;26740;29882;401565;2844;23048;51490;414332;26468;23511;28;26995;389827;57684;4957;54662;286256;157927;59335;169436;51552;158135;79095;10319;57720;7410;10811;1025;138882;1621;254295;51117;733;29085;8019;5082;10999;1289;30815;377841;90120;55684;403341;158056;10383;26301;26086;445;57582;56751;1861;23404;92400;4010;392399;402381;54932;9536,274
1,1,9,124642754,141146461,16503707,29952;10422;54863;6136;84960;360203;2889;158067;389799;2220;1759;51148;441478;81605;158248;10444;2800;399665;56654;3309;23452;89891;643596;389792;2733;9919;389812;1056;392390;140459;27090;25;6709;54461;81873;10773;8022;83549;6256;6621;375775;55342;84929;8721;8021;84726;9719;29989;375759;401562;6837;84895;1384;10244;392391;347148;10807;23099;2021;51759;10555;64975;10868;774;5695;158055;158131;114789;26735;5537;7633;26012;286336;100132403;7186;11092;203245;441476;286207;401551;94107;54542;5524;138881;100505993;883;84253;347168;64855;169714;27433;138428;10783;954;6835;11091;8939;25920;23064;5900;2022;11224;51162;138311;80142;9442;23413;286205;389816;79813;138429;5047;10439;92715;203;1757;3934;11182;116225;5090;26130;11093;6130;375791;5730;25792;642968;138162;4851;9328;138151;57109;3933;728489;29988;83543;26219;286257;254956;8636;9355;84628;90678;2801;89958;27158;6812;2516;56262;11253;56904;11094;401563;22845;6838;389813;157922;51116;6836;138883;254973;51450;23637;2356;5742;10585;9022;27348;84814;8328;56623;7248;9858;2219;256158;138307;20;29941;4702;26737;10044;23203;91373;8818;727800;142680;92714;375757;169611;28989;85014;29991;79109;64794;57171;6834;158062;64170;6418;92399;347169;286204;9649;392392;57706;84885;89853;9329;286262;7270;2649;2902;2529;26740;29882;401565;2844;23048;51490;414332;26468;23511;28;26995;389827;57684;4957;54662;286256;157927;59335;169436;158135;79095;10319;57720;7410;10811;1025;138882;1621;254295;51117;733;29085;8019;5082;10999;1289;30815;377841;90120;55684;403341;158056;10383;26301;26086;445;57582;56751;1861;23404;92400;4010;392399;402381;54932;9536,269
-1,-1,9,125308811,125369924,61113,138882;138881,2
1,-1,9,125308811,125390514,81703,138882;158131;138881,3
-1,1,9,125857877,129456122,3598245,79109;2649;3309;10783;23637;81873;2516;401551;5695;10244;55342;5090;286204;11224;4010;26130;57706;89853;5537;9355;286205;169611;2800,23
1,-1,9,127253558,127254078,520,2516,1
1,-1,9,127253558,127254078,520,2516,1
-1,1,9,127818144,131400225,3582081,79109;79095;6136;2356;1025;29988;51117;2022;9649;114789;80142;1759;89853;5537;51148;7633;286205;10999;30815;81605;158248;138429;90678;399665;2801;6812;3309;403341;23452;203245;89891;203;286207;3934;10044;10244;2733;5090;4010;8818;26130;26995;375757;84253;4957;64855;23099;27090;6709;25792;27433;138428,52
1,1,9,128652785,141044751,12391966,29952;10422;9328;54863;6136;84960;360203;2889;138151;57109;3933;158067;728489;29988;83543;389799;286257;8636;2220;1759;51148;441478;9536;81605;158248;10444;84628;90678;399665;2801;56654;6812;89958;27158;89891;23452;643596;389792;56262;11253;2733;56904;11094;9919;1056;389812;401563;22845;140459;6838;389813;27090;25;6709;157922;51116;6836;54461;51450;2356;8022;83549;6256;6621;375775;10585;9022;27348;84929;84814;8721;8021;8328;56623;84726;7248;9719;9858;2219;256158;29989;138307;20;29941;375759;401562;10044;84895;6837;1384;23203;91373;8818;727800;142680;92714;375757;347148;10807;23099;2021;51759;28989;10555;85014;64975;10868;29991;64794;57171;774;6834;158062;64170;6418;158055;9649;114789;84885;89853;7633;9329;26012;286336;7186;7270;286262;2902;11092;203245;2529;441476;29882;286207;401565;94107;23048;51490;5524;414332;23511;4851;28;26995;389827;100505993;883;84253;4957;169714;64855;54662;286256;157927;59335;169436;27433;138428;79095;10319;57720;7410;954;6835;11091;10811;1025;8939;1621;25920;23064;254295;51117;5900;2022;51162;733;138311;80142;29085;8019;9442;10999;23413;1289;30815;389816;90120;377841;79813;138429;55684;5047;10439;92715;403341;158056;10383;203;26301;1757;26086;3934;445;11182;57582;56751;1861;116225;5090;23404;4010;11093;392399;402381;6130;375791;54932;5730;25792;642968;138162,222
-1,1,9,129079208,130851795,1772587,403341;23452;203245;6136;203;2356;286207;1025;10044;29988;2022;4010;9649;8818;114789;138428;89853;399665;84253;7633;30815;64855;158248;23099;27090;138429;90678;27433;6812,29
1,-1,9,129450463,129455590,5127,4010,1
-1,1,9,130390139,132760275,2370136,79095;57171;51450;2356;1025;254295;6418;51117;6709;2022;27348;27433;114789;80142;1759;51148;84885;10999;30815;81605;158248;10444;138429;399665;2801;6812;89891;29941;203245;375759;203;389792;286207;3934;56262;10044;84895;1384;2733;51490;56904;1861;23048;5524;8818;22845;23511;140459;26995;375757;883;4957;54662;27090;2021;51759;28989;25792;10868;9536;138428,61
1,-1,9,130616981,130636569,19588,203;2022,2
-1,1,9,130857850,131830890,973040,79095;89891;29941;3934;56262;84895;2733;254295;6418;51117;51490;56904;22845;23511;114789;26995;375757;1759;80142;51148;84885;883;4957;10999;81605;10444;54662;2021;6709;25792;2801,31
-1,1,9,130912549,132540023,1627474,79095;57171;51450;254295;6418;51117;6709;1759;51148;84885;10999;81605;10444;2801;89891;29941;375759;389792;3934;56262;84895;1384;2733;51490;56904;5524;22845;23511;140459;26995;375757;883;4957;54662;2021;28989;25792;9536,38
-1,1,9,130998626,131674346,675720,89891;29941;56262;2733;51490;6418;51117;26995;375757;1759;51148;84885;883;4957;10999;81605;10444;54662;2021;6709;2801,21
1,1,9,131830839,141073897,9243058,29952;10422;9328;54863;84960;360203;2889;138151;57109;3933;158067;728489;83543;389799;286257;8636;2220;441478;9536;84628;56654;89958;27158;643596;389792;11253;9919;11094;389812;1056;401563;140459;6838;389813;25;157922;51116;6836;54461;51450;8022;83549;6256;6621;375775;10585;9022;27348;84929;84814;8721;8021;8328;56623;84726;7248;9719;9858;2219;256158;29989;138307;20;375759;401562;6837;84895;1384;23203;91373;727800;142680;92714;347148;10807;51759;28989;10555;85014;64975;10868;29991;64794;57171;774;6834;158062;64170;158055;9329;26012;286336;7186;7270;286262;2902;11092;2529;441476;29882;401565;94107;23048;5524;414332;4851;100505993;28;389827;169714;286256;157927;59335;169436;10319;57720;7410;954;6835;11091;10811;8939;1621;25920;23064;5900;51162;733;138311;29085;8019;9442;23413;1289;389816;90120;377841;79813;55684;5047;10439;92715;158056;10383;26301;1757;26086;445;11182;57582;56751;1861;116225;23404;11093;392399;402381;6130;375791;54932;5730;642968;138162,163
1,1,9,133388594,141018984,7630390,29952;10422;9328;54863;84960;360203;2889;138151;57109;3933;158067;728489;83543;389799;286257;8636;2220;441478;84628;56654;89958;27158;643596;11253;9919;11094;389812;1056;401563;6838;389813;25;157922;51116;6836;54461;8022;83549;6256;6621;375775;10585;9022;84929;84814;8721;8021;8328;56623;84726;7248;9719;9858;2219;20;29989;138307;401562;6837;23203;91373;727800;142680;92714;347148;10807;10555;85014;64975;29991;64794;774;6834;158062;64170;158055;9329;26012;286336;7186;7270;286262;2902;11092;2529;441476;29882;401565;94107;414332;4851;100505993;28;389827;169714;286256;157927;59335;169436;10319;7410;954;6835;11091;10811;8939;1621;25920;23064;5900;51162;733;138311;29085;8019;9442;1289;389816;90120;377841;79813;55684;5047;10439;92715;158056;10383;26301;1757;26086;11182;57582;56751;116225;23404;11093;392399;402381;6130;375791;54932;5730;642968;138162,144
1,-1,9,133814416,133931621,117205,10319;84929,2
1,1,9,135261940,140954147,5692207,64794;29952;10422;9328;54863;774;84960;6834;360203;158062;138151;57109;3933;64170;158067;728489;158055;389799;286257;8636;2220;441478;85014;9329;26012;56654;89958;27158;7270;7186;286262;2902;11092;2529;441476;643596;29882;401565;11253;94107;9919;11094;389812;1056;401563;414332;4851;100505993;28;6838;389827;389813;169714;286256;157927;157922;51116;6836;169436;54461;7410;954;6835;8022;11091;6256;10811;1621;6621;25920;375775;9022;5900;51162;733;8721;8328;138311;29085;8019;1289;56623;389816;90120;377841;79813;7248;9719;9858;55684;2219;5047;20;29989;138307;10439;92715;158056;10383;401562;26301;1757;26086;6837;11182;57582;56751;23203;116225;91373;727800;142680;11093;92714;392399;402381;6130;10807;375791;54932;5730;10555;64975;642968;138162;29991,126
1,1,9,135862290,141008915,5146625,29952;10422;9328;54863;774;84960;6834;360203;158062;138151;57109;3933;64170;728489;158055;286257;8636;2220;441478;85014;26012;56654;89958;27158;7186;286262;2902;2529;441476;643596;29882;401565;11253;94107;9919;11094;389812;1056;401563;414332;4851;100505993;28;6838;389827;389813;169714;286256;157927;157922;51116;6836;169436;54461;7410;954;6835;8022;11091;6256;10811;1621;6621;25920;375775;9022;5900;51162;733;8721;8328;138311;29085;8019;1289;56623;389816;90120;377841;79813;9719;9858;55684;5047;2219;20;29989;138307;10439;92715;158056;10383;401562;26301;1757;26086;6837;11182;57582;23203;116225;91373;727800;142680;11093;92714;392399;402381;6130;10807;375791;54932;5730;10555;64975;642968;138162;29991,118
1,-1,9,135940490,135948528,8038,1056,1
1,-1,9,135940490,135948528,8038,1056,1
1,-1,9,135940490,135962157,21667,1056,1
1,-1,9,135940490,135962157,21667,1056,1
1,-1,9,135940490,135962157,21667,1056,1
1,-1,9,135940490,135962157,21667,1056,1
1,-1,9,135940490,135962157,21667,1056,1
1,-1,9,135940490,135962157,21667,1056,1
1,-1,9,135940490,135962157,21667,1056,1
1,-1,9,135940490,135962157,21667,1056,1
1,-1,9,135940490,135962157,21667,1056,1
1,-1,9,135940490,135962157,21667,1056,1
1,-1,9,135940490,135962360,21870,1056,1
1,-1,9,135947140,135962157,15017,1056,1
1,-1,9,135947140,135962157,15017,1056,1
1,-1,9,135947140,135962157,15017,1056,1
1,1,9,136324358,141053525,4729167,29952;10422;54863;774;84960;158062;360203;138151;3933;64170;728489;158055;286257;8636;2220;441478;85014;26012;56654;89958;27158;7186;286262;2902;2529;441476;643596;29882;401565;11253;94107;9919;11094;389812;401563;414332;4851;100505993;389827;389813;169714;286256;157927;157922;51116;54461;7410;954;11091;8022;10811;6256;1621;6621;25920;375775;9022;51162;733;8721;138311;29085;8019;1289;56623;389816;90120;377841;79813;9858;9719;55684;5047;2219;20;138307;10439;92715;158056;10383;401562;1757;26086;11182;57582;23203;116225;91373;727800;142680;11093;92714;392399;402381;10807;375791;54932;5730;10555;64975;642968;138162;29991,103
1,1,9,136783193,141053525,4270332,29952;10422;54863;774;84960;158062;360203;138151;3933;64170;728489;158055;286257;8636;2220;441478;85014;26012;56654;89958;27158;7186;286262;2902;2529;441476;643596;29882;401565;11253;94107;9919;389812;401563;414332;4851;100505993;389813;169714;286256;157927;157922;51116;54461;7410;954;11091;8022;10811;6256;6621;25920;375775;9022;51162;733;8721;138311;29085;8019;1289;56623;389816;90120;377841;79813;9858;55684;5047;2219;20;138307;10439;92715;158056;10383;401562;26086;57582;23203;116225;91373;727800;142680;392399;92714;402381;10807;375791;54932;5730;10555;64975;138162;29991,95
1,1,9,136861349,141018976,4157627,29952;10422;54863;774;84960;158062;360203;138151;3933;64170;728489;158055;286257;8636;2220;441478;85014;26012;56654;89958;27158;7186;286262;2902;2529;441476;643596;29882;401565;11253;94107;9919;389812;401563;414332;4851;100505993;389813;169714;286256;157927;157922;51116;54461;954;11091;8022;10811;6256;6621;25920;375775;9022;51162;733;8721;138311;29085;8019;1289;56623;389816;90120;377841;79813;9858;55684;5047;2219;20;138307;10439;92715;158056;10383;401562;26086;57582;23203;116225;91373;727800;142680;392399;92714;402381;10807;375791;54932;5730;10555;64975;138162;29991,94
1,1,9,137247660,140468865,3221205,29952;10422;54863;84960;158062;360203;138151;3933;64170;728489;158055;286257;8636;2220;441478;85014;26012;56654;89958;27158;7186;286262;2902;2529;441476;643596;29882;401565;11253;94107;9919;389812;401563;414332;4851;100505993;389813;169714;286256;157927;157922;51116;54461;954;10811;8022;6256;6621;25920;375775;9022;51162;733;8721;138311;29085;1289;56623;389816;90120;377841;9858;55684;5047;2219;20;138307;10439;92715;158056;10383;401562;26086;57582;23203;91373;727800;142680;392399;402381;10807;375791;54932;5730;10555;64975;138162;29991,88
-1,1,9,137435549,137617713,182164,1289,1
1,-1,9,138130912,138283558,152646,157927,1
1,-1,9,138157660,138283558,125898,157927,1
1,-1,9,138157660,138283558,125898,157927,1
1,-1,9,138157660,138283558,125898,157927,1
1,-1,9,138157660,138283558,125898,157927,1
1,-1,9,138157660,138283558,125898,157927,1
1,-1,9,138181935,138297515,115580,157927,1
-1,1,9,138209358,141020389,2811031,29952;10422;54863;774;84960;158062;360203;138151;3933;64170;728489;158055;286257;8636;441478;85014;26012;56654;89958;27158;7186;286262;2902;2529;441476;643596;29882;401565;11253;94107;9919;389812;401563;414332;4851;100505993;389813;169714;286256;157927;157922;51116;54461;954;10811;8022;6621;25920;375775;9022;51162;733;8721;138311;29085;56623;389816;90120;377841;79813;9858;55684;5047;20;138307;92715;158056;10383;401562;26086;57582;23203;116225;91373;727800;142680;392399;92714;402381;10807;375791;54932;5730;10555;64975;138162;29991,87
-1,1,9,138222049,141018925,2796876,29952;10422;54863;774;84960;158062;360203;138151;3933;64170;728489;158055;286257;8636;441478;85014;26012;56654;89958;27158;7186;286262;2902;2529;441476;643596;29882;401565;11253;94107;9919;389812;401563;414332;4851;100505993;389813;169714;286256;157927;157922;51116;54461;954;10811;8022;6621;25920;375775;9022;51162;733;8721;138311;29085;56623;389816;90120;377841;79813;9858;55684;5047;20;138307;92715;158056;10383;401562;26086;57582;23203;116225;91373;727800;142680;392399;92714;402381;10807;375791;54932;5730;10555;64975;138162;29991,87
1,-1,9,138585277,138589454,4177,402381,1
-1,1,9,139218428,140909058,1690630,29952;54863;774;84960;158062;64170;728489;158055;286257;8636;10555;441478;26012;56654;89958;7186;286262;27158;2902;2529;441476;643596;29882;401565;11253;94107;9919;389812;401563;414332;100505993;389813;286256;54461;954;10811;6621;25920;375775;9022;51162;733;8721;138311;29085;56623;389816;377841;79813;55684;20;138307;92715;158056;10383;401562;26086;23203;116225;91373;727800;142680;92714;10807;375791;5730;54932;85014;64975;4851,70
-1,1,9,139218428,140909058,1690630,29952;54863;774;84960;158062;64170;728489;158055;286257;8636;10555;441478;26012;56654;89958;7186;286262;27158;2902;2529;441476;643596;29882;401565;11253;94107;9919;389812;401563;414332;100505993;389813;286256;54461;954;10811;6621;25920;375775;9022;51162;733;8721;138311;29085;56623;389816;377841;79813;55684;20;138307;92715;158056;10383;401562;26086;23203;116225;91373;727800;142680;92714;10807;375791;5730;54932;85014;64975;4851,70
-1,1,9,139282807,141020389,1737582,29952;54863;774;84960;158062;158055;286257;8636;10555;441478;26012;56654;89958;7186;286262;27158;2902;2529;441476;643596;29882;401565;11253;94107;9919;389812;401563;414332;100505993;389813;286256;54461;954;10811;6621;25920;375775;9022;51162;733;8721;138311;29085;56623;389816;377841;79813;55684;20;138307;92715;158056;10383;401562;23203;116225;91373;727800;142680;92714;10807;375791;5730;54932;85014;64975;4851,67
-1,1,9,139299672,139503090,203418,10807;23203;9919;158055;4851;56623,6
1,-1,9,139566910,139751899,184989,10555;138307;158056;138311;84960;389813;158062;29085;389812;85014;55684;414332;51162,13
1,-1,9,139739420,139744458,5038,29085;389813,2
-1,1,9,139772224,141018976,1246752,29952;54863;54461;774;954;10811;25920;375775;9022;286257;733;8636;441478;389816;377841;26012;79813;56654;89958;7186;286262;20;2902;27158;92715;10383;2529;441476;643596;401562;29882;401565;11253;94107;116225;91373;401563;727800;142680;100505993;92714;375791;54932;5730;286256;64975,46
1,-1,9,139919662,139942533,22871,20;2529;401563;56654,4
1,-1,9,139987081,140164480,177399,2902;29952;10383;441476;643596;29882;401565;11253;94107;25920;8636;727800;100505993;142680;375791;286262;389816;27158,18
-1,1,9,140043049,141020389,977340,2902;92715;54863;10383;441476;774;643596;10811;29882;401565;25920;94107;116225;375775;8636;727800;142680;100505993;92714;441478;286262;375791;54932;389816;377841;26012;79813;64975;27158,29
-1,1,9,140240417,141053535,813118,92715;92714;774;10811;54932;377841;26012;79813;116225;375775;64975,11
1,1,9,140286134,141008915,722781,92715;92714;774;10811;54932;377841;26012;79813;116225;375775;64975,11
-1,1,9,140309120,141018925,709805,92715;92714;774;10811;54932;377841;26012;79813;116225;375775;64975,11
-1,1,9,140407572,141053525,645953,92715;92714;79813;116225;375775;64975;774,7
-1,1,9,140468865,141009273,540408,92715;92714;79813;116225;774,5
-1,1,9,140444759,140730408,285649,92715;92714;79813;116225;375775;64975,6
-1,1,9,140444759,140878805,434046,92715;92714;79813;116225;375775;64975;774,7
-1,1,9,140533290,140716973,183683,79813,1
-1,1,9,140620020,140854178,234158,79813;774,2
-1,1,9,140637559,140638660,1101,79813,1
-1,1,9,140639661,140726103,86442,79813,1
-1,1,9,140652116,140669912,17796,79813,1
-1,1,9,140667620,140677737,10117,79813,1
-1,1,9,140705084,140711209,6125,79813,1
1,-1,9,140757063,140954147,197084,774,1
1,-1,9,140757063,140954147,197084,774,1
1,-1,9,141033138,141106476,73338,,0
1,-1,9,141033138,141106476,73338,,0
1,-1,9,141033138,141106476,73338,,0
1,-1,9,141033138,141138727,105589,100132403,1
1,-1,9,141033138,141138727,105589,100132403,1
1,-1,9,141033138,141138727,105589,100132403,1
1,-1,9,141033138,141138727,105589,100132403,1
1,-1,9,141033138,141138727,105589,100132403,1
1,-1,9,141037873,141122055,84182,100132403,1
1,-1,9,141044751,141090728,45977,,0
1,-1,9,141044751,141146405,101654,100132403,1
1,-1,9,141061567,141106476,44909,,0
1,-1,9,141061567,141138727,77160,100132403,1
1,-1,9,141073853,141102474,28621,,0
1,-1,9,141073853,141106476,32623,,0
1,-1,9,141073853,141106476,32623,,0
1,-1,9,141073853,141122055,48202,100132403,1
1,-1,9,141073853,141122055,48202,100132403,1
1,-1,9,141073853,141122055,48202,100132403,1
1,-1,9,141073853,141146405,72552,100132403,1
-1,1,10,72842,5302166,5229324,105;1109;10531;22884;10771;5214;83592;23560;91734;23185;8644;22982;1316;347688;1646;3422;1645,17
1,1,10,72842,35689121,35616279,57512;3698;84930;221060;84569;22921;8516;1787;648;11164;10730;51322;80314;10531;10529;10771;222389;9712;219771;9397;84898;6935;338596;64215;8829;79741;56243;283078;83592;23560;91734;2625;79746;79723;8644;3799;1316;221061;25805;23412;10276;254427;256815;7431;55149;1109;10557;83860;5209;3601;644890;5588;94134;22944;10006;6840;5264;8559;3688;9317;347688;1646;8028;219670;5305;221079;22884;22929;53904;57118;256297;1390;219681;114131;51806;283080;56288;54522;783;57584;55691;143098;9200;8029;91452;10659;105;55301;57713;5214;221044;79861;23590;84991;54906;399726;8872;6251;414149;9576;55388;56952;83643;3422;10133;653567;387638;119180;220929;54518;3559;23185;55130;8453;26019;84893;80760;80013;55176;810;389941;57608;387640;51182;340895;221074;374308;2572;1326;221078;509;79754;220213;22852;441549;100532731;8027;22982;4360;22931;55526;83641;2665;79896;340900;1645;64421,147
1,1,10,93297,135378918,135285621,26509;27291;84896;143187;643161;8433;84930;54838;221060;29974;3087;9126;26287;8516;55088;6441;143384;11164;9748;10023;414189;3778;503542;150;10844;5552;1308;10771;29982;10367;338599;4288;1305;55506;27250;80312;54777;118812;80351;118611;6387;657;23082;118881;84159;9060;83401;644168;2849;387718;80195;283078;3799;9221;55280;22984;55847;55760;1558;282974;4601;26091;219736;729262;57412;2018;56647;10121;79290;3167;84333;387715;23223;27069;1109;220979;143282;3601;5588;1557;729092;118813;170392;119559;8509;219670;26507;5599;9849;9721;10570;84287;51806;56288;119467;142827;90550;9184;55315;143098;387707;221037;22876;80313;55301;3434;57713;387694;9211;119391;118987;1791;3983;10724;84632;8661;6251;36;10660;56952;94233;818;100144748;3422;196740;5660;118491;27143;3026;653567;81894;6468;30819;840;84332;401647;55662;63877;114815;54788;5309;55454;259230;23268;118738;118856;84883;9937;644054;219770;389941;57608;3189;26123;10579;1326;2572;57715;1847;221078;220202;2674;220213;23053;22852;8187;22982;253430;92211;340900;56652;118472;414152;253738;1755;26128;2834;3437;10285;60370;84569;22921;642517;594857;170371;56889;84293;51196;10974;648;653145;118663;10730;3257;10529;81619;54537;9023;9148;8034;58529;222389;5408;9712;6571;5654;6975;10105;84898;282996;9562;6229;119395;120;132;2253;4255;84108;8829;79741;57178;85442;8031;54708;27343;29760;83592;7511;5407;2625;54764;1316;221035;25805;170384;219699;9044;119587;101;5146;23412;254427;355;8325;642938;7431;55149;55118;9679;10557;5209;26985;55361;219793;94134;23411;80201;10556;8559;22891;81855;118924;56165;59;1103;9317;347688;8028;57698;1959;55753;219749;119016;221079;23555;64072;9033;22884;9124;220992;64106;84171;159296;256297;118788;282973;220972;340665;23234;1390;55222;114131;283080;414157;340654;54522;10360;9200;5540;55165;84890;221002;5464;221044;414236;84991;255022;119504;118471;9576;9118;55388;143244;83643;340719;11155;374354;55680;3363;1979;8036;56681;27287;8945;54805;23401;23232;64210;2263;83849;79946;3832;55176;5949;1892;80007;810;10539;7587;11130;5995;509;2746;51021;51008;441549;100532731;219738;6425;259217;93377;282991;57089;4360;22931;10613;439996;7073;55526;54536;23283;340745;399814;2665;79896;983;64077;1645;81621;64421;196792;57512;84457;142910;27063;3698;8030;195977;50674;5033;22986;79949;399818;83742;10935;9231;340784;79955;1787;100288485;54780;4942;953;51322;80314;729238;4153;23522;8038;119385;9446;219771;6623;9397;653509;3195;170370;3070;338596;399823;1355;11101;64215;9632;1369;55717;25961;159686;140766;64115;23560;91734;79746;79723;51207;347731;25911;6832;112817;1592;10276;84858;80019;5076;83860;219743;79933;57700;219654;338567;143279;54619;26103;644890;58504;8879;83938;5264;7570;100130539;57209;5092;92565;79004;390010;9188;311;93426;5305;53828;60495;22929;7321;3098;57118;10718;100652748;4838;79892;91074;1793;57705;196051;1571;2869;119032;9806;51013;84435;85450;643236;387712;64318;26095;118461;51684;643418;4143;92170;54906;414149;93550;2894;55844;10133;387638;8729;220929;54541;118672;387695;59338;55130;4714;22943;8453;57559;26019;54462;84893;80760;220963;79009;100133093;159195;84795;387700;51182;221074;100463289;142891;23063;84665;84545;79754;51703;404636;282966;5728;84504;8027;1147;2658;50624;3416;83641;653308;7479;374355;5592;387680;5328;267004;79591;9886;6319;5791;11128;56521;5662;7390;729020;143379;55719;728118;81603;6585;5223;10531;4791;118490;51063;8505;3185;1244;51363;170394;2074;6935;118670;219623;7417;1488;64081;1763;11319;9559;253725;5832;7093;56243;5950;22841;8644;664;282969;221061;84445;728113;56624;256815;143162;24138;119548;219790;2662;84647;2805;3632;6865;159371;288;80217;9585;29119;11067;53354;8861;65217;22944;100287932;10006;118932;6840;26098;84986;3688;119392;9644;7580;1586;1646;79803;7582;79991;10580;79176;9469;53904;26033;153;219621;79847;83937;8513;403;118980;50632;1559;64429;22849;219681;474354;7581;196743;92482;338557;783;57584;55691;142940;8029;91452;6572;10659;105;256536;5214;25956;79812;11196;79861;23590;7414;399726;220965;8872;5406;6001;3988;119180;310;5532;3433;9531;54518;3559;23185;1562;7019;55749;340706;143241;4892;80013;55328;6877;6934;23172;11023;387640;340895;84458;374308;643414;5551;64376;9790;118487;80114;100507027;219348;5979;22978;317662;51076;4477;5507;57678;240;84833,711
-1,1,10,100026,1074710,974684,91734;22982;23560;10771;23185,5
-1,1,10,100026,1642998,1542972,22982;105;22884;10771;3422;23560;91734;23185,8
-1,1,10,100026,4761588,4661562,22982;1316;105;10531;22884;10771;5214;3422;23560;91734;23185,11
-1,1,10,100026,12842179,12742153,22884;3698;57118;83592;23560;91734;23185;3559;2625;8644;79746;1316;114131;51806;26019;54522;84893;80760;55176;11164;810;10276;254427;10659;105;1109;83860;10531;5214;10771;57713;79754;5209;3601;509;79861;5588;9712;84991;54906;22944;22982;8872;55526;1646;2665;3422;1645,48
1,1,10,100026,13247916,13147890,22884;3698;57118;83592;23560;91734;23185;3559;2625;8644;79746;1316;114131;51806;26019;54522;84893;80760;55176;11164;810;10276;254427;10659;105;1109;83860;10531;5214;10771;57713;79754;5209;3601;509;79861;5588;9712;84991;54906;22944;22982;8872;55388;83643;55526;1646;2665;3422;1645;10133,51
-1,1,10,100026,19625909,19525883,221079;22884;22929;3698;57118;221060;8516;1787;114131;51806;54522;11164;783;55691;9200;8029;10659;105;55301;10531;57713;10771;5214;221044;79861;222389;9712;84991;54906;9397;8872;6251;414149;55388;83643;3422;338596;10133;653567;83592;23560;91734;2625;79746;79723;8644;3559;23185;1316;221061;26019;84893;80760;80013;55176;810;389941;10276;254427;51182;7431;340895;221074;1109;10557;83860;221078;509;79754;5209;3601;644890;441549;5588;22944;8027;5264;22982;8559;4360;55526;9317;83641;1646;2665;1645;64421,87
1,1,10,100026,30278548,30178522,57512;3698;84930;221060;84569;22921;8516;1787;648;11164;10730;51322;10531;10529;10771;222389;9712;9397;84898;338596;64215;56243;283078;83592;23560;91734;2625;79746;79723;8644;1316;221061;25805;23412;10276;254427;256815;7431;1109;10557;83860;5209;3601;644890;5588;22944;10006;6840;5264;8559;9317;1646;8028;219670;5305;221079;22884;22929;53904;57118;256297;219681;114131;51806;283080;54522;783;57584;55691;143098;9200;8029;91452;10659;105;55301;57713;5214;221044;79861;23590;84991;54906;399726;8872;6251;414149;9576;55388;56952;83643;3422;10133;653567;387638;54518;3559;23185;55130;26019;84893;80760;80013;55176;810;389941;387640;51182;340895;221074;374308;2572;221078;509;79754;220213;22852;441549;100532731;8027;22982;4360;22931;55526;83641;2665;79896;340900;1645;64421,130
1,1,10,100026,50961640,50861614,57512;267004;3698;195977;84930;221060;84569;22921;642517;8516;1787;100288485;170371;648;11164;653145;10730;51322;80314;10531;10529;10771;222389;9712;219771;9397;84898;3185;2074;6935;170370;338596;6387;64215;8829;253725;644168;79741;56243;283078;83592;23560;91734;2625;79746;79723;8644;3799;1316;221061;25805;79290;728113;23412;10276;254427;8325;256815;143162;7431;55149;2662;1109;10557;83860;220979;5209;3601;644890;58504;5588;94134;11067;22944;10006;6840;5264;8559;3688;7570;100130539;57209;7580;1103;9317;1646;8028;7582;219670;55753;219749;5305;119016;5599;221079;53828;22884;22929;53904;220992;57118;83937;256297;9721;220972;91074;1390;219681;114131;51806;283080;56288;7581;57705;54522;474354;783;57584;55691;143098;9200;5540;8029;91452;221002;643236;10659;105;6572;55301;57713;5214;26095;221044;118461;79861;23590;84991;54906;399726;8872;6251;414149;9576;93550;55388;56952;83643;3422;196740;10133;653567;387638;119180;220929;54518;55454;3559;23185;55130;8453;83849;26019;118738;84893;80760;80013;55176;5949;644054;219770;100133093;810;389941;57608;387640;51182;340895;221074;374308;2572;1326;7587;221078;509;79754;9790;220213;282966;22852;8187;441549;100532731;8027;22982;5979;4360;2658;22931;55526;83641;2665;79896;340900;1645;240;64421,207
1,1,10,100027,135427143,135327116,26509;27291;84896;143187;643161;8433;84930;54838;221060;29974;3087;9126;26287;8516;55088;6441;143384;11164;9748;10023;414189;3778;503542;150;10844;5552;1308;10771;29982;10367;338599;4288;1305;55506;27250;80312;54777;118812;80351;118611;6387;657;23082;118881;84159;9060;83401;644168;2849;387718;80195;283078;3799;9221;55280;22984;55847;55760;1558;282974;4601;26091;219736;729262;57412;2018;56647;10121;79290;3167;84333;387715;23223;27069;1109;220979;143282;3601;5588;1557;729092;118813;170392;119559;8509;219670;26507;5599;9849;9721;10570;84287;51806;56288;119467;142827;90550;9184;55315;143098;387707;221037;22876;80313;55301;3434;57713;387694;9211;119391;118987;1791;3983;10724;84632;8661;6251;36;10660;56952;94233;818;100144748;3422;196740;5660;118491;27143;3026;653567;81894;6468;30819;840;84332;401647;55662;63877;114815;54788;5309;55454;259230;23268;118738;118856;84883;9937;644054;219770;389941;57608;3189;26123;10579;1326;2572;57715;1847;221078;220202;2674;220213;23053;22852;8187;22982;253430;92211;340900;56652;118472;414152;253738;1755;26128;2834;3437;10285;60370;84569;22921;642517;594857;170371;56889;84293;51196;10974;648;653145;118663;10730;3257;10529;81619;54537;9023;9148;8034;58529;222389;5408;9712;6571;5654;6975;10105;84898;282996;9562;6229;119395;120;132;2253;4255;84108;8829;79741;57178;85442;8031;54708;27343;29760;83592;7511;5407;2625;54764;1316;221035;25805;170384;219699;9044;119587;101;5146;23412;254427;355;8325;642938;7431;55149;55118;9679;10557;5209;26985;55361;219793;94134;23411;80201;10556;8559;22891;81855;118924;56165;59;1103;9317;8028;57698;1959;55753;219749;119016;221079;23555;64072;9033;22884;9124;220992;64106;84171;159296;256297;118788;282973;220972;340665;23234;1390;55222;114131;283080;414157;340654;54522;10360;9200;5540;55165;84890;221002;5464;221044;414236;84991;255022;119504;118471;9576;9118;55388;143244;83643;340719;11155;374354;55680;3363;1979;8036;56681;27287;8945;54805;23401;23232;64210;2263;83849;79946;3832;55176;5949;1892;80007;810;10539;7587;11130;5995;509;2746;51021;51008;441549;100532731;219738;6425;259217;93377;282991;57089;4360;22931;10613;439996;7073;55526;54536;23283;340745;399814;2665;79896;983;64077;1645;81621;64421;196792;57512;84457;142910;27063;3698;8030;195977;50674;5033;22986;79949;399818;83742;10935;9231;340784;79955;1787;100288485;54780;4942;953;51322;80314;729238;4153;23522;8038;119385;9446;219771;6623;9397;653509;3195;170370;3070;338596;399823;1355;11101;64215;9632;1369;55717;25961;159686;140766;64115;23560;91734;79746;79723;51207;347731;25911;6832;112817;1592;10276;84858;80019;5076;83860;219743;79933;57700;219654;338567;143279;54619;26103;644890;58504;8879;83938;5264;7570;100130539;57209;5092;92565;79004;390010;9188;311;93426;5305;53828;60495;22929;7321;3098;57118;10718;100652748;4838;79892;91074;1793;57705;196051;1571;2869;119032;9806;51013;84435;85450;643236;387712;64318;26095;118461;51684;643418;4143;92170;54906;414149;93550;2894;55844;10133;387638;8729;220929;54541;118672;387695;59338;55130;4714;22943;8453;57559;26019;54462;84893;80760;220963;79009;100133093;159195;84795;387700;51182;221074;100463289;142891;23063;84665;84545;79754;51703;404636;282966;5728;84504;8027;1147;2658;50624;3416;83641;653308;7479;374355;5592;387680;5328;267004;79591;9886;6319;5791;11128;56521;5662;7390;729020;143379;55719;728118;81603;6585;5223;10531;4791;118490;51063;8505;3185;1244;51363;170394;2074;6935;118670;219623;7417;1488;64081;1763;11319;9559;253725;5832;7093;56243;5950;22841;8644;664;282969;221061;84445;728113;56624;256815;143162;24138;119548;219790;2662;84647;2805;3632;6865;159371;288;80217;9585;29119;11067;53354;8861;65217;22944;100287932;10006;118932;6840;26098;84986;3688;119392;9644;7580;1586;1646;79803;7582;79991;10580;79176;9469;53904;26033;153;219621;79847;83937;8513;403;118980;50632;1559;64429;22849;219681;474354;7581;196743;92482;338557;783;57584;55691;142940;8029;91452;6572;10659;105;256536;5214;25956;79812;11196;79861;23590;7414;399726;220965;8872;5406;6001;3988;119180;310;5532;3433;9531;54518;3559;23185;1562;7019;55749;340706;143241;4892;80013;55328;6877;6934;23172;11023;387640;340895;84458;374308;643414;5551;64376;9790;118487;80114;100507027;219348;5979;22978;317662;51076;4477;5507;57678;240;84833,710
1,1,10,100027,135427143,135327116,26509;27291;84896;143187;643161;8433;84930;54838;221060;29974;3087;9126;26287;8516;55088;6441;143384;11164;9748;10023;414189;3778;503542;150;10844;5552;1308;10771;29982;10367;338599;4288;1305;55506;27250;80312;54777;118812;80351;118611;6387;657;23082;118881;84159;9060;83401;644168;2849;387718;80195;283078;3799;9221;55280;22984;55847;55760;1558;282974;4601;26091;219736;729262;57412;2018;56647;10121;79290;3167;84333;387715;23223;27069;1109;220979;143282;3601;5588;1557;729092;118813;170392;119559;8509;219670;26507;5599;9849;9721;10570;84287;51806;56288;119467;142827;90550;9184;55315;143098;387707;221037;22876;80313;55301;3434;57713;387694;9211;119391;118987;1791;3983;10724;84632;8661;6251;36;10660;56952;94233;818;100144748;3422;196740;5660;118491;27143;3026;653567;81894;6468;30819;840;84332;401647;55662;63877;114815;54788;5309;55454;259230;23268;118738;118856;84883;9937;644054;219770;389941;57608;3189;26123;10579;1326;2572;57715;1847;221078;220202;2674;220213;23053;22852;8187;22982;253430;92211;340900;56652;118472;414152;253738;1755;26128;2834;3437;10285;60370;84569;22921;642517;594857;170371;56889;84293;51196;10974;648;653145;118663;10730;3257;10529;81619;54537;9023;9148;8034;58529;222389;5408;9712;6571;5654;6975;10105;84898;282996;9562;6229;119395;120;132;2253;4255;84108;8829;79741;57178;85442;8031;54708;27343;29760;83592;7511;5407;2625;54764;1316;221035;25805;170384;219699;9044;119587;101;5146;23412;254427;355;8325;642938;7431;55149;55118;9679;10557;5209;26985;55361;219793;94134;23411;80201;10556;8559;22891;81855;118924;56165;59;1103;9317;8028;57698;1959;55753;219749;119016;221079;23555;64072;9033;22884;9124;220992;64106;84171;159296;256297;118788;282973;220972;340665;23234;1390;55222;114131;283080;414157;340654;54522;10360;9200;5540;55165;84890;221002;5464;221044;414236;84991;255022;119504;118471;9576;9118;55388;143244;83643;340719;11155;374354;55680;3363;1979;8036;56681;27287;8945;54805;23401;23232;64210;2263;83849;79946;3832;55176;5949;1892;80007;810;10539;7587;11130;5995;509;2746;51021;51008;441549;100532731;219738;6425;259217;93377;282991;57089;4360;22931;10613;439996;7073;55526;54536;23283;340745;399814;2665;79896;983;64077;1645;81621;64421;196792;57512;84457;142910;27063;3698;8030;195977;50674;5033;22986;79949;399818;83742;10935;9231;340784;79955;1787;100288485;54780;4942;953;51322;80314;729238;4153;23522;8038;119385;9446;219771;6623;9397;653509;3195;170370;3070;338596;399823;1355;11101;64215;9632;1369;55717;25961;159686;140766;64115;23560;91734;79746;79723;51207;347731;25911;6832;112817;1592;10276;84858;80019;5076;83860;219743;79933;57700;219654;338567;143279;54619;26103;644890;58504;8879;83938;5264;7570;100130539;57209;5092;92565;79004;390010;9188;311;93426;5305;53828;60495;22929;7321;3098;57118;10718;100652748;4838;79892;91074;1793;57705;196051;1571;2869;119032;9806;51013;84435;85450;643236;387712;64318;26095;118461;51684;643418;4143;92170;54906;414149;93550;2894;55844;10133;387638;8729;220929;54541;118672;387695;59338;55130;4714;22943;8453;57559;26019;54462;84893;80760;220963;79009;100133093;159195;84795;387700;51182;221074;100463289;142891;23063;84665;84545;79754;51703;404636;282966;5728;84504;8027;1147;2658;50624;3416;83641;653308;7479;374355;5592;387680;5328;267004;79591;9886;6319;5791;11128;56521;5662;7390;729020;143379;55719;728118;81603;6585;5223;10531;4791;118490;51063;8505;3185;1244;51363;170394;2074;6935;118670;219623;7417;1488;64081;1763;11319;9559;253725;5832;7093;56243;5950;22841;8644;664;282969;221061;84445;728113;56624;256815;143162;24138;119548;219790;2662;84647;2805;3632;6865;159371;288;80217;9585;29119;11067;53354;8861;65217;22944;100287932;10006;118932;6840;26098;84986;3688;119392;9644;7580;1586;1646;79803;7582;79991;10580;79176;9469;53904;26033;153;219621;79847;83937;8513;403;118980;50632;1559;64429;22849;219681;474354;7581;196743;92482;338557;783;57584;55691;142940;8029;91452;6572;10659;105;256536;5214;25956;79812;11196;79861;23590;7414;399726;220965;8872;5406;6001;3988;119180;310;5532;3433;9531;54518;3559;23185;1562;7019;55749;340706;143241;4892;80013;55328;6877;6934;23172;11023;387640;340895;84458;374308;643414;5551;64376;9790;118487;80114;100507027;219348;5979;22978;317662;51076;4477;5507;57678;240;84833,710
1,1,10,119796,12857914,12738118,22884;3698;57118;83592;23560;91734;23185;3559;2625;8644;79746;1316;114131;51806;26019;54522;84893;80760;55176;11164;810;10276;254427;10659;105;1109;83860;10531;5214;10771;57713;79754;5209;3601;509;79861;5588;9712;84991;54906;22944;22982;8872;55526;1646;2665;3422;1645,48
-1,1,10,136361,8850609,8714248,22884;3698;83592;23560;91734;23185;3559;2625;8644;1316;114131;51806;54522;84893;80760;810;10276;105;1109;83860;10531;5214;10771;57713;79754;5209;3601;509;79861;5588;84991;54906;22944;22982;1646;2665;3422;1645,38
-1,1,10,224406,3593472,3369066,22982;105;10531;22884;10771;5214;3422;23560;91734;23185,10
-1,1,10,224406,4627886,4403480,22982;1316;105;10531;22884;10771;5214;3422;23560;91734;23185,11
1,1,10,224406,11755048,11530642,22884;3698;83592;23560;91734;23185;3559;2625;8644;1316;114131;51806;54522;84893;80760;810;10276;10659;105;1109;83860;10531;5214;10771;57713;509;79754;5209;3601;79861;5588;9712;84991;54906;22944;22982;1646;2665;3422;1645,40
-1,1,10,224406,13778564,13554158,22884;22929;3698;57118;83592;23560;91734;23185;3559;2625;8644;79746;1316;114131;51806;26019;54522;84893;80760;55176;11164;810;10276;254427;55691;10659;105;1109;83860;10531;5214;10771;57713;509;79754;5209;3601;221044;79861;222389;5588;9712;84991;54906;22944;22982;5264;8872;8559;55388;83643;55526;1646;2665;3422;1645;10133,57
1,1,10,224406,15415335,15190929,22884;22929;3698;57118;221060;114131;51806;54522;11164;55691;10659;105;55301;10531;5214;10771;57713;221044;79861;222389;9712;84991;54906;9397;8872;414149;55388;83643;3422;10133;83592;23560;91734;23185;3559;2625;8644;79746;79723;1316;221061;26019;84893;80760;55176;810;10276;254427;51182;1109;83860;10557;509;79754;5209;3601;644890;441549;5588;22944;22982;5264;8559;55526;83641;1646;2665;1645;64421,69
1,1,10,224406,26628907,26404501,5305;57512;221079;22884;22929;3698;53904;57118;256297;221060;22921;8516;1787;219681;114131;51806;54522;648;11164;783;1645;57584;55691;9200;8029;10659;105;55301;10531;10529;10771;57713;5214;221044;79861;222389;9712;84991;54906;399726;9397;84898;8872;6251;414149;9576;55388;56952;83643;3422;338596;10133;64215;653567;387638;56243;83592;23560;91734;2625;79746;79723;8644;3559;23185;1316;221061;26019;84893;80760;80013;55176;810;23412;10276;254427;389941;256815;387640;7431;51182;340895;221074;2572;1109;83860;10557;221078;509;79754;5209;3601;220213;644890;441549;5588;100532731;22944;8027;5264;22982;8559;4360;55526;9317;83641;1646;8028;2665;79896;340900;219670;64421,113
1,-1,10,226083,291562,65479,10771,1
1,-1,10,248464,451013,202549,22982;10771,2
1,-1,10,248464,451013,202549,22982;10771,2
1,-1,10,1985245,2134409,149164,,0
1,-1,10,2134409,3174004,1039595,5214,1
-1,-1,10,2294085,2517261,223176,,0
1,-1,10,2695392,3124061,428669,5214,1
1,-1,10,2819465,3111473,292008,5214,1
1,-1,10,4646926,47531169,42884243,57512;3698;84930;221060;84569;22921;8516;1787;100288485;648;11164;10730;51322;80314;10529;222389;9712;219771;9397;84898;3185;6935;338596;6387;64215;8829;253725;79741;56243;283078;83592;79746;79723;2625;3799;8644;221061;25805;79290;728113;23412;10276;254427;8325;256815;7431;55149;1109;83860;10557;220979;5209;3601;644890;5588;94134;11067;22944;10006;6840;5264;8559;3688;7570;100130539;57209;7580;9317;1646;8028;7582;219670;219749;5305;119016;221079;53828;22929;53904;220992;57118;83937;256297;9721;220972;91074;1390;219681;114131;51806;283080;56288;7581;54522;783;57584;55691;143098;9200;5540;8029;91452;221002;643236;10659;55301;57713;221044;79861;23590;84991;54906;399726;8872;6251;414149;9576;93550;55388;56952;83643;10133;653567;387638;119180;220929;54518;55454;3559;55130;8453;83849;26019;84893;80760;80013;55176;219770;810;389941;57608;387640;51182;340895;221074;374308;2572;1326;7587;221078;509;79754;9790;220213;22852;8187;441549;100532731;8027;5979;4360;22931;55526;83641;2665;79896;340900;1645;240;64421,170
1,-1,10,5025476,5049453,23977,1646,1
1,-1,10,6689655,6833210,143555,,0
1,-1,10,6689655,6833210,143555,,0
-1,1,10,7377293,9129131,1751838,509;3698;22944;83860;57713;2625;80760,7
-1,1,10,7470732,21876681,14405949,653567;221079;387638;22929;3698;57118;221060;79746;79723;2625;8516;1787;221061;26019;80760;80013;55176;11164;783;389941;254427;55691;9200;8029;387640;51182;7431;221074;10659;340895;55301;83860;10557;221078;10529;509;221044;644890;222389;441549;9712;22944;399726;8027;5264;9397;8872;8559;6251;414149;4360;84898;55388;83643;55526;9317;83641;8028;338596;10133;64421,61
1,-1,10,9009111,9301368,292257,,0
-1,-1,10,9568299,9721038,152739,,0
1,-1,10,14991045,15014753,23708,644890;64421,2
1,-1,10,14991045,15014753,23708,644890;64421,2
1,-1,10,14991045,15014753,23708,644890;64421,2
1,-1,10,14991045,15014753,23708,644890;64421,2
1,-1,10,15611468,16818795,1207327,80013;8516;6251;389941;9317,5
1,-1,10,16939938,16996953,57015,8029,1
-1,-1,10,17809523,17892239,82716,653567,1
1,-1,10,17809523,17962915,153392,653567,1
1,-1,10,17809523,18273895,464372,653567;221074;4360,3
1,-1,10,17841131,17891703,50572,653567,1
1,-1,10,17841131,17949651,108520,653567,1
-1,-1,10,19446590,19810710,364120,340895,1
-1,-1,10,21195183,21199560,4377,10529,1
-1,1,10,24400270,25639569,1239299,79896;57512;219670;57584;56952;56243,6
-1,1,10,27111945,30537855,3425910,91452;374308;84930;22852;283078;55130;10006;84569;6840;22931;25805;283080;57608;10730;143098;51322,16
1,1,10,32288848,38408609,6119761,219749;7587;8829;79741;3799;219771;91074;1390;8453;3688;100288485;57209;56288;7581;219770;8325;80314,17
1,-1,10,35055358,35183401,128043,56288,1
1,-1,10,35061767,35157790,96023,56288,1
-1,-1,10,35183401,35473340,289939,1390;8453,2
1,-1,10,37443505,37494966,51461,91074,1
-1,-1,10,38240258,38356008,115750,219749;7581,2
1,1,10,42607635,69160433,26552798,119016;5599;84457;53828;267004;220992;7321;219621;8030;195977;9886;83937;100652748;9721;220972;29974;642517;57705;170371;474354;653145;414189;5540;221037;84890;221002;643236;6572;4153;29982;26095;118461;387680;8505;3185;220965;93550;2074;170370;219623;196740;6387;84159;253725;644168;8031;55454;55847;7019;22943;347731;221035;83849;259230;118738;220963;5949;79290;644054;100133093;728113;56624;143162;11130;5592;219790;100463289;2662;220979;9790;288;282966;58504;29119;8187;11067;80114;65217;100507027;100287932;5979;22891;2658;7570;100130539;253430;7580;1103;23283;653308;4477;983;7582;1959;55753;240,96
1,1,10,42890649,52636819,9746170,119016;5599;53828;267004;220992;195977;83937;100652748;9721;220972;29974;642517;57705;474354;170371;653145;414189;5540;221002;643236;6572;26095;118461;8505;3185;93550;2074;170370;196740;6387;253725;644168;8031;55454;83849;240;259230;118738;5949;79290;644054;100133093;728113;56624;143162;2662;220979;9790;282966;8187;58504;11067;100287932;5979;2658;7570;100130539;7580;1103;653308;4477;7582;55753;387680,64
1,1,10,43180754,75475666,32294912,84457;414152;267004;26128;8030;195977;9886;50674;5033;29974;642517;56521;170371;653145;414189;5552;4153;29982;10367;8034;58529;118490;1305;8505;3185;55506;80312;2074;170370;219623;64081;6387;1763;11319;9559;84159;253725;644168;25961;8031;140766;64115;55847;347731;221035;26091;219736;6832;219699;79290;728113;56624;143162;219790;2662;84647;219743;220979;6865;79933;288;58504;29119;219793;11067;65217;23411;100287932;80201;8879;729092;22891;7570;100130539;5092;7580;170392;1103;9188;1959;55753;119016;5599;9469;23555;53828;64072;220992;7321;3098;219621;64106;83937;100652748;4838;9721;220972;23234;55222;57705;474354;90550;9806;55315;5540;221037;84890;221002;643236;6572;26095;5464;118461;220965;119504;93550;55680;196740;5660;118491;27143;1979;56681;310;5532;54541;54788;55454;7019;22943;83849;55749;240;259230;118738;220963;79009;5949;84883;644054;100133093;159195;3189;11130;100463289;5551;220202;84665;9790;51021;51008;282966;8187;80114;219738;100507027;5979;2658;317662;253430;23283;653308;4477;983;5592;387680,166
1,1,10,43379742,54025077,10645335,119016;5599;53828;267004;220992;195977;83937;100652748;9721;220972;29974;642517;57705;474354;170371;653145;414189;5540;221002;643236;6572;26095;118461;8505;3185;93550;2074;170370;196740;6387;253725;644168;8031;55454;83849;240;259230;118738;5949;79290;644054;100133093;728113;56624;143162;2662;220979;282966;8187;58504;11067;100287932;5979;2658;7570;100130539;7580;1103;23283;653308;4477;5592;55753;387680,64
1,1,10,43379742,54025077,10645335,119016;5599;53828;267004;220992;195977;83937;100652748;9721;220972;29974;642517;57705;474354;170371;653145;414189;5540;221002;643236;6572;26095;118461;8505;3185;93550;2074;170370;196740;6387;253725;644168;8031;55454;83849;240;259230;118738;5949;79290;644054;100133093;728113;56624;143162;2662;220979;282966;8187;58504;11067;100287932;5979;2658;7570;100130539;7580;1103;23283;653308;4477;5592;55753;387680,64
1,-1,10,43600625,43600691,66,5979,1
1,-1,10,43600657,43600691,34,5979,1
1,1,10,43957496,55681185,11723689,6387;119016;5599;253725;644168;267004;220992;8031;195977;83937;100652748;9721;220972;22943;29974;83849;642517;259230;57705;474354;170371;118738;653145;5949;79290;644054;100133093;728113;414189;5540;56624;143162;643236;6572;2662;220979;26095;118461;4153;282966;8187;58504;387680;11067;65217;100287932;8505;2658;7570;100130539;93550;7580;1103;23283;653308;2074;170370;4477;196740;5592;55753;240,62
1,-1,10,45247685,45331277,83592,,0
1,-1,10,45247685,45331277,83592,,0
1,-1,10,45247685,45331277,83592,,0
1,-1,10,45247685,45331277,83592,,0
1,-1,10,45247685,45331277,83592,,0
1,-1,10,45247685,45331277,83592,,0
1,-1,10,45247685,45331277,83592,,0
1,-1,10,45247685,45331277,83592,,0
1,-1,10,45247685,45331277,83592,,0
-1,1,10,46205690,51330432,5124742,119016;5599;253725;644168;267004;195977;9721;83849;642517;57705;474354;170371;118738;653145;5949;644054;100133093;728113;5540;143162;6572;2662;26095;118461;282966;58504;8505;2658;1103;2074;170370;196740;55753,33
-1,1,10,46205696,51724915,5519219,119016;5599;253725;644168;267004;8031;195977;100652748;9721;83849;642517;57705;474354;170371;118738;653145;5949;644054;100133093;728113;5540;143162;6572;2662;26095;118461;282966;58504;100287932;8505;2658;1103;2074;170370;4477;196740;55753,37
1,-1,10,46224446,46321318,96872,253725;119016,2
-1,1,10,46224446,51594991,5370545,119016;5599;253725;644168;267004;8031;195977;100652748;9721;83849;642517;57705;474354;170371;118738;653145;5949;644054;100133093;728113;5540;143162;6572;2662;26095;118461;282966;58504;100287932;8505;2658;1103;2074;170370;4477;196740;55753,37
1,-1,10,46476965,47531169,1054204,728113;9721;83849;5540,4
1,-1,10,46491169,46550696,59527,,0
1,-1,10,46491169,46550969,59800,,0
-1,1,10,46491169,51594991,5103822,5599;644168;267004;8031;195977;100652748;9721;83849;642517;57705;474354;170371;118738;653145;5949;644054;100133093;728113;5540;143162;6572;2662;26095;118461;282966;58504;100287932;8505;2658;1103;2074;170370;4477;196740;55753,35
1,-1,10,46533414,47158684,625270,728113;9721;83849;5540,4
1,-1,10,46550787,47323674,772887,728113;9721;83849;5540,4
1,-1,10,46550787,47323674,772887,728113;9721;83849;5540,4
1,-1,10,46550787,47929856,1379069,195977;83849;728113;9721;5540,5
1,-1,10,46550787,48055707,1504920,195977;83849;728113;9721;5540,5
1,-1,10,46550803,47323674,772871,728113;9721;83849;5540,4
1,-1,10,46550847,47158684,607837,728113;9721;83849;5540,4
1,-1,10,46550847,47158684,607837,728113;9721;83849;5540,4
1,-1,10,46550847,47158684,607837,728113;9721;83849;5540,4
1,-1,10,46550847,47158684,607837,728113;9721;83849;5540,4
1,-1,10,46550847,47158684,607837,728113;9721;83849;5540,4
1,-1,10,46550847,47158684,607837,728113;9721;83849;5540,4
1,-1,10,46550847,47158684,607837,728113;9721;83849;5540,4
1,-1,10,46550847,47158684,607837,728113;9721;83849;5540,4
1,-1,10,46550847,47158684,607837,728113;9721;83849;5540,4
1,-1,10,46550847,47158684,607837,728113;9721;83849;5540,4
1,-1,10,46550847,47161385,610538,728113;9721;83849;5540,4
-1,-1,10,46550847,47531169,980322,728113;9721;83849;5540,4
-1,-1,10,46550847,47531169,980322,728113;9721;83849;5540,4
1,-1,10,46550847,47531169,980322,728113;9721;83849;5540,4
1,-1,10,46550847,47531169,980322,728113;9721;83849;5540,4
1,-1,10,46550847,47531169,980322,728113;9721;83849;5540,4
1,-1,10,46550847,47531169,980322,728113;9721;83849;5540,4
1,-1,10,46550847,47531169,980322,728113;9721;83849;5540,4
1,-1,10,46550847,47531169,980322,728113;9721;83849;5540,4
1,-1,10,46550847,47531169,980322,728113;9721;83849;5540,4
1,-1,10,46550847,47531169,980322,728113;9721;83849;5540,4
1,-1,10,46550847,47531169,980322,728113;9721;83849;5540,4
1,-1,10,46550847,47531169,980322,728113;9721;83849;5540,4
1,-1,10,46550847,47531169,980322,728113;9721;83849;5540,4
1,-1,10,46550847,47531169,980322,728113;9721;83849;5540,4
1,-1,10,46550847,47531169,980322,728113;9721;83849;5540,4
1,-1,10,46550847,47531169,980322,728113;9721;83849;5540,4
1,-1,10,46550847,47531169,980322,728113;9721;83849;5540,4
1,-1,10,46550847,47531169,980322,728113;9721;83849;5540,4
1,-1,10,46550847,47531169,980322,728113;9721;83849;5540,4
1,-1,10,46550847,47719896,1169049,195977;83849;728113;9721;5540,5
1,-1,10,46550847,47719896,1169049,195977;83849;728113;9721;5540,5
1,-1,10,46550847,47719896,1169049,195977;83849;728113;9721;5540,5
1,-1,10,46550847,47719896,1169049,195977;83849;728113;9721;5540,5
1,-1,10,46550847,47738628,1187781,195977;83849;728113;9721;5540,5
1,-1,10,46550847,47776292,1225445,195977;83849;728113;9721;5540,5
1,-1,10,46550847,47776292,1225445,195977;83849;728113;9721;5540,5
-1,-1,10,46566708,47531169,964461,728113;9721;83849;5540,4
-1,-1,10,46609932,47033418,423486,9721;83849,2
-1,-1,10,46609932,47033418,423486,9721;83849,2
-1,-1,10,46609932,47033418,423486,9721;83849,2
-1,-1,10,46609932,47074919,464987,9721;83849,2
-1,-1,10,46609932,47074919,464987,9721;83849,2
-1,-1,10,46609932,47074919,464987,9721;83849,2
-1,-1,10,46609932,47074919,464987,9721;83849,2
-1,-1,10,46609932,47074919,464987,9721;83849,2
-1,-1,10,46609932,47074919,464987,9721;83849,2
-1,-1,10,46609932,47074919,464987,9721;83849,2
-1,-1,10,46609932,47074919,464987,9721;83849,2
1,-1,10,46609932,47323674,713742,728113;9721;83849;5540,4
1,-1,10,46609932,47323674,713742,728113;9721;83849;5540,4
1,-1,10,46609932,47323674,713742,728113;9721;83849;5540,4
-1,-1,10,46609932,47323674,713742,728113;9721;83849;5540,4
1,-1,10,46609932,47323674,713742,728113;9721;83849;5540,4
-1,-1,10,46609932,47323674,713742,728113;9721;83849;5540,4
-1,-1,10,46609932,47323674,713742,728113;9721;83849;5540,4
-1,-1,10,46609932,47323674,713742,728113;9721;83849;5540,4
-1,-1,10,46609932,47323674,713742,728113;9721;83849;5540,4
-1,-1,10,46609932,47323674,713742,728113;9721;83849;5540,4
-1,-1,10,46609932,47323674,713742,728113;9721;83849;5540,4
-1,-1,10,46609932,47323674,713742,728113;9721;83849;5540,4
-1,-1,10,46609932,47323674,713742,728113;9721;83849;5540,4
1,-1,10,46609932,47323674,713742,728113;9721;83849;5540,4
1,-1,10,46609932,47323674,713742,728113;9721;83849;5540,4
-1,-1,10,46609932,47323674,713742,728113;9721;83849;5540,4
-1,-1,10,46609932,47323674,713742,728113;9721;83849;5540,4
1,-1,10,46609932,48055707,1445775,195977;83849;728113;9721;5540,5
1,-1,10,46609948,49262406,2652458,83849;642517;2658;2662;26095;118738;195977;653145;5949;644054;100133093;728113;9721;5540,14
1,-1,10,46624421,47531169,906748,728113;9721;83849;5540,4
1,-1,10,46624421,47531169,906748,728113;9721;83849;5540,4
1,-1,10,46654643,47531169,876526,728113;9721;83849;5540,4
1,-1,10,46654643,47531169,876526,728113;9721;83849;5540,4
1,-1,10,46654643,47531169,876526,728113;9721;83849;5540,4
1,-1,10,46654643,47531169,876526,728113;9721;83849;5540,4
1,-1,10,46654643,47531169,876526,728113;9721;83849;5540,4
1,-1,10,46654643,47531169,876526,728113;9721;83849;5540,4
1,-1,10,46654643,47531169,876526,728113;9721;83849;5540,4
1,-1,10,46654643,47719896,1065253,195977;83849;728113;9721;5540,5
1,-1,10,46654643,47719896,1065253,195977;83849;728113;9721;5540,5
1,-1,10,46654643,47719896,1065253,195977;83849;728113;9721;5540,5
1,-1,10,46654643,47719896,1065253,195977;83849;728113;9721;5540,5
1,-1,10,46654643,47719896,1065253,195977;83849;728113;9721;5540,5
1,-1,10,46654643,47719896,1065253,195977;83849;728113;9721;5540,5
1,-1,10,46654643,47719896,1065253,195977;83849;728113;9721;5540,5
1,-1,10,46654643,47719896,1065253,195977;83849;728113;9721;5540,5
1,-1,10,46654643,47719896,1065253,195977;83849;728113;9721;5540,5
1,-1,10,46654643,47719896,1065253,195977;83849;728113;9721;5540,5
1,-1,10,46654643,47719896,1065253,195977;83849;728113;9721;5540,5
1,-1,10,46654643,47719896,1065253,195977;83849;728113;9721;5540,5
1,-1,10,46654643,47719896,1065253,195977;83849;728113;9721;5540,5
1,-1,10,46654643,47719896,1065253,195977;83849;728113;9721;5540,5
1,-1,10,46654643,47719896,1065253,195977;83849;728113;9721;5540,5
1,-1,10,46654643,47719896,1065253,195977;83849;728113;9721;5540,5
1,-1,10,46654643,47719896,1065253,195977;83849;728113;9721;5540,5
1,-1,10,46654643,47719896,1065253,195977;83849;728113;9721;5540,5
1,-1,10,46654643,47719896,1065253,195977;83849;728113;9721;5540,5
1,-1,10,46654643,47719896,1065253,195977;83849;728113;9721;5540,5
1,-1,10,46654643,47719896,1065253,195977;83849;728113;9721;5540,5
1,-1,10,46654643,47719896,1065253,195977;83849;728113;9721;5540,5
1,-1,10,46654643,47719896,1065253,195977;83849;728113;9721;5540,5
1,-1,10,46654643,47719896,1065253,195977;83849;728113;9721;5540,5
1,-1,10,46654643,47719896,1065253,195977;83849;728113;9721;5540,5
1,-1,10,46654643,47719896,1065253,195977;83849;728113;9721;5540,5
1,-1,10,46654643,47719896,1065253,195977;83849;728113;9721;5540,5
1,-1,10,46654643,47735909,1081266,195977;83849;728113;9721;5540,5
1,-1,10,46654643,47735909,1081266,195977;83849;728113;9721;5540,5
1,-1,10,46654643,47735909,1081266,195977;83849;728113;9721;5540,5
1,-1,10,46654643,47735909,1081266,195977;83849;728113;9721;5540,5
1,-1,10,46654643,47735909,1081266,195977;83849;728113;9721;5540,5
1,-1,10,46654643,47735909,1081266,195977;83849;728113;9721;5540,5
1,-1,10,46654643,47735909,1081266,195977;83849;728113;9721;5540,5
1,-1,10,46654643,47735909,1081266,195977;83849;728113;9721;5540,5
1,-1,10,46654643,47735909,1081266,195977;83849;728113;9721;5540,5
1,-1,10,46654643,47735909,1081266,195977;83849;728113;9721;5540,5
1,-1,10,46654643,47735909,1081266,195977;83849;728113;9721;5540,5
1,-1,10,46654643,47738628,1083985,195977;83849;728113;9721;5540,5
1,-1,10,46654643,47738628,1083985,195977;83849;728113;9721;5540,5
1,-1,10,46654643,47738628,1083985,195977;83849;728113;9721;5540,5
1,-1,10,46654643,47759580,1104937,195977;83849;728113;9721;5540,5
1,-1,10,46654643,47759580,1104937,195977;83849;728113;9721;5540,5
1,-1,10,46654643,47759580,1104937,195977;83849;728113;9721;5540,5
1,-1,10,46654643,47768480,1113837,195977;83849;728113;9721;5540,5
1,-1,10,46654643,47776292,1121649,195977;83849;728113;9721;5540,5
1,-1,10,46654643,47776292,1121649,195977;83849;728113;9721;5540,5
1,-1,10,46654643,47776292,1121649,195977;83849;728113;9721;5540,5
1,-1,10,46654643,47776292,1121649,195977;83849;728113;9721;5540,5
1,-1,10,46654643,47776292,1121649,195977;83849;728113;9721;5540,5
1,-1,10,46654643,47776292,1121649,195977;83849;728113;9721;5540,5
1,-1,10,46654643,47776292,1121649,195977;83849;728113;9721;5540,5
1,-1,10,46654643,47776292,1121649,195977;83849;728113;9721;5540,5
1,-1,10,46654643,47776292,1121649,195977;83849;728113;9721;5540,5
1,-1,10,46654643,47776292,1121649,195977;83849;728113;9721;5540,5
1,-1,10,46654643,47776292,1121649,195977;83849;728113;9721;5540,5
1,-1,10,46654643,47776292,1121649,195977;83849;728113;9721;5540,5
1,-1,10,46654643,47776292,1121649,195977;83849;728113;9721;5540,5
1,-1,10,46654643,47776292,1121649,195977;83849;728113;9721;5540,5
1,-1,10,46654643,47776292,1121649,195977;83849;728113;9721;5540,5
1,-1,10,46654643,47776292,1121649,195977;83849;728113;9721;5540,5
1,-1,10,46654643,47776292,1121649,195977;83849;728113;9721;5540,5
1,-1,10,46654643,47776292,1121649,195977;83849;728113;9721;5540,5
1,-1,10,46654643,47776292,1121649,195977;83849;728113;9721;5540,5
1,-1,10,46654643,47776292,1121649,195977;83849;728113;9721;5540,5
1,-1,10,46654643,47776292,1121649,195977;83849;728113;9721;5540,5
1,-1,10,46654643,47776292,1121649,195977;83849;728113;9721;5540,5
1,-1,10,46654643,47776292,1121649,195977;83849;728113;9721;5540,5
1,-1,10,46654643,47776292,1121649,195977;83849;728113;9721;5540,5
1,-1,10,46654643,47776292,1121649,195977;83849;728113;9721;5540,5
1,-1,10,46654643,47776292,1121649,195977;83849;728113;9721;5540,5
1,-1,10,46654643,47776292,1121649,195977;83849;728113;9721;5540,5
1,-1,10,46654643,47776292,1121649,195977;83849;728113;9721;5540,5
1,-1,10,46654643,47776292,1121649,195977;83849;728113;9721;5540,5
1,-1,10,46654643,47776292,1121649,195977;83849;728113;9721;5540,5
1,-1,10,46654643,47776292,1121649,195977;83849;728113;9721;5540,5
1,-1,10,46654643,47776292,1121649,195977;83849;728113;9721;5540,5
1,-1,10,46654643,47776292,1121649,195977;83849;728113;9721;5540,5
1,-1,10,46654643,47776292,1121649,195977;83849;728113;9721;5540,5
1,-1,10,46654643,47776292,1121649,195977;83849;728113;9721;5540,5
1,-1,10,46654643,47776292,1121649,195977;83849;728113;9721;5540,5
1,-1,10,46654643,47776292,1121649,195977;83849;728113;9721;5540,5
1,-1,10,46654643,47776292,1121649,195977;83849;728113;9721;5540,5
1,-1,10,46654643,47776292,1121649,195977;83849;728113;9721;5540,5
1,-1,10,46654643,47776292,1121649,195977;83849;728113;9721;5540,5
1,-1,10,46654643,47776292,1121649,195977;83849;728113;9721;5540,5
1,-1,10,46654643,47776292,1121649,195977;83849;728113;9721;5540,5
1,-1,10,46654643,47776292,1121649,195977;83849;728113;9721;5540,5
1,-1,10,46654643,47776292,1121649,195977;83849;728113;9721;5540,5
1,-1,10,46654643,47776292,1121649,195977;83849;728113;9721;5540,5
1,-1,10,46654643,47776292,1121649,195977;83849;728113;9721;5540,5
1,-1,10,46654643,47776292,1121649,195977;83849;728113;9721;5540,5
1,-1,10,46654643,47776292,1121649,195977;83849;728113;9721;5540,5
1,-1,10,46654643,47776292,1121649,195977;83849;728113;9721;5540,5
1,-1,10,46654643,47776292,1121649,195977;83849;728113;9721;5540,5
1,-1,10,46654643,47776292,1121649,195977;83849;728113;9721;5540,5
1,-1,10,46654643,47776292,1121649,195977;83849;728113;9721;5540,5
1,-1,10,46654643,47776292,1121649,195977;83849;728113;9721;5540,5
1,-1,10,46654643,47776292,1121649,195977;83849;728113;9721;5540,5
1,-1,10,46654643,47776292,1121649,195977;83849;728113;9721;5540,5
1,-1,10,46654643,47776292,1121649,195977;83849;728113;9721;5540,5
1,-1,10,46654643,47776292,1121649,195977;83849;728113;9721;5540,5
1,-1,10,46654643,47776292,1121649,195977;83849;728113;9721;5540,5
1,-1,10,46654643,47776292,1121649,195977;83849;728113;9721;5540,5
1,-1,10,46654643,47776292,1121649,195977;83849;728113;9721;5540,5
1,-1,10,46654643,47776292,1121649,195977;83849;728113;9721;5540,5
1,-1,10,46654643,47776292,1121649,195977;83849;728113;9721;5540,5
1,-1,10,46654643,47776292,1121649,195977;83849;728113;9721;5540,5
1,-1,10,46654643,47776292,1121649,195977;83849;728113;9721;5540,5
1,-1,10,46654643,47776292,1121649,195977;83849;728113;9721;5540,5
1,-1,10,46654643,47776292,1121649,195977;83849;728113;9721;5540,5
1,-1,10,46654643,47776292,1121649,195977;83849;728113;9721;5540,5
1,-1,10,46654643,47776292,1121649,195977;83849;728113;9721;5540,5
1,-1,10,46654643,47776292,1121649,195977;83849;728113;9721;5540,5
1,-1,10,46654643,47776292,1121649,195977;83849;728113;9721;5540,5
1,-1,10,46654643,47776292,1121649,195977;83849;728113;9721;5540,5
1,-1,10,46654643,47776292,1121649,195977;83849;728113;9721;5540,5
1,-1,10,46654643,47776292,1121649,195977;83849;728113;9721;5540,5
1,-1,10,46654643,47776292,1121649,195977;83849;728113;9721;5540,5
1,-1,10,46654643,47776292,1121649,195977;83849;728113;9721;5540,5
1,-1,10,46654643,47776292,1121649,195977;83849;728113;9721;5540,5
1,-1,10,46654643,47897436,1242793,195977;83849;728113;9721;5540,5
1,-1,10,46654643,47897436,1242793,195977;83849;728113;9721;5540,5
1,-1,10,46654643,47906980,1252337,195977;83849;728113;9721;5540,5
1,-1,10,46654643,47906980,1252337,195977;83849;728113;9721;5540,5
1,-1,10,46654643,48055707,1401064,195977;83849;728113;9721;5540,5
1,-1,10,46691612,47776292,1084680,195977;83849;728113;9721;5540,5
1,-1,10,46691612,47776292,1084680,195977;83849;728113;9721;5540,5
-1,-1,10,46711354,47531169,819815,728113;9721;83849;5540,4
1,-1,10,46712703,47531169,818466,728113;9721;83849;5540,4
1,-1,10,46712703,47531169,818466,728113;9721;83849;5540,4
1,-1,10,46712703,47531169,818466,728113;9721;83849;5540,4
1,-1,10,46712703,47531169,818466,728113;9721;83849;5540,4
1,-1,10,46712703,47531169,818466,728113;9721;83849;5540,4
1,-1,10,46732864,47531169,798305,728113;9721;83849;5540,4
1,-1,10,46732864,47531169,798305,728113;9721;83849;5540,4
1,-1,10,46732864,47531169,798305,728113;9721;83849;5540,4
1,-1,10,46732864,47531169,798305,728113;9721;83849;5540,4
1,-1,10,46732864,47531169,798305,728113;9721;83849;5540,4
1,-1,10,46732864,47531169,798305,728113;9721;83849;5540,4
1,-1,10,46732864,47531169,798305,728113;9721;83849;5540,4
1,-1,10,46732864,47531169,798305,728113;9721;83849;5540,4
1,-1,10,46732864,47531169,798305,728113;9721;83849;5540,4
1,-1,10,46732864,47531169,798305,728113;9721;83849;5540,4
1,-1,10,46749346,47531169,781823,728113;9721;83849;5540,4
1,-1,10,46749346,47531169,781823,728113;9721;83849;5540,4
1,-1,10,46749346,47531169,781823,728113;9721;83849;5540,4
1,-1,10,46749346,47531169,781823,728113;9721;83849;5540,4
1,-1,10,46749346,47531169,781823,728113;9721;83849;5540,4
1,-1,10,46749346,47531169,781823,728113;9721;83849;5540,4
1,-1,10,46749346,47531169,781823,728113;9721;83849;5540,4
1,-1,10,46749346,47531169,781823,728113;9721;83849;5540,4
1,-1,10,46800405,47702392,901987,195977;83849;728113;9721;5540,5
1,-1,10,46814483,47531169,716686,728113;9721;83849;5540,4
1,-1,10,46814483,47776292,961809,195977;83849;728113;9721;5540,5
1,-1,10,46814483,47776292,961809,195977;83849;728113;9721;5540,5
1,-1,10,46949255,48364954,1415699,83849;642517;118738;195977;653145;100133093;728113;9721;5540,9
-1,-1,10,47006954,47074832,67878,,0
-1,-1,10,47006954,47074861,67907,,0
-1,-1,10,47006954,47074861,67907,,0
1,-1,10,47006954,47148518,141564,5540,1
-1,-1,10,47006954,47323674,316720,728113;5540,2
1,-1,10,47006954,47323674,316720,728113;5540,2
-1,-1,10,47006954,47323674,316720,728113;5540,2
-1,-1,10,47006954,47323674,316720,728113;5540,2
1,-1,10,47006954,47323674,316720,728113;5540,2
-1,-1,10,47006954,47323674,316720,728113;5540,2
-1,-1,10,47006954,47323674,316720,728113;5540,2
-1,-1,10,47006954,47323674,316720,728113;5540,2
-1,-1,10,47006954,47323674,316720,728113;5540,2
-1,-1,10,47006954,47323674,316720,728113;5540,2
-1,-1,10,47006954,47323674,316720,728113;5540,2
1,-1,10,47006954,47323674,316720,728113;5540,2
-1,-1,10,47006954,47323674,316720,728113;5540,2
1,-1,10,47006954,47323674,316720,728113;5540,2
-1,-1,10,47006954,47323674,316720,728113;5540,2
1,-1,10,47006954,47323674,316720,728113;5540,2
1,-1,10,47006954,47323674,316720,728113;5540,2
-1,-1,10,47006954,47323674,316720,728113;5540,2
-1,-1,10,47006954,47323674,316720,728113;5540,2
1,-1,10,47006954,47323674,316720,728113;5540,2
-1,-1,10,47006954,47323674,316720,728113;5540,2
1,-1,10,47006954,47323674,316720,728113;5540,2
-1,-1,10,47006954,47323674,316720,728113;5540,2
-1,-1,10,47006954,47531169,524215,728113;5540,2
-1,-1,10,47006954,47531169,524215,728113;5540,2
1,-1,10,47006954,47531169,524215,728113;5540,2
1,-1,10,47006954,47531169,524215,728113;5540,2
1,-1,10,47006954,47531169,524215,728113;5540,2
1,-1,10,47006954,47531169,524215,728113;5540,2
1,-1,10,47006954,47531169,524215,728113;5540,2
1,-1,10,47006954,47531169,524215,728113;5540,2
1,-1,10,47006954,47531169,524215,728113;5540,2
1,-1,10,47006954,47531169,524215,728113;5540,2
1,-1,10,47006954,47531169,524215,728113;5540,2
1,-1,10,47006954,47531169,524215,728113;5540,2
1,-1,10,47006954,47531169,524215,728113;5540,2
1,-1,10,47006954,47531169,524215,728113;5540,2
1,-1,10,47006954,47531169,524215,728113;5540,2
-1,-1,10,47006954,47531169,524215,728113;5540,2
-1,-1,10,47006954,47531169,524215,728113;5540,2
1,-1,10,47006954,47531169,524215,728113;5540,2
1,-1,10,47006954,47531169,524215,728113;5540,2
1,-1,10,47006954,47531169,524215,728113;5540,2
1,-1,10,47006954,47531169,524215,728113;5540,2
-1,-1,10,47006954,47531169,524215,728113;5540,2
1,-1,10,47006954,47531169,524215,728113;5540,2
1,-1,10,47006954,47531169,524215,728113;5540,2
1,-1,10,47006954,47531169,524215,728113;5540,2
-1,-1,10,47006954,47531169,524215,728113;5540,2
1,-1,10,47006954,47531169,524215,728113;5540,2
1,-1,10,47006954,47531169,524215,728113;5540,2
1,-1,10,47006954,47531169,524215,728113;5540,2
1,-1,10,47006954,47531169,524215,728113;5540,2
1,-1,10,47006954,47531169,524215,728113;5540,2
1,-1,10,47006954,47531169,524215,728113;5540,2
1,-1,10,47006954,47531169,524215,728113;5540,2
-1,-1,10,47006954,47531169,524215,728113;5540,2
1,-1,10,47006954,47531169,524215,728113;5540,2
1,-1,10,47006954,47531169,524215,728113;5540,2
1,-1,10,47006954,47531169,524215,728113;5540,2
1,-1,10,47006954,47531169,524215,728113;5540,2
-1,-1,10,47006954,47531169,524215,728113;5540,2
1,-1,10,47006954,47531169,524215,728113;5540,2
1,-1,10,47006954,47531169,524215,728113;5540,2
1,-1,10,47006954,47531169,524215,728113;5540,2
1,-1,10,47006954,47531169,524215,728113;5540,2
1,-1,10,47006954,47531169,524215,728113;5540,2
-1,-1,10,47006954,47531169,524215,728113;5540,2
1,-1,10,47006954,47531169,524215,728113;5540,2
-1,-1,10,47006954,47531169,524215,728113;5540,2
1,-1,10,47006954,47531169,524215,728113;5540,2
1,-1,10,47006954,47531169,524215,728113;5540,2
-1,-1,10,47006954,47531169,524215,728113;5540,2
1,-1,10,47006954,47531169,524215,728113;5540,2
1,-1,10,47006954,47531169,524215,728113;5540,2
1,-1,10,47006954,47531169,524215,728113;5540,2
1,-1,10,47006954,47531169,524215,728113;5540,2
-1,-1,10,47006954,47531169,524215,728113;5540,2
1,-1,10,47006954,47531169,524215,728113;5540,2
1,-1,10,47006954,47531169,524215,728113;5540,2
1,-1,10,47006954,47531169,524215,728113;5540,2
1,-1,10,47006954,47531169,524215,728113;5540,2
1,-1,10,47006954,47531169,524215,728113;5540,2
1,-1,10,47006954,47531169,524215,728113;5540,2
-1,-1,10,47006954,47531169,524215,728113;5540,2
1,-1,10,47006954,47531169,524215,728113;5540,2
1,-1,10,47006954,47702558,695604,728113;195977;5540,3
1,-1,10,47006954,47768522,761568,728113;195977;5540,3
1,-1,10,47006954,47768540,761586,728113;195977;5540,3
1,-1,10,47006954,47768540,761586,728113;195977;5540,3
-1,-1,10,47006954,47768540,761586,728113;195977;5540,3
1,-1,10,47006954,47768540,761586,728113;195977;5540,3
1,-1,10,47006954,47929856,922902,728113;195977;5540,3
1,-1,10,47006954,48055707,1048753,728113;195977;5540,3
1,-1,10,47006954,48055707,1048753,728113;195977;5540,3
1,-1,10,47006954,48055707,1048753,728113;195977;5540,3
1,-1,10,47006954,48055707,1048753,728113;195977;5540,3
1,-1,10,47006954,48055707,1048753,728113;195977;5540,3
1,-1,10,47006954,48055707,1048753,728113;195977;5540,3
-1,-1,10,47006954,48055707,1048753,728113;195977;5540,3
-1,-1,10,47006954,48055707,1048753,728113;195977;5540,3
1,-1,10,47006954,48055707,1048753,728113;195977;5540,3
1,-1,10,47006954,48055707,1048753,728113;195977;5540,3
1,-1,10,47006954,48055707,1048753,728113;195977;5540,3
1,-1,10,47006954,48055707,1048753,728113;195977;5540,3
1,-1,10,47006954,48055707,1048753,728113;195977;5540,3
1,-1,10,47006954,48055707,1048753,728113;195977;5540,3
1,-1,10,47006954,48055707,1048753,728113;195977;5540,3
1,-1,10,47033385,47531169,497784,728113;5540,2
1,-1,10,47033385,47531169,497784,728113;5540,2
1,-1,10,47074802,47531169,456367,728113;5540,2
1,-1,10,47074802,47531169,456367,728113;5540,2
1,-1,10,47074802,47531169,456367,728113;5540,2
1,-1,10,47074802,47531169,456367,728113;5540,2
1,-1,10,47074802,47531169,456367,728113;5540,2
1,-1,10,47074860,47531169,456309,728113;5540,2
1,-1,10,47074860,47531169,456309,728113;5540,2
1,-1,10,47229666,47776292,546626,195977,1
1,-1,10,47547622,47655116,107494,,0
1,-1,10,48664015,49299273,635258,26095;644054,2
1,-1,10,49002272,49351034,348762,644054,1
1,-1,10,49002272,49351034,348762,644054,1
1,-1,10,49002272,49351034,348762,644054,1
1,-1,10,49002272,49351034,348762,644054,1
1,-1,10,49002272,49351034,348762,644054,1
1,-1,10,49002272,49351034,348762,644054,1
1,-1,10,49002272,49351034,348762,644054,1
1,-1,10,49002272,49351034,348762,644054,1
1,-1,10,49002272,49351034,348762,644054,1
1,-1,10,49002272,49372022,369750,143162;644054,2
1,-1,10,49002272,49372022,369750,143162;644054,2
1,-1,10,49002272,49372022,369750,143162;644054,2
1,-1,10,49002272,49372022,369750,143162;644054,2
1,-1,10,49002272,49372022,369750,143162;644054,2
1,-1,10,49002272,49390071,387799,143162;644054,2
1,-1,10,49002272,49390071,387799,143162;644054,2
1,-1,10,49002272,49390071,387799,143162;644054,2
1,-1,10,49002272,49390071,387799,143162;644054,2
1,-1,10,49002272,49390071,387799,143162;644054,2
1,-1,10,49002272,49390071,387799,143162;644054,2
1,-1,10,49002272,49390071,387799,143162;644054,2
1,-1,10,49002272,49390071,387799,143162;644054,2
1,-1,10,49002272,49390071,387799,143162;644054,2
1,-1,10,49002272,49390071,387799,143162;644054,2
1,-1,10,49002272,49390071,387799,143162;644054,2
1,-1,10,49002272,49390071,387799,143162;644054,2
-1,-1,10,49002272,49390071,387799,143162;644054,2
1,-1,10,49002272,49390071,387799,143162;644054,2
1,-1,10,49002272,49390071,387799,143162;644054,2
1,-1,10,49002272,49416448,414176,143162;644054,2
1,-1,10,49002272,49416448,414176,143162;644054,2
1,-1,10,49002272,49416448,414176,143162;644054,2
1,-1,10,49002272,49416448,414176,143162;644054,2
1,-1,10,49002272,49416448,414176,143162;644054,2
1,-1,10,49002272,49416448,414176,143162;644054,2
1,-1,10,49002272,49431037,428765,143162;644054,2
1,-1,10,49002272,49453774,451502,143162;644054,2
1,-1,10,49367155,49382926,15771,143162,1
1,-1,10,49367155,49382926,15771,143162,1
1,-1,10,49367155,49382926,15771,143162,1
1,-1,10,49367155,49382926,15771,143162,1
1,-1,10,49367155,49392896,25741,143162,1
-1,-1,10,51058602,51089817,31215,8505,1
1,-1,10,52489127,52518930,29803,653308,1
1,1,10,52489127,88906961,36417834,5328;84457;414152;26128;8030;5033;9886;50674;643161;11128;29974;9231;56521;6441;84293;10974;3778;729238;5552;54537;81619;4153;29982;23522;10367;8034;58529;338599;119385;118490;1305;6623;10105;55506;80312;653509;6229;219623;132;7417;64081;1763;11319;9559;9632;118881;84159;657;25961;57178;80195;140766;64115;51207;55847;347731;221035;26091;170384;219736;6832;729262;219699;84858;219790;27069;84647;219743;6865;79933;219654;288;26985;26103;29119;219793;65217;23411;80201;8879;729092;83938;22891;170392;5092;9188;8509;311;1959;9469;23555;64072;64106;7321;3098;219621;10718;4838;23234;55222;90550;9806;55315;221037;84890;5464;387694;79812;4143;7414;414236;220965;119504;143244;94233;2894;11155;818;55680;5660;118491;27143;1979;84332;56681;310;5532;54541;54788;387695;7019;22943;55749;143241;54462;220963;79009;84883;159195;3189;11130;100463289;142891;5551;220202;5995;84665;23063;2746;51021;51008;23053;118487;80114;219738;100507027;219348;317662;253430;92211;23283;653308;340745;983;5592,165
1,-1,10,53834509,53982615,148106,5592,1
-1,1,10,54810806,56486307,1675501,65217,1
-1,1,10,55714219,55857931,143712,65217,1
1,-1,10,56176972,56196387,19415,65217,1
1,-1,10,56176972,56196387,19415,65217,1
-1,-1,10,56932314,57187055,254741,,0
1,1,10,57046937,69318200,12271263,84890;11130;219790;84457;84159;100463289;29982;7321;219621;8030;288;9886;29119;80114;100507027;7019;55847;220965;347731;221035;22891;253430;220963;219623;983;1959;221037,27
1,-1,10,59180697,59364871,184174,,0
-1,1,10,65162339,77055857,11893518,5328;9469;23555;414152;64072;64106;26128;3098;5033;50674;4838;23234;56521;55222;90550;9806;55315;221037;5552;5464;23522;10367;8034;58529;338599;118490;1305;7414;414236;119504;55506;80312;818;55680;132;5660;7417;118491;27143;64081;1763;11319;9559;9632;118881;1979;25961;56681;310;5532;54541;140766;54788;64115;51207;347731;221035;26091;55749;170384;219736;6832;219699;79009;84883;159195;3189;84647;142891;5551;220202;219743;6865;79933;84665;26985;51021;51008;23053;29119;219793;118487;23411;80201;8879;729092;219738;317662;170392;5092;9188;8509,92
-1,-1,10,66985030,67121618,136588,,0
-1,-1,10,68072732,68154487,81755,29119,1
-1,-1,10,68072732,68251535,178803,29119,1
-1,-1,10,68122938,68376764,253826,29119,1
-1,-1,10,68154487,68359435,204948,29119,1
-1,-1,10,68182308,68290259,107951,29119,1
-1,-1,10,68182308,68322619,140311,29119,1
-1,-1,10,68211551,68322619,111068,29119,1
-1,-1,10,68237581,68443835,206254,29119,1
-1,-1,10,68251565,68427784,176219,29119,1
-1,-1,10,68290259,68465910,175651,29119,1
-1,-1,10,68322619,68359435,36816,29119,1
-1,-1,10,68322619,68465910,143291,29119,1
-1,-1,10,68395508,68465910,70402,29119,1
-1,-1,10,68443835,68516519,72684,29119,1
-1,-1,10,68479220,68599432,120212,29119,1
1,1,10,68956325,81181813,12225488,5328;9469;23555;414152;64072;64106;26128;3098;5033;50674;4838;11128;23234;9231;56521;55222;90550;3778;9806;55315;5552;5464;23522;10367;8034;58529;338599;118490;1305;7414;414236;10105;119504;55506;80312;6229;818;55680;132;5660;7417;118491;27143;64081;1763;11319;9559;9632;118881;1979;25961;57178;56681;310;5532;54541;140766;54788;64115;51207;26091;55749;170384;219736;6832;219699;79009;84883;159195;84858;3189;84647;142891;5551;220202;219743;6865;79933;219654;84665;26985;51021;51008;23053;29119;219793;118487;23411;80201;8879;729092;83938;219738;317662;170392;5092;9188;8509,98
1,-1,10,75434036,75457286,23250,729092,1
1,-1,10,75434036,75457286,23250,729092,1
1,-1,10,75434036,75461165,27129,729092,1
-1,1,10,75542067,79428995,3886928,5328;118881;142891;23522;26985;23053;338599;7417;118487;7414;51207;414236;83938;8509;818;132;3778;84858,18
1,-1,10,81251577,81557993,306416,729262;143244;653509;729238,4
-1,1,10,81449116,88983530,7534414,657;27069;84332;23063;54537;81619;5995;387694;79812;2746;119385;80195;10718;643161;26103;4143;387695;219348;6623;143241;729262;6441;54462;92211;94233;2894;84293;340745;10974;11155;311,31
-1,1,10,81561459,88828018,7266559,657;27069;84332;23063;81619;5995;387694;79812;2746;119385;80195;10718;643161;26103;4143;387695;219348;6623;143241;92211;6441;54462;94233;2894;84293;340745;10974;11155;311,29
-1,1,10,81597767,88951347,7353580,657;27069;84332;23063;54537;81619;5995;387694;79812;2746;119385;80195;10718;643161;26103;4143;387695;219348;6623;143241;92211;6441;54462;94233;2894;84293;340745;10974;11155;311,30
-1,1,10,81617260,88980961,7363701,657;27069;84332;23063;54537;81619;5995;387694;79812;2746;119385;80195;10718;643161;26103;4143;387695;219348;6623;143241;92211;6441;54462;94233;2894;84293;340745;10974;11155;311,30
1,1,10,81630468,88973570,7343102,657;27069;84332;23063;54537;81619;5995;387694;79812;2746;119385;80195;10718;643161;26103;4143;387695;219348;6623;143241;92211;6441;54462;94233;2894;84293;340745;10974;11155;311,30
-1,1,10,81630468,88975551,7345083,657;27069;84332;23063;54537;81619;5995;387694;79812;2746;119385;80195;10718;643161;26103;4143;387695;219348;6623;143241;92211;6441;54462;94233;2894;84293;340745;10974;11155;311,30
-1,1,10,81640994,88940429,7299435,657;27069;84332;23063;54537;81619;5995;387694;79812;2746;119385;80195;10718;643161;26103;4143;387695;219348;6623;143241;92211;6441;54462;94233;2894;84293;340745;10974;11155;311,30
-1,1,10,81641918,88828018,7186100,657;27069;84332;23063;81619;5995;387694;79812;2746;119385;80195;10718;643161;26103;4143;387695;219348;6623;143241;92211;6441;54462;94233;2894;84293;340745;10974;11155;311,29
-1,1,10,81641918,88828018,7186100,657;27069;84332;23063;81619;5995;387694;79812;2746;119385;80195;10718;643161;26103;4143;387695;219348;6623;143241;92211;6441;54462;94233;2894;84293;340745;10974;11155;311,29
-1,1,10,81685362,135524747,53839385,26509;196792;27291;142910;84896;27063;143187;22986;643161;8433;54838;79949;399818;83742;10935;3087;9126;26287;55088;340784;79955;4942;54780;6441;953;143384;9748;10023;503542;150;10844;1308;8038;119385;9446;4288;6623;27250;54777;118812;3195;3070;399823;1355;80351;118611;11101;657;23082;1369;9060;83401;2849;55717;159686;387718;80195;9221;55760;55280;22984;282974;1558;4601;25911;57412;2018;56647;10121;112817;1592;3167;84333;80019;387715;23223;27069;5076;57700;143282;338567;143279;54619;26103;1557;118813;92565;119559;79004;390010;311;26507;93426;9849;60495;10718;79892;10570;1793;84287;196051;119467;142827;9184;1571;2869;119032;51013;387707;84435;85450;22876;80313;387712;64318;3434;387694;9211;51684;643418;119391;118987;4143;1791;92170;3983;10724;84632;8661;36;10660;94233;2894;55844;100144748;3026;81894;6468;30819;840;84332;401647;55662;63877;8729;114815;118672;5309;387695;59338;4714;57559;23268;54462;118856;9937;84795;387700;26123;10579;57715;23063;1847;84545;2674;51703;404636;5728;84504;1147;50624;92211;3416;374355;7479;56652;118472;253738;1755;79591;2834;3437;6319;10285;60370;5791;5662;594857;7390;56889;729020;84293;51196;10974;118663;143379;55719;728118;81603;3257;6585;5223;54537;81619;9023;9148;4791;5408;6571;5654;51063;6975;1244;51363;170394;282996;9562;118670;119395;120;2253;4255;84108;1488;85442;5832;7093;54708;27343;5950;22841;29760;7511;5407;54764;664;441581;282969;9044;119587;84445;101;5146;355;642938;24138;9679;55118;119548;2805;3632;159371;55361;80217;9585;53354;8861;10556;118932;26098;84986;119392;81855;118924;9644;56165;59;1586;79803;57698;79991;10580;79176;9033;9124;26033;153;84171;79847;159296;8513;403;118980;118788;282973;50632;340665;1559;64429;22849;414157;340654;196743;92482;338557;10360;142940;55165;256536;25956;79812;11196;255022;118471;9118;340719;11155;374354;5406;6001;3988;3363;8036;3433;27287;8945;54805;9531;23401;23232;64210;2263;1562;79946;340706;143241;3832;4892;6877;55328;6934;1892;23172;80007;11023;10539;84458;643414;5995;64376;2746;6425;259217;219348;93377;282991;57089;22978;10613;51076;439996;7073;54536;399814;340745;5507;64077;57678;81621;84833,360
-1,1,10,81685369,88711465,7026096,657;27069;84332;23063;81619;5995;387694;79812;80195;10718;26103;4143;387695;219348;143241;92211;6441;54462;94233;2894;84293;340745;11155;311,24
-1,1,10,81892411,88722952,6830541,657;27069;84332;23063;81619;5995;387694;79812;10718;26103;4143;387695;219348;6623;143241;92211;54462;94233;2894;84293;340745;11155;311,23
-1,1,10,82013260,89166455,7153195,657;27069;84332;23063;54537;81619;5995;387694;79812;2746;119385;10718;643161;26103;4143;387695;6623;143241;92211;54462;94233;2894;84293;340745;10974;11155;728118,27
-1,-1,10,84137675,84270008,132333,10718,1
1,-1,10,84232776,84433985,201209,10718,1
-1,1,10,86766571,92609514,5842943,657;9060;142910;84896;3433;643161;3437;8513;57559;340654;55328;10974;728118;355;387700;24138;643414;23063;3434;54537;9023;79812;2746;119385;643418;9585;5728;53354;118932;6623;439996;9562;59;94233;2894;11155;100144748;3988;3363,39
1,-1,10,89685136,89685328,192,5728,1
-1,-1,10,90236197,90341481,105284,55328,1
1,-1,10,92363552,92594891,231339,3363,1
-1,1,10,92667881,98970384,6302503,26509;9849;27063;9124;5832;7093;54708;5950;29760;118788;1562;340665;23232;1559;1558;3087;22849;3832;142827;9044;953;56889;51196;338557;1592;5146;84333;387707;26123;55165;84458;6585;64318;143282;159371;9211;143279;54619;1557;1791;10556;93377;118924;54536;3416;5507;80351;3070;10580,49
-1,1,10,93186527,95820286,2633759,26509;55165;143282;159371;54708;143279;9211;5950;340665;3087;22849;118924;3832;54536;9044;3416;51196;5507;338557;1592;5146;80351,22
1,1,10,93283493,135427143,42143650,26509;196792;27291;143187;22986;8433;54838;79949;399818;83742;10935;3087;9126;26287;79955;55088;54780;340784;4942;953;143384;9748;10023;503542;150;10844;1308;8038;9446;4288;27250;54777;118812;3195;3070;399823;1355;80351;118611;11101;23082;1369;83401;55717;2849;159686;387718;9221;55760;55280;22984;282974;1558;4601;25911;57412;2018;56647;10121;112817;1592;3167;80019;387715;23223;5076;57700;143282;338567;54619;1557;118813;92565;79004;119559;390010;26507;93426;9849;60495;79892;10570;1793;84287;196051;119467;142827;9184;1571;2869;119032;51013;387707;84435;85450;22876;387712;64318;80313;9211;51684;119391;118987;1791;92170;3983;10724;84632;8661;36;10660;55844;3026;81894;6468;30819;840;401647;55662;63877;8729;114815;118672;5309;59338;4714;23268;118856;9937;84795;26123;10579;57715;1847;84545;2674;51703;404636;84504;1147;50624;3416;374355;7479;56652;118472;253738;1755;79591;2834;6319;10285;60370;5791;5662;7390;594857;56889;729020;118663;51196;143379;55719;81603;3257;6585;5223;9148;4791;5408;51063;6571;5654;6975;1244;51363;170394;282996;118670;119395;120;2253;4255;84108;1488;85442;5832;7093;54708;27343;5950;22841;29760;7511;5407;54764;664;282969;9044;119587;84445;101;5146;642938;119548;55118;9679;2805;3632;159371;55361;80217;8861;26098;84986;119392;81855;118924;9644;56165;1586;79803;79991;57698;10580;79176;9033;9124;26033;153;84171;79847;159296;403;118980;118788;282973;50632;340665;1559;64429;22849;414157;196743;92482;338557;10360;142940;55165;256536;25956;11196;255022;118471;9118;340719;374354;5406;6001;8036;27287;8945;54805;9531;1562;23232;23401;64210;2263;79946;340706;3832;4892;6877;6934;1892;23172;11023;80007;10539;84458;64376;6425;259217;93377;282991;57089;22978;10613;51076;7073;54536;399814;5507;64077;57678;81621;84833,298
-1,1,10,93908171,101809723,7901552,26509;9849;27291;60495;9124;84171;159296;118788;60370;83742;340665;1559;3087;84287;22849;26287;414157;142827;953;56889;51196;338557;10023;51013;387707;55165;3257;6585;5223;64318;9211;1791;1244;118812;3070;1355;81894;1369;401647;5832;7093;54708;5950;29760;1562;23232;23401;64210;1558;23268;3832;112817;1592;84795;5146;80019;26123;84458;23223;55118;2805;159371;54619;55361;1557;6425;93377;57089;84986;118813;118924;51076;10580;54536;3416;26507,76
-1,1,10,94403676,97230894,2827218,26509;55165;64318;9124;159371;9211;5950;1562;23232;340665;1557;1559;1558;3087;118924;3832;142827;54536;51196;338557;1592;3070;5146;10580,24
-1,-1,10,96453830,96612764,158934,1557;1562,2
-1,-1,10,96520226,96540436,20210,1557,1
-1,-1,10,100667725,100696797,29072,60495,1
1,1,10,100780957,135427143,34646186,196792;253738;1755;79591;143187;2834;22986;6319;8433;54838;10285;79949;399818;5791;10935;9126;340784;79955;5662;55088;54780;4942;7390;594857;729020;143384;118663;9748;143379;55719;81603;503542;150;10844;1308;9148;8038;9446;4791;4288;5408;51063;6571;5654;6975;1244;27250;51363;170394;282996;54777;3195;118670;119395;120;2253;399823;4255;84108;1355;1488;118611;11101;23082;1369;83401;55717;2849;159686;85442;387718;27343;22841;7511;9221;5407;55280;22984;54764;55760;282974;664;4601;282969;25911;57412;2018;56647;119587;84445;10121;101;3167;642938;387715;119548;9679;2805;5076;3632;57700;338567;80217;8861;26098;119392;81855;9644;56165;92565;1586;79004;119559;390010;79803;79991;57698;26507;93426;79176;9033;60495;26033;153;79847;159296;403;118980;282973;79892;50632;10570;1793;64429;196051;119467;196743;92482;9184;1571;2869;119032;10360;142940;84435;85450;22876;387712;256536;80313;25956;51684;11196;119391;118987;255022;92170;3983;10724;84632;8661;36;118471;10660;9118;340719;55844;374354;5406;6001;3026;81894;6468;30819;8036;55662;840;63877;8729;27287;8945;54805;114815;9531;118672;5309;59338;2263;4714;79946;340706;23268;4892;6877;118856;6934;9937;1892;23172;11023;80007;10579;10539;57715;1847;64376;84545;2674;51703;404636;259217;84504;282991;57089;1147;22978;10613;51076;50624;7073;399814;374355;7479;56652;64077;57678;81621;118472;84833,229
1,1,10,102360249,135436092,33075843,196792;253738;1755;79591;143187;2834;22986;8433;54838;10285;79949;399818;5791;10935;9126;340784;79955;5662;55088;54780;4942;7390;594857;729020;143384;118663;9748;143379;55719;81603;503542;150;10844;1308;9148;8038;9446;4791;4288;5408;51063;6571;5654;6975;27250;51363;170394;282996;54777;3195;118670;119395;120;2253;399823;4255;84108;1488;118611;11101;23082;83401;55717;2849;159686;85442;387718;27343;22841;7511;9221;5407;22984;55760;54764;282974;664;4601;282969;25911;57412;2018;56647;119587;84445;10121;101;3167;642938;387715;119548;9679;5076;3632;57700;338567;80217;8861;26098;119392;81855;9644;56165;92565;1586;79004;119559;390010;79803;79991;57698;93426;79176;26033;153;79847;403;118980;282973;79892;50632;10570;1793;64429;196051;119467;196743;92482;9184;1571;2869;119032;10360;142940;84435;85450;22876;387712;256536;80313;51684;11196;119391;118987;255022;92170;3983;10724;84632;8661;36;118471;10660;9118;340719;55844;374354;5406;6001;3026;30819;6468;8036;840;63877;8729;27287;8945;54805;114815;9531;118672;5309;59338;2263;79946;340706;4892;6877;118856;6934;9937;1892;23172;11023;80007;10579;10539;57715;1847;64376;84545;2674;51703;404636;259217;84504;22978;50624;7073;399814;374355;56652;64077;57678;81621;118472;84833,208
-1,1,10,102437474,102524276,86802,5076,1
1,1,10,102937062,103478866,541804,27343;8945;6468;10660;25911,5
1,1,10,102969098,103402989,433891,27343;8945;6468;10660;25911,5
1,1,10,102947729,103488168,540439,27343;8945;6468;10660;25911,5
1,1,10,102949227,103482524,533297,27343;8945;6468;10660;25911,5
1,1,10,102949737,103432420,482683,27343;8945;6468;10660;25911,5
1,1,10,102969339,103508138,538799,27343;8945;6468;10660;25911,5
1,1,10,103208804,103449273,240469,8945;6468;27343;25911,4
-1,1,10,104030479,115410590,11380111,3026;79176;8036;159686;8729;143187;79847;54805;22986;114815;403;54838;118980;7511;10285;22984;9126;4601;64429;79946;5662;57412;4892;729020;6877;92482;10121;9748;6934;119032;81603;85450;150;1308;1847;9148;51684;9446;4791;80217;119391;51703;51063;255022;6975;22978;119392;27250;9118;9644;282996;1586;79004;119395;120;79991;57678;84108;84833,59
-1,1,10,104491930,115844864,11352934,3026;8036;840;159686;143187;153;54805;22986;114815;54838;10285;118980;79949;7511;22984;9126;4601;64429;57412;4892;729020;6877;92482;9748;6934;9937;119032;85450;150;1308;1847;9148;9446;80217;51703;119391;51063;255022;6975;22978;119392;27250;9118;9644;282996;1586;374354;119395;120;79991;57678;84108;84833,53
1,1,10,104633712,135427143,30793431,196792;253738;1755;143187;2834;22986;8433;10285;79949;399818;5791;10935;9126;340784;55088;4942;54780;7390;594857;729020;143384;118663;9748;143379;503542;150;10844;1308;9148;8038;9446;4288;5408;51063;6571;5654;6975;27250;51363;170394;282996;54777;118670;119395;120;399823;4255;84108;1488;118611;11101;55717;2849;159686;85442;387718;22841;7511;55760;5407;22984;282974;54764;664;4601;282969;57412;2018;56647;119587;101;3167;642938;387715;119548;9679;3632;57700;338567;80217;26098;119392;9644;56165;92565;119559;390010;57698;79991;93426;26033;153;282973;79892;50632;10570;1793;64429;196051;119467;196743;92482;9184;1571;2869;142940;84435;85450;22876;387712;256536;80313;11196;119391;118987;255022;92170;3983;84632;8661;36;118471;9118;340719;55844;374354;5406;6001;3026;8036;840;63877;27287;54805;114815;9531;118672;59338;2263;340706;4892;6877;118856;6934;9937;1892;23172;11023;80007;10579;10539;1847;64376;2674;51703;404636;259217;84504;22978;50624;7073;399814;374355;64077;57678;118472;84833,167
1,1,10,106003533,135427143,29423610,196792;253738;1755;143187;2834;22986;8433;10285;79949;399818;5791;10935;9126;340784;55088;4942;54780;7390;594857;143384;118663;143379;503542;150;10844;8038;9446;4288;5408;6571;5654;6975;27250;51363;170394;282996;54777;118670;120;399823;4255;1488;118611;11101;55717;2849;159686;85442;387718;22841;7511;55760;5407;282974;54764;664;4601;282969;2018;56647;119587;101;3167;642938;387715;119548;9679;3632;57700;338567;26098;56165;92565;119559;390010;57698;93426;26033;153;282973;79892;50632;10570;1793;64429;196051;119467;196743;92482;9184;1571;2869;142940;84435;85450;22876;387712;256536;80313;11196;119391;118987;92170;3983;84632;8661;36;118471;340719;55844;374354;5406;6001;3026;8036;840;63877;27287;114815;118672;9531;59338;2263;340706;4892;118856;6934;9937;1892;23172;11023;80007;10579;10539;1847;64376;2674;51703;404636;259217;84504;50624;7073;399814;374355;64077;57678;118472,148
1,-1,10,107109062,107280724,171662,,0
1,-1,10,107109062,107280724,171662,,0
1,-1,10,108460220,108512225,52005,114815,1
1,1,10,109862345,135434178,25571833,196792;253738;1755;143187;2834;8433;10285;79949;399818;5791;10935;9126;340784;55088;4942;54780;7390;594857;143384;118663;143379;503542;150;10844;8038;4288;5408;6571;5654;6975;27250;51363;170394;282996;54777;118670;120;399823;4255;1488;118611;11101;55717;2849;85442;387718;22841;7511;55760;5407;282974;54764;664;4601;282969;2018;56647;119587;101;3167;642938;387715;119548;9679;3632;57700;338567;26098;56165;92565;119559;390010;57698;93426;26033;153;282973;79892;50632;10570;1793;64429;196051;119467;196743;92482;9184;1571;2869;142940;84435;22876;387712;256536;80313;11196;118987;92170;3983;84632;8661;36;118471;340719;55844;374354;5406;6001;3026;8036;840;63877;27287;118672;9531;59338;2263;340706;4892;118856;6934;9937;1892;23172;11023;80007;10579;10539;1847;64376;2674;51703;404636;259217;84504;50624;7073;399814;374355;64077;57678;118472,142
1,1,10,109862345,135434178,25571833,196792;253738;1755;143187;2834;8433;10285;79949;399818;5791;10935;9126;340784;55088;4942;54780;7390;594857;143384;118663;143379;503542;150;10844;8038;4288;5408;6571;5654;6975;27250;51363;170394;282996;54777;118670;120;399823;4255;1488;118611;11101;55717;2849;85442;387718;22841;7511;55760;5407;282974;54764;664;4601;282969;2018;56647;119587;101;3167;642938;387715;119548;9679;3632;57700;338567;26098;56165;92565;119559;390010;57698;93426;26033;153;282973;79892;50632;10570;1793;64429;196051;119467;196743;92482;9184;1571;2869;142940;84435;22876;387712;256536;80313;11196;118987;92170;3983;84632;8661;36;118471;340719;55844;374354;5406;6001;3026;8036;840;63877;27287;118672;9531;59338;2263;340706;4892;118856;6934;9937;1892;23172;11023;80007;10579;10539;1847;64376;2674;51703;404636;259217;84504;50624;7073;399814;374355;64077;57678;118472,142
1,-1,10,110670383,111523045,852662,,0
-1,-1,10,110764724,110873097,108373,,0
1,1,10,111428528,126441219,15012691,196792;1755;26033;143187;2834;153;10285;79949;79892;10935;9126;340784;64429;55088;4942;54780;196051;143384;118663;92482;9184;143379;2869;142940;150;22876;387712;11196;118987;5408;6571;5654;3983;6975;84632;8661;36;27250;51363;282996;340719;118670;374354;5406;120;6001;11101;3026;55717;2849;8036;840;63877;118672;9531;22841;7511;59338;5407;2263;4601;340706;2018;4892;119587;6934;9937;11023;80007;3167;387715;10579;119548;9679;1847;57700;64376;338567;2674;51703;404636;259217;50624;56165;7073;399814;119559;390010;374355;64077;57698;57678,92
-1,1,10,113833852,117032437,3198585,3026;840;57700;26033;143187;153;51703;79949;3983;6975;84632;64429;55088;340706;56165;4892;374354;6934;9937;57678;142940,21
1,1,10,118124844,135474725,17349881,196792;253738;1755;2834;8433;399818;5791;282973;79892;10935;50632;10570;1793;340784;4942;54780;7390;594857;196051;119467;196743;143384;118663;9184;143379;1571;2869;503542;84435;10844;22876;387712;256536;80313;8038;11196;4288;118987;5408;6571;5654;92170;8661;36;51363;170394;118471;340719;54777;55844;118670;5406;6001;399823;4255;1488;118611;11101;55717;2849;63877;85442;387718;27287;118672;9531;22841;55760;5407;282974;59338;54764;2263;664;441581;282969;2018;56647;119587;118856;101;1892;23172;11023;80007;3167;642938;387715;10579;10539;118472;119548;9679;3632;64376;338567;404636;259217;84504;26098;50624;92565;7073;399814;374355;119559;390010;64077;57698;93426,110
1,-1,10,119302796,119306966,4170,2018,1
1,1,10,120089648,120445385,355737,2834;63877;143384,3
1,1,10,120520942,131399550,10878608,11101;196792;55717;2849;1755;387718;118672;9531;399818;59338;2263;79892;10935;54764;55760;1793;5791;340784;4942;54780;196051;7390;56647;594857;119467;118663;119587;9184;118856;2869;23172;80007;3167;642938;387715;10579;9679;22876;64376;8038;11196;404636;4288;5654;26098;8661;36;51363;50624;92565;340719;7073;399814;119559;390010;4255;118670;6001;64077;399823;1488;118611,62
1,1,10,121467368,135427143,13959775,196792;253738;1755;8433;399818;5791;282973;50632;79892;10570;1793;340784;4942;54780;7390;594857;196051;119467;196743;118663;9184;1571;503542;84435;10844;22876;256536;80313;8038;11196;4288;5654;92170;36;118471;51363;170394;54777;55844;118670;4255;399823;1488;118611;11101;55717;2849;85442;387718;27287;118672;55760;282974;59338;2263;54764;664;282969;56647;119587;118856;101;1892;23172;80007;3167;642938;387715;10579;10539;118472;9679;3632;64376;84504;26098;50624;92565;399814;390010;64077;93426,82
-1,1,10,122343861,135427143,13083282,196792;253738;1755;8433;399818;5791;282973;50632;10570;1793;340784;4942;54780;196051;7390;594857;119467;196743;118663;9184;1571;503542;84435;10844;80313;256536;8038;4288;5654;92170;36;118471;51363;170394;54777;55844;118670;4255;399823;1488;118611;11101;55717;2849;85442;387718;27287;118672;55760;282974;59338;2263;54764;664;282969;56647;119587;118856;101;1892;23172;80007;3167;642938;387715;10579;10539;118472;9679;3632;64376;84504;26098;50624;92565;399814;390010;64077;93426,79
-1,1,10,122730071,135436092,12706021,196792;253738;1755;8433;399818;5791;282973;50632;10570;1793;340784;4942;54780;7390;594857;119467;196743;118663;9184;1571;503542;84435;10844;80313;256536;8038;4288;5654;92170;36;118471;51363;170394;54777;55844;118670;4255;399823;1488;118611;11101;2849;85442;387718;27287;118672;55760;282974;59338;2263;54764;664;282969;56647;119587;118856;101;1892;23172;80007;3167;642938;387715;10579;10539;118472;9679;3632;64376;84504;26098;50624;92565;399814;390010;64077;93426,77
-1,1,10,123348506,135434178,12085672,196792;253738;1755;8433;399818;5791;282973;50632;10570;1793;340784;4942;54780;7390;594857;119467;196743;118663;9184;1571;84435;503542;10844;80313;256536;8038;4288;5654;92170;36;118471;51363;170394;55844;54777;118670;4255;399823;1488;118611;11101;2849;85442;387718;27287;118672;59338;2263;55760;282974;54764;664;282969;56647;119587;118856;101;1892;23172;80007;3167;642938;387715;10579;10539;118472;9679;3632;64376;84504;26098;50624;92565;399814;390010;64077;93426,77
-1,1,10,123678062,135434178,11756116,196792;253738;1755;8433;399818;5791;282973;50632;10570;1793;340784;4942;54780;7390;594857;119467;196743;118663;9184;1571;84435;503542;10844;80313;256536;8038;4288;5654;92170;36;118471;51363;170394;55844;54777;118670;4255;399823;1488;118611;11101;2849;85442;387718;27287;118672;59338;55760;282974;54764;664;282969;56647;119587;118856;101;1892;23172;80007;3167;642938;387715;10579;10539;118472;9679;3632;64376;84504;26098;50624;92565;399814;390010;64077;93426,76
-1,1,10,123902691,126046582,2143891,196792;2849;1755;64376;118672;59338;5654;340784;36;51363;50624;399814;118663;119587;9184;118670;80007;3167;387715;10579,20
-1,1,10,124147428,135370736,11223308,196792;253738;1755;8433;399818;5791;282973;50632;10570;1793;340784;4942;7390;594857;119467;196743;9184;1571;84435;503542;10844;80313;256536;8038;4288;5654;92170;36;118471;51363;170394;55844;54777;118670;4255;399823;1488;118611;2849;85442;387718;27287;118672;59338;55760;282974;54764;664;282969;56647;119587;118856;101;1892;23172;80007;3167;642938;387715;10539;118472;9679;3632;64376;84504;26098;50624;92565;399814;390010;64077;93426,72
1,-1,10,124500982,124604479,103497,50624,1
-1,1,10,124640723,135434113,10793390,253738;8433;399818;5791;282973;50632;10570;1793;340784;4942;7390;594857;119467;196743;9184;1571;84435;503542;10844;80313;256536;8038;4288;92170;36;118471;51363;170394;55844;54777;118670;4255;399823;1488;118611;2849;85442;387718;27287;118672;55760;282974;54764;664;282969;56647;119587;118856;101;1892;23172;80007;3167;642938;10539;118472;9679;3632;64376;84504;26098;92565;390010;64077;93426,65
-1,1,10,125335909,135427143,10091234,2849;253738;85442;387718;27287;8433;399818;55760;5791;282973;10570;54764;282974;1793;664;50632;282969;4942;7390;594857;56647;119467;196743;119587;118856;101;1892;23172;1571;642938;84435;503542;10539;10844;9679;80313;256536;3632;8038;4288;93426;92170;84504;26098;118471;51363;170394;92565;4255;55844;390010;54777;64077;399823;1488;118472;118611,57
-1,1,10,125746288,135427143,9680855,253738;85442;387718;27287;8433;399818;55760;5791;282973;10570;54764;282974;1793;664;50632;282969;4942;7390;594857;56647;119467;196743;118856;101;1892;23172;1571;642938;84435;503542;10539;10844;9679;80313;256536;3632;8038;4288;93426;92170;84504;26098;118471;51363;170394;92565;4255;55844;390010;54777;64077;399823;1488;118472;118611,55
1,1,10,125792404,129167091,3374687,9679;387718;8038;399818;55760;54764;26098;1793;1488;51363;4942;7390;92565;56647;118856;390010;64077;23172;642938;118611,20
-1,1,10,126161677,135434113,9272436,253738;85442;387718;27287;8433;399818;55760;5791;282973;10570;54764;282974;1793;664;50632;282969;7390;594857;56647;119467;196743;118856;101;1892;23172;1571;642938;84435;503542;10539;399823;118472;10844;9679;80313;256536;3632;8038;4288;92170;84504;26098;118471;170394;92565;55844;54777;64077;4255;1488;93426;118611,52
-1,1,10,126523427,135436092,8912665,253738;85442;387718;27287;8433;5791;55760;282973;282974;10570;54764;50632;1793;664;282969;7390;594857;56647;119467;196743;118856;101;1892;23172;1571;642938;84435;503542;10539;118472;10844;80313;256536;3632;8038;4288;92170;84504;26098;118471;170394;92565;4255;55844;54777;399823;1488;93426;118611,49
-1,1,10,126710564,135434113,8723549,253738;85442;387718;27287;8433;5791;55760;282973;282974;10570;50632;1793;664;282969;7390;594857;56647;119467;196743;118856;101;1892;1571;642938;84435;503542;10539;118472;10844;80313;256536;3632;8038;4288;92170;84504;26098;118471;170394;92565;4255;55844;54777;399823;1488;93426;118611,47
1,1,10,127141474,135523199,8381725,253738;85442;387718;27287;8433;5791;55760;282973;282974;10570;50632;1793;664;441581;282969;7390;594857;56647;119467;196743;118856;101;1892;1571;399823;642938;84435;10539;503542;10844;80313;256536;3632;8038;4288;93426;92170;84504;26098;118471;170394;92565;55844;54777;4255;118472;118611,47
-1,1,10,127346041,135434178,8088137,253738;85442;387718;27287;8433;5791;55760;282973;282974;10570;50632;1793;664;282969;7390;594857;56647;119467;196743;118856;101;1892;1571;642938;84435;503542;10539;118472;10844;80313;256536;3632;8038;4288;92170;84504;26098;118471;170394;92565;4255;55844;54777;399823;93426;118611,46
-1,1,10,127346041,135434178,8088137,253738;85442;387718;27287;8433;5791;55760;282973;282974;10570;50632;1793;664;282969;7390;594857;56647;119467;196743;118856;101;1892;1571;642938;84435;503542;10539;118472;10844;80313;256536;3632;8038;4288;92170;84504;26098;118471;170394;92565;4255;55844;54777;399823;93426;118611,46
-1,1,10,127658004,135427143,7769139,253738;85442;27287;8433;5791;282974;282973;50632;10570;1793;664;282969;594857;119467;196743;101;1892;1571;642938;84435;503542;10539;118472;10844;80313;256536;3632;8038;4288;92170;84504;118471;170394;92565;4255;55844;54777;399823;93426;118611,40
1,-1,10,127797178,128068419,271241,8038,1
-1,1,10,128419465,135434113,7014648,253738;85442;27287;8433;5791;282974;282973;50632;10570;1793;664;282969;594857;119467;196743;101;1892;1571;399823;642938;84435;10539;503542;10844;80313;256536;3632;4288;93426;92170;84504;118471;170394;55844;54777;4255;118472,37
-1,1,10,128465436,135427143,6961707,253738;85442;27287;8433;5791;282974;282973;50632;10570;1793;664;282969;594857;119467;196743;101;1892;1571;399823;642938;84435;10539;503542;10844;80313;256536;3632;4288;93426;92170;84504;118471;170394;55844;54777;4255;118472,37
-1,1,10,128483215,135427143,6943928,253738;85442;27287;8433;5791;282974;282973;50632;10570;1793;664;282969;594857;119467;196743;101;1892;1571;399823;642938;84435;10539;503542;10844;80313;256536;3632;4288;93426;92170;84504;118471;170394;55844;54777;4255;118472,37
1,-1,10,128636069,128656069,20000,1793,1
1,-1,10,128636069,128656069,20000,1793,1
1,-1,10,128636069,128656069,20000,1793,1
1,-1,10,128636069,128656069,20000,1793,1
1,1,10,129007673,135427143,6419470,253738;85442;27287;8433;5791;282974;282973;50632;10570;1793;664;282969;594857;119467;196743;101;1892;1571;84435;503542;10539;118472;10844;80313;256536;3632;4288;92170;84504;118471;170394;4255;55844;54777;399823;93426,36
-1,1,10,129234249,135436092,6201843,253738;85442;27287;8433;5791;282974;282973;50632;10570;1793;664;282969;594857;119467;196743;101;1892;1571;84435;503542;10539;118472;10844;80313;256536;3632;4288;92170;84504;118471;170394;4255;55844;54777;399823;93426,36
1,-1,10,129536749,129539386,2637,399823,1
-1,1,10,129647981,135436092,5788111,253738;85442;27287;8433;5791;282974;282973;50632;10570;664;282969;119467;196743;101;1892;1571;84435;503542;10539;10844;80313;256536;3632;4288;93426;92170;84504;118471;170394;55844;54777;4255;118472,33
-1,1,10,130348177,135436092,5087915,118472;10844;80313;256536;253738;85442;3632;27287;8433;93426;282973;282974;50632;92170;10570;84504;664;282969;118471;170394;196743;55844;54777;503542;101;1892;1571;4255;84435;10539,30
1,1,10,130670683,135377532,4706849,118472;10844;80313;256536;253738;85442;3632;27287;8433;93426;282973;282974;50632;92170;10570;84504;664;282969;118471;170394;196743;55844;54777;503542;101;1892;1571;4255;84435;10539,30
-1,1,10,131225784,135436092,4210308,118472;10844;80313;256536;253738;85442;3632;27287;8433;93426;282973;282974;50632;92170;10570;84504;664;282969;118471;170394;196743;55844;54777;503542;101;1892;1571;4255;84435;10539,30
-1,1,10,131347522,135434178,4086656,118472;10844;80313;256536;253738;85442;3632;27287;8433;93426;282973;282974;50632;92170;10570;84504;664;282969;118471;170394;196743;55844;54777;503542;101;1892;1571;4255;84435;10539,30
-1,1,10,131458045,135434178,3976133,118472;10844;80313;256536;253738;85442;3632;27287;8433;93426;282973;282974;50632;92170;10570;84504;664;282969;118471;170394;196743;55844;54777;503542;101;1892;1571;4255;84435;10539,30
-1,1,10,132468363,135367666,2899303,118472;10844;80313;256536;3632;85442;27287;8433;93426;282973;282974;50632;92170;10570;84504;664;282969;118471;170394;196743;55844;54777;503542;101;1892;1571;84435,27
1,-1,10,133255624,133728500,472876,,0
1,-1,10,133594027,133637871,43844,,0
-1,1,10,133991979,135434178,1442199,118472;10844;80313;3632;85442;27287;8433;93426;282973;282974;50632;92170;10570;84504;282969;118471;170394;196743;54777;503542;101;1892;1571;84435,24
-1,-1,10,134590030,134599348,9318,3632;84504,2
1,-1,10,134599348,134814579,215231,54777;84504,2
1,-1,10,134704410,134754545,50135,54777,1
1,-1,10,134704410,134795598,91188,54777,1
1,-1,10,134748338,134843094,94756,54777,1
-1,-1,10,134947783,135214016,266233,10844;118471;282969;85442;27287;196743;92170;8433;101;1892;50632;118472,12
1,-1,10,135234763,135404550,169787,93426;1571;503542,3
-1,-1,10,135234787,135372492,137705,93426;1571;503542,3
1,-1,10,135242631,135369831,127200,93426;1571,2
1,-1,10,135242631,135369831,127200,93426;1571,2
1,-1,10,135242631,135377390,134759,93426;1571,2
1,-1,10,135242631,135377390,134759,93426;1571,2
1,-1,10,135242631,135377390,134759,93426;1571,2
1,-1,10,135242631,135377390,134759,93426;1571,2
1,-1,10,135242631,135377390,134759,93426;1571,2
1,-1,10,135242631,135377390,134759,93426;1571,2
1,-1,10,135242631,135377390,134759,93426;1571,2
1,-1,10,135242631,135377390,134759,93426;1571,2
1,-1,10,135242631,135377390,134759,93426;1571,2
1,-1,10,135242631,135377390,134759,93426;1571,2
1,-1,10,135242631,135377390,134759,93426;1571,2
1,-1,10,135242631,135377390,134759,93426;1571,2
1,-1,10,135242631,135377390,134759,93426;1571,2
1,-1,10,135242631,135377390,134759,93426;1571,2
1,-1,10,135242631,135377390,134759,93426;1571,2
1,-1,10,135242631,135377390,134759,93426;1571,2
1,-1,10,135242631,135377390,134759,93426;1571,2
1,-1,10,135242631,135377390,134759,93426;1571,2
1,-1,10,135242631,135377390,134759,93426;1571,2
-1,-1,10,135242631,135377390,134759,93426;1571,2
1,-1,10,135242631,135377390,134759,93426;1571,2
-1,-1,10,135242631,135377390,134759,93426;1571,2
-1,-1,10,135242631,135377390,134759,93426;1571,2
1,-1,10,135242631,135377390,134759,93426;1571,2
1,-1,10,135242631,135377390,134759,93426;1571,2
1,-1,10,135242631,135377390,134759,93426;1571,2
1,-1,10,135242631,135377390,134759,93426;1571,2
1,-1,10,135242631,135377390,134759,93426;1571,2
-1,-1,10,135242631,135377390,134759,93426;1571,2
1,-1,10,135242631,135377390,134759,93426;1571,2
-1,-1,10,135242631,135377390,134759,93426;1571,2
1,-1,10,135242631,135377390,134759,93426;1571,2
1,-1,10,135242631,135377390,134759,93426;1571,2
1,-1,10,135242631,135377390,134759,93426;1571,2
1,-1,10,135242631,135377390,134759,93426;1571,2
1,-1,10,135242631,135377390,134759,93426;1571,2
1,-1,10,135242631,135404550,161919,93426;1571,2
1,-1,10,135242631,135404550,161919,93426;1571,2
1,-1,10,135242631,135404550,161919,93426;1571,2
1,-1,10,135242631,135404550,161919,93426;1571,2
1,-1,10,135242631,135434113,191482,93426;1571,2
1,-1,10,135242631,135434113,191482,93426;1571,2
1,-1,10,135242631,135434113,191482,93426;1571,2
1,-1,10,135242631,135434113,191482,93426;1571,2
1,-1,10,135242631,135434113,191482,93426;1571,2
1,-1,10,135242631,135434113,191482,93426;1571,2
1,-1,10,135242631,135434113,191482,93426;1571,2
1,-1,10,135242631,135434113,191482,93426;1571,2
1,-1,10,135242631,135434113,191482,93426;1571,2
1,-1,10,135243049,135377532,134483,93426;1571,2
1,-1,10,135243049,135377532,134483,93426;1571,2
1,-1,10,135243049,135377532,134483,93426;1571,2
1,-1,10,135243049,135377532,134483,93426;1571,2
1,-1,10,135243049,135377532,134483,93426;1571,2
1,-1,10,135243049,135377532,134483,93426;1571,2
1,-1,10,135245746,135372492,126746,93426;1571,2
-1,-1,10,135245746,135377532,131786,93426;1571,2
1,-1,10,135254039,135367722,113683,93426;1571,2
-1,-1,10,135254039,135377532,123493,93426;1571,2
-1,-1,10,135254039,135377532,123493,93426;1571,2
1,-1,10,135254039,135377532,123493,93426;1571,2
1,-1,10,135254039,135377532,123493,93426;1571,2
1,-1,10,135254039,135377532,123493,93426;1571,2
1,-1,10,135254039,135377532,123493,93426;1571,2
1,-1,10,135254039,135377532,123493,93426;1571,2
-1,-1,10,135254039,135377532,123493,93426;1571,2
1,-1,10,135254039,135377532,123493,93426;1571,2
1,-1,10,135254039,135377532,123493,93426;1571,2
1,-1,10,135254039,135377532,123493,93426;1571,2
1,-1,10,135254039,135377532,123493,93426;1571,2
1,-1,10,135254039,135377532,123493,93426;1571,2
1,-1,10,135254039,135377532,123493,93426;1571,2
1,-1,10,135254039,135377532,123493,93426;1571,2
1,-1,10,135254039,135377532,123493,93426;1571,2
1,-1,10,135254039,135377532,123493,93426;1571,2
-1,-1,10,135254039,135377532,123493,93426;1571,2
1,-1,10,135254039,135377532,123493,93426;1571,2
1,-1,10,135254039,135377532,123493,93426;1571,2
1,-1,10,135254039,135377532,123493,93426;1571,2
1,-1,10,135254039,135377532,123493,93426;1571,2
1,-1,10,135254039,135377532,123493,93426;1571,2
1,-1,10,135254039,135377532,123493,93426;1571,2
1,-1,10,135254039,135377532,123493,93426;1571,2
-1,-1,10,135254039,135377532,123493,93426;1571,2
1,-1,10,135254039,135377532,123493,93426;1571,2
-1,-1,10,135254039,135377532,123493,93426;1571,2
1,-1,10,135254039,135377532,123493,93426;1571,2
1,-1,10,135254039,135377532,123493,93426;1571,2
-1,-1,10,135254039,135377532,123493,93426;1571,2
1,-1,10,135254039,135377532,123493,93426;1571,2
-1,-1,10,135254039,135377532,123493,93426;1571,2
1,-1,10,135254039,135377532,123493,93426;1571,2
-1,-1,10,135254039,135377532,123493,93426;1571,2
1,-1,10,135254039,135377532,123493,93426;1571,2
1,-1,10,135254039,135377532,123493,93426;1571,2
-1,-1,10,135254039,135377532,123493,93426;1571,2
-1,-1,10,135254039,135377532,123493,93426;1571,2
-1,-1,10,135254039,135377532,123493,93426;1571,2
1,-1,10,135254039,135377532,123493,93426;1571,2
-1,-1,10,135254039,135377532,123493,93426;1571,2
1,-1,10,135254039,135377532,123493,93426;1571,2
1,-1,10,135254039,135377532,123493,93426;1571,2
1,-1,10,135254039,135377532,123493,93426;1571,2
-1,-1,10,135254039,135377532,123493,93426;1571,2
1,-1,10,135254039,135377532,123493,93426;1571,2
1,-1,10,135254039,135377532,123493,93426;1571,2
1,-1,10,135254039,135377532,123493,93426;1571,2
1,-1,10,135254039,135377532,123493,93426;1571,2
1,-1,10,135254039,135377532,123493,93426;1571,2
1,-1,10,135254039,135377532,123493,93426;1571,2
1,-1,10,135254039,135377532,123493,93426;1571,2
1,-1,10,135254039,135377532,123493,93426;1571,2
-1,-1,10,135254039,135377532,123493,93426;1571,2
1,-1,10,135254039,135377532,123493,93426;1571,2
1,-1,10,135254039,135377532,123493,93426;1571,2
-1,-1,10,135254039,135377532,123493,93426;1571,2
1,-1,10,135254039,135377532,123493,93426;1571,2
1,-1,10,135254039,135377532,123493,93426;1571,2
1,-1,10,135254039,135377532,123493,93426;1571,2
-1,-1,10,135254039,135377532,123493,93426;1571,2
1,-1,10,135254039,135377532,123493,93426;1571,2
1,-1,10,135254039,135377532,123493,93426;1571,2
1,-1,10,135254039,135377532,123493,93426;1571,2
1,-1,10,135254039,135377532,123493,93426;1571,2
1,-1,10,135254039,135377532,123493,93426;1571,2
-1,-1,10,135254039,135377532,123493,93426;1571,2
1,-1,10,135254039,135377532,123493,93426;1571,2
-1,-1,10,135254039,135377532,123493,93426;1571,2
1,-1,10,135254039,135377532,123493,93426;1571,2
1,-1,10,135254039,135404523,150484,93426;1571,2
1,-1,10,135254039,135404523,150484,93426;1571,2
1,-1,10,135254039,135434178,180139,93426;1571,2
1,-1,10,135254039,135434178,180139,93426;1571,2
1,-1,10,135254039,135434178,180139,93426;1571,2
1,-1,10,135254039,135434178,180139,93426;1571,2
-1,-1,10,135254053,135377390,123337,93426;1571,2
1,-1,10,135254053,135434113,180060,93426;1571,2
1,-1,10,135254067,135372463,118396,93426;1571,2
-1,-1,10,135258619,135349723,91104,1571,1
1,-1,10,135258676,135377502,118826,93426;1571,2
1,-1,10,135267356,135352746,85390,1571,1
-1,-1,10,135270265,135377390,107125,93426;1571,2
1,-1,10,135270265,135377390,107125,93426;1571,2
1,-1,10,135270265,135377390,107125,93426;1571,2
1,-1,10,135270265,135377390,107125,93426;1571,2
1,-1,10,135270265,135377390,107125,93426;1571,2
1,-1,10,135270265,135377390,107125,93426;1571,2
1,-1,10,135270265,135377390,107125,93426;1571,2
1,-1,10,135274904,135369831,94927,93426;1571,2
-1,-1,10,135274904,135377390,102486,93426;1571,2
-1,-1,10,135274904,135377390,102486,93426;1571,2
-1,-1,10,135274904,135377390,102486,93426;1571,2
1,-1,10,135274904,135377390,102486,93426;1571,2
1,-1,10,135274904,135377390,102486,93426;1571,2
1,-1,10,135274904,135377390,102486,93426;1571,2
1,-1,10,135274904,135377390,102486,93426;1571,2
1,-1,10,135274904,135377390,102486,93426;1571,2
1,-1,10,135274904,135377390,102486,93426;1571,2
1,-1,10,135274904,135377390,102486,93426;1571,2
1,-1,10,135274904,135377390,102486,93426;1571,2
1,-1,10,135274904,135377390,102486,93426;1571,2
1,-1,10,135274904,135377390,102486,93426;1571,2
1,-1,10,135274904,135377390,102486,93426;1571,2
1,-1,10,135274904,135377390,102486,93426;1571,2
1,-1,10,135274904,135377390,102486,93426;1571,2
1,-1,10,135274904,135434113,159209,93426;1571,2
1,-1,10,135279267,135369835,90568,93426;1571,2
1,-1,10,135279267,135372492,93225,93426;1571,2
1,-1,10,135279267,135372492,93225,93426;1571,2
1,-1,10,135279267,135377532,98265,93426;1571,2
1,-1,10,135281699,135369831,88132,93426;1571,2
1,-1,10,135281699,135377390,95691,93426;1571,2
1,-1,10,135281699,135377390,95691,93426;1571,2
1,-1,10,135281699,135377390,95691,93426;1571,2
1,-1,10,135281699,135377390,95691,93426;1571,2
1,-1,10,135281699,135377390,95691,93426;1571,2
1,-1,10,135281699,135377390,95691,93426;1571,2
1,-1,10,135295139,135372521,77382,93426;1571,2
1,-1,10,135295747,135377390,81643,93426;1571,2
1,-1,10,135295747,135434113,138366,93426;1571,2
1,-1,10,135316810,135434178,117368,93426;1571,2
1,-1,10,135316810,135434178,117368,93426;1571,2
1,-1,10,135316867,135332584,15717,,0
-1,-1,10,135323834,135345854,22020,1571,1
1,-1,10,135338156,135354334,16178,1571,1
1,-1,10,135342180,135434113,91933,93426;1571,2
1,-1,10,135349664,135434113,84449,93426;1571,2
1,-1,10,135352362,135369831,17469,93426;1571,2
1,-1,10,135352362,135434113,81751,93426;1571,2
1,-1,10,135352362,135434113,81751,93426;1571,2
1,-1,10,135352362,135434113,81751,93426;1571,2
1,-1,10,135352362,135434113,81751,93426;1571,2
1,-1,10,135352362,135434113,81751,93426;1571,2
1,-1,10,135352362,135434113,81751,93426;1571,2
1,-1,10,135352362,135434113,81751,93426;1571,2
1,-1,10,135352362,135434113,81751,93426;1571,2
1,-1,10,135352362,135434113,81751,93426;1571,2
1,-1,10,135352362,135434113,81751,93426;1571,2
1,-1,10,135352362,135434113,81751,93426;1571,2
1,-1,10,135352362,135434113,81751,93426;1571,2
1,-1,10,135352362,135434113,81751,93426;1571,2
1,-1,10,135352362,135434113,81751,93426;1571,2
1,-1,10,135352362,135434113,81751,93426;1571,2
1,-1,10,135352362,135434113,81751,93426;1571,2
1,-1,10,135352362,135434113,81751,93426;1571,2
1,-1,10,135352362,135434113,81751,93426;1571,2
1,-1,10,135352362,135434113,81751,93426;1571,2
1,-1,10,135352362,135434113,81751,93426;1571,2
1,-1,10,135352362,135434113,81751,93426;1571,2
1,-1,10,135352362,135434113,81751,93426;1571,2
1,-1,10,135352362,135434113,81751,93426;1571,2
1,-1,10,135352362,135434113,81751,93426;1571,2
1,-1,10,135352362,135434113,81751,93426;1571,2
1,-1,10,135352362,135434113,81751,93426;1571,2
1,-1,10,135352362,135434113,81751,93426;1571,2
1,-1,10,135352362,135434113,81751,93426;1571,2
1,-1,10,135352362,135434113,81751,93426;1571,2
1,-1,10,135352362,135434113,81751,93426;1571,2
1,-1,10,135352362,135434113,81751,93426;1571,2
1,-1,10,135352362,135434113,81751,93426;1571,2
1,-1,10,135352362,135434113,81751,93426;1571,2
1,-1,10,135352362,135434113,81751,93426;1571,2
1,-1,10,135352362,135434113,81751,93426;1571,2
1,-1,10,135352362,135434113,81751,93426;1571,2
1,-1,10,135352362,135434113,81751,93426;1571,2
1,-1,10,135352362,135434113,81751,93426;1571,2
1,-1,10,135352362,135434113,81751,93426;1571,2
1,-1,10,135352362,135434113,81751,93426;1571,2
1,-1,10,135352372,135372492,20120,93426;1571,2
1,-1,10,135352372,135372492,20120,93426;1571,2
-1,-1,10,135352372,135377532,25160,93426;1571,2
-1,-1,10,135352372,135377532,25160,93426;1571,2
-1,-1,10,135352372,135377532,25160,93426;1571,2
-1,-1,10,135352372,135377532,25160,93426;1571,2
-1,-1,10,135352372,135377532,25160,93426;1571,2
-1,-1,10,135352372,135377532,25160,93426;1571,2
-1,-1,10,135352372,135377532,25160,93426;1571,2
-1,-1,10,135352372,135377532,25160,93426;1571,2
1,-1,10,135352372,135404523,52151,93426;1571,2
1,-1,10,135352372,135434178,81806,93426;1571,2
1,-1,10,135352372,135434178,81806,93426;1571,2
1,-1,10,135352372,135434178,81806,93426;1571,2
1,-1,10,135352372,135434178,81806,93426;1571,2
1,-1,10,135352372,135434178,81806,93426;1571,2
1,-1,10,135352372,135434178,81806,93426;1571,2
1,-1,10,135352372,135434178,81806,93426;1571,2
1,-1,10,135352372,135434178,81806,93426;1571,2
1,-1,10,135352372,135434178,81806,93426;1571,2
1,-1,10,135352372,135434178,81806,93426;1571,2
1,-1,10,135352372,135434178,81806,93426;1571,2
1,-1,10,135352372,135434178,81806,93426;1571,2
1,-1,10,135352372,135434178,81806,93426;1571,2
1,-1,10,135352372,135434178,81806,93426;1571,2
1,-1,10,135352372,135434178,81806,93426;1571,2
1,-1,10,135352372,135434178,81806,93426;1571,2
1,-1,10,135352372,135434178,81806,93426;1571,2
1,-1,10,135352372,135434178,81806,93426;1571,2
1,-1,10,135352372,135434178,81806,93426;1571,2
1,-1,10,135352372,135434178,81806,93426;1571,2
1,-1,10,135352372,135434178,81806,93426;1571,2
1,-1,10,135352372,135434178,81806,93426;1571,2
1,-1,10,135352372,135434178,81806,93426;1571,2
1,-1,10,135352372,135434178,81806,93426;1571,2
1,-1,10,135352372,135434178,81806,93426;1571,2
1,-1,10,135354275,135369831,15556,93426,1
1,-1,10,135354275,135434113,79838,93426,1
1,-1,10,135391263,135411383,20120,,0
1,-1,10,135391263,135443414,52151,441581,1
1,-1,10,135391263,135443414,52151,441581,1
1,-1,11,61793,116316,54523,,0
1,1,11,61793,10749516,10687723,26515;7748;11187;4583;341277;5719;272;120775;4676;256892;23258;390038;114879;10527;3265;143630;8642;65975;338322;5441;5002;23538;56676;390093;4046;5003;10612;340980;120065;6050;4586;322;54472;7140;51272;390058;160298;1850;23647;119678;57053;120793;119682;171389;1509;90019;56673;8519;7275;390066;401667;79608;401665;387733;338707;119679;3630;112464;6343;53840;9866;4588;390064;390036;282763;445372;51700;119772;341276;10581;3665;390084;6881;440026;53841;101927503;347862;60626;143501;79345;119692;3046;390054;1200;283298;10410;390075;10077;8045;390078;10894;81532;417;81846;79751;119774;4004;283232;10078;977;23378;120066;23075;386746;119694;3043;3611;387748;161;1815;79473;143496;29850;119695;8590;56675;56547;7054;283229;390063;144125;50862;10335;84067;430;23410;6609;26496;66005;101927423;147199;439915;120787;50613;6157;390037;120796;133;7136;283297;100463486;8495;55367;283111;117854;56674;6786;723961;887;144124;833;103344718;3784;402778;390081;8665;6737;143502;391;3047;1262;27288;59307;440023;440021;390067;338440;6888;6150;390079;390083;63875;387266;29125;9024;81285;51286;119687;6764;390072;387264;10346;196335;55128;85363;144132;401666;7465;113746;27315;3263;115399;6181;116534;7106;3048;3045;255725;338323;56672;4928;7262;64787;390059;7702;57661;3481;1028;81282;79339;10522;120776;390077;975;727897;80162;79324;390061;143425;57758;81490;7761;7762;6240;116969;338751;57104;338755;256329;143503,230
1,1,11,138203,5484157,5345954,7748;11187;4583;5719;4676;256892;390038;114879;3265;5441;5002;23538;4046;5003;6050;4586;54472;7140;51272;390058;1850;119678;57053;119682;171389;1509;90019;8519;401667;401665;387733;338707;119679;3630;6343;4588;390064;390036;282763;119772;10581;3665;53841;101927503;347862;60626;143501;79345;119692;3046;390054;10410;10077;8045;81532;417;79751;119774;283232;10078;977;386746;119694;3043;161;1815;143496;29850;119695;56547;7054;283229;390063;430;23410;66005;101927423;147199;439915;390037;7136;55367;283111;6786;723961;833;103344718;3784;402778;6737;143502;391;3047;59307;440023;440021;338440;6888;6150;387266;29125;9024;81285;51286;119687;387264;55128;401666;113746;27315;115399;6181;116534;7106;3048;3045;4928;7262;64787;390059;57661;3481;1028;81282;79339;10522;975;727897;80162;79324;390061;81490;6240;116969;57104;256329;143503,137
1,1,11,193187,5291338,5098151,11187;4583;5719;4676;256892;390038;114879;3265;5441;5002;23538;4046;5003;6050;4586;54472;7140;51272;1850;119678;57053;119682;171389;1509;90019;8519;401667;401665;387733;338707;119679;3630;6343;4588;390036;119772;10581;3665;53841;101927503;347862;60626;143501;119692;3046;390054;10410;10077;8045;81532;417;256329;79751;119774;283232;10078;977;386746;119694;3043;161;1815;143496;29850;119695;56547;7054;283229;430;23410;66005;101927423;147199;439915;390037;7136;55367;283111;6786;723961;833;103344718;3784;402778;6737;143502;391;3047;59307;440023;440021;338440;6888;6150;387266;29125;9024;81285;51286;119687;387264;55128;401666;113746;27315;115399;6181;116534;7106;3048;3045;57104;4928;7262;64787;57661;3481;1028;10522;975;727897;80162;79324;81490;6240;116969;81282;7748;143503,129
1,1,11,196855,2137415,1940560,11187;283229;4583;5719;23410;66005;101927423;439915;3265;5441;7136;4046;6050;4586;55367;54472;7140;51272;1850;103344718;402778;171389;59307;1509;440021;440023;338440;6888;8519;6150;90019;387266;9024;51286;387733;387264;338707;6343;4588;113746;115399;10581;3665;6181;7106;53841;101927503;347862;60626;10410;64787;57661;8045;81532;10522;79751;727897;283232;80162;977;81490;161;1815;57104;256329,65
1,1,11,196855,5343104,5146249,11187;4583;5719;4676;256892;390038;114879;3265;5441;5002;23538;4046;5003;6050;4586;54472;7140;51272;1850;119678;57053;119682;171389;1509;90019;8519;401667;401665;387733;338707;119679;3630;6343;4588;390036;119772;10581;3665;53841;101927503;347862;60626;143501;119692;3046;390054;10410;10077;8045;81532;417;256329;79751;119774;283232;10078;977;386746;119694;3043;161;1815;143496;29850;119695;56547;7054;283229;430;23410;66005;101927423;439915;390037;7136;55367;283111;6786;723961;833;103344718;3784;402778;6737;143502;391;3047;59307;440023;440021;338440;6888;6150;387266;29125;9024;81285;51286;119687;387264;55128;401666;113746;27315;115399;6181;116534;7106;3048;3045;57104;4928;7262;64787;57661;3481;1028;79339;10522;975;727897;80162;79324;81490;6240;116969;81282;7748;143503,129
1,-1,11,196966,244236,47270,60626;113746;23410;51272;5719,5
1,-1,11,196966,244236,47270,60626;113746;23410;51272;5719,5
1,-1,11,200222,237805,37583,60626;113746;23410;51272;5719,5
1,1,11,230615,6644927,6414312,26515;11187;4583;5719;4676;256892;390038;114879;3265;143630;8642;5441;5002;23538;4046;5003;10612;340980;6050;4586;322;54472;7140;390058;160298;1850;23647;119678;57053;120793;119682;171389;1509;90019;8519;390066;401667;401665;387733;338707;119679;3630;112464;6343;53840;4588;390064;390036;282763;445372;119772;10581;3665;390084;6881;53841;101927503;347862;143501;79345;119692;3046;390054;1200;10410;390075;10077;8045;390078;81532;417;256329;79751;119774;283232;10078;977;23378;386746;119694;3043;3611;387748;161;1815;79473;143496;29850;119695;56547;7054;283229;390063;84067;430;23410;6609;66005;101927423;439915;120787;50613;390037;120796;7136;55367;283111;117854;6786;723961;887;833;103344718;3784;402778;390081;6737;143502;391;3047;1262;59307;440023;440021;390067;338440;6888;6150;390079;390083;387266;29125;9024;81285;51286;119687;390072;387264;10346;196335;55128;85363;144132;401666;27315;3263;115399;6181;116534;7106;3048;3045;255725;57104;4928;7262;64787;390059;57661;3481;1028;79339;10522;390077;975;727897;80162;79324;390061;81490;6240;116969;338751;81282;7748;143503,176
1,1,11,230615,25584362,25353747,11187;5719;272;4676;23258;117195;114879;3265;23538;390093;340990;4046;10612;120065;6050;4586;160287;54472;1315;1850;119678;4654;57053;120793;5140;171389;1509;102724957;390066;401667;79608;401665;84953;387733;338707;55031;119679;3630;3767;55742;6343;9866;4588;6288;282763;51700;119772;9645;10581;100500938;6881;440026;53841;101927503;406;390054;390075;120237;10077;8045;390078;10894;81532;81846;79751;387755;283232;23378;120066;23075;144100;119694;79473;143496;5741;8590;6289;7054;84067;430;23410;10196;6157;390037;120796;7251;283297;56674;6786;723961;887;10083;4745;103344718;390081;402778;6737;143502;1262;59307;390067;338440;6888;390079;387266;29125;259249;119687;81285;390072;387264;10346;55128;85363;374378;9646;401666;7465;6207;115399;117194;116534;7106;3045;255725;4928;64787;57084;10944;1028;203859;79339;120776;390077;283106;727897;11234;80162;143425;81490;7762;374383;6240;116969;81282;117196;338755;256329;26515;10553;4583;341277;3746;120775;256892;390038;10527;143630;8642;65975;338322;84867;5441;5002;56676;79733;5003;340980;84280;322;7140;390058;160298;23647;6833;144108;22800;119682;89797;90019;56673;26297;113174;8519;7275;100528017;796;112464;54503;6291;53840;3939;390064;4925;390036;445372;341276;3665;390084;2620;347862;143501;79345;119692;3046;1200;283298;10410;2188;417;8048;119774;4004;977;10078;386746;3043;3611;387748;161;1815;29850;119695;56675;258010;55293;56547;283229;390063;144125;50862;10335;5682;6609;26496;797;66005;101927423;439915;120787;50613;133;7136;100463486;8495;55367;283111;117854;338645;144124;833;120227;3784;8665;391;3047;3948;27288;440023;440021;2965;6150;63875;390083;9024;7003;51286;5286;7166;27122;6764;196335;144132;283284;27315;3263;644943;84188;6181;55553;3048;338323;9152;56672;144110;1982;7262;390059;7702;58486;57661;3481;10522;10418;975;79324;390061;57758;7761;338751;57104;7748;143503,303
1,1,11,230615,31995219,31764604,11187;5719;272;4676;23258;117195;114879;3265;23538;390093;340990;4046;10612;744;120065;6050;4586;160287;54472;1315;1850;63982;119678;4654;57053;120793;5140;171389;1509;102724957;390066;401667;79608;401665;84953;338707;387733;55031;119679;3630;3767;55742;6343;9866;4588;5080;6288;282763;100500938;51700;9645;119772;10581;6881;440026;101927503;53841;406;390054;390075;120237;10077;8045;390078;10894;81532;81846;79751;387755;283232;23378;120066;23075;144100;119694;5741;143496;79473;8424;8590;6289;7054;84067;430;23410;10196;6157;390037;3739;120796;7251;283297;56674;6786;723961;10083;887;4745;196294;103344718;390081;402778;6737;143502;1262;55327;59307;390067;338440;6888;390079;387266;29125;259249;119687;81285;390072;387264;10346;55128;85363;374378;9646;401666;7465;6207;627;115399;117194;116534;7106;2488;3045;255725;4928;64787;57084;10944;1028;203859;79339;120776;390077;283106;727897;11234;80162;143425;81490;7762;374383;6240;116969;81282;117196;338755;256329;26515;10553;159963;4583;341277;3746;120775;143662;256892;91057;390038;10527;143630;8642;65975;338322;84867;5441;79733;5002;56676;5003;340980;84280;322;7140;390058;160298;23647;144108;6833;22800;81930;119682;89797;90019;56673;26297;113174;8519;7275;100528017;796;120526;112464;54503;6291;53840;3939;4925;196074;390064;390036;445372;341276;3665;390084;2620;347862;143501;79345;119692;3046;1200;283298;10410;2188;417;8048;119774;4004;26610;977;10078;55366;386746;3043;3611;387748;161;1815;29850;119695;56675;258010;55293;56547;341019;283229;390063;50862;5682;144125;10335;6609;26496;797;120534;66005;101927423;439915;120787;50613;133;7136;100463486;8495;55367;283111;117854;338645;144124;833;120227;8665;3784;391;3047;3948;27288;440023;440021;2965;6150;63875;390083;9024;7003;5286;7166;51286;27122;6764;196335;144132;283284;27315;3263;644943;84188;6181;55553;3048;338323;9152;56672;144110;1982;7262;390059;58486;7702;57661;3481;10522;10418;975;387758;79324;390061;57758;7761;338751;57104;7748;143503,323
1,1,11,230615,37698540,37467925,79832;11187;5719;272;4676;7189;23258;4076;117195;114879;847;3265;23538;390093;340990;4046;10612;744;120065;6050;4586;960;160287;7490;54472;1315;1850;63982;119678;4654;57053;120793;5140;171389;1509;102724957;390066;10114;401667;79608;401665;84953;338707;387733;55031;119679;3630;3767;55742;6343;966;9866;4588;5080;6288;51074;282763;100500938;51700;9645;119772;10581;6881;440026;55226;101927503;25841;53841;29099;55346;406;390054;390075;120237;10077;8045;390078;10894;81532;79899;81846;79751;387755;283232;23378;120066;23075;144100;119694;100131378;5741;143496;79473;8424;8590;6289;7054;84067;430;23410;25758;10196;6157;390037;3739;120796;7251;283297;56674;6786;723961;10083;887;4745;196294;103344718;390081;402778;8050;6737;143502;1262;55327;59307;390067;338440;6888;390079;5897;387266;29125;259249;119687;81285;390072;387264;10346;2001;55128;85363;374378;9646;401666;7465;6207;4005;627;115399;117194;116534;7106;1479;2488;3045;255725;4928;64787;57084;10944;1028;143458;203859;79339;120776;390077;283106;727897;11234;80162;143425;81490;7762;374383;6240;116969;81282;117196;338755;256329;26515;10553;159963;4583;341277;3746;5896;120775;143662;256892;91057;390038;10527;143630;8642;65975;338322;84867;5441;79733;5002;56676;5003;340980;84280;322;7140;390058;160298;23647;144108;6833;22800;81930;119682;89797;90019;56673;26297;113174;8519;7275;100528017;796;120526;10480;112464;54503;6291;53840;3939;4925;196074;390064;390036;445372;341276;119710;3665;390084;25891;2620;347862;143501;79345;119692;493860;3046;1200;283298;10410;2188;417;8048;119774;4004;26610;26298;79056;977;10078;55366;386746;3043;3611;387748;161;1815;29850;119695;56675;258010;55293;56547;341019;283229;390063;50862;5682;144125;10335;6609;26496;797;120534;66005;101927423;439915;120787;50613;133;6506;7136;100463486;8495;55367;283111;117854;338645;144124;833;120227;26273;8665;3784;391;3047;3948;27288;440023;440021;2965;6150;63875;390083;9024;7003;5286;7166;51286;27122;6764;196335;144132;283284;27315;3263;644943;84188;6181;55553;91614;3048;338323;5954;9152;56672;24147;144110;1982;7262;390059;58486;7702;57661;3481;10522;10418;975;387758;79324;390061;57758;7761;54765;338751;57104;7748;143503,358
1,1,11,230616,134938470,134707854,83759;23201;11187;5091;63970;5719;272;83707;220042;5331;28971;27314;79842;10629;25921;100526737;219875;9702;23538;440050;2526;4586;7490;54472;1315;4975;219479;80168;51773;256148;25858;219968;57830;401667;390265;401665;10888;5436;119679;6343;387601;22897;966;219482;65084;6288;282763;54663;102288414;5970;26580;6881;2286;101927503;25841;23682;390181;11181;390075;91893;84957;219954;8045;84959;387755;283232;338662;144100;23075;81300;5920;4038;143496;100130348;741;3846;26005;6289;54851;221120;430;4722;89944;2915;25758;2542;390037;3739;256472;85016;9638;54949;10083;5222;641654;3338;50507;402778;50863;8050;55327;51585;55800;80227;6888;255239;2197;283162;119687;10432;25906;80150;10346;144097;390154;1474;401666;2785;6207;4297;92292;79827;2694;81570;283092;1479;5837;80829;390113;91252;6520;2101;10205;57084;220074;219960;79339;143686;120776;727897;25923;81490;7762;89;6712;113130;9177;4135;2249;26515;60494;159963;643037;3746;503497;10632;79829;2950;5241;399888;9246;219595;390168;10003;246330;403312;8642;114902;83552;5883;338322;84867;116085;79733;10809;5003;4162;7140;390058;160298;8882;144108;90019;26297;9965;8519;220004;728588;219844;796;120526;7356;120146;6749;9409;390243;196074;9415;4314;119710;55867;23387;2620;120071;219469;5017;51399;79345;79796;3046;254439;2350;1200;170689;10410;387778;254359;8986;747;4004;219487;26298;335;977;23310;386746;8301;2230;80198;6494;120425;64232;55293;6609;56158;101927423;256364;390174;120787;390245;89792;219870;9158;100129216;100532726;6506;253935;7352;8495;4837;56649;114609;144124;26273;26007;8665;55231;84881;3047;3948;440021;10524;81309;80194;7166;337;219938;283284;144132;5007;27339;4013;84188;9066;9873;338323;402;56672;25988;7299;24147;84364;1982;58486;23621;572;9846;10418;25855;221092;975;26229;79841;79324;3703;283093;85456;283208;51503;1798;57804;56912;29068;7748;5790;53826;2017;81544;28970;1410;4676;4076;117195;114879;871;338657;390093;338699;10612;9440;338692;116519;63982;403253;57053;8726;84000;1128;59082;63876;120586;283212;390271;390199;390152;254187;84953;91703;387733;3630;254122;55742;23649;3508;1717;51700;119772;10581;283254;84897;2346;4723;390157;9600;4647;390110;26521;57010;29099;219965;3177;55346;219473;220032;10897;143888;51083;5138;55291;120237;23235;401;10894;9313;219432;387273;84259;79026;100131378;9219;219855;79473;84866;8424;64066;65998;60492;84767;283116;26579;84623;58487;219873;10263;8061;5547;2495;143872;114571;10196;1408;64837;6157;120796;10413;921;1072;387775;9610;6786;723961;80310;30008;6737;5871;79053;390067;220382;219833;120406;387266;259249;53;119765;7069;387264;6688;55216;85363;100506127;399948;120114;219464;38;84441;143903;114769;57586;837;219436;79073;57175;219537;254225;11145;54970;3762;80162;91894;283248;219429;23625;10658;374383;2977;80071;338755;219527;219477;120775;143662;91057;10978;283171;64231;10527;55572;56676;143689;220047;283189;56;340980;322;219431;3619;745;390190;23647;4192;10072;6833;5936;823;282775;1937;100528017;390259;23360;9854;6188;64852;112464;54503;219988;8539;8815;23705;6309;3939;390064;51317;334;390036;374403;60529;25891;399968;5702;5499;143501;114971;84437;65987;399979;2188;417;26610;79056;10179;10435;58475;10078;1500;254102;79869;3611;387748;161;642612;29850;119695;440044;283219;220323;1270;341019;26496;100507050;66005;439915;11309;642623;1662;219983;23052;100463486;117854;283237;143678;345;3784;27288;4322;440023;29984;219952;390083;582;81876;27122;54494;196335;4718;4250;867;22941;51075;347853;29087;23529;51296;2147;5795;83638;219869;3263;8772;414899;10963;55553;8065;283159;3048;5954;374393;85459;57689;7262;7702;79731;283149;10522;9183;57758;751071;3992;7761;6392;3145;54765;1075;390151;100287896;143503;390197;143941;79832;55709;54733;9986;196264;3636;53340;9743;7189;23258;9354;57571;3265;54972;5450;440068;6050;349633;960;595;3995;79684;4654;120793;219986;79101;84285;219484;23769;257160;55761;219858;100169851;64221;2206;441608;23365;85463;338707;9159;120224;9866;4588;5080;472;143570;486;100500938;9645;390212;440026;79780;4321;55226;282679;6876;10004;256144;390195;915;6484;390054;5977;85458;399949;1740;10077;54766;390078;81532;79751;79097;64137;1643;2615;120066;6811;5741;7351;7108;10825;24145;60496;219972;8501;7225;9376;4926;55298;283297;726;55531;51144;282770;55199;22997;143684;91801;7704;103344718;710;84447;27034;1737;90952;338440;8525;63901;57562;917;440051;55128;390275;54827;5526;84304;2237;79080;116071;4005;81341;28992;120379;57093;117194;115399;119749;8567;116337;283238;746;4928;50801;646754;10714;64787;10944;116985;2893;4054;414301;143458;203859;219447;10992;220001;4296;79671;9099;283106;51259;79102;84680;120376;80789;341116;51524;25833;116969;219539;117245;83875;117196;26338;5031;26011;79081;55690;256892;254263;26519;23650;390038;219453;143630;65975;283234;5441;740;170589;83706;55191;114900;54979;22917;9049;81930;56673;7275;4319;81318;2248;9537;219428;55107;50937;916;1119;1111;10480;79703;341208;219493;6291;10312;53840;2348;4925;7405;387787;445372;54948;3665;390084;143884;4041;55626;219927;219437;8538;9538;10798;7423;90139;219970;81327;6327;120400;3043;56935;3732;338675;10648;1815;57410;56675;932;56547;390063;50862;5682;283229;390144;5519;51501;3359;50613;81622;133;399967;923;26973;91683;9828;7536;834;283111;5553;51475;6330;338645;8722;833;120227;6094;80975;112936;9789;341152;79797;391;374407;23130;6150;2965;10525;55004;4900;7003;5286;23279;102724265;154810;6764;219982;330;27315;644943;2352;89849;838;79064;4607;738;390059;5029;54538;57661;7439;187;3312;55611;219995;10235;390264;6734;10313;399909;54961;390061;643;120103;6947;220064;338751;57104;160065;3606;6230;4246;219541;7070;219981;55048;847;9973;56946;6768;5870;340990;4046;55823;744;120065;399939;221091;387763;81328;160287;5866;23788;390148;1351;3014;1850;10482;5058;119678;5140;338674;390231;4316;171389;1509;102724957;404552;390066;10114;283160;79608;790955;55031;219957;79864;374395;3767;220002;51642;642446;57646;387804;51074;23584;9479;245802;9379;372;53841;329;4312;644672;26492;9092;406;23086;29118;79899;81846;408;4978;23378;119694;7481;143879;390167;4728;254552;56981;1642;51035;338661;8590;219417;5913;643847;7054;2900;84067;23410;3316;57569;84689;280636;78999;51400;3587;7251;10873;4684;79096;55343;29763;219990;29901;56674;887;4745;6809;196294;390081;8500;219956;6653;10534;390191;143502;1262;59307;390079;349667;5897;57558;29125;219899;26472;11041;81285;56834;5049;390072;221;2001;10394;84153;53942;219854;374378;9776;9646;10647;7465;22992;23193;2313;83661;627;1521;65003;116534;7106;2488;3045;390142;255725;4544;10938;29015;27087;1656;1813;51287;1028;643834;114908;220359;55331;390077;117144;219902;156;54843;51092;11234;91056;143425;11095;6240;81282;256329;8322;10553;266743;4583;5896;341277;9356;26595;7007;5818;341032;245911;5002;119764;83786;85329;84280;390261;23187;79659;26493;5612;54734;83480;2132;22800;192134;119682;4361;89797;113174;25987;220388;11007;220296;6199;28960;219931;116512;81168;51111;10062;283130;84649;4863;931;399947;341276;1132;51504;8898;219865;11251;57453;347862;55863;119692;55693;493860;84233;283298;283129;54860;160140;5805;159989;23220;8048;119774;100131539;55366;4221;112937;283209;29907;283152;10249;116535;1374;390205;84811;390155;258010;729384;10089;219874;144125;10335;222;53838;283150;120534;797;25824;56253;57124;79849;58473;56980;10008;9633;83700;7136;79607;3758;100533181;4317;55367;2011;390201;5962;8534;10929;63875;64776;11098;9024;392;51286;90993;9404;92105;7379;8690;55561;7753;25884;219958;57476;5024;219959;390260;6181;91614;54414;6588;10589;4798;1207;9152;51338;25996;144110;390162;3481;9793;387758;2113;7542;643376;10068;219438,1258
1,1,11,230616,134938470,134707854,83759;23201;11187;5091;63970;5719;272;83707;220042;5331;28971;27314;79842;10629;25921;100526737;219875;9702;23538;440050;2526;4586;7490;54472;1315;4975;219479;80168;51773;256148;25858;219968;57830;401667;390265;401665;10888;5436;119679;6343;387601;22897;966;219482;65084;6288;282763;54663;102288414;5970;26580;6881;2286;101927503;25841;23682;390181;11181;390075;91893;84957;219954;8045;84959;387755;283232;338662;144100;23075;81300;5920;4038;143496;100130348;741;3846;26005;6289;54851;221120;430;4722;89944;2915;25758;2542;390037;3739;256472;85016;9638;54949;10083;5222;641654;3338;50507;402778;50863;8050;55327;51585;55800;80227;6888;255239;2197;283162;119687;10432;25906;80150;10346;144097;390154;1474;401666;2785;6207;4297;92292;79827;2694;81570;283092;1479;5837;80829;390113;91252;6520;2101;10205;57084;220074;219960;79339;143686;120776;727897;25923;81490;7762;89;6712;113130;9177;4135;2249;26515;60494;159963;643037;3746;503497;10632;79829;2950;5241;399888;9246;219595;390168;10003;246330;403312;8642;114902;83552;5883;338322;84867;116085;79733;10809;5003;4162;7140;390058;160298;8882;144108;90019;26297;9965;8519;220004;728588;219844;796;120526;7356;120146;6749;9409;390243;196074;9415;4314;119710;55867;23387;2620;120071;219469;5017;51399;79345;79796;3046;254439;2350;1200;170689;10410;387778;254359;8986;747;4004;219487;26298;335;977;23310;386746;8301;2230;80198;6494;120425;64232;55293;6609;56158;101927423;256364;390174;120787;390245;89792;219870;9158;100129216;100532726;6506;253935;7352;8495;4837;56649;114609;144124;26273;26007;8665;55231;84881;3047;3948;440021;10524;81309;80194;7166;337;219938;283284;144132;5007;27339;4013;84188;9066;9873;338323;402;56672;25988;7299;24147;84364;1982;58486;23621;572;9846;10418;25855;221092;975;26229;79841;79324;3703;283093;85456;283208;51503;1798;57804;56912;29068;7748;5790;53826;2017;81544;28970;1410;4676;4076;117195;114879;871;338657;390093;338699;10612;9440;338692;116519;63982;403253;57053;8726;84000;1128;59082;63876;120586;283212;390271;390199;390152;254187;84953;91703;387733;3630;254122;55742;23649;3508;1717;51700;119772;10581;283254;84897;2346;4723;390157;9600;4647;390110;26521;57010;29099;219965;3177;55346;219473;220032;10897;143888;51083;5138;55291;120237;23235;401;10894;9313;219432;387273;84259;79026;100131378;9219;219855;79473;84866;8424;64066;65998;60492;84767;283116;26579;84623;58487;219873;10263;8061;5547;2495;143872;114571;10196;1408;64837;6157;120796;10413;921;1072;387775;9610;6786;723961;80310;30008;6737;5871;79053;390067;220382;219833;120406;387266;259249;53;119765;7069;387264;6688;55216;85363;100506127;399948;120114;219464;38;84441;143903;114769;57586;837;219436;79073;57175;219537;254225;11145;54970;3762;80162;91894;283248;219429;23625;10658;374383;2977;80071;338755;219527;219477;120775;143662;91057;10978;283171;64231;10527;55572;56676;143689;220047;283189;56;340980;322;219431;3619;745;390190;23647;4192;10072;6833;5936;823;282775;1937;100528017;390259;23360;9854;6188;64852;112464;54503;219988;8539;8815;23705;6309;3939;390064;51317;334;390036;374403;60529;25891;399968;5702;5499;143501;114971;84437;65987;399979;2188;417;26610;79056;10179;10435;58475;10078;1500;254102;79869;3611;387748;161;642612;29850;119695;440044;283219;220323;1270;341019;26496;100507050;66005;439915;11309;642623;1662;219983;23052;100463486;117854;283237;143678;345;3784;27288;4322;440023;29984;219952;390083;582;81876;27122;54494;196335;4718;4250;867;22941;51075;347853;29087;23529;51296;2147;5795;83638;219869;3263;8772;414899;10963;55553;8065;283159;3048;5954;374393;85459;57689;7262;7702;79731;283149;10522;9183;57758;751071;3992;7761;6392;3145;54765;1075;390151;100287896;143503;390197;143941;79832;55709;54733;9986;196264;3636;53340;9743;7189;23258;9354;57571;3265;54972;5450;440068;6050;349633;960;595;3995;79684;4654;120793;219986;79101;84285;219484;23769;257160;55761;219858;100169851;64221;2206;441608;23365;85463;338707;9159;120224;9866;4588;5080;472;143570;486;100500938;9645;390212;440026;79780;4321;55226;282679;6876;10004;256144;390195;915;6484;390054;5977;85458;399949;1740;10077;54766;390078;81532;79751;79097;64137;1643;2615;120066;6811;5741;7351;7108;10825;24145;60496;219972;8501;7225;9376;4926;55298;283297;726;55531;51144;282770;55199;22997;143684;91801;7704;103344718;710;84447;27034;1737;90952;338440;8525;63901;57562;917;440051;55128;390275;54827;5526;84304;2237;79080;116071;4005;81341;28992;120379;57093;117194;115399;119749;8567;116337;283238;746;4928;50801;646754;10714;64787;10944;116985;2893;4054;414301;143458;203859;219447;10992;220001;4296;79671;9099;283106;51259;79102;84680;120376;80789;341116;51524;25833;116969;219539;117245;83875;117196;26338;5031;26011;79081;55690;256892;254263;26519;23650;390038;219453;143630;65975;283234;5441;740;170589;83706;55191;114900;54979;22917;9049;81930;56673;7275;4319;81318;2248;9537;219428;55107;50937;916;1119;1111;10480;79703;341208;219493;6291;10312;53840;2348;4925;7405;387787;445372;54948;3665;390084;143884;4041;55626;219927;219437;8538;9538;10798;7423;90139;219970;81327;6327;120400;3043;56935;3732;338675;10648;1815;57410;56675;932;56547;390063;50862;5682;283229;390144;5519;51501;3359;50613;81622;133;399967;923;26973;91683;9828;7536;834;283111;5553;51475;6330;338645;8722;833;120227;6094;80975;112936;9789;341152;79797;391;374407;23130;6150;2965;10525;55004;4900;7003;5286;23279;102724265;154810;6764;219982;330;27315;644943;2352;89849;838;79064;4607;738;390059;5029;54538;57661;7439;187;3312;55611;219995;10235;390264;6734;10313;399909;54961;390061;643;120103;6947;220064;338751;57104;160065;3606;6230;4246;219541;7070;219981;55048;847;9973;56946;6768;5870;340990;4046;55823;744;120065;399939;221091;387763;81328;160287;5866;23788;390148;1351;3014;1850;10482;5058;119678;5140;338674;390231;4316;171389;1509;102724957;404552;390066;10114;283160;79608;790955;55031;219957;79864;374395;3767;220002;51642;642446;57646;387804;51074;23584;9479;245802;9379;372;53841;329;4312;644672;26492;9092;406;23086;29118;79899;81846;408;4978;23378;119694;7481;143879;390167;4728;254552;56981;1642;51035;338661;8590;219417;5913;643847;7054;2900;84067;23410;3316;57569;84689;280636;78999;51400;3587;7251;10873;4684;79096;55343;29763;219990;29901;56674;887;4745;6809;196294;390081;8500;219956;6653;10534;390191;143502;1262;59307;390079;349667;5897;57558;29125;219899;26472;11041;81285;56834;5049;390072;221;2001;10394;84153;53942;219854;374378;9776;9646;10647;7465;22992;23193;2313;83661;627;1521;65003;116534;7106;2488;3045;390142;255725;4544;10938;29015;27087;1656;1813;51287;1028;643834;114908;220359;55331;390077;117144;219902;156;54843;51092;11234;91056;143425;11095;6240;81282;256329;8322;10553;266743;4583;5896;341277;9356;26595;7007;5818;341032;245911;5002;119764;83786;85329;84280;390261;23187;79659;26493;5612;54734;83480;2132;22800;192134;119682;4361;89797;113174;25987;220388;11007;220296;6199;28960;219931;116512;81168;51111;10062;283130;84649;4863;931;399947;341276;1132;51504;8898;219865;11251;57453;347862;55863;119692;55693;493860;84233;283298;283129;54860;160140;5805;159989;23220;8048;119774;100131539;55366;4221;112937;283209;29907;283152;10249;116535;1374;390205;84811;390155;258010;729384;10089;219874;144125;10335;222;53838;283150;120534;797;25824;56253;57124;79849;58473;56980;10008;9633;83700;7136;79607;3758;100533181;4317;55367;2011;390201;5962;8534;10929;63875;64776;11098;9024;392;51286;90993;9404;92105;7379;8690;55561;7753;25884;219958;57476;5024;219959;390260;6181;91614;54414;6588;10589;4798;1207;9152;51338;25996;144110;390162;3481;9793;387758;2113;7542;643376;10068;219438,1258
1,-1,11,313991,504786,190795,338440;8519;10410;81490;11187;6050;338707;59307,8
1,-1,11,359217,414570,55353,11187;338707;59307,3
1,-1,11,359217,414570,55353,11187;338707;59307,3
1,-1,11,371634,414570,42936,11187;338707;59307,3
1,-1,11,371634,414570,42936,11187;338707;59307,3
1,-1,11,371634,414570,42936,11187;338707;59307,3
1,-1,11,371634,414570,42936,11187;338707;59307,3
1,-1,11,371634,414570,42936,11187;338707;59307,3
1,-1,11,371634,414570,42936,11187;338707;59307,3
1,-1,11,371634,426161,54527,11187;338707;338440;59307,4
1,-1,11,371634,426161,54527,11187;338707;338440;59307,4
1,-1,11,371634,426161,54527,11187;338707;338440;59307,4
1,-1,11,371634,426161,54527,11187;338707;338440;59307,4
1,-1,11,371634,426161,54527,11187;338707;338440;59307,4
1,1,11,446754,18926289,18479535,272;4676;23258;117195;114879;3265;23538;390093;340990;4046;10612;120065;6050;4586;160287;54472;1315;1850;119678;4654;57053;120793;5140;1509;102724957;390066;401667;79608;401665;84953;55031;119679;3630;3767;55742;6343;9866;4588;6288;282763;51700;119772;9645;6881;440026;53841;101927503;406;390054;390075;10077;8045;390078;10894;81532;81846;79751;387755;283232;23378;120066;23075;144100;119694;79473;143496;5741;8590;6289;7054;84067;430;6157;390037;120796;7251;283297;56674;6786;723961;887;10083;103344718;390081;402778;6737;143502;1262;390067;6888;390079;387266;29125;119687;81285;390072;387264;10346;55128;85363;374378;9646;401666;7465;6207;115399;116534;7106;3045;255725;4928;64787;10944;1028;79339;120776;390077;283106;727897;11234;143425;81490;7762;374383;6240;116969;81282;117196;338755;256329;26515;4583;341277;3746;120775;256892;390038;10527;143630;8642;65975;338322;84867;5441;5002;56676;5003;340980;84280;322;7140;390058;160298;23647;6833;144108;22800;119682;90019;56673;26297;113174;7275;100528017;796;112464;6291;53840;3939;390064;4925;390036;445372;341276;3665;390084;347862;143501;79345;119692;3046;1200;283298;417;119774;4004;977;10078;386746;3043;3611;387748;161;1815;29850;119695;56675;55293;56547;283229;390063;144125;50862;10335;5682;6609;26496;797;66005;101927423;439915;120787;50613;133;7136;100463486;8495;55367;283111;117854;144124;833;120227;3784;8665;391;3047;3948;27288;440023;440021;2965;6150;63875;390083;9024;7003;51286;5286;7166;27122;6764;196335;144132;283284;27315;3263;644943;84188;6181;55553;3048;338323;56672;144110;1982;7262;390059;7702;58486;57661;3481;10522;10418;975;79324;390061;57758;7761;338751;57104;7748;143503,273
-1,-1,11,662668,699404,36736,283232;10522,2
-1,1,11,1126807,3235153,2108346,7054;4676;430;439915;114879;5002;7136;4046;5003;4586;54472;7262;7140;1850;3481;723961;10077;1028;833;81532;103344718;3784;402778;975;727897;440023;440021;1509;90019;6150;10078;387266;29125;9024;29850;387264;3630,37
1,-1,11,1362463,1468991,106528,9024,1
1,-1,11,1362463,1468991,106528,9024,1
1,1,11,1558609,3381999,1823390,7748;7054;4676;430;439915;114879;116534;5002;7136;4046;5003;7262;7140;1850;3481;723961;10077;1028;833;103344718;3784;402778;975;440023;440021;1509;90019;6150;10078;386746;387266;29125;29850;387264;3630,35
1,-1,11,1996741,2159676,162935,3481;103344718,2
1,1,11,1996741,2909925,913184,10078;7054;3481;723961;29125;10077;1028;103344718;430;3784;5003;29850;975;3630,14
1,-1,11,2016675,2016841,166,103344718,1
1,-1,11,2016675,2016841,166,103344718,1
1,-1,11,2019681,2020547,866,,0
-1,1,11,2475746,2482833,7087,3784,1
1,-1,11,2904944,2905042,98,1028,1
1,-1,11,3547816,3645310,97494,,0
1,-1,11,3645310,3655670,10360,,0
1,-1,11,5269595,5275588,5993,3047;3048,2
1,-1,11,5269595,5275588,5993,3047;3048,2
1,-1,11,5269595,5275588,5993,3047;3048,2
1,-1,11,5269595,5275588,5993,3047;3048,2
1,-1,11,5269595,5275588,5993,3047;3048,2
1,-1,11,5269595,5275588,5993,3047;3048,2
1,-1,11,5269595,5275588,5993,3047;3048,2
1,-1,11,5269595,5275588,5993,3047;3048,2
1,1,11,6282812,6659230,376418,112464;8642;26515;144132;23378;1200;6881;887;23647;3611;6609;10612;3263;322,14
-1,-1,11,7686529,7818037,131508,120065;341277;51700,3
-1,-1,11,7712477,7818037,105560,120065;341277,2
-1,-1,11,7817491,7847049,29558,120065;120066,2
-1,-1,11,7817491,7847049,29558,120065;120066,2
-1,-1,11,7817491,7847049,29558,120065;120066,2
-1,-1,11,7817491,7847049,29558,120065;120066,2
-1,-1,11,7817491,7847049,29558,120065;120066,2
-1,-1,11,7817491,7847049,29558,120065;120066,2
-1,-1,11,7817491,7847049,29558,120065;120066,2
-1,-1,11,7817491,7847049,29558,120065;120066,2
-1,-1,11,7817491,7847049,29558,120065;120066,2
-1,-1,11,7817491,7894373,76882,120065;120066,2
-1,1,11,10011063,16847353,6836290,374378;55742;9646;50862;5682;10335;272;797;644943;84188;9645;55553;133;84280;100463486;1982;406;58486;10944;1315;10894;120227;81846;10418;22800;5140;283106;387755;102724957;144100;7003;796;27122;5741;84953;55031,36
1,1,11,10172921,13963463,3790542,1982;406;374378;58486;55742;9646;50862;10335;272;10894;81846;644943;283106;84188;9645;133;7003;27122;5741;84953;84280;55031;100463486,23
1,-1,11,18908667,18956427,47760,259249,1
1,-1,11,18908667,19048572,139905,259249,1
1,-1,11,18955543,19076609,121066,259249;117194,2
-1,1,11,20101020,34485543,14384523,79832;10553;258010;341019;8424;159963;966;4005;5080;143662;196074;627;120534;4076;91057;100500938;847;25758;10196;91614;3739;2620;2488;1479;55226;5954;9152;25841;744;55346;493860;7490;57084;120237;4745;338645;203859;63982;196294;2188;26273;81930;26610;79056;55327;89797;387758;55366;10114;100131378;120526;10480,52
-1,1,11,23527622,27901352,4373730,387758;55366;159963;338645;63982;143662;627;91057;8424;55327,10
1,-1,11,24563723,24657683,93960,338645,1
1,1,11,24616945,31118086,6501141,341019;159963;338645;63982;143662;196074;627;120534;91057;81930;55327;387758;55366;3739;2488;744;8424,17
-1,-1,11,24847925,25085213,237288,338645,1
1,-1,11,25424279,26330690,906411,63982,1
-1,1,11,25771208,35614978,9843770,79832;341019;8424;159963;966;4005;5080;143662;196074;627;120534;4076;91057;51074;847;25758;91614;25891;3739;2488;1479;55226;6506;5954;25841;744;55346;960;493860;7490;63982;196294;26273;8050;81930;26610;79056;55327;26298;387758;55366;10114;100131378;120526;10480;2001,46
-1,1,11,26390509,35274523,8884014,79832;341019;159963;966;4005;5080;143662;196074;627;120534;4076;91057;51074;847;25758;91614;3739;2488;1479;55226;6506;5954;25841;744;55346;960;493860;7490;63982;196294;26273;8050;81930;26610;79056;55327;26298;387758;55366;10114;100131378;120526;8424;10480;2001,45
1,1,11,26574629,50508019,23933390,79832;55709;5913;341019;283116;159963;5896;221120;143662;7189;4722;399888;4076;91057;120534;847;25758;1408;3739;119764;6506;79096;55343;29763;744;51144;960;387763;7490;23788;2132;114900;63982;143678;403253;4192;196294;26273;8050;81930;8534;79797;55327;55761;256148;8525;5897;10114;9537;53;23360;392;23279;90993;119765;120526;10480;6688;2001;10062;8539;9776;9409;966;2147;5795;4005;5080;196074;51317;627;51074;9479;119710;283254;1132;60529;2346;91614;25891;8567;390110;120071;283092;55226;55626;2488;1479;25841;5954;390113;5702;29099;4607;256144;55346;57689;91252;57586;493860;24147;84364;646754;114971;143458;9793;79899;90139;26610;79056;26298;79841;55366;387758;1643;3732;4038;100131378;283093;10658;84680;54765;56981;8424,124
-1,1,11,27895487,34494489,6599002,79832;7490;341019;966;4005;5080;196074;196294;26273;120534;4076;81930;26610;79056;847;25758;91614;3739;2488;1479;55226;10114;5954;25841;100131378;744;10480;120526;55346;493860,30
-1,1,11,29238811,45494063,16255252,79832;8539;341019;5896;966;221120;4005;5080;7189;120534;4076;51074;847;119710;25758;91614;60529;25891;3739;390110;2488;1479;55226;6506;5954;25841;744;29099;57689;55346;51144;960;387763;493860;24147;7490;57586;2132;143458;196294;26273;79899;8050;90139;26610;79056;26298;55761;5897;10114;3732;9537;100131378;84680;54765;56981;120526;10480;2001,59
-1,1,11,31210842,31722681,511839,120526;26610;341019;196294,4
-1,1,11,31210842,35436121,4225279,79832;7490;341019;966;4005;5080;196294;26273;51074;4076;8050;26610;79056;847;26298;25758;91614;1479;55226;10114;6506;5954;25841;100131378;10480;120526;55346;960;493860;2001,30
-1,1,11,31320870,31811619,490749,341019;196294;120526;26610;5080,5
1,1,11,31622079,32144347,522268,5080;26610;5954,3
-1,1,11,31825724,31839168,13444,5080,1
-1,1,11,31828509,34576695,2748186,79832;7490;966;4005;5080;26273;4076;79056;847;25758;91614;1479;55226;10114;5954;25841;100131378;10480;55346;493860;2001,21
-1,-1,11,36294301,36310900,16599,29099,1
-1,1,11,39200802,49157287,9956485,5913;55709;283116;221120;4722;399888;1408;119764;79096;55343;29763;51144;387763;23788;2132;114900;143678;403253;4192;8534;79797;55761;8525;256148;53;9537;392;23360;23279;90993;119765;6688;10062;8539;9776;9409;2147;5795;51317;9479;283254;1132;60529;8567;390110;120071;55626;390113;5702;4607;57689;91252;57586;256144;84364;646754;114971;9793;90139;79841;1643;3732;4038;84680;10658;56981,66
-1,1,11,39706376,44866811,5160435,60529;8539;55761;2132;390110;221120;3732;84680;90139;57689;51144;387763,12
-1,-1,11,40339615,40652281,312666,57689,1
-1,1,11,41139872,48664555,7524683,5913;55709;221120;4722;399888;1408;119764;79096;55343;29763;51144;387763;23788;2132;114900;143678;403253;4192;8534;79797;55761;8525;256148;53;9537;392;23360;23279;90993;119765;6688;10062;8539;9776;9409;2147;5795;51317;9479;283254;1132;60529;8567;390110;120071;55626;390113;5702;4607;57689;256144;57586;91252;84364;114971;9793;90139;79841;1643;3732;4038;84680;10658;56981,64
-1,1,11,42475897,48372559,5896662,10062;5913;8539;55709;9776;9409;2147;221120;5795;51317;4722;399888;9479;283254;1132;60529;1408;8567;390110;120071;55626;119764;79096;390113;55343;29763;5702;4607;256144;51144;57586;91252;387763;84364;23788;2132;114971;114900;143678;9793;4192;90139;8534;79797;79841;55761;8525;1643;256148;53;3732;9537;84680;392;4038;90993;10658;23360;23279;56981;119765;6688,62
-1,1,11,42575209,46136343,3561134,8539;2132;9409;221120;143678;51317;90139;8534;9479;60529;1408;55761;390110;120071;3732;9537;84680;55343;56981;51144;57586;387763,22
-1,1,11,44214357,44305745,91388,60529;2132,2
-1,1,11,47232210,47448882,216672,10062;1643;8567;53;5702;4607;91252;6688,8
1,-1,11,47589813,47617121,27308,55709;4722;399888;114971;114900,5
1,-1,11,50008083,51378911,1370828,,0
1,-1,11,50008083,51378911,1370828,,0
1,-1,11,50008083,51378911,1370828,,0
1,-1,11,50032805,51378911,1346106,,0
1,-1,11,50049613,51378911,1329298,,0
1,-1,11,50121285,51378911,1257626,,0
1,-1,11,50121285,51378911,1257626,,0
1,-1,11,50121285,51378911,1257626,,0
1,-1,11,50121285,51378911,1257626,,0
1,-1,11,55029738,55980347,950609,390148;84767;219436;10798;390144;219447;338674;219453;81327;79097;81168;219432;219429;81300;282775;120586;81309;219438;390142;219428;390152;219437;390151;282770;219431;81328;26338,27
1,-1,11,55033164,55980347,947183,390148;84767;219436;10798;390144;219447;338674;219453;81327;79097;81168;219432;219429;81300;282775;120586;81309;219438;390142;219428;390152;219437;390151;282770;219431;81328;26338,27
1,-1,11,55033261,55997702,964441,390148;84767;219436;10798;390144;219447;338674;219453;81327;79097;81168;219432;219429;81300;282775;120586;81309;219438;390142;219428;390152;219437;390151;282770;219431;81328;26338,27
1,-1,11,55086995,55980406,893411,390148;84767;219436;10798;390144;219447;338674;219453;81327;81168;219432;219429;81300;282775;120586;81309;219438;390142;219428;390152;219437;390151;282770;219431;81328;26338,26
1,-1,11,55086995,55980406,893411,390148;84767;219436;10798;390144;219447;338674;219453;81327;81168;219432;219429;81300;282775;120586;81309;219438;390142;219428;390152;219437;390151;282770;219431;81328;26338,26
1,-1,11,55086995,55980406,893411,390148;84767;219436;10798;390144;219447;338674;219453;81327;81168;219432;219429;81300;282775;120586;81309;219438;390142;219428;390152;219437;390151;282770;219431;81328;26338,26
1,1,11,55086995,58766250,3679255,390155;1270;84767;219541;390144;26519;10978;219453;9246;390168;390174;8501;280636;25921;283189;282770;219431;81328;5553;390148;390190;219479;219956;710;338674;390191;219484;219952;282775;349667;120586;81309;219968;219428;441608;390152;9404;81168;219957;10394;6749;390154;219493;51075;219464;219482;219958;81341;92292;219527;5024;219959;390157;219469;390142;80829;219965;219437;219473;29015;390162;390181;26338;10798;219954;219436;219960;219447;187;219537;219970;81327;219487;219432;219429;81300;1500;643376;338675;85456;219438;390167;219539;390151;10249;219477;219417,87
-1,-1,11,55368154,55560160,192006,390142;219429;81300;219432;219431,5
1,-1,11,55368362,55438706,70344,219432;219429;219431;81300,4
-1,-1,11,55368362,55450758,82396,219432;219429;219431;81300,4
1,-1,11,55368362,55450758,82396,219432;219429;219431;81300,4
1,-1,11,55368362,55450758,82396,219432;219429;219431;81300,4
1,-1,11,55368362,55450758,82396,219432;219429;219431;81300,4
1,-1,11,55368362,55450758,82396,219432;219429;219431;81300,4
1,-1,11,55368362,55450758,82396,219432;219429;219431;81300,4
-1,-1,11,55368362,55450758,82396,219432;219429;219431;81300,4
1,-1,11,55368362,55450758,82396,219432;219429;219431;81300,4
1,-1,11,55368362,55450758,82396,219432;219429;219431;81300,4
-1,-1,11,55368362,55450758,82396,219432;219429;219431;81300,4
-1,-1,11,55368362,55450758,82396,219432;219429;219431;81300,4
-1,-1,11,55368362,55450758,82396,219432;219429;219431;81300,4
-1,-1,11,55703736,55816312,112576,338674;282770;10798;219447,4
-1,-1,11,55740538,55821016,80478,338674;219447,2
-1,-1,11,55740538,55821016,80478,338674;219447,2
-1,-1,11,55740538,55821016,80478,338674;219447,2
1,-1,11,55740538,55821016,80478,338674;219447,2
-1,-1,11,55740538,55821016,80478,338674;219447,2
1,-1,11,55917298,56537994,620696,390155;390154;219493;390162;219464;219482;219479;219453;390168;390174;219487;219484;282775;390157;338675;219469;390167;283189;219473;219477;219417,21
-1,-1,11,56322990,56352364,29374,390167,1
-1,-1,11,56322990,56352364,29374,390167,1
1,1,11,62016992,62713565,696573,4250;374395;79081;23193;2785;54663;79842;256364;10629;102288414;26580;7356;79064;221091;6520;283237;10482;6094;221092;26229;1128;751071;1937;404552;79026;9219;80789;790955;6811;64852;51035;80150;5436,33
-1,1,11,65508902,67473140,1964238,83759;9986;266743;5091;222;55690;2950;254263;8061;10263;57571;246330;57124;9973;5883;78999;64837;89792;100526737;9158;256472;91683;338692;1072;51475;9610;8722;10072;30008;5936;9049;55231;84285;29984;11007;582;80194;11041;10432;81876;6199;254187;91703;254122;79703;8815;1474;22992;347853;23529;83638;1521;374403;390212;65003;4723;9600;10589;5017;57010;5499;3177;10897;9092;254439;254359;10992;57175;25855;117144;156;54961;91056;80198;89;254552;6712;57804;5790,79
-1,-1,11,67164667,67411909,247242,51475;347853;5790;2950;57175;9049;10263;57571;374403;5883;390212;4723;9600;80194;254552;6199;57010;5499;91703,19
1,-1,11,67259243,67274585,15342,9600;10263,2
1,-1,11,67511222,67643217,131995,,0
1,-1,11,67574343,67643217,68874,,0
1,-1,11,67764080,67811086,47006,10312;4728;81622;221,4
1,-1,11,69587777,69588196,419,2249,1
1,1,11,70853054,71088948,235894,22941,1
-1,1,11,71088949,72833199,1744250,3846;55191;3636;220074;5138;116985;2348;401;2350;1717;387273;100131539;2352;89849;9873;245911;4926;100129216;81570;10809;440050;10068;57830;55004;55298;25906;440051;55199,28
-1,1,11,71154800,71157788,2988,1717,1
-1,1,11,75652798,98228688,22575890,24145;26011;729384;60494;28970;643037;54851;58487;220042;28971;27314;51501;5547;219595;2915;10003;390245;642623;56946;9702;100532726;338699;10873;2526;220047;143689;26973;9440;23052;726;399939;5612;143684;4975;5058;50507;8726;192134;390231;51773;79101;79053;51585;4361;10929;220382;25987;220388;11098;57558;154810;7069;92105;10888;8690;120146;4718;100506127;341208;642446;120114;390243;387804;7405;65084;57093;283219;84441;8898;4647;79780;1207;282679;23682;4544;55863;85459;220032;55693;7299;84233;79731;9846;1740;65987;55331;159989;143686;54843;2615;8301;7481;56935;120103;51503;642612;1075;60492;8322,99
-1,1,11,80318996,96116221,15797225,24145;729384;60494;28970;643037;54851;58487;220042;51501;27314;5547;219595;2915;10003;390245;642623;9702;338699;10873;26973;220047;2526;143689;9440;23052;399939;143684;50507;8726;390231;79101;51585;4361;10929;220382;220388;11098;154810;10888;120146;341208;642446;120114;390243;387804;65084;57093;84441;8898;79780;23682;4544;55863;85459;7299;55693;84233;1740;143686;159989;54843;8301;120103;56935;51503;642612;1075;60492;8322,69
-1,-1,11,80656651,80902908,246257,,0
-1,-1,11,81137098,81218937,81839,,0
-1,-1,11,84333985,84419443,85458,1740,1
-1,-1,11,84419443,84583725,164282,1740,1
-1,1,11,88152458,109414650,21262192,54733;24145;729384;28970;643037;54851;60496;5241;219595;2915;10003;143872;390245;642623;7225;1662;10413;9702;85016;253935;2526;143689;26973;440068;9440;23052;55531;399939;79659;4317;834;54734;143684;91801;80310;50507;390231;4316;79101;4322;4361;10929;59082;4319;154810;57562;10888;8690;120146;53942;341208;330;642446;120114;390243;38;387804;472;4863;4314;57093;399947;84441;143884;838;8898;8065;6588;79780;4321;329;4312;4544;85459;114769;55693;143888;7299;23086;837;84437;2893;414301;114908;160140;159989;143686;9313;84259;56935;120103;143879;51503;2977;642612;64066,96
-1,1,11,88156563,114491338,26334775,54733;28970;643037;1410;5241;219595;10003;341032;5450;9702;2526;143689;440068;9440;349633;399939;79659;54734;390231;4316;79101;4361;59082;4319;85463;10888;120146;341208;642446;57646;390243;387804;472;4863;4314;399947;143884;8898;79780;4321;329;4312;26521;79796;644672;55693;143888;23086;85458;84437;91893;399949;54766;23235;160140;159989;5805;9313;10179;84259;120400;2230;56935;143879;642612;64066;24145;729384;54851;60496;5519;56158;2915;143872;3316;57569;390245;642623;7225;1662;3359;10413;85016;253935;4684;26973;23052;55531;4317;834;143684;4837;91801;80310;7704;5962;80975;50507;1737;4322;10929;64776;255239;154810;57562;54494;8690;55216;53942;330;54827;399948;120114;38;120379;57093;84441;838;8065;6588;143903;4544;85459;114769;25996;7299;837;1813;2893;414301;114908;143686;9183;54970;91894;120103;6392;51503;120376;2977;9177;83875;3606,143
1,-1,11,89540275,89956475,416200,120146;729384;642446;26973;642612;399939;10003;57093;642623,9
-1,-1,11,89631979,89656912,24933,399939,1
-1,1,11,90819827,109466308,18646481,54733;24145;28970;643037;54851;60496;5241;143872;390245;1662;7225;10413;9702;85016;253935;2526;143689;23052;440068;9440;55531;79659;4317;834;54734;143684;91801;80310;4316;79101;4322;4361;10929;59082;4319;154810;57562;10888;8690;53942;341208;330;120114;390243;38;387804;472;4863;4314;399947;84441;143884;838;8898;8065;6588;79780;4321;329;4312;4544;85459;114769;55693;143888;23086;837;84437;2893;414301;114908;160140;159989;143686;9313;84259;56935;120103;143879;51503;2977;64066,82
-1,-1,11,92293847,92397611,103764,120114,1
1,-1,11,96632623,97924186,1291563,,0
1,-1,11,96808589,97273356,464767,,0
-1,-1,11,97720768,98228629,507861,,0
-1,-1,11,97720768,98309787,589019,,0
-1,-1,11,97720768,98309787,589019,,0
-1,1,11,98228629,105929873,7701244,53942;330;5241;4314;143872;7225;838;10413;85016;4321;253935;329;4312;114769;440068;4317;79659;834;837;84437;2893;414301;80310;114908;4316;9313;4322;84259;59082;4319;57562;143879;64066,33
1,1,11,101323715,103914833,2591118,330;414301;80310;114908;4314;4316;9313;4322;84259;7225;10413;4319;85016;4317;4321;57562;253935;329;4312;64066;79659,21
-1,-1,11,103267305,103347787,80482,79659,1
1,-1,11,104321199,104405899,84700,,0
1,-1,11,104643215,104701837,58622,,0
1,1,11,106467595,113879729,7412134,54733;399948;57646;38;5519;1410;472;56158;4863;3316;341032;399947;57569;1662;120379;143884;3359;8065;6588;5450;143903;4684;26521;55531;349633;79796;644672;143888;23086;54734;1813;85458;91893;91801;399949;54766;23235;5962;80975;160140;5805;3606;9183;1737;54970;91894;9177;64776;2230;255239;6392;120376;2977;85463;83875;55216,56
-1,1,11,107349817,108093259,743442,54733;54734;8065;6588;91801;38;4863;55531,8
1,-1,11,107537206,107582654,45448,55531;6588,2
1,-1,11,109804992,109928090,123098,,0
1,1,11,112832130,131059210,18227080,143941;196264;6230;53340;63970;9743;10632;26595;7070;7007;23650;283171;5818;9354;403312;114902;83552;338657;219875;55572;6768;56;55823;4162;23187;390261;26493;83480;8882;116519;3014;79684;84000;257160;219858;63876;100169851;283160;390259;390271;64221;23365;9854;916;390265;220296;1111;219844;50937;28960;9159;79864;23705;6309;120224;22897;57646;334;486;23584;84897;219865;23387;372;57453;6876;399968;51399;644672;26492;915;6484;8538;170689;11181;9538;29118;399979;84959;6327;10179;335;64137;120400;338662;56912;219855;120425;84866;283152;84811;338661;220323;219874;2900;84623;283150;219873;3359;2542;56253;79849;3587;219870;56980;399967;4684;79607;3758;100533181;9638;6330;4837;56649;114609;7704;80975;345;641654;6653;84881;55800;90952;219833;255239;120406;10525;283162;219899;917;4900;337;5049;54494;7379;867;390275;219854;54827;7753;2313;57476;219869;4297;4013;390260;414899;79827;54414;283159;116337;4798;25996;25988;1656;1813;10205;23621;54538;283149;3312;9183;390264;6734;79671;9099;219902;51092;54970;3762;2113;643;79102;3703;25833;11095;3145;1798;9177;80071;160065;29068;53826,183
1,1,11,116676984,134945165,18268181,143941;196264;6230;53340;63970;9743;10632;26595;7070;7007;23650;283171;5818;9354;403312;114902;83552;338657;219875;55572;6768;56;55823;4162;23187;390261;26493;83480;3014;79684;84000;257160;219858;63876;100169851;283160;390259;390271;64221;23365;9854;916;390265;220296;1111;219844;50937;28960;9159;79864;6309;120224;22897;80071;334;486;23584;84897;219865;23387;372;57453;6876;399968;51399;26492;915;6484;8538;170689;11181;9538;29118;399979;84959;6327;335;4978;64137;338662;23310;112937;219855;120425;84866;283152;338661;220323;219874;2900;84623;283150;219873;89944;2542;56253;79849;3587;219870;56980;83700;399967;79607;3758;100533181;22997;9638;6330;56649;114609;345;641654;112936;6653;84881;50863;27034;55800;90952;219833;10525;283162;219899;917;4900;337;219938;5049;7379;867;390275;219854;7753;29087;2313;57476;219869;4297;4013;390260;414899;79827;54414;283159;116337;4798;27087;25988;1656;10205;23621;54538;283149;3312;390264;6734;79671;9099;219902;51092;3762;2113;643;79102;3703;25833;11095;3145;1798;56912;160065;29068;53826,173
1,1,11,116681007,134938470,18257463,143941;196264;6230;53340;63970;9743;10632;26595;7070;7007;23650;283171;5818;9354;403312;114902;83552;338657;219875;55572;6768;56;55823;4162;23187;390261;26493;83480;3014;79684;84000;257160;219858;63876;100169851;283160;390259;390271;64221;23365;9854;916;390265;220296;1111;219844;50937;28960;9159;79864;6309;120224;22897;80071;334;486;23584;84897;219865;23387;372;57453;6876;399968;51399;26492;915;6484;8538;170689;11181;9538;29118;399979;84959;6327;335;4978;64137;338662;23310;112937;219855;120425;84866;283152;338661;220323;219874;2900;84623;283150;219873;89944;2542;56253;79849;3587;219870;56980;83700;399967;79607;3758;100533181;22997;9638;6330;56649;114609;345;641654;112936;6653;84881;50863;27034;55800;90952;219833;10525;283162;219899;917;4900;337;219938;5049;7379;867;390275;219854;7753;29087;2313;57476;219869;4297;4013;390260;414899;79827;54414;283159;116337;4798;27087;25988;1656;10205;23621;54538;283149;3312;390264;6734;79671;9099;219902;51092;3762;2113;643;79102;3703;25833;11095;3145;1798;56912;160065;29068;53826,173
1,1,11,116681007,134938470,18257463,143941;196264;6230;53340;63970;9743;10632;26595;7070;7007;23650;283171;5818;9354;403312;114902;83552;338657;219875;55572;6768;56;55823;4162;23187;390261;26493;83480;3014;79684;84000;257160;219858;63876;100169851;283160;390259;390271;64221;23365;9854;916;390265;220296;1111;219844;50937;28960;9159;79864;6309;120224;22897;80071;334;486;23584;84897;219865;23387;372;57453;6876;399968;51399;26492;915;6484;8538;170689;11181;9538;29118;399979;84959;6327;335;4978;64137;338662;23310;112937;219855;120425;84866;283152;338661;220323;219874;2900;84623;283150;219873;89944;2542;56253;79849;3587;219870;56980;83700;399967;79607;3758;100533181;22997;9638;6330;56649;114609;345;641654;112936;6653;84881;50863;27034;55800;90952;219833;10525;283162;219899;917;4900;337;219938;5049;7379;867;390275;219854;7753;29087;2313;57476;219869;4297;4013;390260;414899;79827;54414;283159;116337;4798;27087;25988;1656;10205;23621;54538;283149;3312;390264;6734;79671;9099;219902;51092;3762;2113;643;79102;3703;25833;11095;3145;1798;56912;160065;29068;53826,173
1,1,11,116681007,134938470,18257463,143941;196264;6230;53340;63970;9743;10632;26595;7070;7007;23650;283171;5818;9354;403312;114902;83552;338657;219875;55572;6768;56;55823;4162;23187;390261;26493;83480;3014;79684;84000;257160;219858;63876;100169851;283160;390259;390271;64221;23365;9854;916;390265;220296;1111;219844;50937;28960;9159;79864;6309;120224;22897;80071;334;486;23584;84897;219865;23387;372;57453;6876;399968;51399;26492;915;6484;8538;170689;11181;9538;29118;399979;84959;6327;335;4978;64137;338662;23310;112937;219855;120425;84866;283152;338661;220323;219874;2900;84623;283150;219873;89944;2542;56253;79849;3587;219870;56980;83700;399967;79607;3758;100533181;22997;9638;6330;56649;114609;345;641654;112936;6653;84881;50863;27034;55800;90952;219833;10525;283162;219899;917;4900;337;219938;5049;7379;867;390275;219854;7753;29087;2313;57476;219869;4297;4013;390260;414899;79827;54414;283159;116337;4798;27087;25988;1656;10205;23621;54538;283149;3312;390264;6734;79671;9099;219902;51092;3762;2113;643;79102;3703;25833;11095;3145;1798;56912;160065;29068;53826,173
1,1,11,116684163,134938470,18254307,143941;196264;6230;53340;63970;9743;10632;26595;7070;7007;23650;283171;5818;9354;403312;114902;83552;338657;219875;55572;6768;56;55823;4162;23187;390261;26493;83480;3014;79684;84000;257160;219858;63876;100169851;283160;390259;390271;64221;23365;9854;916;390265;220296;1111;219844;50937;28960;9159;79864;6309;120224;22897;80071;334;486;23584;84897;219865;23387;372;57453;6876;399968;51399;26492;915;6484;8538;170689;11181;9538;29118;399979;84959;6327;335;4978;64137;338662;23310;112937;219855;120425;84866;283152;338661;220323;219874;2900;84623;283150;219873;89944;2542;56253;79849;3587;219870;56980;83700;399967;79607;3758;100533181;22997;9638;6330;56649;114609;345;641654;112936;6653;84881;50863;27034;55800;90952;219833;10525;283162;219899;917;4900;337;219938;5049;7379;867;390275;219854;7753;29087;2313;57476;219869;4297;4013;390260;414899;79827;54414;283159;116337;4798;27087;25988;1656;10205;23621;54538;283149;3312;390264;6734;79671;9099;219902;51092;3762;2113;643;79102;3703;25833;11095;3145;1798;56912;160065;29068;53826,173
1,1,11,116722088,134868420,18146332,143941;196264;6230;53340;63970;9743;10632;26595;7070;7007;23650;283171;5818;9354;403312;114902;83552;338657;219875;55572;6768;56;55823;4162;23187;390261;26493;83480;3014;79684;84000;257160;219858;63876;100169851;283160;390259;390271;64221;23365;9854;916;390265;220296;1111;219844;50937;28960;9159;79864;6309;120224;22897;334;486;23584;84897;219865;23387;372;57453;6876;399968;51399;26492;915;6484;8538;170689;11181;9538;29118;399979;84959;6327;4978;64137;338662;23310;112937;56912;219855;120425;84866;283152;338661;220323;219874;2900;84623;283150;219873;89944;2542;56253;79849;3587;219870;56980;83700;399967;79607;3758;100533181;22997;9638;6330;56649;114609;641654;112936;6653;84881;50863;27034;55800;90952;219833;10525;283162;219899;917;4900;219938;5049;7379;867;390275;219854;7753;29087;2313;57476;219869;4297;4013;390260;414899;79827;54414;283159;116337;4798;27087;25988;1656;10205;23621;54538;283149;3312;390264;6734;79671;9099;219902;51092;3762;2113;643;79102;3703;25833;11095;3145;1798;80071;160065;29068;53826,170
1,1,11,116722111,134868407,18146296,143941;196264;6230;53340;63970;9743;10632;26595;7070;7007;23650;283171;5818;9354;403312;114902;83552;338657;219875;55572;6768;56;55823;4162;23187;390261;26493;83480;3014;79684;84000;257160;219858;63876;100169851;283160;390259;390271;64221;23365;9854;916;390265;220296;1111;219844;50937;28960;9159;79864;6309;120224;22897;334;486;23584;84897;219865;23387;372;57453;6876;399968;51399;26492;915;6484;8538;170689;11181;9538;29118;399979;84959;6327;4978;64137;338662;23310;112937;56912;219855;120425;84866;283152;338661;220323;219874;2900;84623;283150;219873;89944;2542;56253;79849;3587;219870;56980;83700;399967;79607;3758;100533181;22997;9638;6330;56649;114609;641654;112936;6653;84881;50863;27034;55800;90952;219833;10525;283162;219899;917;4900;219938;5049;7379;867;390275;219854;7753;29087;2313;57476;219869;4297;4013;390260;414899;79827;54414;283159;116337;4798;27087;25988;1656;10205;23621;54538;283149;3312;390264;6734;79671;9099;219902;51092;3762;2113;643;79102;3703;25833;11095;3145;1798;80071;160065;29068;53826,170
1,1,11,116722111,134868407,18146296,143941;196264;6230;53340;63970;9743;10632;26595;7070;7007;23650;283171;5818;9354;403312;114902;83552;338657;219875;55572;6768;56;55823;4162;23187;390261;26493;83480;3014;79684;84000;257160;219858;63876;100169851;283160;390259;390271;64221;23365;9854;916;390265;220296;1111;219844;50937;28960;9159;79864;6309;120224;22897;334;486;23584;84897;219865;23387;372;57453;6876;399968;51399;26492;915;6484;8538;170689;11181;9538;29118;399979;84959;6327;4978;64137;338662;23310;112937;56912;219855;120425;84866;283152;338661;220323;219874;2900;84623;283150;219873;89944;2542;56253;79849;3587;219870;56980;83700;399967;79607;3758;100533181;22997;9638;6330;56649;114609;641654;112936;6653;84881;50863;27034;55800;90952;219833;10525;283162;219899;917;4900;219938;5049;7379;867;390275;219854;7753;29087;2313;57476;219869;4297;4013;390260;414899;79827;54414;283159;116337;4798;27087;25988;1656;10205;23621;54538;283149;3312;390264;6734;79671;9099;219902;51092;3762;2113;643;79102;3703;25833;11095;3145;1798;80071;160065;29068;53826,170
1,1,11,116739651,134945165,18205514,143941;196264;6230;53340;63970;9743;10632;26595;7070;7007;23650;283171;5818;9354;403312;114902;83552;338657;219875;55572;6768;56;55823;4162;23187;390261;26493;83480;3014;79684;84000;257160;219858;63876;100169851;283160;390259;390271;64221;23365;9854;916;390265;220296;1111;219844;50937;28960;9159;79864;6309;120224;22897;334;486;23584;84897;219865;23387;372;57453;6876;399968;51399;26492;915;6484;8538;170689;11181;9538;29118;399979;84959;6327;4978;64137;338662;23310;112937;56912;219855;120425;84866;283152;338661;220323;219874;2900;84623;283150;219873;89944;2542;56253;79849;3587;219870;56980;83700;399967;79607;3758;100533181;22997;9638;6330;56649;114609;641654;112936;6653;84881;50863;27034;55800;90952;219833;10525;283162;219899;917;4900;219938;5049;7379;867;390275;219854;7753;29087;2313;57476;219869;4297;4013;390260;414899;79827;54414;283159;116337;4798;27087;25988;1656;10205;23621;54538;283149;3312;390264;6734;79671;9099;219902;51092;3762;2113;643;79102;3703;25833;11095;3145;1798;80071;160065;29068;53826,170
1,1,11,116739651,134945165,18205514,143941;196264;6230;53340;63970;9743;10632;26595;7070;7007;23650;283171;5818;9354;403312;114902;83552;338657;219875;55572;6768;56;55823;4162;23187;390261;26493;83480;3014;79684;84000;257160;219858;63876;100169851;283160;390259;390271;64221;23365;9854;916;390265;220296;1111;219844;50937;28960;9159;79864;6309;120224;22897;334;486;23584;84897;219865;23387;372;57453;6876;399968;51399;26492;915;6484;8538;170689;11181;9538;29118;399979;84959;6327;4978;64137;338662;23310;112937;56912;219855;120425;84866;283152;338661;220323;219874;2900;84623;283150;219873;89944;2542;56253;79849;3587;219870;56980;83700;399967;79607;3758;100533181;22997;9638;6330;56649;114609;641654;112936;6653;84881;50863;27034;55800;90952;219833;10525;283162;219899;917;4900;219938;5049;7379;867;390275;219854;7753;29087;2313;57476;219869;4297;4013;390260;414899;79827;54414;283159;116337;4798;27087;25988;1656;10205;23621;54538;283149;3312;390264;6734;79671;9099;219902;51092;3762;2113;643;79102;3703;25833;11095;3145;1798;80071;160065;29068;53826,170
1,1,11,117204668,127579051,10374383,143941;196264;6230;53340;10632;26595;7070;7007;23650;5818;9354;403312;114902;83552;338657;219875;55572;56;55823;4162;23187;390261;26493;83480;3014;79684;84000;219858;63876;100169851;283160;390259;390271;64221;23365;9854;916;390265;220296;1111;219844;50937;28960;79864;6309;22897;486;23584;84897;219865;372;57453;399968;51399;26492;915;6484;11181;9538;29118;84959;6327;64137;338662;56912;219855;120425;84866;283152;338661;220323;219874;2900;84623;283150;219873;2542;56253;79849;3587;219870;399967;79607;100533181;9638;6330;56649;114609;641654;6653;84881;55800;90952;10525;283162;219899;917;4900;7379;867;390275;219854;7753;57476;219869;4297;4013;390260;414899;79827;54414;283159;116337;25988;1656;10205;54538;283149;3312;390264;6734;79671;9099;219902;643;79102;3703;25833;3145;1798;80071;160065;53826,133
1,1,11,119054729,134946516,15891787,219874;53340;63970;9743;2900;84623;26595;7070;7007;219873;23650;89944;283171;5818;56253;403312;114902;83552;79849;219870;56980;219875;55572;83700;6768;399967;56;79607;4162;390261;3758;26493;160065;22997;9638;83480;114609;79684;641654;112936;6653;84881;50863;27034;55800;90952;219858;219833;63876;100169851;283162;283160;390259;390271;64221;23365;220296;390265;1111;219844;50937;28960;219938;4900;79864;6309;867;390275;219854;120224;7753;29087;2313;219899;57476;334;219869;4013;23584;390260;414899;84897;79827;54414;219865;283159;116337;4798;399968;27087;26492;6484;8538;170689;54538;9538;29118;399979;3312;390264;6734;84959;219902;9099;3762;4978;2113;338662;23310;112937;79102;3703;25833;11095;219855;80071;283152;338661;29068;220323,120
-1,1,11,119295007,134945165,15650158,219874;53340;63970;9743;2900;84623;26595;7070;7007;219873;23650;89944;283171;5818;56253;403312;219870;56980;219875;55572;83700;6768;399967;56;79607;390261;3758;26493;22997;9638;83480;114609;79684;641654;112936;6653;84881;50863;27034;55800;90952;219858;219833;63876;100169851;283162;283160;390259;390271;219844;23365;64221;390265;220296;1111;50937;28960;219938;4900;79864;6309;219854;390275;120224;7753;29087;2313;219899;57476;334;219869;4013;23584;390260;414899;84897;79827;54414;219865;283159;116337;4798;399968;27087;26492;6484;8538;170689;54538;9538;29118;399979;3312;390264;6734;84959;219902;3762;4978;2113;338662;23310;112937;3703;25833;11095;219855;80071;160065;338661;29068;220323,112
-1,1,11,119513909,134938470,15424561,219874;53340;63970;9743;2900;84623;26595;7007;219873;23650;89944;283171;5818;56253;403312;219870;56980;219875;55572;83700;6768;399967;56;79607;390261;3758;26493;22997;9638;83480;114609;79684;641654;112936;6653;84881;50863;27034;55800;90952;219858;219833;63876;100169851;283162;283160;390259;390271;219844;23365;64221;390265;220296;1111;50937;28960;219938;4900;79864;6309;219854;390275;120224;7753;29087;2313;219899;57476;334;219869;4013;23584;390260;414899;84897;79827;54414;219865;283159;116337;4798;399968;27087;26492;6484;8538;170689;54538;9538;29118;399979;3312;390264;6734;84959;219902;3762;4978;2113;338662;23310;112937;3703;25833;11095;219855;80071;160065;338661;29068;220323,111
-1,1,11,119950851,125699001,5748150,219874;53340;2900;26595;7007;219873;23650;56253;403312;219870;219875;399967;56;390261;26493;9638;79684;641654;6653;55800;90952;219858;63876;100169851;283162;219899;390259;283160;390271;23365;4900;390265;64221;220296;1111;79864;6309;219854;390275;7753;57476;219869;4013;23584;390260;414899;84897;79827;54414;219865;283159;116337;26492;54538;9538;3312;390264;84959;219902;338662;3703;25833;219855;80071;160065;338661;220323,67
-1,1,11,120296802,124641109,4344307,6309;390275;7753;219874;53340;2900;26595;7007;57476;219873;219869;4013;23584;390260;56253;414899;79827;84897;54414;219865;219870;219875;283159;116337;390261;26492;26493;79684;3312;6653;390264;84959;55800;90952;338662;219858;283162;219899;390259;283160;390271;23365;4900;390265;338661;79864,46
-1,1,11,120386468,134945165,14558697,219874;53340;2900;63970;9743;84623;26595;7007;219873;89944;283171;56253;403312;219870;56980;219875;55572;83700;6768;399967;56;79607;390261;3758;26493;22997;9638;83480;114609;79684;641654;112936;6653;84881;50863;27034;55800;90952;219858;219833;63876;100169851;283162;283160;390259;390271;64221;220296;219844;390265;1111;50937;28960;219938;4900;79864;6309;219854;390275;120224;7753;29087;2313;219899;57476;334;219869;4013;23584;390260;414899;84897;79827;54414;219865;283159;116337;4798;399968;27087;26492;6484;8538;170689;54538;9538;29118;399979;3312;390264;6734;84959;3762;4978;2113;338662;23310;112937;3703;11095;219855;80071;160065;338661;29068,105
-1,1,11,120527021,134938470,14411449,219874;53340;2900;63970;9743;84623;26595;7007;219873;89944;283171;56253;403312;219870;56980;219875;55572;83700;6768;399967;56;79607;390261;3758;26493;22997;9638;83480;114609;79684;641654;112936;6653;84881;50863;27034;55800;90952;219858;219833;63876;100169851;283162;283160;390259;390271;64221;220296;219844;390265;1111;50937;28960;219938;4900;79864;6309;219854;390275;120224;7753;29087;2313;219899;57476;334;219869;4013;23584;390260;414899;84897;79827;54414;219865;283159;116337;4798;399968;27087;26492;6484;8538;170689;54538;9538;29118;399979;3312;390264;6734;84959;3762;4978;2113;338662;23310;112937;3703;11095;219855;80071;160065;338661;29068,105
-1,1,11,121136603,134938470,13801867,219874;53340;63970;9743;84623;26595;219873;89944;283171;56253;403312;219870;56980;219875;55572;83700;6768;399967;56;79607;390261;3758;26493;22997;9638;83480;114609;79684;641654;112936;6653;84881;50863;27034;55800;90952;219858;219833;63876;100169851;283162;283160;390259;390271;64221;220296;219844;390265;1111;50937;28960;219938;4900;79864;6309;219854;390275;120224;7753;29087;2313;57476;334;219869;4013;23584;390260;414899;84897;79827;54414;219865;283159;116337;4798;399968;27087;26492;6484;8538;170689;54538;9538;29118;399979;3312;390264;6734;84959;3762;4978;2113;338662;23310;112937;3703;11095;219855;80071;160065;338661;29068,102
-1,1,11,121416261,134938470,13522209,219874;53340;63970;9743;84623;26595;219873;89944;283171;56253;403312;219870;56980;219875;55572;83700;6768;399967;56;79607;390261;3758;26493;22997;9638;83480;114609;79684;641654;112936;6653;50863;84881;27034;55800;90952;219858;219833;63876;100169851;283162;283160;390259;390271;64221;220296;219844;390265;1111;50937;28960;219938;4900;79864;219854;390275;120224;7753;29087;2313;57476;334;219869;4013;23584;390260;414899;84897;79827;54414;219865;283159;116337;4798;399968;27087;26492;6484;8538;170689;54538;9538;29118;399979;3312;390264;6734;84959;3762;4978;2113;338662;23310;112937;3703;11095;219855;80071;160065;338661;29068,101
-1,1,11,121482185,134938470,13456285,219874;53340;63970;9743;84623;26595;219873;89944;283171;56253;403312;219870;56980;219875;55572;83700;6768;399967;56;79607;390261;3758;26493;22997;9638;83480;114609;79684;641654;112936;6653;50863;84881;27034;55800;90952;219858;219833;63876;100169851;283162;283160;390259;390271;64221;220296;219844;390265;1111;50937;28960;219938;4900;79864;219854;390275;120224;7753;29087;2313;57476;334;219869;4013;23584;390260;414899;84897;79827;54414;219865;283159;116337;4798;399968;27087;26492;6484;8538;170689;54538;9538;29118;399979;3312;390264;6734;84959;3762;4978;2113;338662;23310;112937;3703;11095;219855;80071;160065;338661;29068,101
-1,1,11,121501072,134868348,13367276,219874;53340;63970;9743;84623;26595;219873;89944;283171;56253;403312;219870;56980;219875;55572;83700;6768;399967;56;79607;390261;3758;26493;22997;9638;83480;114609;79684;641654;112936;6653;50863;84881;27034;55800;90952;219858;219833;63876;100169851;283162;283160;390259;390271;64221;220296;219844;390265;1111;50937;28960;219938;4900;79864;219854;390275;120224;7753;29087;2313;57476;334;219869;4013;23584;390260;414899;84897;79827;54414;219865;283159;116337;4798;399968;27087;26492;6484;8538;170689;54538;9538;29118;399979;3312;390264;6734;84959;3762;4978;2113;338662;23310;112937;3703;11095;219855;80071;160065;338661;29068,101
-1,1,11,121559102,134938470,13379368,219874;53340;63970;9743;84623;26595;219873;89944;283171;56253;403312;219870;56980;219875;55572;83700;6768;399967;56;79607;390261;3758;26493;22997;9638;83480;114609;79684;641654;112936;50863;84881;27034;55800;90952;219858;219833;63876;100169851;283162;283160;390259;390271;64221;220296;219844;390265;1111;50937;28960;219938;4900;79864;219854;390275;120224;7753;29087;2313;57476;334;219869;4013;23584;390260;414899;84897;79827;54414;219865;283159;116337;4798;399968;27087;26492;6484;8538;170689;54538;9538;29118;399979;3312;390264;6734;84959;3762;4978;2113;338662;23310;112937;3703;11095;219855;80071;160065;338661;29068,100
-1,1,11,121559760,134945165,13385405,219874;53340;63970;9743;84623;26595;219873;89944;283171;56253;403312;219870;56980;219875;55572;83700;6768;399967;56;79607;390261;3758;26493;22997;9638;83480;114609;79684;641654;112936;50863;84881;27034;55800;90952;219858;219833;63876;100169851;283162;283160;390259;390271;64221;220296;219844;390265;1111;50937;28960;219938;4900;79864;219854;390275;120224;7753;29087;2313;57476;334;219869;4013;23584;390260;414899;84897;79827;54414;219865;283159;116337;4798;399968;27087;26492;6484;8538;170689;54538;9538;29118;399979;3312;390264;6734;84959;3762;4978;2113;338662;23310;112937;3703;11095;219855;80071;160065;338661;29068,100
-1,1,11,121651167,134945165,13293998,219874;53340;63970;9743;84623;26595;219873;89944;283171;56253;403312;219870;56980;219875;55572;83700;6768;399967;56;79607;390261;3758;26493;22997;9638;83480;114609;79684;641654;112936;50863;84881;27034;55800;90952;219858;219833;63876;100169851;283162;283160;390259;390271;64221;220296;219844;390265;1111;50937;28960;219938;4900;79864;219854;390275;120224;7753;29087;2313;57476;334;219869;4013;23584;390260;414899;84897;79827;54414;219865;283159;116337;4798;399968;27087;26492;6484;8538;170689;54538;9538;29118;399979;3312;390264;6734;84959;3762;4978;2113;338662;23310;112937;3703;11095;219855;80071;160065;338661;29068,100
-1,1,11,121677255,134938470,13261215,219874;53340;63970;9743;84623;26595;219873;89944;283171;56253;403312;219870;56980;219875;55572;83700;6768;399967;56;79607;390261;3758;26493;22997;9638;83480;114609;79684;641654;112936;50863;84881;27034;55800;90952;219858;219833;63876;100169851;283162;283160;390259;390271;64221;220296;219844;390265;1111;50937;28960;219938;4900;79864;219854;390275;120224;7753;29087;2313;57476;334;219869;4013;23584;390260;414899;84897;79827;54414;219865;283159;116337;4798;399968;27087;26492;6484;8538;170689;54538;9538;29118;399979;3312;390264;6734;84959;3762;4978;2113;338662;23310;112937;3703;11095;219855;80071;160065;338661;29068,100
-1,1,11,121679628,134946516,13266888,219874;53340;63970;9743;84623;26595;219873;89944;283171;56253;403312;219870;56980;219875;55572;83700;6768;399967;56;79607;390261;3758;26493;22997;9638;83480;114609;79684;641654;112936;50863;84881;27034;55800;90952;219858;219833;63876;100169851;283162;283160;390259;390271;64221;220296;219844;390265;1111;50937;28960;219938;4900;79864;219854;390275;120224;7753;29087;2313;57476;334;219869;4013;23584;390260;414899;84897;79827;54414;219865;283159;116337;4798;399968;27087;26492;6484;8538;170689;54538;9538;29118;399979;3312;390264;6734;84959;3762;4978;2113;338662;23310;112937;3703;11095;219855;80071;160065;338661;29068,100
-1,1,11,122053151,125827872,3774721,219854;390275;7753;219874;53340;26595;57476;219873;219869;4013;23584;390260;56253;84897;79827;54414;403312;219865;219870;219875;283159;116337;399967;399968;56;390261;26492;26493;9638;83480;54538;9538;79684;29118;3312;641654;390264;84959;100169851;55800;90952;338662;219858;63876;283162;3703;283160;390259;390271;4900;64221;220296;390265;219855;1111;219844;50937;80071;160065;338661;79864,61
-1,1,11,122403610,134938470,12534860,219874;53340;63970;9743;84623;26595;219873;89944;283171;56253;403312;219870;56980;219875;55572;83700;6768;399967;56;79607;390261;3758;26493;22997;9638;83480;114609;79684;641654;112936;50863;84881;27034;55800;90952;219858;219833;63876;100169851;283162;283160;390259;390271;64221;220296;219844;390265;1111;50937;28960;219938;4900;79864;219854;390275;120224;7753;29087;2313;57476;334;219869;4013;23584;390260;84897;79827;54414;219865;283159;116337;4798;399968;27087;26492;6484;8538;170689;54538;9538;29118;399979;3312;390264;6734;84959;3762;4978;2113;338662;23310;112937;3703;11095;219855;80071;160065;338661;29068,99
1,1,11,122884694,134938470,12053776,219874;53340;63970;9743;84623;26595;219873;89944;283171;403312;219870;56980;219875;55572;83700;6768;399967;56;79607;390261;3758;26493;22997;9638;83480;114609;79684;641654;112936;50863;84881;27034;55800;90952;219858;219833;63876;100169851;283162;283160;64221;390271;220296;219844;50937;390265;1111;28960;4900;219938;219854;390275;120224;7753;29087;2313;57476;334;219869;4013;23584;390260;84897;79827;54414;219865;283159;116337;4798;399968;27087;26492;6484;8538;170689;54538;9538;29118;399979;3312;390264;6734;3762;4978;2113;338662;23310;112937;3703;11095;219855;80071;160065;338661;29068,95
-1,1,11,123670646,134868420,11197774,219874;53340;63970;9743;84623;26595;219873;89944;283171;403312;219870;56980;219875;55572;83700;6768;399967;56;79607;390261;3758;26493;22997;9638;83480;114609;79684;641654;112936;50863;84881;27034;90952;219858;219833;63876;100169851;283162;283160;64221;390271;220296;219844;50937;390265;1111;28960;4900;219938;219854;390275;120224;29087;2313;334;219869;4013;23584;84897;54414;219865;283159;116337;4798;399968;27087;26492;6484;8538;170689;54538;9538;29118;399979;390264;6734;3762;4978;2113;338662;23310;112937;3703;11095;219855;80071;160065;338661;29068,89
-1,1,11,123833781,134945165,11111384,53340;63970;9743;84623;26595;219873;89944;283171;403312;219870;56980;55572;83700;6768;399967;56;79607;3758;26493;22997;9638;83480;114609;79684;641654;112936;50863;84881;27034;90952;219858;219833;63876;100169851;283162;283160;64221;390271;220296;219844;50937;390265;1111;28960;4900;219938;219854;390275;120224;29087;2313;334;219869;4013;23584;84897;54414;219865;283159;116337;4798;399968;27087;26492;6484;8538;170689;54538;9538;29118;399979;390264;6734;3762;4978;2113;23310;112937;3703;11095;219855;80071;160065;29068,84
-1,1,11,123860285,134868407,11008122,53340;63970;9743;84623;26595;89944;283171;403312;219870;56980;55572;83700;6768;399967;56;79607;3758;26493;22997;9638;83480;114609;79684;641654;112936;50863;84881;27034;90952;219858;219833;63876;100169851;283162;283160;64221;390271;220296;219844;50937;390265;1111;28960;4900;219938;219854;390275;120224;29087;2313;334;219869;4013;23584;84897;54414;219865;283159;116337;4798;399968;27087;26492;6484;8538;170689;54538;9538;29118;399979;390264;6734;3762;4978;2113;23310;112937;3703;11095;219855;80071;160065;29068,83
-1,1,11,124075932,134868420,10792488,53340;63970;9743;84623;26595;89944;283171;403312;56980;55572;83700;6768;399967;56;79607;3758;26493;22997;9638;83480;114609;79684;641654;112936;50863;84881;27034;90952;219858;219833;63876;100169851;283162;283160;64221;390271;220296;219844;50937;4900;1111;28960;219938;219854;390275;120224;29087;2313;334;23584;84897;54414;219865;283159;116337;4798;399968;27087;26492;6484;8538;170689;54538;9538;29118;399979;6734;3762;4978;2113;23310;112937;3703;11095;219855;80071;160065;29068,78
-1,1,11,124184921,134688010,10503089,53340;63970;9743;84623;26595;89944;283171;403312;56980;55572;83700;399967;6768;56;79607;3758;26493;22997;9638;83480;114609;79684;641654;112936;50863;84881;27034;90952;219858;219833;63876;283162;100169851;283160;4900;390271;64221;220296;219844;50937;1111;28960;219938;219854;390275;120224;29087;2313;334;23584;84897;54414;116337;4798;399968;27087;6484;8538;170689;54538;9538;29118;399979;6734;3762;4978;2113;23310;112937;3703;11095;219855;80071;160065;29068,75
-1,1,11,124254553,125315622,1061069,219854;390275;54538;53340;79684;641654;23584;84897;90952;54414;219858;63876;116337;283162;4900;64221;390271;220296;219855;80071;26493,21
-1,1,11,124809955,134945165,10135210,219854;120224;9743;63970;2313;29087;84623;334;89944;283171;403312;56980;55572;4798;399967;6768;83700;399968;56;79607;27087;3758;22997;6484;9638;8538;170689;83480;9538;114609;29118;399979;112936;6734;84881;50863;27034;3762;4978;2113;219833;23310;63876;112937;100169851;3703;219844;50937;219855;1111;28960;11095;219938;80071;160065;29068,56
-1,1,11,125111368,134868407,9757039,120224;9743;63970;2313;29087;84623;334;89944;283171;403312;56980;55572;4798;399967;6768;83700;399968;56;79607;27087;3758;22997;6484;9638;8538;170689;83480;9538;114609;29118;399979;112936;6734;84881;50863;27034;3762;4978;2113;219833;23310;63876;112937;100169851;3703;219844;50937;11095;1111;28960;219938;160065;29068,53
-1,1,11,125662934,134938470,9275536,120224;9743;63970;2313;29087;84623;334;89944;283171;56980;55572;4798;6768;83700;399968;79607;27087;3758;22997;6484;8538;170689;83480;114609;29118;399979;112936;6734;84881;50863;27034;3762;4978;2113;219833;23310;112937;219844;50937;11095;219938;28960;29068,43
-1,1,11,125780310,128942331,3162021,6484;114609;63970;2313;9743;84623;29118;6734;84881;3762;2113;219833;55572;50937;28960;79607;3758,17
-1,1,11,125916253,134868407,8952154,120224;9743;63970;2313;29087;84623;334;89944;283171;56980;55572;4798;6768;83700;79607;27087;3758;22997;6484;8538;170689;114609;399979;112936;6734;84881;50863;27034;3762;4978;2113;219833;23310;112937;50937;11095;219938;28960;29068,39
-1,1,11,125916253,134945165,9028912,120224;9743;63970;2313;29087;84623;334;89944;283171;56980;55572;4798;6768;83700;79607;27087;3758;22997;6484;8538;170689;114609;399979;112936;6734;84881;50863;27034;3762;4978;2113;219833;23310;112937;50937;11095;219938;28960;29068,39
-1,1,11,126069484,134945165,8875681,120224;9743;63970;2313;29087;84623;334;89944;283171;56980;55572;4798;6768;83700;79607;27087;3758;22997;6484;8538;170689;114609;399979;112936;6734;84881;50863;27034;3762;4978;2113;219833;23310;112937;11095;219938;28960;29068,38
-1,1,11,126762944,134938470,8175526,8538;170689;120224;9743;63970;2313;29087;84623;399979;334;112936;50863;89944;283171;27034;3762;4978;2113;219833;56980;23310;112937;4798;6768;83700;11095;219938;29068;27087;3758;22997,31
-1,1,11,127434377,134945165,7510788,8538;170689;120224;9743;63970;2313;29087;399979;334;112936;50863;89944;283171;27034;3762;4978;2113;219833;56980;23310;112937;4798;6768;83700;11095;219938;29068;27087;3758;22997,30
-1,1,11,127785859,134938470,7152611,8538;170689;120224;9743;63970;2313;29087;399979;334;112936;50863;89944;283171;27034;3762;4978;2113;219833;56980;23310;112937;4798;6768;83700;11095;219938;29068;27087;3758;22997,30
-1,1,11,129721809,134938470,5216661,170689;120224;29087;399979;334;112936;50863;89944;283171;27034;4978;56980;23310;112937;4798;6768;83700;11095;219938;29068;27087;22997,22
-1,1,11,130576399,134945165,4368766,4978;23310;112937;29087;83700;399979;112936;219938;50863;89944;283171;27034;27087;22997,14
-1,1,11,131081923,134945165,3863242,4978;23310;112937;29087;83700;112936;219938;50863;89944;27034;27087;22997,12
-1,1,11,131426397,134938470,3512073,4978;23310;112937;29087;83700;112936;219938;50863;89944;27034;27087;22997,12
-1,1,11,132806620,134868407,2061787,4978;23310;112937;29087;83700;112936;219938;89944;27034;27087;22997,11
-1,-1,11,133546203,133626429,80226,,0
1,-1,11,134157357,134207815,50458,89944;112937,2
1,-1,11,134157357,134207815,50458,89944;112937,2
-1,-1,11,134157357,134207815,50458,89944;112937,2
-1,-1,11,134157357,134207815,50458,89944;112937,2
-1,-1,11,134157357,134207815,50458,89944;112937,2
-1,-1,11,134157357,134207815,50458,89944;112937,2
-1,-1,11,134157357,134207815,50458,89944;112937,2
1,-1,11,134157357,134228038,70681,89944;112937,2
-1,1,11,134247841,134938470,690629,27087,1
1,-1,11,134300576,134711672,411096,,0
1,-1,11,134300598,134720418,419820,,0
1,-1,11,134353814,134711613,357799,,0
1,-1,11,134353814,134711613,357799,,0
1,-1,11,134353814,134711613,357799,,0
1,-1,11,134353814,134711613,357799,,0
1,-1,11,134353814,134711613,357799,,0
1,-1,11,134353814,134711613,357799,,0
1,-1,11,134353814,134711613,357799,,0
1,-1,11,134353814,134711613,357799,,0
1,-1,11,134353814,134711613,357799,,0
1,-1,11,134353814,134711613,357799,,0
1,-1,11,134353814,134711613,357799,,0
-1,-1,11,134381632,134446101,64469,,0
1,-1,11,134381632,134711672,330040,,0
1,-1,11,134381632,134711672,330040,,0
1,-1,11,134381632,134711672,330040,,0
1,-1,11,134381632,134711672,330040,,0
1,-1,11,134381632,134711672,330040,,0
1,-1,11,134381632,134711672,330040,,0
1,-1,11,134381632,134711672,330040,,0
1,-1,11,134381632,134711672,330040,,0
1,-1,11,134381632,134720344,338712,,0
-1,-1,11,134381662,134446131,64469,,0
1,-1,11,134381667,134720418,338751,,0
1,-1,11,134381667,134720418,338751,,0
1,-1,11,134381667,134720418,338751,,0
1,-1,11,134381667,134720418,338751,,0
1,-1,11,134381667,134720418,338751,,0
1,-1,11,134381667,134720418,338751,,0
1,-1,11,134381667,134720418,338751,,0
1,-1,11,134381667,134720418,338751,,0
1,-1,11,134381667,134720418,338751,,0
1,-1,11,134381667,134720418,338751,,0
-1,-1,11,134381667,134868420,486753,,0
1,-1,11,134479138,134662766,183628,,0
1,-1,11,134555490,134737625,182135,,0
-1,-1,11,134668757,134904181,235424,,0
1,-1,11,134711613,134816320,104707,,0
1,-1,11,134711613,134816320,104707,,0
1,-1,11,134737566,134816413,78847,,0
1,-1,11,134778896,134945106,166210,,0
1,-1,11,134816261,134890799,74538,,0
1,-1,12,70794,230421,159627,440073,1
1,-1,12,91682,176861,85179,440073,1
1,1,12,147099,7054359,6907260,4704;55846;2784;57101;6337;1822;171017;654429;83461;928;5927;920;57121;55080;10233;283358;894;1108;5763;81029;2251;83695;775;84318;3736;50813;55200;10867;3902;9918;7450;196513;4908;27239;57097;3741;7167;7132;5893;2288;51147;84519;84727;6540;84766;2597;7289;83714;93589;939;57102;8798;10566;10635;6843;8078;8079;26290;113246;7004;6539;440073;56341;10536;4055;4839;196500;2305;4815;51258;144699;8074;25900;65125;23085;3742;57103;79602;2026,79
1,-1,12,148034,176816,28782,440073,1
1,-1,12,148034,176816,28782,440073,1
1,-1,12,148034,176816,28782,440073,1
1,-1,12,148034,176816,28782,440073,1
1,-1,12,148034,176816,28782,440073,1
1,-1,12,148034,176816,28782,440073,1
1,-1,12,148034,176816,28782,440073,1
1,-1,12,148034,176816,28782,440073,1
1,-1,12,148034,176816,28782,440073,1
1,1,12,148375,37864477,37716102,4704;83857;144195;25977;2842;6337;65981;1822;4040;259295;10060;121512;144568;51026;10233;6660;1108;50865;55500;2998;10599;26127;3736;8302;259294;23012;50813;10867;22914;55359;23710;121504;5545;57097;5149;1911;441631;55907;2984;3375;10219;4257;83445;397;51071;79785;79365;51768;8078;55729;26290;387849;196500;55766;160364;93661;2305;50838;8496;728858;3823;80824;55259;89869;60488;5800;1389;121536;51067;57542;160492;79887;928;144608;5318;3822;55810;283358;2;1027;586;5288;2251;55200;440093;9976;196513;5858;160365;27239;50836;93978;64581;83758;9573;9847;338339;7167;7132;11331;341392;653247;341346;2288;51147;84519;84727;84766;2597;7289;51290;56938;83714;51729;9412;10635;6843;8079;81575;6539;440073;10536;4055;359787;6489;6515;55138;118426;420;11171;8074;55297;29121;3742;51267;57103;2026;387836;51202;51266;11228;2784;3709;51279;57101;3821;2120;5965;171017;50856;5927;920;636;144363;57121;55080;26253;715;894;259296;645177;81029;100431172;84318;55507;3845;259292;3902;85004;6579;5777;196394;4908;55726;53919;4973;283316;55196;5544;28234;100129361;57102;10566;3764;113246;7004;54477;1663;341359;55110;4033;4815;51258;106707243;55885;160518;10162;360030;51348;8076;79602;5554;10526;283420;55846;10436;2059;79912;9332;654429;83461;58516;2012;120939;84920;259289;57379;4074;79923;57613;5763;83695;387837;254013;775;2904;729025;55711;259290;100528032;440087;3820;170482;100287284;259293;9918;7450;57494;196415;8082;9052;3741;80763;338821;5893;5555;79370;6540;54682;93589;5830;939;8798;3824;50835;8531;353164;4256;121506;50839;56341;4839;10059;50837;719;716;341350;50840;9746;144699;11272;5542;25900;65125;969;3945;5744;440077;339;23085;5139,281
-1,1,12,173786,2865649,2691863,283358;6539;440073;5893;81029;775;4815;84318;6540;144699;654429;5927;93589;65125;196513;23085;79602,17
-1,1,12,173786,5737510,5563724,3741;4704;55846;5893;2288;57103;6540;84766;57101;7289;654429;5927;83714;93589;57102;8798;10566;10635;26290;283358;6539;440073;7004;56341;894;81029;2251;83695;775;2305;4815;84318;3736;144699;10867;8074;65125;196513;4908;23085;3742;57097;79602,43
-1,1,12,173786,6378954,6205168,3741;4704;55846;5893;2288;57103;6540;84766;57101;7289;654429;928;5927;83714;93589;57102;8798;10566;10635;26290;283358;6539;440073;7004;56341;894;81029;2251;83695;775;2305;4815;84318;3736;144699;10867;7450;8074;65125;196513;4908;23085;3742;57097;79602,45
1,1,12,173786,8257049,8083263,4704;144195;55846;10436;25977;2784;51279;57101;6337;1822;171017;9332;654429;83461;928;5927;920;57121;79923;55080;55810;10233;715;283358;894;1108;5763;81029;2251;83695;775;84318;3736;50813;55200;170482;10867;3902;9918;7450;5777;196513;4908;27239;83758;9573;57097;3741;7167;7132;11331;283316;341392;5893;2288;51147;84519;84727;6540;84766;2597;7289;83714;93589;5830;939;57102;8798;10566;10635;6843;8078;8079;26290;113246;7004;6539;440073;56341;10536;4055;4839;359787;196500;6515;719;2305;4815;716;51258;9746;144699;10162;360030;8074;25900;65125;339;23085;3742;57103;79602;2026,103
1,1,12,173786,11677456,11503670,387836;4704;51266;144195;25977;2784;51267;51279;57101;6337;3821;1822;171017;50856;5927;920;259295;57121;55080;26253;144568;10233;715;894;1108;259296;81029;100431172;84318;3736;8302;259294;259292;50813;10867;3902;5777;22914;55359;4908;23710;5545;57097;4973;283316;1911;5544;10219;100129361;57102;10566;8078;26290;113246;7004;196500;160364;55110;2305;50838;4815;51258;106707243;10162;360030;3823;51348;8076;79602;5554;283420;55846;10436;9332;654429;83461;928;120939;259289;57379;4074;79923;3822;55810;283358;2;5763;2251;83695;387837;775;259290;100528032;3820;55200;170482;259293;9918;7450;9976;196513;5858;160365;27239;57494;50836;93978;64581;83758;9573;338339;3741;7167;7132;11331;341392;653247;5893;2288;51147;5555;84519;84727;6540;84766;2597;7289;83714;93589;5830;939;8798;3824;50835;8531;353164;10635;6843;8079;50839;6539;440073;56341;10536;4055;4839;359787;50837;6515;719;55138;716;50840;9746;144699;11272;5542;8074;25900;65125;969;440077;339;29121;23085;3742;57103;2026,168
1,1,12,173786,20026080,19852294,387836;51202;4704;51266;144195;25977;2784;2842;51267;51279;57101;6337;3821;2120;1822;171017;50856;5927;920;4040;259295;57121;55080;26253;144568;10233;715;894;1108;259296;50865;81029;100431172;84318;3736;8302;259294;55507;259292;50813;10867;3902;85004;5777;22914;55359;4908;23710;121504;5545;57097;5149;4973;283316;1911;5544;2984;10219;4257;83445;100129361;57102;397;10566;51071;79785;8078;55729;26290;113246;7004;54477;196500;55766;160364;55110;93661;2305;50838;4815;51258;106707243;55885;10162;360030;3823;80824;89869;51348;5800;8076;79602;5554;1389;283420;55846;10436;2059;121536;9332;654429;83461;79887;928;2012;120939;144608;259289;57379;4074;79923;3822;55810;283358;2;1027;57613;5288;5763;2251;83695;387837;775;2904;729025;259290;100528032;440087;3820;55200;170482;259293;9918;7450;9976;196513;5858;160365;27239;57494;50836;93978;64581;83758;9573;338339;9052;3741;7167;7132;11331;341392;653247;5893;2288;51147;5555;84519;84727;6540;84766;2597;79370;7289;54682;83714;93589;5830;939;51729;8798;3824;50835;8531;353164;10635;6843;4256;121506;8079;50839;81575;6539;440073;56341;10536;4055;4839;359787;50837;6515;719;55138;118426;716;50840;9746;144699;11272;420;5542;11171;8074;25900;65125;969;440077;339;29121;23085;3742;57103;2026,213
1,1,12,173786,25286865,25113079,387836;51202;4704;51266;144195;25977;2784;2842;51267;51279;57101;6337;3821;2120;5965;1822;171017;50856;5927;920;4040;259295;57121;10060;55080;26253;144568;51026;10233;715;6660;894;1108;259296;50865;55500;645177;2998;81029;10599;100431172;84318;3736;8302;259294;55507;259292;50813;10867;3902;85004;6579;5777;22914;55359;4908;53919;23710;121504;5545;57097;5149;4973;283316;1911;5544;55907;2984;3375;10219;4257;28234;83445;100129361;57102;397;10566;3764;51071;79785;8078;55729;26290;113246;7004;54477;196500;55766;160364;55110;93661;2305;4033;50838;4815;51258;106707243;55885;10162;360030;3823;80824;55259;89869;51348;5800;8076;79602;5554;1389;283420;55846;10436;2059;121536;79912;9332;654429;83461;79887;928;2012;120939;144608;259289;57379;4074;79923;3822;55810;283358;2;1027;57613;5288;5763;2251;586;83695;387837;775;2904;729025;259290;100528032;440087;3820;55200;170482;259293;9918;7450;9976;196513;5858;160365;27239;57494;50836;196415;93978;64581;83758;9573;9847;338339;9052;3741;7167;80763;7132;11331;338821;341392;653247;5893;2288;51147;5555;84519;84727;6540;84766;2597;79370;7289;54682;83714;93589;5830;939;51729;8798;3824;50835;8531;353164;10635;6843;4256;121506;8079;50839;81575;6539;440073;56341;10536;4055;4839;359787;50837;6515;719;55138;6489;118426;716;50840;9746;144699;11272;420;5542;11171;8074;25900;65125;969;3945;440077;339;29121;23085;3742;57103;5139;2026,238
1,1,12,173786,28219229,28045443,4704;144195;25977;2842;6337;1822;4040;259295;10060;144568;51026;10233;6660;1108;50865;55500;2998;10599;26127;3736;8302;259294;23012;50813;10867;22914;55359;23710;121504;5545;57097;5149;1911;55907;2984;3375;10219;4257;83445;397;51071;79785;79365;51768;8078;55729;26290;387849;196500;55766;160364;93661;2305;50838;8496;728858;3823;80824;55259;89869;60488;5800;1389;121536;57542;160492;79887;928;144608;3822;55810;283358;2;1027;586;5288;2251;55200;9976;196513;5858;160365;27239;50836;93978;64581;83758;9573;9847;338339;7167;7132;11331;341392;653247;341346;2288;51147;84519;84727;84766;2597;7289;56938;83714;51729;9412;10635;6843;8079;81575;6539;440073;10536;4055;359787;6489;6515;55138;118426;420;11171;8074;29121;3742;51267;57103;2026;387836;51202;51266;11228;2784;3709;51279;57101;3821;2120;5965;171017;50856;5927;920;144363;57121;55080;26253;715;894;259296;645177;81029;100431172;84318;55507;3845;259292;3902;85004;6579;5777;4908;55726;53919;4973;283316;5544;28234;100129361;57102;10566;3764;113246;7004;54477;55110;4033;4815;51258;106707243;55885;10162;360030;51348;8076;79602;5554;283420;55846;10436;2059;79912;9332;654429;83461;2012;120939;259289;57379;4074;79923;57613;5763;83695;387837;775;2904;729025;259290;100528032;440087;3820;170482;100287284;259293;9918;7450;57494;196415;8082;9052;3741;80763;338821;5893;5555;79370;6540;54682;93589;5830;939;8798;3824;50835;8531;353164;4256;121506;50839;56341;4839;50837;719;716;50840;9746;144699;11272;5542;25900;65125;969;3945;5744;440077;339;23085;5139,259
1,1,12,173786,34835837,34662051,4704;83857;144195;25977;2842;6337;65981;1822;4040;259295;10060;121512;144568;51026;10233;6660;1108;50865;55500;2998;10599;26127;3736;8302;259294;23012;50813;10867;22914;55359;23710;121504;5545;57097;5149;1911;441631;55907;2984;3375;10219;4257;83445;397;51071;79785;79365;51768;8078;55729;26290;387849;196500;55766;160364;93661;2305;50838;8496;728858;3823;80824;55259;89869;60488;5800;1389;121536;51067;57542;160492;79887;928;144608;5318;3822;55810;283358;2;1027;586;5288;2251;55200;440093;9976;196513;5858;160365;27239;50836;93978;64581;83758;9573;9847;338339;7167;7132;11331;341392;653247;341346;2288;51147;84519;84727;84766;2597;7289;51290;56938;83714;51729;9412;10635;6843;8079;81575;6539;440073;10536;4055;359787;6489;6515;55138;118426;420;11171;8074;55297;29121;3742;51267;57103;2026;387836;51202;51266;11228;2784;3709;51279;57101;3821;2120;5965;171017;50856;5927;920;636;144363;57121;55080;26253;715;894;259296;645177;81029;100431172;84318;55507;3845;259292;3902;85004;6579;5777;196394;4908;55726;53919;4973;283316;55196;5544;28234;100129361;57102;10566;3764;113246;7004;54477;1663;341359;55110;4033;4815;51258;106707243;55885;160518;10162;360030;51348;8076;79602;5554;10526;283420;55846;10436;2059;79912;9332;654429;83461;58516;2012;120939;84920;259289;57379;4074;79923;57613;5763;83695;387837;254013;775;2904;729025;55711;259290;100528032;440087;3820;170482;100287284;259293;9918;7450;57494;196415;8082;9052;3741;80763;338821;5893;5555;79370;6540;54682;93589;5830;939;8798;3824;50835;8531;353164;4256;121506;50839;56341;4839;10059;50837;719;716;341350;50840;9746;144699;11272;5542;25900;65125;969;3945;5744;440077;339;23085;5139,281
1,1,12,173786,34835837,34662051,4704;83857;144195;25977;2842;6337;65981;1822;4040;259295;10060;121512;144568;51026;10233;6660;1108;50865;55500;2998;10599;26127;3736;8302;259294;23012;50813;10867;22914;55359;23710;121504;5545;57097;5149;1911;441631;55907;2984;3375;10219;4257;83445;397;51071;79785;79365;51768;8078;55729;26290;387849;196500;55766;160364;93661;2305;50838;8496;728858;3823;80824;55259;89869;60488;5800;1389;121536;51067;57542;160492;79887;928;144608;5318;3822;55810;283358;2;1027;586;5288;2251;55200;440093;9976;196513;5858;160365;27239;50836;93978;64581;83758;9573;9847;338339;7167;7132;11331;341392;653247;341346;2288;51147;84519;84727;84766;2597;7289;51290;56938;83714;51729;9412;10635;6843;8079;81575;6539;440073;10536;4055;359787;6489;6515;55138;118426;420;11171;8074;55297;29121;3742;51267;57103;2026;387836;51202;51266;11228;2784;3709;51279;57101;3821;2120;5965;171017;50856;5927;920;636;144363;57121;55080;26253;715;894;259296;645177;81029;100431172;84318;55507;3845;259292;3902;85004;6579;5777;196394;4908;55726;53919;4973;283316;55196;5544;28234;100129361;57102;10566;3764;113246;7004;54477;1663;341359;55110;4033;4815;51258;106707243;55885;160518;10162;360030;51348;8076;79602;5554;10526;283420;55846;10436;2059;79912;9332;654429;83461;58516;2012;120939;84920;259289;57379;4074;79923;57613;5763;83695;387837;254013;775;2904;729025;55711;259290;100528032;440087;3820;170482;100287284;259293;9918;7450;57494;196415;8082;9052;3741;80763;338821;5893;5555;79370;6540;54682;93589;5830;939;8798;3824;50835;8531;353164;4256;121506;50839;56341;4839;10059;50837;719;716;341350;50840;9746;144699;11272;5542;25900;65125;969;3945;5744;440077;339;23085;5139,281
1,1,12,173786,37869301,37695515,4704;83857;144195;25977;2842;6337;65981;1822;4040;259295;10060;121512;144568;51026;10233;6660;1108;50865;55500;2998;10599;26127;3736;8302;259294;23012;50813;10867;22914;55359;23710;121504;5545;57097;5149;1911;441631;55907;2984;3375;10219;4257;83445;397;51071;79785;79365;51768;8078;55729;26290;387849;196500;55766;160364;93661;2305;50838;8496;728858;3823;80824;55259;89869;60488;5800;1389;121536;51067;57542;160492;79887;928;144608;5318;3822;55810;283358;2;1027;586;5288;2251;55200;440093;9976;196513;5858;160365;27239;50836;93978;64581;83758;9573;9847;338339;7167;7132;11331;341392;653247;341346;2288;51147;84519;84727;84766;2597;7289;51290;56938;83714;51729;9412;10635;6843;8079;81575;6539;440073;10536;4055;359787;6489;6515;55138;118426;420;11171;8074;55297;29121;3742;51267;57103;2026;387836;51202;51266;11228;2784;3709;51279;57101;3821;2120;5965;171017;50856;5927;920;636;144363;57121;55080;26253;715;894;259296;645177;81029;100431172;84318;55507;3845;259292;3902;85004;6579;5777;196394;4908;55726;53919;4973;283316;55196;5544;28234;100129361;57102;10566;3764;113246;7004;54477;1663;341359;55110;4033;4815;51258;106707243;55885;160518;10162;360030;51348;8076;79602;5554;10526;283420;55846;10436;2059;79912;9332;654429;83461;58516;2012;120939;84920;259289;57379;4074;79923;57613;5763;83695;387837;254013;775;2904;729025;55711;259290;100528032;440087;3820;170482;100287284;259293;9918;7450;57494;196415;8082;9052;3741;80763;338821;5893;5555;79370;6540;54682;93589;5830;939;8798;3824;50835;8531;353164;4256;121506;50839;56341;4839;10059;50837;719;716;341350;50840;9746;144699;11272;5542;25900;65125;969;3945;5744;440077;339;23085;5139,281
1,1,12,173787,133777902,133604115,113251;11197;4704;83857;9802;144195;9612;25977;29902;2842;79676;6337;65981;326625;1822;283349;4040;7296;55206;23504;3852;403282;8739;121665;3224;1634;10233;91523;1108;390326;4048;55500;29915;2998;28981;160762;5781;10599;22895;1840;27198;23389;26127;9700;6171;55884;3736;91298;283383;3678;84872;196446;10867;5908;196385;54407;22914;55359;55010;1975;5037;121504;5545;57097;254050;51134;85437;728568;55530;3848;121355;11108;55332;57634;4666;10154;196477;9880;8445;121642;84216;55907;2984;3375;53831;83591;41;55967;89910;5025;112;4257;140465;83445;53373;256710;80324;55508;7480;79785;4778;9169;27289;283446;4604;121129;387849;967;23316;100289635;144577;55766;2305;120892;283377;6778;338809;283459;11113;144404;51329;8496;253827;55743;54509;23067;64211;3823;3458;23426;55259;5992;55596;51347;9498;5916;3226;84915;8655;4938;4842;574016;84102;552;50511;613227;25840;160492;3889;7786;377;79887;341567;928;114795;341416;4673;3223;11260;574028;121599;3856;51303;5318;29953;55576;1431;1027;140461;85406;5288;27165;10540;6926;50616;3626;89795;1610;217;9976;160777;6927;196513;160365;27239;319;80184;23468;64581;83758;9573;57666;10445;5630;23390;341392;6404;1280;51147;5959;57458;84900;3034;84519;84727;84766;341418;55681;8738;390327;488;10635;6843;121227;196374;22818;8079;54621;429;160760;81575;6539;440073;55266;84747;10536;4055;7024;3178;1368;6489;6515;54434;10019;7846;118426;81566;359;1019;387890;80212;1649;4848;84101;4617;57605;11213;55297;29121;64333;50515;112802;9958;11228;2967;6895;79837;55785;3225;196527;7637;3821;9735;51535;91574;5965;60314;171017;283337;4069;121601;22953;50856;84329;3695;283463;144363;3221;5036;4637;6311;9840;4234;9194;283461;2735;362;55080;23583;1337;715;894;259296;645177;55703;283431;319101;55117;121273;84926;3845;259292;341568;341405;23014;65082;6579;144501;196394;23416;4659;517;5153;4908;26259;11211;55726;121340;196441;3242;121549;254786;283316;65244;196410;283365;10961;338442;144165;283375;3679;35;25834;28234;7334;121457;144453;29951;84190;100129361;57102;10566;23479;23371;56899;55188;192111;7004;54477;55832;6334;1663;4801;59341;51380;4033;8437;55885;10106;8411;79039;84934;283385;22822;144717;91012;121275;93058;121214;51228;23409;83448;254783;100533183;5554;51350;283420;10024;1990;3851;2059;23306;79611;5319;338811;59277;83461;376132;58516;2012;25895;387885;84920;50846;11081;10956;57379;4074;29127;5094;2799;8638;89894;5250;3229;10970;2647;254013;387837;6602;775;374454;5204;79720;55711;4035;440087;170482;100287284;144448;11010;144347;11016;57494;283464;196415;8082;23344;84324;390321;84070;3741;23519;6433;8089;4141;2802;5555;6540;283403;10576;54682;83892;8435;939;51474;50835;4256;196403;8085;56341;7112;79794;4839;390323;10198;10059;10795;84298;716;9119;55198;341350;50840;79035;91010;115749;64431;1240;5542;5053;353116;118430;10193;949;493861;65125;3945;5744;196528;6821;10411;80018;23085;7556;5139;10329;51499;160418;10988;10102;283471;400;8620;8092;23074;3892;113675;9921;5901;57701;9026;4891;259295;120935;10060;1272;121274;9924;140707;121512;23141;90070;144568;51026;6660;23457;8099;50865;144321;51367;440107;8302;23012;259294;6231;9478;117159;440097;57522;50813;8550;84975;55652;9891;80196;56901;8693;2054;317781;23710;85478;144193;121551;56616;5149;2065;7181;3891;115557;160335;7574;1911;441631;117177;54997;11153;144423;1833;29843;121643;7471;10219;51564;121006;51019;552889;246329;3855;7103;397;51071;441639;51411;11103;79365;51768;10677;8078;121278;55729;269;317;26290;11247;7009;4633;54458;387893;5756;196500;80070;160364;144245;93661;363;694;50838;374470;7374;11137;92979;728858;6866;144535;92797;80824;3489;89869;282809;60488;5800;1594;1389;84749;114134;121536;51067;121364;116986;9761;57542;22877;4640;7421;64375;225;144608;60673;9271;28977;10645;3822;55810;25946;9671;3906;283358;8825;11021;2;586;57228;2251;101060200;3875;2819;3071;5801;5128;4939;784;401720;23011;88455;400073;80024;23545;1407;55200;440093;9904;6472;5463;6249;5858;83729;50836;246213;5564;6128;93978;57658;57122;3887;3890;9847;6302;338339;5985;100129940;29110;7167;55801;7132;11331;347902;341346;653247;403284;1017;2288;26353;64786;2597;3798;3479;7289;32;51290;10138;56938;7316;83714;51729;23603;9412;3747;5027;84698;2583;84125;1848;115811;58158;91419;8499;359787;6667;3888;114882;283455;4254;11066;55138;3850;10818;94;79738;4753;338761;5787;420;92558;121053;84660;11171;8074;144455;374462;55716;10959;3742;1466;51267;57103;29095;2026;387836;51202;23329;51266;386653;6601;10330;5213;9416;10993;2784;1606;5557;23592;3709;51279;57101;2120;196383;64897;56890;5927;920;79023;140807;5869;10094;636;84876;8843;57121;91;121130;26253;81539;55591;5715;506;81029;114785;100431172;57609;84274;84318;283417;144406;6857;121256;55507;5502;3902;85004;80724;5777;6636;10728;79050;53919;286887;84305;51561;55089;605;466;4973;121441;8315;55196;144233;5544;54934;23041;3849;8683;8408;9815;3764;3853;84678;8562;51184;121260;65117;113246;9182;22864;65012;121268;341359;55110;4815;51258;11318;5367;904;79369;106707243;160518;7184;79022;79158;387882;57460;57696;10162;360030;160428;10985;6996;8549;23017;3228;10220;255394;4326;51348;4440;8076;79602;5571;29080;11052;490;6490;84530;10526;51434;55846;10436;57647;387856;55605;196472;51433;79962;120863;23325;79912;92293;79657;9332;9971;160622;654429;3854;27345;120939;80298;8835;5827;160419;259289;51135;4665;6910;5829;79923;51699;283373;27340;3227;8608;11163;2004;8091;144402;5939;57613;5763;100507055;79600;83695;79867;90488;2904;729025;8909;259290;8630;100528032;4284;3820;5501;259293;9918;7450;4940;64426;6175;8914;51559;4618;338773;9052;80763;100528030;338821;5426;6773;5893;144348;84790;79370;11176;3164;7699;338785;10906;83468;25766;93589;5830;4327;283450;8798;3824;121506;8531;353164;50839;10376;56994;4922;65985;3222;196463;84260;4598;50837;719;5074;283310;160728;1967;9733;9746;23109;144699;11272;25875;4193;643246;121391;84987;25900;51643;969;8086;4060;440077;339;144715;11226;50614,1002
1,1,12,173787,133777902,133604115,113251;11197;4704;83857;9802;144195;9612;25977;29902;2842;79676;6337;65981;326625;1822;283349;4040;7296;55206;23504;3852;403282;8739;121665;3224;1634;10233;91523;1108;390326;4048;55500;29915;2998;28981;160762;5781;10599;22895;1840;27198;23389;26127;9700;6171;55884;3736;91298;283383;3678;84872;196446;10867;5908;196385;54407;22914;55359;55010;1975;5037;121504;5545;57097;254050;51134;85437;728568;55530;3848;121355;11108;55332;57634;4666;10154;196477;9880;8445;121642;84216;55907;2984;3375;53831;83591;41;55967;89910;5025;112;4257;140465;83445;53373;256710;80324;55508;7480;79785;4778;9169;27289;283446;4604;121129;387849;967;23316;100289635;144577;55766;2305;120892;283377;6778;338809;283459;11113;144404;51329;8496;253827;55743;54509;23067;64211;3823;3458;23426;55259;5992;55596;51347;9498;5916;3226;84915;8655;4938;4842;574016;84102;552;50511;613227;25840;160492;3889;7786;377;79887;341567;928;114795;341416;4673;3223;11260;574028;121599;3856;51303;5318;29953;55576;1431;1027;140461;85406;5288;27165;10540;6926;50616;3626;89795;1610;217;9976;160777;6927;196513;160365;27239;319;80184;23468;64581;83758;9573;57666;10445;5630;23390;341392;6404;1280;51147;5959;57458;84900;3034;84519;84727;84766;341418;55681;8738;390327;488;10635;6843;121227;196374;22818;8079;54621;429;160760;81575;6539;440073;55266;84747;10536;4055;7024;3178;1368;6489;6515;54434;10019;7846;118426;81566;359;1019;387890;80212;1649;4848;84101;4617;57605;11213;55297;29121;64333;50515;112802;9958;11228;2967;6895;79837;55785;3225;196527;7637;3821;9735;51535;91574;5965;60314;171017;283337;4069;121601;22953;50856;84329;3695;283463;144363;3221;5036;4637;6311;9840;4234;9194;283461;2735;362;55080;23583;1337;715;894;259296;645177;55703;283431;319101;55117;121273;84926;3845;259292;341568;341405;23014;65082;6579;144501;196394;23416;4659;517;5153;4908;26259;11211;55726;121340;196441;3242;121549;254786;283316;65244;196410;283365;10961;338442;144165;283375;3679;35;25834;28234;7334;121457;144453;29951;84190;100129361;57102;10566;23479;23371;56899;55188;192111;7004;54477;55832;6334;1663;4801;59341;51380;4033;8437;55885;10106;8411;79039;84934;283385;22822;144717;91012;121275;93058;121214;51228;23409;83448;254783;100533183;5554;51350;283420;10024;1990;3851;2059;23306;79611;5319;338811;59277;83461;376132;58516;2012;25895;387885;84920;50846;11081;10956;57379;4074;29127;5094;2799;8638;89894;5250;3229;10970;2647;254013;387837;6602;775;374454;5204;79720;55711;4035;440087;170482;100287284;144448;11010;144347;11016;57494;283464;196415;8082;23344;84324;390321;84070;3741;23519;6433;8089;4141;2802;5555;6540;283403;10576;54682;83892;8435;939;51474;50835;4256;196403;8085;56341;7112;79794;4839;390323;10198;10059;10795;84298;716;9119;55198;341350;50840;79035;91010;115749;64431;1240;5542;5053;353116;118430;10193;949;493861;65125;3945;5744;196528;6821;10411;80018;23085;7556;5139;10329;51499;160418;10988;10102;283471;400;8620;8092;23074;3892;113675;9921;5901;57701;9026;4891;259295;120935;10060;1272;121274;9924;140707;121512;23141;90070;144568;51026;6660;23457;8099;50865;144321;51367;440107;8302;23012;259294;6231;9478;117159;440097;57522;50813;8550;84975;55652;9891;80196;56901;8693;2054;317781;23710;85478;144193;121551;56616;5149;2065;7181;3891;115557;160335;7574;1911;441631;117177;54997;11153;144423;1833;29843;121643;7471;10219;51564;121006;51019;552889;246329;3855;7103;397;51071;441639;51411;11103;79365;51768;10677;8078;121278;55729;269;317;26290;11247;7009;4633;54458;387893;5756;196500;80070;160364;144245;93661;363;694;50838;374470;7374;11137;92979;728858;6866;144535;92797;80824;3489;89869;282809;60488;5800;1594;1389;84749;114134;121536;51067;121364;116986;9761;57542;22877;4640;7421;64375;225;144608;60673;9271;28977;10645;3822;55810;25946;9671;3906;283358;8825;11021;2;586;57228;2251;101060200;3875;2819;3071;5801;5128;4939;784;401720;23011;88455;400073;80024;23545;1407;55200;440093;9904;6472;5463;6249;5858;83729;50836;246213;5564;6128;93978;57658;57122;3887;3890;9847;6302;338339;5985;100129940;29110;7167;55801;7132;11331;347902;341346;653247;403284;1017;2288;26353;64786;2597;3798;3479;7289;32;51290;10138;56938;7316;83714;51729;23603;9412;3747;5027;84698;2583;84125;1848;115811;58158;91419;8499;359787;6667;3888;114882;283455;4254;11066;55138;3850;10818;94;79738;4753;338761;5787;420;92558;121053;84660;11171;8074;144455;374462;55716;10959;3742;1466;51267;57103;29095;2026;387836;51202;23329;51266;386653;6601;10330;5213;9416;10993;2784;1606;5557;23592;3709;51279;57101;2120;196383;64897;56890;5927;920;79023;140807;5869;10094;636;84876;8843;57121;91;121130;26253;81539;55591;5715;506;81029;114785;100431172;57609;84274;84318;283417;144406;6857;121256;55507;5502;3902;85004;80724;5777;6636;10728;79050;53919;286887;84305;51561;55089;605;466;4973;121441;8315;55196;144233;5544;54934;23041;3849;8683;8408;9815;3764;3853;84678;8562;51184;121260;65117;113246;9182;22864;65012;121268;341359;55110;4815;51258;11318;5367;904;79369;106707243;160518;7184;79022;79158;387882;57460;57696;10162;360030;160428;10985;6996;8549;23017;3228;10220;255394;4326;51348;4440;8076;79602;5571;29080;11052;490;6490;84530;10526;51434;55846;10436;57647;387856;55605;196472;51433;79962;120863;23325;79912;92293;79657;9332;9971;160622;654429;3854;27345;120939;80298;8835;5827;160419;259289;51135;4665;6910;5829;79923;51699;283373;27340;3227;8608;11163;2004;8091;144402;5939;57613;5763;100507055;79600;83695;79867;90488;2904;729025;8909;259290;8630;100528032;4284;3820;5501;259293;9918;7450;4940;64426;6175;8914;51559;4618;338773;9052;80763;100528030;338821;5426;6773;5893;144348;84790;79370;11176;3164;7699;338785;10906;83468;25766;93589;5830;4327;283450;8798;3824;121506;8531;353164;50839;10376;56994;4922;65985;3222;196463;84260;4598;50837;719;5074;283310;160728;1967;9733;9746;23109;144699;11272;25875;4193;643246;121391;84987;25900;51643;969;8086;4060;440077;339;144715;11226;50614,1002
1,1,12,173787,133777902,133604115,113251;11197;4704;83857;9802;144195;9612;25977;29902;2842;79676;6337;65981;326625;1822;283349;4040;7296;55206;23504;3852;403282;8739;121665;3224;1634;10233;91523;1108;390326;4048;55500;29915;2998;28981;160762;5781;10599;22895;1840;27198;23389;26127;9700;6171;55884;3736;91298;283383;3678;84872;196446;10867;5908;196385;54407;22914;55359;55010;1975;5037;121504;5545;57097;254050;51134;85437;728568;55530;3848;121355;11108;55332;57634;4666;10154;196477;9880;8445;121642;84216;55907;2984;3375;53831;83591;41;55967;89910;5025;112;4257;140465;83445;53373;256710;80324;55508;7480;79785;4778;9169;27289;283446;4604;121129;387849;967;23316;100289635;144577;55766;2305;120892;283377;6778;338809;283459;11113;144404;51329;8496;253827;55743;54509;23067;64211;3823;3458;23426;55259;5992;55596;51347;9498;5916;3226;84915;8655;4938;4842;574016;84102;552;50511;613227;25840;160492;3889;7786;377;79887;341567;928;114795;341416;4673;3223;11260;574028;121599;3856;51303;5318;29953;55576;1431;1027;140461;85406;5288;27165;10540;6926;50616;3626;89795;1610;217;9976;160777;6927;196513;160365;27239;319;80184;23468;64581;83758;9573;57666;10445;5630;23390;341392;6404;1280;51147;5959;57458;84900;3034;84519;84727;84766;341418;55681;8738;390327;488;10635;6843;121227;196374;22818;8079;54621;429;160760;81575;6539;440073;55266;84747;10536;4055;7024;3178;1368;6489;6515;54434;10019;7846;118426;81566;359;1019;387890;80212;1649;4848;84101;4617;57605;11213;55297;29121;64333;50515;112802;9958;11228;2967;6895;79837;55785;3225;196527;7637;3821;9735;51535;91574;5965;60314;171017;283337;4069;121601;22953;50856;84329;3695;283463;144363;3221;5036;4637;6311;9840;4234;9194;283461;2735;362;55080;23583;1337;715;894;259296;645177;55703;283431;319101;55117;121273;84926;3845;259292;341568;341405;23014;65082;6579;144501;196394;23416;4659;517;5153;4908;26259;11211;55726;121340;196441;3242;121549;254786;283316;65244;196410;283365;10961;338442;144165;283375;3679;35;25834;28234;7334;121457;144453;29951;84190;100129361;57102;10566;23479;23371;56899;55188;192111;7004;54477;55832;6334;1663;4801;59341;51380;4033;8437;55885;10106;8411;79039;84934;283385;22822;144717;91012;121275;93058;121214;51228;23409;83448;254783;100533183;5554;51350;283420;10024;1990;3851;2059;23306;79611;5319;338811;59277;83461;376132;58516;2012;25895;387885;84920;50846;11081;10956;57379;4074;29127;5094;2799;8638;89894;5250;3229;10970;2647;254013;387837;6602;775;374454;5204;79720;55711;4035;440087;170482;100287284;144448;11010;144347;11016;57494;283464;196415;8082;23344;84324;390321;84070;3741;23519;6433;8089;4141;2802;5555;6540;283403;10576;54682;83892;8435;939;51474;50835;4256;196403;8085;56341;7112;79794;4839;390323;10198;10059;10795;84298;716;9119;55198;341350;50840;79035;91010;115749;64431;1240;5542;5053;353116;118430;10193;949;493861;65125;3945;5744;196528;6821;10411;80018;23085;7556;5139;10329;51499;160418;10988;10102;283471;400;8620;8092;23074;3892;113675;9921;5901;57701;9026;4891;259295;120935;10060;1272;121274;9924;140707;121512;23141;90070;144568;51026;6660;23457;8099;50865;144321;51367;440107;8302;23012;259294;6231;9478;117159;440097;57522;50813;8550;84975;55652;9891;80196;56901;8693;2054;317781;23710;85478;144193;121551;56616;5149;2065;7181;3891;115557;160335;7574;1911;441631;117177;54997;11153;144423;1833;29843;121643;7471;10219;51564;121006;51019;552889;246329;3855;7103;397;51071;441639;51411;11103;79365;51768;10677;8078;121278;55729;269;317;26290;11247;7009;4633;54458;387893;5756;196500;80070;160364;144245;93661;363;694;50838;374470;7374;11137;92979;728858;6866;144535;92797;80824;3489;89869;282809;60488;5800;1594;1389;84749;114134;121536;51067;121364;116986;9761;57542;22877;4640;7421;64375;225;144608;60673;9271;28977;10645;3822;55810;25946;9671;3906;283358;8825;11021;2;586;57228;2251;101060200;3875;2819;3071;5801;5128;4939;784;401720;23011;88455;400073;80024;23545;1407;55200;440093;9904;6472;5463;6249;5858;83729;50836;246213;5564;6128;93978;57658;57122;3887;3890;9847;6302;338339;5985;100129940;29110;7167;55801;7132;11331;347902;341346;653247;403284;1017;2288;26353;64786;2597;3798;3479;7289;32;51290;10138;56938;7316;83714;51729;23603;9412;3747;5027;84698;2583;84125;1848;115811;58158;91419;8499;359787;6667;3888;114882;283455;4254;11066;55138;3850;10818;94;79738;4753;338761;5787;420;92558;121053;84660;11171;8074;144455;374462;55716;10959;3742;1466;51267;57103;29095;2026;387836;51202;23329;51266;386653;6601;10330;5213;9416;10993;2784;1606;5557;23592;3709;51279;57101;2120;196383;64897;56890;5927;920;79023;140807;5869;10094;636;84876;8843;57121;91;121130;26253;81539;55591;5715;506;81029;114785;100431172;57609;84274;84318;283417;144406;6857;121256;55507;5502;3902;85004;80724;5777;6636;10728;79050;53919;286887;84305;51561;55089;605;466;4973;121441;8315;55196;144233;5544;54934;23041;3849;8683;8408;9815;3764;3853;84678;8562;51184;121260;65117;113246;9182;22864;65012;121268;341359;55110;4815;51258;11318;5367;904;79369;106707243;160518;7184;79022;79158;387882;57460;57696;10162;360030;160428;10985;6996;8549;23017;3228;10220;255394;4326;51348;4440;8076;79602;5571;29080;11052;490;6490;84530;10526;51434;55846;10436;57647;387856;55605;196472;51433;79962;120863;23325;79912;92293;79657;9332;9971;160622;654429;3854;27345;120939;80298;8835;5827;160419;259289;51135;4665;6910;5829;79923;51699;283373;27340;3227;8608;11163;2004;8091;144402;5939;57613;5763;100507055;79600;83695;79867;90488;2904;729025;8909;259290;8630;100528032;4284;3820;5501;259293;9918;7450;4940;64426;6175;8914;51559;4618;338773;9052;80763;100528030;338821;5426;6773;5893;144348;84790;79370;11176;3164;7699;338785;10906;83468;25766;93589;5830;4327;283450;8798;3824;121506;8531;353164;50839;10376;56994;4922;65985;3222;196463;84260;4598;50837;719;5074;283310;160728;1967;9733;9746;23109;144699;11272;25875;4193;643246;121391;84987;25900;51643;969;8086;4060;440077;339;144715;11226;50614,1002
1,1,12,189578,34756150,34566572,4704;83857;144195;25977;2842;6337;65981;1822;4040;259295;10060;121512;144568;51026;10233;6660;1108;50865;55500;2998;10599;26127;3736;8302;259294;23012;50813;10867;22914;55359;23710;121504;5545;57097;5149;1911;441631;55907;2984;3375;10219;4257;83445;397;51071;79785;79365;51768;8078;55729;26290;387849;196500;55766;160364;93661;2305;50838;8496;728858;3823;80824;55259;89869;60488;5800;1389;121536;51067;57542;160492;79887;928;144608;5318;3822;55810;283358;2;1027;586;5288;2251;55200;440093;9976;196513;5858;160365;27239;50836;93978;64581;83758;9573;9847;338339;7167;7132;11331;341392;653247;341346;2288;51147;84519;84727;84766;2597;7289;51290;56938;83714;51729;9412;10635;6843;8079;81575;6539;440073;10536;4055;359787;6489;6515;55138;118426;420;11171;8074;55297;29121;3742;51267;57103;2026;387836;51202;51266;11228;2784;3709;51279;57101;3821;2120;5965;171017;50856;5927;920;636;144363;57121;55080;26253;715;894;259296;645177;81029;100431172;84318;55507;3845;259292;3902;85004;6579;5777;196394;4908;55726;53919;4973;283316;55196;5544;28234;100129361;57102;10566;3764;113246;7004;54477;1663;341359;55110;4033;4815;51258;106707243;55885;160518;10162;360030;51348;8076;79602;5554;10526;283420;55846;10436;2059;79912;9332;654429;83461;58516;2012;120939;84920;259289;57379;4074;79923;57613;5763;83695;387837;254013;775;2904;729025;55711;259290;100528032;440087;3820;170482;100287284;259293;9918;7450;57494;196415;8082;9052;3741;80763;338821;5893;5555;79370;6540;54682;93589;5830;939;8798;3824;50835;8531;353164;4256;121506;50839;56341;4839;10059;50837;719;716;341350;50840;9746;144699;11272;5542;25900;65125;969;3945;5744;440077;339;23085;5139,281
1,-1,12,282465,369192,86727,6540;6539;440073,3
-1,1,12,282465,2667263,2384798,283358;6539;440073;5893;81029;775;4815;84318;6540;144699;654429;5927;93589;65125;196513;23085;79602,17
-1,1,12,282465,2959765,2677300,283358;6539;440073;55846;5893;81029;2288;775;4815;6540;84318;144699;654429;5927;83714;93589;65125;196513;23085;79602,20
-1,1,12,282465,3112486,2830021,283358;6539;440073;7004;55846;5893;81029;83695;2288;775;2305;4815;6540;84318;7289;144699;654429;5927;83714;93589;65125;196513;23085;79602,24
-1,1,12,282465,3112486,2830021,283358;6539;440073;7004;55846;5893;81029;83695;2288;775;2305;4815;6540;84318;7289;144699;654429;5927;83714;93589;65125;196513;23085;79602,24
-1,1,12,282465,3748769,3466304,283358;6539;440073;7004;56341;55846;5893;81029;83695;2288;775;2305;4815;6540;84766;84318;7289;144699;654429;10867;5927;83714;93589;65125;196513;23085;79602,27
-1,1,12,282465,4114078,3831613,283358;6539;440073;7004;56341;55846;5893;81029;83695;2288;775;2305;4815;6540;84766;84318;7289;144699;654429;10867;5927;83714;93589;65125;196513;23085;57097;79602,28
-1,1,12,282465,4529751,4247286,283358;6539;440073;7004;56341;894;55846;5893;81029;83695;2288;775;2305;4815;6540;84766;84318;7289;144699;654429;10867;5927;83714;8074;93589;57097;65125;196513;23085;57103;79602,31
1,1,12,282465,11256448,10973983,387836;4704;51266;144195;25977;2784;51279;57101;6337;3821;1822;171017;50856;5927;920;259295;57121;55080;26253;144568;10233;715;894;1108;259296;81029;100431172;84318;3736;8302;259294;259292;50813;10867;3902;5777;22914;55359;4908;23710;57097;4973;283316;1911;57103;10219;57102;10566;8078;26290;113246;7004;196500;160364;55110;2305;50838;4815;51258;106707243;10162;360030;3823;51348;8076;79602;5554;283420;55846;10436;9332;654429;83461;928;120939;259289;57379;4074;79923;3822;55810;283358;2;5763;2251;83695;387837;775;259290;100528032;3820;55200;170482;9918;7450;9976;196513;5858;160365;27239;57494;50836;93978;64581;83758;9573;338339;3741;7167;7132;11331;341392;5893;2288;51147;5555;84519;84727;6540;84766;2597;7289;83714;93589;5830;939;8798;3824;50835;8531;10635;6843;8079;50839;6539;440073;56341;10536;4055;4839;359787;50837;6515;719;55138;716;50840;9746;144699;11272;8074;25900;65125;969;440077;339;29121;23085;3742;51267;2026,161
1,1,12,282465,34756196,34473731,4704;83857;144195;25977;2842;6337;65981;1822;4040;259295;10060;121512;144568;51026;10233;6660;1108;50865;55500;2998;10599;26127;3736;8302;259294;23012;50813;10867;22914;55359;23710;121504;5545;57097;5149;1911;441631;55907;2984;3375;10219;4257;83445;397;51071;79785;79365;51768;8078;55729;26290;387849;196500;55766;160364;93661;2305;50838;8496;728858;3823;80824;55259;89869;60488;5800;1389;121536;51067;57542;160492;79887;928;144608;5318;3822;55810;283358;2;1027;586;5288;2251;55200;440093;9976;196513;5858;160365;27239;50836;93978;64581;83758;9573;9847;338339;7167;7132;11331;341392;653247;341346;2288;51147;84519;84727;84766;2597;7289;51290;56938;83714;51729;9412;10635;6843;8079;81575;6539;440073;10536;4055;359787;6489;6515;55138;118426;420;11171;8074;55297;29121;3742;51267;57103;2026;387836;51202;51266;11228;2784;3709;51279;57101;3821;2120;5965;171017;50856;5927;920;636;144363;57121;55080;26253;715;894;259296;645177;81029;100431172;84318;55507;3845;259292;3902;85004;6579;5777;196394;4908;55726;53919;4973;283316;55196;5544;28234;100129361;57102;10566;3764;113246;7004;54477;1663;341359;55110;4033;4815;51258;106707243;55885;160518;10162;360030;51348;8076;79602;5554;10526;283420;55846;10436;2059;79912;9332;654429;83461;58516;2012;120939;84920;259289;57379;4074;79923;57613;5763;83695;387837;254013;775;2904;729025;55711;259290;100528032;440087;3820;170482;100287284;259293;9918;7450;57494;196415;8082;9052;3741;80763;338821;5893;5555;79370;6540;54682;93589;5830;939;8798;3824;50835;8531;353164;4256;121506;50839;56341;4839;10059;50837;719;716;341350;50840;9746;144699;11272;5542;25900;65125;969;3945;5744;440077;339;23085;5139,281
1,1,12,282465,34756209,34473744,4704;83857;144195;25977;2842;6337;65981;1822;4040;259295;10060;121512;144568;51026;10233;6660;1108;50865;55500;2998;10599;26127;3736;8302;259294;23012;50813;10867;22914;55359;23710;121504;5545;57097;5149;1911;441631;55907;2984;3375;10219;4257;83445;397;51071;79785;79365;51768;8078;55729;26290;387849;196500;55766;160364;93661;2305;50838;8496;728858;3823;80824;55259;89869;60488;5800;1389;121536;51067;57542;160492;79887;928;144608;5318;3822;55810;283358;2;1027;586;5288;2251;55200;440093;9976;196513;5858;160365;27239;50836;93978;64581;83758;9573;9847;338339;7167;7132;11331;341392;653247;341346;2288;51147;84519;84727;84766;2597;7289;51290;56938;83714;51729;9412;10635;6843;8079;81575;6539;440073;10536;4055;359787;6489;6515;55138;118426;420;11171;8074;55297;29121;3742;51267;57103;2026;387836;51202;51266;11228;2784;3709;51279;57101;3821;2120;5965;171017;50856;5927;920;636;144363;57121;55080;26253;715;894;259296;645177;81029;100431172;84318;55507;3845;259292;3902;85004;6579;5777;196394;4908;55726;53919;4973;283316;55196;5544;28234;100129361;57102;10566;3764;113246;7004;54477;1663;341359;55110;4033;4815;51258;106707243;55885;160518;10162;360030;51348;8076;79602;5554;10526;283420;55846;10436;2059;79912;9332;654429;83461;58516;2012;120939;84920;259289;57379;4074;79923;57613;5763;83695;387837;254013;775;2904;729025;55711;259290;100528032;440087;3820;170482;100287284;259293;9918;7450;57494;196415;8082;9052;3741;80763;338821;5893;5555;79370;6540;54682;93589;5830;939;8798;3824;50835;8531;353164;4256;121506;50839;56341;4839;10059;50837;719;716;341350;50840;9746;144699;11272;5542;25900;65125;969;3945;5744;440077;339;23085;5139,281
1,1,12,282465,34761006,34478541,4704;83857;144195;25977;2842;6337;65981;1822;4040;259295;10060;121512;144568;51026;10233;6660;1108;50865;55500;2998;10599;26127;3736;8302;259294;23012;50813;10867;22914;55359;23710;121504;5545;57097;5149;1911;441631;55907;2984;3375;10219;4257;83445;397;51071;79785;79365;51768;8078;55729;26290;387849;196500;55766;160364;93661;2305;50838;8496;728858;3823;80824;55259;89869;60488;5800;1389;121536;51067;57542;160492;79887;928;144608;5318;3822;55810;283358;2;1027;586;5288;2251;55200;440093;9976;196513;5858;160365;27239;50836;93978;64581;83758;9573;9847;338339;7167;7132;11331;341392;653247;341346;2288;51147;84519;84727;84766;2597;7289;51290;56938;83714;51729;9412;10635;6843;8079;81575;6539;440073;10536;4055;359787;6489;6515;55138;118426;420;11171;8074;55297;29121;3742;51267;57103;2026;387836;51202;51266;11228;2784;3709;51279;57101;3821;2120;5965;171017;50856;5927;920;636;144363;57121;55080;26253;715;894;259296;645177;81029;100431172;84318;55507;3845;259292;3902;85004;6579;5777;196394;4908;55726;53919;4973;283316;55196;5544;28234;100129361;57102;10566;3764;113246;7004;54477;1663;341359;55110;4033;4815;51258;106707243;55885;160518;10162;360030;51348;8076;79602;5554;10526;283420;55846;10436;2059;79912;9332;654429;83461;58516;2012;120939;84920;259289;57379;4074;79923;57613;5763;83695;387837;254013;775;2904;729025;55711;259290;100528032;440087;3820;170482;100287284;259293;9918;7450;57494;196415;8082;9052;3741;80763;338821;5893;5555;79370;6540;54682;93589;5830;939;8798;3824;50835;8531;353164;4256;121506;50839;56341;4839;10059;50837;719;716;341350;50840;9746;144699;11272;5542;25900;65125;969;3945;5744;440077;339;23085;5139,281
1,1,12,282465,133773393,133490928,113251;11197;4704;83857;9802;144195;9612;25977;29902;2842;79676;6337;65981;326625;1822;283349;4040;7296;55206;23504;3852;403282;8739;121665;3224;1634;10233;91523;1108;390326;4048;55500;29915;2998;28981;160762;5781;10599;22895;1840;27198;23389;26127;9700;6171;55884;3736;91298;283383;3678;84872;196446;10867;5908;54407;22914;55359;55010;1975;5037;121504;5545;57097;254050;51134;85437;728568;55530;3848;121355;11108;55332;57634;4666;10154;196477;9880;8445;121642;84216;55907;2984;3375;53831;83591;41;55967;89910;5025;112;4257;140465;83445;53373;256710;80324;55508;7480;79785;4778;9169;27289;283446;4604;121129;387849;967;23316;100289635;144577;55766;2305;120892;283377;6778;338809;283459;11113;144404;51329;8496;253827;55743;54509;23067;64211;3823;3458;23426;55259;5992;55596;51347;9498;5916;3226;84915;8655;4938;4842;574016;84102;552;50511;613227;25840;160492;3889;7786;377;79887;341567;928;114795;341416;4673;3223;11260;574028;121599;3856;51303;5318;29953;55576;1431;1027;140461;85406;5288;27165;10540;6926;50616;3626;89795;1610;217;9976;160777;6927;196513;160365;27239;319;80184;23468;64581;83758;9573;57666;10445;5630;23390;341392;6404;1280;51147;5959;57458;84900;3034;84519;84727;84766;341418;55681;8738;390327;488;10635;6843;121227;196374;22818;8079;54621;429;160760;81575;6539;440073;55266;84747;10536;4055;7024;3178;1368;6489;6515;54434;10019;7846;118426;81566;359;1019;387890;80212;1649;4848;84101;4617;57605;11213;55297;29121;64333;50515;112802;9958;11228;2967;6895;79837;55785;3225;196527;7637;3821;9735;51535;91574;5965;60314;171017;283337;4069;121601;22953;50856;84329;3695;283463;144363;3221;5036;4637;6311;9840;4234;9194;283461;2735;362;55080;23583;1337;715;894;259296;645177;55703;283431;319101;55117;121273;84926;3845;259292;341568;341405;23014;65082;6579;144501;196394;23416;4659;517;5153;4908;26259;11211;55726;121340;196441;3242;121549;254786;283316;65244;196410;283365;10961;338442;144165;283375;3679;35;25834;28234;7334;121457;144453;29951;84190;100129361;57102;10566;23479;23371;56899;55188;192111;7004;54477;55832;6334;1663;4801;59341;51380;4033;8437;55885;10106;8411;79039;84934;283385;22822;144717;91012;121275;93058;121214;51228;23409;83448;254783;100533183;5554;51350;283420;10024;1990;3851;2059;23306;79611;5319;338811;59277;83461;376132;58516;2012;25895;387885;84920;50846;11081;10956;57379;4074;29127;5094;2799;8638;89894;5250;3229;10970;2647;254013;387837;6602;775;374454;5204;79720;55711;4035;440087;170482;100287284;144448;11010;144347;11016;57494;283464;196415;8082;23344;84324;5985;390321;84070;3741;23519;6433;8089;4141;2802;5555;6540;283403;10576;54682;83892;8435;939;51474;50835;4256;196403;8085;56341;7112;79794;4839;390323;10198;10059;10795;84298;716;9119;55198;341350;50840;79035;91010;115749;64431;1240;5542;5053;353116;118430;10193;949;493861;65125;3945;5744;196528;6821;10411;80018;23085;7556;5139;10329;51499;160418;10988;10102;283471;400;8620;8092;23074;3892;113675;9921;5901;57701;9026;4891;259295;120935;10060;1272;121274;9924;140707;121512;23141;90070;144568;51026;6660;23457;8099;50865;144321;51367;440107;8302;23012;259294;6231;9478;117159;440097;57522;50813;8550;84975;55652;9891;80196;56901;8693;2054;317781;23710;85478;144193;121551;56616;5149;2065;7181;3891;115557;160335;7574;1911;441631;117177;54997;11153;144423;1833;29843;121643;7471;10219;51564;121006;51019;552889;246329;3855;7103;397;51071;441639;51411;11103;79365;51768;10677;8078;121278;55729;269;317;26290;11247;7009;4633;54458;387893;5756;196500;80070;160364;144245;93661;363;694;50838;374470;7374;11137;92979;728858;6866;144535;92797;80824;3489;89869;282809;60488;5800;1594;1389;84749;114134;121536;51067;121364;116986;9761;57542;4640;7421;64375;225;144608;60673;9271;28977;10645;3822;55810;25946;9671;3906;283358;8825;11021;2;586;57228;2251;101060200;3875;2819;3071;5801;5128;4939;784;401720;23011;88455;400073;80024;23545;1407;55200;440093;9904;6472;5463;6249;5858;83729;50836;246213;5564;6128;93978;57658;57122;3887;3890;22877;9847;6302;338339;100129940;29110;7167;55801;7132;11331;347902;341346;653247;403284;1017;2288;26353;64786;2597;3798;3479;7289;32;51290;10138;56938;7316;83714;51729;23603;9412;3747;5027;84698;2583;84125;1848;115811;58158;91419;8499;359787;6667;3888;114882;283455;4254;11066;55138;3850;10818;94;79738;4753;338761;5787;420;92558;121053;84660;11171;8074;144455;374462;55716;10959;3742;1466;51267;57103;29095;2026;387836;51202;23329;51266;386653;6601;10330;5213;9416;10993;2784;1606;5557;23592;3709;51279;57101;2120;196383;64897;56890;5927;920;79023;140807;5869;10094;636;84876;8843;57121;91;121130;26253;81539;55591;5715;506;81029;114785;100431172;57609;84274;84318;283417;144406;6857;121256;55507;5502;3902;85004;80724;5777;6636;10728;79050;53919;286887;84305;51561;55089;605;466;4973;121441;8315;55196;144233;5544;54934;23041;11226;3849;8683;8408;9815;3764;3853;84678;8562;51184;121260;65117;113246;9182;22864;65012;121268;341359;55110;4815;51258;11318;5367;904;79369;106707243;160518;7184;79022;79158;387882;57460;57696;10162;360030;160428;10985;6996;8549;23017;3228;10220;255394;4326;51348;4440;8076;79602;5571;29080;11052;490;6490;84530;10526;51434;55846;10436;57647;387856;55605;196472;51433;79962;120863;23325;79912;92293;79657;9332;9971;160622;654429;3854;27345;120939;80298;8835;5827;160419;259289;51135;4665;6910;5829;79923;51699;283373;27340;3227;8608;11163;2004;8091;144402;5939;57613;5763;100507055;79600;83695;79867;90488;2904;729025;8909;259290;8630;100528032;4284;3820;5501;259293;9918;7450;4940;64426;6175;8914;51559;4618;338773;9052;80763;100528030;338821;5426;6773;5893;144348;84790;79370;11176;3164;7699;338785;10906;83468;25766;93589;5830;4327;283450;8798;3824;121506;8531;353164;50839;10376;56994;4922;65985;3222;196463;84260;4598;50837;719;5074;283310;160728;1967;9733;9746;23109;144699;11272;25875;4193;643246;121391;84987;25900;51643;969;8086;4060;440077;339;144715;196385;50614,1002
-1,1,12,309062,5916532,5607470,3741;4704;55846;5893;2288;6540;84766;57101;7289;654429;5927;83714;93589;57102;8798;10566;10635;26290;283358;6539;7004;56341;894;81029;2251;83695;775;2305;4815;84318;3736;144699;10867;8074;57097;65125;196513;4908;23085;3742;57103;79602,42
1,-1,12,461549,475768,14219,5927,1
1,-1,12,461549,475768,14219,5927,1
1,1,12,527587,6345080,5817493,3741;4704;55846;5893;2288;84766;57101;7289;654429;928;83714;93589;57102;8798;10566;10635;26290;283358;7004;56341;894;81029;2251;83695;775;2305;4815;84318;3736;144699;10867;7450;8074;57097;65125;196513;4908;23085;3742;57103;79602,41
1,-1,12,574727,835424,260697,283358;4815,2
1,-1,12,673437,702446,29009,4815,1
1,-1,12,673437,702446,29009,4815,1
1,1,12,733373,18723930,17990557,387836;51202;4704;51266;144195;25977;2784;2842;51279;57101;6337;3821;2120;1822;171017;50856;920;4040;259295;57121;55080;26253;144568;10233;715;894;1108;259296;50865;81029;100431172;3736;8302;259294;55507;259292;50813;10867;3902;85004;5777;22914;55359;4908;23710;121504;5545;57097;5149;4973;283316;1911;5544;57103;2984;10219;4257;83445;100129361;57102;397;10566;51071;79785;8078;55729;26290;113246;7004;196500;55766;160364;55110;2305;50838;4815;51258;106707243;55885;10162;360030;3823;80824;51348;5800;8076;79602;5554;1389;283420;55846;10436;2059;9332;654429;83461;79887;928;2012;120939;144608;259289;57379;4074;79923;3822;55810;2;1027;57613;5288;5763;2251;83695;387837;775;2904;729025;259290;100528032;440087;3820;55200;170482;259293;9918;7450;9976;196513;5858;160365;27239;57494;50836;93978;64581;83758;9573;338339;9052;3741;7167;7132;11331;341392;653247;5893;2288;51147;5555;84519;84727;84766;79370;2597;7289;54682;83714;93589;5830;939;51729;8798;3824;50835;8531;353164;10635;6843;4256;121506;8079;50839;81575;56341;10536;4055;4839;359787;50837;6515;719;55138;118426;716;50840;9746;144699;11272;420;5542;11171;8074;25900;65125;969;440077;339;29121;23085;3742;51267;2026,203
1,-1,12,754496,866727,112231,65125;4815,2
1,1,12,1367440,20810511,19443071,387836;51202;4704;51266;144195;25977;2784;2842;51279;57101;6337;3821;2120;1822;171017;50856;920;4040;259295;57121;55080;26253;144568;10233;715;894;1108;259296;50865;81029;100431172;3736;8302;259294;55507;259292;50813;10867;3902;85004;5777;22914;55359;4908;23710;121504;5545;57097;5149;4973;283316;1911;5544;57103;2984;10219;4257;83445;100129361;57102;397;10566;51071;79785;8078;55729;26290;113246;7004;54477;196500;55766;160364;55110;93661;2305;50838;51258;106707243;55885;10162;360030;3823;80824;89869;51348;5800;8076;79602;5554;1389;283420;55846;10436;2059;121536;9332;654429;83461;79887;928;2012;120939;144608;259289;57379;4074;79923;3822;55810;2;1027;57613;5288;5763;2251;83695;387837;775;2904;729025;259290;100528032;440087;3820;55200;170482;259293;9918;7450;9976;196513;5858;160365;27239;57494;50836;93978;64581;83758;9573;338339;9052;3741;7167;7132;11331;341392;653247;2288;51147;5555;84519;84727;84766;79370;2597;7289;54682;83714;93589;5830;939;51729;8798;3824;50835;8531;353164;10635;6843;4256;121506;8079;50839;81575;56341;10536;4055;4839;359787;50837;6515;719;55138;118426;716;50840;9746;144699;11272;420;5542;11171;8074;25900;969;440077;339;29121;23085;3742;51267;5139;2026,205
1,1,12,1832285,9735479,7903194,4704;144195;55846;10436;25977;2784;51279;57101;6337;1822;171017;9332;654429;83461;928;50856;920;57379;57121;4074;79923;55080;26253;144568;55810;10233;715;894;1108;2;5763;2251;83695;775;3736;50813;55200;170482;10867;3902;9918;7450;5777;196513;5858;4908;27239;57494;93978;83758;9573;57097;338339;3741;7167;7132;11331;283316;341392;2288;51147;1911;84519;84727;84766;2597;10219;7289;83714;93589;5830;939;57102;8798;10566;10635;6843;8078;8079;26290;113246;7004;56341;10536;4055;4839;359787;196500;6515;719;2305;55138;716;51258;9746;10162;360030;8074;25900;440077;339;3742;57103;8076;79602;2026,106
1,1,12,2980907,15140282,12159375,387836;51202;4704;51266;144195;25977;2784;2842;51279;57101;6337;3821;2120;1822;171017;50856;920;4040;259295;57121;55080;26253;144568;10233;715;894;1108;259296;50865;100431172;3736;8302;259294;55507;259292;50813;10867;3902;5777;22914;55359;4908;23710;121504;5545;57097;5149;4973;283316;1911;5544;57103;2984;10219;83445;100129361;57102;397;10566;8078;55729;26290;113246;7004;196500;55766;160364;55110;2305;50838;51258;106707243;10162;360030;3823;80824;51348;8076;5554;1389;283420;10436;9332;83461;79887;928;2012;120939;144608;259289;57379;4074;79923;3822;55810;2;1027;57613;5763;2251;83695;387837;2904;259290;100528032;440087;3820;55200;170482;259293;9918;7450;9976;160365;5858;27239;57494;50836;93978;64581;9573;83758;338339;9052;3741;7167;7132;11331;341392;653247;51147;5555;84519;84727;84766;79370;2597;7289;54682;5830;51729;939;8798;3824;50835;8531;353164;10635;6843;4256;121506;8079;50839;81575;56341;10536;4055;4839;359787;50837;6515;719;55138;118426;716;50840;9746;420;11272;5542;8074;25900;969;440077;339;29121;3742;51267;2026,179
-1,1,12,6108512,6252553,144041,7450,1
1,-1,12,6806571,6840710,34139,50813;196500,2
1,-1,12,7899994,8071941,171947,6515;170482;79923;144195;360030,5
1,-1,12,7899994,8088660,188666,6515;170482;79923;144195;360030,5
-1,-1,12,8003414,8088660,85246,144195;6515,2
1,-1,12,8325164,8379000,53836,55138;440077,2
1,-1,12,8325164,8379000,53836,55138;440077,2
1,-1,12,8325164,8379000,53836,55138;440077,2
1,-1,12,8325164,8379000,53836,55138;440077,2
1,-1,12,8325164,8379000,53836,55138;440077,2
1,-1,12,8325164,8379000,53836,55138;440077,2
1,-1,12,8325164,8379000,53836,55138;440077,2
1,-1,12,8325164,8379000,53836,55138;440077,2
1,-1,12,8328462,8379000,50538,55138;440077,2
1,-1,12,8328462,8379000,50538,55138;440077,2
1,-1,12,8340669,8379000,38331,55138,1
1,-1,12,8340669,8379000,38331,55138,1
1,-1,12,8352346,8379000,26654,55138,1
1,-1,12,8352346,8379000,26654,55138,1
1,-1,12,8352346,8379000,26654,55138,1
1,-1,12,8352346,8379000,26654,55138,1
-1,-1,12,9623843,9721829,97986,,0
-1,-1,12,9637353,9687869,50516,,0
-1,-1,12,9637353,9687869,50516,,0
-1,-1,12,9637353,9687869,50516,,0
-1,-1,12,9637353,9693919,56566,,0
-1,-1,12,9637353,9693919,56566,,0
-1,-1,12,9637353,9693919,56566,,0
-1,-1,12,9637353,9693919,56566,,0
-1,-1,12,9637353,9693919,56566,,0
1,-1,12,9637353,9693919,56566,,0
1,-1,12,9637353,9721829,84476,,0
-1,-1,12,9637353,9721829,84476,,0
1,-1,12,9637353,9721829,84476,,0
1,-1,12,9637353,9721829,84476,,0
1,-1,12,9637353,9721829,84476,,0
-1,-1,12,11192674,11273638,80964,259289;5554;106707243;259292,4
-1,1,12,11256448,14367063,3110615,9052;51202;5554;1389;81575;1027;653247;50865;57613;5544;2904;79370;2842;118426;2120;55507;106707243;5542;54682;2012;83445;4040;259293;80824;100129361;353164;5545,27
1,-1,12,11513416,11553484,40068,653247,1
-1,1,12,12514722,15433522,2918800,9052;51202;5149;1389;81575;1027;50865;57613;55766;2904;118426;2842;2984;55507;440087;420;79887;85004;2012;83445;144608;51729;80824;397;4256;121506;121504;55729,28
-1,1,12,12514722,15433522,2918800,9052;51202;5149;1389;81575;1027;50865;57613;55766;2904;118426;2842;2984;55507;440087;420;79887;85004;2012;83445;144608;51729;80824;397;4256;121506;121504;55729,28
-1,1,12,15993788,22174586,6180798,80763;54477;338821;5288;121536;2998;10599;93661;729025;5139;79912;3375;5965;55885;4257;28234;6579;11171;3945;89869;3764;51071;53919;10060;79785;51026,26
1,1,12,18037107,26681362,8644255,80763;338821;121536;11228;3709;55907;79912;3375;5965;160492;28234;144363;3764;10060;79785;79365;51026;6660;54477;55500;586;5288;2998;645177;10599;6489;4033;93661;3845;6579;55259;3945;89869;53919;196415;8082;9847;5139,38
-1,-1,12,21017576,21356582,339006,338821;28234;10599,3
1,-1,12,22208422,22235024,26602,55907,1
1,1,12,22329117,27545626,5216509,6660;55500;586;645177;11228;6489;4033;26127;3709;23012;160492;3845;728858;56938;144363;55259;9412;55726;196415;8082;51768;9847;79365,23
-1,1,12,22735149,24052760,1317611,55500;6660,2
-1,1,12,23674558,23735393,60835,6660,1
-1,1,12,23899592,24266672,367080,6660,1
1,-1,12,24965813,25225609,259796,645177;586;196415;4033,4
1,-1,12,25097583,25225609,128026,645177;586;196415;4033,4
-1,1,12,25416767,34217463,8800696,83857;341346;10526;55196;11228;51067;441631;3709;57542;65981;160492;51290;58516;56938;84920;636;9412;79365;51768;121512;5318;387849;1663;341359;254013;10059;26127;23012;55711;8496;341350;160518;100287284;728858;440093;196394;5744;55297;55726;8082;60488,41
1,-1,12,25485811,25623204,137393,,0
-1,-1,12,27306290,27760067,453777,341346;23012;8496;56938,4
1,-1,12,27378911,27728702,349791,341346;23012;8496;56938,4
1,-1,12,33515025,37864477,4349452,341359;84920,2
1,-1,12,33515025,37864477,4349452,341359;84920,2
1,-1,12,33515025,37864477,4349452,341359;84920,2
1,-1,12,33515025,37864477,4349452,341359;84920,2
1,-1,12,33528404,33579087,50683,341359,1
1,-1,12,33545353,37864477,4319124,341359;84920,2
1,-1,12,34044997,37864477,3819480,84920,1
1,-1,12,34044997,37864477,3819480,84920,1
1,1,12,37857750,49791459,11933709,114134;10024;5213;9416;387856;55605;196527;79962;51535;79657;377;7421;341567;225;283463;50846;51135;51303;1272;283461;121274;81539;3906;91523;144402;140461;83448;8909;784;121273;440097;341568;55652;54407;283464;55089;85478;85437;23519;347902;5630;65244;1280;54934;144165;84790;84216;29843;7471;51564;10138;112;29951;7480;9169;27289;8085;10376;121268;80070;5756;144245;120892;7846;4753;338761;904;23109;79022;121275;196528;55716;10411;5571,74
1,-1,12,38323017,38864308,541291,144245,1
1,-1,12,38323017,38864308,541291,144245,1
1,-1,12,38453610,38861446,407836,144245,1
1,-1,12,38527748,38721130,193382,144245,1
1,-1,12,38527748,38826097,298349,144245,1
1,-1,12,38527748,38826097,298349,144245,1
1,-1,12,38527748,38826097,298349,144245,1
-1,1,12,41107689,46945683,5837994,85437;80070;5756;83448;196527;144165;4753;84216;51535;440097;10138;29951;54407;51135;196528;283464;1272;9169;81539,19
-1,1,12,43928619,48084409,4155790,347902;91523;80070;5756;83448;196527;4753;84216;79657;440097;54407;51135;196528;55089;9169;81539,16
-1,-1,12,45667640,45782413,114773,196527,1
-1,1,12,50516142,53642244,3126102,113251;51350;9802;1990;3851;283471;613227;25840;3889;3892;283337;160622;3854;3695;140807;60673;4891;3856;91;3852;57228;3875;319101;374454;57609;401720;84926;341405;5463;144501;286887;1975;3887;3890;466;3891;3848;3164;283403;121006;338785;3855;3849;8435;51474;3853;51411;196374;23371;6334;7024;3888;51380;3850;94;81566;9119;25875;121391;91012;3489;9498;5916;11226;112802,65
-1,1,12,51027671,53245693,2218022,466;3891;3848;9802;1990;51350;3851;283471;613227;25840;3164;283403;3889;3892;338785;160622;3854;11226;3855;140807;60673;4891;3849;91;3852;3853;51411;196374;6334;57228;7024;3888;319101;374454;3850;94;57609;81566;401720;9119;25875;341405;121391;5463;144501;286887;9498;3887;3890;112802,50
1,-1,12,52704767,52747397,42630,3889,1
1,-1,12,52704767,52779684,74917,3890;3889;3891,3
1,-1,12,52704767,52779684,74917,3890;3889;3891,3
1,-1,12,52704767,52779684,74917,3890;3889;3891,3
1,1,12,53814390,56596726,2782336,6490;6601;6895;1606;121364;8620;3225;7786;64375;341416;3223;5869;4637;3221;5036;403282;9840;5094;3224;23583;90070;121130;3227;25946;3229;390326;85406;2647;3071;6171;6231;117159;3678;5502;84872;517;5153;11016;23468;84305;23344;57658;84324;390321;2065;254786;1017;121355;403284;196410;283365;5959;3679;53831;341418;140465;4327;390327;441639;4778;22818;269;121129;967;3222;58158;54458;390323;3178;118430;10193;3228;10220;6821;29095;254783;3226,77
-1,-1,12,57336297,57374437,38140,8608,1
-1,-1,12,57346683,57350897,4214,8608,1
-1,1,12,59495114,70574966,11079852,100129940;29110;23329;10329;9958;11197;55801;11052;8089;8445;117177;552;23592;338811;10576;4069;376132;56890;23041;283349;144453;11260;9194;2799;55508;8091;55832;144577;1368;84298;10818;50616;283417;253827;115749;57522;4193;196446;57460;5908;3458;92797;23426;51643;11213;57122,46
-1,-1,12,60367402,60454894,87492,,0
-1,1,12,61300932,66961857,5660925,100129940;29110;23329;10329;9958;11197;8091;144577;552;84298;23592;283417;338811;253827;115749;57522;57460;23041;283349;92797;11260;23426;51643;11213;2799,25
-1,-1,12,63931234,64135026,203792,283417,1
-1,-1,12,63931234,64135026,203792,283417,1
-1,-1,12,63931234,64135026,203792,283417,1
-1,-1,12,63931234,64135026,203792,283417,1
-1,-1,12,63931234,64135026,203792,283417,1
-1,-1,12,63931234,64135026,203792,283417,1
-1,-1,12,63931234,64150760,219526,283417,1
-1,-1,12,63947732,64078170,130438,283417,1
1,-1,12,63947732,64078170,130438,283417,1
1,-1,12,63947732,64078170,130438,283417,1
1,-1,12,63947732,64116509,168777,283417,1
1,-1,12,63947732,64116509,168777,283417,1
1,-1,12,63947732,64116509,168777,283417,1
1,-1,12,63947732,64116509,168777,283417,1
1,-1,12,63947732,64116509,168777,283417,1
1,-1,12,63947732,64116509,168777,283417,1
1,-1,12,63947732,64116509,168777,283417,1
1,-1,12,63947732,64116509,168777,283417,1
1,-1,12,63947732,64116509,168777,283417,1
-1,-1,12,63947732,64116509,168777,283417,1
1,-1,12,63947732,64116509,168777,283417,1
1,-1,12,63947732,64116509,168777,283417,1
1,-1,12,63947732,64116509,168777,283417,1
1,-1,12,63947732,64116509,168777,283417,1
1,-1,12,63947732,64116509,168777,283417,1
-1,-1,12,63947732,64116509,168777,283417,1
-1,-1,12,63947732,64116509,168777,283417,1
1,-1,12,64020292,64116509,96217,283417,1
-1,1,12,65838956,71420117,5581161,100129940;11052;55801;8089;8445;117177;10576;4069;376132;56890;27345;144453;55508;8091;55832;1368;5801;84298;10818;50616;253827;5787;4193;196446;4848;5908;3458;92797;23426;51643;11213;57122,32
-1,-1,12,66895380,66911133,15753,23426,1
-1,-1,12,67177292,67249002,71710,,0
-1,-1,12,67183476,67210339,26863,,0
-1,1,12,70163517,77357997,7194480,121278;23390;55266;114882;144321;1466;5801;117177;79738;64786;23011;83591;5787;196446;552889;27345;29953;4673;4848;22822;11010;8549;7103;256710;3747;84698;11103;196441,28
-1,1,12,73879477,93189581,19310104,29080;100528030;23390;574016;160335;160418;196477;79611;1833;8092;25834;552889;4673;84190;574028;160419;11081;256710;3747;84698;11103;1634;8825;84125;9182;4922;1848;8499;114882;144321;4254;5074;283310;55117;79738;694;338809;440107;6857;91298;8411;89795;144448;22822;11010;4659;4617;144455;374462;80184;8693;4060;282809;4618;1466;490,56
-1,-1,12,74338711,74420680,81969,,0
-1,-1,12,74338711,74420680,81969,,0
-1,-1,12,74359565,74468373,108808,,0
-1,-1,12,74359565,74468373,108808,,0
-1,-1,12,83091644,83140037,48393,160335,1
1,-1,12,83165733,84206428,1040695,160335,1
1,-1,12,84028770,84426004,397234,,0
-1,-1,12,86422840,86485493,62653,25834,1
-1,-1,12,88077553,88201641,124088,,0
1,1,12,91438095,109571015,18132920,84749;574016;10988;400;55785;196472;84102;120863;50511;23325;23074;59277;9971;121601;79023;80298;7296;8835;574028;121599;11081;120935;28977;27340;1634;55576;9671;5250;11163;2004;55591;29915;4048;55703;10970;283431;5128;90488;440107;1407;1610;9891;6636;55010;246213;51559;338773;144193;121551;51134;121549;7181;121441;728568;55530;11108;55332;6404;10154;57458;121642;11153;3034;3479;55967;55681;8738;83468;51019;121457;7334;23603;23479;317;56899;429;55188;4604;56994;7112;4801;7374;54434;694;338809;160728;374470;9733;55198;5367;64431;8411;387882;7184;11137;79158;1240;5053;121053;84101;144535;160428;6996;493861;5992;255394;4060;50515,108
-1,-1,12,99958415,100005273,46858,56899,1
-1,-1,12,99958415,100005273,46858,56899,1
1,-1,12,101596807,101879937,283130,160728;27340;400;121599,4
1,-1,12,109559096,109647327,88231,32,1
1,-1,12,109836267,110075116,238849,283446;83892;326625;4598;89910,5
1,-1,12,112162458,112305133,142675,8550;217;80724,3
1,-1,12,112194796,112304163,109367,8550;217;80724,3
-1,1,12,112963559,116095198,3131639,4938;115811;196463;1840;22895;10993;8437;4939;6926;80024;113675;79039;84934;64211;9904;4940;387885;53373;6910,19
-1,1,12,113515580,114810171,1294591,84934;64211;9904;115811;196463;1840;387885;53373;79039;10993;8437;6910;80024;113675,14
1,1,12,114706208,133777902,19071694,386653;51499;9612;2967;79676;7637;9735;91574;196383;22953;9921;64897;5901;9026;55206;84876;8843;23504;8739;140707;121665;23141;1337;23457;8099;5715;5827;51367;27198;23389;55884;84274;121256;144406;9478;283383;23014;65082;80196;26259;11211;2054;317781;79050;254050;5037;605;3242;56616;57634;338442;7574;54997;144423;35;5025;8683;8408;80324;84678;8562;121260;65117;192111;100289635;387893;144404;283459;11113;51329;55743;283385;54509;23067;57696;10985;55596;4326;51347;23409;4440;100533183;84530;8655;4842;57647;51433;9761;5319;92293;114795;9271;6910;5829;8638;10645;11021;100507055;101060200;79867;6926;79720;23545;64426;6175;160777;6927;6249;144347;5564;5985;22877;79369;57666;6433;5426;84900;26353;144348;2802;7699;7316;5027;54621;79794;84747;65985;10198;11066;283455;10795;1967;387890;80212;92558;353116;949;643246;84660;57605;10959;7556;196385;50614,144
-1,1,12,114828057,114832670,4613,6910,1
-1,1,12,114995645,115376925,381280,6926,1
-1,1,12,116028864,118791808,2762944,643246;79794;4842;283455;84900;26259;23389;8739;54997;55884;5985;51347;5037;54621;23014,15
1,1,12,121135475,133779076,12643601,386653;9612;2967;57647;51433;79676;7637;9761;9735;91574;196383;22953;92293;64897;5901;114795;9026;55206;84876;8843;23504;9271;8638;140707;121665;23141;10645;23457;8099;5715;5827;100507055;101060200;79867;27198;121256;144406;79720;23545;283383;65082;6249;6927;144347;80196;11211;317781;2054;79050;254050;605;3242;22877;79369;57666;56616;6433;5426;57634;338442;7574;144348;144423;2802;35;5025;7699;7316;8408;80324;5027;84678;8562;121260;65117;192111;100289635;65985;84747;387893;10198;11066;10795;1967;144404;51329;80212;55743;283385;54509;353116;23067;949;57696;84660;57605;55596;4326;10959;7556;196385;50614;100533183,103
-1,1,12,121156589,127984760,6828171,386653;9612;2967;57647;51433;79676;9735;91574;196383;64897;114795;9026;55206;84876;8843;8638;140707;121665;10645;23457;8099;5715;79867;27198;79720;144406;23545;65082;6249;6927;144347;80196;254050;605;22877;3242;79369;56616;338442;144348;35;5025;7316;5027;84678;8562;65117;65985;84747;387893;10198;11066;1967;144404;51329;80212;283385;54509;353116;23067;84660;57696;949;57605;55596;10959;196385;100533183,68
-1,1,12,122355664,128287262,5931598,56616;386653;9612;2967;338442;57647;144348;79676;9735;91574;196383;114795;9026;55206;7316;8843;8562;140707;65117;23457;8099;5715;65985;387893;10198;11066;79867;27198;1967;79720;144406;51329;23545;80212;65082;353116;949;84660;57696;6249;144347;57605;55596;10959;254050;605;196385;22877;79369;100533183,50
1,-1,12,123185916,123187546,1630,338442,1
1,-1,12,123185916,123187546,1630,338442,1
1,-1,12,123185916,123199400,13484,338442;8843,2
1,-1,12,123185916,123199400,13484,338442;8843,2
1,-1,12,123185916,123199400,13484,338442;8843,2
1,-1,12,123185916,123199400,13484,338442;8843,2
1,-1,12,123185916,123199400,13484,338442;8843,2
1,-1,12,123185916,123199400,13484,338442;8843,2
1,-1,12,123185916,123199400,13484,338442;8843,2
1,-1,12,123185916,123199400,13484,338442;8843,2
1,-1,12,123185916,123199400,13484,338442;8843,2
1,-1,12,123185916,123199400,13484,338442;8843,2
1,-1,12,123185916,123199400,13484,338442;8843,2
1,-1,12,123185916,123199400,13484,338442;8843,2
1,-1,12,123185916,123200173,14257,338442;8843,2
1,-1,12,123185916,123200755,14839,338442;8843,2
1,1,12,123994372,133767986,9773614,6433;5426;9612;57634;2967;57647;7574;144348;144423;2802;7637;22953;7699;92293;5901;114795;7316;9271;23504;8408;80324;140707;121260;23141;192111;100289635;65985;5827;100507055;101060200;79867;10795;1967;23545;121256;80212;283383;55743;353116;949;57696;144347;4326;11211;317781;2054;79050;10959;7556;196385;50614;57666;100533183,53
1,-1,12,124113899,124192840,78941,2967;1967;79867,3
-1,-1,12,126647428,126794429,147001,,0
-1,-1,12,127696154,127798205,102051,,0
1,-1,12,128590089,128689778,99689,,0
1,-1,12,131450373,132135146,684773,283383,1
-1,-1,12,131733523,132078262,344739,,0
-1,1,12,131749518,133777902,2028384,6433;192111;100289635;5426;5827;57634;100507055;7574;101060200;10795;2802;7637;22953;7699;55743;4326;8408;80324;317781;79050;7556;23141;50614;57666,24
-1,-1,12,131839750,132089098,249348,,0
-1,1,12,131862310,133777902,1915592,6433;192111;100289635;5426;5827;57634;100507055;7574;101060200;10795;2802;7637;22953;7699;55743;4326;8408;80324;317781;79050;7556;23141;50614;57666,24
-1,1,12,132135087,133767986,1632899,6433;192111;100289635;5426;5827;57634;100507055;7574;101060200;10795;2802;7637;22953;7699;55743;4326;8408;80324;317781;79050;7556;23141;50614;57666,24
-1,1,12,132382041,133777902,1395861,192111;100289635;5426;5827;57634;100507055;7574;101060200;10795;2802;7637;22953;7699;55743;8408;80324;317781;79050;7556;23141;50614;57666,22
1,-1,12,132701526,132746992,45466,50614,1
1,-1,12,132701526,132746992,45466,50614,1
1,-1,12,132726992,132746992,20000,50614,1
1,-1,12,132726992,132746992,20000,50614,1
1,-1,12,132726992,132746992,20000,50614,1
1,-1,12,132726992,132746992,20000,50614,1
1,-1,12,132726992,132746992,20000,50614,1
1,-1,12,132726992,132826002,99010,50614,1
1,-1,12,132736992,132826002,89010,50614,1
-1,1,12,133153200,133767986,614786,192111;100289635;5426;5827;100507055;7574;101060200;10795;2802;7637;22953;7699;55743;7556;23141;57666,16
1,1,12,133324869,133777902,453033,100289635;7574;101060200;10795;2802;7637;7556;23141;7699;55743,10
1,-1,12,133712947,133779017,66070,10795;7556,2
1,-1,12,133727565,133772989,45424,10795;7556,2
1,-1,12,133763907,133773393,9486,10795,1
-1,1,13,19020001,115085141,96065140,7027;79612;2862;283518;23026;144809;57213;10426;730249;84945;10804;26960;64881;400165;100129307;7174;113622;4081;9882;221154;3839;90634;54841;1602;11215;10631;29079;5457;386618;3621;5983;122011;56163;5925;341640;5994;10257;2155;221143;283537;8451;27253;81550;107303344;6445;100526761;144811;64062;10208;337867;219409;2308;387921;161003;84056;26224;729250;81624;5100;219287;5101;145173;1045;10166;122183;115825;81602;10240;253512;1361;29103;57511;338872;220081;1024;26278;220416;440145;93081;55270;100129836;2159;6144;54602;2262;9365;9107;78988;115207;729240;79774;2841;26586;9724;55647;10160;6541;729420;8428;220108;84078;5412;55213;51761;9818;675;540;23111;729233;23077;9201;51131;79758;8848;93492;3356;3843;6564;57626;4752;10910;10284;2073;90627;9617;23250;3981;496;54737;79596;26747;10253;11166;53342;219402;84935;259232;1997;57105;79866;1102;728215;11278;2963;26512;643677;387911;3651;688;255967;55835;8660;5911;220107;220082;22894;4008;7278;171425;440138;55901;8796;646625;9205;23281;122046;6656;83548;6555;51569;2259;79587;3146;2322;3916;8874;55757;89890;55608;241;8858;646799;22862;122042;7546;51082;65110;10673;55068;26050;9375;55425;9071;196541;10150;8100;122060;253832;266722;8803;27199;140432;4285;55504;170622;1282;1948;542767;122258;51028;267012;7347;221178;10562;10443;84899;83446;2971;479;79070;1284;400120;2098;4093;10186;94240;283489;23263;55269;55739;1203;387923;283514;23483;2835;80209;5611;3936;10808;79024;2321;85416;348013;100533467;54937;55795;51084;160897;8900;22873;341676;7178;1880;101928841;55578;29880;23348;2254;387914;2706;10206;6049;23143;9358;115761;26524;219333;84189;87769;10082;643365;10161;55002;728591;84650;64328;23078;28984;7223;11061;222484;647174;6011;51371;83852;22821;144983;79621;23047;10129;221150;1910;2700;2621;729246;10464;114798;121793;143;81617;160857;11193;160851;10810;7750;55082;5095;9445;5042;1638;8881;8600;55208;23091;387496;80183;11340,317
1,1,13,19030180,115105760,96075580,7027;79612;2862;283518;23026;144809;57213;10426;730249;84945;10804;26960;64881;400165;100129307;7174;113622;4081;9882;221154;3839;90634;54841;1602;11215;10631;29079;5457;386618;3621;5983;122011;56163;5925;341640;5994;10257;2155;221143;283537;8451;27253;81550;107303344;6445;100526761;144811;64062;10208;337867;219409;2308;387921;161003;84056;26224;729250;81624;5100;219287;5101;145173;1045;10166;122183;115825;81602;10240;253512;1361;29103;57511;338872;220081;1024;26278;220416;440145;93081;55270;100129836;2159;6144;54602;2262;9365;9107;78988;115207;729240;79774;2841;26586;9724;55647;10160;6541;729420;8428;220108;84078;5412;55213;51761;9818;675;540;23111;729233;23077;9201;51131;79758;8848;93492;3356;3843;6564;57626;4752;10910;10284;2073;90627;9617;23250;3981;496;54737;79596;26747;10253;11166;53342;219402;84935;259232;1997;57105;79866;1102;728215;11278;2963;26512;643677;387911;3651;688;255967;55835;8660;5911;220107;220082;22894;4008;7278;171425;440138;55901;8796;646625;9205;23281;122046;6656;83548;6555;51569;2259;79587;3146;2322;3916;8874;55757;89890;55608;241;8858;646799;22862;122042;7546;51082;65110;10673;55068;26050;9375;55425;9071;196541;10150;8100;122060;253832;266722;8803;27199;140432;4285;55504;170622;1282;1948;542767;122258;51028;267012;7347;221178;10562;10443;84899;83446;2971;479;79070;1284;400120;2098;4093;10186;94240;283489;23263;55269;55739;1203;387923;283514;23483;2835;80209;5611;3936;10808;79024;2321;85416;348013;100533467;54937;55795;51084;160897;8900;22873;341676;7178;1880;101928841;55578;29880;23348;2254;387914;2706;10206;6049;23143;9358;115761;26524;219333;84189;87769;10082;643365;10161;55002;728591;84650;64328;23078;28984;7223;11061;222484;647174;6011;51371;83852;22821;144983;79621;23047;10129;221150;1910;2700;2621;729246;10464;114798;121793;143;81617;160857;11193;160851;10810;7750;55082;5095;9445;5042;1638;8881;8600;55208;23091;387496;80183;11340,317
1,-1,13,19327344,19380812,53468,,0
1,-1,13,19327344,19380812,53468,,0
1,-1,13,19327344,19380812,53468,,0
1,1,13,19436286,23063313,3627027,51084;78988;53342;26524;55269;7278;8100;253832;93492;10284;7750;64328;9205;10804;221150;2700;221143;2254;2706;54737;221154,21
1,1,13,19436286,34151488,14715202,51084;3146;2322;241;646799;387496;122042;6541;10804;9107;51082;2254;387914;2706;51761;5412;6049;221154;9818;675;90634;26524;8100;219333;253832;93492;10284;4285;55504;64328;56163;90627;222484;221143;283537;542767;51371;54737;6445;221178;78988;10208;53342;219409;219402;84935;10443;84056;23047;10129;221150;479;2700;219287;387911;3651;145173;1045;255967;55835;143;338872;55269;7278;1024;26278;2835;10810;7750;646625;9205;23281;10808;5042;122046;2321;6144;9365;2971,79
1,1,13,19436286,115107733,95671447,7027;79612;2862;283518;23026;144809;57213;10426;730249;84945;10804;26960;64881;400165;100129307;7174;113622;4081;9882;221154;3839;90634;54841;1602;11215;10631;29079;5457;386618;3621;5983;122011;56163;5925;341640;5994;10257;2155;221143;283537;8451;27253;81550;107303344;6445;100526761;144811;64062;10208;337867;219409;2308;387921;161003;84056;26224;729250;81624;5100;219287;5101;145173;1045;10166;122183;115825;81602;10240;253512;1361;29103;57511;338872;220081;1024;26278;220416;440145;93081;55270;100129836;2159;6144;54602;2262;9365;9107;78988;115207;729240;79774;2841;26586;9724;55647;10160;6541;729420;8428;220108;84078;5412;55213;51761;9818;675;540;23111;729233;23077;9201;51131;79758;8848;93492;3356;3843;6564;57626;4752;10910;10284;2073;90627;9617;23250;3981;496;54737;79596;26747;10253;11166;53342;219402;84935;259232;1997;57105;79866;1102;728215;11278;2963;26512;643677;387911;3651;688;255967;55835;8660;5911;220107;220082;22894;4008;7278;171425;440138;55901;8796;646625;9205;23281;122046;6656;83548;6555;51569;2259;79587;3146;2322;3916;8874;55757;89890;55608;241;8858;646799;22862;122042;7546;51082;65110;10673;55068;26050;9375;55425;9071;196541;10150;8100;122060;253832;266722;8803;27199;140432;4285;55504;170622;1282;1948;542767;122258;51028;267012;7347;221178;10562;10443;84899;83446;2971;479;79070;1284;400120;2098;4093;10186;94240;283489;23263;55269;55739;1203;387923;283514;23483;2835;80209;5611;3936;10808;79024;2321;85416;348013;100533467;54937;55795;51084;160897;8900;22873;341676;7178;1880;101928841;55578;29880;23348;2254;387914;2706;10206;6049;23143;9358;115761;26524;219333;84189;87769;10082;643365;10161;55002;728591;84650;64328;23078;28984;7223;11061;222484;647174;6011;51371;83852;22821;144983;79621;23047;10129;221150;1910;2700;2621;729246;10464;114798;121793;143;81617;160857;11193;160851;10810;7750;55082;5095;9445;5042;1638;8881;8600;55208;23091;387496;80183;11340,317
1,1,13,19436286,115107733,95671447,7027;79612;2862;283518;23026;144809;57213;10426;730249;84945;10804;26960;64881;400165;100129307;7174;113622;4081;9882;221154;3839;90634;54841;1602;11215;10631;29079;5457;386618;3621;5983;122011;56163;5925;341640;5994;10257;2155;221143;283537;8451;27253;81550;107303344;6445;100526761;144811;64062;10208;337867;219409;2308;387921;161003;84056;26224;729250;81624;5100;219287;5101;145173;1045;10166;122183;115825;81602;10240;253512;1361;29103;57511;338872;220081;1024;26278;220416;440145;93081;55270;100129836;2159;6144;54602;2262;9365;9107;78988;115207;729240;79774;2841;26586;9724;55647;10160;6541;729420;8428;220108;84078;5412;55213;51761;9818;675;540;23111;729233;23077;9201;51131;79758;8848;93492;3356;3843;6564;57626;4752;10910;10284;2073;90627;9617;23250;3981;496;54737;79596;26747;10253;11166;53342;219402;84935;259232;1997;57105;79866;1102;728215;11278;2963;26512;643677;387911;3651;688;255967;55835;8660;5911;220107;220082;22894;4008;7278;171425;440138;55901;8796;646625;9205;23281;122046;6656;83548;6555;51569;2259;79587;3146;2322;3916;8874;55757;89890;55608;241;8858;646799;22862;122042;7546;51082;65110;10673;55068;26050;9375;55425;9071;196541;10150;8100;122060;253832;266722;8803;27199;140432;4285;55504;170622;1282;1948;542767;122258;51028;267012;7347;221178;10562;10443;84899;83446;2971;479;79070;1284;400120;2098;4093;10186;94240;283489;23263;55269;55739;1203;387923;283514;23483;2835;80209;5611;3936;10808;79024;2321;85416;348013;100533467;54937;55795;51084;160897;8900;22873;341676;7178;1880;101928841;55578;29880;23348;2254;387914;2706;10206;6049;23143;9358;115761;26524;219333;84189;87769;10082;643365;10161;55002;728591;84650;64328;23078;28984;7223;11061;222484;647174;6011;51371;83852;22821;144983;79621;23047;10129;221150;1910;2700;2621;729246;10464;114798;121793;143;81617;160857;11193;160851;10810;7750;55082;5095;9445;5042;1638;8881;8600;55208;23091;387496;80183;11340,317
1,1,13,19436287,115107733,95671446,7027;79612;2862;283518;23026;144809;57213;10426;730249;84945;10804;26960;64881;400165;100129307;7174;113622;4081;9882;221154;3839;90634;54841;1602;11215;10631;29079;5457;386618;3621;5983;122011;56163;5925;341640;5994;10257;2155;221143;283537;8451;27253;81550;107303344;6445;100526761;144811;64062;10208;337867;219409;2308;387921;161003;84056;26224;729250;81624;5100;219287;5101;145173;1045;10166;122183;115825;81602;10240;253512;1361;29103;57511;338872;220081;1024;26278;220416;440145;93081;55270;100129836;2159;6144;54602;2262;9365;9107;78988;115207;729240;79774;2841;26586;9724;55647;10160;6541;729420;8428;220108;84078;5412;55213;51761;9818;675;540;23111;729233;23077;9201;51131;79758;8848;93492;3356;3843;6564;57626;4752;10910;10284;2073;90627;9617;23250;3981;496;54737;79596;26747;10253;11166;53342;219402;84935;259232;1997;57105;79866;1102;728215;11278;2963;26512;643677;387911;3651;688;255967;55835;8660;5911;220107;220082;22894;4008;7278;171425;440138;55901;8796;646625;9205;23281;122046;6656;83548;6555;51569;2259;79587;3146;2322;3916;8874;55757;89890;55608;241;8858;646799;22862;122042;7546;51082;65110;10673;55068;26050;9375;55425;9071;196541;10150;8100;122060;253832;266722;8803;27199;140432;4285;55504;170622;1282;1948;542767;122258;51028;267012;7347;221178;10562;10443;84899;83446;2971;479;79070;1284;400120;2098;4093;10186;94240;283489;23263;55269;55739;1203;387923;283514;23483;2835;80209;5611;3936;10808;79024;2321;85416;348013;100533467;54937;55795;51084;160897;8900;22873;341676;7178;1880;101928841;55578;29880;23348;2254;387914;2706;10206;6049;23143;9358;115761;26524;219333;84189;87769;10082;643365;10161;55002;728591;84650;64328;23078;28984;7223;11061;222484;647174;6011;51371;83852;22821;144983;79621;23047;10129;221150;1910;2700;2621;729246;10464;114798;121793;143;81617;160857;11193;160851;10810;7750;55082;5095;9445;5042;1638;8881;8600;55208;23091;387496;80183;11340,317
1,1,13,19436287,115107733,95671446,7027;79612;2862;283518;23026;144809;57213;10426;730249;84945;10804;26960;64881;400165;100129307;7174;113622;4081;9882;221154;3839;90634;54841;1602;11215;10631;29079;5457;386618;3621;5983;122011;56163;5925;341640;5994;10257;2155;221143;283537;8451;27253;81550;107303344;6445;100526761;144811;64062;10208;337867;219409;2308;387921;161003;84056;26224;729250;81624;5100;219287;5101;145173;1045;10166;122183;115825;81602;10240;253512;1361;29103;57511;338872;220081;1024;26278;220416;440145;93081;55270;100129836;2159;6144;54602;2262;9365;9107;78988;115207;729240;79774;2841;26586;9724;55647;10160;6541;729420;8428;220108;84078;5412;55213;51761;9818;675;540;23111;729233;23077;9201;51131;79758;8848;93492;3356;3843;6564;57626;4752;10910;10284;2073;90627;9617;23250;3981;496;54737;79596;26747;10253;11166;53342;219402;84935;259232;1997;57105;79866;1102;728215;11278;2963;26512;643677;387911;3651;688;255967;55835;8660;5911;220107;220082;22894;4008;7278;171425;440138;55901;8796;646625;9205;23281;122046;6656;83548;6555;51569;2259;79587;3146;2322;3916;8874;55757;89890;55608;241;8858;646799;22862;122042;7546;51082;65110;10673;55068;26050;9375;55425;9071;196541;10150;8100;122060;253832;266722;8803;27199;140432;4285;55504;170622;1282;1948;542767;122258;51028;267012;7347;221178;10562;10443;84899;83446;2971;479;79070;1284;400120;2098;4093;10186;94240;283489;23263;55269;55739;1203;387923;283514;23483;2835;80209;5611;3936;10808;79024;2321;85416;348013;100533467;54937;55795;51084;160897;8900;22873;341676;7178;1880;101928841;55578;29880;23348;2254;387914;2706;10206;6049;23143;9358;115761;26524;219333;84189;87769;10082;643365;10161;55002;728591;84650;64328;23078;28984;7223;11061;222484;647174;6011;51371;83852;22821;144983;79621;23047;10129;221150;1910;2700;2621;729246;10464;114798;121793;143;81617;160857;11193;160851;10810;7750;55082;5095;9445;5042;1638;8881;8600;55208;23091;387496;80183;11340,317
1,1,13,19436287,115107733,95671446,7027;79612;2862;283518;23026;144809;57213;10426;730249;84945;10804;26960;64881;400165;100129307;7174;113622;4081;9882;221154;3839;90634;54841;1602;11215;10631;29079;5457;386618;3621;5983;122011;56163;5925;341640;5994;10257;2155;221143;283537;8451;27253;81550;107303344;6445;100526761;144811;64062;10208;337867;219409;2308;387921;161003;84056;26224;729250;81624;5100;219287;5101;145173;1045;10166;122183;115825;81602;10240;253512;1361;29103;57511;338872;220081;1024;26278;220416;440145;93081;55270;100129836;2159;6144;54602;2262;9365;9107;78988;115207;729240;79774;2841;26586;9724;55647;10160;6541;729420;8428;220108;84078;5412;55213;51761;9818;675;540;23111;729233;23077;9201;51131;79758;8848;93492;3356;3843;6564;57626;4752;10910;10284;2073;90627;9617;23250;3981;496;54737;79596;26747;10253;11166;53342;219402;84935;259232;1997;57105;79866;1102;728215;11278;2963;26512;643677;387911;3651;688;255967;55835;8660;5911;220107;220082;22894;4008;7278;171425;440138;55901;8796;646625;9205;23281;122046;6656;83548;6555;51569;2259;79587;3146;2322;3916;8874;55757;89890;55608;241;8858;646799;22862;122042;7546;51082;65110;10673;55068;26050;9375;55425;9071;196541;10150;8100;122060;253832;266722;8803;27199;140432;4285;55504;170622;1282;1948;542767;122258;51028;267012;7347;221178;10562;10443;84899;83446;2971;479;79070;1284;400120;2098;4093;10186;94240;283489;23263;55269;55739;1203;387923;283514;23483;2835;80209;5611;3936;10808;79024;2321;85416;348013;100533467;54937;55795;51084;160897;8900;22873;341676;7178;1880;101928841;55578;29880;23348;2254;387914;2706;10206;6049;23143;9358;115761;26524;219333;84189;87769;10082;643365;10161;55002;728591;84650;64328;23078;28984;7223;11061;222484;647174;6011;51371;83852;22821;144983;79621;23047;10129;221150;1910;2700;2621;729246;10464;114798;121793;143;81617;160857;11193;160851;10810;7750;55082;5095;9445;5042;1638;8881;8600;55208;23091;387496;80183;11340,317
1,1,13,19436287,115107733,95671446,7027;79612;2862;283518;23026;144809;57213;10426;730249;84945;10804;26960;64881;400165;100129307;7174;113622;4081;9882;221154;3839;90634;54841;1602;11215;10631;29079;5457;386618;3621;5983;122011;56163;5925;341640;5994;10257;2155;221143;283537;8451;27253;81550;107303344;6445;100526761;144811;64062;10208;337867;219409;2308;387921;161003;84056;26224;729250;81624;5100;219287;5101;145173;1045;10166;122183;115825;81602;10240;253512;1361;29103;57511;338872;220081;1024;26278;220416;440145;93081;55270;100129836;2159;6144;54602;2262;9365;9107;78988;115207;729240;79774;2841;26586;9724;55647;10160;6541;729420;8428;220108;84078;5412;55213;51761;9818;675;540;23111;729233;23077;9201;51131;79758;8848;93492;3356;3843;6564;57626;4752;10910;10284;2073;90627;9617;23250;3981;496;54737;79596;26747;10253;11166;53342;219402;84935;259232;1997;57105;79866;1102;728215;11278;2963;26512;643677;387911;3651;688;255967;55835;8660;5911;220107;220082;22894;4008;7278;171425;440138;55901;8796;646625;9205;23281;122046;6656;83548;6555;51569;2259;79587;3146;2322;3916;8874;55757;89890;55608;241;8858;646799;22862;122042;7546;51082;65110;10673;55068;26050;9375;55425;9071;196541;10150;8100;122060;253832;266722;8803;27199;140432;4285;55504;170622;1282;1948;542767;122258;51028;267012;7347;221178;10562;10443;84899;83446;2971;479;79070;1284;400120;2098;4093;10186;94240;283489;23263;55269;55739;1203;387923;283514;23483;2835;80209;5611;3936;10808;79024;2321;85416;348013;100533467;54937;55795;51084;160897;8900;22873;341676;7178;1880;101928841;55578;29880;23348;2254;387914;2706;10206;6049;23143;9358;115761;26524;219333;84189;87769;10082;643365;10161;55002;728591;84650;64328;23078;28984;7223;11061;222484;647174;6011;51371;83852;22821;144983;79621;23047;10129;221150;1910;2700;2621;729246;10464;114798;121793;143;81617;160857;11193;160851;10810;7750;55082;5095;9445;5042;1638;8881;8600;55208;23091;387496;80183;11340,317
1,1,13,19436287,115107733,95671446,7027;79612;2862;283518;23026;144809;57213;10426;730249;84945;10804;26960;64881;400165;100129307;7174;113622;4081;9882;221154;3839;90634;54841;1602;11215;10631;29079;5457;386618;3621;5983;122011;56163;5925;341640;5994;10257;2155;221143;283537;8451;27253;81550;107303344;6445;100526761;144811;64062;10208;337867;219409;2308;387921;161003;84056;26224;729250;81624;5100;219287;5101;145173;1045;10166;122183;115825;81602;10240;253512;1361;29103;57511;338872;220081;1024;26278;220416;440145;93081;55270;100129836;2159;6144;54602;2262;9365;9107;78988;115207;729240;79774;2841;26586;9724;55647;10160;6541;729420;8428;220108;84078;5412;55213;51761;9818;675;540;23111;729233;23077;9201;51131;79758;8848;93492;3356;3843;6564;57626;4752;10910;10284;2073;90627;9617;23250;3981;496;54737;79596;26747;10253;11166;53342;219402;84935;259232;1997;57105;79866;1102;728215;11278;2963;26512;643677;387911;3651;688;255967;55835;8660;5911;220107;220082;22894;4008;7278;171425;440138;55901;8796;646625;9205;23281;122046;6656;83548;6555;51569;2259;79587;3146;2322;3916;8874;55757;89890;55608;241;8858;646799;22862;122042;7546;51082;65110;10673;55068;26050;9375;55425;9071;196541;10150;8100;122060;253832;266722;8803;27199;140432;4285;55504;170622;1282;1948;542767;122258;51028;267012;7347;221178;10562;10443;84899;83446;2971;479;79070;1284;400120;2098;4093;10186;94240;283489;23263;55269;55739;1203;387923;283514;23483;2835;80209;5611;3936;10808;79024;2321;85416;348013;100533467;54937;55795;51084;160897;8900;22873;341676;7178;1880;101928841;55578;29880;23348;2254;387914;2706;10206;6049;23143;9358;115761;26524;219333;84189;87769;10082;643365;10161;55002;728591;84650;64328;23078;28984;7223;11061;222484;647174;6011;51371;83852;22821;144983;79621;23047;10129;221150;1910;2700;2621;729246;10464;114798;121793;143;81617;160857;11193;160851;10810;7750;55082;5095;9445;5042;1638;8881;8600;55208;23091;387496;80183;11340,317
1,1,13,19571503,115092510,95521007,7027;79612;2862;283518;23026;144809;57213;10426;730249;84945;10804;26960;64881;400165;100129307;7174;113622;4081;9882;221154;3839;90634;54841;1602;11215;10631;29079;5457;386618;3621;5983;122011;56163;5925;341640;5994;10257;2155;221143;283537;8451;27253;81550;107303344;6445;100526761;144811;64062;10208;337867;219409;2308;387921;161003;84056;26224;729250;81624;5100;219287;5101;145173;1045;10166;122183;115825;81602;10240;253512;1361;29103;57511;338872;220081;1024;26278;220416;440145;93081;55270;100129836;2159;6144;54602;2262;9365;9107;78988;115207;729240;79774;2841;26586;9724;55647;10160;6541;729420;8428;220108;84078;5412;55213;51761;9818;675;540;23111;729233;23077;9201;51131;79758;8848;93492;3356;3843;6564;57626;4752;10910;10284;2073;90627;9617;23250;3981;496;54737;79596;26747;10253;11166;53342;219402;84935;259232;1997;57105;79866;1102;728215;11278;2963;26512;643677;387911;3651;688;255967;55835;8660;5911;220107;220082;22894;4008;7278;171425;440138;55901;8796;646625;9205;23281;122046;6656;83548;6555;51569;2259;79587;3146;2322;3916;8874;55757;89890;55608;241;8858;646799;22862;122042;7546;51082;65110;10673;55068;26050;9375;55425;9071;196541;10150;8100;122060;253832;266722;8803;27199;140432;4285;55504;170622;1282;1948;542767;122258;51028;267012;7347;221178;10562;10443;84899;83446;2971;479;79070;1284;400120;2098;4093;10186;94240;283489;23263;55269;55739;1203;387923;283514;23483;2835;80209;5611;3936;10808;79024;2321;85416;348013;100533467;54937;55795;51084;160897;8900;22873;341676;7178;1880;101928841;55578;29880;23348;2254;387914;2706;10206;6049;23143;9358;115761;26524;219333;84189;87769;10082;643365;10161;55002;728591;84650;64328;23078;28984;7223;11061;222484;647174;6011;51371;83852;22821;144983;79621;23047;10129;221150;1910;2700;2621;729246;10464;114798;121793;143;81617;160857;11193;160851;10810;7750;55082;5095;9445;5042;1638;8881;8600;55208;23091;387496;80183;11340,317
1,1,13,19571503,115092510,95521007,7027;79612;2862;283518;23026;144809;57213;10426;730249;84945;10804;26960;64881;400165;100129307;7174;113622;4081;9882;221154;3839;90634;54841;1602;11215;10631;29079;5457;386618;3621;5983;122011;56163;5925;341640;5994;10257;2155;221143;283537;8451;27253;81550;107303344;6445;100526761;144811;64062;10208;337867;219409;2308;387921;161003;84056;26224;729250;81624;5100;219287;5101;145173;1045;10166;122183;115825;81602;10240;253512;1361;29103;57511;338872;220081;1024;26278;220416;440145;93081;55270;100129836;2159;6144;54602;2262;9365;9107;78988;115207;729240;79774;2841;26586;9724;55647;10160;6541;729420;8428;220108;84078;5412;55213;51761;9818;675;540;23111;729233;23077;9201;51131;79758;8848;93492;3356;3843;6564;57626;4752;10910;10284;2073;90627;9617;23250;3981;496;54737;79596;26747;10253;11166;53342;219402;84935;259232;1997;57105;79866;1102;728215;11278;2963;26512;643677;387911;3651;688;255967;55835;8660;5911;220107;220082;22894;4008;7278;171425;440138;55901;8796;646625;9205;23281;122046;6656;83548;6555;51569;2259;79587;3146;2322;3916;8874;55757;89890;55608;241;8858;646799;22862;122042;7546;51082;65110;10673;55068;26050;9375;55425;9071;196541;10150;8100;122060;253832;266722;8803;27199;140432;4285;55504;170622;1282;1948;542767;122258;51028;267012;7347;221178;10562;10443;84899;83446;2971;479;79070;1284;400120;2098;4093;10186;94240;283489;23263;55269;55739;1203;387923;283514;23483;2835;80209;5611;3936;10808;79024;2321;85416;348013;100533467;54937;55795;51084;160897;8900;22873;341676;7178;1880;101928841;55578;29880;23348;2254;387914;2706;10206;6049;23143;9358;115761;26524;219333;84189;87769;10082;643365;10161;55002;728591;84650;64328;23078;28984;7223;11061;222484;647174;6011;51371;83852;22821;144983;79621;23047;10129;221150;1910;2700;2621;729246;10464;114798;121793;143;81617;160857;11193;160851;10810;7750;55082;5095;9445;5042;1638;8881;8600;55208;23091;387496;80183;11340,317
1,-1,13,20026165,20129722,103557,93492,1
-1,1,13,20246074,25560010,5313936,6445;51084;221178;143;78988;53342;26524;55269;338872;8100;253832;26278;10284;4285;7750;64328;9205;10804;221150;2700;479;55504;56163;387911;221143;542767;2254;2706;54737;221154;55835,31
1,1,13,20246074,41488903,21242829,51569;51084;3146;2322;8900;241;646799;387496;122042;6541;10804;26960;9107;55578;29880;51082;4081;2254;387914;2706;51761;5412;6049;221154;9818;675;90634;11340;26524;23111;9201;8100;219333;253832;10631;10284;4285;728591;5983;55504;122011;56163;64328;7223;90627;222484;341640;5994;221143;283537;542767;51371;54737;6445;221178;100526761;78988;10208;53342;219409;219402;84935;2308;387921;10443;161003;84056;23047;10129;221150;479;2700;400120;219287;4093;387911;3651;145173;1045;10186;10166;255967;55835;10240;143;57511;338872;55269;1024;26278;2835;10810;80209;7750;646625;9205;23281;10808;5042;122046;2321;6144;9365;2971;54937,105
1,1,13,20246074,115085141,94839067,7027;79612;2862;283518;23026;144809;57213;10426;730249;84945;10804;26960;64881;400165;100129307;7174;113622;4081;9882;221154;3839;90634;54841;1602;11215;10631;29079;5457;386618;3621;5983;122011;56163;5925;341640;5994;10257;2155;221143;283537;8451;27253;81550;107303344;6445;100526761;144811;64062;10208;337867;219409;2308;387921;161003;84056;26224;729250;81624;5100;219287;5101;145173;1045;10166;122183;115825;81602;10240;253512;1361;29103;57511;338872;220081;1024;26278;220416;440145;93081;55270;100129836;2159;6144;54602;2262;9365;9107;78988;115207;729240;79774;2841;26586;9724;55647;10160;6541;729420;8428;220108;84078;5412;55213;51761;9818;675;540;23111;729233;23077;9201;51131;79758;8848;3356;3843;6564;57626;4752;10910;10284;2073;90627;9617;23250;3981;496;54737;79596;26747;10253;11166;53342;219402;84935;259232;1997;57105;79866;1102;728215;11278;2963;26512;643677;387911;3651;688;255967;55835;8660;5911;220107;220082;22894;4008;171425;440138;55901;8796;646625;9205;23281;122046;6656;83548;6555;51569;2259;79587;3146;2322;3916;8874;55757;89890;55608;241;8858;646799;22862;122042;7546;51082;65110;10673;55068;26050;9375;55425;9071;196541;10150;8100;122060;253832;266722;8803;27199;140432;4285;55504;170622;1282;1948;542767;122258;51028;267012;7347;221178;10562;10443;84899;83446;2971;479;79070;1284;400120;2098;4093;10186;94240;283489;23263;55269;55739;1203;387923;283514;23483;2835;80209;5611;3936;10808;79024;2321;85416;348013;100533467;54937;55795;51084;160897;8900;22873;341676;7178;1880;101928841;55578;29880;23348;2254;387914;2706;10206;6049;23143;9358;115761;26524;219333;84189;87769;10082;643365;10161;55002;728591;84650;64328;23078;28984;7223;11061;222484;647174;6011;51371;83852;22821;144983;79621;23047;10129;221150;1910;2700;2621;729246;10464;114798;121793;143;81617;160857;11193;160851;10810;7750;55082;5095;9445;5042;1638;8881;8600;55208;23091;387496;80183;11340,315
1,1,13,20246074,115085141,94839067,7027;79612;2862;283518;23026;144809;57213;10426;730249;84945;10804;26960;64881;400165;100129307;7174;113622;4081;9882;221154;3839;90634;54841;1602;11215;10631;29079;5457;386618;3621;5983;122011;56163;5925;341640;5994;10257;2155;221143;283537;8451;27253;81550;107303344;6445;100526761;144811;64062;10208;337867;219409;2308;387921;161003;84056;26224;729250;81624;5100;219287;5101;145173;1045;10166;122183;115825;81602;10240;253512;1361;29103;57511;338872;220081;1024;26278;220416;440145;93081;55270;100129836;2159;6144;54602;2262;9365;9107;78988;115207;729240;79774;2841;26586;9724;55647;10160;6541;729420;8428;220108;84078;5412;55213;51761;9818;675;540;23111;729233;23077;9201;51131;79758;8848;3356;3843;6564;57626;4752;10910;10284;2073;90627;9617;23250;3981;496;54737;79596;26747;10253;11166;53342;219402;84935;259232;1997;57105;79866;1102;728215;11278;2963;26512;643677;387911;3651;688;255967;55835;8660;5911;220107;220082;22894;4008;171425;440138;55901;8796;646625;9205;23281;122046;6656;83548;6555;51569;2259;79587;3146;2322;3916;8874;55757;89890;55608;241;8858;646799;22862;122042;7546;51082;65110;10673;55068;26050;9375;55425;9071;196541;10150;8100;122060;253832;266722;8803;27199;140432;4285;55504;170622;1282;1948;542767;122258;51028;267012;7347;221178;10562;10443;84899;83446;2971;479;79070;1284;400120;2098;4093;10186;94240;283489;23263;55269;55739;1203;387923;283514;23483;2835;80209;5611;3936;10808;79024;2321;85416;348013;100533467;54937;55795;51084;160897;8900;22873;341676;7178;1880;101928841;55578;29880;23348;2254;387914;2706;10206;6049;23143;9358;115761;26524;219333;84189;87769;10082;643365;10161;55002;728591;84650;64328;23078;28984;7223;11061;222484;647174;6011;51371;83852;22821;144983;79621;23047;10129;221150;1910;2700;2621;729246;10464;114798;121793;143;81617;160857;11193;160851;10810;7750;55082;5095;9445;5042;1638;8881;8600;55208;23091;387496;80183;11340,315
1,1,13,20246074,115085141,94839067,7027;79612;2862;283518;23026;144809;57213;10426;730249;84945;10804;26960;64881;400165;100129307;7174;113622;4081;9882;221154;3839;90634;54841;1602;11215;10631;29079;5457;386618;3621;5983;122011;56163;5925;341640;5994;10257;2155;221143;283537;8451;27253;81550;107303344;6445;100526761;144811;64062;10208;337867;219409;2308;387921;161003;84056;26224;729250;81624;5100;219287;5101;145173;1045;10166;122183;115825;81602;10240;253512;1361;29103;57511;338872;220081;1024;26278;220416;440145;93081;55270;100129836;2159;6144;54602;2262;9365;9107;78988;115207;729240;79774;2841;26586;9724;55647;10160;6541;729420;8428;220108;84078;5412;55213;51761;9818;675;540;23111;729233;23077;9201;51131;79758;8848;3356;3843;6564;57626;4752;10910;10284;2073;90627;9617;23250;3981;496;54737;79596;26747;10253;11166;53342;219402;84935;259232;1997;57105;79866;1102;728215;11278;2963;26512;643677;387911;3651;688;255967;55835;8660;5911;220107;220082;22894;4008;171425;440138;55901;8796;646625;9205;23281;122046;6656;83548;6555;51569;2259;79587;3146;2322;3916;8874;55757;89890;55608;241;8858;646799;22862;122042;7546;51082;65110;10673;55068;26050;9375;55425;9071;196541;10150;8100;122060;253832;266722;8803;27199;140432;4285;55504;170622;1282;1948;542767;122258;51028;267012;7347;221178;10562;10443;84899;83446;2971;479;79070;1284;400120;2098;4093;10186;94240;283489;23263;55269;55739;1203;387923;283514;23483;2835;80209;5611;3936;10808;79024;2321;85416;348013;100533467;54937;55795;51084;160897;8900;22873;341676;7178;1880;101928841;55578;29880;23348;2254;387914;2706;10206;6049;23143;9358;115761;26524;219333;84189;87769;10082;643365;10161;55002;728591;84650;64328;23078;28984;7223;11061;222484;647174;6011;51371;83852;22821;144983;79621;23047;10129;221150;1910;2700;2621;729246;10464;114798;121793;143;81617;160857;11193;160851;10810;7750;55082;5095;9445;5042;1638;8881;8600;55208;23091;387496;80183;11340,315
1,1,13,20246074,115085141,94839067,7027;79612;2862;283518;23026;144809;57213;10426;730249;84945;10804;26960;64881;400165;100129307;7174;113622;4081;9882;221154;3839;90634;54841;1602;11215;10631;29079;5457;386618;3621;5983;122011;56163;5925;341640;5994;10257;2155;221143;283537;8451;27253;81550;107303344;6445;100526761;144811;64062;10208;337867;219409;2308;387921;161003;84056;26224;729250;81624;5100;219287;5101;145173;1045;10166;122183;115825;81602;10240;253512;1361;29103;57511;338872;220081;1024;26278;220416;440145;93081;55270;100129836;2159;6144;54602;2262;9365;9107;78988;115207;729240;79774;2841;26586;9724;55647;10160;6541;729420;8428;220108;84078;5412;55213;51761;9818;675;540;23111;729233;23077;9201;51131;79758;8848;3356;3843;6564;57626;4752;10910;10284;2073;90627;9617;23250;3981;496;54737;79596;26747;10253;11166;53342;219402;84935;259232;1997;57105;79866;1102;728215;11278;2963;26512;643677;387911;3651;688;255967;55835;8660;5911;220107;220082;22894;4008;171425;440138;55901;8796;646625;9205;23281;122046;6656;83548;6555;51569;2259;79587;3146;2322;3916;8874;55757;89890;55608;241;8858;646799;22862;122042;7546;51082;65110;10673;55068;26050;9375;55425;9071;196541;10150;8100;122060;253832;266722;8803;27199;140432;4285;55504;170622;1282;1948;542767;122258;51028;267012;7347;221178;10562;10443;84899;83446;2971;479;79070;1284;400120;2098;4093;10186;94240;283489;23263;55269;55739;1203;387923;283514;23483;2835;80209;5611;3936;10808;79024;2321;85416;348013;100533467;54937;55795;51084;160897;8900;22873;341676;7178;1880;101928841;55578;29880;23348;2254;387914;2706;10206;6049;23143;9358;115761;26524;219333;84189;87769;10082;643365;10161;55002;728591;84650;64328;23078;28984;7223;11061;222484;647174;6011;51371;83852;22821;144983;79621;23047;10129;221150;1910;2700;2621;729246;10464;114798;121793;143;81617;160857;11193;160851;10810;7750;55082;5095;9445;5042;1638;8881;8600;55208;23091;387496;80183;11340,315
1,1,13,20246074,115085141,94839067,7027;79612;2862;283518;23026;144809;57213;10426;730249;84945;10804;26960;64881;400165;100129307;7174;113622;4081;9882;221154;3839;90634;54841;1602;11215;10631;29079;5457;386618;3621;5983;122011;56163;5925;341640;5994;10257;2155;221143;283537;8451;27253;81550;107303344;6445;100526761;144811;64062;10208;337867;219409;2308;387921;161003;84056;26224;729250;81624;5100;219287;5101;145173;1045;10166;122183;115825;81602;10240;253512;1361;29103;57511;338872;220081;1024;26278;220416;440145;93081;55270;100129836;2159;6144;54602;2262;9365;9107;78988;115207;729240;79774;2841;26586;9724;55647;10160;6541;729420;8428;220108;84078;5412;55213;51761;9818;675;540;23111;729233;23077;9201;51131;79758;8848;3356;3843;6564;57626;4752;10910;10284;2073;90627;9617;23250;3981;496;54737;79596;26747;10253;11166;53342;219402;84935;259232;1997;57105;79866;1102;728215;11278;2963;26512;643677;387911;3651;688;255967;55835;8660;5911;220107;220082;22894;4008;171425;440138;55901;8796;646625;9205;23281;122046;6656;83548;6555;51569;2259;79587;3146;2322;3916;8874;55757;89890;55608;241;8858;646799;22862;122042;7546;51082;65110;10673;55068;26050;9375;55425;9071;196541;10150;8100;122060;253832;266722;8803;27199;140432;4285;55504;170622;1282;1948;542767;122258;51028;267012;7347;221178;10562;10443;84899;83446;2971;479;79070;1284;400120;2098;4093;10186;94240;283489;23263;55269;55739;1203;387923;283514;23483;2835;80209;5611;3936;10808;79024;2321;85416;348013;100533467;54937;55795;51084;160897;8900;22873;341676;7178;1880;101928841;55578;29880;23348;2254;387914;2706;10206;6049;23143;9358;115761;26524;219333;84189;87769;10082;643365;10161;55002;728591;84650;64328;23078;28984;7223;11061;222484;647174;6011;51371;83852;22821;144983;79621;23047;10129;221150;1910;2700;2621;729246;10464;114798;121793;143;81617;160857;11193;160851;10810;7750;55082;5095;9445;5042;1638;8881;8600;55208;23091;387496;80183;11340,315
1,1,13,20246074,115085141,94839067,7027;79612;2862;283518;23026;144809;57213;10426;730249;84945;10804;26960;64881;400165;100129307;7174;113622;4081;9882;221154;3839;90634;54841;1602;11215;10631;29079;5457;386618;3621;5983;122011;56163;5925;341640;5994;10257;2155;221143;283537;8451;27253;81550;107303344;6445;100526761;144811;64062;10208;337867;219409;2308;387921;161003;84056;26224;729250;81624;5100;219287;5101;145173;1045;10166;122183;115825;81602;10240;253512;1361;29103;57511;338872;220081;1024;26278;220416;440145;93081;55270;100129836;2159;6144;54602;2262;9365;9107;78988;115207;729240;79774;2841;26586;9724;55647;10160;6541;729420;8428;220108;84078;5412;55213;51761;9818;675;540;23111;729233;23077;9201;51131;79758;8848;3356;3843;6564;57626;4752;10910;10284;2073;90627;9617;23250;3981;496;54737;79596;26747;10253;11166;53342;219402;84935;259232;1997;57105;79866;1102;728215;11278;2963;26512;643677;387911;3651;688;255967;55835;8660;5911;220107;220082;22894;4008;171425;440138;55901;8796;646625;9205;23281;122046;6656;83548;6555;51569;2259;79587;3146;2322;3916;8874;55757;89890;55608;241;8858;646799;22862;122042;7546;51082;65110;10673;55068;26050;9375;55425;9071;196541;10150;8100;122060;253832;266722;8803;27199;140432;4285;55504;170622;1282;1948;542767;122258;51028;267012;7347;221178;10562;10443;84899;83446;2971;479;79070;1284;400120;2098;4093;10186;94240;283489;23263;55269;55739;1203;387923;283514;23483;2835;80209;5611;3936;10808;79024;2321;85416;348013;100533467;54937;55795;51084;160897;8900;22873;341676;7178;1880;101928841;55578;29880;23348;2254;387914;2706;10206;6049;23143;9358;115761;26524;219333;84189;87769;10082;643365;10161;55002;728591;84650;64328;23078;28984;7223;11061;222484;647174;6011;51371;83852;22821;144983;79621;23047;10129;221150;1910;2700;2621;729246;10464;114798;121793;143;81617;160857;11193;160851;10810;7750;55082;5095;9445;5042;1638;8881;8600;55208;23091;387496;80183;11340,315
1,1,13,20246074,115085141,94839067,7027;79612;2862;283518;23026;144809;57213;10426;730249;84945;10804;26960;64881;400165;100129307;7174;113622;4081;9882;221154;3839;90634;54841;1602;11215;10631;29079;5457;386618;3621;5983;122011;56163;5925;341640;5994;10257;2155;221143;283537;8451;27253;81550;107303344;6445;100526761;144811;64062;10208;337867;219409;2308;387921;161003;84056;26224;729250;81624;5100;219287;5101;145173;1045;10166;122183;115825;81602;10240;253512;1361;29103;57511;338872;220081;1024;26278;220416;440145;93081;55270;100129836;2159;6144;54602;2262;9365;9107;78988;115207;729240;79774;2841;26586;9724;55647;10160;6541;729420;8428;220108;84078;5412;55213;51761;9818;675;540;23111;729233;23077;9201;51131;79758;8848;3356;3843;6564;57626;4752;10910;10284;2073;90627;9617;23250;3981;496;54737;79596;26747;10253;11166;53342;219402;84935;259232;1997;57105;79866;1102;728215;11278;2963;26512;643677;387911;3651;688;255967;55835;8660;5911;220107;220082;22894;4008;171425;440138;55901;8796;646625;9205;23281;122046;6656;83548;6555;51569;2259;79587;3146;2322;3916;8874;55757;89890;55608;241;8858;646799;22862;122042;7546;51082;65110;10673;55068;26050;9375;55425;9071;196541;10150;8100;122060;253832;266722;8803;27199;140432;4285;55504;170622;1282;1948;542767;122258;51028;267012;7347;221178;10562;10443;84899;83446;2971;479;79070;1284;400120;2098;4093;10186;94240;283489;23263;55269;55739;1203;387923;283514;23483;2835;80209;5611;3936;10808;79024;2321;85416;348013;100533467;54937;55795;51084;160897;8900;22873;341676;7178;1880;101928841;55578;29880;23348;2254;387914;2706;10206;6049;23143;9358;115761;26524;219333;84189;87769;10082;643365;10161;55002;728591;84650;64328;23078;28984;7223;11061;222484;647174;6011;51371;83852;22821;144983;79621;23047;10129;221150;1910;2700;2621;729246;10464;114798;121793;143;81617;160857;11193;160851;10810;7750;55082;5095;9445;5042;1638;8881;8600;55208;23091;387496;80183;11340,315
1,1,13,20246074,115085141,94839067,7027;79612;2862;283518;23026;144809;57213;10426;730249;84945;10804;26960;64881;400165;100129307;7174;113622;4081;9882;221154;3839;90634;54841;1602;11215;10631;29079;5457;386618;3621;5983;122011;56163;5925;341640;5994;10257;2155;221143;283537;8451;27253;81550;107303344;6445;100526761;144811;64062;10208;337867;219409;2308;387921;161003;84056;26224;729250;81624;5100;219287;5101;145173;1045;10166;122183;115825;81602;10240;253512;1361;29103;57511;338872;220081;1024;26278;220416;440145;93081;55270;100129836;2159;6144;54602;2262;9365;9107;78988;115207;729240;79774;2841;26586;9724;55647;10160;6541;729420;8428;220108;84078;5412;55213;51761;9818;675;540;23111;729233;23077;9201;51131;79758;8848;3356;3843;6564;57626;4752;10910;10284;2073;90627;9617;23250;3981;496;54737;79596;26747;10253;11166;53342;219402;84935;259232;1997;57105;79866;1102;728215;11278;2963;26512;643677;387911;3651;688;255967;55835;8660;5911;220107;220082;22894;4008;171425;440138;55901;8796;646625;9205;23281;122046;6656;83548;6555;51569;2259;79587;3146;2322;3916;8874;55757;89890;55608;241;8858;646799;22862;122042;7546;51082;65110;10673;55068;26050;9375;55425;9071;196541;10150;8100;122060;253832;266722;8803;27199;140432;4285;55504;170622;1282;1948;542767;122258;51028;267012;7347;221178;10562;10443;84899;83446;2971;479;79070;1284;400120;2098;4093;10186;94240;283489;23263;55269;55739;1203;387923;283514;23483;2835;80209;5611;3936;10808;79024;2321;85416;348013;100533467;54937;55795;51084;160897;8900;22873;341676;7178;1880;101928841;55578;29880;23348;2254;387914;2706;10206;6049;23143;9358;115761;26524;219333;84189;87769;10082;643365;10161;55002;728591;84650;64328;23078;28984;7223;11061;222484;647174;6011;51371;83852;22821;144983;79621;23047;10129;221150;1910;2700;2621;729246;10464;114798;121793;143;81617;160857;11193;160851;10810;7750;55082;5095;9445;5042;1638;8881;8600;55208;23091;387496;80183;11340,315
1,1,13,20246074,115085141,94839067,7027;79612;2862;283518;23026;144809;57213;10426;730249;84945;10804;26960;64881;400165;100129307;7174;113622;4081;9882;221154;3839;90634;54841;1602;11215;10631;29079;5457;386618;3621;5983;122011;56163;5925;341640;5994;10257;2155;221143;283537;8451;27253;81550;107303344;6445;100526761;144811;64062;10208;337867;219409;2308;387921;161003;84056;26224;729250;81624;5100;219287;5101;145173;1045;10166;122183;115825;81602;10240;253512;1361;29103;57511;338872;220081;1024;26278;220416;440145;93081;55270;100129836;2159;6144;54602;2262;9365;9107;78988;115207;729240;79774;2841;26586;9724;55647;10160;6541;729420;8428;220108;84078;5412;55213;51761;9818;675;540;23111;729233;23077;9201;51131;79758;8848;3356;3843;6564;57626;4752;10910;10284;2073;90627;9617;23250;3981;496;54737;79596;26747;10253;11166;53342;219402;84935;259232;1997;57105;79866;1102;728215;11278;2963;26512;643677;387911;3651;688;255967;55835;8660;5911;220107;220082;22894;4008;171425;440138;55901;8796;646625;9205;23281;122046;6656;83548;6555;51569;2259;79587;3146;2322;3916;8874;55757;89890;55608;241;8858;646799;22862;122042;7546;51082;65110;10673;55068;26050;9375;55425;9071;196541;10150;8100;122060;253832;266722;8803;27199;140432;4285;55504;170622;1282;1948;542767;122258;51028;267012;7347;221178;10562;10443;84899;83446;2971;479;79070;1284;400120;2098;4093;10186;94240;283489;23263;55269;55739;1203;387923;283514;23483;2835;80209;5611;3936;10808;79024;2321;85416;348013;100533467;54937;55795;51084;160897;8900;22873;341676;7178;1880;101928841;55578;29880;23348;2254;387914;2706;10206;6049;23143;9358;115761;26524;219333;84189;87769;10082;643365;10161;55002;728591;84650;64328;23078;28984;7223;11061;222484;647174;6011;51371;83852;22821;144983;79621;23047;10129;221150;1910;2700;2621;729246;10464;114798;121793;143;81617;160857;11193;160851;10810;7750;55082;5095;9445;5042;1638;8881;8600;55208;23091;387496;80183;11340,315
-1,1,13,20333330,22665578,2332248,51084;53342;26524;55269;8100;253832;10284;7750;64328;9205;10804;221150;2700;221143;2254;2706;78988;221154,18
1,-1,13,20398449,20436518,38069,9205,1
1,1,13,20407270,115064089,94656819,7027;79612;2862;283518;23026;144809;57213;10426;730249;84945;10804;26960;64881;400165;100129307;7174;113622;4081;9882;221154;3839;90634;54841;1602;11215;10631;29079;5457;386618;3621;5983;122011;56163;5925;341640;5994;10257;2155;221143;283537;8451;27253;81550;107303344;6445;100526761;144811;64062;10208;337867;219409;2308;387921;161003;84056;26224;729250;81624;5100;219287;5101;145173;1045;10166;122183;115825;81602;10240;253512;1361;29103;57511;338872;220081;1024;26278;220416;440145;93081;55270;100129836;2159;6144;54602;2262;9365;9107;78988;115207;729240;79774;2841;26586;9724;55647;10160;6541;729420;8428;220108;84078;5412;55213;51761;9818;675;540;23111;729233;23077;9201;51131;79758;8848;3356;3843;6564;57626;4752;10910;10284;2073;90627;9617;23250;3981;496;79596;26747;10253;11166;53342;219402;84935;259232;1997;57105;79866;1102;728215;11278;2963;26512;643677;387911;3651;688;255967;55835;8660;5911;220107;220082;22894;4008;171425;440138;55901;8796;646625;9205;23281;122046;6656;83548;6555;51569;2259;79587;3146;2322;3916;8874;55757;89890;55608;241;8858;646799;22862;122042;7546;51082;65110;10673;55068;26050;9375;55425;9071;196541;10150;8100;122060;253832;266722;8803;27199;140432;4285;55504;170622;1282;1948;542767;122258;51028;267012;7347;221178;10562;10443;84899;83446;2971;479;79070;1284;400120;2098;4093;10186;94240;23263;55739;1203;387923;283514;23483;2835;80209;5611;3936;10808;79024;2321;85416;348013;100533467;54937;55795;51084;160897;8900;22873;341676;7178;1880;101928841;55578;29880;23348;2254;387914;2706;10206;6049;23143;9358;115761;26524;219333;84189;87769;10082;643365;10161;55002;728591;84650;64328;23078;28984;7223;11061;222484;647174;6011;51371;83852;22821;144983;79621;23047;10129;221150;1910;2700;2621;729246;10464;114798;121793;143;81617;160857;11193;160851;10810;7750;55082;5095;9445;5042;1638;8881;8600;55208;23091;387496;80183;11340,312
1,1,13,20407270,115085141,94677871,7027;79612;2862;283518;23026;144809;57213;10426;730249;84945;10804;26960;64881;400165;100129307;7174;113622;4081;9882;221154;3839;90634;54841;1602;11215;10631;29079;5457;386618;3621;5983;122011;56163;5925;341640;5994;10257;2155;221143;283537;8451;27253;81550;107303344;6445;100526761;144811;64062;10208;337867;219409;2308;387921;161003;84056;26224;729250;81624;5100;219287;5101;145173;1045;10166;122183;115825;81602;10240;253512;1361;29103;57511;338872;220081;1024;26278;220416;440145;93081;55270;100129836;2159;6144;54602;2262;9365;9107;78988;115207;729240;79774;2841;26586;9724;55647;10160;6541;729420;8428;220108;84078;5412;55213;51761;9818;675;540;23111;729233;23077;9201;51131;79758;8848;3356;3843;6564;57626;4752;10910;10284;2073;90627;9617;23250;3981;496;79596;26747;10253;11166;53342;219402;84935;259232;1997;57105;79866;1102;728215;11278;2963;26512;643677;387911;3651;688;255967;55835;8660;5911;220107;220082;22894;4008;171425;440138;55901;8796;646625;9205;23281;122046;6656;83548;6555;51569;2259;79587;3146;2322;3916;8874;55757;89890;55608;241;8858;646799;22862;122042;7546;51082;65110;10673;55068;26050;9375;55425;9071;196541;10150;8100;122060;253832;266722;8803;27199;140432;4285;55504;170622;1282;1948;542767;122258;51028;267012;7347;221178;10562;10443;84899;83446;2971;479;79070;1284;400120;2098;4093;10186;94240;283489;23263;55739;1203;387923;283514;23483;2835;80209;5611;3936;10808;79024;2321;85416;348013;100533467;54937;55795;51084;160897;8900;22873;341676;7178;1880;101928841;55578;29880;23348;2254;387914;2706;10206;6049;23143;9358;115761;26524;219333;84189;87769;10082;643365;10161;55002;728591;84650;64328;23078;28984;7223;11061;222484;647174;6011;51371;83852;22821;144983;79621;23047;10129;221150;1910;2700;2621;729246;10464;114798;121793;143;81617;160857;11193;160851;10810;7750;55082;5095;9445;5042;1638;8881;8600;55208;23091;387496;80183;11340,313
1,1,13,20407270,115085141,94677871,7027;79612;2862;283518;23026;144809;57213;10426;730249;84945;10804;26960;64881;400165;100129307;7174;113622;4081;9882;221154;3839;90634;54841;1602;11215;10631;29079;5457;386618;3621;5983;122011;56163;5925;341640;5994;10257;2155;221143;283537;8451;27253;81550;107303344;6445;100526761;144811;64062;10208;337867;219409;2308;387921;161003;84056;26224;729250;81624;5100;219287;5101;145173;1045;10166;122183;115825;81602;10240;253512;1361;29103;57511;338872;220081;1024;26278;220416;440145;93081;55270;100129836;2159;6144;54602;2262;9365;9107;78988;115207;729240;79774;2841;26586;9724;55647;10160;6541;729420;8428;220108;84078;5412;55213;51761;9818;675;540;23111;729233;23077;9201;51131;79758;8848;3356;3843;6564;57626;4752;10910;10284;2073;90627;9617;23250;3981;496;79596;26747;10253;11166;53342;219402;84935;259232;1997;57105;79866;1102;728215;11278;2963;26512;643677;387911;3651;688;255967;55835;8660;5911;220107;220082;22894;4008;171425;440138;55901;8796;646625;9205;23281;122046;6656;83548;6555;51569;2259;79587;3146;2322;3916;8874;55757;89890;55608;241;8858;646799;22862;122042;7546;51082;65110;10673;55068;26050;9375;55425;9071;196541;10150;8100;122060;253832;266722;8803;27199;140432;4285;55504;170622;1282;1948;542767;122258;51028;267012;7347;221178;10562;10443;84899;83446;2971;479;79070;1284;400120;2098;4093;10186;94240;283489;23263;55739;1203;387923;283514;23483;2835;80209;5611;3936;10808;79024;2321;85416;348013;100533467;54937;55795;51084;160897;8900;22873;341676;7178;1880;101928841;55578;29880;23348;2254;387914;2706;10206;6049;23143;9358;115761;26524;219333;84189;87769;10082;643365;10161;55002;728591;84650;64328;23078;28984;7223;11061;222484;647174;6011;51371;83852;22821;144983;79621;23047;10129;221150;1910;2700;2621;729246;10464;114798;121793;143;81617;160857;11193;160851;10810;7750;55082;5095;9445;5042;1638;8881;8600;55208;23091;387496;80183;11340,313
1,-1,13,20411535,20530702,119167,9205,1
1,1,13,20411535,115085141,94673606,7027;79612;2862;283518;23026;144809;57213;10426;730249;84945;10804;26960;64881;400165;100129307;7174;113622;4081;9882;221154;3839;90634;54841;1602;11215;10631;29079;5457;386618;3621;5983;122011;56163;5925;341640;5994;10257;2155;221143;283537;8451;27253;81550;107303344;6445;100526761;144811;64062;10208;337867;219409;2308;387921;161003;84056;26224;729250;81624;5100;219287;5101;145173;1045;10166;122183;115825;81602;10240;253512;1361;29103;57511;338872;220081;1024;26278;220416;440145;93081;55270;100129836;2159;6144;54602;2262;9365;9107;78988;115207;729240;79774;2841;26586;9724;55647;10160;6541;729420;8428;220108;84078;5412;55213;51761;9818;675;540;23111;729233;23077;9201;51131;79758;8848;3356;3843;6564;57626;4752;10910;10284;2073;90627;9617;23250;3981;496;79596;26747;10253;11166;53342;219402;84935;259232;1997;57105;79866;1102;728215;11278;2963;26512;643677;387911;3651;688;255967;55835;8660;5911;220107;220082;22894;4008;171425;440138;55901;8796;646625;9205;23281;122046;6656;83548;6555;51569;2259;79587;3146;2322;3916;8874;55757;89890;55608;241;8858;646799;22862;122042;7546;51082;65110;10673;55068;26050;9375;55425;9071;196541;10150;8100;122060;253832;266722;8803;27199;140432;4285;55504;170622;1282;1948;542767;122258;51028;267012;7347;221178;10562;10443;84899;83446;2971;479;79070;1284;400120;2098;4093;10186;94240;283489;23263;55739;1203;387923;283514;23483;2835;80209;5611;3936;10808;79024;2321;85416;348013;100533467;54937;55795;51084;160897;8900;22873;341676;7178;1880;101928841;55578;29880;23348;2254;387914;2706;10206;6049;23143;9358;115761;26524;219333;84189;87769;10082;643365;10161;55002;728591;84650;64328;23078;28984;7223;11061;222484;647174;6011;51371;83852;22821;144983;79621;23047;10129;221150;1910;2700;2621;729246;10464;114798;121793;143;81617;160857;11193;160851;10810;7750;55082;5095;9445;5042;1638;8881;8600;55208;23091;387496;80183;11340,313
1,-1,13,20419133,20445461,26328,9205,1
1,-1,13,20425451,20445320,19869,9205,1
-1,1,13,20459423,22588637,2129214,51084;53342;26524;8100;253832;10284;7750;64328;10804;221150;2700;221143;2254;2706;78988;221154,16
-1,-1,13,20808567,21095903,287336,51084,1
-1,-1,13,20808567,21095903,287336,51084,1
-1,-1,13,20803674,21087711,284037,51084;10804,2
-1,-1,13,20808544,21001316,192772,51084,1
-1,-1,13,20867199,21078901,211702,51084,1
-1,-1,13,20867199,21095903,228704,51084,1
-1,-1,13,20867199,21095903,228704,51084,1
-1,-1,13,21721135,21742457,21322,221150;10284,2
1,-1,13,21728320,21742457,14137,221150,1
1,-1,13,23517984,23619382,101398,,0
1,-1,13,23517984,23795488,277504,6445,1
-1,1,13,23671134,24896556,1225422,6445;4285;55504;221178;338872;387911;542767;26278,8
-1,1,13,23681101,24430171,749070,6445;55504;26278;4285,4
-1,1,13,23681101,24430171,749070,6445;55504;26278;4285,4
1,-1,13,24776253,24910684,134431,221178;338872,2
1,-1,13,27416494,27641229,224735,219333,1
-1,1,13,29647457,37130151,7482694,675;100526761;3146;90634;10208;84935;23111;8900;9201;241;10443;9365;646799;84056;23047;10129;728591;6541;122042;23281;5983;26960;10808;90627;122046;145173;4081;5412;54937,29
1,1,13,29895591,37569485,7673894,100526761;3146;10208;84935;8900;241;10443;646799;84056;23047;10129;6541;122042;26960;400120;4093;29880;145173;4081;5412;675;90634;23111;9201;728591;5983;23281;10808;90627;122046;5994;9365;54937,33
-1,1,13,30887946,39841818,8953872,51569;100526761;3146;10208;84935;8900;387921;241;10443;161003;646799;23047;10129;122042;26960;400120;55578;4093;29880;145173;4081;675;90634;11340;23111;9201;10631;728591;80209;5983;122011;10808;7223;90627;341640;122046;5994;9365;54937,39
-1,1,13,31592297,49065340,17473043,51569;79612;89890;8900;144809;646799;122042;26960;7178;55578;29880;84078;4081;675;55068;23143;90634;55425;11340;23111;9201;11215;10631;8803;8848;3356;29079;10161;386618;728591;5983;122011;23078;28984;5925;7223;90627;341640;9617;5994;26747;100526761;144811;2308;387921;10443;161003;23047;10129;1997;1102;400120;2098;2963;4093;145173;10186;10166;94240;10240;253512;1361;220082;29103;57511;220081;160857;387923;283514;11193;160851;220416;80209;55270;3936;10808;79024;9445;8600;23091;9365;83548;80183;54937,84
-1,1,13,31682663,33765790,2083127,675;122042;90634;10808;90627;145173;9365;10443;646799;23047;10129,11
1,1,13,31937609,91227546,59289937,51569;79612;2862;89890;283518;144809;646799;57213;22862;122042;730249;26960;64881;100129307;4081;9882;3839;55068;26050;90634;55425;1602;11215;122060;10631;8803;29079;5457;386618;5983;122011;5925;341640;170622;5994;51028;27253;81550;107303344;7347;100526761;144811;10562;64062;2308;387921;10443;161003;83446;26224;729250;81624;5100;400120;2098;4093;5101;10186;10166;122183;115825;81602;94240;10240;253512;1361;29103;57511;1203;220081;387923;283514;440145;220416;55270;80209;3936;79024;54602;9365;54937;115207;729240;26586;8900;9724;341676;7178;729420;55578;29880;220108;84078;55213;10206;675;23143;115761;540;23111;729233;9201;23077;51131;84189;79758;8848;3356;57626;4752;10910;10161;728591;84650;23078;28984;7223;90627;11061;9617;647174;79596;26747;10253;83852;144983;79621;23047;10129;1997;57105;79866;1910;1102;11278;2963;26512;729246;688;10464;114798;220107;81617;220082;22894;4008;160857;440138;55901;11193;160851;8796;9445;8600;23091;83548;80183;11340,158
1,1,13,31937609,91227546,59289937,51569;79612;2862;89890;283518;144809;646799;57213;22862;122042;730249;26960;64881;100129307;4081;9882;3839;55068;26050;90634;55425;1602;11215;122060;10631;8803;29079;5457;386618;5983;122011;5925;341640;170622;5994;51028;27253;81550;107303344;7347;100526761;144811;10562;64062;2308;387921;10443;161003;83446;26224;729250;81624;5100;400120;2098;4093;5101;10186;10166;122183;115825;81602;94240;10240;253512;1361;29103;57511;1203;220081;387923;283514;440145;220416;55270;80209;3936;79024;54602;9365;54937;115207;729240;26586;8900;9724;341676;7178;729420;55578;29880;220108;84078;55213;10206;675;23143;115761;540;23111;729233;9201;23077;51131;84189;79758;8848;3356;57626;4752;10910;10161;728591;84650;23078;28984;7223;90627;11061;9617;647174;79596;26747;10253;83852;144983;79621;23047;10129;1997;57105;79866;1910;1102;11278;2963;26512;729246;688;10464;114798;220107;81617;220082;22894;4008;160857;440138;55901;11193;160851;8796;9445;8600;23091;83548;80183;11340,158
1,1,13,32127745,66044499,33916754,51569;729240;79612;2862;89890;26586;8900;9724;283518;144809;646799;57213;22862;122042;26960;341676;7178;55578;64881;29880;220108;84078;4081;55213;10206;3839;675;55068;23143;90634;55425;11340;115761;540;23111;729233;9201;11215;51131;79758;10631;8803;8848;3356;29079;4752;10910;10161;386618;728591;5983;122011;84650;23078;5925;28984;7223;90627;341640;11061;5994;9617;647174;26747;51028;27253;81550;107303344;83852;100526761;144811;10562;144983;2308;387921;79621;10443;161003;83446;23047;10129;729250;81624;1997;57105;1102;5100;400120;2098;2963;26512;4093;729246;10186;10166;122183;115825;81602;94240;10240;253512;1361;220107;81617;220082;29103;57511;220081;160857;387923;283514;440138;55901;11193;160851;220416;55270;80209;3936;79024;9445;8600;23091;9365;83548;80183;54937,127
-1,1,13,32920483,32922331,1848,675,1
-1,1,13,32926238,33397752,471514,675;10443;90634;23047,4
-1,1,13,32946120,62698217,29752097,51569;729240;79612;2862;89890;26586;8900;9724;283518;144809;57213;22862;26960;341676;7178;55578;64881;29880;220108;84078;4081;55213;10206;3839;675;55068;23143;90634;55425;11340;115761;540;23111;729233;9201;11215;51131;79758;10631;8803;8848;3356;29079;4752;10910;10161;386618;728591;5983;122011;84650;23078;5925;28984;7223;90627;341640;11061;5994;9617;647174;26747;51028;27253;81550;107303344;83852;100526761;144811;10562;144983;2308;387921;79621;10443;161003;83446;23047;729250;81624;1997;57105;1102;5100;400120;2098;2963;26512;4093;729246;10186;10166;122183;115825;81602;94240;10240;253512;1361;220107;81617;220082;29103;57511;220081;160857;387923;283514;440138;55901;11193;160851;220416;55270;80209;3936;79024;9445;8600;23091;9365;83548;80183;54937,124
1,1,13,33105623,87409299,54303676,51569;79612;2862;89890;283518;144809;57213;22862;730249;26960;64881;100129307;4081;9882;3839;55068;55425;1602;11215;122060;10631;8803;29079;5457;386618;5983;122011;5925;341640;170622;5994;51028;27253;81550;107303344;7347;100526761;144811;10562;64062;2308;387921;10443;161003;83446;26224;729250;81624;5100;400120;2098;4093;5101;10186;10166;122183;115825;81602;94240;10240;253512;1361;29103;57511;1203;220081;387923;283514;440145;220416;55270;80209;3936;79024;54602;9365;54937;115207;729240;26586;8900;9724;341676;7178;729420;55578;29880;220108;84078;55213;10206;23143;115761;540;23111;729233;9201;23077;51131;84189;79758;8848;3356;57626;4752;10910;10161;728591;84650;23078;28984;7223;90627;11061;9617;647174;79596;26747;10253;83852;144983;79621;23047;1997;57105;79866;1910;1102;11278;2963;26512;729246;688;10464;114798;220107;81617;220082;22894;4008;160857;440138;55901;11193;160851;8796;9445;8600;23091;83548;80183;11340,152
-1,1,13,37351455,63530009,26178554,51569;729240;79612;2862;89890;26586;9724;283518;144809;57213;22862;341676;7178;55578;64881;29880;220108;84078;55213;10206;3839;55068;23143;55425;115761;540;729233;11215;51131;79758;10631;8803;8848;3356;29079;4752;10910;10161;386618;84650;122011;23078;28984;5925;7223;11061;341640;9617;5994;647174;26747;51028;27253;81550;107303344;83852;144811;10562;144983;2308;387921;79621;161003;83446;729250;81624;1997;57105;1102;5100;2098;2963;26512;4093;729246;10186;10166;122183;115825;81602;94240;10240;253512;1361;220107;81617;220082;29103;57511;220081;160857;387923;283514;440138;55901;11193;160851;220416;80209;55270;3936;79024;9445;8600;23091;83548;80183;11340,108
-1,1,13,37351455,63530009,26178554,51569;729240;79612;2862;89890;26586;9724;283518;144809;57213;22862;341676;7178;55578;64881;29880;220108;84078;55213;10206;3839;55068;23143;55425;115761;540;729233;11215;51131;79758;10631;8803;8848;3356;29079;4752;10910;10161;386618;84650;122011;23078;28984;5925;7223;11061;341640;9617;5994;647174;26747;51028;27253;81550;107303344;83852;144811;10562;144983;2308;387921;79621;161003;83446;729250;81624;1997;57105;1102;5100;2098;2963;26512;4093;729246;10186;10166;122183;115825;81602;94240;10240;253512;1361;220107;81617;220082;29103;57511;220081;160857;387923;283514;440138;55901;11193;160851;220416;80209;55270;3936;79024;9445;8600;23091;83548;80183;11340,108
1,1,13,38199035,39032633,833598,51569;7223,2
-1,1,13,38438363,68537920,30099557,51569;729240;79612;2862;89890;26586;9724;283518;144809;57213;22862;341676;7178;64881;220108;84078;55213;10206;3839;55068;23143;55425;115761;540;729233;11215;51131;79758;8848;8803;3356;29079;4752;10910;10161;386618;84650;23078;28984;7223;5925;11061;341640;9617;647174;26747;51028;27253;81550;107303344;83852;144811;10562;144983;2308;387921;79621;161003;83446;729250;81624;1997;57105;1102;5100;2098;2963;26512;729246;5101;10186;10166;122183;115825;81602;94240;10240;253512;1361;220107;81617;220082;29103;57511;220081;160857;387923;283514;440138;55901;11193;160851;220416;80209;55270;3936;79024;9445;8600;23091;83548;80183,102
-1,1,13,39088314,51999350,12911036,79612;2862;89890;283518;144809;57213;22862;7178;220108;84078;55213;10206;3839;55068;23143;55425;115761;11215;51131;8848;3356;8803;29079;10161;386618;84650;23078;28984;5925;341640;9617;647174;26747;83852;107303344;144811;2308;387921;79621;161003;1997;57105;1102;2098;2963;26512;10186;10166;81602;94240;10240;220107;253512;1361;81617;220082;29103;57511;160857;220081;387923;283514;11193;160851;220416;80209;55270;3936;79024;9445;8600;23091;83548;80183,74
-1,1,13,41516434,115085141,73568707,7027;2259;79587;79612;2862;3916;8874;55757;89890;55608;283518;144809;23026;8858;57213;10426;22862;730249;84945;64881;400165;100129307;7174;7546;113622;65110;10673;9882;3839;55068;26050;55425;9375;9071;54841;196541;10150;1602;11215;122060;8803;266722;27199;140432;29079;5457;386618;3621;5925;170622;1282;10257;2155;1948;122258;8451;51028;27253;81550;107303344;7347;267012;144811;10562;64062;337867;84899;83446;26224;729250;81624;79070;5100;1284;2098;5101;122183;115825;81602;94240;253512;1361;283489;23263;29103;55739;1203;220081;387923;283514;440145;220416;23483;93081;55270;5611;3936;79024;100129836;85416;348013;2159;54602;2262;100533467;115207;729240;160897;55795;79774;2841;26586;9724;22873;55647;10160;341676;7178;1880;729420;101928841;8428;220108;23348;84078;55213;10206;23143;9358;115761;540;729233;23077;51131;84189;87769;79758;8848;3356;10082;3843;6564;57626;10910;4752;10161;55002;84650;643365;23078;28984;2073;11061;9617;647174;23250;6011;3981;496;79596;26747;10253;83852;11166;22821;144983;79621;259232;1997;57105;79866;1910;1102;11278;728215;2963;26512;729246;643677;2621;688;10464;5911;8660;114798;121793;220107;81617;220082;22894;4008;160857;171425;55901;440138;11193;160851;8796;55082;5095;9445;1638;6656;8881;8600;55208;23091;83548;80183;6555,210
-1,1,13,41717956,85711687,43993731,115207;729240;79612;2862;26586;9724;283518;144809;57213;22862;730249;341676;7178;729420;64881;100129307;220108;84078;55213;10206;9882;3839;55068;23143;55425;115761;540;729233;1602;23077;11215;51131;122060;79758;8848;8803;3356;29079;57626;10910;4752;10161;5457;386618;84650;23078;28984;5925;11061;170622;9617;647174;79596;26747;51028;27253;81550;107303344;7347;10253;83852;144811;10562;64062;144983;79621;83446;26224;729250;81624;57105;79866;1910;1102;5100;11278;2098;2963;26512;729246;5101;688;10464;122183;115825;81602;94240;114798;253512;1361;220107;81617;220082;29103;22894;4008;1203;220081;160857;387923;283514;440138;55901;440145;220416;160851;55270;8796;3936;79024;9445;8600;54602;23091;83548;80183,116
1,1,13,41862629,85711687,43849058,115207;729240;79612;2862;26586;9724;283518;144809;57213;22862;730249;341676;7178;729420;64881;100129307;220108;55213;10206;9882;3839;55068;23143;55425;115761;540;729233;1602;23077;11215;51131;122060;79758;8848;8803;3356;29079;57626;10910;4752;10161;5457;386618;84650;23078;28984;5925;11061;170622;647174;79596;26747;51028;27253;81550;107303344;7347;10253;83852;144811;10562;64062;144983;79621;83446;26224;729250;81624;57105;79866;1910;1102;5100;11278;2098;2963;26512;729246;5101;688;10464;122183;115825;81602;94240;114798;253512;1361;220107;81617;220082;29103;22894;4008;1203;220081;160857;387923;283514;440138;55901;440145;220416;160851;55270;8796;3936;79024;9445;8600;54602;23091;83548;80183,114
-1,1,13,42457841,91796698,49338857,115207;729240;2862;26586;9724;283518;144809;57213;22862;730249;341676;7178;729420;64881;100129307;220108;55213;10206;9882;3839;55068;26050;23143;55425;115761;540;729233;1602;23077;11215;51131;122060;84189;79758;8803;8848;3356;29079;57626;4752;10910;10161;5457;386618;84650;23078;5925;11061;170622;647174;79596;26747;51028;27253;81550;107303344;7347;10253;83852;144811;10562;64062;144983;79621;83446;26224;729250;81624;57105;79866;1910;1102;5100;11278;2098;2963;26512;729246;5101;688;10464;122183;115825;81602;94240;114798;253512;1361;220107;81617;220082;29103;22894;4008;1203;220081;160857;387923;283514;440138;55901;440145;220416;160851;55270;8796;3936;79024;9445;8600;54602;23091;83548;80183,114
-1,1,13,47312129,51342279,4030150,107303344;220107;23143;2862;81617;115761;51131;83852;283518;3356;8803;29079;57213;10161;22862;55270;57105;84650;5925;1102;9445;2098;55213;10206;3839;81602,26
-1,1,13,47691722,84875070,37183348,115207;729240;2862;26586;9724;283518;57213;22862;730249;341676;729420;64881;100129307;220108;55213;10206;9882;3839;115761;540;729233;1602;23077;51131;122060;79758;8803;29079;57626;4752;10910;10161;5457;84650;5925;11061;170622;647174;79596;10253;27253;51028;81550;107303344;7347;83852;10562;64062;144983;79621;83446;26224;729250;81624;57105;79866;1910;1102;5100;11278;26512;729246;5101;688;10464;122183;115825;81602;114798;220107;81617;22894;4008;1203;440138;55901;440145;55270;8796;9445;54602,81
-1,1,13,48339337,62632653,14293316,729240;10562;2862;144983;26586;9724;79621;283518;83446;57213;22862;729250;57105;81624;341676;1102;5100;26512;729246;27253;220108;64881;55213;10206;122183;115825;3839;81602;220107;81617;115761;540;729233;51131;79758;440138;8803;55901;29079;4752;10910;10161;55270;84650;5925;11061;9445;647174;81550;51028;83852;107303344,52
-1,1,13,48756523,48899280,142757,9445;5925,2
-1,1,13,48881438,51501609,2620171,107303344;220107;81617;2862;115761;79621;51131;283518;83852;57213;10161;22862;84650;57105;5925;1102;55213;10206;3839;81602,20
-1,1,13,48906943,52778614,3871671,2862;9724;79621;283518;83446;57213;22862;57105;341676;1102;26512;220108;55213;10206;115825;3839;81602;220107;81617;115761;540;51131;79758;440138;4752;10161;84650;5925;647174;83852;107303344,31
1,-1,13,52150871,52272652,121781,115825,1
1,-1,13,52793642,52893811,100169,,0
-1,1,13,53551300,109850651,56299351,115207;2259;729240;160897;55757;2841;22873;23026;730249;10160;84945;1880;729420;64881;8428;100129307;7174;7546;23348;10673;9882;26050;9358;9375;9071;54841;196541;10150;1602;729233;23077;84189;122060;87769;266722;27199;10082;140432;3843;6564;57626;5457;2073;170622;10257;1948;3981;79596;10253;27253;267012;81550;7347;10562;64062;11166;337867;84899;259232;26224;729250;81624;79866;1910;79070;11278;728215;643677;729246;5101;688;10464;122183;5911;114798;22894;4008;1203;171425;440145;23483;93081;8796;5611;55082;5095;85416;1638;54602;2262;100533467;6555,92
1,1,13,53932358,96586363,42654005,7347;729240;115207;160897;64062;11166;55757;22873;26224;729250;81624;730249;79866;1910;11278;729420;729246;64881;100129307;5101;688;10464;122183;9882;114798;26050;9071;22894;4008;1203;729233;1602;23077;84189;122060;10082;440145;57626;23483;5457;8796;5611;170622;10257;1638;54602;2262;79596;10253;27253;81550,51
-1,-1,13,55153988,55457713,303725,,0
1,1,13,56431743,115107733,58675990,7027;2259;79587;3916;8874;55757;55608;23026;8858;10426;730249;84945;64881;400165;100129307;7174;7546;113622;65110;10673;9882;26050;9375;9071;54841;196541;10150;1602;122060;266722;27199;140432;5457;3621;170622;1282;10257;2155;1948;122258;8451;27253;267012;81550;7347;64062;337867;84899;26224;729250;81624;79070;1284;5101;122183;283489;23263;55739;1203;440145;23483;93081;5611;100129836;85416;348013;2159;54602;2262;100533467;115207;729240;160897;55795;79774;2841;22873;55647;10160;1880;729420;101928841;8428;23348;9358;729233;23077;84189;87769;10082;3843;6564;57626;643365;55002;2073;23250;6011;3981;496;79596;10253;11166;22821;259232;79866;1910;11278;728215;643677;2621;729246;688;10464;5911;8660;114798;121793;22894;4008;171425;8796;55082;5095;1638;6656;8881;55208;6555,129
1,1,13,56987542,69758302,12770760,729250;729240;81624;729246;729233;64881;5101;122183;27253;81550,10
-1,-1,13,57793354,57872497,79143,,0
-1,1,13,61110478,85127323,24016845,7347;115207;114798;64062;22894;4008;1203;23077;1602;122060;440145;57626;26224;5457;730249;8796;79866;1910;11278;729420;170622;64881;100129307;5101;688;54602;10464;79596;10253;9882;81550,31
1,1,13,61424168,115107733,53683565,7027;2259;79587;115207;160897;55795;79774;3916;8874;55757;2841;55608;22873;23026;8858;55647;10426;730249;10160;84945;1880;729420;101928841;64881;400165;100129307;7174;7546;113622;65110;8428;23348;10673;9882;26050;9358;9375;9071;54841;196541;10150;1602;23077;84189;122060;87769;266722;27199;10082;140432;3843;6564;57626;643365;5457;3621;55002;2073;170622;1282;10257;2155;23250;1948;6011;3981;496;122258;8451;79596;10253;267012;7347;64062;11166;22821;337867;84899;259232;26224;79866;1910;79070;1284;11278;728215;643677;2621;5101;688;10464;5911;8660;114798;121793;283489;23263;22894;55739;1203;4008;171425;440145;23483;93081;8796;5611;55082;5095;100129836;85416;1638;348013;2159;6656;8881;54602;2262;100533467;55208;6555,121
-1,1,13,61686543,83302092,21615549,7347;115207;64062;22894;4008;1203;23077;1602;122060;440145;57626;26224;5457;730249;8796;79866;1910;11278;729420;170622;64881;100129307;5101;688;54602;10464;79596;10253;9882,29
-1,1,13,64287498,80212550,15925052,7347;115207;64062;22894;4008;1203;23077;1602;122060;440145;57626;26224;5457;730249;8796;79866;1910;11278;729420;170622;100129307;5101;688;54602;10464;79596;9882,27
-1,-1,13,64446655,64913525,466870,,0
-1,-1,13,64504041,64845402,341361,,0
1,1,13,64640033,74267715,9627682,79866;11278;22894;1602;5101;688;10464;440145;57626,9
1,-1,13,65943201,66491226,548025,,0
-1,1,13,66895130,88507684,21612554,7347;115207;114798;26050;64062;22894;4008;1203;23077;1602;84189;122060;440145;57626;26224;5457;730249;8796;79866;1910;11278;729420;170622;100129307;5101;688;54602;10464;79596;10253;9882,31
-1,-1,13,67109147,67162425,53278,5101,1
-1,-1,13,67307371,67369938,62567,5101,1
-1,-1,13,67327801,67341918,14117,5101,1
-1,-1,13,67327801,67348819,21018,5101,1
1,-1,13,67593035,67716015,122980,5101,1
1,1,13,68624430,115085141,46460711,7027;2259;79587;115207;160897;55795;79774;3916;8874;55757;2841;55608;22873;23026;8858;55647;10426;730249;10160;84945;1880;729420;101928841;400165;8428;100129307;7174;7546;113622;65110;23348;10673;9882;26050;9358;9375;9071;54841;196541;10150;1602;23077;84189;122060;87769;266722;27199;10082;140432;3843;6564;57626;643365;5457;3621;55002;2073;170622;1282;10257;2155;23250;1948;6011;3981;496;122258;8451;79596;10253;267012;7347;64062;11166;22821;337867;84899;259232;26224;79866;1910;79070;1284;11278;728215;643677;2621;688;10464;5911;8660;114798;121793;283489;23263;22894;55739;1203;4008;171425;440145;23483;93081;8796;5611;55082;5095;100129836;85416;1638;348013;2159;6656;8881;54602;2262;100533467;55208;6555,119
1,-1,13,69509381,69615712,106331,,0
1,1,13,71871468,115107733,43236265,7027;2259;79587;115207;160897;55795;79774;3916;8874;55757;2841;55608;22873;23026;8858;55647;10426;730249;10160;84945;1880;729420;101928841;400165;8428;100129307;7174;7546;113622;65110;23348;10673;9882;26050;9358;9375;9071;54841;196541;10150;1602;23077;84189;122060;87769;266722;27199;10082;140432;3843;6564;643365;5457;3621;55002;2073;170622;1282;10257;2155;23250;1948;6011;3981;496;122258;8451;79596;10253;267012;7347;64062;11166;22821;337867;84899;259232;26224;79866;1910;79070;1284;11278;728215;643677;2621;688;10464;5911;8660;114798;121793;283489;23263;22894;55739;1203;4008;171425;440145;23483;93081;8796;5611;55082;5095;100129836;85416;1638;348013;2159;6656;8881;54602;2262;100533467;55208;6555,118
-1,1,13,72174742,82221361,10046619,7347;115207;64062;22894;4008;1203;23077;1602;122060;440145;26224;5457;730249;8796;79866;1910;11278;729420;170622;100129307;688;54602;10464;79596;10253;9882,26
-1,-1,13,72826303,73017334,191031,,0
-1,1,13,73255678,80212603,6956925,7347;115207;64062;22894;4008;1203;23077;122060;440145;26224;5457;730249;8796;79866;1910;11278;729420;170622;100129307;688;54602;10464;79596;9882,24
-1,1,13,77455170,81099829,3644659,115207;5457;730249;8796;64062;1910;1203;23077;100129307;122060;54602;79596;10253;26224,14
-1,1,13,77635915,93112659,15476744,5457;8796;114798;26050;64062;1910;23077;100129307;84189;122060;54602;2262;79596;10253,14
-1,-1,13,78751523,79255257,503734,5457;79596,2
-1,1,13,78878937,91936194,13057257,5457;114798;26050;64062;84189;54602;79596;10253,8
1,1,13,79538358,115085141,35546783,7027;2259;79587;160897;55795;79774;3916;8874;55757;2841;55608;22873;23026;8858;55647;10426;10160;84945;1880;101928841;400165;8428;7174;7546;113622;65110;23348;10673;26050;9358;9375;9071;54841;196541;10150;84189;87769;27199;266722;10082;140432;3843;6564;643365;55002;3621;2073;1282;10257;2155;23250;1948;6011;3981;496;122258;8451;10253;267012;64062;11166;22821;337867;84899;259232;79070;1284;728215;643677;2621;5911;8660;114798;121793;283489;23263;55739;171425;23483;93081;5611;55082;5095;100129836;85416;1638;348013;2159;6656;8881;54602;2262;100533467;55208;6555,95
1,1,13,79573453,115085141,35511688,7027;2259;79587;160897;55795;79774;3916;8874;55757;2841;55608;22873;23026;8858;55647;10426;10160;84945;1880;101928841;400165;8428;7174;7546;113622;65110;23348;10673;26050;9358;9375;9071;54841;196541;10150;84189;87769;27199;266722;10082;140432;3843;6564;643365;55002;3621;2073;1282;10257;2155;23250;1948;6011;3981;496;122258;8451;10253;267012;64062;11166;22821;337867;84899;259232;79070;1284;728215;643677;2621;5911;8660;114798;121793;283489;23263;55739;171425;23483;93081;5611;55082;5095;100129836;85416;1638;348013;2159;6656;8881;54602;2262;100533467;55208;6555,95
1,1,13,80058840,115107733,35048893,7027;2259;79587;160897;55795;79774;3916;8874;55757;2841;55608;22873;23026;8858;55647;10426;10160;84945;1880;101928841;400165;8428;7174;7546;113622;65110;23348;10673;26050;9358;9375;9071;54841;196541;10150;84189;87769;27199;266722;10082;140432;3843;6564;643365;55002;3621;2073;1282;10257;2155;23250;1948;6011;3981;496;122258;8451;10253;267012;11166;22821;337867;84899;259232;79070;1284;728215;643677;2621;5911;8660;114798;121793;283489;23263;55739;171425;23483;93081;5611;55082;5095;100129836;85416;1638;348013;2159;6656;8881;54602;2262;100533467;55208;6555,94
-1,1,13,80572498,108719528,28147030,160897;2259;11166;55757;337867;2841;22873;84899;259232;10160;1880;79070;728215;643677;8428;7174;23348;7546;5911;114798;26050;9358;9375;9071;54841;196541;10150;84189;171425;87769;27199;266722;10082;3843;23483;140432;6564;93081;5611;2073;55082;5095;10257;1638;85416;1948;2262;100533467;10253;6555;267012,51
-1,-1,13,81161198,81417735,256537,,0
-1,-1,13,81682597,82033267,350670,,0
-1,1,13,81851091,102864674,21013583,160897;2259;11166;55757;337867;2841;22873;84899;259232;10160;1880;8428;23348;7546;5911;114798;26050;9358;9375;9071;10150;84189;171425;87769;27199;266722;3843;10082;23483;140432;6564;5611;5095;10257;1638;85416;2262,37
1,1,13,82221361,115092569,32871208,7027;2259;79587;160897;55795;79774;3916;8874;55757;2841;55608;22873;23026;8858;55647;10426;10160;84945;1880;101928841;400165;8428;7174;7546;113622;65110;23348;10673;26050;9358;9375;9071;54841;196541;10150;84189;87769;27199;266722;3843;140432;10082;6564;643365;55002;3621;2073;1282;10257;2155;23250;1948;6011;3981;496;122258;8451;267012;11166;22821;337867;84899;259232;79070;1284;728215;643677;2621;5911;8660;114798;121793;283489;23263;55739;171425;23483;93081;5611;55082;5095;100129836;85416;1638;348013;2159;6656;8881;2262;100533467;55208;6555,92
1,1,13,83435292,115107733,31672441,7027;2259;79587;160897;55795;79774;3916;8874;55757;2841;55608;22873;23026;8858;55647;10426;10160;84945;1880;101928841;400165;8428;7174;7546;113622;65110;23348;10673;26050;9358;9375;9071;54841;196541;10150;84189;87769;27199;266722;3843;140432;10082;6564;643365;55002;3621;2073;1282;10257;2155;23250;1948;6011;3981;496;122258;8451;267012;11166;22821;337867;84899;259232;79070;1284;728215;643677;2621;5911;8660;114798;121793;283489;23263;55739;171425;23483;93081;5611;55082;5095;100129836;85416;1638;348013;2159;6656;8881;2262;100533467;55208;6555,92
1,1,13,83862266,115107733,31245467,7027;2259;79587;160897;55795;79774;3916;8874;55757;2841;55608;22873;23026;8858;55647;10426;10160;84945;1880;101928841;400165;8428;7174;7546;113622;65110;23348;10673;26050;9358;9375;9071;54841;196541;10150;84189;87769;27199;266722;3843;140432;10082;6564;643365;55002;3621;2073;1282;10257;2155;23250;1948;6011;3981;496;122258;8451;267012;11166;22821;337867;84899;259232;79070;1284;728215;643677;2621;5911;8660;114798;121793;283489;23263;55739;171425;23483;93081;5611;55082;5095;100129836;85416;1638;348013;2159;6656;8881;2262;100533467;55208;6555,92
1,1,13,84619041,115085141,30466100,7027;2259;79587;160897;55795;79774;3916;8874;55757;2841;55608;22873;23026;8858;55647;10426;10160;84945;1880;101928841;400165;8428;7174;7546;113622;65110;23348;10673;26050;9358;9375;9071;54841;196541;10150;84189;87769;27199;266722;3843;140432;10082;6564;643365;55002;3621;2073;1282;10257;2155;23250;1948;6011;3981;496;122258;8451;267012;11166;22821;337867;84899;259232;79070;1284;728215;643677;2621;5911;8660;121793;283489;23263;55739;171425;23483;93081;5611;55082;5095;100129836;85416;1638;348013;2159;6656;8881;2262;100533467;55208;6555,91
1,1,13,85176519,115107733,29931214,7027;2259;79587;160897;55795;79774;3916;8874;55757;2841;55608;22873;23026;8858;55647;10426;10160;84945;1880;101928841;400165;8428;7174;7546;113622;65110;23348;10673;26050;9358;9375;9071;54841;196541;10150;84189;87769;27199;266722;3843;140432;10082;6564;643365;55002;3621;2073;1282;10257;2155;23250;1948;6011;3981;496;122258;8451;267012;11166;22821;337867;84899;259232;79070;1284;728215;643677;2621;5911;8660;121793;283489;23263;55739;171425;23483;93081;5611;55082;5095;100129836;85416;1638;348013;2159;6656;8881;2262;100533467;55208;6555,91
1,1,13,86963003,93390362,6427359,26050;2262,2
1,-1,13,87111222,87361937,250715,,0
-1,1,13,87441182,115085141,27643959,7027;2259;79587;160897;55795;79774;3916;8874;55757;2841;55608;22873;23026;8858;55647;10426;10160;84945;1880;101928841;400165;8428;7174;7546;113622;65110;23348;10673;26050;9358;9375;9071;54841;196541;10150;87769;27199;266722;3843;140432;10082;6564;643365;55002;3621;2073;1282;10257;2155;23250;1948;6011;3981;496;122258;8451;267012;11166;22821;337867;84899;259232;79070;1284;728215;643677;2621;5911;8660;121793;283489;23263;55739;171425;23483;93081;5611;55082;5095;100129836;85416;1638;348013;2159;6656;8881;2262;100533467;55208;6555,90
-1,1,13,88073140,115107733,27034593,7027;2259;79587;160897;55795;79774;3916;8874;55757;2841;55608;22873;23026;8858;55647;10426;10160;84945;1880;101928841;400165;8428;7174;7546;113622;65110;23348;10673;26050;9358;9375;9071;54841;196541;10150;87769;27199;266722;3843;140432;10082;6564;643365;55002;3621;2073;1282;10257;2155;23250;1948;6011;3981;496;122258;8451;267012;11166;22821;337867;84899;259232;79070;1284;728215;643677;2621;5911;8660;121793;283489;23263;55739;171425;23483;93081;5611;55082;5095;100129836;85416;1638;348013;2159;6656;8881;2262;100533467;55208;6555,90
-1,1,13,88596734,100518796,11922062,160897;9375;11166;9071;55757;337867;2841;10150;22873;171425;27199;266722;3843;10082;140432;23483;6564;10160;5611;1880;10257;1638;8428;23348;2262;5911,26
1,1,13,89589905,115085141,25495236,7027;2259;79587;160897;55795;79774;3916;8874;55757;2841;55608;22873;23026;8858;55647;10426;10160;84945;1880;101928841;400165;8428;7174;7546;113622;65110;23348;10673;9358;9375;9071;54841;196541;10150;87769;27199;266722;3843;140432;10082;6564;643365;55002;3621;2073;1282;10257;2155;23250;1948;6011;3981;496;122258;8451;267012;11166;22821;337867;84899;259232;79070;1284;728215;643677;2621;5911;8660;121793;283489;23263;55739;171425;23483;93081;5611;55082;5095;100129836;85416;1638;348013;2159;6656;8881;2262;100533467;55208;6555,89
-1,-1,13,90041897,90255725,213828,,0
-1,1,13,91935136,92046713,111577,,0
-1,1,13,91935331,92046713,111382,,0
-1,-1,13,92065460,92267510,202050,2262,1
-1,-1,13,92173306,92249821,76515,2262,1
-1,1,13,93997311,110110501,16113190,160897;2259;11166;55757;337867;2841;22873;23026;84899;259232;10160;84945;1880;79070;728215;643677;8428;7174;23348;7546;10673;5911;9358;9375;9071;54841;196541;10150;171425;87769;27199;266722;10082;3843;6564;140432;23483;93081;5611;2073;55082;5095;10257;1638;85416;1948;3981;100533467;6555;267012,50
-1,-1,13,94253664,94277058,23394,10082,1
1,1,13,94269729,115107733,20838004,7027;2259;79587;160897;55795;79774;3916;8874;55757;2841;55608;22873;23026;8858;55647;10426;10160;84945;1880;101928841;400165;8428;7174;7546;113622;65110;23348;10673;9358;9375;9071;54841;196541;10150;87769;27199;266722;10082;140432;3843;6564;643365;55002;3621;2073;1282;10257;2155;23250;1948;6011;3981;496;122258;8451;267012;11166;22821;337867;84899;259232;79070;1284;728215;643677;2621;5911;8660;121793;283489;23263;55739;171425;23483;93081;5611;55082;5095;100129836;85416;1638;348013;2159;6656;8881;100533467;55208;6555,88
1,-1,13,94342109,94423150,81041,10082,1
-1,1,13,94474530,115107733,20633203,7027;2259;79587;160897;55795;79774;3916;8874;55757;2841;55608;22873;23026;8858;55647;10426;10160;84945;1880;101928841;400165;8428;7174;7546;113622;65110;23348;10673;9358;9375;9071;54841;196541;10150;87769;27199;266722;10082;140432;3843;6564;643365;55002;3621;2073;1282;10257;2155;23250;1948;6011;3981;496;122258;8451;267012;11166;22821;337867;84899;259232;79070;1284;728215;643677;2621;5911;8660;121793;283489;23263;55739;171425;23483;93081;5611;55082;5095;100129836;85416;1638;348013;2159;6656;8881;100533467;55208;6555,88
1,-1,13,95963329,96016904,53575,,0
1,1,13,96397109,111516165,15119056,2259;79587;55757;337867;2841;23026;84899;259232;55647;10160;84945;1880;79070;728215;1284;643677;8428;7174;23348;7546;10673;5911;8660;9358;9375;55739;54841;196541;10150;171425;87769;266722;27199;3843;6564;140432;93081;3621;5611;2073;55082;5095;1282;100129836;85416;1948;3981;100533467;6555;267012,50
-1,1,13,96586481,115107733,18521252,7027;2259;79587;55795;79774;3916;8874;55757;2841;55608;23026;8858;55647;10426;10160;84945;1880;101928841;400165;8428;7174;7546;113622;65110;23348;10673;9358;9375;54841;196541;10150;87769;266722;27199;3843;140432;6564;643365;55002;3621;2073;1282;2155;23250;1948;6011;3981;496;122258;8451;267012;22821;337867;84899;259232;79070;1284;728215;643677;2621;5911;8660;121793;283489;23263;55739;171425;93081;55082;5095;100129836;85416;6656;348013;2159;8881;55208;100533467;6555,79
1,1,13,97397313,115085141,17687828,7027;2259;79587;55795;79774;3916;8874;2841;55608;23026;8858;55647;10426;10160;84945;1880;101928841;400165;8428;7174;7546;113622;65110;23348;10673;9358;9375;54841;196541;10150;87769;266722;27199;3843;140432;6564;643365;55002;3621;2073;1282;2155;23250;1948;6011;3981;496;122258;8451;267012;22821;337867;84899;259232;79070;1284;728215;643677;2621;5911;8660;121793;283489;23263;55739;171425;93081;55082;5095;100129836;85416;6656;348013;2159;8881;55208;100533467;6555,78
-1,1,13,97866125,109815264,11949139,2259;337867;2841;23026;259232;84899;10160;84945;1880;79070;728215;643677;8428;7174;23348;7546;10673;5911;9358;9375;54841;196541;10150;171425;87769;3843;6564;140432;93081;2073;55082;5095;85416;1948;3981;100533467;6555;267012,38
1,1,13,98660269,104349582,5689313,2259;9358;9375;337867;2841;54841;196541;171425;87769;3843;259232;84899;6564;140432;93081;10160;2073;5095;1880;79070;643677;85416;8428;7174;23348;7546;100533467;6555,28
-1,1,13,99333632,100773336,1439704,9375;5095;1880;337867;2841;85416;23348;171425;7546;6564,10
-1,1,13,100016737,101862895,1846158,5095;9375;337867;85416;84899;7546;171425;87769;259232,9
1,1,13,101357397,115107733,13750336,7027;2259;79587;55795;79774;3916;8874;22821;55608;23026;8858;259232;55647;10426;84945;79070;728215;1284;101928841;643677;2621;400165;7174;113622;65110;10673;8660;121793;283489;9358;23263;55739;54841;196541;348013;643365;93081;55002;3621;2073;55082;1282;100129836;6656;23250;1948;3981;2155;2159;100533467;122258;55208;496;8451;6011;8881;6555;267012,58
-1,1,13,101747941,105726899,3978958,2259;2073;9358;79070;643677;196541;54841;7174;100533467;259232;6555;93081,12
1,1,13,102415138,115105760,12690622,7027;2259;55795;79587;79774;3916;8874;22821;55608;23026;8858;55647;10426;8451;84945;79070;728215;1284;101928841;643677;2621;400165;7174;113622;65110;10673;8660;121793;283489;23263;55739;54841;196541;643365;93081;55002;3621;2073;55082;1282;100129836;6656;23250;348013;1948;3981;2155;2159;100533467;122258;55208;496;6011;8881;6555;267012,56
1,1,13,102521058,115059020,12537962,7027;2259;55795;79587;79774;3916;8874;22821;55608;23026;8858;55647;10426;8451;84945;79070;728215;1284;101928841;643677;2621;400165;7174;113622;65110;10673;8660;121793;23263;55739;54841;196541;643365;93081;55002;3621;2073;55082;1282;100129836;6656;23250;348013;1948;3981;2155;2159;100533467;122258;55208;496;6011;8881;6555;267012,55
-1,1,13,103170306,115107733,11937427,7027;55795;79587;79774;3916;8874;22821;55608;23026;8858;55647;10426;84945;79070;728215;1284;101928841;643677;2621;400165;7174;113622;65110;10673;8660;121793;283489;23263;55739;54841;196541;348013;643365;93081;55002;3621;2073;55082;1282;100129836;6656;23250;1948;3981;2155;2159;100533467;122258;55208;496;8451;6011;8881;6555;267012,55
-1,1,13,103535672,115085141,11549469,7027;55795;79587;79774;3916;8874;22821;55608;23026;8858;55647;10426;84945;728215;1284;101928841;2621;400165;113622;65110;10673;8660;121793;283489;23263;55739;643365;55002;3621;55082;1282;100129836;6656;23250;1948;3981;2155;2159;55208;122258;496;6011;8451;348013;8881;6555;267012,47
-1,1,13,103880953,115107733,11226780,7027;55795;79587;79774;3916;8874;22821;55608;23026;8858;55647;10426;84945;728215;1284;101928841;2621;400165;113622;65110;10673;8660;121793;283489;23263;55739;643365;55002;3621;55082;1282;100129836;6656;23250;1948;3981;2155;2159;55208;122258;496;6011;8451;348013;8881;267012,46
1,-1,13,103940341,104473494,533153,,0
1,-1,13,103940341,104473494,533153,,0
-1,-1,13,104834556,104931959,97403,,0
-1,-1,13,104834556,105862032,1027476,,0
-1,1,13,104950552,115085141,10134589,7027;55795;79587;79774;3916;8874;22821;55608;23026;8858;55647;10426;84945;728215;1284;101928841;2621;400165;113622;65110;10673;8660;121793;283489;23263;55739;643365;55002;3621;55082;1282;100129836;6656;23250;1948;3981;2155;2159;55208;122258;496;6011;8451;348013;8881;267012,46
-1,1,13,105620486,108955885,3335399,1948;3981;55082;84945;728215;10673;267012,7
-1,1,13,105620486,115085141,9464655,7027;55795;79587;79774;3916;8874;22821;55608;23026;8858;55647;10426;84945;728215;1284;101928841;2621;400165;113622;65110;10673;8660;121793;283489;23263;55739;643365;55002;3621;55082;1282;100129836;6656;23250;1948;3981;2155;2159;55208;122258;496;6011;8451;348013;8881;267012,46
-1,1,13,106056749,115107733,9050984,7027;55795;79587;79774;3916;8874;22821;55608;23026;8858;55647;10426;84945;728215;1284;101928841;2621;400165;113622;65110;10673;8660;121793;283489;23263;55739;643365;55002;3621;55082;1282;100129836;6656;23250;1948;3981;2155;2159;55208;122258;496;6011;8451;348013;8881;267012,46
-1,1,13,106450862,115107733,8656871,7027;55795;79587;79774;3916;8874;22821;55608;23026;8858;55647;10426;84945;728215;1284;101928841;2621;400165;113622;65110;10673;8660;121793;283489;23263;55739;643365;55002;3621;55082;1282;100129836;6656;23250;1948;3981;2155;2159;55208;122258;496;6011;8451;348013;8881,45
-1,1,13,106513424,115107733,8594309,7027;55795;79587;79774;3916;8874;22821;55608;23026;8858;55647;10426;84945;728215;1284;101928841;2621;400165;113622;65110;10673;8660;121793;283489;23263;55739;643365;55002;3621;55082;1282;100129836;6656;23250;1948;3981;2155;2159;55208;122258;496;6011;8451;348013;8881,45
-1,1,13,107727825,115085141,7357316,7027;55795;79587;79774;3916;8874;22821;55608;23026;8858;55647;10426;84945;728215;1284;101928841;2621;400165;113622;65110;10673;8660;121793;283489;23263;55739;643365;55002;3621;1282;100129836;6656;23250;2155;3981;2159;55208;496;122258;6011;348013;8451;8881,43
-1,1,13,108361003,112755426,4394423,79587;121793;8874;55739;55608;23026;55647;3621;84945;728215;1284;1282;100129836;6656;3981;10673;8660,17
-1,-1,13,108447340,108745644,298304,728215,1
-1,1,13,108570480,115085141,6514661,7027;55795;79587;79774;3916;8874;22821;55608;23026;8858;55647;10426;84945;1284;101928841;2621;400165;113622;65110;10673;8660;121793;283489;23263;55739;643365;55002;3621;1282;100129836;6656;23250;2155;3981;2159;55208;496;122258;6011;348013;8451;8881,42
-1,1,13,109151651,115107733,5956082,7027;55795;79587;79774;3916;8874;22821;55608;23026;8858;55647;10426;1284;101928841;2621;400165;113622;65110;8660;121793;283489;23263;55739;643365;55002;3621;1282;100129836;6656;23250;2155;2159;55208;496;6011;122258;348013;8881;8451,39
-1,1,13,110902315,115085141,4182826,7027;55795;79587;79774;3916;8874;22821;55608;8858;55647;10426;1284;101928841;2621;400165;113622;65110;121793;283489;23263;55739;643365;55002;3621;1282;100129836;6656;23250;2155;2159;55208;496;6011;122258;348013;8881;8451,37
-1,1,13,111282121,115107733,3825612,7027;55795;79587;79774;3916;8874;22821;55608;8858;10426;101928841;2621;400165;113622;65110;121793;283489;23263;55739;643365;55002;3621;6656;23250;2155;2159;55208;496;6011;122258;348013;8881;8451,33
-1,1,13,111510243,115107733,3597490,7027;55795;121793;283489;79774;23263;3916;8874;22821;55608;8858;643365;10426;55002;8451;101928841;2621;400165;6656;23250;2155;2159;113622;65110;55208;496;6011;122258;348013;8881,30
-1,1,13,111550457,115107733,3557276,7027;55795;121793;283489;79774;23263;3916;8874;22821;55608;8858;643365;10426;55002;8451;101928841;2621;400165;6656;23250;2155;2159;113622;65110;55208;496;6011;122258;348013;8881,30
-1,1,13,111853333,115085141,3231808,7027;55795;121793;283489;79774;23263;3916;8874;22821;8858;643365;10426;55002;8451;101928841;2621;400165;6656;23250;2155;2159;113622;65110;55208;496;6011;122258;348013;8881,29
-1,1,13,112008088,115085141,3077053,7027;55795;283489;79774;23263;3916;22821;8858;643365;10426;55002;8451;101928841;2621;400165;23250;6656;2155;2159;113622;65110;55208;496;6011;122258;348013;8881,27
-1,1,13,112091743,115092510,3000767,7027;55795;283489;79774;23263;3916;22821;8858;643365;10426;55002;8451;101928841;2621;400165;23250;6656;2155;2159;113622;65110;55208;496;6011;122258;348013;8881,27
1,-1,13,113105619,113538619,433000,10426;23250;400165,3
1,-1,13,114517405,114528430,11025,2621,1
1,-1,13,114781654,114893774,112120,22821,1
1,-1,13,114792894,114886865,93971,22821,1
1,1,13,114843912,115085141,241229,22821;8881;283489;65110,4
1,-1,13,114990361,115085141,94780,8881;283489;65110,3
1,-1,13,114998561,115054713,56152,8881;65110,2
1,-1,14,19057055,20427125,1370070,441669;390429;79317;441670;440153;390431;79334;641455;79544;404785,10
1,-1,14,19100771,20201260,1100489,79334;641455;440153;404785,4
1,-1,14,19100771,20427125,1326354,441669;390429;79317;441670;440153;390431;79334;641455;79544;404785,10
1,-1,14,19188847,20427125,1238278,441669;390429;79317;441670;440153;390431;79334;641455;79544;404785,10
1,-1,14,19188847,20427125,1238278,441669;390429;79317;441670;440153;390431;79334;641455;79544;404785,10
1,-1,14,19188847,20427125,1238278,441669;390429;79317;441670;440153;390431;79334;641455;79544;404785,10
1,-1,14,19357159,20201260,844101,79334;641455;440153;404785,4
1,-1,14,19357159,20201260,844101,79334;641455;440153;404785,4
1,-1,14,19357159,20376193,1019034,441669;390429;441670;440153;390431;79334;641455;404785,8
1,-1,14,19357159,20427125,1069966,441669;390429;79317;441670;440153;390431;79334;641455;79544;404785,10
1,-1,14,19357159,20427125,1069966,441669;390429;79317;441670;440153;390431;79334;641455;79544;404785,10
1,-1,14,19357159,20427125,1069966,441669;390429;79317;441670;440153;390431;79334;641455;79544;404785,10
1,-1,14,19357159,20427125,1069966,441669;390429;79317;441670;440153;390431;79334;641455;79544;404785,10
1,-1,14,19357159,20427125,1069966,441669;390429;79317;441670;440153;390431;79334;641455;79544;404785,10
1,-1,14,19373470,20004126,630656,641455;440153;404785,3
1,-1,14,19361410,20201260,839850,79334;641455;440153;404785,4
1,-1,14,19361410,20201260,839850,79334;641455;440153;404785,4
1,-1,14,19361410,20201260,839850,79334;641455;440153;404785,4
1,-1,14,19361410,20201260,839850,79334;641455;440153;404785,4
1,-1,14,19361410,20201260,839850,79334;641455;440153;404785,4
1,-1,14,19361410,20201260,839850,79334;641455;440153;404785,4
1,-1,14,19361410,20201260,839850,79334;641455;440153;404785,4
1,-1,14,19361410,20201260,839850,79334;641455;440153;404785,4
1,-1,14,19361410,20201260,839850,79334;641455;440153;404785,4
1,-1,14,19361410,20201260,839850,79334;641455;440153;404785,4
1,-1,14,19361410,20201260,839850,79334;641455;440153;404785,4
1,-1,14,19361410,20201260,839850,79334;641455;440153;404785,4
1,-1,14,19361410,20201260,839850,79334;641455;440153;404785,4
1,-1,14,19361410,20201260,839850,79334;641455;440153;404785,4
1,-1,14,19361410,20201260,839850,79334;641455;440153;404785,4
1,-1,14,19361410,20201260,839850,79334;641455;440153;404785,4
1,-1,14,19361410,20201260,839850,79334;641455;440153;404785,4
1,-1,14,19361410,20201260,839850,79334;641455;440153;404785,4
1,-1,14,19361410,20201260,839850,79334;641455;440153;404785,4
1,-1,14,19361410,20201260,839850,79334;641455;440153;404785,4
1,-1,14,19361410,20201260,839850,79334;641455;440153;404785,4
1,-1,14,19361410,20201260,839850,79334;641455;440153;404785,4
1,-1,14,19361410,20201260,839850,79334;641455;440153;404785,4
-1,-1,14,19361410,20242150,880740,441669;440153;79334;641455;404785,5
1,-1,14,19361410,20280344,918934,441669;390429;440153;79334;641455;404785;441670,7
1,-1,14,19361410,20311153,949743,441669;390429;440153;79334;641455;404785;441670,7
1,-1,14,19361410,20350911,989501,441669;390429;441670;440153;390431;79334;641455;404785,8
1,-1,14,19361410,20376193,1014783,441669;390429;441670;440153;390431;79334;641455;404785,8
1,-1,14,19361410,20376193,1014783,441669;390429;441670;440153;390431;79334;641455;404785,8
-1,-1,14,19361410,20427125,1065715,441669;390429;79317;441670;440153;390431;79334;641455;79544;404785,10
1,-1,14,19361410,20427125,1065715,441669;390429;79317;441670;440153;390431;79334;641455;79544;404785,10
-1,-1,14,19361410,20427125,1065715,441669;390429;79317;441670;440153;390431;79334;641455;79544;404785,10
1,-1,14,19361410,20427125,1065715,441669;390429;79317;441670;440153;390431;79334;641455;79544;404785,10
1,-1,14,19361410,20427125,1065715,441669;390429;79317;441670;440153;390431;79334;641455;79544;404785,10
1,-1,14,19361410,20427125,1065715,441669;390429;79317;441670;440153;390431;79334;641455;79544;404785,10
1,-1,14,19361410,20427125,1065715,441669;390429;79317;441670;440153;390431;79334;641455;79544;404785,10
1,-1,14,19361410,20427125,1065715,441669;390429;79317;441670;440153;390431;79334;641455;79544;404785,10
1,-1,14,19361410,20427125,1065715,441669;390429;79317;441670;440153;390431;79334;641455;79544;404785,10
1,-1,14,19361410,20427125,1065715,441669;390429;79317;441670;440153;390431;79334;641455;79544;404785,10
1,-1,14,19361410,20427125,1065715,441669;390429;79317;441670;440153;390431;79334;641455;79544;404785,10
1,-1,14,19361410,20427125,1065715,441669;390429;79317;441670;440153;390431;79334;641455;79544;404785,10
-1,-1,14,19361410,20427125,1065715,441669;390429;79317;441670;440153;390431;79334;641455;79544;404785,10
1,-1,14,19361410,20427125,1065715,441669;390429;79317;441670;440153;390431;79334;641455;79544;404785,10
1,-1,14,19361410,20427125,1065715,441669;390429;79317;441670;440153;390431;79334;641455;79544;404785,10
-1,-1,14,19361410,20427125,1065715,441669;390429;79317;441670;440153;390431;79334;641455;79544;404785,10
-1,-1,14,19361410,20427125,1065715,441669;390429;79317;441670;440153;390431;79334;641455;79544;404785,10
1,-1,14,19361410,20427125,1065715,441669;390429;79317;441670;440153;390431;79334;641455;79544;404785,10
1,-1,14,19361410,20427125,1065715,441669;390429;79317;441670;440153;390431;79334;641455;79544;404785,10
1,-1,14,19361410,20427125,1065715,441669;390429;79317;441670;440153;390431;79334;641455;79544;404785,10
1,-1,14,19361410,20427125,1065715,441669;390429;79317;441670;440153;390431;79334;641455;79544;404785,10
1,-1,14,19361410,20427125,1065715,441669;390429;79317;441670;440153;390431;79334;641455;79544;404785,10
1,-1,14,19361410,20427125,1065715,441669;390429;79317;441670;440153;390431;79334;641455;79544;404785,10
1,-1,14,19361410,20427125,1065715,441669;390429;79317;441670;440153;390431;79334;641455;79544;404785,10
1,-1,14,19361410,20427125,1065715,441669;390429;79317;441670;440153;390431;79334;641455;79544;404785,10
1,-1,14,19361410,20427125,1065715,441669;390429;79317;441670;440153;390431;79334;641455;79544;404785,10
1,-1,14,19361410,20427125,1065715,441669;390429;79317;441670;440153;390431;79334;641455;79544;404785,10
1,-1,14,19361410,20427125,1065715,441669;390429;79317;441670;440153;390431;79334;641455;79544;404785,10
1,-1,14,19361410,20427125,1065715,441669;390429;79317;441670;440153;390431;79334;641455;79544;404785,10
1,-1,14,19361410,20427125,1065715,441669;390429;79317;441670;440153;390431;79334;641455;79544;404785,10
1,-1,14,19361410,20427125,1065715,441669;390429;79317;441670;440153;390431;79334;641455;79544;404785,10
-1,-1,14,19361410,20427125,1065715,441669;390429;79317;441670;440153;390431;79334;641455;79544;404785,10
1,-1,14,19361410,20427125,1065715,441669;390429;79317;441670;440153;390431;79334;641455;79544;404785,10
1,-1,14,19361410,20427125,1065715,441669;390429;79317;441670;440153;390431;79334;641455;79544;404785,10
-1,-1,14,19361410,20427125,1065715,441669;390429;79317;441670;440153;390431;79334;641455;79544;404785,10
-1,-1,14,19361410,20427125,1065715,441669;390429;79317;441670;440153;390431;79334;641455;79544;404785,10
1,-1,14,19361410,20427125,1065715,441669;390429;79317;441670;440153;390431;79334;641455;79544;404785,10
1,-1,14,19361410,20427125,1065715,441669;390429;79317;441670;440153;390431;79334;641455;79544;404785,10
1,-1,14,19361410,20427125,1065715,441669;390429;79317;441670;440153;390431;79334;641455;79544;404785,10
-1,-1,14,19361410,20427125,1065715,441669;390429;79317;441670;440153;390431;79334;641455;79544;404785,10
1,-1,14,19361410,20427125,1065715,441669;390429;79317;441670;440153;390431;79334;641455;79544;404785,10
1,-1,14,19361410,20427125,1065715,441669;390429;79317;441670;440153;390431;79334;641455;79544;404785,10
1,-1,14,19361410,20427125,1065715,441669;390429;79317;441670;440153;390431;79334;641455;79544;404785,10
1,-1,14,19361410,20427125,1065715,441669;390429;79317;441670;440153;390431;79334;641455;79544;404785,10
-1,-1,14,19361410,20427125,1065715,441669;390429;79317;441670;440153;390431;79334;641455;79544;404785,10
1,-1,14,19361410,20427125,1065715,441669;390429;79317;441670;440153;390431;79334;641455;79544;404785,10
-1,-1,14,19361410,20427125,1065715,441669;390429;79317;441670;440153;390431;79334;641455;79544;404785,10
1,-1,14,19361410,20427125,1065715,441669;390429;79317;441670;440153;390431;79334;641455;79544;404785,10
1,-1,14,19361410,20427125,1065715,441669;390429;79317;441670;440153;390431;79334;641455;79544;404785,10
1,-1,14,19361410,20427125,1065715,441669;390429;79317;441670;440153;390431;79334;641455;79544;404785,10
1,-1,14,19361410,20427125,1065715,441669;390429;79317;441670;440153;390431;79334;641455;79544;404785,10
1,-1,14,19361410,20427125,1065715,441669;390429;79317;441670;440153;390431;79334;641455;79544;404785,10
1,-1,14,19361410,20427125,1065715,441669;390429;79317;441670;440153;390431;79334;641455;79544;404785,10
1,-1,14,19361410,20427125,1065715,441669;390429;79317;441670;440153;390431;79334;641455;79544;404785,10
1,-1,14,19361410,20427125,1065715,441669;390429;79317;441670;440153;390431;79334;641455;79544;404785,10
1,-1,14,19361410,20427125,1065715,441669;390429;79317;441670;440153;390431;79334;641455;79544;404785,10
1,-1,14,19361410,20427125,1065715,441669;390429;79317;441670;440153;390431;79334;641455;79544;404785,10
1,-1,14,19361410,20427125,1065715,441669;390429;79317;441670;440153;390431;79334;641455;79544;404785,10
1,-1,14,19361410,20427125,1065715,441669;390429;79317;441670;440153;390431;79334;641455;79544;404785,10
-1,-1,14,19361410,20427125,1065715,441669;390429;79317;441670;440153;390431;79334;641455;79544;404785,10
1,-1,14,19361410,20427125,1065715,441669;390429;79317;441670;440153;390431;79334;641455;79544;404785,10
1,-1,14,19361410,20427125,1065715,441669;390429;79317;441670;440153;390431;79334;641455;79544;404785,10
1,-1,14,19361410,20427125,1065715,441669;390429;79317;441670;440153;390431;79334;641455;79544;404785,10
1,-1,14,19361410,20427125,1065715,441669;390429;79317;441670;440153;390431;79334;641455;79544;404785,10
1,-1,14,19361410,20427125,1065715,441669;390429;79317;441670;440153;390431;79334;641455;79544;404785,10
1,-1,14,19361410,20427125,1065715,441669;390429;79317;441670;440153;390431;79334;641455;79544;404785,10
1,-1,14,19361410,20427125,1065715,441669;390429;79317;441670;440153;390431;79334;641455;79544;404785,10
1,-1,14,19361410,20427125,1065715,441669;390429;79317;441670;440153;390431;79334;641455;79544;404785,10
1,-1,14,19361410,20427125,1065715,441669;390429;79317;441670;440153;390431;79334;641455;79544;404785,10
1,-1,14,19361410,20427125,1065715,441669;390429;79317;441670;440153;390431;79334;641455;79544;404785,10
1,-1,14,19361410,20427125,1065715,441669;390429;79317;441670;440153;390431;79334;641455;79544;404785,10
1,-1,14,19361410,20427125,1065715,441669;390429;79317;441670;440153;390431;79334;641455;79544;404785,10
1,-1,14,19361410,20427125,1065715,441669;390429;79317;441670;440153;390431;79334;641455;79544;404785,10
1,-1,14,19361410,20427125,1065715,441669;390429;79317;441670;440153;390431;79334;641455;79544;404785,10
1,-1,14,19361410,20427125,1065715,441669;390429;79317;441670;440153;390431;79334;641455;79544;404785,10
1,-1,14,19361410,20427125,1065715,441669;390429;79317;441670;440153;390431;79334;641455;79544;404785,10
1,-1,14,19361410,20427125,1065715,441669;390429;79317;441670;440153;390431;79334;641455;79544;404785,10
1,-1,14,19361410,20427125,1065715,441669;390429;79317;441670;440153;390431;79334;641455;79544;404785,10
1,-1,14,19361410,20427125,1065715,441669;390429;79317;441670;440153;390431;79334;641455;79544;404785,10
1,-1,14,19361410,20427125,1065715,441669;390429;79317;441670;440153;390431;79334;641455;79544;404785,10
1,-1,14,19361410,20427125,1065715,441669;390429;79317;441670;440153;390431;79334;641455;79544;404785,10
-1,-1,14,19361410,20427125,1065715,441669;390429;79317;441670;440153;390431;79334;641455;79544;404785,10
1,-1,14,19361410,20427125,1065715,441669;390429;79317;441670;440153;390431;79334;641455;79544;404785,10
1,-1,14,19361410,20427125,1065715,441669;390429;79317;441670;440153;390431;79334;641455;79544;404785,10
1,-1,14,19361410,20427125,1065715,441669;390429;79317;441670;440153;390431;79334;641455;79544;404785,10
1,-1,14,19361410,20427125,1065715,441669;390429;79317;441670;440153;390431;79334;641455;79544;404785,10
-1,-1,14,19361410,20427125,1065715,441669;390429;79317;441670;440153;390431;79334;641455;79544;404785,10
-1,-1,14,19361410,20427125,1065715,441669;390429;79317;441670;440153;390431;79334;641455;79544;404785,10
1,-1,14,19361410,20427125,1065715,441669;390429;79317;441670;440153;390431;79334;641455;79544;404785,10
1,-1,14,19361410,20427125,1065715,441669;390429;79317;441670;440153;390431;79334;641455;79544;404785,10
-1,-1,14,19361410,20427125,1065715,441669;390429;79317;441670;440153;390431;79334;641455;79544;404785,10
1,-1,14,19361410,20427125,1065715,441669;390429;79317;441670;440153;390431;79334;641455;79544;404785,10
1,-1,14,19361410,20427125,1065715,441669;390429;79317;441670;440153;390431;79334;641455;79544;404785,10
1,-1,14,19361410,20427125,1065715,441669;390429;79317;441670;440153;390431;79334;641455;79544;404785,10
1,-1,14,19361410,20427125,1065715,441669;390429;79317;441670;440153;390431;79334;641455;79544;404785,10
-1,-1,14,19361410,20427125,1065715,441669;390429;79317;441670;440153;390431;79334;641455;79544;404785,10
1,-1,14,19361410,20427125,1065715,441669;390429;79317;441670;440153;390431;79334;641455;79544;404785,10
1,-1,14,19361410,20427125,1065715,441669;390429;79317;441670;440153;390431;79334;641455;79544;404785,10
1,-1,14,19361410,20427125,1065715,441669;390429;79317;441670;440153;390431;79334;641455;79544;404785,10
-1,-1,14,19361410,20427125,1065715,441669;390429;79317;441670;440153;390431;79334;641455;79544;404785,10
1,-1,14,19361410,20427125,1065715,441669;390429;79317;441670;440153;390431;79334;641455;79544;404785,10
1,-1,14,19361410,20427125,1065715,441669;390429;79317;441670;440153;390431;79334;641455;79544;404785,10
1,-1,14,19361410,20427125,1065715,441669;390429;79317;441670;440153;390431;79334;641455;79544;404785,10
1,-1,14,19361410,20427125,1065715,441669;390429;79317;441670;440153;390431;79334;641455;79544;404785,10
1,-1,14,19361410,20427125,1065715,441669;390429;79317;441670;440153;390431;79334;641455;79544;404785,10
1,-1,14,19361410,20427125,1065715,441669;390429;79317;441670;440153;390431;79334;641455;79544;404785,10
1,-1,14,19361410,20427125,1065715,441669;390429;79317;441670;440153;390431;79334;641455;79544;404785,10
1,-1,14,19361410,20427125,1065715,441669;390429;79317;441670;440153;390431;79334;641455;79544;404785,10
1,-1,14,19361410,20427125,1065715,441669;390429;79317;441670;440153;390431;79334;641455;79544;404785,10
1,-1,14,19361410,20427125,1065715,441669;390429;79317;441670;440153;390431;79334;641455;79544;404785,10
-1,-1,14,19361410,20427125,1065715,441669;390429;79317;441670;440153;390431;79334;641455;79544;404785,10
-1,-1,14,19361410,20427125,1065715,441669;390429;79317;441670;440153;390431;79334;641455;79544;404785,10
-1,-1,14,19361410,20427125,1065715,441669;390429;79317;441670;440153;390431;79334;641455;79544;404785,10
1,-1,14,19361410,20427125,1065715,441669;390429;79317;441670;440153;390431;79334;641455;79544;404785,10
1,-1,14,19361410,20427125,1065715,441669;390429;79317;441670;440153;390431;79334;641455;79544;404785,10
1,-1,14,19361410,20427125,1065715,441669;390429;79317;441670;440153;390431;79334;641455;79544;404785,10
1,-1,14,19361410,20427125,1065715,441669;390429;79317;441670;440153;390431;79334;641455;79544;404785,10
1,-1,14,19361410,20427125,1065715,441669;390429;79317;441670;440153;390431;79334;641455;79544;404785,10
-1,-1,14,19361410,20445326,1083916,441669;390429;79317;81127;441670;440153;390431;79334;641455;79544;404785,11
-1,-1,14,19376792,19434604,57812,440153,1
1,-1,14,19376792,20414203,1037411,441669;390429;79317;441670;440153;390431;79334;641455;79544;404785,10
-1,-1,14,19376792,20435888,1059096,441669;390429;79317;441670;440153;390431;79334;641455;79544;404785,10
-1,-1,14,19434605,20435888,1001283,441669;390429;79317;441670;390431;79334;641455;79544;404785,9
1,-1,14,19467197,20427125,959928,441669;390429;79317;441670;390431;79334;641455;79544;404785,9
1,-1,14,19467197,20427125,959928,441669;390429;79317;441670;390431;79334;641455;79544;404785,9
1,-1,14,19467197,20427125,959928,441669;390429;79317;441670;390431;79334;641455;79544;404785,9
1,-1,14,19467197,20427125,959928,441669;390429;79317;441670;390431;79334;641455;79544;404785,9
1,-1,14,19467197,20427125,959928,441669;390429;79317;441670;390431;79334;641455;79544;404785,9
1,-1,14,19467197,20427125,959928,441669;390429;79317;441670;390431;79334;641455;79544;404785,9
1,-1,14,19467197,20427125,959928,441669;390429;79317;441670;390431;79334;641455;79544;404785,9
1,-1,14,19467197,20427125,959928,441669;390429;79317;441670;390431;79334;641455;79544;404785,9
1,-1,14,19467197,20427125,959928,441669;390429;79317;441670;390431;79334;641455;79544;404785,9
-1,-1,14,19474802,20435888,961086,441669;390429;79317;441670;390431;79334;641455;79544;404785,9
1,-1,14,19520766,20427125,906359,441669;390429;79317;441670;390431;79334;641455;79544;404785,9
1,-1,14,19554412,20409332,854920,441669;390429;79317;441670;390431;79334;641455;79544;404785,9
-1,-1,14,19572282,20261126,688844,441669;79334;641455;404785;441670,5
-1,-1,14,19601648,20414203,812555,441669;390429;79317;441670;390431;79334;641455;79544,8
-1,-1,14,19643241,19794590,151349,,0
1,-1,14,19689326,20420820,731494,441669;390429;79317;441670;390431;79334;641455;79544,8
-1,-1,14,19728671,20414203,685532,441669;390429;79317;441670;390431;79334;641455;79544,8
-1,-1,14,19728671,20414203,685532,441669;390429;79317;441670;390431;79334;641455;79544,8
1,1,14,19794561,34049214,14254653,54930;25983;390433;122665;390442;84962;10038;90809;9985;85446;493901;116173;51310;122748;79317;26534;5720;55644;10379;6038;641455;84502;1053;394;51016;4624;599;57820;122742;55701;4625;23428;100528064;1241;4860;122664;56339;9472;643382;22985;64184;161247;57523;161424;5693;11035;23351;55072;8906;10901;317749;112487;441669;63874;64806;2290;10876;2856;122704;1511;6035;57447;51222;4857;122651;145553;81127;3002;4901;2999;100529063;57680;390443;10278;10202;29082;161253;115817;390439;60686;11198;79544;728635;9878;10548;23256;84659;26277;11154;64403;57096;390431;338879;390437;90668;390429;341799;64067;6036;4323;56948;84932;4738;55017;283;6039;7011;51292;9362;27141;56413;196883;5106;9056;1690;1215;79178;25938;29091;5721;440163;283629;6037;122706;7051;91875;6297;29986;390445;90673;80224;1603;26686;122740;5018;80344;5875;123103;25831;643866;10419;26687;26020;3183;26533;57594;390436;79711;328;8106;55632;5587;29966;441670;4776;55147;100507650;79334;64745,159
1,1,14,19794561,107234280,87439719,1743;338917;1965;79609;390433;8477;171546;5283;91828;90809;27133;51109;1112;5104;9578;207;122953;55644;6038;5836;1053;145482;256281;5890;10972;1397;51016;1734;23428;4293;122876;161291;8892;145567;5700;22985;641371;3429;51528;3169;8906;54331;8487;10572;64806;2290;7187;10876;2530;26175;83982;374569;6617;1113;122651;123016;3002;9369;85457;90141;2999;100529063;10516;9692;55237;60686;55860;122416;5529;93487;23241;317761;9950;327657;283576;79820;9112;8111;90668;9628;81693;341799;114088;55334;866;51241;11161;26257;6729;80017;80821;90135;91833;78990;4707;283;51382;51292;5826;79890;145258;145282;89874;1690;1215;25938;91754;283579;5721;8814;2957;122706;10965;53349;12;90673;22863;107984640;3714;5687;5265;9895;122740;5018;54916;341880;55218;643866;26020;84520;56659;55030;29966;4149;957;4776;55015;4331;5015;80224;79334;6751;9517;25983;23588;55837;9985;5427;388015;493901;116173;57062;161142;122748;51804;1396;319089;55195;599;122742;7517;55701;4625;8110;100528064;1241;23034;2342;5684;64184;3895;161424;623;2103;11035;10668;23351;29954;55072;122553;317749;23224;441669;55333;283638;63874;83544;382;1983;51339;283635;55745;122704;10577;647310;57578;145553;112752;55051;254170;55671;57596;87;79697;23357;29082;6495;3091;6710;79696;6166;8812;122809;11198;9878;55012;10548;55172;10640;5228;57452;2954;26277;23186;9252;64403;57096;122509;400258;9321;338879;11099;390437;9495;84334;3306;9786;55640;376267;64112;5732;84932;81537;84193;4738;9556;7011;57697;8747;26153;56413;23508;55102;57862;400224;51199;55778;4329;8650;647286;6297;55727;89932;51635;9529;5891;64093;29986;122402;4053;10490;5641;64398;23093;80127;1073;91748;113146;123103;25831;58517;57570;79711;122622;10979;10914;51077;5587;123036;441670;30001;3705;54930;387990;84962;10038;253970;22990;58157;51310;26534;5720;2643;8846;91612;145497;10175;7043;84502;2972;4522;394;161357;2100;2079;9240;51156;624;6235;7453;57718;161145;161247;57523;9147;145376;7127;5693;51466;5494;161436;26499;256394;51218;100529261;57544;11183;55038;1033;83694;54813;91750;7528;57475;80757;1511;64207;6035;145407;57143;51222;3320;5267;58533;22846;2009;57680;5729;10278;4247;90050;51004;29933;55812;677;26030;728635;64430;9787;84684;11154;390431;51637;5083;317762;26520;81892;51676;6036;9870;4323;145270;161176;2877;6430;122525;23002;79446;283554;57381;7443;112840;27141;196883;23116;7253;79178;29091;55148;283629;6037;10858;122773;7051;2353;5527;390445;8788;55775;145508;1603;399671;1152;84075;80344;84312;1778;388021;2764;10484;10419;10538;3183;57594;100529257;122616;84439;390436;5583;10001;123096;9766;55147;729665;100507650;4792;801;122665;390442;283643;85446;283600;55320;4140;79317;85439;10379;51550;63894;641455;55668;8816;161198;4624;10243;57820;652;79038;4860;122664;56339;9472;643382;51562;646658;79789;64919;54207;161394;123041;97;341947;10598;56967;10901;60485;4990;112487;22795;145581;283598;283578;51062;53981;100128927;8115;5663;27030;2856;6547;57447;4857;6655;81127;26094;122961;4287;123099;4901;64582;6400;23768;64423;390443;6554;10202;7597;161253;115817;26037;390439;145264;79544;112849;7080;22890;23256;84659;79882;64841;51527;253959;79944;112399;57161;387332;390429;440193;64067;283571;3831;56948;2287;140801;2581;55017;6039;115708;6815;641372;56252;9362;145501;122481;3958;5106;9056;122945;11177;5706;122830;122970;1735;9623;5926;440163;4253;91875;23503;81542;56936;145447;26686;122618;6252;5875;122769;145389;26687;26533;57156;8748;122786;11169;145226;23368;145483;23405;22938;328;5411;8106;55632;384;27109;83851;64745,587
-1,-1,14,19820023,20186485,366462,79334;641455,2
-1,-1,14,19980910,20427125,446215,441669;390429;79317;441670;390431;79334;641455;79544,8
1,-1,14,20085860,20137126,51266,,0
-1,-1,14,20085860,20435888,350028,441669;390429;390431;79334;79317;79544;441670,7
-1,-1,14,20097119,20146553,49434,,0
-1,-1,14,20097119,20242202,145083,79334;441669,2
-1,-1,14,20186485,20406327,219842,441669;390429;390431;79317;79544;441670,6
-1,-1,14,20201260,20406327,205067,441669;390429;390431;79317;79544;441670,6
-1,-1,14,20201260,20406327,205067,441669;390429;390431;79317;79544;441670,6
-1,-1,14,20201260,20406327,205067,441669;390429;390431;79317;79544;441670,6
-1,-1,14,20201260,20406327,205067,441669;390429;390431;79317;79544;441670,6
-1,-1,14,20201260,20406327,205067,441669;390429;390431;79317;79544;441670,6
-1,-1,14,20201260,20406327,205067,441669;390429;390431;79317;79544;441670,6
-1,-1,14,20201260,20406327,205067,441669;390429;390431;79317;79544;441670,6
-1,-1,14,20201260,20406327,205067,441669;390429;390431;79317;79544;441670,6
-1,-1,14,20201260,20406327,205067,441669;390429;390431;79317;79544;441670,6
-1,-1,14,20201260,20406327,205067,441669;390429;390431;79317;79544;441670,6
-1,-1,14,20201260,20406327,205067,441669;390429;390431;79317;79544;441670,6
-1,-1,14,20201260,20406327,205067,441669;390429;390431;79317;79544;441670,6
-1,-1,14,20201260,20406327,205067,441669;390429;390431;79317;79544;441670,6
-1,-1,14,20201260,20406327,205067,441669;390429;390431;79317;79544;441670,6
-1,-1,14,20201260,20406327,205067,441669;390429;390431;79317;79544;441670,6
-1,-1,14,20201260,20406327,205067,441669;390429;390431;79317;79544;441670,6
-1,-1,14,20201260,20406327,205067,441669;390429;390431;79317;79544;441670,6
-1,-1,14,20201260,20406327,205067,441669;390429;390431;79317;79544;441670,6
-1,-1,14,20201260,20406327,205067,441669;390429;390431;79317;79544;441670,6
-1,-1,14,20201260,20406327,205067,441669;390429;390431;79317;79544;441670,6
-1,-1,14,20201260,20406327,205067,441669;390429;390431;79317;79544;441670,6
-1,-1,14,20201260,20406327,205067,441669;390429;390431;79317;79544;441670,6
-1,-1,14,20201260,20406327,205067,441669;390429;390431;79317;79544;441670,6
-1,-1,14,20201260,20406327,205067,441669;390429;390431;79317;79544;441670,6
-1,-1,14,20201260,20406327,205067,441669;390429;390431;79317;79544;441670,6
-1,-1,14,20201260,20406327,205067,441669;390429;390431;79317;79544;441670,6
-1,-1,14,20201260,20406327,205067,441669;390429;390431;79317;79544;441670,6
-1,-1,14,20201260,20406327,205067,441669;390429;390431;79317;79544;441670,6
-1,-1,14,20201260,20406327,205067,441669;390429;390431;79317;79544;441670,6
-1,-1,14,20201260,20406327,205067,441669;390429;390431;79317;79544;441670,6
-1,-1,14,20201260,20406327,205067,441669;390429;390431;79317;79544;441670,6
-1,-1,14,20201260,20406327,205067,441669;390429;390431;79317;79544;441670,6
-1,-1,14,20201260,20406327,205067,441669;390429;390431;79317;79544;441670,6
-1,-1,14,20201260,20406327,205067,441669;390429;390431;79317;79544;441670,6
-1,-1,14,20201260,20406327,205067,441669;390429;390431;79317;79544;441670,6
-1,-1,14,20201260,20406327,205067,441669;390429;390431;79317;79544;441670,6
-1,-1,14,20201260,20406327,205067,441669;390429;390431;79317;79544;441670,6
-1,-1,14,20201260,20406327,205067,441669;390429;390431;79317;79544;441670,6
-1,-1,14,20201260,20406327,205067,441669;390429;390431;79317;79544;441670,6
-1,-1,14,20201260,20406327,205067,441669;390429;390431;79317;79544;441670,6
-1,-1,14,20201260,20406327,205067,441669;390429;390431;79317;79544;441670,6
-1,-1,14,20201260,20406327,205067,441669;390429;390431;79317;79544;441670,6
-1,-1,14,20201260,20406327,205067,441669;390429;390431;79317;79544;441670,6
-1,-1,14,20201260,20406327,205067,441669;390429;390431;79317;79544;441670,6
-1,-1,14,20201260,20406327,205067,441669;390429;390431;79317;79544;441670,6
-1,-1,14,20201260,20406327,205067,441669;390429;390431;79317;79544;441670,6
-1,-1,14,20201260,20406327,205067,441669;390429;390431;79317;79544;441670,6
-1,-1,14,20201260,20406327,205067,441669;390429;390431;79317;79544;441670,6
-1,-1,14,20201260,20406327,205067,441669;390429;390431;79317;79544;441670,6
-1,-1,14,20201260,20406327,205067,441669;390429;390431;79317;79544;441670,6
-1,-1,14,20201260,20406327,205067,441669;390429;390431;79317;79544;441670,6
-1,-1,14,20201260,20406327,205067,441669;390429;390431;79317;79544;441670,6
-1,-1,14,20201260,20406327,205067,441669;390429;390431;79317;79544;441670,6
-1,-1,14,20201260,20406327,205067,441669;390429;390431;79317;79544;441670,6
-1,-1,14,20201260,20406327,205067,441669;390429;390431;79317;79544;441670,6
-1,-1,14,20201260,20406327,205067,441669;390429;390431;79317;79544;441670,6
-1,-1,14,20201260,20406327,205067,441669;390429;390431;79317;79544;441670,6
-1,-1,14,20201260,20406327,205067,441669;390429;390431;79317;79544;441670,6
-1,-1,14,20201260,20406327,205067,441669;390429;390431;79317;79544;441670,6
-1,-1,14,20201260,20406327,205067,441669;390429;390431;79317;79544;441670,6
-1,-1,14,20201260,20406327,205067,441669;390429;390431;79317;79544;441670,6
-1,-1,14,20201260,20406327,205067,441669;390429;390431;79317;79544;441670,6
-1,-1,14,20201260,20406327,205067,441669;390429;390431;79317;79544;441670,6
-1,-1,14,20201260,20406327,205067,441669;390429;390431;79317;79544;441670,6
-1,-1,14,20201260,20406327,205067,441669;390429;390431;79317;79544;441670,6
-1,-1,14,20201260,20406327,205067,441669;390429;390431;79317;79544;441670,6
-1,-1,14,20201260,20406327,205067,441669;390429;390431;79317;79544;441670,6
-1,-1,14,20201260,20406327,205067,441669;390429;390431;79317;79544;441670,6
-1,-1,14,20201260,20406327,205067,441669;390429;390431;79317;79544;441670,6
-1,-1,14,20201260,20406327,205067,441669;390429;390431;79317;79544;441670,6
-1,-1,14,20201260,20406327,205067,441669;390429;390431;79317;79544;441670,6
-1,-1,14,20201260,20406327,205067,441669;390429;390431;79317;79544;441670,6
-1,-1,14,20201260,20406327,205067,441669;390429;390431;79317;79544;441670,6
-1,-1,14,20201260,20406327,205067,441669;390429;390431;79317;79544;441670,6
-1,-1,14,20201260,20406327,205067,441669;390429;390431;79317;79544;441670,6
-1,-1,14,20201260,20406327,205067,441669;390429;390431;79317;79544;441670,6
-1,-1,14,20201260,20406327,205067,441669;390429;390431;79317;79544;441670,6
-1,-1,14,20201260,20406327,205067,441669;390429;390431;79317;79544;441670,6
-1,-1,14,20201260,20406327,205067,441669;390429;390431;79317;79544;441670,6
-1,-1,14,20201260,20406327,205067,441669;390429;390431;79317;79544;441670,6
-1,-1,14,20201260,20406327,205067,441669;390429;390431;79317;79544;441670,6
-1,-1,14,20201260,20406327,205067,441669;390429;390431;79317;79544;441670,6
-1,-1,14,20201260,20406327,205067,441669;390429;390431;79317;79544;441670,6
-1,-1,14,20201260,20406327,205067,441669;390429;390431;79317;79544;441670,6
-1,-1,14,20201260,20406327,205067,441669;390429;390431;79317;79544;441670,6
-1,-1,14,20201260,20406327,205067,441669;390429;390431;79317;79544;441670,6
-1,-1,14,20201260,20406327,205067,441669;390429;390431;79317;79544;441670,6
-1,-1,14,20201260,20406327,205067,441669;390429;390431;79317;79544;441670,6
-1,-1,14,20201260,20406327,205067,441669;390429;390431;79317;79544;441670,6
-1,-1,14,20201260,20406327,205067,441669;390429;390431;79317;79544;441670,6
-1,-1,14,20201260,20406327,205067,441669;390429;390431;79317;79544;441670,6
-1,-1,14,20201260,20406327,205067,441669;390429;390431;79317;79544;441670,6
-1,-1,14,20201260,20406327,205067,441669;390429;390431;79317;79544;441670,6
-1,-1,14,20201260,20406327,205067,441669;390429;390431;79317;79544;441670,6
-1,-1,14,20201260,20406327,205067,441669;390429;390431;79317;79544;441670,6
-1,-1,14,20201260,20406327,205067,441669;390429;390431;79317;79544;441670,6
-1,-1,14,20201260,20406327,205067,441669;390429;390431;79317;79544;441670,6
-1,-1,14,20201260,20406327,205067,441669;390429;390431;79317;79544;441670,6
-1,-1,14,20201260,20406327,205067,441669;390429;390431;79317;79544;441670,6
-1,-1,14,20201260,20406327,205067,441669;390429;390431;79317;79544;441670,6
-1,-1,14,20201260,20406327,205067,441669;390429;390431;79317;79544;441670,6
-1,-1,14,20201260,20406327,205067,441669;390429;390431;79317;79544;441670,6
-1,-1,14,20201260,20406327,205067,441669;390429;390431;79317;79544;441670,6
-1,-1,14,20201260,20406327,205067,441669;390429;390431;79317;79544;441670,6
-1,-1,14,20201260,20406327,205067,441669;390429;390431;79317;79544;441670,6
-1,-1,14,20201260,20406327,205067,441669;390429;390431;79317;79544;441670,6
-1,-1,14,20201260,20406327,205067,441669;390429;390431;79317;79544;441670,6
-1,-1,14,20201260,20406327,205067,441669;390429;390431;79317;79544;441670,6
-1,-1,14,20201260,20406327,205067,441669;390429;390431;79317;79544;441670,6
-1,-1,14,20201260,20406327,205067,441669;390429;390431;79317;79544;441670,6
-1,-1,14,20201260,20406327,205067,441669;390429;390431;79317;79544;441670,6
-1,-1,14,20201260,20406327,205067,441669;390429;390431;79317;79544;441670,6
-1,-1,14,20201260,20406327,205067,441669;390429;390431;79317;79544;441670,6
-1,-1,14,20201260,20406327,205067,441669;390429;390431;79317;79544;441670,6
-1,-1,14,20201260,20406327,205067,441669;390429;390431;79317;79544;441670,6
-1,-1,14,20201260,20406327,205067,441669;390429;390431;79317;79544;441670,6
-1,-1,14,20201260,20406327,205067,441669;390429;390431;79317;79544;441670,6
-1,-1,14,20201260,20406327,205067,441669;390429;390431;79317;79544;441670,6
-1,-1,14,20201260,20406327,205067,441669;390429;390431;79317;79544;441670,6
-1,-1,14,20201260,20406327,205067,441669;390429;390431;79317;79544;441670,6
-1,-1,14,20201260,20406327,205067,441669;390429;390431;79317;79544;441670,6
-1,-1,14,20201260,20406327,205067,441669;390429;390431;79317;79544;441670,6
-1,-1,14,20201260,20406327,205067,441669;390429;390431;79317;79544;441670,6
-1,-1,14,20201260,20406327,205067,441669;390429;390431;79317;79544;441670,6
-1,-1,14,20201260,20406327,205067,441669;390429;390431;79317;79544;441670,6
-1,-1,14,20201260,20406327,205067,441669;390429;390431;79317;79544;441670,6
-1,-1,14,20201260,20406327,205067,441669;390429;390431;79317;79544;441670,6
-1,-1,14,20201260,20406327,205067,441669;390429;390431;79317;79544;441670,6
-1,-1,14,20201260,20406327,205067,441669;390429;390431;79317;79544;441670,6
-1,-1,14,20201260,20406327,205067,441669;390429;390431;79317;79544;441670,6
-1,-1,14,20201260,20406327,205067,441669;390429;390431;79317;79544;441670,6
-1,-1,14,20201260,20406327,205067,441669;390429;390431;79317;79544;441670,6
-1,-1,14,20201260,20406327,205067,441669;390429;390431;79317;79544;441670,6
-1,-1,14,20201260,20406327,205067,441669;390429;390431;79317;79544;441670,6
-1,-1,14,20201260,20406327,205067,441669;390429;390431;79317;79544;441670,6
-1,-1,14,20201260,20406327,205067,441669;390429;390431;79317;79544;441670,6
-1,-1,14,20201260,20406327,205067,441669;390429;390431;79317;79544;441670,6
-1,-1,14,20201260,20406327,205067,441669;390429;390431;79317;79544;441670,6
-1,-1,14,20201260,20406327,205067,441669;390429;390431;79317;79544;441670,6
-1,-1,14,20201260,20406327,205067,441669;390429;390431;79317;79544;441670,6
-1,-1,14,20201260,20406327,205067,441669;390429;390431;79317;79544;441670,6
-1,-1,14,20201260,20406327,205067,441669;390429;390431;79317;79544;441670,6
-1,-1,14,20201260,20406327,205067,441669;390429;390431;79317;79544;441670,6
-1,-1,14,20201260,20406327,205067,441669;390429;390431;79317;79544;441670,6
-1,-1,14,20201260,20406327,205067,441669;390429;390431;79317;79544;441670,6
-1,-1,14,20201260,20406327,205067,441669;390429;390431;79317;79544;441670,6
-1,-1,14,20201260,20406327,205067,441669;390429;390431;79317;79544;441670,6
-1,-1,14,20201260,20406327,205067,441669;390429;390431;79317;79544;441670,6
-1,-1,14,20201260,20406327,205067,441669;390429;390431;79317;79544;441670,6
-1,-1,14,20201260,20406327,205067,441669;390429;390431;79317;79544;441670,6
-1,-1,14,20201260,20406327,205067,441669;390429;390431;79317;79544;441670,6
-1,-1,14,20201260,20406327,205067,441669;390429;390431;79317;79544;441670,6
-1,-1,14,20201260,20406327,205067,441669;390429;390431;79317;79544;441670,6
-1,-1,14,20201260,20406327,205067,441669;390429;390431;79317;79544;441670,6
-1,-1,14,20201260,20406327,205067,441669;390429;390431;79317;79544;441670,6
-1,-1,14,20201260,20406327,205067,441669;390429;390431;79317;79544;441670,6
-1,-1,14,20201260,20406327,205067,441669;390429;390431;79317;79544;441670,6
-1,-1,14,20201260,20406327,205067,441669;390429;390431;79317;79544;441670,6
-1,-1,14,20201260,20406327,205067,441669;390429;390431;79317;79544;441670,6
-1,-1,14,20201260,20406327,205067,441669;390429;390431;79317;79544;441670,6
-1,-1,14,20201260,20406327,205067,441669;390429;390431;79317;79544;441670,6
-1,-1,14,20201260,20406327,205067,441669;390429;390431;79317;79544;441670,6
-1,-1,14,20201260,20406327,205067,441669;390429;390431;79317;79544;441670,6
-1,-1,14,20201260,20406327,205067,441669;390429;390431;79317;79544;441670,6
-1,-1,14,20201260,20406327,205067,441669;390429;390431;79317;79544;441670,6
-1,-1,14,20201260,20406327,205067,441669;390429;390431;79317;79544;441670,6
-1,-1,14,20201260,20406327,205067,441669;390429;390431;79317;79544;441670,6
-1,-1,14,20201260,20406327,205067,441669;390429;390431;79317;79544;441670,6
-1,-1,14,20201260,20406327,205067,441669;390429;390431;79317;79544;441670,6
-1,-1,14,20201260,20406327,205067,441669;390429;390431;79317;79544;441670,6
-1,-1,14,20201260,20406327,205067,441669;390429;390431;79317;79544;441670,6
-1,-1,14,20201260,20406327,205067,441669;390429;390431;79317;79544;441670,6
-1,-1,14,20201260,20406327,205067,441669;390429;390431;79317;79544;441670,6
-1,-1,14,20201260,20406327,205067,441669;390429;390431;79317;79544;441670,6
-1,-1,14,20201260,20406327,205067,441669;390429;390431;79317;79544;441670,6
-1,-1,14,20201260,20406327,205067,441669;390429;390431;79317;79544;441670,6
-1,-1,14,20201260,20406327,205067,441669;390429;390431;79317;79544;441670,6
-1,-1,14,20201260,20406327,205067,441669;390429;390431;79317;79544;441670,6
-1,-1,14,20201260,20406327,205067,441669;390429;390431;79317;79544;441670,6
-1,-1,14,20201260,20406327,205067,441669;390429;390431;79317;79544;441670,6
-1,-1,14,20201260,20406327,205067,441669;390429;390431;79317;79544;441670,6
-1,-1,14,20201260,20406327,205067,441669;390429;390431;79317;79544;441670,6
-1,-1,14,20201260,20406327,205067,441669;390429;390431;79317;79544;441670,6
-1,-1,14,20201260,20406327,205067,441669;390429;390431;79317;79544;441670,6
-1,-1,14,20201260,20406327,205067,441669;390429;390431;79317;79544;441670,6
-1,-1,14,20201260,20406327,205067,441669;390429;390431;79317;79544;441670,6
-1,-1,14,20201260,20406327,205067,441669;390429;390431;79317;79544;441670,6
-1,-1,14,20201260,20406327,205067,441669;390429;390431;79317;79544;441670,6
-1,-1,14,20201260,20406327,205067,441669;390429;390431;79317;79544;441670,6
-1,-1,14,20201260,20406327,205067,441669;390429;390431;79317;79544;441670,6
-1,-1,14,20201260,20406327,205067,441669;390429;390431;79317;79544;441670,6
-1,-1,14,20201260,20406327,205067,441669;390429;390431;79317;79544;441670,6
-1,-1,14,20201260,20406327,205067,441669;390429;390431;79317;79544;441670,6
-1,-1,14,20201260,20406327,205067,441669;390429;390431;79317;79544;441670,6
-1,-1,14,20201260,20406327,205067,441669;390429;390431;79317;79544;441670,6
-1,-1,14,20201260,20406327,205067,441669;390429;390431;79317;79544;441670,6
-1,-1,14,20201260,20406327,205067,441669;390429;390431;79317;79544;441670,6
-1,-1,14,20201260,20406327,205067,441669;390429;390431;79317;79544;441670,6
-1,-1,14,20201260,20406327,205067,441669;390429;390431;79317;79544;441670,6
-1,-1,14,20201260,20406327,205067,441669;390429;390431;79317;79544;441670,6
-1,-1,14,20201260,20406327,205067,441669;390429;390431;79317;79544;441670,6
1,-1,14,20198966,20465976,267010,441669;390429;390431;79317;81127;79544;441670,7
1,-1,14,20203478,20409332,205854,441669;390429;390431;79317;79544;441670,6
1,-1,14,20203478,20420820,217342,441669;390429;390431;79317;79544;441670,6
1,-1,14,20217284,20406327,189043,390429;390431;79317;79544;441670,5
1,-1,14,20217284,20406327,189043,390429;390431;79317;79544;441670,5
1,-1,14,20217284,20406327,189043,390429;390431;79317;79544;441670,5
-1,-1,14,20253908,20406327,152419,79317;390429;79544;390431,4
-1,-1,14,20338772,20420820,82048,79317;79544;390431,3
-1,-1,14,20338772,20420820,82048,79317;79544;390431,3
-1,-1,14,20350922,20397702,46780,79317,1
-1,-1,14,20376238,20397702,21464,79317,1
1,1,14,20490852,44562875,24072023,54930;6751;25983;390433;122665;390442;84962;171546;10038;55837;90809;253970;9985;85446;493901;116173;51310;122748;26534;5720;55644;10379;6038;319089;84502;1053;394;161198;51016;4624;599;57820;122742;55701;4625;23428;100528064;1241;4860;122664;56339;9472;643382;22985;64184;51562;161247;57523;161424;5693;11035;23351;3169;55072;8906;122553;10901;317749;112487;8487;145581;63874;64806;2290;10876;283635;2856;122704;1511;6035;57447;51222;4857;122651;145553;3002;58533;4901;2999;254170;100529063;57680;390443;10278;10202;29082;161253;115817;390439;9692;60686;11198;728635;9878;55012;10548;7080;84684;23256;84659;26277;11154;64403;57096;253959;338879;112399;5083;390437;90668;341799;64067;6036;4323;56948;26257;6729;84932;4738;55017;283;6039;7011;51292;9362;27141;56413;196883;145282;5106;9056;89874;11177;1690;1215;79178;25938;29091;5721;440163;283629;6037;4253;122706;7051;91875;6297;29986;390445;90673;80224;1603;5687;26686;5018;80344;84312;5875;1073;123103;25831;643866;10484;10419;26687;26020;3183;26533;57594;390436;79711;328;5411;8106;55632;5587;29966;4776;55147;100507650;4792;64745,182
1,1,14,20511672,49111245,28599573,54930;6751;25983;122665;390442;84962;171546;10038;55837;90809;253970;9985;85446;493901;116173;55320;51310;122748;26534;5720;55644;10379;6038;319089;84502;1053;394;161357;161198;51016;4624;599;57820;122742;55701;4625;23428;100528064;1241;4860;122664;56339;9472;643382;22985;64184;51562;161247;57523;161424;5693;11035;23351;3169;55072;8906;122553;10901;317749;112487;8487;145581;63874;64806;2290;54813;10876;283635;2856;122704;1511;6035;57447;51222;4857;122651;145553;3002;58533;4901;2999;254170;100529063;57680;390443;10278;10202;29082;161253;115817;390439;9692;60686;11198;728635;9878;55012;10548;7080;84684;23256;84659;26277;11154;64403;57096;253959;338879;112399;5083;390437;90668;341799;64067;6036;4323;56948;2287;140801;26257;6729;84932;122525;4738;55017;283;6039;7011;57697;51292;9362;27141;56413;196883;23116;145282;5106;9056;89874;11177;1690;1215;79178;25938;29091;5721;440163;283629;6037;4253;122706;7051;91875;6297;29986;390445;90673;80224;1603;5687;26686;84075;5018;80344;84312;5875;1073;123103;25831;643866;10484;10419;26687;26020;3183;26533;57594;390436;79711;328;5411;8106;55632;5587;29966;4776;55147;55015;100507650;4792;64745,191
1,1,14,20511673,107285437,86773764,1743;338917;1965;79609;8477;171546;5283;91828;90809;27133;51109;1112;5104;9578;207;122953;55644;6038;5836;1053;145482;256281;5890;10972;1397;51016;1734;23428;4293;122876;161291;8892;145567;5700;22985;641371;3429;51528;3169;8906;54331;8487;10572;64806;2290;7187;10876;2530;26175;83982;374569;6617;1113;122651;123016;3002;9369;85457;90141;2999;100529063;10516;9692;55237;60686;55860;122416;5529;93487;23241;317761;9950;327657;283576;79820;9112;8111;90668;9628;81693;341799;114088;55334;866;51241;11161;26257;6729;80017;80821;90135;91833;78990;4707;283;51382;51292;5826;79890;145258;145282;89874;1690;1215;25938;91754;283579;5721;8814;2957;122706;10965;53349;12;90673;22863;107984640;3714;5687;5265;9895;5018;54916;341880;55218;643866;26020;84520;56659;55030;29966;4149;957;4776;55015;4331;5015;80224;6751;9517;25983;23588;55837;9985;5427;388015;493901;116173;57062;161142;122748;51804;1396;319089;55195;599;122742;7517;55701;4625;8110;100528064;1241;23034;2342;5684;64184;3895;161424;623;2103;11035;10668;23351;29954;55072;122553;317749;23224;55333;283638;63874;83544;382;1983;51339;283635;55745;122704;10577;647310;57578;145553;112752;55051;254170;55671;57596;87;79697;23357;29082;6495;3091;6710;79696;6166;8812;122809;11198;9878;55012;10548;55172;10640;5228;57452;2954;26277;23186;9252;64403;57096;122509;400258;9321;338879;11099;390437;9495;84334;3306;9786;55640;376267;64112;5732;84932;81537;84193;4738;9556;7011;57697;8747;26153;56413;23508;55102;57862;400224;51199;55778;4329;8650;647286;6297;55727;89932;51635;9529;5891;64093;29986;122402;4053;10490;5641;64398;23093;80127;1073;91748;113146;123103;25831;58517;57570;79711;122622;10979;10914;51077;5587;123036;30001;3705;54930;387990;84962;10038;253970;22990;58157;51310;26534;5720;2643;8846;91612;145497;10175;7043;84502;2972;4522;394;161357;2100;2079;9240;51156;624;6235;7453;57718;161145;161247;57523;9147;145376;7127;5693;51466;5494;161436;26499;256394;51218;100529261;57544;11183;55038;1033;83694;54813;91750;7528;57475;80757;1511;64207;6035;145407;57143;51222;3320;5267;58533;22846;2009;57680;5729;10278;4247;90050;51004;29933;55812;677;26030;728635;64430;9787;84684;11154;51637;5083;317762;26520;81892;51676;6036;9870;4323;145270;161176;2877;6430;122525;23002;79446;283554;57381;7443;112840;27141;196883;23116;7253;79178;29091;55148;283629;6037;10858;122773;7051;2353;5527;390445;8788;55775;145508;1603;399671;1152;84075;80344;84312;1778;388021;2764;10484;10419;10538;3183;57594;100529257;122616;84439;390436;5583;10001;123096;9766;55147;729665;100507650;4792;801;122665;390442;283643;85446;283600;55320;4140;85439;10379;51550;63894;55668;8816;161198;4624;10243;57820;652;79038;4860;122664;56339;9472;643382;51562;646658;79789;64919;54207;161394;123041;97;341947;10598;56967;10901;60485;4990;112487;22795;145581;283598;283578;51062;53981;100128927;8115;5663;27030;2856;6547;57447;4857;6655;26094;122961;4287;123099;4901;64582;6400;23768;64423;390443;6554;10202;7597;161253;115817;26037;390439;145264;112849;7080;22890;23256;84659;79882;64841;51527;253959;79944;112399;57161;387332;440193;64067;283571;3831;56948;2287;140801;2581;55017;6039;115708;6815;641372;56252;9362;145501;122481;3958;5106;9056;122945;11177;5706;122830;122970;1735;9623;5926;440163;4253;91875;23503;81542;56936;145447;26686;122618;6252;5875;122769;145389;26687;26533;57156;8748;122786;11169;145226;23368;145483;23405;22938;328;5411;8106;55632;384;27109;83851;64745,576
1,1,14,20511673,107285437,86773764,1743;338917;1965;79609;8477;171546;5283;91828;90809;27133;51109;1112;5104;9578;207;122953;55644;6038;5836;1053;145482;256281;5890;10972;1397;51016;1734;23428;4293;122876;161291;8892;145567;5700;22985;641371;3429;51528;3169;8906;54331;8487;10572;64806;2290;7187;10876;2530;26175;83982;374569;6617;1113;122651;123016;3002;9369;85457;90141;2999;100529063;10516;9692;55237;60686;55860;122416;5529;93487;23241;317761;9950;327657;283576;79820;9112;8111;90668;9628;81693;341799;114088;55334;866;51241;11161;26257;6729;80017;80821;90135;91833;78990;4707;283;51382;51292;5826;79890;145258;145282;89874;1690;1215;25938;91754;283579;5721;8814;2957;122706;10965;53349;12;90673;22863;107984640;3714;5687;5265;9895;5018;54916;341880;55218;643866;26020;84520;56659;55030;29966;4149;957;4776;55015;4331;5015;80224;6751;9517;25983;23588;55837;9985;5427;388015;493901;116173;57062;161142;122748;51804;1396;319089;55195;599;122742;7517;55701;4625;8110;100528064;1241;23034;2342;5684;64184;3895;161424;623;2103;11035;10668;23351;29954;55072;122553;317749;23224;55333;283638;63874;83544;382;1983;51339;283635;55745;122704;10577;647310;57578;145553;112752;55051;254170;55671;57596;87;79697;23357;29082;6495;3091;6710;79696;6166;8812;122809;11198;9878;55012;10548;55172;10640;5228;57452;2954;26277;23186;9252;64403;57096;122509;400258;9321;338879;11099;390437;9495;84334;3306;9786;55640;376267;64112;5732;84932;81537;84193;4738;9556;7011;57697;8747;26153;56413;23508;55102;57862;400224;51199;55778;4329;8650;647286;6297;55727;89932;51635;9529;5891;64093;29986;122402;4053;10490;5641;64398;23093;80127;1073;91748;113146;123103;25831;58517;57570;79711;122622;10979;10914;51077;5587;123036;30001;3705;54930;387990;84962;10038;253970;22990;58157;51310;26534;5720;2643;8846;91612;145497;10175;7043;84502;2972;4522;394;161357;2100;2079;9240;51156;624;6235;7453;57718;161145;161247;57523;9147;145376;7127;5693;51466;5494;161436;26499;256394;51218;100529261;57544;11183;55038;1033;83694;54813;91750;7528;57475;80757;1511;64207;6035;145407;57143;51222;3320;5267;58533;22846;2009;57680;5729;10278;4247;90050;51004;29933;55812;677;26030;728635;64430;9787;84684;11154;51637;5083;317762;26520;81892;51676;6036;9870;4323;145270;161176;2877;6430;122525;23002;79446;283554;57381;7443;112840;27141;196883;23116;7253;79178;29091;55148;283629;6037;10858;122773;7051;2353;5527;390445;8788;55775;145508;1603;399671;1152;84075;80344;84312;1778;388021;2764;10484;10419;10538;3183;57594;100529257;122616;84439;390436;5583;10001;123096;9766;55147;729665;100507650;4792;801;122665;390442;283643;85446;283600;55320;4140;85439;10379;51550;63894;55668;8816;161198;4624;10243;57820;652;79038;4860;122664;56339;9472;643382;51562;646658;79789;64919;54207;161394;123041;97;341947;10598;56967;10901;60485;4990;112487;22795;145581;283598;283578;51062;53981;100128927;8115;5663;27030;2856;6547;57447;4857;6655;26094;122961;4287;123099;4901;64582;6400;23768;64423;390443;6554;10202;7597;161253;115817;26037;390439;145264;112849;7080;22890;23256;84659;79882;64841;51527;253959;79944;112399;57161;387332;440193;64067;283571;3831;56948;2287;140801;2581;55017;6039;115708;6815;641372;56252;9362;145501;122481;3958;5106;9056;122945;11177;5706;122830;122970;1735;9623;5926;440163;4253;91875;23503;81542;56936;145447;26686;122618;6252;5875;122769;145389;26687;26533;57156;8748;122786;11169;145226;23368;145483;23405;22938;328;5411;8106;55632;384;27109;83851;64745,576
1,1,14,20511673,107285437,86773764,1743;338917;1965;79609;8477;171546;5283;91828;90809;27133;51109;1112;5104;9578;207;122953;55644;6038;5836;1053;145482;256281;5890;10972;1397;51016;1734;23428;4293;122876;161291;8892;145567;5700;22985;641371;3429;51528;3169;8906;54331;8487;10572;64806;2290;7187;10876;2530;26175;83982;374569;6617;1113;122651;123016;3002;9369;85457;90141;2999;100529063;10516;9692;55237;60686;55860;122416;5529;93487;23241;317761;9950;327657;283576;79820;9112;8111;90668;9628;81693;341799;114088;55334;866;51241;11161;26257;6729;80017;80821;90135;91833;78990;4707;283;51382;51292;5826;79890;145258;145282;89874;1690;1215;25938;91754;283579;5721;8814;2957;122706;10965;53349;12;90673;22863;107984640;3714;5687;5265;9895;5018;54916;341880;55218;643866;26020;84520;56659;55030;29966;4149;957;4776;55015;4331;5015;80224;6751;9517;25983;23588;55837;9985;5427;388015;493901;116173;57062;161142;122748;51804;1396;319089;55195;599;122742;7517;55701;4625;8110;100528064;1241;23034;2342;5684;64184;3895;161424;623;2103;11035;10668;23351;29954;55072;122553;317749;23224;55333;283638;63874;83544;382;1983;51339;283635;55745;122704;10577;647310;57578;145553;112752;55051;254170;55671;57596;87;79697;23357;29082;6495;3091;6710;79696;6166;8812;122809;11198;9878;55012;10548;55172;10640;5228;57452;2954;26277;23186;9252;64403;57096;122509;400258;9321;338879;11099;390437;9495;84334;3306;9786;55640;376267;64112;5732;84932;81537;84193;4738;9556;7011;57697;8747;26153;56413;23508;55102;57862;400224;51199;55778;4329;8650;647286;6297;55727;89932;51635;9529;5891;64093;29986;122402;4053;10490;5641;64398;23093;80127;1073;91748;113146;123103;25831;58517;57570;79711;122622;10979;10914;51077;5587;123036;30001;3705;54930;387990;84962;10038;253970;22990;58157;51310;26534;5720;2643;8846;91612;145497;10175;7043;84502;2972;4522;394;161357;2100;2079;9240;51156;624;6235;7453;57718;161145;161247;57523;9147;145376;7127;5693;51466;5494;161436;26499;256394;51218;100529261;57544;11183;55038;1033;83694;54813;91750;7528;57475;80757;1511;64207;6035;145407;57143;51222;3320;5267;58533;22846;2009;57680;5729;10278;4247;90050;51004;29933;55812;677;26030;728635;64430;9787;84684;11154;51637;5083;317762;26520;81892;51676;6036;9870;4323;145270;161176;2877;6430;122525;23002;79446;283554;57381;7443;112840;27141;196883;23116;7253;79178;29091;55148;283629;6037;10858;122773;7051;2353;5527;390445;8788;55775;145508;1603;399671;1152;84075;80344;84312;1778;388021;2764;10484;10419;10538;3183;57594;100529257;122616;84439;390436;5583;10001;123096;9766;55147;729665;100507650;4792;801;122665;390442;283643;85446;283600;55320;4140;85439;10379;51550;63894;55668;8816;161198;4624;10243;57820;652;79038;4860;122664;56339;9472;643382;51562;646658;79789;64919;54207;161394;123041;97;341947;10598;56967;10901;60485;4990;112487;22795;145581;283598;283578;51062;53981;100128927;8115;5663;27030;2856;6547;57447;4857;6655;26094;122961;4287;123099;4901;64582;6400;23768;64423;390443;6554;10202;7597;161253;115817;26037;390439;145264;112849;7080;22890;23256;84659;79882;64841;51527;253959;79944;112399;57161;387332;440193;64067;283571;3831;56948;2287;140801;2581;55017;6039;115708;6815;641372;56252;9362;145501;122481;3958;5106;9056;122945;11177;5706;122830;122970;1735;9623;5926;440163;4253;91875;23503;81542;56936;145447;26686;122618;6252;5875;122769;145389;26687;26533;57156;8748;122786;11169;145226;23368;145483;23405;22938;328;5411;8106;55632;384;27109;83851;64745,576
1,1,14,20619308,107263478,86644170,1743;338917;1965;79609;8477;171546;5283;91828;90809;27133;51109;1112;5104;9578;207;122953;55644;6038;5836;1053;145482;256281;5890;10972;1397;51016;1734;23428;4293;122876;161291;8892;145567;5700;22985;641371;3429;51528;3169;8906;54331;8487;10572;64806;2290;7187;10876;2530;26175;83982;374569;6617;1113;122651;123016;3002;9369;85457;90141;2999;100529063;10516;9692;55237;60686;55860;122416;5529;93487;23241;317761;9950;327657;283576;79820;9112;8111;90668;9628;81693;341799;114088;55334;866;51241;11161;26257;6729;80017;80821;90135;91833;78990;4707;283;51382;51292;5826;79890;145258;145282;89874;1690;1215;25938;91754;283579;5721;8814;2957;122706;10965;53349;12;90673;22863;107984640;3714;5687;5265;9895;5018;54916;341880;55218;643866;26020;84520;56659;55030;29966;4149;957;4776;55015;4331;5015;80224;6751;9517;25983;23588;55837;9985;5427;388015;493901;116173;57062;161142;122748;51804;1396;319089;55195;599;7517;55701;4625;8110;100528064;1241;23034;2342;5684;64184;3895;161424;623;2103;11035;10668;23351;29954;55072;122553;317749;23224;55333;283638;63874;83544;382;1983;51339;283635;55745;122704;10577;647310;57578;145553;112752;55051;254170;55671;57596;87;79697;23357;29082;6495;3091;6710;79696;6166;8812;122809;11198;9878;55012;10548;55172;10640;5228;57452;2954;26277;23186;9252;64403;57096;122509;400258;9321;338879;11099;9495;84334;3306;9786;55640;376267;64112;5732;84932;81537;84193;4738;9556;7011;57697;8747;26153;56413;23508;55102;57862;400224;51199;55778;4329;8650;647286;6297;55727;89932;51635;9529;5891;64093;29986;122402;4053;10490;5641;64398;23093;80127;1073;91748;113146;123103;25831;58517;57570;79711;122622;10979;10914;51077;5587;123036;30001;3705;54930;387990;84962;10038;253970;22990;58157;51310;26534;5720;2643;8846;91612;145497;10175;7043;84502;2972;4522;394;161357;2100;2079;9240;51156;624;6235;7453;57718;161145;161247;57523;9147;145376;7127;5693;51466;5494;161436;26499;256394;51218;100529261;57544;11183;55038;1033;83694;54813;91750;7528;57475;80757;1511;64207;6035;145407;57143;51222;3320;5267;58533;22846;2009;57680;5729;10278;4247;90050;51004;29933;55812;677;26030;728635;64430;9787;84684;11154;51637;5083;317762;26520;81892;51676;6036;9870;4323;145270;161176;2877;6430;122525;23002;79446;283554;57381;7443;112840;27141;196883;23116;7253;79178;29091;55148;283629;6037;10858;122773;7051;2353;5527;390445;8788;55775;145508;1603;399671;1152;84075;80344;84312;1778;388021;2764;10484;10419;10538;3183;57594;100529257;122616;84439;5583;10001;123096;9766;55147;729665;100507650;4792;801;122665;390442;283643;85446;283600;55320;4140;85439;10379;51550;63894;55668;8816;161198;4624;10243;57820;652;79038;4860;122664;56339;9472;643382;51562;646658;79789;64919;54207;161394;123041;97;341947;10598;56967;10901;60485;4990;112487;22795;145581;283598;283578;51062;53981;100128927;8115;5663;27030;2856;6547;57447;4857;6655;26094;122961;4287;123099;4901;64582;6400;23768;64423;390443;6554;10202;7597;161253;115817;26037;390439;145264;112849;7080;22890;23256;84659;79882;64841;51527;253959;79944;112399;57161;387332;440193;64067;283571;3831;56948;2287;140801;2581;55017;6039;115708;6815;641372;56252;9362;145501;122481;3958;5106;9056;122945;11177;5706;122830;122970;1735;9623;5926;440163;4253;91875;23503;81542;56936;145447;26686;122618;6252;5875;122769;145389;26687;26533;57156;8748;122786;11169;145226;23368;145483;23405;22938;328;5411;8106;55632;384;27109;83851;64745,573
1,-1,14,20691395,20716774,25379,122748;390442,2
1,-1,14,20757405,20886235,128830,10038;7011;57820;91875,4
1,-1,14,20967930,20980067,12137,338879,1
1,-1,14,20967930,20980067,12137,338879,1
1,-1,14,20967930,20980067,12137,338879,1
1,-1,14,20971275,20977156,5881,,0
1,-1,14,20971275,20977156,5881,,0
1,-1,14,20971275,20980067,8792,338879,1
1,-1,14,20971275,20980067,8792,338879,1
1,-1,14,22330761,22996342,665581,,0
-1,-1,14,22322590,22964922,642332,,0
-1,-1,14,22369144,22952425,583281,,0
-1,-1,14,22387418,22980010,592592,,0
1,-1,14,22441988,22980175,538187,,0
1,-1,14,22441988,22980175,538187,,0
1,-1,14,22441988,22980175,538187,,0
1,-1,14,22441988,22980175,538187,,0
1,-1,14,22441988,22980175,538187,,0
1,-1,14,22441988,22996342,554354,,0
1,-1,14,22441988,22897028,455040,,0
-1,-1,14,22441989,22911507,469518,,0
1,-1,14,22468548,22980175,511627,,0
1,-1,14,22468548,22980175,511627,,0
1,-1,14,22468548,22980175,511627,,0
1,-1,14,22468548,22980175,511627,,0
1,-1,14,22468548,22980175,511627,,0
1,-1,14,22468548,22980175,511627,,0
1,-1,14,22468548,22996342,527794,,0
1,-1,14,22468548,23030320,561772,,0
1,-1,14,22489905,22793429,303524,,0
1,-1,14,22598068,22811855,213787,,0
-1,-1,14,22618708,22952425,333717,,0
-1,-1,14,22696964,22964922,267958,,0
-1,-1,14,22696964,22964922,267958,,0
-1,-1,14,22696964,22964922,267958,,0
-1,-1,14,22696964,22964922,267958,,0
-1,-1,14,22696964,22964922,267958,,0
-1,-1,14,22696964,22964922,267958,,0
-1,-1,14,22696964,22964922,267958,,0
1,1,14,23164384,54733411,31569027,30001;54930;6751;25983;79609;84962;171546;23588;55837;253970;9985;5427;85446;116173;55320;51310;5720;10379;319089;5836;84502;1053;394;161357;161198;51016;4624;599;4625;652;23428;100528064;1241;6235;9472;22985;51562;161247;57523;9147;161424;5693;11035;23351;3169;55072;8906;54331;122553;10901;317749;60485;57544;11183;112487;22795;8487;145581;64806;2290;382;51062;54813;283635;2856;122704;1511;4857;6655;145553;3002;58533;4901;2999;254170;100529063;5729;10278;4247;10202;29082;161253;115817;6166;9692;60686;728635;55012;10548;7080;55172;84684;23256;26277;11154;64403;64841;51637;253959;79944;112399;5083;90668;64067;114088;4323;56948;2287;140801;26257;6729;5732;80821;122525;4738;55017;283554;6815;57697;51292;9362;27141;56413;196883;23116;145282;5106;9056;89874;11177;1690;1215;79178;25938;29091;51199;5721;5706;283629;4253;8814;122773;122706;7051;81542;90673;80224;145447;5687;84075;5018;80344;84312;5875;1073;122769;25831;643866;10484;10419;26020;57594;122786;79711;10979;5411;8106;55632;5587;29966;27109;4776;55147;55015;100507650;4792,176
-1,1,14,24233721,31377083,7143362,728635;283629;23351;10548;23256;26277;7051;55072;10901;317749;9985;90668;2290;5720;10379;80344;5875;56948;1511;643866;4857;51016;145553;3002;4901;2999;4738;100528064;1241;79711;51292;9362;29082;27141;56413;115817;196883;5587;55632;29966;5106;161247;4776;57523;161424;1690;1215;11035;29091;5721,50
-1,1,14,24453274,25843700,1390426,728635;283629;23351;10548;26277;7051;55072;317749;9985;90668;5720;10379;80344;5875;56948;1511;643866;51016;145553;3002;4901;2999;4738;100528064;1241;79711;51292;9362;29082;27141;56413;115817;196883;5106;161247;4776;57523;161424;1215;11035;29091;5721,42
-1,-1,14,27068986,28179920,1110934,,0
1,1,14,27174014,33887605,6713591,25831;9472;2290;55632;23256;5587;29966;11154;64067;2856;1690;25938;80224;112487;394,15
-1,1,14,27188661,29723971,2535310,2290,1
-1,-1,14,27799870,27924402,124532,,0
1,-1,14,28224092,28256820,32728,,0
-1,1,14,29273194,33703472,4430278,25831;9472;55632;23256;5587;29966;11154;64067;2856;1690;25938;80224;112487;394,14
-1,1,14,30851760,38181546,7329786,55012;7080;84684;3169;23256;11154;171546;55837;253970;253959;112487;112399;5083;5687;64067;283635;2856;84312;319089;1073;394;25831;26257;6729;58533;9472;55632;29966;51562;145282;9692;89874;11177;1690;25938;80224;4792,37
-1,1,14,31261477,45154334,13892857,4253;55012;7080;6751;84684;3169;11154;171546;122553;55837;253970;253959;112487;112399;5083;8487;145581;5687;64067;283635;84075;2856;84312;319089;1073;394;25831;26257;161198;6729;10484;58533;254170;9472;5411;29966;51562;145282;9692;89874;11177;1690;25938;80224;4792,45
-1,1,14,34049147,49348823,15299676,4253;55012;7080;6751;84684;3169;171546;122553;55837;253970;253959;112399;5083;8487;145581;55320;5687;54813;64067;283635;84075;319089;84312;1073;2287;140801;26257;161198;6729;161357;10484;58533;122525;254170;57697;5411;51562;23116;145282;9692;89874;55015;11177;4792,44
-1,1,14,34349618,42828688,8479070,4253;55012;7080;6751;84684;3169;171546;122553;55837;253970;253959;112399;5083;8487;145581;5687;283635;319089;84312;1073;26257;161198;6729;10484;58533;254170;5411;51562;145282;9692;89874;11177;4792,33
-1,-1,14,34680977,34797265,116288,,0
-1,1,14,35537482,44463980,8926498,4253;26257;161198;55012;7080;6751;10484;84684;3169;122553;254170;253970;253959;5083;8487;145581;5411;5687;51562;283635;145282;9692;89874;319089;84312;4792,26
-1,-1,14,35579022,35620232,41210,9692;55012,2
-1,1,14,35850213,40138562,4288349,4253;26257;161198;7080;6751;10484;84684;3169;122553;254170;253970;253959;5083;8487;5411;51562;145282;89874;319089;84312;4792,21
-1,1,14,35983284,37283221,1299937,26257;7080;84684;51562;89874;84312;253970;253959;5083,9
1,1,14,36660917,37697705,1036788,26257;89874;7080;253970;51562;5083;145282,7
-1,-1,14,36747497,36787893,40396,51562,1
-1,1,14,37002653,37810624,807971,26257;89874;5083;145282,4
-1,-1,14,40436124,40591751,155627,,0
-1,-1,14,40733870,40890943,157073,,0
-1,-1,14,40733870,40890943,157073,,0
-1,-1,14,40859536,40960013,100477,,0
-1,-1,14,40960013,41634431,674418,,0
-1,-1,14,41018728,41234652,215924,,0
1,-1,14,43856486,44223814,367328,,0
1,-1,14,43856486,44223814,367328,,0
1,-1,14,43856486,44223814,367328,,0
1,-1,14,43856486,44223814,367328,,0
1,-1,14,43856486,44223814,367328,,0
1,-1,14,43856486,44223814,367328,,0
1,-1,14,43856486,44223814,367328,,0
1,-1,14,43856486,44623069,766583,,0
-1,-1,14,44973489,45393462,419973,84075;122525,2
-1,-1,14,45821442,45979670,158228,,0
-1,-1,14,45821442,45979670,158228,,0
-1,-1,14,45821442,45979729,158287,,0
-1,-1,14,48786773,48891586,104813,,0
-1,-1,14,48786773,48906286,119513,,0
-1,-1,14,48786773,48906286,119513,,0
-1,-1,14,48786773,48906286,119513,,0
-1,1,14,52011564,55787316,3775752,30001;10668;93487;9787;5732;80821;54331;652;64841;51637;23034;122786;57544;283554;11169;5729;6815;22795;1033;10979;55030;3958;122809;2643;5706;10175;2764,27
-1,1,14,53820659,55003253,1182594,10668;652;1033;10175;2764,5
1,-1,14,56568535,56819234,250699,57161,1
-1,1,14,58120131,64560246,6440115,112849;64430;51528;317761;387990;51635;27133;5494;23224;4990;51804;51339;26520;6252;9786;341880;145407;6617;145389;81537;23002;64582;57570;122876;5583;161291;5684;57381;112840;6495;3091;4331;729665;83851;5926;55860;5529,37
-1,1,14,59073273,61983038,2909765,112849;145389;64430;51528;317761;23002;64582;51635;57570;4990;5583;161291;51804;51339;6495;4331;729665;6252;5494,19
1,1,14,62493932,107285437,44791505,1743;3705;338917;1965;8477;5283;91828;27133;51109;1112;5104;9578;207;22990;58157;122953;8846;91612;145497;7043;2972;4522;145482;256281;5890;2100;10972;1397;1734;2079;9240;51156;624;4293;122876;8892;7453;145567;57718;5700;161145;641371;145376;7127;51466;3429;161436;26499;256394;51218;100529261;55038;10572;83694;91750;7187;7528;2530;57475;26175;83982;374569;80757;64207;57143;3320;1113;123016;5267;9369;22846;85457;2009;90141;90050;10516;51004;29933;55812;55237;677;26030;5529;122416;23241;9950;327657;283576;79820;9112;8111;9628;317762;81693;81892;51676;55334;866;51241;9870;11161;145270;161176;2877;80017;6430;90135;79446;91833;78990;4707;51382;57381;5826;7443;112840;79890;145258;7253;91754;283579;55148;10858;2957;10965;2353;5527;53349;12;8788;107984640;3714;55775;145508;399671;5265;9895;1152;1778;388021;55218;10538;100529257;122616;84520;84439;56659;10001;123096;9766;4149;957;801;9517;283643;388015;283600;57062;161142;4140;1396;85439;51550;63894;55668;8816;10243;7517;8110;79038;2342;646658;79789;623;2103;64919;54207;161394;123041;29954;97;341947;10598;56967;23224;55333;283598;283578;283638;83544;53981;1983;100128927;8115;5663;27030;6547;10577;647310;57578;26094;122961;4287;123099;112752;55051;6400;23768;64423;6554;55671;57596;7597;87;79697;23357;26037;6710;79696;8812;145264;5228;22890;57452;2954;23186;9252;79882;122509;51527;400258;9321;11099;440193;9495;283571;3831;84334;3306;55640;376267;64112;2581;81537;84193;9556;115708;641372;56252;8747;145501;26153;122481;23508;55102;122945;57862;400224;55778;4329;122970;1735;9623;8650;647286;23503;55727;89932;9529;5891;64093;122402;56936;4053;10490;5641;64398;23093;80127;122618;113146;91748;57156;8748;58517;145226;23368;145483;23405;122622;22938;10914;51077;384;123036;83851,296
-1,1,14,62719418,66220134,3500716,2100;2877;376267;22890;81537;27133;100529261;23224;122876;26030;2342;57381;7597;112840;4149;9495;6710;3306;2530;145376;91612;4522;5529,23
1,-1,14,63779634,63849018,69384,122876;5529,2
-1,1,14,70028816,82441728,12412912,1743;338917;9517;5228;2954;283576;22990;58157;9628;122953;81892;85439;283571;8846;51241;63894;145497;9870;7043;55668;11161;145482;55640;10972;1734;6430;9240;8110;4293;8892;641372;5826;56252;8747;145501;23508;7253;641371;646658;122945;57862;2103;91754;283579;4329;122970;8650;161394;29954;2957;97;10965;2353;10598;89932;64093;53349;56936;55333;145508;283578;4053;399671;83544;83694;91750;5663;27030;23093;80127;6547;91748;64207;10577;57143;10538;26094;122961;22846;85457;9369;112752;57156;6400;8748;100529257;58517;6554;145483;10001;22938;79697;23357;9766;51077;26037;51004;957;79696;55237,100
1,-1,14,72638897,72665618,26721,9628,1
1,1,14,73750741,107285437,33534696,1743;801;338917;3705;9517;8477;283643;91828;5104;1112;9578;207;388015;58157;283600;57062;4140;1396;122953;85439;51550;8846;63894;145497;7043;55668;2972;145482;256281;10972;1397;1734;9240;7517;51156;624;79038;8892;7453;145567;57718;5700;641371;646658;79789;7127;623;2103;51466;3429;161436;64919;54207;161394;123041;29954;97;256394;341947;51218;10598;56967;55038;10572;283598;283578;283638;83544;83694;53981;1983;91750;27030;8115;7187;7528;100128927;26175;83982;374569;80757;64207;10577;57143;647310;3320;1113;57578;123016;5267;9369;122961;22846;85457;90141;112752;55051;6400;23768;4287;2009;123099;64423;55671;57596;90050;79697;23357;10516;51004;29933;55812;8812;79696;145264;55237;122416;23241;5228;9950;2954;23186;327657;283576;9252;79882;122509;51527;400258;79820;9321;11099;9112;8111;317762;81693;440193;81892;51676;283571;3831;84334;866;9870;11161;145270;55640;161176;80017;64112;2581;84193;90135;79446;91833;78990;4707;9556;115708;641372;5826;56252;7443;145501;79890;26153;122481;145258;7253;55102;122945;57862;91754;283579;55778;4329;122970;1735;9623;8650;55148;647286;10858;2957;10965;2353;55727;5527;9529;5891;12;8788;107984640;122402;3714;55775;145508;4053;399671;5265;5641;9895;1152;23093;80127;122618;1778;113146;91748;388021;10538;57156;122616;84520;84439;56659;23368;145483;23405;123096;22938;122622;10914;51077;957;123036,226
-1,-1,14,74004581,74040262,35681,641371;399671;10965,3
-1,-1,14,74008382,74042276,33894,641371;399671;10965,3
1,1,14,74122475,107287505,33165030,1743;801;338917;3705;9517;8477;283643;91828;5104;1112;9578;207;388015;58157;283600;57062;4140;1396;122953;85439;51550;8846;63894;145497;7043;55668;2972;145482;256281;10972;1397;1734;9240;7517;51156;624;79038;8892;7453;145567;57718;5700;646658;79789;7127;623;2103;51466;3429;161436;64919;54207;161394;123041;29954;97;256394;341947;51218;10598;56967;55038;10572;283598;283578;283638;83544;53981;83694;1983;100128927;91750;27030;8115;7187;7528;26175;83982;374569;80757;64207;10577;57143;647310;3320;1113;57578;123016;5267;9369;122961;22846;85457;90141;112752;55051;6400;23768;4287;2009;123099;64423;55671;57596;90050;23357;10516;51004;29933;55812;8812;79696;145264;55237;122416;23241;5228;9950;2954;23186;327657;283576;9252;79882;122509;51527;400258;79820;9321;11099;9112;8111;317762;81693;440193;81892;51676;283571;3831;84334;866;9870;11161;145270;55640;161176;80017;64112;2581;84193;90135;79446;91833;78990;4707;9556;115708;56252;5826;7443;145501;79890;26153;122481;145258;7253;55102;122945;57862;91754;283579;55778;4329;1735;9623;55148;647286;10858;2957;2353;55727;5527;9529;5891;12;8788;107984640;122402;3714;55775;145508;4053;5265;5641;9895;1152;23093;80127;122618;1778;113146;91748;388021;10538;57156;122616;84520;84439;56659;23368;145483;23405;123096;22938;122622;10914;51077;957;123036,219
1,1,14,77689138,107287505,29598367,801;3705;9517;8477;283643;91828;5104;1112;9578;207;388015;58157;283600;57062;4140;1396;85439;51550;8846;63894;2972;256281;1397;1734;7517;51156;624;79038;7453;145567;57718;5700;79789;7127;623;51466;3429;161436;64919;54207;161394;123041;29954;256394;341947;51218;10598;56967;55038;10572;283598;283578;283638;53981;1983;100128927;8115;7187;7528;26175;83982;374569;80757;57143;647310;3320;1113;57578;123016;5267;9369;4287;2009;90141;123099;55051;6400;23768;64423;55671;57596;90050;10516;29933;55812;8812;145264;122416;23241;9950;2954;23186;327657;9252;79882;122509;51527;400258;79820;9321;11099;9112;8111;317762;81693;440193;81892;51676;3831;84334;866;145270;161176;80017;64112;2581;84193;90135;79446;91833;78990;4707;9556;115708;7443;145501;79890;26153;122481;145258;7253;55102;122945;55778;283579;1735;9623;55148;647286;10858;2957;55727;5527;9529;5891;12;8788;107984640;122402;3714;55775;145508;5265;5641;9895;1152;122618;1778;113146;388021;57156;122616;84520;84439;56659;23368;23405;123096;22938;122622;10914;123036,172
1,-1,14,78146198,78205077,58879,22938;8846;81892,3
1,-1,14,78146198,78205077,58879,22938;8846;81892,3
1,-1,14,78146198,78205077,58879,22938;8846;81892,3
-1,-1,14,80674955,80736720,61765,1734,1
1,1,14,93007328,105329995,12322667,3705;9950;23186;327657;122509;91828;5104;9578;207;51527;400258;388015;283600;317762;81693;57062;4140;51676;3831;51550;84334;866;145270;161176;64112;7517;84193;79446;51156;624;79038;91833;78990;9556;115708;7453;7443;57718;26153;79890;122481;145258;79789;55102;7127;623;51466;55778;3429;1735;64919;9623;55148;647286;10858;256394;341947;51218;55727;56967;5527;9529;5891;12;8788;107984640;122402;10572;283598;1983;5265;100128927;8115;7187;5641;9895;7528;1152;26175;83982;374569;1778;388021;3320;1113;57578;5267;2009;123099;84520;64423;84439;57596;90050;23368;23405;123096;122622;10914;8812;145264;122416,102
1,1,14,93331784,107289540,13957756,3705;23241;23186;327657;283643;122509;91828;5104;9578;207;51527;400258;388015;9112;283600;317762;81693;57062;4140;1396;51676;3831;51550;84334;866;2972;256281;145270;161176;1397;64112;7517;84193;90135;51156;624;79038;79446;91833;78990;9556;115708;7453;7443;57718;26153;122481;145258;79789;55102;7127;623;51466;55778;3429;1735;64919;9623;55148;647286;10858;256394;341947;51218;55727;56967;5527;9529;55038;5891;12;8788;107984640;122402;3714;10572;283598;283638;1983;5265;100128927;8115;7187;9895;1152;7528;122618;26175;83982;374569;80757;1778;113146;388021;647310;3320;1113;57578;5267;2009;123099;122616;84520;64423;84439;57596;90050;23368;23405;123096;122622;10914;29933;8812;145264;122416,116
-1,1,14,95990744,107287708,11296964,23241;23186;283643;91828;9578;207;51527;400258;388015;9112;283600;317762;81693;4140;1396;3831;51550;84334;2972;256281;1397;7517;84193;90135;79446;624;79038;91833;9556;115708;7453;7443;26153;122481;55102;7127;623;51466;55778;1735;64919;9623;647286;10858;51218;5527;56967;9529;55038;5891;8788;107984640;122402;3714;10572;283598;283638;1983;100128927;8115;7187;9895;1152;7528;122618;80757;1778;374569;113146;388021;647310;3320;2009;123099;122616;64423;84439;57596;23368;123096;122622;10914;29933;8812;122416,85
-1,1,14,95990744,107287708,11296964,23241;23186;283643;91828;9578;207;51527;400258;388015;9112;283600;317762;81693;4140;1396;3831;51550;84334;2972;256281;1397;7517;84193;90135;79446;624;79038;91833;9556;115708;7453;7443;26153;122481;55102;7127;623;51466;55778;1735;64919;9623;647286;10858;51218;5527;56967;9529;55038;5891;8788;107984640;122402;3714;10572;283598;283638;1983;100128927;8115;7187;9895;1152;7528;122618;80757;1778;374569;113146;388021;647310;3320;2009;123099;122616;64423;84439;57596;23368;123096;122622;10914;29933;8812;122416,85
1,1,14,98104857,107263478,9158621,23241;23186;283643;91828;9578;400258;207;388015;9112;317762;283600;81693;4140;1396;3831;51550;84334;2972;256281;1397;84193;7517;79446;91833;90135;79038;9556;115708;7453;26153;7127;55778;51466;1735;64919;647286;10858;5527;9529;5891;55038;8788;107984640;122402;3714;10572;283598;283638;1983;100128927;7187;9895;1152;7528;122618;80757;1778;374569;388021;113146;647310;3320;2009;123099;122616;84439;64423;57596;23368;123096;122622;29933;8812;122416,74
-1,-1,14,99178605,99183596,4991,283598,1
1,1,14,99914349,107258824,7344475,23241;23186;283643;91828;9578;400258;207;388015;9112;317762;283600;81693;4140;1396;3831;51550;84334;2972;256281;1397;84193;7517;79446;91833;90135;79038;9556;115708;7453;26153;7127;55778;51466;1735;647286;10858;5527;9529;5891;55038;8788;107984640;122402;3714;10572;283638;1983;100128927;7187;9895;1152;7528;122618;80757;1778;374569;388021;113146;647310;3320;2009;123099;122616;84439;64423;57596;23368;123096;122622;29933;8812;122416,72
-1,1,14,100260674,101410904,1150230,123096;283600;2009;7528;123099;79446;51466;388015;57596;8788;7453,11
-1,1,14,100297992,107263478,6965486,23241;23186;283643;91828;9578;400258;207;388015;9112;283600;81693;4140;1396;3831;51550;84334;2972;256281;1397;7517;90135;79446;91833;79038;9556;115708;7453;26153;7127;51466;55778;1735;647286;5527;9529;5891;55038;8788;107984640;122402;3714;10572;283638;1983;100128927;7187;9895;1152;7528;122618;80757;1778;374569;388021;113146;647310;3320;2009;123099;122616;64423;57596;23368;123096;122622;29933;122416,67
-1,1,14,100397006,101488936,1091930,123096;283600;2009;7528;123099;79446;51466;388015;57596;8788;7453,11
-1,1,14,100661319,107285437,6624118,23241;23186;283643;91828;9578;400258;207;388015;9112;283600;81693;4140;1396;3831;51550;84334;2972;256281;1397;7517;90135;79446;91833;79038;9556;115708;7453;26153;7127;55778;1735;647286;5527;9529;5891;55038;8788;107984640;122402;3714;10572;283638;1983;100128927;7187;9895;1152;7528;122618;80757;1778;374569;388021;113146;647310;3320;122616;64423;57596;23368;123096;122622;29933;122416,64
-1,1,14,100729173,102967034,2237861,3320;79446;5527;91833;5891;388015;57596;8788;7453;123096;283600;9895;7528;51550;1778;55778;1735,17
1,1,14,100775719,106453697,5677978,647286;23241;23186;283643;5527;91828;9578;9529;400258;5891;207;55038;388015;8788;9112;107984640;283600;122402;81693;10572;283638;3714;1983;4140;100128927;1396;7187;9895;1152;3831;51550;84334;122618;80757;1778;374569;388021;113146;2972;256281;647310;3320;1397;7517;90135;79446;91833;79038;122616;9556;64423;115708;57596;23368;7453;122622;26153;29933;7127;55778;1735;122416,62
-1,1,14,101048396,107285437,6237041,647286;23241;23186;283643;5527;91828;9578;9529;400258;5891;207;55038;388015;8788;9112;107984640;122402;3714;81693;10572;283638;1983;4140;100128927;1396;7187;9895;1152;3831;51550;84334;122618;80757;1778;374569;388021;113146;2972;256281;647310;3320;1397;7517;90135;91833;79038;122616;9556;64423;115708;23368;122622;26153;29933;7127;55778;1735;122416,58
-1,1,14,102131939,107263478,5131539,647286;23241;23186;283643;5527;91828;9578;9529;400258;5891;207;55038;9112;107984640;122402;3714;81693;10572;283638;1983;4140;100128927;1396;7187;9895;1152;3831;51550;84334;122618;80757;1778;374569;388021;113146;2972;256281;647310;3320;1397;7517;90135;91833;79038;122616;9556;64423;115708;23368;122622;26153;29933;7127;55778;122416,55
-1,1,14,102392007,107284531,4892524,647286;23241;23186;283643;5527;91828;9578;9529;400258;5891;207;55038;9112;107984640;122402;3714;81693;10572;283638;1983;4140;100128927;1396;7187;9895;1152;3831;51550;84334;122618;80757;1778;374569;388021;113146;2972;256281;647310;3320;1397;7517;90135;91833;79038;122616;9556;64423;115708;23368;122622;26153;29933;7127;55778;122416,55
-1,1,14,102670706,107285437,4614731,647286;23241;23186;283643;91828;9578;9529;400258;5891;207;55038;9112;107984640;122402;3714;81693;10572;283638;1983;4140;100128927;1396;7187;9895;1152;3831;51550;84334;122618;80757;374569;388021;113146;2972;256281;647310;1397;7517;90135;91833;79038;122616;9556;64423;115708;23368;122622;26153;29933;7127;55778;122416,52
-1,1,14,102705759,107285437,4579678,647286;23241;23186;283643;91828;9578;9529;400258;5891;207;55038;9112;107984640;122402;3714;81693;10572;283638;1983;4140;100128927;1396;7187;9895;1152;3831;51550;84334;122618;80757;374569;388021;113146;2972;256281;647310;1397;7517;90135;79038;122616;9556;64423;115708;23368;122622;26153;29933;7127;55778;122416,51
-1,1,14,103071433,107287505,4216072,647286;23241;23186;283643;91828;9578;9529;400258;207;55038;9112;122402;107984640;3714;81693;10572;283638;1983;4140;100128927;1396;7187;1152;3831;84334;122618;80757;374569;388021;113146;2972;256281;647310;1397;7517;90135;79038;122616;9556;64423;115708;23368;122622;26153;29933;7127,46
-1,1,14,103153637,107285437,4131800,647286;23241;23186;283643;91828;9578;9529;400258;207;55038;9112;122402;107984640;3714;81693;10572;283638;1983;4140;100128927;1396;7187;1152;3831;84334;122618;80757;374569;388021;113146;2972;256281;647310;1397;7517;90135;79038;122616;9556;64423;115708;23368;122622;26153;29933;7127,46
-1,1,14,103390060,104436909,1046849,647286;7517;91828;79038;9578;9529;9556;115708;23368;122402;107984640;81693;1983;4140;1152;3831;84334;7127,18
-1,1,14,103711336,107285437,3574101,647286;23241;283643;9529;400258;207;55038;9112;122402;3714;10572;283638;4140;1983;100128927;1396;1152;3831;84334;122618;80757;374569;388021;113146;2972;256281;647310;1397;7517;90135;79038;122616;9556;64423;115708;23368;122622;26153;29933,39
1,1,14,103788751,107263478,3474727,647286;23241;283643;9529;400258;207;55038;9112;122402;3714;10572;283638;4140;1983;100128927;1396;1152;3831;84334;122618;80757;374569;388021;113146;2972;256281;647310;1397;7517;90135;79038;122616;9556;64423;115708;23368;122622;26153;29933,39
-1,1,14,103965059,107285437,3320378,647286;23241;283643;9529;400258;207;55038;9112;122402;3714;10572;283638;4140;100128927;1396;1152;3831;84334;122618;80757;374569;388021;113146;2972;256281;647310;1397;7517;90135;79038;122616;9556;64423;115708;23368;122622;26153;29933,38
-1,1,14,104289937,107287505,2997568,647310;647286;23241;1397;283643;90135;122616;207;400258;9556;55038;374569;64423;9112;23368;122402;122622;3714;10572;283638;26153;100128927;1396;29933;122618;80757;113146;388021;2972;256281,30
-1,1,14,104517595,107285437,2767842,647310;23241;1397;283643;90135;122616;207;400258;64423;55038;374569;9112;122402;122622;3714;10572;283638;26153;100128927;1396;29933;122618;80757;113146;388021;2972;256281,27
1,-1,14,104804779,104913869,109090,,0
-1,1,14,104915608,107285437,2369829,647310;23241;1397;283643;90135;122616;207;400258;64423;55038;9112;122622;3714;10572;283638;100128927;1396;29933;122618;80757;113146;388021;2972;256281,24
1,-1,14,105047592,105081292,33700,388021;400258,2
-1,1,14,105489733,107258965,1769232,647310;3714;23241;1397;1396;29933;90135;283643;80757;2972;9112;256281,12
1,-1,14,105929852,105996549,66697,1397;80757;1396;9112;283643,5
1,-1,14,105937585,105957346,19761,1396;1397;283643,3
1,-1,14,105937585,105957346,19761,1396;1397;283643,3
1,-1,14,105957346,105996549,39203,80757;283643,2
1,-1,14,105957346,105996549,39203,80757;283643,2
-1,-1,14,106072662,106209522,136860,,0
1,1,14,106252705,107263478,1010773,,0
1,1,14,106252705,107263478,1010773,,0
1,1,14,106252705,107263478,1010773,,0
-1,1,14,106252705,107287505,1034800,,0
-1,-1,14,106252705,107287708,1035003,,0
1,-1,14,106361449,107124613,763164,,0
-1,-1,14,106453638,106774672,321034,,0
-1,-1,14,106572867,106923671,350804,,0
-1,-1,14,106572867,106923671,350804,,0
1,-1,14,106572867,107145709,572842,,0
1,-1,14,106512914,106923671,410757,,0
-1,-1,14,106538421,106774672,236251,,0
1,-1,14,106538421,106852173,313752,,0
1,-1,14,106538421,107169357,630936,,0
1,-1,14,106538451,106572278,33827,,0
-1,-1,14,106539719,106559073,19354,,0
1,-1,14,106539719,106559073,19354,,0
1,-1,14,106539719,106559073,19354,,0
1,-1,14,106539719,106559073,19354,,0
-1,-1,14,106539719,106572277,32558,,0
-1,-1,14,106539719,106572277,32558,,0
1,-1,14,106574892,106923823,348931,,0
-1,-1,14,106602112,106803289,201177,,0
-1,-1,14,106602112,106803289,201177,,0
-1,-1,14,106602112,106803289,201177,,0
-1,-1,14,106664991,106852183,187192,,0
-1,-1,14,106664991,106923671,258680,,0
1,-1,14,106664991,107182651,517660,,0
1,-1,14,106716345,107124579,408234,,0
1,-1,14,106786177,106810256,24079,,0
-1,-1,14,106786177,106810256,24079,,0
-1,-1,14,106786177,106810256,24079,,0
1,-1,14,106831508,107089193,257685,,0
1,-1,14,106852114,107169357,317243,,0
1,-1,14,106852124,107089193,237069,,0
-1,-1,14,106906709,106931163,24454,,0
-1,-1,14,106906709,106931163,24454,,0
1,-1,14,106906901,107169357,262456,,0
1,-1,14,106906901,107169357,262456,,0
1,-1,14,106906901,107169357,262456,,0
1,-1,14,106906901,107169357,262456,,0
1,-1,14,106906901,107169357,262456,,0
1,-1,14,106906901,107169357,262456,,0
1,-1,14,106923612,107021833,98221,,0
1,-1,14,106923612,107109083,185471,,0
1,-1,14,106923612,107182651,259039,,0
1,-1,14,106923612,107182651,259039,,0
1,-1,14,106923612,107182651,259039,,0
1,-1,14,106923612,107182651,259039,,0
1,-1,14,106923612,107182651,259039,,0
1,-1,14,106957881,107182651,224770,,0
1,-1,14,107070359,107169498,99139,,0
1,-1,14,107070559,107169357,98798,,0
1,-1,14,107070559,107169357,98798,,0
1,-1,14,107070559,107169357,98798,,0
1,-1,14,107070559,107169357,98798,,0
-1,-1,14,107070604,107109083,38479,,0
1,-1,14,107079944,107145709,65765,,0
-1,-1,14,107079944,107152026,72082,,0
-1,-1,14,107080001,107134861,54860,,0
-1,-1,14,107080001,107134861,54860,,0
-1,-1,14,107134790,107182651,47861,,0
1,-1,14,107141076,107182651,41575,,0
1,-1,14,107141076,107182651,41575,,0
1,-1,14,107141076,107182651,41575,,0
1,-1,14,107141076,107182651,41575,,0
1,-1,14,107141076,107182651,41575,,0
1,-1,14,107141076,107182651,41575,,0
1,-1,14,107141076,107182651,41575,,0
1,-1,14,107145650,107182651,37001,,0
1,-1,14,107145650,107182651,37001,,0
1,-1,14,107145650,107182651,37001,,0
1,-1,14,107145650,107182651,37001,,0
1,-1,14,107145650,107182651,37001,,0
1,-1,14,107145650,107182651,37001,,0
1,-1,14,107145650,107182651,37001,,0
1,-1,14,107145650,107182651,37001,,0
1,-1,14,107145650,107182651,37001,,0
1,-1,14,107145650,107182651,37001,,0
1,-1,14,107145650,107189879,44229,,0
-1,-1,14,107148712,107168761,20049,,0
-1,-1,14,107148712,107168761,20049,,0
-1,-1,14,107148712,107168761,20049,,0
-1,-1,14,107148712,107168761,20049,,0
-1,-1,14,107148712,107168761,20049,,0
-1,-1,14,107148712,107175214,26502,,0
-1,-1,14,107148712,107180121,31409,,0
-1,-1,14,107148712,107180121,31409,,0
-1,-1,14,107148712,107180121,31409,,0
-1,-1,14,107148712,107180121,31409,,0
-1,-1,14,107148712,107180121,31409,,0
-1,-1,14,107148712,107180121,31409,,0
-1,-1,14,107148712,107180121,31409,,0
1,-1,14,107148712,107180121,31409,,0
1,-1,14,107148712,107180121,31409,,0
1,-1,14,107148712,107180121,31409,,0
-1,-1,14,107148712,107180121,31409,,0
-1,-1,14,107148712,107180121,31409,,0
1,-1,14,107148712,107180121,31409,,0
-1,-1,14,107148712,107180121,31409,,0
-1,-1,14,107148712,107182649,33937,,0
1,-1,14,107148712,107182651,33939,,0
1,-1,14,107148712,107182651,33939,,0
1,-1,14,107148712,107182651,33939,,0
1,-1,14,107148712,107182651,33939,,0
1,-1,14,107148712,107182651,33939,,0
1,-1,14,107148712,107182651,33939,,0
1,-1,14,107148712,107182651,33939,,0
-1,-1,14,107148712,107182651,33939,,0
-1,-1,14,107148712,107182651,33939,,0
1,-1,14,107148712,107182651,33939,,0
1,-1,14,107148712,107182651,33939,,0
1,-1,14,107148712,107182651,33939,,0
-1,-1,14,107148712,107182651,33939,,0
-1,-1,14,107148712,107182651,33939,,0
1,-1,14,107148712,107182651,33939,,0
-1,-1,14,107148712,107182651,33939,,0
1,-1,14,107148712,107182651,33939,,0
1,-1,14,107148712,107182651,33939,,0
-1,-1,14,107148712,107182651,33939,,0
1,-1,14,107148712,107182651,33939,,0
1,-1,14,107148712,107182651,33939,,0
1,-1,14,107148712,107182651,33939,,0
1,-1,14,107148712,107182651,33939,,0
-1,-1,14,107148712,107182651,33939,,0
1,-1,14,107148712,107182651,33939,,0
1,-1,14,107148712,107182651,33939,,0
1,-1,14,107148712,107182651,33939,,0
1,-1,14,107148712,107182651,33939,,0
1,-1,14,107148712,107182651,33939,,0
1,-1,14,107148712,107182651,33939,,0
1,-1,14,107148712,107182651,33939,,0
1,-1,14,107148712,107182651,33939,,0
1,-1,14,107148712,107182651,33939,,0
1,-1,14,107148712,107182651,33939,,0
1,-1,14,107148712,107182651,33939,,0
1,-1,14,107148712,107182651,33939,,0
1,-1,14,107148712,107182651,33939,,0
1,-1,14,107148712,107182651,33939,,0
-1,-1,14,107148712,107182651,33939,,0
1,-1,14,107148712,107182651,33939,,0
1,-1,14,107148712,107182651,33939,,0
1,-1,14,107148712,107182651,33939,,0
1,-1,14,107148712,107182651,33939,,0
1,-1,14,107148712,107182651,33939,,0
1,-1,14,107148712,107182651,33939,,0
1,-1,14,107148712,107182651,33939,,0
1,-1,14,107148712,107182651,33939,,0
1,-1,14,107148712,107182651,33939,,0
1,-1,14,107148712,107182651,33939,,0
1,-1,14,107148712,107182651,33939,,0
1,-1,14,107148712,107182651,33939,,0
1,-1,14,107148712,107182651,33939,,0
1,-1,14,107148712,107182651,33939,,0
1,-1,14,107148712,107182651,33939,,0
1,-1,14,107148712,107182651,33939,,0
1,-1,14,107148712,107182651,33939,,0
1,-1,14,107148712,107182651,33939,,0
-1,-1,14,107148712,107182651,33939,,0
-1,-1,14,107148712,107182651,33939,,0
1,-1,14,107148712,107182651,33939,,0
1,-1,14,107148712,107182651,33939,,0
1,-1,14,107148712,107182651,33939,,0
1,-1,14,107148712,107182651,33939,,0
1,-1,14,107148712,107182651,33939,,0
1,-1,14,107148712,107182651,33939,,0
1,-1,14,107148712,107182651,33939,,0
1,-1,14,107148712,107182651,33939,,0
1,-1,14,107148712,107182651,33939,,0
1,-1,14,107148712,107182651,33939,,0
1,-1,14,107148712,107182651,33939,,0
1,-1,14,107148712,107182651,33939,,0
-1,-1,14,107148712,107182651,33939,,0
1,-1,14,107148712,107182651,33939,,0
1,-1,14,107148712,107182651,33939,,0
1,-1,14,107148712,107182651,33939,,0
1,-1,14,107148712,107182651,33939,,0
1,-1,14,107148712,107182651,33939,,0
1,-1,14,107148712,107182651,33939,,0
1,-1,14,107148712,107182651,33939,,0
1,-1,14,107148712,107182651,33939,,0
-1,-1,14,107148712,107182651,33939,,0
1,-1,14,107148712,107182651,33939,,0
1,-1,14,107148712,107182651,33939,,0
1,-1,14,107148712,107182651,33939,,0
1,-1,14,107148712,107182651,33939,,0
1,-1,14,107148712,107182651,33939,,0
1,-1,14,107148712,107182651,33939,,0
1,-1,14,107148712,107182651,33939,,0
1,-1,14,107148712,107182651,33939,,0
1,-1,14,107148712,107182651,33939,,0
1,-1,14,107148712,107182651,33939,,0
1,-1,14,107148712,107182651,33939,,0
1,-1,14,107148712,107182651,33939,,0
1,-1,14,107148712,107182651,33939,,0
1,-1,14,107148712,107182651,33939,,0
1,-1,14,107148712,107182651,33939,,0
1,-1,14,107148712,107182651,33939,,0
1,-1,14,107148712,107182651,33939,,0
-1,-1,14,107148712,107182651,33939,,0
1,-1,14,107148712,107182651,33939,,0
1,-1,14,107148712,107182651,33939,,0
1,-1,14,107148712,107182651,33939,,0
-1,-1,14,107148712,107182651,33939,,0
1,-1,14,107148712,107182651,33939,,0
1,-1,14,107148712,107182651,33939,,0
1,-1,14,107148712,107182651,33939,,0
1,-1,14,107148712,107182651,33939,,0
1,-1,14,107148712,107182651,33939,,0
1,-1,14,107148712,107182651,33939,,0
1,-1,14,107148712,107182651,33939,,0
-1,-1,14,107148712,107182651,33939,,0
1,-1,14,107148712,107182651,33939,,0
1,-1,14,107148712,107182651,33939,,0
-1,-1,14,107148712,107182651,33939,,0
-1,-1,14,107148712,107182651,33939,,0
1,-1,14,107148712,107182651,33939,,0
-1,-1,14,107148712,107182651,33939,,0
-1,-1,14,107148712,107182651,33939,,0
1,-1,14,107148712,107182651,33939,,0
1,-1,14,107148712,107182651,33939,,0
-1,-1,14,107148712,107182651,33939,,0
1,-1,14,107148712,107182651,33939,,0
1,-1,14,107148712,107182651,33939,,0
1,-1,14,107148712,107182651,33939,,0
1,-1,14,107148712,107182651,33939,,0
-1,-1,14,107148712,107182651,33939,,0
1,-1,14,107148712,107182651,33939,,0
-1,-1,14,107148712,107182651,33939,,0
-1,-1,14,107148712,107182651,33939,,0
-1,-1,14,107148712,107182651,33939,,0
1,-1,14,107148712,107182651,33939,,0
1,-1,14,107148712,107182651,33939,,0
1,-1,14,107148712,107182651,33939,,0
1,-1,14,107148712,107182651,33939,,0
-1,-1,14,107148712,107182651,33939,,0
-1,-1,14,107148712,107182651,33939,,0
1,-1,14,107148712,107182651,33939,,0
-1,-1,14,107148712,107182651,33939,,0
-1,-1,14,107148712,107182651,33939,,0
-1,-1,14,107148712,107182651,33939,,0
1,-1,14,107148712,107182651,33939,,0
-1,-1,14,107148712,107182651,33939,,0
-1,-1,14,107148712,107182651,33939,,0
1,-1,14,107148712,107182651,33939,,0
1,-1,14,107148712,107182651,33939,,0
1,-1,14,107148712,107182651,33939,,0
1,-1,14,107148712,107182651,33939,,0
1,-1,14,107148712,107182651,33939,,0
-1,-1,14,107148712,107182651,33939,,0
1,-1,14,107148712,107182651,33939,,0
-1,-1,14,107148712,107182651,33939,,0
1,-1,14,107148712,107182651,33939,,0
-1,-1,14,107148712,107182651,33939,,0
1,-1,14,107148712,107182651,33939,,0
1,-1,14,107148712,107182651,33939,,0
-1,-1,14,107148712,107182651,33939,,0
1,-1,14,107148712,107182651,33939,,0
-1,-1,14,107148712,107182651,33939,,0
1,-1,14,107148712,107182651,33939,,0
1,-1,14,107148712,107182651,33939,,0
1,-1,14,107148712,107182651,33939,,0
-1,-1,14,107148712,107182651,33939,,0
1,-1,14,107148712,107182651,33939,,0
1,-1,14,107148712,107182651,33939,,0
1,-1,14,107148712,107182651,33939,,0
-1,-1,14,107148712,107182651,33939,,0
-1,-1,14,107148712,107182651,33939,,0
-1,-1,14,107148712,107182651,33939,,0
-1,-1,14,107148712,107182651,33939,,0
1,-1,14,107148712,107182651,33939,,0
-1,-1,14,107148712,107182651,33939,,0
-1,-1,14,107148712,107182651,33939,,0
1,-1,14,107148712,107182651,33939,,0
-1,-1,14,107148712,107182651,33939,,0
1,-1,14,107148712,107182651,33939,,0
1,-1,14,107148712,107182651,33939,,0
1,-1,14,107148712,107182651,33939,,0
1,-1,14,107148712,107182651,33939,,0
-1,-1,14,107148712,107182651,33939,,0
1,-1,14,107148712,107182651,33939,,0
-1,-1,14,107148712,107182651,33939,,0
1,-1,14,107148712,107182651,33939,,0
1,-1,14,107148712,107182651,33939,,0
-1,-1,14,107148712,107182651,33939,,0
1,-1,14,107148712,107182651,33939,,0
1,-1,14,107148712,107182651,33939,,0
-1,-1,14,107148712,107182651,33939,,0
1,-1,14,107148712,107182651,33939,,0
-1,-1,14,107148712,107182651,33939,,0
-1,-1,14,107148712,107182651,33939,,0
1,-1,14,107148712,107182651,33939,,0
1,-1,14,107148712,107182651,33939,,0
1,-1,14,107148712,107182651,33939,,0
1,-1,14,107148712,107182651,33939,,0
1,-1,14,107148712,107182651,33939,,0
1,-1,14,107148712,107182651,33939,,0
1,-1,14,107148712,107182651,33939,,0
-1,-1,14,107148712,107182651,33939,,0
-1,-1,14,107148712,107182651,33939,,0
1,-1,14,107148712,107182651,33939,,0
1,-1,14,107148712,107182651,33939,,0
-1,-1,14,107148712,107182651,33939,,0
1,-1,14,107148712,107182651,33939,,0
-1,-1,14,107148712,107182651,33939,,0
1,-1,14,107148712,107182651,33939,,0
1,-1,14,107148712,107182651,33939,,0
1,-1,14,107148712,107182651,33939,,0
-1,-1,14,107148712,107182651,33939,,0
-1,-1,14,107148712,107182651,33939,,0
1,-1,14,107148712,107182651,33939,,0
-1,-1,14,107148712,107182651,33939,,0
-1,-1,14,107148712,107182651,33939,,0
-1,-1,14,107148712,107182651,33939,,0
-1,-1,14,107148712,107182651,33939,,0
-1,-1,14,107148712,107182651,33939,,0
1,-1,14,107148712,107182651,33939,,0
1,-1,14,107148712,107182651,33939,,0
1,-1,14,107148712,107182651,33939,,0
1,-1,14,107148712,107182651,33939,,0
-1,-1,14,107148712,107182651,33939,,0
1,-1,14,107148712,107182651,33939,,0
-1,-1,14,107148712,107182651,33939,,0
-1,-1,14,107148712,107182651,33939,,0
1,-1,14,107148712,107182651,33939,,0
1,-1,14,107148712,107182651,33939,,0
-1,-1,14,107148712,107182651,33939,,0
1,-1,14,107148712,107182651,33939,,0
1,-1,14,107148712,107182651,33939,,0
1,-1,14,107148712,107182651,33939,,0
1,-1,14,107148712,107182651,33939,,0
-1,-1,14,107148712,107182651,33939,,0
1,-1,14,107148712,107182651,33939,,0
-1,-1,14,107148712,107182651,33939,,0
-1,-1,14,107148712,107182651,33939,,0
1,-1,14,107148712,107182651,33939,,0
1,-1,14,107148712,107182651,33939,,0
1,-1,14,107148712,107182651,33939,,0
1,-1,14,107148712,107182651,33939,,0
-1,-1,14,107148712,107182651,33939,,0
-1,-1,14,107148712,107182651,33939,,0
-1,-1,14,107148712,107182651,33939,,0
-1,-1,14,107148712,107182651,33939,,0
1,-1,14,107148712,107182651,33939,,0
1,-1,14,107148712,107182651,33939,,0
1,-1,14,107148712,107182651,33939,,0
1,-1,14,107148712,107182651,33939,,0
1,-1,14,107148712,107182651,33939,,0
1,-1,14,107148712,107182651,33939,,0
1,-1,14,107148712,107182651,33939,,0
1,-1,14,107148712,107182651,33939,,0
1,-1,14,107148712,107182651,33939,,0
-1,-1,14,107148712,107182651,33939,,0
1,-1,14,107148712,107182651,33939,,0
-1,-1,14,107148712,107182651,33939,,0
1,-1,14,107148712,107182651,33939,,0
1,-1,14,107148712,107182651,33939,,0
-1,-1,14,107148712,107182651,33939,,0
-1,-1,14,107148712,107182651,33939,,0
1,-1,14,107148712,107182651,33939,,0
-1,-1,14,107148712,107182651,33939,,0
1,-1,14,107148712,107182651,33939,,0
1,-1,14,107148712,107182651,33939,,0
1,-1,14,107148712,107182651,33939,,0
1,-1,14,107148712,107182651,33939,,0
1,-1,14,107148712,107182651,33939,,0
-1,-1,14,107148712,107182651,33939,,0
1,-1,14,107148712,107182651,33939,,0
1,-1,14,107148712,107182651,33939,,0
1,-1,14,107148712,107182651,33939,,0
-1,-1,14,107148712,107182651,33939,,0
1,-1,14,107148712,107182651,33939,,0
1,-1,14,107148712,107182651,33939,,0
1,-1,14,107148712,107182651,33939,,0
1,-1,14,107148712,107182651,33939,,0
1,-1,14,107148712,107182651,33939,,0
-1,-1,14,107148712,107182651,33939,,0
-1,-1,14,107148712,107182651,33939,,0
1,-1,14,107148712,107182651,33939,,0
-1,-1,14,107148712,107182651,33939,,0
-1,-1,14,107148712,107182651,33939,,0
-1,-1,14,107148712,107182651,33939,,0
-1,-1,14,107148712,107182651,33939,,0
1,-1,14,107148712,107182651,33939,,0
-1,-1,14,107148712,107182651,33939,,0
1,-1,14,107148712,107182651,33939,,0
1,-1,14,107148712,107182651,33939,,0
1,-1,14,107148712,107182651,33939,,0
1,-1,14,107148712,107182651,33939,,0
-1,-1,14,107148712,107182651,33939,,0
1,-1,14,107148712,107182651,33939,,0
-1,-1,14,107148712,107182651,33939,,0
1,-1,14,107148712,107182651,33939,,0
1,-1,14,107148712,107182651,33939,,0
1,-1,14,107148712,107182651,33939,,0
1,-1,14,107148712,107182651,33939,,0
1,-1,14,107148712,107182651,33939,,0
1,-1,14,107148712,107182651,33939,,0
-1,-1,14,107148712,107182651,33939,,0
1,-1,14,107148712,107182651,33939,,0
-1,-1,14,107148712,107182651,33939,,0
1,-1,14,107148712,107182651,33939,,0
1,-1,14,107148712,107182651,33939,,0
-1,-1,14,107148712,107182651,33939,,0
-1,-1,14,107148712,107182651,33939,,0
1,-1,14,107148712,107182651,33939,,0
-1,-1,14,107148712,107182651,33939,,0
1,-1,14,107148712,107182651,33939,,0
1,-1,14,107148712,107182651,33939,,0
1,-1,14,107148712,107182651,33939,,0
-1,-1,14,107148712,107182651,33939,,0
1,-1,14,107148712,107182651,33939,,0
-1,-1,14,107148712,107182651,33939,,0
1,-1,14,107148712,107182651,33939,,0
1,-1,14,107148712,107182651,33939,,0
1,-1,14,107148712,107182651,33939,,0
-1,-1,14,107148712,107182651,33939,,0
-1,-1,14,107148712,107182651,33939,,0
1,-1,14,107148712,107182651,33939,,0
1,-1,14,107148712,107182651,33939,,0
1,-1,14,107148712,107182651,33939,,0
1,-1,14,107148712,107182651,33939,,0
1,-1,14,107148712,107182651,33939,,0
1,-1,14,107148712,107182651,33939,,0
1,-1,14,107148712,107182651,33939,,0
-1,-1,14,107148712,107182651,33939,,0
1,-1,14,107148712,107182651,33939,,0
1,-1,14,107148712,107182651,33939,,0
1,-1,14,107148712,107185512,36800,,0
-1,-1,14,107148712,107185512,36800,,0
-1,-1,14,107148712,107185512,36800,,0
-1,-1,14,107148712,107185512,36800,,0
-1,-1,14,107148712,107185512,36800,,0
-1,-1,14,107148712,107189879,41167,,0
1,-1,14,107148739,107160026,11287,,0
1,-1,14,107148739,107168750,20011,,0
1,-1,14,107148739,107182658,33919,,0
-1,-1,14,107148739,107182658,33919,,0
1,-1,14,107148739,107182658,33919,,0
1,-1,14,107148739,107182658,33919,,0
1,-1,14,107148739,107182658,33919,,0
1,-1,14,107148739,107182658,33919,,0
1,-1,14,107148739,107182658,33919,,0
1,-1,14,107148739,107182658,33919,,0
1,-1,14,107148739,107182658,33919,,0
1,-1,14,107148739,107182658,33919,,0
1,-1,14,107148739,107182658,33919,,0
1,-1,14,107148739,107182658,33919,,0
1,-1,14,107148739,107182658,33919,,0
1,-1,14,107148739,107182658,33919,,0
1,-1,14,107148739,107182658,33919,,0
-1,-1,14,107148739,107182658,33919,,0
1,-1,14,107148739,107182658,33919,,0
1,-1,14,107148739,107185512,36773,,0
-1,-1,14,107148740,107180095,31355,,0
-1,-1,14,107155096,107182651,27555,,0
1,-1,14,107155096,107182651,27555,,0
1,-1,14,107155096,107182651,27555,,0
1,-1,14,107155096,107182651,27555,,0
1,-1,14,107155096,107182651,27555,,0
1,-1,14,107155096,107182651,27555,,0
1,-1,14,107155096,107182651,27555,,0
1,-1,14,107155096,107182651,27555,,0
1,-1,14,107155096,107182651,27555,,0
1,-1,14,107155096,107182651,27555,,0
-1,-1,14,107160845,107180121,19276,,0
-1,-1,14,107160845,107182651,21806,,0
1,-1,14,107160845,107182651,21806,,0
1,-1,14,107160845,107182651,21806,,0
1,-1,14,107160845,107182651,21806,,0
1,-1,14,107160845,107182651,21806,,0
1,-1,14,107160845,107182651,21806,,0
1,-1,14,107160845,107182651,21806,,0
1,-1,14,107160845,107182651,21806,,0
1,-1,14,107160845,107182651,21806,,0
1,-1,14,107160845,107182651,21806,,0
1,-1,14,107160845,107182651,21806,,0
1,-1,14,107160845,107182651,21806,,0
1,-1,14,107160845,107182651,21806,,0
1,-1,14,107160845,107182651,21806,,0
1,-1,14,107160845,107182651,21806,,0
1,-1,14,107160845,107182651,21806,,0
1,-1,14,107160845,107182651,21806,,0
1,-1,14,107160845,107182651,21806,,0
-1,-1,14,107160845,107182651,21806,,0
-1,-1,14,107160845,107182651,21806,,0
-1,-1,14,107160845,107182651,21806,,0
-1,-1,14,107160845,107182651,21806,,0
-1,-1,14,107160845,107182651,21806,,0
-1,-1,14,107163040,107180121,17081,,0
-1,-1,14,107163040,107182651,19611,,0
-1,-1,14,107163040,107182651,19611,,0
-1,-1,14,107189820,107214878,25058,,0
-1,-1,14,107189831,107214893,25062,,0
1,-1,14,107258735,107270326,11591,,0
1,-1,14,107259155,107269750,10595,,0
1,1,15,20045834,32914140,12868306,321;7681;123606;283694;643699;390538;23359;6638;22909;8926;161725;283710;283685;653720;89839;4692;54893;23191;283767;728498;2562;101059918;727832;9824;100996331;4948;57194;81614;100287399;4308;2558;1139;7082;8924;114791;23742;51621;7337;89832;653125;653073;2567;54551;728047;56160,45
1,-1,15,20063340,20624533,561193,,0
1,-1,15,20063340,21929931,1866591,727832;100287399,2
1,-1,15,20063340,22303901,2240561,100996331;727832;100287399,3
-1,-1,15,20063340,22332342,2269002,100996331;727832;100287399,3
1,-1,15,20063340,22652060,2588720,283694;727832;100287399;390538;100996331,5
1,-1,15,20063340,22652060,2588720,283694;727832;100287399;390538;100996331,5
1,-1,15,20063340,22652060,2588720,283694;727832;100287399;390538;100996331,5
1,-1,15,20063340,22652060,2588720,283694;727832;100287399;390538;100996331,5
1,-1,15,20063340,22652060,2588720,283694;727832;100287399;390538;100996331,5
1,-1,15,20063340,22652060,2588720,283694;727832;100287399;390538;100996331,5
1,-1,15,20063340,22652060,2588720,283694;727832;100287399;390538;100996331,5
1,-1,15,20063340,22652060,2588720,283694;727832;100287399;390538;100996331,5
1,-1,15,20063340,22652060,2588720,283694;727832;100287399;390538;100996331,5
1,-1,15,20063340,22652060,2588720,283694;727832;100287399;390538;100996331,5
1,-1,15,20063340,22652060,2588720,283694;727832;100287399;390538;100996331,5
1,-1,15,20063340,22652060,2588720,283694;727832;100287399;390538;100996331,5
1,-1,15,20063340,22652060,2588720,283694;727832;100287399;390538;100996331,5
1,-1,15,20063340,22652060,2588720,283694;727832;100287399;390538;100996331,5
1,-1,15,20063340,22652060,2588720,283694;727832;100287399;390538;100996331,5
1,-1,15,20063340,22652060,2588720,283694;727832;100287399;390538;100996331,5
1,-1,15,20063340,22652060,2588720,283694;727832;100287399;390538;100996331,5
1,-1,15,20063340,22684152,2620812,283694;727832;100287399;390538;100996331,5
1,-1,15,20063340,22762571,2699231,283694;727832;100287399;390538;283767;100996331,6
1,-1,15,20063340,22762571,2699231,283694;727832;100287399;390538;283767;100996331,6
1,-1,15,20063340,22762571,2699231,283694;727832;100287399;390538;283767;100996331,6
1,-1,15,20063340,22762571,2699231,283694;727832;100287399;390538;283767;100996331,6
1,-1,15,20063340,22762571,2699231,283694;727832;100287399;390538;283767;100996331,6
1,-1,15,20063340,22762571,2699231,283694;727832;100287399;390538;283767;100996331,6
1,-1,15,20063340,22762571,2699231,283694;727832;100287399;390538;283767;100996331,6
1,-1,15,20063340,22762571,2699231,283694;727832;100287399;390538;283767;100996331,6
1,-1,15,20063340,22762571,2699231,283694;727832;100287399;390538;283767;100996331,6
1,-1,15,20063340,22762571,2699231,283694;727832;100287399;390538;283767;100996331,6
1,-1,15,20063340,22815074,2751734,283694;727832;100287399;390538;283767;100996331,6
1,-1,15,20063340,22835864,2772524,283694;727832;114791;100287399;390538;283767;100996331,7
1,1,15,20063340,29093456,9030116,2562;7681;727832;100996331;123606;4948;57194;283694;81614;100287399;390538;2558;8924;114791;23742;7337;6638;2567;8926;283685;653720;54551;4692;23191;283767,25
1,1,15,20063340,29209620,9146280,2562;7681;727832;100996331;123606;4948;57194;283694;81614;100287399;390538;2558;8924;114791;23742;7337;6638;2567;8926;283685;653720;54551;4692;23191;283767,25
1,1,15,20063340,30448351,10385011,321;7681;2562;727832;100996331;123606;4948;57194;283694;81614;100287399;390538;2558;23359;7082;8924;114791;23742;7337;6638;653073;2567;8926;283685;653720;54551;4692;23191;283767;56160,30
1,1,15,20063340,32439302,12375962,321;7681;123606;283694;390538;23359;6638;22909;8926;161725;283710;283685;653720;89839;4692;54893;23191;283767;728498;2562;101059918;727832;100996331;4948;57194;81614;100287399;4308;2558;1139;7082;8924;114791;23742;51621;7337;89832;653073;2567;54551;56160,41
1,1,15,20063340,32942613,12879273,321;7681;123606;283694;643699;390538;23359;6638;22909;8926;161725;283710;283685;653720;89839;4692;54893;23191;283767;728498;2562;101059918;727832;9824;6447;100996331;4948;57194;81614;100287399;4308;2558;1139;7082;8924;114791;23742;51621;7337;89832;653125;653073;2567;54551;728047;56160,46
1,1,15,20063340,32942613,12879273,321;7681;123606;283694;643699;390538;23359;6638;22909;8926;161725;283710;283685;653720;89839;4692;54893;23191;283767;728498;2562;101059918;727832;9824;6447;100996331;4948;57194;81614;100287399;4308;2558;1139;7082;8924;114791;23742;51621;7337;89832;653125;653073;2567;54551;728047;56160,46
1,1,15,20063340,32986584,12923244,321;7681;123606;283694;643699;390538;23359;6638;22909;8926;161725;283710;283685;653720;89839;4692;54893;23191;283767;728498;2562;101059918;727832;9824;6447;100996331;4948;57194;81614;100287399;4308;2558;1139;7082;8924;114791;23742;51621;7337;89832;653125;653073;2567;54551;728047;56160,46
1,1,15,20063340,102521392,82458052,1445;548596;2242;80213;4058;79875;283694;390538;9399;123228;55505;161725;8483;10017;283685;653720;55055;283767;80031;9824;5923;84978;6692;196951;83640;10002;5045;23005;663;51762;653125;54962;170691;302;197135;145957;9488;390594;4947;3418;653641;1512;56964;145773;57519;9899;400359;29766;10509;49855;643338;80119;23184;4091;348110;10125;400410;1138;54832;10169;4240;51621;56965;246777;64410;619189;10239;6447;90527;84993;59274;204219;23015;10588;100820829;5597;4130;145788;161829;57538;27229;79834;11261;64963;9455;113201;10099;79631;25989;342132;9245;80301;23168;100505679;5046;8482;374659;57722;22801;100137047;7782;440270;29767;9051;146050;196993;161514;254531;56204;5479;197131;22856;342184;161582;9133;290;145781;8120;2200;53905;101059918;55272;4644;25820;2252;54629;1139;161753;90381;405753;80765;283677;646;9768;338949;57214;5604;115752;56963;220;80381;100133220;1159;6638;64397;50810;1544;54893;4122;55329;728498;5780;117155;5315;101928527;4123;283807;90427;8925;3671;10081;390616;51103;26263;100128108;84191;390637;9716;728047;79719;7681;2595;123606;390648;161502;56905;5371;5955;123264;51203;140691;1543;374654;6263;11339;23205;1133;23191;84465;91947;54822;7301;646892;5330;64864;100287399;84942;79664;58472;55897;1198;2038;23742;6642;56851;23604;4649;10302;23741;390595;80208;79661;10681;7090;145645;54617;9990;9153;3175;256586;8926;283710;6727;100131244;79968;9101;161779;8125;145942;55075;2628;9960;27023;123624;9154;5151;123263;123720;440279;85455;57617;5428;51332;10260;3480;79400;11214;10519;145741;283726;79029;54778;647042;145864;26108;64799;4828;50804;57194;51065;10066;2923;84419;79895;348093;257364;594855;8800;25942;23431;4351;123591;123169;123355;9543;100526783;57099;3419;10021;54839;113189;79748;5873;9836;256764;440295;4236;91433;23336;54956;54866;81556;342125;51285;90416;60677;2562;2184;6938;92912;100996331;11001;100505573;6652;145873;84529;1136;105376731;26035;56906;80153;1583;8773;123688;9055;64927;140460;348094;57369;55177;81488;9493;11057;192683;9915;5346;256646;3712;10620;123207;5888;2644;23269;23359;25764;8766;10363;55142;84206;10845;145853;28232;9325;23060;55898;55784;26015;100137049;3067;51324;10391;57082;390598;161835;1106;58489;8924;116179;4734;5607;54982;374618;79856;57184;2585;9236;440275;3706;283652;27079;9377;146059;51335;2553;283659;25963;145858;54878;6095;114294;8128;176;53339;727832;70;90525;56924;55323;4205;64784;55829;26682;64220;1464;771;8681;161823;9677;64782;388135;56160;90417;27020;55215;80349;83660;3669;366;91860;54939;283777;4212;388115;29106;585;4692;6176;342035;11173;10116;9728;54816;4916;9187;89978;1588;161742;23102;146057;83440;100528021;283742;30844;7337;641;26585;9333;644809;6124;10073;23582;145946;51458;64843;1143;8854;145748;400451;83464;3603;373509;55466;102;567;4088;84894;9318;6218;4948;3658;653643;8554;7026;80125;701;26276;2567;388121;6627;123283;643707;92483;7158;55070;255189;374655;79094;53944;55930;171177;1854;644844;10776;26589;51234;57188;64506;55192;51187;4643;3073;8826;22995;26258;79768;84888;55180;4308;4756;53346;7082;23478;54913;89832;9640;4016;84952;145814;11245;161497;79705;23423;8669;643699;55889;5685;22909;825;255252;106821730;3990;54567;7057;123722;2558;597;51495;6457;114791;22893;80237;196996;653073;54989;54993;6557;54551;50506;51496;1381;321;54852;390649;283748;23312;10933;399694;57611;6017;10518;2108;197021;89839;23251;80021;79811;123745;2958;23339;56986;81614;60490;388125;399697;84936;54469;342096;7168,568
1,-1,15,20102594,22652060,2549466,283694;727832;100287399;390538;100996331,5
1,-1,15,20102594,22762571,2659977,283694;727832;100287399;390538;283767;100996331,6
1,-1,15,20172592,22586922,2414330,283694;727832;100287399;390538;100996331,5
-1,-1,15,20172592,22586922,2414330,283694;727832;100287399;390538;100996331,5
-1,-1,15,20172592,22586922,2414330,283694;727832;100287399;390538;100996331,5
1,-1,15,20172592,22652060,2479468,283694;727832;100287399;390538;100996331,5
1,1,15,20190548,28406650,8216102,2562;7681;727832;100996331;123606;4948;57194;283694;81614;100287399;390538;2558;8924;114791;23742;7337;6638;2567;8926;283685;54551;4692;23191;283767,24
1,1,15,20190548,32917801,12727253,321;7681;123606;283694;643699;390538;23359;6638;22909;8926;161725;283710;283685;653720;89839;4692;54893;23191;283767;728498;2562;101059918;727832;9824;100996331;4948;57194;81614;100287399;4308;2558;1139;7082;8924;114791;23742;51621;7337;89832;653125;653073;2567;54551;728047;56160,45
1,-1,15,20207712,20816349,608637,727832,1
1,-1,15,20190682,22141158,1950476,100996331;727832;100287399,3
1,-1,15,20190682,22141158,1950476,100996331;727832;100287399,3
1,-1,15,20190682,22141158,1950476,100996331;727832;100287399,3
1,-1,15,20190682,22141158,1950476,100996331;727832;100287399,3
1,-1,15,20190682,22303901,2113219,100996331;727832;100287399,3
1,-1,15,20190682,22303901,2113219,100996331;727832;100287399,3
1,-1,15,20190682,22303901,2113219,100996331;727832;100287399,3
1,-1,15,20190682,22303901,2113219,100996331;727832;100287399,3
1,-1,15,20190682,22303901,2113219,100996331;727832;100287399,3
1,-1,15,20190682,22303901,2113219,100996331;727832;100287399,3
1,-1,15,20190682,22303901,2113219,100996331;727832;100287399,3
1,-1,15,20190682,22303901,2113219,100996331;727832;100287399,3
1,-1,15,20190682,22303901,2113219,100996331;727832;100287399,3
1,-1,15,20190682,22303901,2113219,100996331;727832;100287399,3
1,-1,15,20190682,22303901,2113219,100996331;727832;100287399,3
1,-1,15,20190682,22303901,2113219,100996331;727832;100287399,3
1,-1,15,20190682,22303901,2113219,100996331;727832;100287399,3
1,-1,15,20190682,22303901,2113219,100996331;727832;100287399,3
1,-1,15,20190682,22303901,2113219,100996331;727832;100287399,3
1,-1,15,20190682,22303901,2113219,100996331;727832;100287399,3
1,-1,15,20190682,22303901,2113219,100996331;727832;100287399,3
1,-1,15,20190682,22303901,2113219,100996331;727832;100287399,3
1,-1,15,20190682,22303901,2113219,100996331;727832;100287399,3
1,-1,15,20190682,22303901,2113219,100996331;727832;100287399,3
1,-1,15,20190682,22303901,2113219,100996331;727832;100287399,3
1,-1,15,20190682,22303901,2113219,100996331;727832;100287399,3
1,-1,15,20190682,22303901,2113219,100996331;727832;100287399,3
1,-1,15,20190682,22303901,2113219,100996331;727832;100287399,3
1,-1,15,20190682,22303901,2113219,100996331;727832;100287399,3
1,-1,15,20190682,22303901,2113219,100996331;727832;100287399,3
1,-1,15,20190682,22303901,2113219,100996331;727832;100287399,3
1,-1,15,20190682,22303901,2113219,100996331;727832;100287399,3
1,-1,15,20190682,22303901,2113219,100996331;727832;100287399,3
1,-1,15,20190682,22303901,2113219,100996331;727832;100287399,3
1,-1,15,20190682,22303901,2113219,100996331;727832;100287399,3
1,-1,15,20190682,22303901,2113219,100996331;727832;100287399,3
1,-1,15,20190682,22303901,2113219,100996331;727832;100287399,3
1,-1,15,20190682,22303901,2113219,100996331;727832;100287399,3
1,-1,15,20190682,22303901,2113219,100996331;727832;100287399,3
1,-1,15,20190682,22303901,2113219,100996331;727832;100287399,3
1,-1,15,20190682,22303901,2113219,100996331;727832;100287399,3
1,-1,15,20190682,22303901,2113219,100996331;727832;100287399,3
1,-1,15,20190682,22303901,2113219,100996331;727832;100287399,3
1,-1,15,20190682,22318585,2127903,100996331;727832;100287399,3
1,-1,15,20190682,22318585,2127903,100996331;727832;100287399,3
1,-1,15,20190682,22318585,2127903,100996331;727832;100287399,3
1,-1,15,20190682,22332342,2141660,100996331;727832;100287399,3
1,-1,15,20190682,22409342,2218660,283694;727832;100287399;390538;100996331,5
1,-1,15,20190682,22409342,2218660,283694;727832;100287399;390538;100996331,5
1,-1,15,20190682,22409342,2218660,283694;727832;100287399;390538;100996331,5
1,-1,15,20190682,22409342,2218660,283694;727832;100287399;390538;100996331,5
1,-1,15,20190682,22432504,2241822,283694;727832;100287399;390538;100996331,5
1,-1,15,20190682,22432504,2241822,283694;727832;100287399;390538;100996331,5
1,-1,15,20190682,22432504,2241822,283694;727832;100287399;390538;100996331,5
1,-1,15,20190682,22509196,2318514,283694;727832;100287399;390538;100996331,5
1,-1,15,20190682,22558685,2368003,283694;727832;100287399;390538;100996331,5
1,-1,15,20190682,22558685,2368003,283694;727832;100287399;390538;100996331,5
1,-1,15,20190682,22558685,2368003,283694;727832;100287399;390538;100996331,5
1,-1,15,20190682,22558685,2368003,283694;727832;100287399;390538;100996331,5
1,-1,15,20190682,22586922,2396240,283694;727832;100287399;390538;100996331,5
1,-1,15,20190682,22586922,2396240,283694;727832;100287399;390538;100996331,5
1,-1,15,20190682,22586922,2396240,283694;727832;100287399;390538;100996331,5
1,-1,15,20190682,22586922,2396240,283694;727832;100287399;390538;100996331,5
1,-1,15,20190682,22586922,2396240,283694;727832;100287399;390538;100996331,5
1,-1,15,20190682,22586922,2396240,283694;727832;100287399;390538;100996331,5
1,-1,15,20190682,22586922,2396240,283694;727832;100287399;390538;100996331,5
1,-1,15,20190682,22586922,2396240,283694;727832;100287399;390538;100996331,5
1,-1,15,20190682,22586922,2396240,283694;727832;100287399;390538;100996331,5
1,-1,15,20190682,22586922,2396240,283694;727832;100287399;390538;100996331,5
1,-1,15,20190682,22586922,2396240,283694;727832;100287399;390538;100996331,5
-1,-1,15,20190682,22586922,2396240,283694;727832;100287399;390538;100996331,5
1,-1,15,20190682,22586922,2396240,283694;727832;100287399;390538;100996331,5
1,-1,15,20190682,22586922,2396240,283694;727832;100287399;390538;100996331,5
1,-1,15,20190682,22652060,2461378,283694;727832;100287399;390538;100996331,5
1,-1,15,20190682,22652060,2461378,283694;727832;100287399;390538;100996331,5
1,-1,15,20190682,22652060,2461378,283694;727832;100287399;390538;100996331,5
-1,-1,15,20190682,22652060,2461378,283694;727832;100287399;390538;100996331,5
-1,-1,15,20190682,22652060,2461378,283694;727832;100287399;390538;100996331,5
1,-1,15,20190682,22652060,2461378,283694;727832;100287399;390538;100996331,5
1,-1,15,20190682,22652060,2461378,283694;727832;100287399;390538;100996331,5
1,-1,15,20190682,22652060,2461378,283694;727832;100287399;390538;100996331,5
1,-1,15,20190682,22652060,2461378,283694;727832;100287399;390538;100996331,5
1,-1,15,20190682,22652060,2461378,283694;727832;100287399;390538;100996331,5
1,-1,15,20190682,22652060,2461378,283694;727832;100287399;390538;100996331,5
1,-1,15,20190682,22652060,2461378,283694;727832;100287399;390538;100996331,5
1,-1,15,20190682,22652060,2461378,283694;727832;100287399;390538;100996331,5
1,-1,15,20190682,22652060,2461378,283694;727832;100287399;390538;100996331,5
1,-1,15,20190682,22652060,2461378,283694;727832;100287399;390538;100996331,5
1,-1,15,20190682,22652060,2461378,283694;727832;100287399;390538;100996331,5
1,-1,15,20190682,22652060,2461378,283694;727832;100287399;390538;100996331,5
1,-1,15,20190682,22652060,2461378,283694;727832;100287399;390538;100996331,5
1,-1,15,20190682,22652060,2461378,283694;727832;100287399;390538;100996331,5
1,-1,15,20190682,22652060,2461378,283694;727832;100287399;390538;100996331,5
1,-1,15,20190682,22652060,2461378,283694;727832;100287399;390538;100996331,5
-1,-1,15,20190682,22652060,2461378,283694;727832;100287399;390538;100996331,5
1,-1,15,20190682,22652060,2461378,283694;727832;100287399;390538;100996331,5
1,-1,15,20190682,22652060,2461378,283694;727832;100287399;390538;100996331,5
1,-1,15,20190682,22652060,2461378,283694;727832;100287399;390538;100996331,5
1,-1,15,20190682,22652060,2461378,283694;727832;100287399;390538;100996331,5
-1,-1,15,20190682,22652060,2461378,283694;727832;100287399;390538;100996331,5
1,-1,15,20190682,22652060,2461378,283694;727832;100287399;390538;100996331,5
1,-1,15,20190682,22652060,2461378,283694;727832;100287399;390538;100996331,5
1,-1,15,20190682,22652060,2461378,283694;727832;100287399;390538;100996331,5
1,-1,15,20190682,22652060,2461378,283694;727832;100287399;390538;100996331,5
1,-1,15,20190682,22652060,2461378,283694;727832;100287399;390538;100996331,5
1,-1,15,20190682,22652060,2461378,283694;727832;100287399;390538;100996331,5
1,-1,15,20190682,22652060,2461378,283694;727832;100287399;390538;100996331,5
1,-1,15,20190682,22652060,2461378,283694;727832;100287399;390538;100996331,5
1,-1,15,20190682,22652060,2461378,283694;727832;100287399;390538;100996331,5
1,-1,15,20190682,22652060,2461378,283694;727832;100287399;390538;100996331,5
1,-1,15,20190682,22652060,2461378,283694;727832;100287399;390538;100996331,5
1,-1,15,20190682,22652060,2461378,283694;727832;100287399;390538;100996331,5
1,-1,15,20190682,22652060,2461378,283694;727832;100287399;390538;100996331,5
1,-1,15,20190682,22652060,2461378,283694;727832;100287399;390538;100996331,5
1,-1,15,20190682,22652060,2461378,283694;727832;100287399;390538;100996331,5
1,-1,15,20190682,22652060,2461378,283694;727832;100287399;390538;100996331,5
1,-1,15,20190682,22652060,2461378,283694;727832;100287399;390538;100996331,5
1,-1,15,20190682,22652060,2461378,283694;727832;100287399;390538;100996331,5
1,-1,15,20190682,22652060,2461378,283694;727832;100287399;390538;100996331,5
1,-1,15,20190682,22652060,2461378,283694;727832;100287399;390538;100996331,5
1,-1,15,20190682,22652060,2461378,283694;727832;100287399;390538;100996331,5
1,-1,15,20190682,22652060,2461378,283694;727832;100287399;390538;100996331,5
1,-1,15,20190682,22652060,2461378,283694;727832;100287399;390538;100996331,5
1,-1,15,20190682,22652060,2461378,283694;727832;100287399;390538;100996331,5
1,-1,15,20190682,22652060,2461378,283694;727832;100287399;390538;100996331,5
1,-1,15,20190682,22652060,2461378,283694;727832;100287399;390538;100996331,5
1,-1,15,20190682,22652060,2461378,283694;727832;100287399;390538;100996331,5
1,-1,15,20190682,22652060,2461378,283694;727832;100287399;390538;100996331,5
-1,-1,15,20190682,22652060,2461378,283694;727832;100287399;390538;100996331,5
1,-1,15,20190682,22652060,2461378,283694;727832;100287399;390538;100996331,5
1,-1,15,20190682,22663583,2472901,283694;727832;100287399;390538;100996331,5
1,-1,15,20190682,22663583,2472901,283694;727832;100287399;390538;100996331,5
1,-1,15,20190682,22663583,2472901,283694;727832;100287399;390538;100996331,5
1,-1,15,20190682,22663583,2472901,283694;727832;100287399;390538;100996331,5
1,-1,15,20190682,22663583,2472901,283694;727832;100287399;390538;100996331,5
1,-1,15,20190682,22663583,2472901,283694;727832;100287399;390538;100996331,5
1,-1,15,20190682,22663583,2472901,283694;727832;100287399;390538;100996331,5
1,-1,15,20190682,22663583,2472901,283694;727832;100287399;390538;100996331,5
1,-1,15,20190682,22663583,2472901,283694;727832;100287399;390538;100996331,5
1,-1,15,20190682,22663583,2472901,283694;727832;100287399;390538;100996331,5
1,-1,15,20190682,22663583,2472901,283694;727832;100287399;390538;100996331,5
1,-1,15,20190682,22663583,2472901,283694;727832;100287399;390538;100996331,5
1,-1,15,20190682,22663583,2472901,283694;727832;100287399;390538;100996331,5
1,-1,15,20190682,22663583,2472901,283694;727832;100287399;390538;100996331,5
1,-1,15,20190682,22669079,2478397,283694;727832;100287399;390538;100996331,5
1,-1,15,20190682,22669079,2478397,283694;727832;100287399;390538;100996331,5
1,-1,15,20190682,22669079,2478397,283694;727832;100287399;390538;100996331,5
1,-1,15,20190682,22669079,2478397,283694;727832;100287399;390538;100996331,5
1,-1,15,20190682,22684152,2493470,283694;727832;100287399;390538;100996331,5
1,-1,15,20190682,22684152,2493470,283694;727832;100287399;390538;100996331,5
1,-1,15,20190682,22684152,2493470,283694;727832;100287399;390538;100996331,5
1,-1,15,20190682,22684152,2493470,283694;727832;100287399;390538;100996331,5
1,-1,15,20190682,22684152,2493470,283694;727832;100287399;390538;100996331,5
1,-1,15,20190682,22684152,2493470,283694;727832;100287399;390538;100996331,5
1,-1,15,20190682,22684152,2493470,283694;727832;100287399;390538;100996331,5
1,-1,15,20190682,22684152,2493470,283694;727832;100287399;390538;100996331,5
1,-1,15,20190682,22684501,2493819,283694;727832;100287399;390538;100996331,5
1,-1,15,20190682,22729364,2538682,283694;727832;100287399;390538;100996331,5
1,-1,15,20190682,22748632,2557950,283694;727832;100287399;390538;283767;100996331,6
1,-1,15,20190682,22748632,2557950,283694;727832;100287399;390538;283767;100996331,6
1,-1,15,20190682,22748632,2557950,283694;727832;100287399;390538;283767;100996331,6
1,-1,15,20190682,22748632,2557950,283694;727832;100287399;390538;283767;100996331,6
1,-1,15,20190682,22762571,2571889,283694;727832;100287399;390538;283767;100996331,6
1,-1,15,20190682,22762571,2571889,283694;727832;100287399;390538;283767;100996331,6
1,-1,15,20190682,22762571,2571889,283694;727832;100287399;390538;283767;100996331,6
1,-1,15,20190682,22762571,2571889,283694;727832;100287399;390538;283767;100996331,6
1,-1,15,20190682,22762571,2571889,283694;727832;100287399;390538;283767;100996331,6
1,-1,15,20190682,22762571,2571889,283694;727832;100287399;390538;283767;100996331,6
1,-1,15,20190682,22762571,2571889,283694;727832;100287399;390538;283767;100996331,6
1,-1,15,20190682,22762571,2571889,283694;727832;100287399;390538;283767;100996331,6
1,-1,15,20190682,22762571,2571889,283694;727832;100287399;390538;283767;100996331,6
1,-1,15,20190682,22762571,2571889,283694;727832;100287399;390538;283767;100996331,6
1,-1,15,20190682,22762571,2571889,283694;727832;100287399;390538;283767;100996331,6
1,-1,15,20190682,22762571,2571889,283694;727832;100287399;390538;283767;100996331,6
1,-1,15,20190682,22762571,2571889,283694;727832;100287399;390538;283767;100996331,6
1,-1,15,20190682,22762571,2571889,283694;727832;100287399;390538;283767;100996331,6
1,-1,15,20190682,22762571,2571889,283694;727832;100287399;390538;283767;100996331,6
1,-1,15,20190682,22762571,2571889,283694;727832;100287399;390538;283767;100996331,6
1,-1,15,20190682,22762571,2571889,283694;727832;100287399;390538;283767;100996331,6
1,-1,15,20190682,22762571,2571889,283694;727832;100287399;390538;283767;100996331,6
1,-1,15,20190682,22762571,2571889,283694;727832;100287399;390538;283767;100996331,6
1,-1,15,20190682,22762571,2571889,283694;727832;100287399;390538;283767;100996331,6
1,-1,15,20190682,22762571,2571889,283694;727832;100287399;390538;283767;100996331,6
1,-1,15,20190682,22762571,2571889,283694;727832;100287399;390538;283767;100996331,6
1,-1,15,20190682,22762571,2571889,283694;727832;100287399;390538;283767;100996331,6
1,-1,15,20190682,22762571,2571889,283694;727832;100287399;390538;283767;100996331,6
1,-1,15,20190682,22762571,2571889,283694;727832;100287399;390538;283767;100996331,6
1,-1,15,20190682,22762571,2571889,283694;727832;100287399;390538;283767;100996331,6
1,-1,15,20190682,22762571,2571889,283694;727832;100287399;390538;283767;100996331,6
1,-1,15,20190682,22762571,2571889,283694;727832;100287399;390538;283767;100996331,6
1,-1,15,20190682,22762571,2571889,283694;727832;100287399;390538;283767;100996331,6
1,-1,15,20190682,22762571,2571889,283694;727832;100287399;390538;283767;100996331,6
1,-1,15,20190682,22762571,2571889,283694;727832;100287399;390538;283767;100996331,6
1,-1,15,20190682,22762571,2571889,283694;727832;100287399;390538;283767;100996331,6
1,-1,15,20190682,22762571,2571889,283694;727832;100287399;390538;283767;100996331,6
1,-1,15,20190682,22762571,2571889,283694;727832;100287399;390538;283767;100996331,6
1,-1,15,20190682,22762571,2571889,283694;727832;100287399;390538;283767;100996331,6
1,-1,15,20190682,22798604,2607922,283694;727832;100287399;390538;283767;100996331,6
1,-1,15,20190682,22835864,2645182,283694;727832;114791;100287399;390538;283767;100996331,7
1,-1,15,20190682,22835864,2645182,283694;727832;114791;100287399;390538;283767;100996331,7
1,-1,15,20207772,21929931,1722159,727832;100287399,2
1,-1,15,20207772,22652060,2444288,283694;727832;100287399;390538;100996331,5
1,-1,15,20207772,22652060,2444288,283694;727832;100287399;390538;100996331,5
1,-1,15,20207772,22663583,2455811,283694;727832;100287399;390538;100996331,5
1,-1,15,20207772,22663583,2455811,283694;727832;100287399;390538;100996331,5
1,-1,15,20207772,22684152,2476380,283694;727832;100287399;390538;100996331,5
1,-1,15,20207772,22684152,2476380,283694;727832;100287399;390538;100996331,5
1,-1,15,20207772,22684152,2476380,283694;727832;100287399;390538;100996331,5
1,-1,15,20261544,20816349,554805,727832,1
1,-1,15,20223655,22141158,1917503,100996331;727832;100287399,3
1,-1,15,20223655,22141158,1917503,100996331;727832;100287399,3
1,-1,15,20223655,22141158,1917503,100996331;727832;100287399,3
1,-1,15,20223655,22141158,1917503,100996331;727832;100287399,3
1,-1,15,20223655,22141158,1917503,100996331;727832;100287399,3
1,-1,15,20223655,22141158,1917503,100996331;727832;100287399,3
1,-1,15,20223655,22141158,1917503,100996331;727832;100287399,3
1,-1,15,20223655,22141158,1917503,100996331;727832;100287399,3
1,-1,15,20223655,22141158,1917503,100996331;727832;100287399,3
1,-1,15,20223655,22141158,1917503,100996331;727832;100287399,3
1,-1,15,20223655,22141158,1917503,100996331;727832;100287399,3
1,-1,15,20223655,22141158,1917503,100996331;727832;100287399,3
1,-1,15,20223655,22141158,1917503,100996331;727832;100287399,3
1,-1,15,20223655,22652060,2428405,283694;727832;100287399;390538;100996331,5
1,-1,15,20223655,22652060,2428405,283694;727832;100287399;390538;100996331,5
1,-1,15,20223655,22652060,2428405,283694;727832;100287399;390538;100996331,5
1,-1,15,20223655,22652060,2428405,283694;727832;100287399;390538;100996331,5
1,-1,15,20223655,22652060,2428405,283694;727832;100287399;390538;100996331,5
1,-1,15,20223655,22652060,2428405,283694;727832;100287399;390538;100996331,5
1,-1,15,20223655,22652060,2428405,283694;727832;100287399;390538;100996331,5
1,-1,15,20223655,22652060,2428405,283694;727832;100287399;390538;100996331,5
1,-1,15,20223655,22652060,2428405,283694;727832;100287399;390538;100996331,5
1,-1,15,20223655,22652060,2428405,283694;727832;100287399;390538;100996331,5
1,-1,15,20223655,22652060,2428405,283694;727832;100287399;390538;100996331,5
1,-1,15,20223655,22652060,2428405,283694;727832;100287399;390538;100996331,5
1,-1,15,20223655,22652060,2428405,283694;727832;100287399;390538;100996331,5
1,-1,15,20223655,22652060,2428405,283694;727832;100287399;390538;100996331,5
1,-1,15,20223655,22652060,2428405,283694;727832;100287399;390538;100996331,5
1,-1,15,20223655,22652060,2428405,283694;727832;100287399;390538;100996331,5
1,-1,15,20223655,22652060,2428405,283694;727832;100287399;390538;100996331,5
1,-1,15,20223655,22652060,2428405,283694;727832;100287399;390538;100996331,5
1,-1,15,20223655,22652060,2428405,283694;727832;100287399;390538;100996331,5
1,-1,15,20223655,22652060,2428405,283694;727832;100287399;390538;100996331,5
1,-1,15,20223655,22652060,2428405,283694;727832;100287399;390538;100996331,5
1,-1,15,20223655,22652060,2428405,283694;727832;100287399;390538;100996331,5
1,-1,15,20223655,22652060,2428405,283694;727832;100287399;390538;100996331,5
1,-1,15,20223655,22652060,2428405,283694;727832;100287399;390538;100996331,5
1,-1,15,20223655,22652060,2428405,283694;727832;100287399;390538;100996331,5
1,-1,15,20223655,22652060,2428405,283694;727832;100287399;390538;100996331,5
1,-1,15,20223655,22663583,2439928,283694;727832;100287399;390538;100996331,5
1,-1,15,20223655,22663583,2439928,283694;727832;100287399;390538;100996331,5
1,-1,15,20223655,22663583,2439928,283694;727832;100287399;390538;100996331,5
1,-1,15,20223655,22663583,2439928,283694;727832;100287399;390538;100996331,5
1,-1,15,20223655,22663583,2439928,283694;727832;100287399;390538;100996331,5
1,-1,15,20223655,22684152,2460497,283694;727832;100287399;390538;100996331,5
1,-1,15,20223655,22684152,2460497,283694;727832;100287399;390538;100996331,5
1,-1,15,20223655,22762571,2538916,283694;727832;100287399;390538;283767;100996331,6
1,-1,15,20223655,22762571,2538916,283694;727832;100287399;390538;283767;100996331,6
1,-1,15,20223655,22762571,2538916,283694;727832;100287399;390538;283767;100996331,6
1,-1,15,20223655,22762571,2538916,283694;727832;100287399;390538;283767;100996331,6
1,-1,15,20223655,22762571,2538916,283694;727832;100287399;390538;283767;100996331,6
-1,-1,15,20394226,22589782,2195556,283694;727832;100287399;390538;100996331,5
-1,-1,15,20408298,22652060,2243762,283694;727832;100287399;390538;100996331,5
-1,-1,15,20408298,22652060,2243762,283694;727832;100287399;390538;100996331,5
-1,-1,15,20408298,22652060,2243762,283694;727832;100287399;390538;100996331,5
-1,-1,15,20408298,22652060,2243762,283694;727832;100287399;390538;100996331,5
-1,-1,15,20408298,22652060,2243762,283694;727832;100287399;390538;100996331,5
-1,-1,15,20408313,20849140,440827,727832,1
1,-1,15,20423115,22652121,2229006,283694;727832;100287399;390538;100996331,5
-1,-1,15,20423126,22409532,1986406,283694;727832;100287399;390538;100996331,5
1,-1,15,20423126,22589782,2166656,283694;727832;100287399;390538;100996331,5
-1,-1,15,20423126,22648468,2225342,283694;727832;100287399;390538;100996331,5
1,-1,15,20423175,22141158,1717983,100996331;727832;100287399,3
1,-1,15,20423175,22586922,2163747,283694;727832;100287399;390538;100996331,5
1,-1,15,20423175,22586922,2163747,283694;727832;100287399;390538;100996331,5
1,-1,15,20423175,22652060,2228885,283694;727832;100287399;390538;100996331,5
1,-1,15,20423175,22652060,2228885,283694;727832;100287399;390538;100996331,5
1,-1,15,20423175,22652060,2228885,283694;727832;100287399;390538;100996331,5
-1,-1,15,20432880,22461833,2028953,283694;727832;100287399;390538;100996331,5
-1,-1,15,20432880,22648468,2215588,283694;727832;100287399;390538;100996331,5
1,-1,15,20462603,22648468,2185865,283694;727832;100287399;390538;100996331,5
-1,-1,15,20492146,22578600,2086454,283694;727832;100287399;390538;100996331,5
-1,-1,15,20492147,22344608,1852461,100996331;727832;100287399,3
1,-1,15,20530579,22303901,1773322,100996331;727832;100287399,3
1,-1,15,20530579,22669079,2138500,283694;727832;100287399;390538;100996331,5
1,-1,15,20530579,22684152,2153573,283694;727832;100287399;390538;100996331,5
1,-1,15,20530579,22684152,2153573,283694;727832;100287399;390538;100996331,5
1,-1,15,20530579,22684152,2153573,283694;727832;100287399;390538;100996331,5
1,-1,15,20530579,22684152,2153573,283694;727832;100287399;390538;100996331,5
1,-1,15,20530579,22684152,2153573,283694;727832;100287399;390538;100996331,5
1,-1,15,20530579,22684152,2153573,283694;727832;100287399;390538;100996331,5
1,-1,15,20530579,22684152,2153573,283694;727832;100287399;390538;100996331,5
1,-1,15,20530579,22684152,2153573,283694;727832;100287399;390538;100996331,5
1,-1,15,20530579,22684501,2153922,283694;727832;100287399;390538;100996331,5
1,-1,15,20530579,22717733,2187154,283694;727832;100287399;390538;100996331,5
1,-1,15,20530579,22717733,2187154,283694;727832;100287399;390538;100996331,5
1,-1,15,20530579,22748632,2218053,283694;727832;100287399;390538;283767;100996331,6
1,-1,15,20530579,22748632,2218053,283694;727832;100287399;390538;283767;100996331,6
1,-1,15,20530579,22748632,2218053,283694;727832;100287399;390538;283767;100996331,6
1,-1,15,20530579,22748632,2218053,283694;727832;100287399;390538;283767;100996331,6
1,-1,15,20530579,22762571,2231992,283694;727832;100287399;390538;283767;100996331,6
1,-1,15,20530579,22762571,2231992,283694;727832;100287399;390538;283767;100996331,6
1,-1,15,20530579,22762571,2231992,283694;727832;100287399;390538;283767;100996331,6
1,-1,15,20530579,22762571,2231992,283694;727832;100287399;390538;283767;100996331,6
1,-1,15,20530579,22762571,2231992,283694;727832;100287399;390538;283767;100996331,6
1,-1,15,20530579,22762571,2231992,283694;727832;100287399;390538;283767;100996331,6
1,-1,15,20530579,22762571,2231992,283694;727832;100287399;390538;283767;100996331,6
1,-1,15,20530579,22762571,2231992,283694;727832;100287399;390538;283767;100996331,6
1,-1,15,20530579,22762571,2231992,283694;727832;100287399;390538;283767;100996331,6
1,-1,15,20530579,22762571,2231992,283694;727832;100287399;390538;283767;100996331,6
1,-1,15,20530579,22762571,2231992,283694;727832;100287399;390538;283767;100996331,6
1,-1,15,20530579,22762571,2231992,283694;727832;100287399;390538;283767;100996331,6
1,-1,15,20530579,22762571,2231992,283694;727832;100287399;390538;283767;100996331,6
1,-1,15,20530579,22762571,2231992,283694;727832;100287399;390538;283767;100996331,6
1,-1,15,20530579,22762571,2231992,283694;727832;100287399;390538;283767;100996331,6
1,-1,15,20530579,22762571,2231992,283694;727832;100287399;390538;283767;100996331,6
1,-1,15,20530579,22762571,2231992,283694;727832;100287399;390538;283767;100996331,6
1,-1,15,20530579,22762571,2231992,283694;727832;100287399;390538;283767;100996331,6
1,-1,15,20530579,22762571,2231992,283694;727832;100287399;390538;283767;100996331,6
1,-1,15,20530579,22762571,2231992,283694;727832;100287399;390538;283767;100996331,6
1,-1,15,20530579,22762571,2231992,283694;727832;100287399;390538;283767;100996331,6
1,-1,15,20530579,22762571,2231992,283694;727832;100287399;390538;283767;100996331,6
1,-1,15,20530579,22762571,2231992,283694;727832;100287399;390538;283767;100996331,6
1,-1,15,20530579,22784133,2253554,283694;727832;100287399;390538;283767;100996331,6
1,-1,15,20530579,22815074,2284495,283694;727832;100287399;390538;283767;100996331,6
-1,-1,15,20575676,22285320,1709644,100996331;727832;100287399,3
-1,-1,15,20604598,20877978,273380,727832,1
-1,-1,15,20604598,22264518,1659920,100996331;727832;100287399,3
-1,-1,15,20624452,22669082,2044630,283694;727832;100287399;390538;100996331,5
1,1,15,20686196,30509384,9823188,321;7681;2562;727832;100996331;123606;4948;57194;283694;81614;100287399;390538;2558;23359;7082;8924;114791;23742;7337;6638;653073;2567;8926;283685;653720;54551;4692;23191;283767;56160,30
-1,-1,15,20699921,22141158,1441237,100996331;727832;100287399,3
1,-1,15,20733395,23487423,2754028,727832;114791;100996331;123606;283694;81614;100287399;390538;23191;283767,10
1,1,15,20733395,28406650,7673255,2562;7681;727832;100996331;123606;4948;57194;283694;81614;100287399;390538;2558;8924;114791;23742;7337;6638;2567;8926;283685;54551;4692;23191;283767,24
1,1,15,20733395,102511616,81778221,1445;548596;2242;80213;4058;79875;283694;390538;9399;123228;55505;161725;8483;10017;283685;653720;55055;283767;80031;9824;5923;84978;6692;196951;83640;10002;5045;23005;663;51762;653125;54962;170691;302;197135;145957;9488;390594;4947;3418;653641;1512;56964;145773;57519;9899;400359;29766;10509;49855;643338;80119;23184;4091;348110;10125;400410;1138;54832;10169;4240;51621;56965;246777;64410;619189;10239;6447;90527;84993;59274;204219;23015;10588;100820829;5597;4130;145788;161829;57538;27229;79834;11261;64963;9455;113201;10099;79631;25989;342132;9245;80301;23168;100505679;5046;8482;374659;57722;22801;100137047;7782;440270;29767;9051;146050;196993;161514;254531;56204;5479;197131;22856;342184;161582;9133;290;145781;8120;2200;53905;101059918;55272;4644;25820;2252;54629;1139;161753;90381;405753;80765;283677;646;9768;338949;57214;5604;115752;56963;220;80381;100133220;1159;6638;64397;50810;1544;54893;4122;55329;728498;5780;117155;5315;101928527;4123;283807;90427;8925;3671;10081;390616;51103;26263;100128108;84191;390637;9716;728047;79719;7681;2595;123606;390648;161502;56905;5371;5955;123264;51203;140691;1543;374654;6263;11339;23205;1133;23191;84465;91947;54822;7301;646892;5330;64864;100287399;84942;79664;58472;55897;1198;2038;23742;6642;56851;23604;4649;10302;23741;390595;80208;79661;10681;7090;145645;54617;9990;9153;3175;256586;8926;283710;6727;100131244;79968;9101;161779;8125;145942;55075;2628;9960;27023;123624;9154;5151;123263;123720;440279;85455;57617;5428;51332;10260;3480;79400;11214;10519;145741;283726;79029;54778;647042;145864;26108;64799;4828;50804;57194;51065;10066;2923;84419;79895;348093;257364;594855;8800;25942;23431;4351;123591;123169;123355;9543;100526783;57099;3419;10021;54839;113189;79748;5873;9836;256764;440295;4236;91433;23336;54956;54866;81556;342125;51285;90416;60677;2562;2184;6938;92912;100996331;11001;100505573;6652;145873;84529;1136;105376731;26035;56906;80153;1583;8773;123688;9055;64927;140460;348094;57369;55177;81488;9493;11057;192683;9915;5346;256646;3712;10620;123207;5888;2644;23269;23359;25764;8766;10363;55142;84206;10845;145853;28232;9325;23060;55898;55784;26015;100137049;3067;51324;10391;57082;390598;161835;1106;58489;8924;116179;4734;5607;54982;374618;79856;57184;2585;9236;440275;3706;283652;27079;9377;146059;51335;2553;283659;25963;145858;54878;6095;114294;8128;176;53339;727832;70;90525;56924;55323;4205;64784;55829;26682;64220;1464;771;8681;161823;9677;64782;388135;56160;90417;27020;55215;80349;83660;3669;366;91860;54939;283777;4212;388115;29106;585;4692;6176;342035;11173;10116;9728;54816;4916;9187;89978;1588;161742;23102;146057;83440;100528021;283742;30844;7337;641;26585;9333;644809;6124;10073;23582;145946;51458;64843;1143;8854;145748;400451;83464;3603;373509;55466;102;567;4088;84894;9318;6218;4948;3658;653643;8554;7026;80125;701;26276;2567;388121;6627;123283;643707;92483;7158;55070;255189;374655;79094;53944;55930;171177;1854;644844;10776;26589;51234;57188;64506;55192;51187;4643;3073;8826;22995;26258;79768;84888;55180;4308;4756;53346;7082;23478;54913;89832;9640;4016;84952;145814;11245;161497;79705;23423;8669;643699;55889;5685;22909;825;255252;106821730;3990;54567;7057;123722;2558;597;51495;6457;114791;22893;80237;196996;653073;54989;54993;6557;54551;50506;51496;1381;321;54852;390649;283748;23312;10933;399694;57611;6017;10518;2108;197021;89839;23251;80021;79811;123745;2958;23339;56986;81614;60490;388125;399697;84936;54469;342096;7168,568
-1,-1,15,20765649,22141158,1375509,100996331;100287399,2
-1,-1,15,20765649,22303901,1538252,100996331;100287399,2
1,-1,15,20765649,22509196,1743547,100996331;283694;100287399;390538,4
1,-1,15,20765649,22586922,1821273,100996331;283694;100287399;390538,4
1,-1,15,20765649,22586922,1821273,100996331;283694;100287399;390538,4
1,-1,15,20765649,22652060,1886411,100996331;283694;100287399;390538,4
1,-1,15,20765649,22652060,1886411,100996331;283694;100287399;390538,4
1,-1,15,20765649,22652060,1886411,100996331;283694;100287399;390538,4
-1,-1,15,20787762,22652060,1864298,100996331;283694;100287399;390538,4
1,-1,15,20787762,22652060,1864298,100996331;283694;100287399;390538,4
1,-1,15,20796186,22303901,1507715,100996331;100287399,2
1,-1,15,20796186,22409342,1613156,100996331;283694;100287399;390538,4
1,-1,15,20796186,22586922,1790736,100996331;283694;100287399;390538,4
1,-1,15,20796186,22652060,1855874,100996331;283694;100287399;390538,4
1,-1,15,20796186,22652060,1855874,100996331;283694;100287399;390538,4
1,-1,15,20796186,22652060,1855874,100996331;283694;100287399;390538,4
1,-1,15,20796186,22652060,1855874,100996331;283694;100287399;390538,4
1,-1,15,20796186,22652060,1855874,100996331;283694;100287399;390538,4
1,-1,15,20796186,22652060,1855874,100996331;283694;100287399;390538,4
1,-1,15,20816349,22267887,1451538,100996331;100287399,2
1,-1,15,20816349,22303901,1487552,100996331;100287399,2
1,-1,15,20816349,22332342,1515993,100996331;100287399,2
1,-1,15,20816349,22450180,1633831,100996331;283694;100287399;390538,4
1,-1,15,20816349,22558685,1742336,100996331;283694;100287399;390538,4
1,-1,15,20816349,22586922,1770573,100996331;283694;100287399;390538,4
1,-1,15,20816349,22652060,1835711,100996331;283694;100287399;390538,4
1,-1,15,20816349,22652060,1835711,100996331;283694;100287399;390538,4
1,-1,15,20816349,22652060,1835711,100996331;283694;100287399;390538,4
1,-1,15,20816349,22652060,1835711,100996331;283694;100287399;390538,4
1,-1,15,20816349,22652060,1835711,100996331;283694;100287399;390538,4
1,-1,15,20816349,22652060,1835711,100996331;283694;100287399;390538,4
1,-1,15,20816349,22652060,1835711,100996331;283694;100287399;390538,4
1,-1,15,20816349,22652060,1835711,100996331;283694;100287399;390538,4
1,-1,15,20816349,22652060,1835711,100996331;283694;100287399;390538,4
1,-1,15,20816349,22652060,1835711,100996331;283694;100287399;390538,4
1,-1,15,20816349,22652060,1835711,100996331;283694;100287399;390538,4
1,-1,15,20816349,22652060,1835711,100996331;283694;100287399;390538,4
1,-1,15,20816349,22652060,1835711,100996331;283694;100287399;390538,4
1,-1,15,20816349,22652060,1835711,100996331;283694;100287399;390538,4
1,-1,15,20816349,22652060,1835711,100996331;283694;100287399;390538,4
1,-1,15,20816349,22652060,1835711,100996331;283694;100287399;390538,4
1,-1,15,20816349,22652060,1835711,100996331;283694;100287399;390538,4
1,-1,15,20816349,22663583,1847234,100996331;283694;100287399;390538,4
1,-1,15,20816349,22663583,1847234,100996331;283694;100287399;390538,4
1,-1,15,20816349,22663583,1847234,100996331;283694;100287399;390538,4
1,-1,15,20816349,22663583,1847234,100996331;283694;100287399;390538,4
1,-1,15,20816349,22684152,1867803,100996331;283694;100287399;390538,4
1,-1,15,20816349,22684152,1867803,100996331;283694;100287399;390538,4
1,-1,15,20816349,22684152,1867803,100996331;283694;100287399;390538,4
1,-1,15,20816349,22684152,1867803,100996331;283694;100287399;390538,4
1,-1,15,20816349,22684152,1867803,100996331;283694;100287399;390538,4
1,-1,15,20816349,22684501,1868152,100996331;283694;100287399;390538,4
-1,-1,15,21071443,22558726,1487283,100996331;390538;283694;100287399,4
-1,-1,15,21071443,22589782,1518339,100996331;390538;283694;100287399,4
-1,-1,15,21071443,22589782,1518339,100996331;390538;283694;100287399,4
-1,-1,15,21979073,22698568,719495,390538;283694;100996331,3
1,-1,15,21129984,22318626,1188642,100996331,1
1,-1,15,21142955,21272405,129450,,0
1,-1,15,21200729,22648468,1447739,390538;283694;100996331,3
1,-1,15,21230379,22652060,1421681,390538;283694;100996331,3
1,-1,15,21272460,22652060,1379600,390538;283694;100996331,3
1,-1,15,21272460,22652060,1379600,390538;283694;100996331,3
1,-1,15,21272460,22652060,1379600,390538;283694;100996331,3
1,-1,15,21272460,22652060,1379600,390538;283694;100996331,3
1,-1,15,21272460,22652060,1379600,390538;283694;100996331,3
1,-1,15,21272460,22652060,1379600,390538;283694;100996331,3
1,-1,15,21272460,22652060,1379600,390538;283694;100996331,3
1,-1,15,21272460,22762571,1490111,390538;283694;283767;100996331,4
1,-1,15,21310163,22762571,1452408,390538;283694;283767;100996331,4
1,-1,15,21336136,22684152,1348016,390538;283694;100996331,3
1,-1,15,21336136,22684152,1348016,390538;283694;100996331,3
1,-1,15,21336136,22684152,1348016,390538;283694;100996331,3
1,-1,15,21336136,22684501,1348365,390538;283694;100996331,3
1,-1,15,21365551,22684152,1318601,390538;283694;100996331,3
-1,-1,15,21381757,22652060,1270303,390538;283694;100996331,3
-1,-1,15,21381757,22652060,1270303,390538;283694;100996331,3
-1,-1,15,21381757,22652060,1270303,390538;283694;100996331,3
-1,-1,15,21381757,22652060,1270303,390538;283694;100996331,3
-1,-1,15,21381757,22652060,1270303,390538;283694;100996331,3
-1,-1,15,21381757,22652060,1270303,390538;283694;100996331,3
-1,-1,15,21381757,22652060,1270303,390538;283694;100996331,3
-1,-1,15,21381757,22652060,1270303,390538;283694;100996331,3
-1,-1,15,21381757,22652060,1270303,390538;283694;100996331,3
-1,-1,15,21381757,22652060,1270303,390538;283694;100996331,3
-1,-1,15,21381757,22652060,1270303,390538;283694;100996331,3
-1,-1,15,21381757,22652060,1270303,390538;283694;100996331,3
-1,-1,15,21381757,22652060,1270303,390538;283694;100996331,3
-1,-1,15,21381757,22652060,1270303,390538;283694;100996331,3
-1,-1,15,21381757,22652060,1270303,390538;283694;100996331,3
-1,-1,15,21381757,22652060,1270303,390538;283694;100996331,3
-1,-1,15,21381757,22652060,1270303,390538;283694;100996331,3
-1,-1,15,21381757,22652060,1270303,390538;283694;100996331,3
-1,-1,15,21381757,22652060,1270303,390538;283694;100996331,3
-1,-1,15,21381757,22652060,1270303,390538;283694;100996331,3
-1,-1,15,21381757,22652060,1270303,390538;283694;100996331,3
-1,-1,15,21381757,22652060,1270303,390538;283694;100996331,3
-1,-1,15,21381757,22652060,1270303,390538;283694;100996331,3
-1,-1,15,21381757,22652060,1270303,390538;283694;100996331,3
-1,-1,15,21381757,22652060,1270303,390538;283694;100996331,3
-1,-1,15,21381757,22652060,1270303,390538;283694;100996331,3
-1,-1,15,21381757,22652060,1270303,390538;283694;100996331,3
1,-1,15,21381757,22762571,1380814,390538;283694;283767;100996331,4
1,-1,15,21381757,22762571,1380814,390538;283694;283767;100996331,4
1,-1,15,21381757,22762571,1380814,390538;283694;283767;100996331,4
-1,-1,15,22267946,22652060,384114,390538;283694,2
-1,-1,15,22267946,22652060,384114,390538;283694,2
-1,-1,15,22267946,22652060,384114,390538;283694,2
-1,-1,15,22267946,22652060,384114,390538;283694,2
-1,-1,15,22267946,22652060,384114,390538;283694,2
-1,-1,15,22303901,22558744,254843,390538;283694,2
-1,-1,15,22285307,22652060,366753,390538;283694,2
-1,-1,15,22285307,22652060,366753,390538;283694,2
-1,-1,15,22285307,22652060,366753,390538;283694,2
-1,-1,15,22285307,22652060,366753,390538;283694,2
-1,-1,15,22285307,22652060,366753,390538;283694,2
-1,-1,15,22285307,22652060,366753,390538;283694,2
-1,-1,15,22285307,22652060,366753,390538;283694,2
-1,-1,15,22285307,22652060,366753,390538;283694,2
-1,-1,15,22285307,22652060,366753,390538;283694,2
-1,-1,15,22285307,22652060,366753,390538;283694,2
-1,-1,15,22285307,22652060,366753,390538;283694,2
-1,-1,15,22285307,22652060,366753,390538;283694,2
-1,-1,15,22285307,22652060,366753,390538;283694,2
-1,-1,15,22285307,22652060,366753,390538;283694,2
-1,-1,15,22285307,22652060,366753,390538;283694,2
-1,-1,15,22285307,22652060,366753,390538;283694,2
-1,-1,15,22285307,22652060,366753,390538;283694,2
-1,-1,15,22285307,22652060,366753,390538;283694,2
-1,-1,15,22285307,22652060,366753,390538;283694,2
-1,-1,15,22285307,22652060,366753,390538;283694,2
-1,-1,15,22285307,22652060,366753,390538;283694,2
-1,-1,15,22285307,22652060,366753,390538;283694,2
-1,-1,15,22285307,22652060,366753,390538;283694,2
-1,-1,15,22285307,22652060,366753,390538;283694,2
-1,-1,15,22285307,22652060,366753,390538;283694,2
-1,-1,15,22285307,22652060,366753,390538;283694,2
-1,-1,15,22285307,22652060,366753,390538;283694,2
-1,-1,15,22285307,22652060,366753,390538;283694,2
-1,-1,15,22285307,22652060,366753,390538;283694,2
-1,-1,15,22285307,22652060,366753,390538;283694,2
-1,-1,15,22285307,22652060,366753,390538;283694,2
-1,-1,15,22285307,22652060,366753,390538;283694,2
-1,-1,15,22285307,22652060,366753,390538;283694,2
-1,-1,15,22285307,22652060,366753,390538;283694,2
-1,-1,15,22285307,22652060,366753,390538;283694,2
-1,-1,15,22285307,22652060,366753,390538;283694,2
-1,-1,15,22285307,22663583,378276,390538;283694,2
1,-1,15,22285320,22589782,304462,390538;283694,2
-1,-1,15,22285321,22648468,363147,390538;283694,2
1,1,15,22304596,28577787,6273191,2562;7681;123606;4948;57194;283694;81614;390538;2558;8924;114791;23742;7337;6638;2567;8926;283685;54551;4692;23191;283767,21
-1,-1,15,22304626,22589782,285156,390538;283694,2
-1,-1,15,22304626,22589782,285156,390538;283694,2
-1,-1,15,22304626,22589782,285156,390538;283694,2
1,-1,15,22304626,22698552,393926,390538;283694,2
1,1,15,22318644,29209620,6890976,2562;7681;123606;4948;57194;283694;81614;390538;2558;8924;114791;23742;7337;6638;2567;8926;283685;653720;54551;4692;23191;283767,22
1,1,15,22409401,28952953,6543552,2562;7681;123606;4948;57194;81614;2558;8924;114791;23742;7337;6638;2567;8926;283685;653720;54551;4692;23191;283767,20
-1,1,15,22652047,28726590,6074543,2562;7681;123606;4948;57194;81614;2558;8924;114791;23742;7337;6638;2567;8926;283685;54551;4692;23191;283767,19
1,-1,15,22652060,22698579,46519,,0
1,1,15,22652060,28883749,6231689,2562;7681;123606;4948;57194;81614;2558;8924;114791;23742;7337;6638;2567;8926;283685;54551;4692;23191;283767,19
-1,-1,15,22698522,23086303,387781,123606;114791;81614;23191;283767,5
1,-1,15,22698522,23146132,447610,123606;114791;81614;23191;283767,5
-1,-1,15,22698522,23217514,518992,123606;114791;81614;23191;283767,5
-1,-1,15,22698522,23217514,518992,123606;114791;81614;23191;283767,5
1,-1,15,22698522,23217514,518992,123606;114791;81614;23191;283767,5
1,-1,15,22698522,23217514,518992,123606;114791;81614;23191;283767,5
-1,-1,15,22698522,23260514,561992,123606;114791;81614;23191;283767,5
-1,-1,15,22698522,23260514,561992,123606;114791;81614;23191;283767,5
1,-1,15,22698522,23300287,601765,123606;114791;81614;23191;283767,5
1,-1,15,22698522,23300287,601765,123606;114791;81614;23191;283767,5
-1,-1,15,22698522,23300287,601765,123606;114791;81614;23191;283767,5
-1,-1,15,22698522,23300287,601765,123606;114791;81614;23191;283767,5
-1,-1,15,22698522,23300287,601765,123606;114791;81614;23191;283767,5
-1,-1,15,22698522,23300287,601765,123606;114791;81614;23191;283767,5
-1,-1,15,22698522,23300287,601765,123606;114791;81614;23191;283767,5
-1,-1,15,22698522,23300287,601765,123606;114791;81614;23191;283767,5
-1,-1,15,22698522,23300287,601765,123606;114791;81614;23191;283767,5
-1,-1,15,22698522,23300287,601765,123606;114791;81614;23191;283767,5
-1,1,15,22698522,28406650,5708128,2562;7681;123606;4948;57194;81614;2558;8924;114791;23742;7337;6638;2567;8926;283685;54551;4692;23191;283767,19
-1,1,15,22698522,28406650,5708128,2562;7681;123606;4948;57194;81614;2558;8924;114791;23742;7337;6638;2567;8926;283685;54551;4692;23191;283767,19
-1,1,15,22698522,28406650,5708128,2562;7681;123606;4948;57194;81614;2558;8924;114791;23742;7337;6638;2567;8926;283685;54551;4692;23191;283767,19
-1,1,15,22698522,28557186,5858664,2562;7681;123606;4948;57194;81614;2558;8924;114791;23742;7337;6638;2567;8926;283685;54551;4692;23191;283767,19
-1,1,15,22698522,28691460,5992938,2562;7681;123606;4948;57194;81614;2558;8924;114791;23742;7337;6638;2567;8926;283685;54551;4692;23191;283767,19
-1,1,15,22698522,28691460,5992938,2562;7681;123606;4948;57194;81614;2558;8924;114791;23742;7337;6638;2567;8926;283685;54551;4692;23191;283767,19
1,1,15,22698522,28940098,6241576,2562;7681;123606;4948;57194;81614;2558;8924;114791;23742;7337;6638;2567;8926;283685;54551;4692;23191;283767,19
1,1,15,22698522,29030517,6331995,2562;7681;123606;4948;57194;81614;2558;8924;114791;23742;7337;6638;2567;8926;283685;653720;54551;4692;23191;283767,20
-1,1,15,22698522,29030517,6331995,2562;7681;123606;4948;57194;81614;2558;8924;114791;23742;7337;6638;2567;8926;283685;653720;54551;4692;23191;283767,20
-1,1,15,22698522,29030517,6331995,2562;7681;123606;4948;57194;81614;2558;8924;114791;23742;7337;6638;2567;8926;283685;653720;54551;4692;23191;283767,20
1,1,15,22698522,29030517,6331995,2562;7681;123606;4948;57194;81614;2558;8924;114791;23742;7337;6638;2567;8926;283685;653720;54551;4692;23191;283767,20
1,1,15,22698522,29085896,6387374,2562;7681;123606;4948;57194;81614;2558;8924;114791;23742;7337;6638;2567;8926;283685;653720;54551;4692;23191;283767,20
-1,1,15,22698522,29085896,6387374,2562;7681;123606;4948;57194;81614;2558;8924;114791;23742;7337;6638;2567;8926;283685;653720;54551;4692;23191;283767,20
-1,1,15,22698522,29085896,6387374,2562;7681;123606;4948;57194;81614;2558;8924;114791;23742;7337;6638;2567;8926;283685;653720;54551;4692;23191;283767,20
1,1,15,22698522,30366124,7667602,321;7681;2562;123606;4948;57194;81614;2558;23359;7082;8924;114791;23742;7337;6638;2567;8926;283685;653720;54551;4692;23191;283767;56160,24
1,1,15,22698522,30366124,7667602,321;7681;2562;123606;4948;57194;81614;2558;23359;7082;8924;114791;23742;7337;6638;2567;8926;283685;653720;54551;4692;23191;283767;56160,24
1,1,15,22698522,30366124,7667602,321;7681;2562;123606;4948;57194;81614;2558;23359;7082;8924;114791;23742;7337;6638;2567;8926;283685;653720;54551;4692;23191;283767;56160,24
1,1,15,22698522,30653936,7955414,321;7681;2562;123606;4948;57194;81614;2558;23359;7082;8924;114791;23742;7337;6638;89832;653073;2567;8926;283685;653720;54551;4692;23191;283767;56160,26
-1,1,15,22698522,38381783,15683261,23015;57099;643699;9990;6638;22909;55505;8926;161725;283710;283685;653720;54893;283767;728498;2562;9824;70;161779;4948;145942;2558;84529;114791;653125;653073;2567;54989;54551;56160;9716;57369;728047;321;7681;440270;256646;123606;23359;6263;254531;4212;342184;89839;4692;1133;51234;23191;101059918;79768;89978;57194;81614;4308;1139;7082;8924;23742;51621;7337;89832;26585;56851;6447,64
-1,-1,15,22765628,23076420,310792,123606;23191;114791;81614,4
-1,-1,15,22765628,23082821,317193,123606;23191;114791;81614,4
-1,1,15,22765628,23085096,319468,123606;23191;114791;81614,4
-1,-1,15,22765628,23086303,320675,123606;23191;114791;81614,4
-1,1,15,22765628,23146132,380504,123606;23191;114791;81614,4
1,-1,15,22765628,23217514,451886,123606;23191;114791;81614,4
1,-1,15,22765628,23217514,451886,123606;23191;114791;81614,4
-1,-1,15,22765628,23260514,494886,123606;23191;114791;81614,4
-1,-1,15,22765628,23260514,494886,123606;23191;114791;81614,4
-1,-1,15,22765628,23300287,534659,123606;23191;114791;81614,4
-1,-1,15,22765628,23300287,534659,123606;23191;114791;81614,4
1,1,15,22765628,28520313,5754685,2562;7681;123606;4948;57194;81614;2558;8924;114791;23742;7337;6638;2567;8926;283685;54551;4692;23191,18
1,1,15,22765628,28557186,5791558,2562;7681;123606;4948;57194;81614;2558;8924;114791;23742;7337;6638;2567;8926;283685;54551;4692;23191,18
-1,1,15,22765628,28557186,5791558,2562;7681;123606;4948;57194;81614;2558;8924;114791;23742;7337;6638;2567;8926;283685;54551;4692;23191,18
1,1,15,22765628,28557186,5791558,2562;7681;123606;4948;57194;81614;2558;8924;114791;23742;7337;6638;2567;8926;283685;54551;4692;23191,18
-1,1,15,22765628,28691460,5925832,2562;7681;123606;4948;57194;81614;2558;8924;114791;23742;7337;6638;2567;8926;283685;54551;4692;23191,18
-1,1,15,22765628,28691460,5925832,2562;7681;123606;4948;57194;81614;2558;8924;114791;23742;7337;6638;2567;8926;283685;54551;4692;23191,18
-1,1,15,22765628,28912057,6146429,2562;7681;123606;4948;57194;81614;2558;8924;114791;23742;7337;6638;2567;8926;283685;54551;4692;23191,18
-1,1,15,22765628,28912057,6146429,2562;7681;123606;4948;57194;81614;2558;8924;114791;23742;7337;6638;2567;8926;283685;54551;4692;23191,18
1,1,15,22765628,28912057,6146429,2562;7681;123606;4948;57194;81614;2558;8924;114791;23742;7337;6638;2567;8926;283685;54551;4692;23191,18
-1,1,15,22765628,28940098,6174470,2562;7681;123606;4948;57194;81614;2558;8924;114791;23742;7337;6638;2567;8926;283685;54551;4692;23191,18
-1,1,15,22765628,28976193,6210565,2562;7681;123606;4948;57194;81614;2558;8924;114791;23742;7337;6638;2567;8926;283685;653720;54551;4692;23191,19
1,1,15,22765628,29006852,6241224,2562;7681;123606;4948;57194;81614;2558;8924;114791;23742;7337;6638;2567;8926;283685;653720;54551;4692;23191,19
1,1,15,22765628,29006852,6241224,2562;7681;123606;4948;57194;81614;2558;8924;114791;23742;7337;6638;2567;8926;283685;653720;54551;4692;23191,19
1,1,15,22765628,29006852,6241224,2562;7681;123606;4948;57194;81614;2558;8924;114791;23742;7337;6638;2567;8926;283685;653720;54551;4692;23191,19
1,1,15,22765628,29085896,6320268,2562;7681;123606;4948;57194;81614;2558;8924;114791;23742;7337;6638;2567;8926;283685;653720;54551;4692;23191,19
1,1,15,22765628,29096442,6330814,2562;7681;123606;4948;57194;81614;2558;8924;114791;23742;7337;6638;2567;8926;283685;653720;54551;4692;23191,19
1,1,15,22765628,30366124,7600496,321;7681;2562;123606;4948;57194;81614;2558;23359;7082;8924;114791;23742;7337;6638;2567;8926;283685;653720;54551;4692;23191;56160,23
1,1,15,22765628,30366124,7600496,321;7681;2562;123606;4948;57194;81614;2558;23359;7082;8924;114791;23742;7337;6638;2567;8926;283685;653720;54551;4692;23191;56160,23
1,1,15,22765628,30366124,7600496,321;7681;2562;123606;4948;57194;81614;2558;23359;7082;8924;114791;23742;7337;6638;2567;8926;283685;653720;54551;4692;23191;56160,23
1,1,15,22765628,30366124,7600496,321;7681;2562;123606;4948;57194;81614;2558;23359;7082;8924;114791;23742;7337;6638;2567;8926;283685;653720;54551;4692;23191;56160,23
1,1,15,22765628,30653936,7888308,321;7681;2562;123606;4948;57194;81614;2558;23359;7082;8924;114791;23742;7337;6638;89832;653073;2567;8926;283685;653720;54551;4692;23191;56160,25
1,1,15,22765628,30819509,8053881,321;7681;2562;101059918;123606;4948;57194;81614;2558;23359;7082;8924;114791;23742;7337;6638;89832;653073;2567;8926;283685;653720;54551;4692;23191;56160,26
1,1,15,22765628,30819509,8053881,321;7681;2562;101059918;123606;4948;57194;81614;2558;23359;7082;8924;114791;23742;7337;6638;89832;653073;2567;8926;283685;653720;54551;4692;23191;56160,26
1,1,15,22765628,30819509,8053881,321;7681;2562;101059918;123606;4948;57194;81614;2558;23359;7082;8924;114791;23742;7337;6638;89832;653073;2567;8926;283685;653720;54551;4692;23191;56160,26
1,1,15,22765628,30819509,8053881,321;7681;2562;101059918;123606;4948;57194;81614;2558;23359;7082;8924;114791;23742;7337;6638;89832;653073;2567;8926;283685;653720;54551;4692;23191;56160,26
-1,1,15,22765628,32676855,9911227,321;7681;123606;23359;6638;22909;8926;161725;283710;283685;653720;89839;4692;54893;23191;728498;2562;101059918;4948;57194;81614;4308;2558;1139;7082;8924;114791;23742;51621;7337;89832;653073;2567;54551;56160,35
1,1,15,22765628,38837526,16071898,23015;57099;643699;9990;6638;22909;55505;8926;161725;283710;283685;653720;54893;728498;2562;9824;70;161779;4948;145942;2558;84529;114791;653125;653073;2567;54989;54551;56160;9716;57369;728047;321;7681;440270;256646;123606;23359;6263;254531;4212;342184;89839;4692;1133;51234;23191;101059918;10125;79768;89978;57194;161742;81614;4308;283742;1139;7082;8924;23742;51621;7337;89832;26585;56851;6447,66
1,-1,15,22765637,23085235,319598,123606;23191;114791;81614,4
1,-1,15,22765637,23085235,319598,123606;23191;114791;81614,4
1,-1,15,22765637,23146102,380465,123606;23191;114791;81614,4
1,-1,15,22765637,23217513,451876,123606;23191;114791;81614,4
1,-1,15,22765637,23217513,451876,123606;23191;114791;81614,4
1,-1,15,22765637,23217513,451876,123606;23191;114791;81614,4
1,-1,15,22765637,23300313,534676,123606;23191;114791;81614,4
1,-1,15,22765637,23300313,534676,123606;23191;114791;81614,4
-1,-1,15,22765637,23403639,638002,123606;23191;114791;81614,4
1,1,15,22765637,28520316,5754679,2562;7681;123606;4948;57194;81614;2558;8924;114791;23742;7337;6638;2567;8926;283685;54551;4692;23191,18
1,1,15,22765637,29085888,6320251,2562;7681;123606;4948;57194;81614;2558;8924;114791;23742;7337;6638;2567;8926;283685;653720;54551;4692;23191,19
-1,1,15,22765637,29085888,6320251,2562;7681;123606;4948;57194;81614;2558;8924;114791;23742;7337;6638;2567;8926;283685;653720;54551;4692;23191,19
1,1,15,22765637,29085888,6320251,2562;7681;123606;4948;57194;81614;2558;8924;114791;23742;7337;6638;2567;8926;283685;653720;54551;4692;23191,19
1,1,15,22765637,30366079,7600442,321;7681;2562;123606;4948;57194;81614;2558;23359;7082;8924;114791;23742;7337;6638;2567;8926;283685;653720;54551;4692;23191;56160,23
1,1,15,22765637,31467435,8701798,728498;321;7681;2562;101059918;54551;123606;4948;57194;81614;4308;2558;23359;7082;8924;114791;23742;7337;6638;89832;22909;653073;2567;8926;283685;653720;89839;4692;54893;23191;56160,31
1,1,15,22765637,32509932,9744295,321;7681;123606;23359;6638;22909;8926;161725;283710;283685;653720;89839;4692;54893;23191;728498;2562;101059918;4948;57194;81614;4308;2558;1139;7082;8924;114791;23742;51621;7337;89832;653073;2567;54551;56160,35
1,1,15,22765637,32899558,10133921,321;7681;123606;643699;23359;6638;22909;8926;161725;283710;283685;653720;89839;4692;54893;23191;728498;2562;101059918;4948;57194;81614;4308;2558;1139;7082;8924;114791;23742;51621;7337;89832;653125;653073;2567;54551;728047;56160,38
-1,1,15,22770421,23082328,311907,123606;23191;114791;81614,4
-1,1,15,22770421,23082328,311907,123606;23191;114791;81614,4
-1,1,15,22770421,23082328,311907,123606;23191;114791;81614,4
-1,1,15,22770421,23082328,311907,123606;23191;114791;81614,4
-1,1,15,22770421,23082328,311907,123606;23191;114791;81614,4
-1,1,15,22770421,23082328,311907,123606;23191;114791;81614,4
-1,1,15,22770421,23082328,311907,123606;23191;114791;81614,4
-1,1,15,22770421,23082328,311907,123606;23191;114791;81614,4
-1,1,15,22770421,23191651,421230,123606;23191;114791;81614,4
-1,1,15,22770421,23191651,421230,123606;23191;114791;81614,4
-1,1,15,22770421,23191761,421340,123606;23191;114791;81614,4
-1,1,15,22770421,23195725,425304,123606;23191;114791;81614,4
-1,1,15,22770421,23195725,425304,123606;23191;114791;81614,4
-1,1,15,22770421,23206905,436484,123606;23191;114791;81614,4
-1,1,15,22770421,23213566,443145,123606;23191;114791;81614,4
-1,1,15,22770421,23282799,512378,123606;23191;114791;81614,4
-1,1,15,22770421,23282799,512378,123606;23191;114791;81614,4
-1,1,15,22770421,23282799,512378,123606;23191;114791;81614,4
-1,1,15,22770421,23282799,512378,123606;23191;114791;81614,4
-1,1,15,22770421,23282905,512484,123606;23191;114791;81614,4
-1,1,15,22770421,23282905,512484,123606;23191;114791;81614,4
-1,1,15,22770421,23282976,512555,123606;23191;114791;81614,4
-1,1,15,22770421,23283811,513390,123606;23191;114791;81614,4
-1,1,15,22770421,23290819,520398,123606;23191;114791;81614,4
-1,1,15,22770421,23291159,520738,123606;23191;114791;81614,4
-1,1,15,22770421,28415107,5644686,2562;7681;123606;4948;57194;81614;2558;8924;114791;23742;7337;6638;2567;8926;283685;54551;4692;23191,18
-1,1,15,22770421,28419123,5648702,2562;7681;123606;4948;57194;81614;2558;8924;114791;23742;7337;6638;2567;8926;283685;54551;4692;23191,18
-1,1,15,22770421,28527747,5757326,2562;7681;123606;4948;57194;81614;2558;8924;114791;23742;7337;6638;2567;8926;283685;54551;4692;23191,18
1,1,15,22770421,28527747,5757326,2562;7681;123606;4948;57194;81614;2558;8924;114791;23742;7337;6638;2567;8926;283685;54551;4692;23191,18
1,1,15,22770421,28534245,5763824,2562;7681;123606;4948;57194;81614;2558;8924;114791;23742;7337;6638;2567;8926;283685;54551;4692;23191,18
-1,1,15,22770421,28534458,5764037,2562;7681;123606;4948;57194;81614;2558;8924;114791;23742;7337;6638;2567;8926;283685;54551;4692;23191,18
-1,1,15,22770421,28539975,5769554,2562;7681;123606;4948;57194;81614;2558;8924;114791;23742;7337;6638;2567;8926;283685;54551;4692;23191,18
-1,1,15,22770421,28545355,5774934,2562;7681;123606;4948;57194;81614;2558;8924;114791;23742;7337;6638;2567;8926;283685;54551;4692;23191,18
-1,1,15,22770421,28545355,5774934,2562;7681;123606;4948;57194;81614;2558;8924;114791;23742;7337;6638;2567;8926;283685;54551;4692;23191,18
-1,1,15,22770421,28560269,5789848,2562;7681;123606;4948;57194;81614;2558;8924;114791;23742;7337;6638;2567;8926;283685;54551;4692;23191,18
1,1,15,22770421,28561670,5791249,2562;7681;123606;4948;57194;81614;2558;8924;114791;23742;7337;6638;2567;8926;283685;54551;4692;23191,18
-1,1,15,22770421,28561671,5791250,2562;7681;123606;4948;57194;81614;2558;8924;114791;23742;7337;6638;2567;8926;283685;54551;4692;23191,18
1,1,15,22770421,28644578,5874157,2562;7681;123606;4948;57194;81614;2558;8924;114791;23742;7337;6638;2567;8926;283685;54551;4692;23191,18
-1,1,15,22770421,28660038,5889617,2562;7681;123606;4948;57194;81614;2558;8924;114791;23742;7337;6638;2567;8926;283685;54551;4692;23191,18
1,1,15,22770421,28660038,5889617,2562;7681;123606;4948;57194;81614;2558;8924;114791;23742;7337;6638;2567;8926;283685;54551;4692;23191,18
-1,1,15,22770421,28704050,5933629,2562;7681;123606;4948;57194;81614;2558;8924;114791;23742;7337;6638;2567;8926;283685;54551;4692;23191,18
-1,1,15,22770421,28709715,5939294,2562;7681;123606;4948;57194;81614;2558;8924;114791;23742;7337;6638;2567;8926;283685;54551;4692;23191,18
-1,1,15,22770421,28709715,5939294,2562;7681;123606;4948;57194;81614;2558;8924;114791;23742;7337;6638;2567;8926;283685;54551;4692;23191,18
-1,1,15,22770421,28723454,5953033,2562;7681;123606;4948;57194;81614;2558;8924;114791;23742;7337;6638;2567;8926;283685;54551;4692;23191,18
-1,1,15,22770421,28723454,5953033,2562;7681;123606;4948;57194;81614;2558;8924;114791;23742;7337;6638;2567;8926;283685;54551;4692;23191,18
-1,1,15,22770421,28723454,5953033,2562;7681;123606;4948;57194;81614;2558;8924;114791;23742;7337;6638;2567;8926;283685;54551;4692;23191,18
-1,1,15,22770421,28723454,5953033,2562;7681;123606;4948;57194;81614;2558;8924;114791;23742;7337;6638;2567;8926;283685;54551;4692;23191,18
-1,1,15,22770421,28723454,5953033,2562;7681;123606;4948;57194;81614;2558;8924;114791;23742;7337;6638;2567;8926;283685;54551;4692;23191,18
-1,1,15,22770421,28723454,5953033,2562;7681;123606;4948;57194;81614;2558;8924;114791;23742;7337;6638;2567;8926;283685;54551;4692;23191,18
-1,1,15,22770421,28723454,5953033,2562;7681;123606;4948;57194;81614;2558;8924;114791;23742;7337;6638;2567;8926;283685;54551;4692;23191,18
-1,1,15,22770421,28823722,6053301,2562;7681;123606;4948;57194;81614;2558;8924;114791;23742;7337;6638;2567;8926;283685;54551;4692;23191,18
-1,1,15,22770421,28823722,6053301,2562;7681;123606;4948;57194;81614;2558;8924;114791;23742;7337;6638;2567;8926;283685;54551;4692;23191,18
-1,1,15,22770421,28823722,6053301,2562;7681;123606;4948;57194;81614;2558;8924;114791;23742;7337;6638;2567;8926;283685;54551;4692;23191,18
1,1,15,22770421,28823722,6053301,2562;7681;123606;4948;57194;81614;2558;8924;114791;23742;7337;6638;2567;8926;283685;54551;4692;23191,18
-1,1,15,22770421,28823722,6053301,2562;7681;123606;4948;57194;81614;2558;8924;114791;23742;7337;6638;2567;8926;283685;54551;4692;23191,18
-1,1,15,22770421,28823722,6053301,2562;7681;123606;4948;57194;81614;2558;8924;114791;23742;7337;6638;2567;8926;283685;54551;4692;23191,18
-1,1,15,22770421,28823722,6053301,2562;7681;123606;4948;57194;81614;2558;8924;114791;23742;7337;6638;2567;8926;283685;54551;4692;23191,18
-1,1,15,22770421,28828168,6057747,2562;7681;123606;4948;57194;81614;2558;8924;114791;23742;7337;6638;2567;8926;283685;54551;4692;23191,18
-1,1,15,22770421,28915864,6145443,2562;7681;123606;4948;57194;81614;2558;8924;114791;23742;7337;6638;2567;8926;283685;54551;4692;23191,18
1,1,15,22770421,28915864,6145443,2562;7681;123606;4948;57194;81614;2558;8924;114791;23742;7337;6638;2567;8926;283685;54551;4692;23191,18
1,1,15,22770421,28928730,6158309,2562;7681;123606;4948;57194;81614;2558;8924;114791;23742;7337;6638;2567;8926;283685;54551;4692;23191,18
-1,1,15,22770421,28928730,6158309,2562;7681;123606;4948;57194;81614;2558;8924;114791;23742;7337;6638;2567;8926;283685;54551;4692;23191,18
-1,1,15,22770421,28928730,6158309,2562;7681;123606;4948;57194;81614;2558;8924;114791;23742;7337;6638;2567;8926;283685;54551;4692;23191,18
1,1,15,22770421,28958779,6188358,2562;7681;123606;4948;57194;81614;2558;8924;114791;23742;7337;6638;2567;8926;283685;653720;54551;4692;23191,19
1,1,15,22770421,28958779,6188358,2562;7681;123606;4948;57194;81614;2558;8924;114791;23742;7337;6638;2567;8926;283685;653720;54551;4692;23191,19
1,1,15,22770421,29009042,6238621,2562;7681;123606;4948;57194;81614;2558;8924;114791;23742;7337;6638;2567;8926;283685;653720;54551;4692;23191,19
-1,1,15,22770421,29021034,6250613,2562;7681;123606;4948;57194;81614;2558;8924;114791;23742;7337;6638;2567;8926;283685;653720;54551;4692;23191,19
1,1,15,22770421,29062203,6291782,2562;7681;123606;4948;57194;81614;2558;8924;114791;23742;7337;6638;2567;8926;283685;653720;54551;4692;23191,19
-1,1,15,22770421,29062203,6291782,2562;7681;123606;4948;57194;81614;2558;8924;114791;23742;7337;6638;2567;8926;283685;653720;54551;4692;23191,19
1,1,15,22770421,29069001,6298580,2562;7681;123606;4948;57194;81614;2558;8924;114791;23742;7337;6638;2567;8926;283685;653720;54551;4692;23191,19
-1,1,15,22770421,29081921,6311500,2562;7681;123606;4948;57194;81614;2558;8924;114791;23742;7337;6638;2567;8926;283685;653720;54551;4692;23191,19
1,1,15,22770421,30369944,7599523,321;7681;2562;123606;4948;57194;81614;2558;23359;7082;8924;114791;23742;7337;6638;2567;8926;283685;653720;54551;4692;23191;56160,23
1,1,15,22770421,30386398,7615977,321;7681;2562;123606;4948;57194;81614;2558;23359;7082;8924;114791;23742;7337;6638;653073;2567;8926;283685;653720;54551;4692;23191;56160,24
1,1,15,22770421,30386398,7615977,321;7681;2562;123606;4948;57194;81614;2558;23359;7082;8924;114791;23742;7337;6638;653073;2567;8926;283685;653720;54551;4692;23191;56160,24
1,1,15,22770421,30386398,7615977,321;7681;2562;123606;4948;57194;81614;2558;23359;7082;8924;114791;23742;7337;6638;653073;2567;8926;283685;653720;54551;4692;23191;56160,24
1,1,15,22770421,30386553,7616132,321;7681;2562;123606;4948;57194;81614;2558;23359;7082;8924;114791;23742;7337;6638;653073;2567;8926;283685;653720;54551;4692;23191;56160,24
1,1,15,22770421,30386553,7616132,321;7681;2562;123606;4948;57194;81614;2558;23359;7082;8924;114791;23742;7337;6638;653073;2567;8926;283685;653720;54551;4692;23191;56160,24
1,1,15,22770421,30386553,7616132,321;7681;2562;123606;4948;57194;81614;2558;23359;7082;8924;114791;23742;7337;6638;653073;2567;8926;283685;653720;54551;4692;23191;56160,24
1,1,15,22770421,31073669,8303248,728498;321;7681;2562;101059918;54551;123606;4948;57194;81614;2558;23359;7082;8924;114791;23742;7337;6638;89832;653073;2567;8926;283685;653720;89839;4692;23191;56160,28
1,1,15,22770421,31073669,8303248,728498;321;7681;2562;101059918;54551;123606;4948;57194;81614;2558;23359;7082;8924;114791;23742;7337;6638;89832;653073;2567;8926;283685;653720;89839;4692;23191;56160,28
1,1,15,22770421,31122895,8352474,728498;321;7681;2562;101059918;54551;123606;4948;57194;81614;2558;23359;7082;8924;114791;23742;7337;6638;89832;653073;2567;8926;283685;653720;89839;4692;23191;56160,28
-1,1,15,22770421,31760986,8990565,321;7681;123606;23359;6638;22909;8926;283710;283685;653720;89839;4692;54893;23191;728498;2562;101059918;4948;57194;81614;4308;2558;7082;8924;114791;23742;51621;7337;89832;653073;2567;54551;56160,33
1,1,15,22770421,33707835,10937414,321;7681;123606;643699;23359;6263;6638;22909;342184;8926;161725;283710;283685;653720;89839;4692;54893;23191;728498;2562;101059918;6447;9824;4948;57194;81614;4308;2558;1139;7082;8924;114791;23742;51621;7337;89832;653125;26585;653073;2567;54551;728047;56160,43
-1,1,15,22770422,30316012,7545590,321;7681;2562;123606;4948;57194;81614;2558;23359;7082;8924;114791;23742;7337;6638;2567;8926;283685;653720;54551;4692;23191;56160,23
1,1,15,22770422,102429112,79658690,1445;548596;2242;80213;4058;79875;9399;123228;55505;161725;8483;10017;283685;653720;55055;80031;9824;5923;84978;6692;196951;83640;10002;5045;23005;663;51762;653125;54962;170691;302;197135;145957;9488;390594;4947;3418;653641;1512;56964;145773;57519;9899;400359;29766;10509;49855;643338;80119;23184;4091;348110;10125;400410;1138;54832;10169;4240;51621;56965;246777;64410;619189;10239;6447;90527;84993;59274;204219;23015;10588;100820829;5597;4130;145788;161829;57538;27229;79834;11261;64963;9455;113201;10099;79631;25989;342132;9245;80301;23168;100505679;5046;8482;374659;57722;22801;100137047;7782;440270;29767;9051;146050;196993;161514;254531;56204;5479;197131;22856;342184;161582;9133;290;145781;8120;2200;53905;101059918;55272;4644;25820;2252;54629;1139;161753;90381;405753;80765;283677;646;9768;338949;57214;5604;115752;56963;220;80381;100133220;1159;6638;64397;50810;1544;54893;4122;55329;728498;5780;117155;5315;101928527;4123;283807;90427;8925;3671;10081;390616;51103;26263;100128108;84191;390637;9716;728047;79719;7681;2595;123606;390648;161502;56905;5371;5955;123264;51203;140691;1543;374654;6263;11339;23205;1133;23191;84465;91947;54822;7301;646892;5330;64864;84942;79664;58472;55897;1198;2038;23742;6642;56851;23604;4649;10302;23741;390595;80208;79661;10681;7090;145645;54617;9990;9153;3175;256586;8926;283710;6727;100131244;79968;9101;161779;8125;145942;55075;2628;9960;27023;123624;9154;5151;123263;123720;440279;85455;57617;5428;51332;10260;3480;79400;11214;10519;145741;283726;79029;54778;647042;145864;26108;64799;4828;50804;57194;51065;10066;2923;84419;79895;348093;257364;594855;8800;25942;23431;4351;123591;123169;123355;9543;100526783;57099;3419;10021;54839;113189;79748;5873;9836;256764;440295;4236;91433;23336;54956;54866;81556;342125;51285;90416;60677;2562;2184;6938;92912;11001;100505573;6652;145873;84529;1136;105376731;26035;56906;80153;1583;8773;123688;9055;64927;140460;348094;57369;55177;81488;9493;11057;192683;9915;5346;256646;3712;10620;123207;5888;2644;23269;23359;25764;8766;10363;55142;84206;10845;145853;28232;9325;23060;55898;55784;26015;100137049;3067;51324;10391;57082;390598;161835;1106;58489;8924;116179;4734;5607;54982;374618;79856;57184;2585;9236;440275;3706;283652;27079;9377;146059;51335;2553;283659;25963;145858;54878;6095;114294;8128;176;53339;70;90525;56924;55323;4205;64784;55829;64220;1464;771;8681;161823;9677;64782;388135;56160;90417;27020;55215;80349;83660;3669;366;91860;54939;283777;4212;388115;29106;585;4692;6176;342035;11173;10116;9728;54816;4916;9187;89978;1588;161742;23102;146057;83440;100528021;283742;30844;7337;641;26585;9333;644809;6124;10073;23582;145946;51458;64843;1143;8854;145748;400451;83464;3603;373509;55466;102;567;4088;84894;9318;6218;4948;3658;653643;8554;7026;80125;701;26276;2567;388121;6627;123283;643707;92483;7158;55070;255189;374655;79094;53944;55930;171177;1854;644844;10776;26589;51234;57188;64506;55192;51187;4643;3073;8826;22995;26258;79768;84888;55180;4308;4756;53346;7082;23478;54913;89832;9640;4016;84952;145814;11245;161497;79705;23423;8669;643699;55889;5685;22909;825;255252;106821730;3990;54567;7057;123722;2558;597;51495;6457;114791;22893;80237;196996;653073;54989;54993;6557;54551;50506;51496;1381;321;54852;390649;283748;23312;10933;399694;57611;6017;10518;2108;197021;89839;23251;80021;79811;123745;2958;23339;56986;81614;60490;388125;399697;84936;54469;342096;7168,561
1,1,15,22770422,102429112,79658690,1445;548596;2242;80213;4058;79875;9399;123228;55505;161725;8483;10017;283685;653720;55055;80031;9824;5923;84978;6692;196951;83640;10002;5045;23005;663;51762;653125;54962;170691;302;197135;145957;9488;390594;4947;3418;653641;1512;56964;145773;57519;9899;400359;29766;10509;49855;643338;80119;23184;4091;348110;10125;400410;1138;54832;10169;4240;51621;56965;246777;64410;619189;10239;6447;90527;84993;59274;204219;23015;10588;100820829;5597;4130;145788;161829;57538;27229;79834;11261;64963;9455;113201;10099;79631;25989;342132;9245;80301;23168;100505679;5046;8482;374659;57722;22801;100137047;7782;440270;29767;9051;146050;196993;161514;254531;56204;5479;197131;22856;342184;161582;9133;290;145781;8120;2200;53905;101059918;55272;4644;25820;2252;54629;1139;161753;90381;405753;80765;283677;646;9768;338949;57214;5604;115752;56963;220;80381;100133220;1159;6638;64397;50810;1544;54893;4122;55329;728498;5780;117155;5315;101928527;4123;283807;90427;8925;3671;10081;390616;51103;26263;100128108;84191;390637;9716;728047;79719;7681;2595;123606;390648;161502;56905;5371;5955;123264;51203;140691;1543;374654;6263;11339;23205;1133;23191;84465;91947;54822;7301;646892;5330;64864;84942;79664;58472;55897;1198;2038;23742;6642;56851;23604;4649;10302;23741;390595;80208;79661;10681;7090;145645;54617;9990;9153;3175;256586;8926;283710;6727;100131244;79968;9101;161779;8125;145942;55075;2628;9960;27023;123624;9154;5151;123263;123720;440279;85455;57617;5428;51332;10260;3480;79400;11214;10519;145741;283726;79029;54778;647042;145864;26108;64799;4828;50804;57194;51065;10066;2923;84419;79895;348093;257364;594855;8800;25942;23431;4351;123591;123169;123355;9543;100526783;57099;3419;10021;54839;113189;79748;5873;9836;256764;440295;4236;91433;23336;54956;54866;81556;342125;51285;90416;60677;2562;2184;6938;92912;11001;100505573;6652;145873;84529;1136;105376731;26035;56906;80153;1583;8773;123688;9055;64927;140460;348094;57369;55177;81488;9493;11057;192683;9915;5346;256646;3712;10620;123207;5888;2644;23269;23359;25764;8766;10363;55142;84206;10845;145853;28232;9325;23060;55898;55784;26015;100137049;3067;51324;10391;57082;390598;161835;1106;58489;8924;116179;4734;5607;54982;374618;79856;57184;2585;9236;440275;3706;283652;27079;9377;146059;51335;2553;283659;25963;145858;54878;6095;114294;8128;176;53339;70;90525;56924;55323;4205;64784;55829;64220;1464;771;8681;161823;9677;64782;388135;56160;90417;27020;55215;80349;83660;3669;366;91860;54939;283777;4212;388115;29106;585;4692;6176;342035;11173;10116;9728;54816;4916;9187;89978;1588;161742;23102;146057;83440;100528021;283742;30844;7337;641;26585;9333;644809;6124;10073;23582;145946;51458;64843;1143;8854;145748;400451;83464;3603;373509;55466;102;567;4088;84894;9318;6218;4948;3658;653643;8554;7026;80125;701;26276;2567;388121;6627;123283;643707;92483;7158;55070;255189;374655;79094;53944;55930;171177;1854;644844;10776;26589;51234;57188;64506;55192;51187;4643;3073;8826;22995;26258;79768;84888;55180;4308;4756;53346;7082;23478;54913;89832;9640;4016;84952;145814;11245;161497;79705;23423;8669;643699;55889;5685;22909;825;255252;106821730;3990;54567;7057;123722;2558;597;51495;6457;114791;22893;80237;196996;653073;54989;54993;6557;54551;50506;51496;1381;321;54852;390649;283748;23312;10933;399694;57611;6017;10518;2108;197021;89839;23251;80021;79811;123745;2958;23339;56986;81614;60490;388125;399697;84936;54469;342096;7168,561
1,-1,15,22784523,23085096,300573,123606;23191;114791;81614,4
-1,-1,15,22784523,23085096,300573,123606;23191;114791;81614,4
1,-1,15,22784523,23085096,300573,123606;23191;114791;81614,4
1,-1,15,22784523,23085096,300573,123606;23191;114791;81614,4
1,-1,15,22784523,23085096,300573,123606;23191;114791;81614,4
1,-1,15,22784523,23085096,300573,123606;23191;114791;81614,4
1,-1,15,22784523,23085096,300573,123606;23191;114791;81614,4
-1,1,15,22784523,28525460,5740937,2562;7681;123606;4948;57194;81614;2558;8924;114791;23742;7337;6638;2567;8926;283685;54551;4692;23191,18
-1,1,15,22815306,28406650,5591344,2562;7681;123606;4948;57194;81614;2558;8924;114791;23742;7337;6638;2567;8926;283685;54551;4692;23191,18
1,-1,15,22815577,23217514,401937,123606;23191;114791;81614,4
-1,-1,15,22824342,23086303,261961,123606;23191;114791;81614,4
-1,-1,15,22860857,23300238,439381,123606;23191;114791;81614,4
-1,1,15,22860857,28399196,5538339,2562;7681;123606;4948;57194;81614;2558;8924;114791;23742;7337;6638;2567;8926;283685;54551;4692;23191,18
-1,1,15,22860857,28399196,5538339,2562;7681;123606;4948;57194;81614;2558;8924;114791;23742;7337;6638;2567;8926;283685;54551;4692;23191,18
1,-1,15,22866888,23699760,832872,123606;114791;283685;81614;23191,5
1,1,15,23179889,26225694,3045805,7681;23742;7337;6638;8926;57194;283685;54551;4692,9
-1,1,15,23276605,30370018,7093413,321;7681;2562;4948;57194;2558;23359;7082;8924;23742;7337;6638;2567;8926;283685;653720;54551;4692;56160,19
1,1,15,23282829,32444044,9161215,728498;321;7681;2562;101059918;54551;4948;57194;4308;2558;23359;1139;7082;8924;23742;51621;7337;6638;89832;22909;653073;2567;8926;161725;283710;283685;653720;89839;4692;54893;56160,31
-1,1,15,23282829,32446830,9164001,728498;321;7681;2562;101059918;54551;4948;57194;4308;2558;23359;1139;7082;8924;23742;51621;7337;6638;89832;22909;653073;2567;8926;161725;283710;283685;653720;89839;4692;54893;56160,31
-1,1,15,23286571,28540415,5253844,2562;7681;23742;8924;7337;6638;2567;4948;8926;57194;283685;54551;4692;2558,14
-1,1,15,23286571,28545355,5258784,2562;7681;23742;8924;7337;6638;2567;4948;8926;57194;283685;54551;4692;2558,14
-1,1,15,23286571,28545355,5258784,2562;7681;23742;8924;7337;6638;2567;4948;8926;57194;283685;54551;4692;2558,14
-1,1,15,23286571,28545504,5258933,2562;7681;23742;8924;7337;6638;2567;4948;8926;57194;283685;54551;4692;2558,14
1,1,15,23288374,28534245,5245871,2562;7681;23742;8924;7337;6638;2567;4948;8926;57194;283685;54551;4692;2558,14
-1,1,15,23290786,28545459,5254673,2562;7681;23742;8924;7337;6638;2567;4948;8926;57194;283685;54551;4692;2558,14
-1,1,15,23290786,28561097,5270311,2562;7681;23742;8924;7337;6638;2567;4948;8926;57194;283685;54551;4692;2558,14
1,1,15,23290862,28534245,5243383,2562;7681;23742;8924;7337;6638;2567;4948;8926;57194;283685;54551;4692;2558,14
1,1,15,23290862,28561097,5270235,2562;7681;23742;8924;7337;6638;2567;4948;8926;57194;283685;54551;4692;2558,14
-1,1,15,23290862,28823722,5532860,2562;7681;23742;8924;7337;6638;2567;4948;8926;57194;283685;54551;4692;2558,14
1,1,15,23300138,29338429,6038291,2562;7681;321;4948;57194;2558;8924;23742;7337;6638;2567;8926;283685;653720;54551;4692,16
1,1,15,23300238,28520313,5220075,2562;7681;23742;8924;7337;6638;2567;4948;8926;57194;283685;54551;4692;2558,14
-1,1,15,23300238,28520313,5220075,2562;7681;23742;8924;7337;6638;2567;4948;8926;57194;283685;54551;4692;2558,14
-1,1,15,23300238,28520313,5220075,2562;7681;23742;8924;7337;6638;2567;4948;8926;57194;283685;54551;4692;2558,14
-1,1,15,23300238,28520313,5220075,2562;7681;23742;8924;7337;6638;2567;4948;8926;57194;283685;54551;4692;2558,14
-1,1,15,23300238,28520313,5220075,2562;7681;23742;8924;7337;6638;2567;4948;8926;57194;283685;54551;4692;2558,14
1,1,15,23300254,28691447,5391193,2562;7681;23742;8924;7337;6638;2567;4948;8926;57194;283685;54551;4692;2558,14
-1,-1,15,23300285,23643764,343479,,0
-1,-1,15,23300285,23643764,343479,,0
1,-1,15,23328927,23597805,268878,,0
-1,1,15,23353638,28592766,5239128,2562;7681;23742;8924;7337;6638;2567;4948;8926;57194;283685;54551;4692;2558,14
1,1,15,23487423,28406650,4919227,2562;7681;23742;8924;7337;6638;2567;4948;8926;57194;283685;54551;4692;2558,14
1,1,15,23569415,28399196,4829781,2562;7681;23742;8924;7337;6638;2567;4948;8926;57194;283685;54551;4692;2558,14
-1,1,15,23615768,28534458,4918690,2562;7681;23742;8924;7337;6638;2567;4948;8926;57194;283685;54551;4692;2558,14
-1,1,15,23615768,28534458,4918690,2562;7681;23742;8924;7337;6638;2567;4948;8926;57194;283685;54551;4692;2558,14
-1,1,15,23615768,28540415,4924647,2562;7681;23742;8924;7337;6638;2567;4948;8926;57194;283685;54551;4692;2558,14
-1,1,15,23615768,28545355,4929587,2562;7681;23742;8924;7337;6638;2567;4948;8926;57194;283685;54551;4692;2558,14
-1,1,15,23615768,28659911,5044143,2562;7681;23742;8924;7337;6638;2567;4948;8926;57194;283685;54551;4692;2558,14
-1,1,15,23615768,28823722,5207954,2562;7681;23742;8924;7337;6638;2567;4948;8926;57194;283685;54551;4692;2558,14
-1,1,15,23615768,28823722,5207954,2562;7681;23742;8924;7337;6638;2567;4948;8926;57194;283685;54551;4692;2558,14
-1,1,15,23615769,28163991,4548222,2562;7681;23742;7337;6638;2567;4948;8926;57194;283685;54551;4692;2558,13
-1,1,15,23615769,28545355,4929586,2562;7681;23742;8924;7337;6638;2567;4948;8926;57194;283685;54551;4692;2558,14
-1,1,15,23615769,28545355,4929586,2562;7681;23742;8924;7337;6638;2567;4948;8926;57194;283685;54551;4692;2558,14
1,1,15,23615769,28561097,4945328,2562;7681;23742;8924;7337;6638;2567;4948;8926;57194;283685;54551;4692;2558,14
-1,1,15,23615769,28561671,4945902,2562;7681;23742;8924;7337;6638;2567;4948;8926;57194;283685;54551;4692;2558,14
-1,1,15,23615769,28635058,5019289,2562;7681;23742;8924;7337;6638;2567;4948;8926;57194;283685;54551;4692;2558,14
-1,1,15,23615769,28660038,5044269,2562;7681;23742;8924;7337;6638;2567;4948;8926;57194;283685;54551;4692;2558,14
-1,1,15,23615769,28660038,5044269,2562;7681;23742;8924;7337;6638;2567;4948;8926;57194;283685;54551;4692;2558,14
-1,1,15,23620191,28357230,4737039,2562;7681;23742;8924;7337;6638;2567;4948;8926;57194;283685;54551;4692;2558,14
-1,1,15,23620191,28437018,4816827,2562;7681;23742;8924;7337;6638;2567;4948;8926;57194;283685;54551;4692;2558,14
-1,1,15,23620191,28527734,4907543,2562;7681;23742;8924;7337;6638;2567;4948;8926;57194;283685;54551;4692;2558,14
1,1,15,23620191,28534245,4914054,2562;7681;23742;8924;7337;6638;2567;4948;8926;57194;283685;54551;4692;2558,14
-1,1,15,23620191,28534359,4914168,2562;7681;23742;8924;7337;6638;2567;4948;8926;57194;283685;54551;4692;2558,14
-1,1,15,23620191,28539975,4919784,2562;7681;23742;8924;7337;6638;2567;4948;8926;57194;283685;54551;4692;2558,14
-1,1,15,23620191,28539975,4919784,2562;7681;23742;8924;7337;6638;2567;4948;8926;57194;283685;54551;4692;2558,14
-1,1,15,23620191,28540415,4920224,2562;7681;23742;8924;7337;6638;2567;4948;8926;57194;283685;54551;4692;2558,14
-1,1,15,23620191,28545355,4925164,2562;7681;23742;8924;7337;6638;2567;4948;8926;57194;283685;54551;4692;2558,14
-1,1,15,23620191,28545355,4925164,2562;7681;23742;8924;7337;6638;2567;4948;8926;57194;283685;54551;4692;2558,14
-1,1,15,23620191,28545355,4925164,2562;7681;23742;8924;7337;6638;2567;4948;8926;57194;283685;54551;4692;2558,14
-1,1,15,23620191,28545355,4925164,2562;7681;23742;8924;7337;6638;2567;4948;8926;57194;283685;54551;4692;2558,14
-1,1,15,23620191,28545355,4925164,2562;7681;23742;8924;7337;6638;2567;4948;8926;57194;283685;54551;4692;2558,14
-1,1,15,23620191,28545504,4925313,2562;7681;23742;8924;7337;6638;2567;4948;8926;57194;283685;54551;4692;2558,14
-1,1,15,23620191,28545601,4925410,2562;7681;23742;8924;7337;6638;2567;4948;8926;57194;283685;54551;4692;2558,14
-1,1,15,23620191,28561232,4941041,2562;7681;23742;8924;7337;6638;2567;4948;8926;57194;283685;54551;4692;2558,14
-1,1,15,23620191,28561671,4941480,2562;7681;23742;8924;7337;6638;2567;4948;8926;57194;283685;54551;4692;2558,14
-1,1,15,23620191,28709715,5089524,2562;7681;23742;8924;7337;6638;2567;4948;8926;57194;283685;54551;4692;2558,14
1,1,15,23620191,28958779,5338588,2562;7681;23742;8924;7337;6638;2567;4948;8926;57194;283685;653720;54551;4692;2558,15
-1,1,15,23622526,102521392,78898866,1445;548596;2242;80213;4058;79875;9399;123228;55505;161725;8483;10017;283685;653720;55055;80031;9824;5923;84978;6692;196951;83640;10002;5045;23005;663;51762;653125;54962;170691;302;197135;145957;9488;390594;4947;3418;653641;1512;56964;145773;57519;9899;400359;29766;10509;49855;643338;80119;23184;4091;348110;10125;400410;1138;54832;10169;4240;51621;56965;246777;64410;619189;10239;6447;90527;84993;59274;204219;23015;10588;100820829;5597;4130;145788;161829;57538;27229;79834;11261;64963;9455;113201;10099;79631;25989;342132;9245;80301;23168;100505679;5046;8482;374659;57722;22801;100137047;7782;440270;29767;9051;146050;196993;161514;254531;56204;5479;197131;22856;342184;161582;9133;290;145781;8120;2200;53905;101059918;55272;4644;25820;2252;54629;1139;161753;90381;405753;80765;283677;646;9768;338949;57214;5604;115752;56963;220;80381;100133220;1159;6638;64397;50810;1544;54893;4122;55329;728498;5780;117155;5315;101928527;4123;283807;90427;8925;3671;10081;390616;51103;26263;100128108;84191;390637;9716;728047;79719;7681;2595;390648;161502;56905;5371;5955;123264;51203;140691;1543;374654;6263;11339;23205;1133;84465;91947;54822;7301;646892;5330;64864;84942;79664;58472;55897;1198;2038;23742;6642;56851;23604;4649;10302;23741;390595;80208;79661;10681;7090;145645;54617;9990;9153;3175;256586;8926;283710;6727;100131244;79968;9101;161779;8125;145942;55075;2628;9960;27023;123624;9154;5151;123263;123720;440279;85455;57617;5428;51332;10260;3480;79400;11214;10519;145741;283726;79029;54778;647042;145864;26108;64799;4828;50804;57194;51065;10066;2923;84419;79895;348093;257364;594855;8800;25942;23431;4351;123591;123169;123355;9543;100526783;57099;3419;10021;54839;113189;79748;5873;9836;256764;440295;4236;91433;23336;54956;54866;81556;342125;51285;90416;60677;2562;2184;6938;92912;11001;100505573;6652;145873;84529;1136;105376731;26035;56906;80153;1583;8773;123688;9055;64927;140460;348094;57369;55177;81488;9493;11057;192683;9915;5346;256646;3712;10620;123207;5888;2644;23269;23359;25764;8766;10363;55142;84206;10845;145853;28232;9325;23060;55898;55784;26015;100137049;3067;51324;10391;57082;390598;161835;1106;58489;8924;116179;4734;5607;54982;374618;79856;57184;2585;9236;440275;3706;283652;27079;9377;146059;51335;2553;283659;25963;145858;54878;6095;114294;8128;176;53339;70;90525;56924;55323;4205;64784;55829;26682;64220;1464;771;8681;161823;9677;64782;388135;56160;90417;27020;55215;80349;83660;3669;366;91860;54939;283777;4212;388115;29106;585;4692;6176;342035;11173;10116;9728;54816;4916;9187;89978;1588;161742;23102;146057;83440;100528021;283742;30844;7337;641;26585;9333;644809;6124;10073;23582;145946;51458;64843;1143;8854;145748;400451;83464;3603;373509;55466;102;567;4088;84894;9318;6218;4948;3658;653643;8554;7026;80125;701;26276;2567;388121;6627;123283;643707;92483;7158;55070;255189;374655;79094;53944;55930;171177;1854;644844;10776;26589;51234;57188;64506;55192;51187;4643;3073;8826;22995;26258;79768;84888;55180;4308;4756;53346;7082;23478;54913;89832;9640;4016;84952;145814;11245;161497;79705;23423;8669;643699;55889;5685;22909;825;255252;106821730;3990;54567;7057;123722;2558;597;51495;6457;22893;80237;196996;653073;54989;54993;6557;54551;50506;51496;1381;321;54852;390649;283748;23312;10933;399694;57611;6017;10518;2108;197021;89839;23251;80021;79811;123745;2958;23339;56986;60490;388125;399697;84936;54469;342096;7168,558
-1,1,15,23625784,28540345,4914561,2562;7681;23742;8924;7337;6638;2567;4948;8926;57194;283685;54551;4692;2558,14
1,1,15,23643767,28525460,4881693,2562;7681;23742;8924;7337;6638;2567;4948;8926;57194;283685;54551;4692;2558,14
-1,1,15,23656064,28520316,4864252,2562;7681;23742;8924;7337;6638;2567;4948;8926;57194;283685;54551;4692;2558,14
-1,1,15,23656064,28691447,5035383,2562;7681;23742;8924;7337;6638;2567;4948;8926;57194;283685;54551;4692;2558,14
-1,1,15,23656936,28520313,4863377,2562;7681;23742;8924;7337;6638;2567;4948;8926;57194;283685;54551;4692;2558,14
-1,1,15,23656936,28520313,4863377,2562;7681;23742;8924;7337;6638;2567;4948;8926;57194;283685;54551;4692;2558,14
1,1,15,23656936,28520313,4863377,2562;7681;23742;8924;7337;6638;2567;4948;8926;57194;283685;54551;4692;2558,14
-1,1,15,23656936,28520313,4863377,2562;7681;23742;8924;7337;6638;2567;4948;8926;57194;283685;54551;4692;2558,14
-1,1,15,23656936,28520313,4863377,2562;7681;23742;8924;7337;6638;2567;4948;8926;57194;283685;54551;4692;2558,14
1,1,15,23656936,28520313,4863377,2562;7681;23742;8924;7337;6638;2567;4948;8926;57194;283685;54551;4692;2558,14
1,1,15,23656936,28525460,4868524,2562;7681;23742;8924;7337;6638;2567;4948;8926;57194;283685;54551;4692;2558,14
-1,1,15,23667814,28542124,4874310,2562;7681;23742;8924;7337;6638;2567;4948;8926;57194;283685;54551;4692;2558,14
-1,1,15,23667814,28940008,5272194,2562;7681;23742;8924;7337;6638;2567;4948;8926;57194;283685;54551;4692;2558,14
-1,1,15,23668011,28525460,4857449,2562;7681;23742;8924;7337;6638;2567;4948;8926;57194;283685;54551;4692;2558,14
1,1,15,23668011,28525460,4857449,2562;7681;23742;8924;7337;6638;2567;4948;8926;57194;283685;54551;4692;2558,14
-1,1,15,23668011,28525460,4857449,2562;7681;23742;8924;7337;6638;2567;4948;8926;57194;283685;54551;4692;2558,14
-1,1,15,23668011,28525460,4857449,2562;7681;23742;8924;7337;6638;2567;4948;8926;57194;283685;54551;4692;2558,14
-1,1,15,23668011,28525460,4857449,2562;7681;23742;8924;7337;6638;2567;4948;8926;57194;283685;54551;4692;2558,14
-1,1,15,23668011,28557186,4889175,2562;7681;23742;8924;7337;6638;2567;4948;8926;57194;283685;54551;4692;2558,14
-1,1,15,23668011,28557186,4889175,2562;7681;23742;8924;7337;6638;2567;4948;8926;57194;283685;54551;4692;2558,14
-1,1,15,23668011,28557186,4889175,2562;7681;23742;8924;7337;6638;2567;4948;8926;57194;283685;54551;4692;2558,14
-1,1,15,23668011,28557186,4889175,2562;7681;23742;8924;7337;6638;2567;4948;8926;57194;283685;54551;4692;2558,14
-1,1,15,23668011,28691460,5023449,2562;7681;23742;8924;7337;6638;2567;4948;8926;57194;283685;54551;4692;2558,14
-1,1,15,23668011,28801348,5133337,2562;7681;23742;8924;7337;6638;2567;4948;8926;57194;283685;54551;4692;2558,14
-1,1,15,23684655,28399196,4714541,2562;7681;23742;8924;7337;6638;2567;4948;8926;57194;283685;54551;4692;2558,14
-1,1,15,23684655,28399196,4714541,2562;7681;23742;8924;7337;6638;2567;4948;8926;57194;283685;54551;4692;2558,14
1,1,15,23689315,28522493,4833178,2562;7681;23742;8924;7337;6638;2567;4948;8926;57194;283685;54551;4692;2558,14
-1,1,15,23699701,28525460,4825759,2562;7681;23742;8924;7337;6638;2567;4948;8926;57194;54551;4692;2558,13
-1,1,15,23707252,28535207,4827955,2562;7681;23742;8924;7337;6638;2567;4948;8926;57194;54551;4692;2558,13
-1,1,15,23707435,28520316,4812881,2562;7681;23742;8924;7337;6638;2567;4948;8926;57194;54551;4692;2558,13
-1,1,15,23707435,28557186,4849751,2562;7681;23742;8924;7337;6638;2567;4948;8926;57194;54551;4692;2558,13
-1,1,15,23707435,28691447,4984012,2562;7681;23742;8924;7337;6638;2567;4948;8926;57194;54551;4692;2558,13
-1,1,15,23707435,28940068,5232633,2562;7681;23742;8924;7337;6638;2567;4948;8926;57194;54551;4692;2558,13
-1,1,15,23707452,27296222,3588770,2562;7681;23742;7337;6638;2567;8926;57194;54551;4692;2558,11
1,1,15,23707452,28406650,4699198,2562;7681;23742;8924;7337;6638;2567;4948;8926;57194;54551;4692;2558,13
-1,1,15,23707452,28406650,4699198,2562;7681;23742;8924;7337;6638;2567;4948;8926;57194;54551;4692;2558,13
-1,1,15,23707452,28406650,4699198,2562;7681;23742;8924;7337;6638;2567;4948;8926;57194;54551;4692;2558,13
-1,1,15,23707452,28406650,4699198,2562;7681;23742;8924;7337;6638;2567;4948;8926;57194;54551;4692;2558,13
1,1,15,23707452,28520313,4812861,2562;7681;23742;8924;7337;6638;2567;4948;8926;57194;54551;4692;2558,13
-1,1,15,23707452,28520313,4812861,2562;7681;23742;8924;7337;6638;2567;4948;8926;57194;54551;4692;2558,13
-1,1,15,23707452,28520313,4812861,2562;7681;23742;8924;7337;6638;2567;4948;8926;57194;54551;4692;2558,13
-1,1,15,23707452,28520313,4812861,2562;7681;23742;8924;7337;6638;2567;4948;8926;57194;54551;4692;2558,13
-1,1,15,23707452,28520313,4812861,2562;7681;23742;8924;7337;6638;2567;4948;8926;57194;54551;4692;2558,13
-1,1,15,23707452,28557186,4849734,2562;7681;23742;8924;7337;6638;2567;4948;8926;57194;54551;4692;2558,13
1,1,15,23707452,28940098,5232646,2562;7681;23742;8924;7337;6638;2567;4948;8926;57194;54551;4692;2558,13
-1,1,15,23769081,28525460,4756379,2562;7681;23742;8924;7337;6638;2567;4948;8926;57194;54551;4692;2558,13
-1,1,15,24179003,37238599,13059596,321;440270;256646;23015;57369;57099;643699;23359;9990;6263;6638;254531;22909;4212;342184;8926;161725;283710;54893;653720;89839;1133;51234;55505;728498;2562;101059918;9824;70;79768;161779;89978;4948;57194;4308;2558;1139;7082;84529;8924;23742;51621;7337;89832;653125;26585;653073;2567;54989;56851;56160;9716;728047;6447,54
-1,1,15,24244854,28557186,4312332,2562;8924;23742;7337;6638;2567;4948;8926;57194;2558,10
-1,1,15,24296571,27467567,3170996,2562;23742;7337;6638;2567;8926;57194;2558,8
-1,-1,15,24350467,24668288,317821,,0
-1,-1,15,24350467,24668288,317821,,0
-1,-1,15,24350467,24795327,444860,,0
-1,-1,15,24350467,24795327,444860,,0
-1,-1,15,24350467,24795327,444860,,0
-1,-1,15,24350467,24795327,444860,,0
-1,-1,15,24350467,24795327,444860,,0
1,1,15,24342084,25118317,776233,6638;23742,2
-1,-1,15,24431653,24699937,268284,,0
-1,-1,15,24431653,24738239,306586,,0
-1,-1,15,24470092,24738199,268107,,0
-1,-1,15,24487792,24777982,290190,,0
-1,-1,15,24487792,24777982,290190,,0
-1,-1,15,24487792,24777982,290190,,0
-1,-1,15,24504433,24723143,218710,,0
-1,-1,15,24504433,24723143,218710,,0
-1,-1,15,24504433,24723143,218710,,0
-1,-1,15,24504433,24723143,218710,,0
-1,-1,15,24504433,24777982,273549,,0
-1,-1,15,24504433,24777982,273549,,0
-1,-1,15,24504433,24777982,273549,,0
-1,-1,15,24504460,24738239,233779,,0
-1,-1,15,24540420,24777982,237562,,0
-1,-1,15,24540420,24777982,237562,,0
-1,-1,15,24540420,24777982,237562,,0
-1,-1,15,24681387,24738209,56822,,0
-1,-1,15,25068901,25082506,13605,6638,1
-1,-1,15,25078407,25114364,35957,6638,1
-1,1,15,25279016,37496505,12217489,321;440270;256646;23015;57369;57099;643699;23359;9990;6263;254531;4212;22909;342184;161725;55505;283710;54893;653720;89839;1133;51234;728498;2562;101059918;9824;70;79768;161779;89978;4948;57194;4308;2558;1139;7082;84529;8924;51621;7337;89832;653125;26585;653073;2567;54989;56851;56160;9716;728047;6447,51
1,1,15,25580017,25596966,16949,7337,1
-1,1,15,25582420,25798470,216050,7337,1
1,-1,15,25585059,25585246,187,7337,1
1,-1,15,25683179,25684070,891,7337,1
1,-1,15,25683179,25684070,891,7337,1
1,-1,15,25683179,25684070,891,7337,1
1,-1,15,25683179,25684070,891,7337,1
1,1,15,27958867,28399196,440329,4948;8924,2
1,-1,15,28356357,28399196,42839,8924,1
1,-1,15,28525218,28976133,450915,8924;653720,2
1,-1,15,28525218,28976133,450915,8924;653720,2
1,-1,15,28525218,28976133,450915,8924;653720,2
1,-1,15,28525218,28976133,450915,8924;653720,2
1,-1,15,28525218,28976133,450915,8924;653720,2
1,-1,15,28525218,28976133,450915,8924;653720,2
1,-1,15,28525218,28976133,450915,8924;653720,2
1,-1,15,28525218,28976133,450915,8924;653720,2
1,-1,15,28525218,28976133,450915,8924;653720,2
1,-1,15,28525218,28976133,450915,8924;653720,2
1,-1,15,28525218,28976133,450915,8924;653720,2
1,-1,15,28525218,28976133,450915,8924;653720,2
1,-1,15,28525218,29093456,568238,8924;653720,2
1,-1,15,28525218,29096386,571168,8924;653720,2
1,-1,15,28525218,29096386,571168,8924;653720,2
1,-1,15,28525218,29096386,571168,8924;653720,2
1,-1,15,28525218,29096386,571168,8924;653720,2
1,-1,15,28525218,29096386,571168,8924;653720,2
1,-1,15,28525218,29096386,571168,8924;653720,2
1,-1,15,28525218,29096386,571168,8924;653720,2
1,-1,15,28525218,29209620,684402,8924;653720,2
-1,1,15,28547475,32446830,3899355,728498;321;101059918;4308;23359;1139;7082;8924;51621;89832;22909;653073;161725;283710;54893;653720;56160;89839,18
-1,-1,15,28579796,28755702,175906,,0
-1,-1,15,28579796,28846113,266317,,0
1,-1,15,28579796,29093456,513660,653720,1
-1,-1,15,28646272,28846113,199841,,0
1,-1,15,28691401,29030517,339116,653720,1
1,1,15,28940039,30366124,1426085,321;653720;56160;23359;7082,5
1,1,15,28940039,31077833,2137794,728498;321;101059918;89832;653073;653720;56160;89839;23359;7082,10
-1,1,15,28989650,32514980,3525330,728498;321;101059918;4308;23359;1139;7082;51621;89832;22909;653073;161725;283710;54893;89839;56160,16
-1,1,15,29096445,32633241,3536796,728498;321;101059918;4308;23359;1139;7082;51621;89832;22909;653073;161725;283710;54893;89839;56160,16
-1,1,15,29096445,32635875,3539430,728498;321;101059918;4308;23359;1139;7082;51621;89832;22909;653073;161725;283710;54893;89839;56160,16
-1,1,15,29096445,32732884,3636439,728498;321;101059918;4308;23359;1139;7082;51621;89832;653125;22909;653073;161725;283710;54893;89839;56160,17
-1,1,15,29209620,102521392,73311772,1445;548596;2242;80213;4058;79875;9399;123228;55505;161725;8483;10017;55055;80031;9824;5923;84978;6692;196951;83640;10002;5045;23005;663;51762;653125;54962;170691;302;197135;145957;9488;390594;4947;3418;653641;1512;56964;145773;57519;9899;400359;29766;10509;49855;643338;80119;23184;4091;348110;10125;400410;1138;54832;10169;4240;51621;56965;246777;64410;619189;10239;6447;90527;84993;59274;204219;23015;10588;100820829;5597;4130;145788;161829;57538;27229;79834;11261;64963;9455;113201;10099;79631;25989;342132;9245;80301;23168;100505679;5046;8482;374659;57722;22801;100137047;7782;440270;29767;9051;146050;196993;161514;254531;56204;5479;197131;22856;342184;161582;9133;290;145781;8120;2200;53905;101059918;55272;4644;25820;2252;54629;1139;161753;90381;405753;80765;283677;646;9768;338949;57214;5604;115752;56963;220;80381;100133220;1159;64397;50810;1544;54893;4122;55329;728498;5780;117155;5315;101928527;4123;283807;90427;8925;3671;10081;390616;51103;26263;100128108;84191;390637;9716;728047;79719;2595;390648;161502;56905;5371;5955;123264;51203;140691;1543;374654;6263;11339;23205;1133;84465;91947;54822;7301;646892;5330;64864;84942;79664;58472;55897;1198;2038;6642;56851;23604;4649;10302;23741;390595;80208;79661;10681;7090;145645;54617;9990;9153;3175;256586;283710;6727;100131244;79968;9101;161779;8125;145942;55075;2628;9960;27023;123624;9154;5151;123263;123720;440279;85455;57617;5428;51332;10260;3480;79400;11214;10519;145741;283726;79029;54778;647042;145864;26108;64799;4828;50804;51065;10066;2923;84419;79895;348093;257364;594855;8800;25942;23431;4351;123591;123169;123355;9543;100526783;57099;3419;10021;54839;113189;79748;5873;9836;256764;440295;4236;91433;23336;54956;54866;81556;342125;51285;90416;60677;2184;6938;92912;11001;100505573;6652;145873;84529;1136;105376731;26035;56906;80153;1583;8773;123688;9055;64927;140460;348094;57369;55177;81488;9493;11057;192683;9915;5346;256646;3712;10620;123207;5888;2644;23269;23359;25764;8766;10363;55142;84206;10845;145853;28232;9325;23060;55898;55784;26015;100137049;3067;51324;10391;57082;390598;161835;1106;58489;116179;4734;5607;54982;374618;79856;57184;2585;9236;440275;3706;283652;27079;9377;146059;51335;2553;283659;25963;145858;54878;6095;114294;8128;176;53339;70;90525;56924;55323;4205;64784;55829;26682;64220;1464;771;8681;161823;9677;64782;388135;56160;90417;27020;55215;80349;83660;3669;366;91860;54939;283777;4212;388115;29106;585;6176;342035;11173;10116;9728;54816;4916;9187;89978;1588;161742;23102;146057;83440;100528021;283742;30844;641;26585;9333;644809;6124;10073;23582;145946;51458;64843;1143;8854;145748;400451;83464;3603;373509;55466;102;567;4088;84894;9318;6218;3658;653643;8554;7026;80125;701;26276;388121;6627;123283;643707;92483;7158;55070;255189;374655;79094;53944;55930;171177;1854;644844;10776;26589;51234;57188;64506;55192;51187;4643;3073;8826;22995;26258;79768;84888;55180;4308;4756;53346;7082;23478;54913;89832;9640;4016;84952;145814;11245;161497;79705;23423;8669;643699;55889;5685;22909;825;255252;106821730;3990;54567;7057;123722;597;51495;6457;22893;80237;196996;653073;54989;54993;6557;50506;51496;1381;321;54852;390649;283748;23312;10933;399694;57611;6017;10518;2108;197021;89839;23251;80021;79811;123745;2958;23339;56986;60490;388125;399697;84936;54469;342096;7168,543
-1,1,15,29214105,32418220,3204115,728498;321;101059918;4308;23359;1139;7082;51621;89832;22909;653073;161725;283710;54893;89839;56160,16
1,-1,15,30366079,31077996,711917,728498;101059918;89839;89832;653073,5
-1,-1,15,30390007,30849983,459976,89832;101059918,2
-1,-1,15,30390007,30849983,459976,89832;101059918,2
-1,-1,15,30390007,30865176,475169,89832;101059918,2
-1,-1,15,30390007,30865176,475169,89832;101059918,2
-1,-1,15,30390007,30865176,475169,89832;101059918,2
-1,-1,15,30390007,30865176,475169,89832;101059918,2
-1,-1,15,30390007,30865176,475169,89832;101059918,2
-1,-1,15,30390007,30865176,475169,89832;101059918,2
-1,-1,15,30390007,30865176,475169,89832;101059918,2
-1,-1,15,30390007,30888859,498852,89832;101059918,2
-1,-1,15,30390007,31077996,687989,728498;89832;101059918;89839,4
-1,1,15,30386398,32444044,2057646,728498;101059918;51621;89832;22909;653073;161725;283710;54893;89839;4308;1139,12
1,1,15,30386398,32444196,2057798,728498;101059918;51621;89832;22909;653073;161725;283710;54893;89839;4308;1139,12
1,1,15,30386398,32446830,2060432,728498;101059918;51621;89832;22909;653073;161725;283710;54893;89839;4308;1139,12
-1,-1,15,30405535,30833816,428281,89832;101059918,2
-1,-1,15,30405535,30865176,459641,89832;101059918,2
-1,-1,15,30405535,30865176,459641,89832;101059918,2
-1,-1,15,30448351,30653920,205569,89832,1
-1,-1,15,30448351,30833816,385465,89832;101059918,2
-1,-1,15,30448351,30849983,401632,89832;101059918,2
-1,-1,15,30448351,30849983,401632,89832;101059918,2
-1,-1,15,30448351,30865176,416825,89832;101059918,2
-1,-1,15,30462313,30800272,337959,89832;101059918,2
-1,-1,15,30462313,30800272,337959,89832;101059918,2
-1,-1,15,30462313,30800272,337959,89832;101059918,2
-1,-1,15,30462313,30800272,337959,89832;101059918,2
-1,-1,15,30462313,30800272,337959,89832;101059918,2
-1,-1,15,30462313,30833816,371503,89832;101059918,2
-1,-1,15,30462313,30833816,371503,89832;101059918,2
-1,-1,15,30462313,30833816,371503,89832;101059918,2
-1,-1,15,30462313,30833816,371503,89832;101059918,2
-1,-1,15,30462313,30833816,371503,89832;101059918,2
-1,-1,15,30462313,30849983,387670,89832;101059918,2
-1,-1,15,30462313,30865176,402863,89832;101059918,2
-1,-1,15,30462313,30865176,402863,89832;101059918,2
-1,-1,15,30491382,30865176,373794,89832;101059918,2
-1,-1,15,30489810,30783644,293834,89832;101059918,2
-1,-1,15,30509325,30865176,355851,89832;101059918,2
-1,-1,15,30509325,30865176,355851,89832;101059918,2
-1,1,15,30509325,32509926,2000601,728498;101059918;51621;89832;22909;161725;283710;54893;89839;4308;1139,11
-1,1,15,30509325,32899558,2390233,728498;101059918;51621;89832;653125;22909;161725;283710;54893;89839;643699;4308;728047;1139,14
1,1,15,30583466,32509926,1926460,728498;101059918;51621;89832;22909;161725;283710;54893;89839;4308;1139,11
1,1,15,30653859,32443124,1789265,728498;101059918;51621;89832;22909;161725;283710;54893;89839;4308;1139,11
1,1,15,30653877,31864690,1210813,728498;101059918;51621;89832;22909;161725;283710;54893;89839;4308,10
1,1,15,30653877,32706883,2053006,728498;101059918;51621;89832;653125;22909;161725;283710;54893;89839;4308;1139,12
1,1,15,30653877,32706883,2053006,728498;101059918;51621;89832;653125;22909;161725;283710;54893;89839;4308;1139,12
1,1,15,30653877,32861626,2207749,728498;101059918;51621;89832;653125;22909;161725;283710;54893;89839;4308;728047;1139,13
-1,1,15,30653877,32861626,2207749,728498;101059918;51621;89832;653125;22909;161725;283710;54893;89839;4308;728047;1139,13
1,1,15,30653877,32899558,2245681,728498;101059918;51621;89832;653125;22909;161725;283710;54893;89839;643699;4308;728047;1139,14
-1,1,15,30653877,32914199,2260322,728498;101059918;9824;51621;89832;653125;22909;161725;283710;54893;89839;643699;4308;728047;1139,15
1,1,15,30730513,32861626,2131113,728498;51621;653125;22909;161725;283710;54893;89839;4308;728047;1139,11
1,1,15,30730513,32899558,2169045,728498;51621;653125;22909;161725;283710;54893;89839;643699;4308;728047;1139,12
-1,1,15,30819465,32509926,1690461,728498;51621;22909;161725;283710;54893;89839;4308;1139,9
-1,1,15,30819465,32509926,1690461,728498;51621;22909;161725;283710;54893;89839;4308;1139,9
-1,1,15,30819465,32514980,1695515,728498;51621;22909;161725;283710;54893;89839;4308;1139,9
-1,1,15,30819465,32514980,1695515,728498;51621;22909;161725;283710;54893;89839;4308;1139,9
1,1,15,30913573,32444044,1530471,51621;22909;161725;283710;54893;89839;4308;1139,8
1,1,15,30913574,32439524,1525950,51621;22909;161725;283710;54893;89839;4308;1139,8
-1,1,15,30921917,32514980,1593063,51621;22909;161725;283710;54893;89839;4308;1139,8
-1,1,15,30921917,32514980,1593063,51621;22909;161725;283710;54893;89839;4308;1139,8
-1,1,15,30921917,32514980,1593063,51621;22909;161725;283710;54893;89839;4308;1139,8
-1,1,15,30921917,32514980,1593063,51621;22909;161725;283710;54893;89839;4308;1139,8
-1,1,15,30921917,32514980,1593063,51621;22909;161725;283710;54893;89839;4308;1139,8
-1,1,15,30921917,32514980,1593063,51621;22909;161725;283710;54893;89839;4308;1139,8
-1,1,15,30921917,32514980,1593063,51621;22909;161725;283710;54893;89839;4308;1139,8
-1,1,15,30921917,32514980,1593063,51621;22909;161725;283710;54893;89839;4308;1139,8
-1,1,15,30921917,32514980,1593063,51621;22909;161725;283710;54893;89839;4308;1139,8
-1,1,15,30921917,32514980,1593063,51621;22909;161725;283710;54893;89839;4308;1139,8
-1,1,15,30921917,32514980,1593063,51621;22909;161725;283710;54893;89839;4308;1139,8
-1,1,15,30921917,32514980,1593063,51621;22909;161725;283710;54893;89839;4308;1139,8
-1,1,15,30921917,32514980,1593063,51621;22909;161725;283710;54893;89839;4308;1139,8
-1,1,15,30921917,32514980,1593063,51621;22909;161725;283710;54893;89839;4308;1139,8
-1,1,15,30921917,32514980,1593063,51621;22909;161725;283710;54893;89839;4308;1139,8
-1,1,15,30921917,32539666,1617749,51621;22909;161725;283710;54893;89839;4308;1139,8
-1,1,15,30921917,32539666,1617749,51621;22909;161725;283710;54893;89839;4308;1139,8
-1,1,15,30921917,32539666,1617749,51621;22909;161725;283710;54893;89839;4308;1139,8
-1,1,15,30921917,32567325,1645408,51621;22909;161725;283710;54893;89839;4308;1139,8
1,1,15,30921917,32861626,1939709,51621;653125;22909;161725;283710;54893;89839;4308;728047;1139,10
1,1,15,30921917,32861626,1939709,51621;653125;22909;161725;283710;54893;89839;4308;728047;1139,10
1,1,15,30921917,32861626,1939709,51621;653125;22909;161725;283710;54893;89839;4308;728047;1139,10
1,1,15,30921917,32861626,1939709,51621;653125;22909;161725;283710;54893;89839;4308;728047;1139,10
-1,1,15,30921917,32914199,1992282,9824;51621;653125;22909;161725;283710;54893;89839;643699;4308;728047;1139,12
-1,1,15,30954726,32443895,1489169,161725;283710;54893;51621;4308;22909;1139,7
-1,1,15,30954726,32514957,1560231,161725;283710;54893;51621;4308;22909;1139,7
-1,1,15,30954726,32514957,1560231,161725;283710;54893;51621;4308;22909;1139,7
-1,1,15,30954726,32514957,1560231,161725;283710;54893;51621;4308;22909;1139,7
-1,1,15,30954726,32514957,1560231,161725;283710;54893;51621;4308;22909;1139,7
-1,1,15,30954726,32539670,1584944,161725;283710;54893;51621;4308;22909;1139,7
-1,1,15,30954726,32539670,1584944,161725;283710;54893;51621;4308;22909;1139,7
-1,-1,15,30938215,31244225,306010,22909;54893,2
-1,1,15,30954724,32443124,1488400,161725;283710;54893;51621;4308;22909;1139,7
-1,1,15,30954724,32509932,1555208,161725;283710;54893;51621;4308;22909;1139,7
-1,1,15,30954724,32861612,1906888,51621;653125;22909;161725;283710;54893;4308;728047;1139,9
-1,-1,15,30954726,31077833,123107,,0
-1,1,15,30954726,32509926,1555200,161725;283710;54893;51621;4308;22909;1139,7
-1,1,15,30954726,32509926,1555200,161725;283710;54893;51621;4308;22909;1139,7
-1,1,15,30954726,32509926,1555200,161725;283710;54893;51621;4308;22909;1139,7
-1,1,15,30954726,32509926,1555200,161725;283710;54893;51621;4308;22909;1139,7
-1,1,15,30954726,32509926,1555200,161725;283710;54893;51621;4308;22909;1139,7
-1,1,15,30954726,32509926,1555200,161725;283710;54893;51621;4308;22909;1139,7
-1,1,15,31042916,32899558,1856642,51621;653125;22909;161725;283710;54893;643699;4308;728047;1139,10
-1,1,15,31073668,32446829,1373161,161725;283710;54893;51621;4308;22909;1139,7
-1,1,15,31073668,32446830,1373162,161725;283710;54893;51621;4308;22909;1139,7
1,1,15,31073669,32446830,1373161,161725;283710;54893;51621;4308;22909;1139,7
-1,1,15,31073669,32446830,1373161,161725;283710;54893;51621;4308;22909;1139,7
1,1,15,31073735,32439281,1365546,161725;283710;54893;51621;4308;22909;1139,7
1,1,15,31073735,32444044,1370309,161725;283710;54893;51621;4308;22909;1139,7
-1,1,15,31073735,32444196,1370461,161725;283710;54893;51621;4308;22909;1139,7
-1,1,15,31073735,32446830,1373095,161725;283710;54893;51621;4308;22909;1139,7
-1,1,15,31073735,32446830,1373095,161725;283710;54893;51621;4308;22909;1139,7
-1,1,15,31073735,32446830,1373095,161725;283710;54893;51621;4308;22909;1139,7
-1,1,15,31073735,32446830,1373095,161725;283710;54893;51621;4308;22909;1139,7
-1,1,15,31073735,32446830,1373095,161725;283710;54893;51621;4308;22909;1139,7
-1,1,15,31073735,32446830,1373095,161725;283710;54893;51621;4308;22909;1139,7
-1,1,15,31073735,32446830,1373095,161725;283710;54893;51621;4308;22909;1139,7
-1,1,15,31073735,32446830,1373095,161725;283710;54893;51621;4308;22909;1139,7
-1,1,15,31073735,32446830,1373095,161725;283710;54893;51621;4308;22909;1139,7
1,1,15,31089934,32443019,1353085,161725;283710;54893;51621;4308;22909;1139,7
-1,1,15,31089934,32462642,1372708,161725;283710;54893;51621;4308;22909;1139,7
-1,1,15,31098690,32446830,1348140,161725;283710;54893;51621;4308;22909;1139,7
-1,1,15,31098690,32446830,1348140,161725;283710;54893;51621;4308;22909;1139,7
-1,1,15,31112919,32444261,1331342,161725;283710;54893;51621;4308;22909;1139,7
-1,1,15,31112919,32446830,1333911,161725;283710;54893;51621;4308;22909;1139,7
-1,1,15,31115047,32418220,1303173,161725;283710;54893;51621;4308;22909;1139,7
-1,1,15,31115047,32418220,1303173,161725;283710;54893;51621;4308;22909;1139,7
1,1,15,31115047,32917801,1802754,9824;51621;653125;22909;161725;283710;54893;643699;4308;728047;1139,11
1,1,15,31126934,32444043,1317109,161725;283710;54893;51621;4308;22909;1139,7
1,-1,15,31261835,31609620,347785,4308;283710;54893,3
1,-1,15,31355015,31369385,14370,4308,1
-1,1,15,31541529,34233745,2692216,9824;51621;653125;6263;26585;342184;161725;57099;643699;728047;1139;6447,12
-1,1,15,31956606,32446830,490224,161725;1139,2
-1,1,15,31967641,32446830,479189,161725;1139,2
-1,1,15,31967641,32446830,479189,161725;1139,2
-1,1,15,31972646,32509926,537280,161725;1139,2
-1,1,15,31972646,32509926,537280,161725;1139,2
-1,1,15,31999631,32446830,447199,161725;1139,2
-1,1,15,32003537,32446830,443293,161725;1139,2
1,-1,15,32003537,32446830,443293,161725;1139,2
-1,1,15,32003537,32446830,443293,161725;1139,2
-1,1,15,32003537,32446830,443293,161725;1139,2
-1,1,15,32065077,32514957,449880,161725;1139,2
-1,1,15,32011475,32446830,435355,161725;1139,2
1,-1,15,32020625,32443019,422394,161725;1139,2
1,-1,15,32020625,32443019,422394,161725;1139,2
1,-1,15,32021733,32350044,328311,161725;1139,2
1,-1,15,32021733,32510863,489130,161725;1139,2
1,-1,15,32021733,32510863,489130,161725;1139,2
1,-1,15,32024132,32418220,394088,161725;1139,2
1,-1,15,32024132,32418220,394088,161725;1139,2
1,-1,15,32030812,32439084,408272,161725;1139,2
1,-1,15,32030812,32510067,479255,161725;1139,2
1,-1,15,32031012,32509926,478914,161725;1139,2
1,1,15,32031012,32635959,604947,161725;1139,2
1,-1,15,32064983,32430030,365047,161725;1139,2
1,-1,15,32064983,32443124,378141,161725;1139,2
1,-1,15,32064983,32509932,444949,161725;1139,2
1,-1,15,32064983,32509932,444949,161725;1139,2
1,-1,15,32064983,32509932,444949,161725;1139,2
1,-1,15,32064983,32509932,444949,161725;1139,2
1,-1,15,32064983,32509932,444949,161725;1139,2
1,-1,15,32064983,32509932,444949,161725;1139,2
1,-1,15,32064983,32509932,444949,161725;1139,2
1,-1,15,32064983,32509932,444949,161725;1139,2
1,-1,15,32064983,32509932,444949,161725;1139,2
1,-1,15,32064983,32509932,444949,161725;1139,2
-1,1,15,32065000,32445252,380252,161725;1139,2
-1,1,15,32065000,32445252,380252,161725;1139,2
1,-1,15,32065000,32509926,444926,161725;1139,2
-1,1,15,32065000,32514980,449980,161725;1139,2
-1,1,15,32065000,32514980,449980,161725;1139,2
-1,1,15,32065000,32514980,449980,161725;1139,2
-1,1,15,32065000,32514980,449980,161725;1139,2
-1,1,15,32065000,32539666,474666,161725;1139,2
-1,1,15,32065000,32676855,611855,161725;1139,2
1,-1,15,32098670,32426869,328199,161725;1139,2
1,-1,15,32098670,32908373,809703,161725;9824;643699;653125;728047;1139,6
1,-1,15,32115751,32148947,33196,161725,1
1,-1,15,32115751,32148947,33196,161725,1
1,-1,15,32248451,32510863,262412,1139,1
-1,-1,15,32462643,32861654,399011,653125;728047,2
-1,-1,15,32462643,32861654,399011,653125;728047,2
-1,-1,15,32462643,32861654,399011,653125;728047,2
-1,-1,15,32509657,32861654,351997,653125;728047,2
-1,-1,15,32539611,32861654,322043,653125;728047,2
-1,-1,15,32539611,32861654,322043,653125;728047,2
-1,-1,15,32539611,32861654,322043,653125;728047,2
-1,-1,15,32539611,32861654,322043,653125;728047,2
-1,-1,15,34695196,34841416,146220,440270,1
-1,-1,15,34695196,34841417,146221,440270,1
1,-1,15,34724213,34757001,32788,,0
-1,-1,15,34785023,34964202,179179,440270,1
1,1,15,36905047,40037396,3132349,400359;10125;4212;7057;161742;145942;161835;283742;84529,9
-1,1,15,41689327,52446981,10757654,2585;90527;23741;23582;548596;80208;4058;3706;283652;161497;10681;8669;146059;145645;2553;5597;25963;4130;9836;27229;9153;373509;1159;4236;64397;256586;825;10017;567;113201;80031;255252;79968;9318;90525;84978;9101;117155;11001;196951;23168;6652;2628;23005;8681;80237;161823;9677;51103;8773;388121;6557;197135;50506;51496;100137047;7782;2595;7158;255189;283748;23312;29767;146050;51332;23269;399694;25764;57519;140691;29766;1854;79029;197131;55142;29106;80021;2200;53905;342035;100137049;26015;123745;54822;3067;23339;7301;9728;56986;22995;26258;1588;50804;84888;146057;2252;2923;10169;84419;79895;58472;30844;399697;2038;116179;405753;23431;9333;123169;619189,110
1,1,15,41745084,102354798,60609714,1445;548596;2242;80213;4058;123355;9543;100526783;3419;79875;10021;54839;79748;5873;9399;9836;256764;440295;4236;91433;123228;23336;55055;8483;10017;54956;81556;80031;342125;51285;60677;2184;5923;84978;6938;92912;11001;196951;83640;6652;10002;145873;5045;1136;23005;663;51762;105376731;26035;56906;80153;54962;1583;170691;302;8773;123688;197135;145957;9055;64927;140460;348094;9488;390594;4947;3418;81488;9493;11057;192683;9915;5346;653641;1512;10620;123207;145773;23269;25764;57519;9899;8766;29766;10509;49855;10363;80119;23184;4091;55142;84206;10845;145853;28232;9325;23060;55898;348110;55784;100137049;26015;3067;51324;10391;400410;390598;1106;1138;54832;58489;10169;4240;116179;56965;246777;4734;5607;64410;619189;10239;54982;374618;79856;57184;2585;9236;90527;84993;59274;204219;3706;283652;10588;100820829;9377;146059;51335;2553;283659;5597;4130;145788;25963;57538;27229;145858;54878;6095;79834;114294;8128;176;64963;9455;113201;53339;10099;79631;90525;4205;55323;25989;342132;64784;55829;342096;9245;80301;64220;23168;100505679;5046;1464;771;8482;8681;374659;161823;57722;22801;9677;64782;388135;100137047;7782;27020;55215;29767;9051;146050;80349;83660;3669;366;196993;161514;91860;54939;283777;56204;5479;197131;22856;161582;9133;29106;290;145781;8120;585;2200;6176;53905;342035;55272;11173;4644;10116;25820;9728;54816;4916;9187;1588;23102;146057;83440;2252;54629;100528021;30844;161753;90381;405753;641;9333;80765;283677;646;9768;338949;57214;5604;6124;10073;23582;145946;51458;115752;64843;1143;8854;56963;145748;400451;220;80381;83464;3603;100133220;373509;1159;55466;64397;50810;1544;102;567;4122;55329;4088;84894;5780;9318;6218;117155;5315;101928527;3658;653643;8554;4123;283807;8925;3671;390616;10081;7026;26263;100128108;80125;26276;84191;388121;390637;6627;123283;79719;643707;92483;2595;7158;55070;255189;374655;390648;161502;56905;5371;53944;55930;5955;123264;1543;140691;374654;1854;10776;26589;23205;84465;91947;57188;64506;54822;51187;4643;7301;646892;3073;8826;22995;26258;64864;84888;55180;84942;4756;53346;79664;58472;55897;1198;2038;23478;54913;6642;23604;9640;4016;4649;84952;10302;145814;23741;390595;80208;79661;161497;10681;7090;79705;23423;8669;145645;55889;9153;5685;3175;256586;825;255252;79968;3990;9101;8125;123722;55075;2628;9960;27023;123624;597;51495;6457;9154;5151;80237;196996;123263;123720;54993;6557;440279;50506;51496;1381;54852;283748;5428;23312;10933;51332;10260;3480;79400;11214;399694;10519;57611;6017;145741;283726;79029;54778;10518;647042;2108;145864;197021;23251;80021;26108;64799;79811;123745;2958;23339;4828;56986;50804;51065;10066;60490;2923;84419;79895;388125;348093;257364;399697;594855;8800;25942;23431;4351;123591;54469;56964;123169;7168,452
-1,1,15,42850434,49592633,6742199,2585;7158;90527;23582;548596;23741;80208;283652;146050;161497;8669;146059;145645;399694;4130;25764;57519;140691;9836;27229;9153;619189;1159;4236;79029;1854;197131;55142;567;80021;113201;2200;53905;80031;79968;90525;9318;84978;9728;22995;26258;117155;50804;146057;2923;10169;6652;2628;84419;58472;399697;2038;116179;80237;405753;161823;9677;9333;6557;197135;50506;51496;7782,63
-1,1,15,43077825,43634458,556633,2038;9836;116179;23582;161823;9333;197131;146057;80021,9
1,-1,15,43591116,43851142,260026,9836;27229;7158;116179;161823;9677;146050;4130,8
1,-1,15,43851548,43948346,96798,117155;9677;161497;1159,4
1,-1,15,43851548,43951301,99753,117155;9677;161497;1159,4
-1,1,15,43868571,44014518,145947,117155;161497;548596;1159;9677,5
-1,-1,15,43888927,43938847,49920,117155;1159;161497,3
-1,1,15,43888927,43951301,62374,117155;1159;161497,3
-1,-1,15,43916972,43950720,33748,117155,1
-1,-1,15,43916972,43950720,33748,117155,1
-1,-1,15,43916972,43951301,34329,117155,1
1,-1,15,43916972,43951301,34329,117155,1
-1,-1,15,43916972,43951301,34329,117155,1
-1,-1,15,43916975,43951317,34342,117155,1
-1,1,15,47574384,50369056,2794672,2585;23741;9318;9728;56986;283652;22995;50804;196951;2252;399694;79895;399697;1854;6557;2200;80031,17
-1,1,15,47753041,52786419,5033378,2585;23741;283652;23312;29767;10681;2553;399694;5597;55930;29766;373509;1854;256586;29106;10017;2200;80031;342035;54822;3067;9318;4644;9728;56986;22995;9101;1588;50804;11001;84888;196951;2252;79895;399697;23431;388121;6557;123169,39
1,1,15,48728235,48793803,65568,2200,1
1,1,15,48728235,48793803,65568,2200,1
1,-1,15,50821997,51000060,178063,84888;54822;373509,3
-1,1,15,51568887,57380584,5811697,9236;29767;23312;10681;283659;5597;55930;145788;5873;256764;29766;3175;56204;256586;29106;10017;10776;161582;26108;342035;55329;4644;51187;6938;54816;1588;64864;101928527;4734;123169;440279;9488;374618,33
-1,-1,15,53845372,53901663,56291,256764,1
-1,1,15,54713558,62769295,8055737,81488;92483;9236;8854;100820829;283659;366;145788;145773;5873;145741;6095;54778;161582;9133;102;145781;26108;79811;55329;3990;2958;51187;4643;6938;54816;64864;9245;101928527;54629;54832;27023;79664;388125;663;4734;302;440279;9488;84952;374618,41
1,-1,15,57656005,57748274,92269,84952,1
1,-1,15,57656005,57748274,92269,84952,1
1,-1,15,57656005,57748274,92269,84952,1
1,-1,15,57656005,57748274,92269,84952,1
-1,1,15,58088503,62221756,4133253,92483;3990;2958;4643;8854;9245;54629;145773;366;54832;79664;27023;663;6095;54778;302;9133;102;79811,19
1,1,15,60120659,102461201,42340542,1445;2242;123355;80213;9543;100526783;3419;79875;10021;54839;79748;9399;440295;91433;123228;23336;55055;8483;54956;81556;342125;51285;60677;2184;5923;92912;83640;10002;145873;5045;1136;105376731;26035;51762;56906;80153;54962;1583;170691;302;123688;9055;145957;64927;140460;348094;390594;4947;3418;9493;11057;192683;9915;5346;653641;1512;10620;123207;9899;8766;10363;49855;10509;80119;23184;4091;84206;10845;145853;28232;9325;23060;55898;348110;55784;51324;10391;400410;390598;1106;1138;54832;58489;4240;56965;246777;5607;64410;54982;10239;79856;57184;84993;59274;204219;10588;9377;51335;57538;145858;54878;6095;79834;114294;8128;176;64963;9455;53339;10099;79631;4205;55323;25989;342132;64784;55829;342096;80301;64220;100505679;1464;5046;771;8482;374659;57722;22801;64782;388135;27020;55215;9051;83660;80349;3669;196993;161514;91860;54939;283777;5479;22856;290;585;8120;6176;55272;11173;10116;25820;4916;9187;23102;83440;100528021;161753;90381;641;80765;283677;646;9768;6124;338949;5604;10073;57214;51458;64843;145946;115752;1143;56963;145748;400451;220;80381;83464;3603;100133220;55466;50810;1544;4122;4088;84894;5780;6218;5315;3658;653643;8554;4123;390616;283807;8925;3671;10081;80125;26263;26276;7026;100128108;84191;390637;6627;123283;79719;643707;55070;374655;390648;161502;56905;5371;53944;5955;123264;1543;374654;26589;23205;84465;57188;91947;64506;3073;646892;8826;55180;84942;4756;53346;79664;55897;1198;23478;54913;6642;23604;9640;4016;4649;10302;145814;390595;79661;79705;7090;23423;55889;5685;8125;123722;55075;9960;27023;123624;597;51495;6457;9154;5151;196996;123263;123720;54993;1381;54852;390649;10933;5428;10260;3480;79400;11214;10519;57611;6017;145741;283726;10518;647042;2108;145864;197021;23251;64799;4828;51065;10066;60490;388125;348093;257364;594855;8800;25942;4351;123591;54469;56964;7168,304
-1,1,15,70317639,78998335,8680696,57184;1445;338949;10073;84993;79661;64843;1143;3419;79875;10021;7090;9377;54839;79748;55889;80381;9399;5685;55466;123228;79834;1544;60677;10099;84894;5780;55323;25989;92912;5315;64220;3658;55075;653643;10002;1464;1136;105376731;4123;56906;3671;1583;80153;80125;8482;196996;26263;388135;123688;145957;1381;27020;192683;653641;9051;80349;56905;5371;10620;196993;5955;1543;161514;57611;54939;10363;49855;10518;2108;23205;585;55272;25820;3073;646892;23102;10066;83440;1138;60490;4756;257364;1198;161753;594855;54913;25942;4351;56965;123591;342096;4016;4649;283677,95
1,1,15,72447290,102461201,30013911,646;1445;338949;10073;57214;145946;2242;51458;64843;123355;1143;80213;100526783;3419;10021;56963;145748;79748;400451;220;80381;9399;3603;440295;100133220;55466;91433;23336;50810;1544;4122;342125;60677;2184;84894;5780;5923;92912;6218;5315;83640;3658;653643;145873;5045;1136;105376731;80153;4123;3671;1583;390616;80125;7026;26263;26276;170691;100128108;123688;9055;145957;390637;64927;140460;6627;123283;643707;3418;11057;192683;9915;55070;5346;374655;653641;1512;390648;56964;161502;56905;5371;10620;123207;5955;1543;9899;374654;10363;49855;10509;23184;84206;26589;28232;23205;55898;57188;55784;348110;91947;64506;3073;646892;8826;400410;1106;1138;84942;55180;4756;58489;53346;4240;55897;1198;23478;54913;56965;9640;64410;10239;4016;57184;145814;84993;79661;59274;204219;79705;10588;23423;9377;51335;55889;57538;145858;5685;79834;8128;176;64963;9455;53339;10099;79631;4205;25989;342132;64784;55829;123722;64220;100505679;1464;5046;123624;597;6457;9154;5151;8482;196996;374659;64782;123720;388135;54993;1381;27020;55215;390649;10933;9051;80349;5428;3480;11214;3669;10519;161514;57611;6017;54939;283726;283777;10518;22856;647042;2108;145864;290;585;23251;8120;55272;11173;4828;25820;4916;23102;10066;83440;60490;100528021;257364;161753;90381;594855;8800;25942;641;4351;123591;80765;54469;342096;283677,217
1,-1,15,72921369,72957425,36056,55889,1
-1,1,15,72943184,75567198,2624014,57184;1445;192683;84993;653641;10021;9377;5371;10620;56905;79748;55889;80381;161514;9399;57611;1543;1544;585;283677;25989;10066;83440;64220;60490;4756;1198;105376731;594855;8482;80153;3671;1583;54913;80125;4351;388135;342096;4016;27020,40
-1,1,15,72963970,75535330,2571360,57184;1445;192683;84993;10021;9377;5371;10620;56905;79748;80381;161514;9399;57611;1543;1544;585;283677;25989;10066;83440;64220;60490;4756;1198;105376731;594855;8482;80153;3671;1583;54913;80125;4351;388135;342096;4016;27020,38
-1,1,15,72977572,76019966,3042394,57184;1445;192683;10073;84993;79661;653641;10021;9377;5371;10620;56905;79748;80381;161514;9399;57611;1543;54939;1544;585;55272;5780;283677;25989;10066;83440;64220;60490;4756;653643;1464;257364;1198;161753;105376731;594855;8482;80153;3671;1583;54913;80125;4351;4123;25942;388135;342096;4016;27020,50
-1,1,15,74399305,76040549,1641244,57184;1445;192683;10073;84993;79661;653641;9377;10620;56905;79748;57611;1543;54939;1544;55272;5780;25989;10066;64220;60490;653643;1464;257364;1198;161753;105376731;594855;8482;80153;3671;1583;54913;80125;4351;4123;25942,37
-1,1,15,75535348,76040549,505201,257364;161753;55272;54939;5780;4123;25942;79661;10073;653641;653643;1464,12
-1,-1,15,75541862,75589035,47173,653643;653641,2
1,-1,15,75552647,75580628,27981,653643;653641,2
1,-1,15,75552647,75580628,27981,653643;653641,2
1,-1,15,75552647,75580628,27981,653643;653641,2
1,-1,15,75552647,75580628,27981,653643;653641,2
1,-1,15,75552647,75589035,36388,653643;653641,2
1,-1,15,75562397,75580623,18226,653643;653641,2
1,-1,15,75562397,75580623,18226,653643;653641,2
1,-1,15,75562397,75586721,24324,653643;653641,2
1,-1,15,75562397,75586721,24324,653643;653641,2
1,-1,15,75562397,75586721,24324,653643;653641,2
1,-1,15,75562397,75586721,24324,653643;653641,2
1,-1,15,75562397,75586721,24324,653643;653641,2
1,-1,15,75562397,75586721,24324,653643;653641,2
1,-1,15,75562397,75586721,24324,653643;653641,2
1,-1,15,75562397,75586721,24324,653643;653641,2
1,-1,15,75562397,75586721,24324,653643;653641,2
1,-1,15,75562397,75586721,24324,653643;653641,2
1,-1,15,75562397,75588048,25651,653643;653641,2
1,-1,15,75562401,75589035,26634,653643;653641,2
1,1,15,76061144,102429112,26367968,646;57214;145946;2242;51458;64843;123355;1143;80213;100526783;3419;56963;145748;400451;220;3603;440295;100133220;55466;91433;23336;50810;4122;342125;2184;84894;5923;92912;6218;83640;3658;145873;5045;1136;390616;7026;26263;26276;170691;100128108;123688;9055;145957;390637;64927;140460;6627;123283;643707;3418;11057;9915;55070;5346;374655;1512;390648;161502;123207;5955;9899;374654;10363;49855;10509;23184;84206;26589;28232;23205;55898;57188;55784;348110;91947;64506;646892;8826;400410;1106;1138;84942;55180;58489;53346;4240;55897;23478;9640;64410;10239;145814;59274;204219;79705;10588;23423;51335;57538;145858;5685;79834;8128;176;64963;9455;53339;10099;79631;4205;342132;64784;55829;123722;100505679;5046;123624;597;6457;9154;5151;374659;64782;123720;54993;1381;55215;390649;10933;9051;80349;5428;3480;11214;3669;10519;6017;283726;283777;10518;22856;647042;2108;145864;290;8120;23251;11173;4828;4916;23102;100528021;90381;8800;641;123591;80765;54469;56964,159
-1,1,15,76298495,80274759,3976264,64843;1143;10933;9051;80349;3419;1512;10588;23423;5955;5685;10363;49855;55466;79834;10518;2108;23205;23251;10099;84894;11173;5923;646892;400410;23102;1138;3658;100528021;1136;597;390616;123591;123688;145957;1381,36
1,1,15,77354675,98130043,20775368,646;57214;145946;2242;51458;59274;1143;100526783;3419;10588;23423;56963;51335;400451;3603;440295;57538;145858;100133220;5685;55466;91433;79834;8128;50810;176;64963;9455;53339;4122;342125;2184;10099;84894;79631;5923;6218;342132;64784;123722;83640;3658;145873;100505679;5045;123624;1136;597;6457;9154;5151;390616;374659;7026;64782;26276;123720;54993;123688;9055;390637;1381;643707;3418;55215;11057;9915;55070;5346;374655;10933;80349;1512;5428;56964;161502;123207;11214;3669;10519;6017;9899;374654;10363;10509;283726;23184;10518;84206;647042;145864;26589;28232;23205;290;8120;23251;55898;57188;55784;348110;64506;11173;4828;646892;8826;4916;400410;23102;1106;1138;84942;58489;53346;100528021;4240;55897;23478;90381;8800;641;80765;54469;9640;64410;10239,126
-1,-1,15,77611057,77634432,23375,79834,1
1,-1,15,77722862,77737043,14181,10363,1
1,1,15,80648093,102429112,21781019,646;145814;57214;145946;2242;51458;123355;80213;59274;204219;100526783;79705;56963;51335;145748;400451;220;3603;440295;57538;145858;100133220;91433;8128;23336;50810;176;64963;9455;53339;4122;342125;79631;4205;6218;342132;64784;55829;123722;83640;145873;100505679;5045;5046;123624;6457;9154;5151;374659;7026;64782;26276;170691;100128108;123720;9055;54993;390637;64927;140460;6627;123283;643707;3418;55215;11057;9915;55070;5346;374655;390649;5428;390648;56964;161502;3480;123207;11214;3669;10519;6017;9899;374654;10509;283726;283777;23184;22856;84206;647042;145864;26589;28232;290;8120;55898;57188;55784;348110;91947;64506;4828;8826;4916;1106;55180;84942;58489;53346;4240;55897;23478;90381;8800;641;80765;9640;64410;10239,119
-1,1,15,80703867,83955596,3251729,646;79631;64506;57214;9915;59274;6218;161502;123722;123207;83640;58489;53346;9455;3603;440295;283726;23184;123720;84206;647042;50810;80765;8120;53339;342125,26
1,1,15,83528428,102351195,18822767,646;145814;145946;2242;51458;123355;80213;204219;100526783;79705;56963;51335;145748;400451;220;57538;145858;100133220;91433;8128;23336;50810;176;64963;9455;53339;4122;4205;342132;64784;55829;83640;145873;100505679;5045;5046;123624;6457;9154;5151;374659;7026;64782;26276;170691;100128108;54993;9055;390637;64927;140460;6627;123283;643707;3418;55215;11057;5346;55070;374655;5428;390648;56964;3480;123207;11214;3669;10519;6017;9899;374654;10509;283777;22856;145864;26589;28232;290;55898;57188;55784;348110;91947;4828;8826;4916;1106;55180;84942;53346;4240;55897;23478;90381;8800;641;9640;64410;10239,99
-1,-1,15,83770116,83960718,190602,646;50810;53346,3
1,1,15,84380129,102383473,18003344,145814;145946;2242;51458;123355;80213;204219;100526783;79705;56963;51335;145748;400451;220;57538;145858;100133220;91433;8128;23336;176;64963;4122;4205;342132;64784;55829;145873;100505679;5045;5046;123624;9154;5151;374659;7026;64782;26276;170691;100128108;54993;9055;390637;64927;140460;6627;123283;643707;3418;55215;11057;5346;55070;390649;374655;5428;390648;56964;3480;11214;3669;10519;6017;9899;374654;10509;283777;22856;145864;26589;28232;290;55898;57188;91947;55784;348110;4828;8826;4916;1106;55180;84942;4240;55897;23478;90381;8800;641;9640;64410;10239,92
1,1,15,85089467,102495441,17405974,145814;145946;2242;51458;123355;80213;204219;100526783;79705;56963;51335;145748;400451;220;57538;145858;100133220;91433;8128;23336;176;64963;4122;4205;342132;64784;55829;26682;145873;5045;5046;123624;9154;5151;374659;7026;64782;26276;170691;100128108;54993;9055;390637;64927;140460;6627;123283;3418;55215;11057;5346;55070;390649;374655;5428;390648;56964;3480;11214;3669;10519;6017;9899;374654;10509;283777;22856;145864;26589;28232;290;55898;91947;55784;348110;4828;8826;4916;1106;55180;84942;4240;55897;23478;90381;8800;641;9640;64410;10239,90
1,-1,15,85771281,86136957,365676,100133220;11214,2
1,-1,15,85834072,86088001,253929,11214,1
1,-1,15,85834072,86101813,267741,11214,1
1,1,15,85940770,102429112,16488342,145814;145946;2242;51458;123355;80213;204219;100526783;79705;56963;51335;145748;400451;220;145858;91433;8128;23336;176;64963;4122;4205;342132;64784;55829;145873;5045;5046;123624;374659;7026;64782;26276;170691;100128108;9055;390637;64927;140460;6627;123283;3418;55215;11057;5346;55070;390649;374655;5428;390648;3480;11214;3669;10519;6017;9899;374654;10509;283777;22856;145864;26589;28232;290;55898;91947;55784;348110;8826;4916;1106;55180;4240;55897;90381;8800;641;56964;64410;10239,80
1,1,15,86148286,102511616,16363330,145814;145946;2242;51458;123355;80213;204219;100526783;79705;56963;51335;145748;400451;220;145858;91433;8128;23336;176;64963;4122;4205;342132;64784;55829;26682;145873;5045;5046;123624;374659;7026;64782;26276;170691;100128108;9055;390637;64927;140460;6627;123283;3418;55215;11057;5346;55070;390649;374655;5428;390648;3480;11214;3669;10519;6017;9899;374654;10509;283777;22856;145864;26589;28232;290;55898;91947;55784;348110;8826;4916;1106;55180;4240;55897;90381;8800;641;56964;64410;10239,81
1,1,15,86369896,102461201,16091305,145814;145946;2242;51458;123355;80213;204219;100526783;79705;56963;51335;145748;400451;220;145858;91433;8128;23336;176;64963;4122;4205;342132;64784;55829;145873;5045;5046;123624;374659;7026;64782;26276;170691;100128108;9055;390637;64927;140460;6627;123283;3418;55215;11057;5346;55070;390649;374655;5428;390648;3480;3669;10519;6017;9899;374654;10509;283777;22856;145864;26589;28232;290;55898;91947;55784;348110;8826;4916;1106;55180;4240;55897;90381;8800;641;56964;10239,78
-1,1,15,88295992,94215607,5919615,55215;3418;11057;5346;55070;374655;51458;2242;5428;100526783;56963;51335;3669;10519;400451;6017;9899;145858;374654;10509;91433;8128;145864;26589;176;64963;290;28232;55898;4122;348110;4916;8826;342132;64784;1106;145873;4240;55897;5045;90381;8800;374659;641;64782;26276;9055;390637;56964;10239,50
1,1,15,88447966,102383473,13935507,145814;145946;2242;51458;123355;204219;80213;100526783;79705;56963;51335;145748;400451;220;145858;91433;8128;23336;176;64963;4122;4205;342132;64784;55829;145873;5045;5046;374659;7026;64782;26276;170691;100128108;9055;390637;64927;140460;6627;123283;55215;3418;11057;5346;55070;390649;374655;5428;390648;3480;3669;10519;6017;9899;374654;10509;283777;22856;145864;26589;28232;290;55898;91947;55784;348110;4916;8826;1106;55180;55897;4240;90381;8800;641;56964;10239,77
1,1,15,89219806,98907972,9688166,55215;3418;11057;5346;145946;374655;51458;2242;5428;100526783;56963;51335;10519;400451;6017;9899;145858;374654;10509;91433;8128;145864;176;290;28232;55898;91947;4122;348110;55784;8826;342132;64784;1106;145873;55897;4240;5045;90381;8800;374659;641;7026;26276;9055;390637;56964;10239,48
1,1,15,89817501,102383473,12565972,145814;145946;2242;51458;123355;204219;80213;100526783;79705;56963;51335;145748;400451;220;145858;91433;8128;23336;4122;4205;342132;64784;55829;145873;5045;5046;374659;7026;26276;170691;100128108;9055;390637;64927;140460;6627;123283;55215;3418;5346;390649;374655;5428;390648;3480;10519;9899;374654;10509;283777;22856;28232;290;55898;91947;55784;348110;8826;1106;55180;55897;90381;8800;641;56964;10239,66
1,1,15,89817712,102444623,12626911,145814;145946;2242;51458;123355;204219;80213;100526783;79705;56963;51335;145748;400451;220;145858;91433;8128;23336;4122;4205;342132;64784;55829;145873;5045;5046;374659;7026;26276;170691;100128108;9055;390637;64927;140460;6627;123283;55215;3418;5346;390649;374655;5428;390648;3480;10519;9899;374654;10509;283777;22856;28232;290;55898;91947;55784;348110;8826;1106;55180;55897;90381;8800;641;56964;10239,66
1,1,15,89924847,102429112,12504265,145814;145946;2242;51458;123355;204219;80213;100526783;79705;56963;51335;145748;400451;220;145858;91433;8128;23336;4122;4205;342132;64784;55829;145873;5045;5046;374659;7026;26276;170691;100128108;9055;390637;64927;140460;6627;123283;3418;5346;390649;374655;390648;3480;10519;9899;374654;10509;283777;22856;28232;290;55898;91947;55784;348110;8826;1106;55180;55897;90381;8800;641;56964;10239,64
-1,1,15,90346994,102354798,12007804,3418;145814;145946;374655;2242;123355;204219;80213;100526783;79705;390648;56963;3480;51335;145748;10519;400451;220;9899;145858;10509;283777;91433;8128;23336;22856;28232;290;55898;91947;4122;348110;55784;4205;8826;342132;64784;55829;1106;55180;5045;5046;374659;641;7026;10239;26276;170691;100128108;9055;390637;64927;140460;6627;123283,55
1,-1,15,90857664,90943754,86090,8826;342132,2
-1,1,15,91589712,93889459,2299747,9899;145858;28232;1106;56963;400451;8128,7
1,-1,15,92397220,92592961,195741,28232,1
1,1,15,93148806,102429112,9280306,145814;390649;145946;4205;123355;204219;80213;79705;390648;55829;56963;3480;1106;55180;145748;400451;220;5046;283777;7026;23336;22856;170691;100128108;64927;140460;6627;123283;91947;55784,30
-1,1,15,93506889,93574471,67582,1106,1
1,1,15,93584754,102481529,8896775,145814;390649;145946;4205;123355;204219;80213;79705;390648;55829;26682;56963;3480;55180;145748;220;5046;283777;7026;23336;22856;170691;100128108;64927;140460;6627;123283;91947;55784,29
-1,1,15,93741946,102383473,8641527,145814;390649;145946;4205;123355;204219;80213;79705;390648;55829;3480;55180;145748;220;5046;283777;7026;23336;22856;170691;100128108;64927;140460;6627;123283;91947;55784,27
-1,1,15,93741946,102383473,8641527,145814;390649;145946;4205;123355;204219;80213;79705;390648;55829;3480;55180;145748;220;5046;283777;7026;23336;22856;170691;100128108;64927;140460;6627;123283;91947;55784,27
-1,-1,15,93805530,93889806,84276,,0
-1,-1,15,94150634,94218046,67412,,0
-1,-1,15,94218046,94334589,116543,,0
1,-1,15,94285748,94529561,243813,,0
-1,1,15,94348261,101867081,7518820,145814;145946;4205;123355;204219;79705;55829;3480;55180;145748;220;5046;283777;7026;23336;22856;170691;64927;140460;6627;91947;55784,22
-1,1,15,94782891,102429112,7646221,145814;390649;145946;4205;123355;204219;80213;79705;390648;55829;3480;55180;145748;220;5046;283777;7026;23336;22856;170691;100128108;64927;140460;6627;123283;91947;55784,27
-1,1,15,95013454,102521392,7507938,145814;390649;145946;4205;123355;204219;80213;79705;390648;55829;26682;3480;55180;145748;220;5046;283777;7026;23336;22856;170691;100128108;64927;140460;6627;123283;91947;55784,28
-1,1,15,95136822,102045577,6908755,145814;145946;4205;123355;204219;79705;55829;3480;55180;145748;220;5046;283777;7026;23336;22856;170691;64927;140460;6627;91947,21
1,1,15,95202449,98779894,3577445,145946;7026;91947,3
-1,1,15,95238218,102429112,7190894,145814;390649;145946;4205;123355;204219;80213;79705;390648;55829;3480;55180;145748;220;5046;283777;7026;23336;22856;170691;100128108;64927;140460;6627;123283;91947,26
-1,1,15,96313856,102351195,6037339,145814;145946;4205;123355;204219;80213;79705;390648;55829;3480;55180;145748;220;5046;283777;7026;23336;22856;170691;100128108;64927;140460;6627;123283;91947,25
-1,1,15,96567356,102461201,5893845,145814;390649;145946;4205;123355;204219;80213;79705;390648;55829;3480;55180;145748;220;5046;283777;7026;23336;22856;170691;100128108;64927;140460;6627;123283;91947,26
1,-1,15,96873441,96875578,2137,7026,1
-1,1,15,96913435,102429112,5515677,145814;390649;145946;4205;123355;204219;80213;79705;390648;55829;3480;55180;145748;220;5046;283777;23336;22856;170691;100128108;64927;140460;6627;123283;91947,25
-1,1,15,97223728,102429112,5205384,145814;390649;145946;4205;123355;204219;80213;79705;390648;55829;3480;55180;145748;220;5046;283777;23336;22856;170691;100128108;64927;140460;6627;123283;91947,25
-1,1,15,97557295,102383473,4826178,145814;390649;4205;123355;204219;80213;79705;390648;55829;3480;55180;145748;220;5046;283777;23336;22856;170691;100128108;64927;140460;6627;123283;91947,24
-1,1,15,97715984,102461201,4745217,145814;390649;4205;123355;204219;80213;79705;390648;55829;3480;55180;145748;220;5046;283777;23336;22856;170691;100128108;64927;140460;6627;123283;91947,24
-1,1,15,98220018,102429112,4209094,145814;390649;4205;123355;204219;80213;79705;390648;55829;3480;55180;145748;220;5046;283777;23336;22856;170691;100128108;64927;140460;6627;123283;91947,24
-1,1,15,98224943,102461201,4236258,145814;390649;4205;123355;204219;80213;79705;390648;55829;3480;55180;145748;220;5046;283777;23336;22856;170691;100128108;64927;140460;6627;123283;91947,24
-1,1,15,98484657,102338129,3853472,145814;4205;123355;204219;80213;79705;55829;3480;55180;145748;220;5046;283777;23336;22856;170691;100128108;64927;140460;6627;123283;91947,22
-1,-1,15,98554119,98685713,131594,,0
-1,1,15,98628330,102383473,3755143,145814;390649;4205;123355;204219;80213;79705;390648;55829;3480;55180;145748;220;5046;283777;23336;22856;170691;100128108;64927;140460;6627;123283,23
1,1,15,98668456,99927895,1259439,145814;64927;3480;283777;123355;23336,6
-1,1,15,98737093,102429112,3692019,145814;390649;4205;123355;204219;80213;79705;390648;55829;3480;55180;145748;220;5046;283777;23336;22856;170691;100128108;64927;140460;6627;123283,23
-1,1,15,98818228,102399760,3581532,145814;390649;4205;123355;204219;80213;79705;390648;55829;3480;55180;145748;220;5046;283777;23336;22856;170691;100128108;64927;140460;6627;123283,23
1,1,15,98823526,102429112,3605586,145814;390649;4205;123355;204219;80213;79705;390648;55829;3480;55180;145748;220;5046;283777;23336;22856;170691;100128108;64927;140460;6627;123283,23
-1,1,15,99010526,102383473,3372947,145814;390649;4205;123355;204219;80213;79705;390648;55829;3480;55180;145748;220;5046;283777;23336;22856;170691;100128108;64927;140460;6627;123283,23
-1,1,15,99435936,99722958,287022,145814;64927;3480;23336,4
-1,1,15,99696192,102383473,2687281,390649;4205;123355;204219;80213;79705;55829;390648;55180;145748;5046;220;170691;22856;100128108;64927;140460;6627;123283,19
1,1,15,99878488,102383473,2504985,390649;4205;123355;80213;204219;79705;55829;390648;55180;145748;5046;220;170691;22856;100128108;140460;6627;123283,18
-1,1,15,99927895,102399814,2471919,390649;4205;123355;80213;204219;79705;55829;390648;55180;145748;5046;220;170691;22856;100128108;140460;6627;123283,18
1,-1,15,100411220,100598650,187430,170691,1
1,-1,15,100492038,100591941,99903,170691,1
1,-1,15,101710679,102014393,303714,6627;55829;5046;22856,4
1,-1,15,101780775,102009117,228342,6627;55829;5046;22856,4
-1,-1,15,101935884,101992296,56412,5046,1
1,-1,15,102014334,102256748,242414,80213;123283;5046,3
1,-1,15,102040846,102256734,215888,80213;123283,2
1,-1,15,102040980,102263418,222438,80213;123283,2
1,-1,15,102161480,102206379,44899,80213;123283,2
1,-1,15,102161480,102249013,87533,80213;123283,2
1,-1,15,102161480,102249013,87533,80213;123283,2
1,-1,15,102161480,102249013,87533,80213;123283,2
1,-1,15,102161480,102249013,87533,80213;123283,2
1,-1,15,102161506,102252063,90557,80213;123283,2
1,-1,15,102161506,102252063,90557,80213;123283,2
1,-1,15,102161506,102252063,90557,80213;123283,2
1,-1,15,102226242,102263418,37176,123283,1
1,-1,15,102226242,102263418,37176,123283,1
1,-1,15,102234331,102263389,29058,123283,1
1,-1,15,102415472,102502618,87146,26682,1
1,-1,16,62993,82412,19419,,0
1,-1,16,62993,82412,19419,,0
-1,-1,16,66203,82412,16209,,0
1,-1,16,66203,82412,16209,,0
1,-1,16,66203,82412,16209,,0
1,-1,16,66203,82412,16209,,0
1,-1,16,66203,179080,112877,4350;51728;79622;64285;8131,5
1,-1,16,69193,82412,13219,,0
1,-1,16,69193,82412,13219,,0
1,-1,16,69193,82412,13219,,0
1,-1,16,69193,82412,13219,,0
1,-1,16,69193,82412,13219,,0
1,-1,16,69193,82412,13219,,0
1,1,16,69193,90274381,90205188,4682;64785;100862671;1258;6361;23594;83719;84560;3039;6560;25839;146177;368;64779;197358;1535;79874;84256;146395;728734;8720;408050;51090;10942;7567;7041;21;1540;84290;124446;5073;899;4913;11345;29965;10261;9289;55282;2775;57465;112479;653550;58531;23417;92806;9738;146310;10421;64223;146198;3040;85320;730183;84231;445329;728689;25970;146429;89941;54442;8883;124222;6923;100132247;5620;112869;55815;54820;9810;24150;79077;10328;4501;5531;9088;83886;7284;729993;3835;9274;124491;3801;10204;374739;16;123920;283869;3049;51330;9057;8717;51734;84706;101059953;9351;8912;57478;6817;113000;7627;55512;51005;51764;2294;5681;81631;254528;4917;93517;79728;3681;54957;79724;10143;161931;6810;91862;6123;6911;10573;4775;27183;57585;9605;6236;124359;100506581;23322;29855;51573;64180;83693;260429;3687;54550;3042;1387;5261;2935;84219;23430;63922;728276;6755;1327;5257;84916;390748;29800;6559;56052;348174;146456;28987;146562;23174;29948;1874;51333;6345;100287036;3250;646174;342371;79759;8139;5713;5310;283847;221191;79153;5652;260434;84080;54921;6650;55625;54849;26470;55794;780776;55565;197322;83986;65057;54971;124404;28955;23090;146540;3566;221184;92595;2175;9284;7874;5347;3291;4502;388284;146433;10200;84501;9093;84627;10381;5699;197335;54920;23049;6340;90850;1783;51025;4489;11060;7385;865;9717;255919;101059938;23274;23659;730094;9143;64131;1009;1186;100529251;9914;83985;79152;78994;79585;117166;55718;50615;9235;283927;404550;197342;9726;146378;9080;1731;6477;146225;81577;2622;2813;7329;6137;2521;8786;5595;29105;4363;55623;3050;57149;29904;342372;388228;390664;146439;22928;752014;57407;124093;548593;4499;6367;124245;51172;80063;23406;221223;9564;6376;3394;124401;22879;80777;79903;164;6645;116028;81889;84891;729264;51061;57687;51673;64063;267;54715;10595;10273;440345;10921;8448;124045;161882;4496;22980;81533;388199;2653;204474;50855;552900;85407;23035;116285;124056;23475;283848;84464;55238;115992;4597;100529144;613037;100131303;51741;1504;84662;4832;583;339145;1632;146556;23644;79801;93129;64499;497190;653808;146542;253980;5432;8479;10131;84138;5619;23361;653319;123811;7023;57496;8824;283971;84148;8303;64282;113540;80004;10423;92822;84656;6693;5170;9688;5930;283897;29035;4504;2903;608;65993;7755;9114;4833;51283;7369;4166;90835;1723;253982;9665;1773;124460;79918;4493;55715;124274;1428;11051;1775;83657;10295;55839;53630;51192;79652;255762;3240;10101;57610;55697;4150;23300;57215;51108;123803;100507607;9785;440335;7783;4494;26156;6818;29070;3931;2734;58189;29123;55783;4490;92154;23247;84752;2300;29108;763;10847;197320;92922;57019;146212;7571;79007;79447;124044;57524;79786;114780;4157;79583;64319;6799;10164;8663;10725;1012;643911;728888;23568;27324;79567;729159;2072;27189;728741;9951;197258;57338;1039;23589;124411;4992;79831;8938;221188;100463285;7249;30812;283899;123970;146325;7142;197370;115939;5934;226;113;57546;388289;23295;9764;64711;84264;58986;51760;63928;170692;10265;3281;79622;115584;9709;9961;54386;9894;255027;107282092;348158;79641;197259;4993;51659;7727;81831;55911;1013;1014;89927;25837;91949;283870;643802;57020;654483;6483;162083;79190;90861;84331;80262;56061;83723;114984;94160;1459;6338;4261;89970;2013;2303;54620;10294;1006;55114;51647;8399;29100;10232;79228;4094;339123;79650;398;283948;23204;3683;9013;83716;23059;388282;930;91807;54988;55737;79767;4706;23214;55692;9798;5373;527;54758;55027;112755;26471;1489;8312;54925;80205;26231;463;80790;84229;100129697;23420;729355;348180;26063;6210;81620;5119;869;51327;7014;10300;4350;64788;25823;7760;3684;3038;2588;196483;29117;3299;55308;100130958;6299;57799;11269;162239;146223;283849;64400;2671;10428;1800;64755;146547;343;642799;642778;26000;146279;645811;51704;23019;56942;11105;9074;283953;64714;124454;23162;84326;79191;54496;51693;146434;11151;64146;283820;388276;3483;29109;5336;339105;25894;197257;9727;51451;10368;79091;79791;3294;353;64174;27040;390667;162073;65990;8651;8140;57146;5493;18;79006;93107;1339;222487;9956;26048;84937;146206;4313;83752;3735;257629;29066;55567;23117;79613;54947;6898;9516;8131;9683;55066;493829;79726;79798;90864;79068;146227;27327;1201;27132;84166;4324;9344;81691;440387;25880;146330;84342;65988;55313;124220;54768;146167;84516;1003;9091;2975;79412;54700;65009;342357;283951;3029;2806;55336;6296;146183;487;4495;55159;10229;181;123775;64127;57017;794;123876;400506;23563;388272;5579;197407;9739;57567;7084;342346;91151;9028;100288332;999;123879;23536;9742;6553;283871;1877;85445;4210;10308;123872;54985;83449;333929;23524;1728;84901;80178;1071;79001;283933;29895;7177;51388;80152;863;64285;84309;115;123904;23042;92017;1001;10607;6530;55239;3163;23199;84572;11273;7752;112476;1066;51728;124402;79838;9780;115509;64718;10127;766;23450;1506;10664;80011;57707;114990;64428;80270;440348;79905;246778;8996;23062;360226;23491;4716;64386;118460;6687;4629;6524;79008;9100;6187;124152;8558,812
-1,-1,16,72569,82612,10043,,0
-1,-1,16,72769,82412,9643,,0
-1,-1,16,72769,82412,9643,,0
-1,-1,16,72769,82412,9643,,0
-1,-1,16,72769,82412,9643,,0
-1,-1,16,72769,82412,9643,,0
-1,-1,16,72769,82412,9643,,0
-1,-1,16,72769,82412,9643,,0
-1,-1,16,72769,82412,9643,,0
-1,-1,16,72769,82412,9643,,0
-1,-1,16,72769,82412,9643,,0
-1,-1,16,72769,82412,9643,,0
-1,-1,16,72769,82412,9643,,0
-1,-1,16,72769,82412,9643,,0
1,-1,16,72769,82412,9643,,0
-1,-1,16,72769,82412,9643,,0
-1,-1,16,72769,82412,9643,,0
-1,-1,16,72769,82412,9643,,0
-1,-1,16,72769,82412,9643,,0
-1,-1,16,72769,82412,9643,,0
-1,-1,16,72769,82412,9643,,0
-1,-1,16,72769,82412,9643,,0
-1,-1,16,72769,82412,9643,,0
-1,-1,16,72769,82412,9643,,0
-1,-1,16,72769,82412,9643,,0
-1,-1,16,72769,82412,9643,,0
-1,-1,16,72769,82412,9643,,0
-1,-1,16,72769,82412,9643,,0
-1,-1,16,72769,82412,9643,,0
-1,-1,16,72769,82412,9643,,0
-1,-1,16,72769,82412,9643,,0
-1,-1,16,72769,82412,9643,,0
-1,-1,16,72769,82412,9643,,0
-1,-1,16,72769,82412,9643,,0
-1,-1,16,72798,82437,9639,,0
1,1,16,78801,9169448,9090647,90850;51025;645811;3039;9074;283953;64714;9717;23162;84326;197358;9143;146434;84256;1186;57524;3483;10942;9727;117166;79585;79091;9235;197342;21;9080;390667;65990;899;4913;29965;7329;5493;8786;79006;18;57465;3050;26048;23589;146310;4992;8938;390664;146439;64223;3040;100463285;7249;30812;752014;57407;146325;124093;84231;115939;89941;54442;51172;23295;8131;64711;84264;58986;124222;79622;6923;90864;124401;9894;79903;79641;9088;83886;81889;84891;4993;7727;25880;64063;146330;54715;10273;283869;10921;3049;124220;51330;25837;51734;9091;9351;8912;388199;113000;79412;283870;7627;283951;3029;51005;51764;254528;4917;124056;90861;84331;84464;100529144;114984;84662;4832;6123;1632;10573;146556;57585;64499;342346;91151;9028;29855;260429;9742;10131;283871;10232;79228;1877;3042;1387;339123;4210;398;283948;54985;84219;7023;23430;23524;23059;63922;80178;6755;7177;84656;5170;56052;55692;5373;527;64285;84309;65993;115;7755;146562;4833;8312;54925;10607;1773;3163;6345;84572;7752;646174;1775;51728;124402;26063;5310;64718;10127;79652;6650;10101;4350;64428;64788;25823;7760;114990;196483;360226;83986;4716;64386;440335;124404;57799;7874;6187;9093;2671;197335,196
-1,1,16,85880,643107,557227,6650;3040;64285;4350;146325;3039;4833;8312;64714;3042;8131;398;83986;58986;8786;283948;79622;3049;57799;3050;10573;51728;9091;26063;9727;55692,26
-1,1,16,85880,754083,668203,3040;64285;146325;84331;3039;4833;8312;64714;89941;8131;58986;84326;79622;10573;51728;26063;9727;117166;6650;9028;4350;3042;146330;339123;398;83986;8786;283948;10273;84219;3049;57799;3050;9091;197335;55692,36
1,1,16,85880,9883129,9797249,90850;51025;645811;3039;9074;283953;64714;9717;23162;84326;197358;9143;146434;84256;1186;57524;3483;10942;9727;117166;79585;79091;9235;197342;21;9080;390667;65990;899;4913;29965;7329;5493;8786;79006;18;57465;3050;26048;23589;146310;4992;8938;390664;146439;64223;3040;100463285;7249;30812;752014;57407;146325;124093;84231;115939;89941;54442;51172;23295;8131;64711;84264;58986;124222;79622;6923;90864;124401;9894;79903;79641;9088;83886;81889;84891;4993;7727;25880;64063;146330;54715;10273;283869;10921;3049;124220;51330;25837;51734;9091;9351;8912;388199;113000;79412;283870;7627;283951;3029;51005;51764;254528;4917;124056;90861;84331;84464;100529144;114984;84662;4832;6123;1632;10573;146556;57585;64499;342346;91151;9028;29855;260429;9742;10131;283871;10232;79228;1877;3042;1387;339123;4210;398;283948;54985;84219;7023;23430;23524;23059;63922;80178;6755;7177;84656;5170;56052;55692;5373;527;64285;84309;29035;2903;65993;115;7755;146562;4833;8312;54925;10607;1773;3163;6345;84572;7752;646174;1775;51728;124402;26063;5310;64718;10127;79652;6650;10101;4350;64428;64788;25823;7760;114990;196483;360226;83986;4716;64386;440335;124404;57799;7874;6187;9093;2671;197335,198
1,1,16,85880,19806921,19721041,4682;3039;368;197358;84256;57524;408050;10942;21;5073;899;4913;29965;2072;57465;58531;23589;9738;146310;4992;8938;64223;3040;100463285;7249;30812;146325;7142;84231;115939;89941;54442;23295;64711;84264;58986;51760;124222;79622;6923;5620;54820;9894;255027;79641;9088;83886;729993;4993;7727;283869;3049;51330;89927;25837;51734;101059953;9351;8912;113000;283870;7627;51005;51764;57020;254528;4917;90861;84331;114984;6123;4261;10573;57585;2013;29855;51573;8399;260429;10232;79228;3042;1387;339123;2935;398;283948;23204;84219;23430;23059;63922;728276;6755;56052;55692;5373;527;146562;8312;54925;6345;646174;23420;26063;5310;6210;6650;780776;4350;64788;25823;7760;196483;83986;124404;28955;57799;9284;7874;9093;2671;197335;23049;642799;642778;90850;146279;51025;645811;9074;283953;64714;9717;101059938;23274;23162;84326;9143;146434;64131;283820;1186;3483;9727;117166;79585;79091;9235;197342;9080;390667;162073;65990;8651;7329;5493;8786;79006;18;4363;3050;26048;390664;146439;29066;752014;57407;124093;9516;51172;80063;8131;90864;124401;79903;116028;81889;84891;51061;25880;64063;146330;54715;55313;10273;10921;124220;9091;388199;79412;54700;283951;3029;124056;84464;10229;100529144;84662;400506;4832;1632;146556;64499;342346;91151;9028;100288332;9742;10131;283871;1877;5619;4210;54985;123811;7023;57496;23524;80178;8303;7177;84656;5170;64285;84309;29035;2903;608;65993;115;7755;4833;51283;23042;92017;10607;9665;1773;3163;84572;7752;1775;51728;124402;79838;64718;10127;79652;10101;114990;64428;79905;360226;123803;4716;64386;440335;4629;26156;6187;124152,262
1,1,16,85880,22442007,22356127,4682;3039;146177;368;197358;84256;57524;408050;10942;21;5073;899;4913;29965;10261;2072;57465;112479;58531;1039;23589;9738;146310;4992;8938;64223;3040;100463285;7249;30812;146325;7142;84231;115939;89941;54442;23295;64711;84264;58986;51760;124222;79622;6923;5620;54820;9894;255027;348158;79641;9088;83886;729993;4993;7727;283869;3049;51330;89927;25837;51734;101059953;9351;8912;113000;283870;7627;51005;51764;57020;254528;4917;90861;84331;114984;6123;4261;10573;57585;2013;29855;51573;8399;260429;10232;79228;3042;1387;339123;2935;398;283948;23204;84219;23430;23059;63922;728276;6755;54988;56052;55692;5373;527;146562;8312;54925;6345;646174;23420;26063;5310;6210;6650;780776;4350;64788;25823;7760;196483;83986;124404;28955;57799;9284;7874;9093;2671;197335;23049;642799;642778;90850;146279;51025;645811;51704;7385;9074;283953;64714;9717;101059938;23274;23162;84326;730094;9143;146434;64131;283820;1186;3483;9727;117166;79585;79091;9235;55718;197342;9080;390667;162073;65990;8651;2813;7329;57146;5493;8786;79006;18;4363;55623;3050;57149;29904;26048;257629;390664;146439;29066;55567;752014;23117;57407;124093;9516;51172;80063;8131;90864;124401;79903;116028;81889;84891;81691;51061;25880;64063;146330;54715;55313;10273;440345;10921;124220;9091;388199;79412;54700;283951;3029;204474;6296;116285;124056;146183;84464;10229;100529144;84662;123876;400506;4832;1632;146556;64499;342346;91151;9028;100288332;123879;9742;10131;283871;1877;5619;4210;54985;123811;7023;57496;23524;80178;8303;7177;84656;5170;64285;84309;29035;2903;608;65993;115;7755;4833;51283;23042;7369;92017;10607;9665;1773;3163;84572;124274;1428;7752;1775;51728;124402;79838;64718;10127;79652;255762;10101;114990;64428;79905;51108;360226;123803;4716;64386;440335;7783;4629;26156;6187;124152,294
1,1,16,85881,90155062,90069181,4682;64785;100862671;1258;6361;23594;83719;84560;3039;6560;25839;146177;368;64779;197358;1535;79874;84256;146395;728734;8720;408050;51090;10942;7567;7041;21;1540;84290;124446;5073;899;4913;11345;29965;10261;9289;55282;2775;57465;112479;653550;58531;23417;92806;9738;146310;10421;64223;146198;3040;85320;730183;84231;445329;728689;25970;146429;89941;54442;8883;124222;6923;100132247;5620;112869;55815;54820;9810;24150;79077;10328;4501;5531;9088;83886;7284;729993;3835;9274;124491;3801;10204;374739;16;123920;283869;3049;51330;9057;8717;51734;84706;101059953;9351;8912;57478;6817;113000;7627;55512;51005;51764;2294;5681;81631;254528;4917;93517;79728;3681;54957;79724;10143;161931;6810;91862;6123;6911;10573;4775;27183;57585;9605;6236;124359;100506581;23322;29855;51573;64180;83693;260429;3687;54550;3042;1387;5261;2935;84219;23430;63922;728276;6755;1327;5257;84916;390748;29800;6559;56052;348174;146456;28987;146562;23174;29948;1874;51333;6345;100287036;3250;646174;342371;79759;8139;5713;5310;283847;221191;79153;5652;260434;84080;54921;6650;55625;54849;26470;55794;780776;55565;197322;83986;65057;54971;124404;28955;23090;146540;3566;221184;92595;2175;9284;7874;5347;3291;4502;388284;146433;10200;84501;9093;84627;10381;5699;197335;54920;23049;6340;90850;1783;51025;4489;11060;7385;865;9717;255919;101059938;23274;23659;730094;9143;64131;1009;1186;100529251;9914;83985;79152;78994;79585;117166;55718;50615;9235;283927;404550;197342;9726;146378;9080;1731;6477;146225;81577;2622;2813;7329;6137;2521;8786;5595;29105;4363;55623;3050;57149;29904;342372;388228;390664;146439;22928;752014;57407;124093;548593;4499;6367;124245;51172;80063;23406;221223;9564;6376;3394;124401;22879;80777;79903;164;6645;116028;81889;84891;729264;51061;57687;51673;64063;267;54715;10595;10273;440345;10921;8448;124045;161882;4496;22980;81533;388199;2653;204474;50855;552900;85407;23035;116285;124056;23475;283848;84464;55238;115992;4597;100529144;613037;100131303;51741;1504;84662;4832;583;339145;1632;146556;23644;79801;93129;64499;497190;653808;146542;253980;5432;8479;10131;84138;5619;23361;653319;123811;7023;57496;8824;283971;84148;8303;64282;113540;80004;10423;92822;84656;6693;5170;9688;5930;283897;29035;4504;2903;608;65993;7755;9114;4833;51283;7369;4166;90835;1723;253982;9665;1773;124460;79918;4493;55715;124274;1428;11051;1775;83657;10295;55839;53630;51192;79652;255762;3240;10101;57610;55697;4150;23300;57215;51108;123803;100507607;9785;440335;7783;4494;26156;6818;29070;3931;2734;58189;29123;55783;4490;92154;23247;84752;2300;29108;763;10847;197320;92922;57019;146212;7571;79007;79447;124044;57524;79786;114780;4157;79583;64319;6799;10164;8663;10725;1012;643911;728888;23568;27324;79567;729159;2072;27189;728741;9951;197258;57338;1039;23589;124411;4992;79831;8938;221188;100463285;7249;30812;283899;123970;146325;7142;197370;115939;5934;226;113;57546;388289;23295;9764;64711;84264;58986;51760;63928;170692;10265;3281;79622;115584;9709;9961;54386;9894;255027;107282092;348158;79641;197259;4993;51659;7727;81831;55911;1013;1014;89927;25837;91949;283870;643802;57020;654483;6483;162083;79190;90861;84331;80262;56061;83723;114984;94160;1459;6338;4261;89970;2013;2303;54620;10294;1006;55114;51647;8399;29100;10232;79228;4094;339123;79650;398;283948;23204;3683;9013;83716;23059;388282;930;91807;54988;55737;79767;4706;23214;55692;9798;5373;527;54758;55027;112755;26471;1489;8312;54925;80205;26231;463;80790;84229;100129697;23420;729355;348180;26063;6210;81620;5119;869;51327;7014;10300;4350;64788;25823;7760;3684;3038;2588;196483;29117;3299;55308;100130958;6299;57799;11269;162239;146223;283849;64400;2671;10428;1800;64755;146547;343;642799;642778;26000;146279;645811;51704;23019;56942;11105;9074;283953;64714;124454;23162;84326;79191;54496;51693;146434;11151;64146;283820;388276;3483;29109;5336;339105;25894;197257;9727;51451;10368;79091;79791;3294;353;64174;27040;390667;162073;65990;8651;8140;57146;5493;18;79006;93107;1339;222487;9956;26048;84937;146206;4313;83752;3735;257629;29066;55567;23117;79613;54947;6898;9516;8131;9683;55066;493829;79726;79798;90864;79068;146227;27327;1201;27132;84166;4324;9344;81691;440387;25880;146330;84342;65988;55313;124220;54768;146167;84516;1003;9091;2975;79412;54700;65009;342357;283951;3029;2806;55336;6296;146183;487;4495;55159;10229;181;123775;64127;57017;794;123876;400506;23563;388272;5579;197407;9739;57567;7084;342346;91151;9028;100288332;999;123879;23536;9742;6553;283871;1877;85445;4210;10308;123872;54985;83449;333929;23524;1728;84901;80178;1071;79001;283933;29895;7177;51388;80152;863;64285;84309;115;123904;23042;92017;1001;10607;6530;55239;3163;23199;84572;11273;7752;112476;1066;51728;124402;79838;9780;115509;64718;10127;766;23450;1506;10664;80011;57707;114990;64428;80270;440348;79905;246778;8996;23062;360226;23491;4716;64386;118460;6687;4629;6524;79008;9100;6187;124152;8558,812
1,1,16,85881,90155062,90069181,4682;64785;100862671;1258;6361;23594;83719;84560;3039;6560;25839;146177;368;64779;197358;1535;79874;84256;146395;728734;8720;408050;51090;10942;7567;7041;21;1540;84290;124446;5073;899;4913;11345;29965;10261;9289;55282;2775;57465;112479;653550;58531;23417;92806;9738;146310;10421;64223;146198;3040;85320;730183;84231;445329;728689;25970;146429;89941;54442;8883;124222;6923;100132247;5620;112869;55815;54820;9810;24150;79077;10328;4501;5531;9088;83886;7284;729993;3835;9274;124491;3801;10204;374739;16;123920;283869;3049;51330;9057;8717;51734;84706;101059953;9351;8912;57478;6817;113000;7627;55512;51005;51764;2294;5681;81631;254528;4917;93517;79728;3681;54957;79724;10143;161931;6810;91862;6123;6911;10573;4775;27183;57585;9605;6236;124359;100506581;23322;29855;51573;64180;83693;260429;3687;54550;3042;1387;5261;2935;84219;23430;63922;728276;6755;1327;5257;84916;390748;29800;6559;56052;348174;146456;28987;146562;23174;29948;1874;51333;6345;100287036;3250;646174;342371;79759;8139;5713;5310;283847;221191;79153;5652;260434;84080;54921;6650;55625;54849;26470;55794;780776;55565;197322;83986;65057;54971;124404;28955;23090;146540;3566;221184;92595;2175;9284;7874;5347;3291;4502;388284;146433;10200;84501;9093;84627;10381;5699;197335;54920;23049;6340;90850;1783;51025;4489;11060;7385;865;9717;255919;101059938;23274;23659;730094;9143;64131;1009;1186;100529251;9914;83985;79152;78994;79585;117166;55718;50615;9235;283927;404550;197342;9726;146378;9080;1731;6477;146225;81577;2622;2813;7329;6137;2521;8786;5595;29105;4363;55623;3050;57149;29904;342372;388228;390664;146439;22928;752014;57407;124093;548593;4499;6367;124245;51172;80063;23406;221223;9564;6376;3394;124401;22879;80777;79903;164;6645;116028;81889;84891;729264;51061;57687;51673;64063;267;54715;10595;10273;440345;10921;8448;124045;161882;4496;22980;81533;388199;2653;204474;50855;552900;85407;23035;116285;124056;23475;283848;84464;55238;115992;4597;100529144;613037;100131303;51741;1504;84662;4832;583;339145;1632;146556;23644;79801;93129;64499;497190;653808;146542;253980;5432;8479;10131;84138;5619;23361;653319;123811;7023;57496;8824;283971;84148;8303;64282;113540;80004;10423;92822;84656;6693;5170;9688;5930;283897;29035;4504;2903;608;65993;7755;9114;4833;51283;7369;4166;90835;1723;253982;9665;1773;124460;79918;4493;55715;124274;1428;11051;1775;83657;10295;55839;53630;51192;79652;255762;3240;10101;57610;55697;4150;23300;57215;51108;123803;100507607;9785;440335;7783;4494;26156;6818;29070;3931;2734;58189;29123;55783;4490;92154;23247;84752;2300;29108;763;10847;197320;92922;57019;146212;7571;79007;79447;124044;57524;79786;114780;4157;79583;64319;6799;10164;8663;10725;1012;643911;728888;23568;27324;79567;729159;2072;27189;728741;9951;197258;57338;1039;23589;124411;4992;79831;8938;221188;100463285;7249;30812;283899;123970;146325;7142;197370;115939;5934;226;113;57546;388289;23295;9764;64711;84264;58986;51760;63928;170692;10265;3281;79622;115584;9709;9961;54386;9894;255027;107282092;348158;79641;197259;4993;51659;7727;81831;55911;1013;1014;89927;25837;91949;283870;643802;57020;654483;6483;162083;79190;90861;84331;80262;56061;83723;114984;94160;1459;6338;4261;89970;2013;2303;54620;10294;1006;55114;51647;8399;29100;10232;79228;4094;339123;79650;398;283948;23204;3683;9013;83716;23059;388282;930;91807;54988;55737;79767;4706;23214;55692;9798;5373;527;54758;55027;112755;26471;1489;8312;54925;80205;26231;463;80790;84229;100129697;23420;729355;348180;26063;6210;81620;5119;869;51327;7014;10300;4350;64788;25823;7760;3684;3038;2588;196483;29117;3299;55308;100130958;6299;57799;11269;162239;146223;283849;64400;2671;10428;1800;64755;146547;343;642799;642778;26000;146279;645811;51704;23019;56942;11105;9074;283953;64714;124454;23162;84326;79191;54496;51693;146434;11151;64146;283820;388276;3483;29109;5336;339105;25894;197257;9727;51451;10368;79091;79791;3294;353;64174;27040;390667;162073;65990;8651;8140;57146;5493;18;79006;93107;1339;222487;9956;26048;84937;146206;4313;83752;3735;257629;29066;55567;23117;79613;54947;6898;9516;8131;9683;55066;493829;79726;79798;90864;79068;146227;27327;1201;27132;84166;4324;9344;81691;440387;25880;146330;84342;65988;55313;124220;54768;146167;84516;1003;9091;2975;79412;54700;65009;342357;283951;3029;2806;55336;6296;146183;487;4495;55159;10229;181;123775;64127;57017;794;123876;400506;23563;388272;5579;197407;9739;57567;7084;342346;91151;9028;100288332;999;123879;23536;9742;6553;283871;1877;85445;4210;10308;123872;54985;83449;333929;23524;1728;84901;80178;1071;79001;283933;29895;7177;51388;80152;863;64285;84309;115;123904;23042;92017;1001;10607;6530;55239;3163;23199;84572;11273;7752;112476;1066;51728;124402;79838;9780;115509;64718;10127;766;23450;1506;10664;80011;57707;114990;64428;80270;440348;79905;246778;8996;23062;360226;23491;4716;64386;118460;6687;4629;6524;79008;9100;6187;124152;8558,812
1,1,16,93732,13420663,13326931,4682;90850;146279;51025;645811;3039;9074;283953;64714;9717;23274;23162;84326;197358;9143;146434;84256;1186;57524;3483;10942;9727;117166;79585;79091;9235;197342;21;9080;390667;65990;899;4913;8651;29965;7329;5493;8786;79006;18;57465;3050;58531;26048;23589;146310;4992;8938;390664;146439;64223;29066;3040;100463285;7249;30812;752014;57407;146325;124093;84231;7142;115939;89941;54442;51172;23295;8131;64711;84264;58986;80063;124222;9516;79622;6923;90864;5620;124401;9894;79903;79641;9088;83886;116028;81889;84891;729993;4993;7727;51061;25880;64063;146330;54715;55313;10273;283869;10921;3049;124220;51330;25837;51734;9091;9351;8912;388199;113000;79412;283870;7627;283951;3029;51005;51764;254528;4917;124056;90861;84331;84464;100529144;114984;84662;4832;6123;1632;4261;10573;146556;57585;2013;64499;342346;91151;9028;29855;260429;9742;10131;283871;10232;79228;1877;5619;3042;1387;339123;4210;2935;398;283948;54985;84219;7023;23430;23524;23059;63922;80178;6755;8303;7177;84656;5170;56052;55692;5373;527;64285;84309;29035;2903;608;65993;115;7755;146562;4833;8312;54925;92017;10607;1773;3163;6345;84572;7752;646174;1775;51728;124402;26063;5310;64718;10127;79652;6650;10101;780776;4350;64428;64788;25823;7760;114990;196483;360226;83986;4716;64386;440335;124404;28955;26156;57799;7874;6187;9093;2671;197335,222
-1,1,16,96722,1917328,1820606,283951;3029;51764;254528;645811;90861;84331;3039;64714;23162;84326;4832;1186;10573;3483;57585;64499;9727;117166;197342;9028;390667;9742;65990;10232;3042;7329;339123;398;283948;8786;79006;84219;23430;63922;3050;6755;7177;8938;390664;55692;3040;30812;64285;65993;146325;124093;4833;115939;8312;89941;8131;84264;58986;79622;84572;90864;51728;26063;9894;64718;79652;6650;10101;81889;4350;64428;64788;25823;146330;83986;10273;3049;57799;197335;9091;8912;388199;113000,79
-1,1,16,96766,932211,835445,51764;3040;64285;146325;84331;124093;3039;4833;8312;64714;89941;8131;388199;84264;58986;84326;79622;10573;51728;26063;9727;117166;6650;9028;4350;65990;64428;64788;10232;3042;146330;339123;398;83986;8786;283948;79006;10273;84219;3049;57799;63922;3050;9091;197335;113000;55692,47
-1,1,16,96766,1594015,1497249,283951;51764;645811;84331;3039;64714;84326;1186;10573;64499;9727;117166;9028;390667;9742;65990;10232;3042;7329;339123;398;283948;8786;79006;84219;23430;63922;3050;6755;7177;8938;390664;55692;3040;64285;30812;146325;124093;4833;8312;115939;89941;8131;84264;58986;79622;84572;51728;26063;9894;64718;79652;6650;4350;64428;64788;25823;146330;83986;10273;3049;57799;197335;9091;8912;388199;113000,67
1,1,16,96766,4297186,4200420,90850;645811;3039;9074;64714;23162;84326;197358;9143;146434;84256;1186;57524;3483;10942;9727;117166;9235;197342;21;9080;390667;65990;899;4913;7329;8786;79006;57465;3050;146310;4992;8938;390664;146439;64223;3040;100463285;7249;30812;752014;146325;124093;84231;115939;89941;54442;8131;64711;84264;58986;124222;79622;6923;90864;9894;79903;9088;83886;81889;84891;4993;7727;64063;146330;10273;283869;10921;3049;124220;51330;25837;51734;9091;9351;8912;388199;113000;79412;283870;7627;283951;3029;51005;51764;254528;4917;124056;90861;84331;84464;114984;4832;6123;1632;10573;57585;64499;91151;9028;260429;9742;10131;283871;10232;79228;1877;3042;1387;339123;4210;398;283948;54985;84219;23430;23524;23059;63922;80178;6755;7177;5170;55692;527;64285;65993;115;7755;4833;8312;54925;10607;1773;6345;84572;7752;646174;1775;51728;26063;5310;64718;10127;79652;6650;10101;4350;64428;64788;25823;7760;360226;83986;4716;64386;57799;6187;2671;197335,160
1,1,16,96766,11619372,11522606,4682;90850;146279;51025;645811;3039;9074;283953;64714;9717;23274;23162;84326;197358;9143;146434;84256;1186;57524;3483;10942;9727;117166;79585;79091;9235;197342;21;9080;390667;65990;899;4913;8651;29965;7329;5493;8786;79006;18;57465;3050;58531;26048;23589;146310;4992;8938;390664;146439;64223;3040;100463285;7249;30812;752014;57407;146325;124093;84231;7142;115939;89941;54442;51172;23295;8131;64711;84264;58986;80063;124222;79622;6923;90864;5620;124401;9894;79903;79641;9088;83886;116028;81889;84891;4993;7727;25880;64063;146330;54715;10273;283869;10921;3049;124220;51330;25837;51734;9091;9351;8912;388199;113000;79412;283870;7627;283951;3029;51005;51764;254528;4917;124056;90861;84331;84464;100529144;114984;84662;4832;6123;1632;4261;10573;146556;57585;2013;64499;342346;91151;9028;29855;260429;9742;10131;283871;10232;79228;1877;5619;3042;1387;339123;4210;398;283948;54985;84219;7023;23430;23524;23059;63922;80178;6755;7177;84656;5170;56052;55692;5373;527;64285;84309;29035;2903;65993;115;7755;146562;4833;8312;54925;10607;1773;3163;6345;84572;7752;646174;1775;51728;124402;26063;5310;64718;10127;79652;6650;10101;780776;4350;64428;64788;25823;7760;114990;196483;360226;83986;4716;64386;440335;124404;28955;57799;7874;6187;9093;2671;197335,212
1,-1,16,97133,109978,12845,79622;51728;64285,3
1,1,16,97133,5122974,5025841,90850;51025;645811;3039;9074;64714;9717;23162;84326;197358;9143;146434;84256;1186;57524;3483;10942;9727;117166;79585;9235;197342;21;9080;390667;65990;899;4913;29965;7329;5493;8786;79006;57465;3050;26048;146310;4992;8938;390664;146439;64223;3040;100463285;7249;30812;752014;57407;146325;124093;84231;115939;89941;54442;51172;23295;8131;64711;84264;58986;124222;79622;6923;90864;124401;9894;79903;79641;9088;83886;81889;84891;4993;7727;64063;146330;10273;283869;10921;3049;124220;51330;25837;51734;9091;9351;8912;388199;113000;79412;283870;7627;283951;3029;51005;51764;254528;4917;124056;90861;84331;84464;100529144;114984;84662;4832;6123;1632;10573;146556;57585;64499;342346;91151;9028;29855;260429;9742;10131;283871;10232;79228;1877;3042;1387;339123;4210;398;283948;54985;84219;7023;23430;23524;23059;63922;80178;6755;7177;84656;5170;56052;55692;527;64285;84309;65993;115;7755;146562;4833;8312;54925;10607;1773;3163;6345;84572;7752;646174;1775;51728;124402;26063;5310;64718;10127;79652;6650;10101;4350;64428;64788;25823;7760;114990;360226;83986;4716;64386;440335;124404;57799;6187;9093;2671;197335,187
-1,1,16,109978,1271651,1161673,51764;3040;64285;30812;146325;84331;124093;3039;4833;8312;64714;89941;8131;84264;58986;84326;10573;26063;9727;117166;6650;9028;4350;65990;64428;64788;10232;25823;3042;146330;339123;398;83986;8786;283948;79006;10273;84219;3049;57799;63922;3050;6755;197335;9091;8912;388199;113000;390664;55692,50
1,-1,16,114294,185756,71462,4350;64285;8131,3
-1,-1,16,202249,204466,2217,3050,1
1,-1,16,202249,204466,2217,3050,1
-1,-1,16,202249,215724,13475,3050,1
-1,1,16,215499,233437,17938,3049;3042;3039;3040,4
-1,1,16,215499,233437,17938,3049;3042;3039;3040,4
-1,1,16,215499,233437,17938,3049;3042;3039;3040,4
-1,1,16,215499,234337,18838,3049;3042;3039;3040,4
-1,1,16,215674,232684,17010,3049;3042;3039;3040,4
1,-1,16,216621,223674,7053,3042;3040,2
-1,1,16,223658,225684,2026,3040,1
-1,1,16,223658,225684,2026,3040,1
-1,1,16,223658,225684,2026,3040,1
-1,1,16,230541,231196,655,3049,1
1,-1,16,400651,446961,46310,8312;58986;10573;4833,4
1,-1,16,400651,446961,46310,8312;58986;10573;4833,4
1,-1,16,449695,474204,24509,26063;4833,2
1,-1,16,542760,615476,72716,6650;146325;9727,3
-1,-1,16,571803,608532,36729,6650;9727,2
1,-1,16,584395,772554,188159,6650;9028;65990;146325;84331;89941;339123;146330;283948;79006;84326;10273;84219;57799;9091;197335;117166,17
-1,-1,16,686673,772554,85881,79006;10273;9028;84219;65990;84331;197335;89941;339123;146330,10
1,-1,16,686673,772554,85881,79006;10273;9028;84219;65990;84331;197335;89941;339123;146330,10
-1,-1,16,686673,772554,85881,79006;10273;9028;84219;65990;84331;197335;89941;339123;146330,10
-1,-1,16,686673,772554,85881,79006;10273;9028;84219;65990;84331;197335;89941;339123;146330,10
1,-1,16,686673,836508,149835,84264;79006;10273;9028;84219;113000;65990;124093;84331;64428;10232;197335;89941;339123;146330,15
-1,-1,16,700260,772554,72294,79006;10273;84219;9028;65990;197335;89941;339123;146330,9
-1,-1,16,700260,772554,72294,79006;10273;84219;9028;65990;197335;89941;339123;146330,9
1,1,16,716662,15836961,15120299,4682;642799;642778;90850;146279;51025;645811;9074;283953;9717;23274;23162;197358;9143;146434;84256;1186;57524;3483;10942;79585;79091;9235;197342;21;9080;390667;5073;65990;899;4913;8651;29965;7329;5493;18;79006;2072;57465;58531;26048;23589;146310;4992;8938;390664;146439;64223;29066;100463285;7249;30812;752014;57407;124093;7142;84231;115939;89941;54442;51172;23295;80063;64711;84264;9516;124222;6923;90864;5620;54820;124401;9894;255027;79903;79641;9088;83886;116028;81889;84891;729993;4993;7727;51061;25880;64063;146330;54715;55313;10273;283869;10921;124220;51330;89927;25837;51734;9351;8912;388199;113000;79412;283870;7627;54700;283951;3029;51005;51764;254528;4917;124056;90861;84464;100529144;114984;84662;4832;6123;1632;4261;146556;57585;2013;64499;342346;91151;9028;29855;100288332;8399;260429;9742;10131;283871;10232;79228;1877;5619;1387;339123;4210;2935;54985;84219;7023;57496;23430;23524;23059;63922;80178;6755;8303;7177;84656;5170;56052;5373;527;84309;29035;2903;608;65993;115;7755;146562;51283;54925;23042;92017;10607;9665;1773;3163;6345;84572;7752;646174;1775;124402;23420;5310;64718;10127;79652;10101;780776;114990;64428;64788;25823;7760;196483;360226;123803;4716;64386;440335;124404;28955;4629;26156;9284;7874;6187;9093;2671;197335,211
1,-1,16,755749,766588,10839,79006;146330,2
1,-1,16,813654,824069,10415,10232,1
1,-1,16,813654,824069,10415,10232,1
1,-1,16,813654,834971,21317,10232,1
1,-1,16,816211,824069,7858,10232,1
1,-1,16,816211,824069,7858,10232,1
1,-1,16,816211,830254,14043,10232,1
1,-1,16,816211,863586,47375,10232;51764;388199;113000;63922,5
1,-1,16,824069,863010,38941,388199;113000;63922;51764,4
1,-1,16,845689,848782,3093,63922;51764,2
1,-1,16,845689,857580,11891,388199;63922;51764,3
1,-1,16,1029282,1035586,6304,30812,1
1,-1,16,1034540,1036105,1565,30812,1
1,-1,16,1278591,1306279,27688,23430;7177;64499,3
1,-1,16,1278591,1306880,28289,23430;7177;64499,3
1,-1,16,1279620,1306279,26659,23430;7177;64499,3
1,-1,16,1279620,1306279,26659,23430;7177;64499,3
1,-1,16,1279620,1306279,26659,23430;7177;64499,3
1,-1,16,1279620,1306279,26659,23430;7177;64499,3
1,-1,16,1279620,1306279,26659,23430;7177;64499,3
1,-1,16,1279620,1306279,26659,23430;7177;64499,3
1,-1,16,1279620,1306279,26659,23430;7177;64499,3
1,-1,16,1279620,1306279,26659,23430;7177;64499,3
1,-1,16,1279620,1306279,26659,23430;7177;64499,3
1,-1,16,1279620,1306279,26659,23430;7177;64499,3
1,-1,16,1279620,1306279,26659,23430;7177;64499,3
1,-1,16,1279620,1306279,26659,23430;7177;64499,3
1,-1,16,1279620,1306279,26659,23430;7177;64499,3
1,-1,16,1279620,1306279,26659,23430;7177;64499,3
-1,-1,16,1307542,1486510,178968,283951;84572;23430;645811;115939;64718;7329;8938,8
-1,-1,16,1804786,1866284,61498,3029;23162;197342;10101;4832;90864;65993;3483,8
-1,1,16,2075886,2138687,62801,4913;9351;7249,3
1,1,16,3052290,5011702,1959412,100463285;146439;84309;57407;51025;115;7755;84464;146562;9074;54925;100529144;9717;23295;1773;3163;6345;197358;84662;146434;7752;646174;124402;124401;10127;79585;79903;9235;79641;342346;91151;29855;84891;9080;4993;10131;114990;7727;79228;7760;29965;1387;4210;64386;5493;54985;124404;440335;7023;23059;51330;26048;9093;84656;4992;7627,56
-1,1,16,3146027,6362229,3216202,100463285;84309;57407;51025;115;7755;84464;146562;54925;100529144;9717;51172;23295;1773;3163;6345;197358;84662;146434;7752;646174;146556;124402;124401;10127;79585;79903;7627;79641;342346;91151;29855;84891;4993;10131;114990;7727;7760;29965;196483;1387;54715;4210;5493;440335;124404;7023;23059;26048;9093;84656;4992;56052,53
1,1,16,3586972,4099566,512594,1773;197358;23059;10131;115;84464;1387,7
-1,1,16,3610565,4316797,706232,1773;6345;197358;7023;10131;115;84464;1387,8
-1,1,16,3649387,3800697,151310,1773;1387;84464;10131,4
1,1,16,3716024,3809066,93042,10131;1387,2
-1,1,16,3716036,3788580,72544,10131;1387,2
-1,1,16,3716036,3817969,101933,10131;1387,2
-1,1,16,3750607,3860718,110111,10131;1387,2
1,1,16,3776703,4694962,918259,342346;57407;51025;115;114990;29965;1387;100529144;23295;3163;6345;84662;7023;124402;9093;79585,16
-1,1,16,3776715,3809010,32295,1387,1
-1,1,16,3776715,3809010,32295,1387,1
-1,1,16,3870523,4718348,847825,342346;57407;51025;115;114990;29965;1387;100529144;23295;3163;6345;84662;7023;124402;9093;79585,16
-1,1,16,3900967,3934582,33615,1387,1
-1,1,16,3922991,4004415,81424,1387,1
1,1,16,4694893,29182141,24487248,4682;23049;343;642799;642778;6340;146279;23247;51704;7385;283953;146177;9717;101059938;368;124454;23274;730094;64131;79874;283820;146395;728734;408050;83985;55718;10368;79091;51451;50615;6799;8663;27040;162073;5073;8651;2813;57146;10261;5493;18;2072;4363;55623;112479;57149;29904;58531;26048;9956;9951;728741;1039;23589;9738;388228;257629;79831;29066;55567;23117;7142;197370;728689;25970;9516;51172;23295;80063;51760;63928;100132247;115584;5620;112869;54820;124401;27327;255027;1201;348158;79641;116028;7284;729993;81691;51061;25880;54715;10595;55911;55313;440345;89927;84516;101059953;57478;91949;2975;6817;54700;342357;204474;57020;162083;6296;116285;146183;487;79728;10229;56061;123876;400506;6338;4261;146556;5579;2013;55114;29855;100288332;51573;8399;123879;5619;2935;23204;57496;123811;728276;930;8303;84901;54988;84656;4706;56052;23214;5373;5930;84309;29035;2903;608;26471;146562;51283;7369;23042;92017;9665;124274;1428;11273;23420;79838;6210;255762;780776;79905;246778;196483;51108;23062;123803;100507607;440335;124404;28955;4629;7783;3566;26156;9284;7874;5347;124152,178
1,-1,16,5613366,6017776,404410,,0
-1,-1,16,6303204,6602026,298822,54715,1
-1,1,16,6306086,6618137,312051,54715,1
-1,1,16,6337330,6469280,131950,54715,1
-1,-1,16,6575078,6679243,104165,54715,1
-1,1,16,6836910,7046219,209309,54715,1
-1,-1,16,6950959,6972248,21289,54715,1
-1,-1,16,6980832,7038142,57310,54715,1
-1,-1,16,7046160,7073977,27817,54715,1
-1,1,16,9916365,10185615,269250,2903,1
1,-1,16,14015996,14051021,35025,2072,1
1,1,16,14809973,16794773,1984800,100288332;642799;642778;23042;101059938;368;123803;9665;4629;123811;89927;4363;9284;54820;23420;408050;255027;54700,18
-1,1,16,14809982,16477578,1667596,100288332;642799;642778;23042;101059938;368;123803;9665;4629;123811;89927;4363;9284;54820;23420;408050;255027;54700,18
-1,1,16,14809982,16477578,1667596,100288332;642799;642778;23042;101059938;368;123803;9665;4629;123811;89927;4363;9284;54820;23420;408050;255027;54700,18
-1,1,16,14868192,18738030,3869838,100288332;23042;101059938;368;9665;123803;4629;123811;64131;89927;283820;4363;9284;54820;23420;408050;101059953;255027;54700,19
1,1,16,14866283,16390970,1524687,4629;100288332;123811;89927;4363;9284;54820;23420;408050;368;255027;23042;54700;123803;9665,15
-1,1,16,14866283,16494783,1628500,100288332;23042;101059938;368;123803;9665;4629;123811;89927;4363;9284;54820;23420;408050;255027;54700,16
1,1,16,14866283,16855348,1989065,100288332;23042;101059938;368;123803;9665;4629;123811;89927;4363;9284;54820;23420;408050;255027;54700,16
-1,1,16,14866284,16391910,1525626,4629;100288332;123811;89927;4363;9284;54820;23420;408050;368;255027;23042;54700;123803;9665,15
-1,1,16,14866284,16544419,1678135,100288332;23042;101059938;368;123803;9665;4629;123811;89927;4363;9284;54820;23420;408050;255027;54700,16
-1,1,16,14877687,16292235,1414548,4629;100288332;123811;89927;4363;9284;54820;23420;368;255027;23042;54700;123803;9665,14
-1,1,16,14877687,16292235,1414548,4629;100288332;123811;89927;4363;9284;54820;23420;368;255027;23042;54700;123803;9665,14
-1,1,16,14877687,16292235,1414548,4629;100288332;123811;89927;4363;9284;54820;23420;368;255027;23042;54700;123803;9665,14
-1,1,16,14877687,16327945,1450258,4629;100288332;123811;89927;4363;9284;54820;23420;408050;368;255027;23042;54700;123803;9665,15
-1,-1,16,14897702,15148790,251088,23042;23420;9284;123803,4
1,1,16,14892713,16533890,1641177,100288332;23042;101059938;368;123803;9665;4629;123811;89927;4363;9284;54820;23420;408050;255027;54700,16
-1,1,16,14892880,16533890,1641010,100288332;23042;101059938;368;123803;9665;4629;123811;89927;4363;9284;54820;23420;408050;255027;54700,16
-1,1,16,14896385,16330672,1434287,4629;100288332;123811;89927;4363;9284;54820;23420;408050;368;255027;23042;54700;123803;9665,15
-1,1,16,14897372,16495076,1597704,100288332;23042;101059938;368;123803;9665;4629;123811;89927;4363;9284;54820;23420;408050;255027;54700,16
-1,1,16,14897625,16391910,1494285,4629;100288332;123811;89927;4363;9284;54820;23420;408050;368;255027;23042;54700;123803;9665,15
-1,1,16,14897625,16494783,1597158,100288332;23042;101059938;368;123803;9665;4629;123811;89927;4363;9284;54820;23420;408050;255027;54700,16
-1,1,16,14897625,16516109,1618484,100288332;23042;101059938;368;123803;9665;4629;123811;89927;4363;9284;54820;23420;408050;255027;54700,16
-1,1,16,14897788,16508039,1610251,100288332;23042;101059938;368;123803;9665;4629;123811;89927;4363;9284;54820;23420;408050;255027;54700,16
-1,1,16,14899630,16458353,1558723,4629;100288332;123811;89927;4363;9284;54820;23420;408050;368;255027;23042;54700;123803;9665,15
-1,1,16,14899676,16514111,1614435,100288332;23042;101059938;368;123803;9665;4629;123811;89927;4363;9284;54820;23420;408050;255027;54700,16
-1,1,16,14905705,16391045,1485340,4629;100288332;123811;89927;4363;9284;54820;23420;408050;368;255027;23042;54700;123803;9665,15
-1,1,16,14906734,16330672,1423938,4629;100288332;123811;89927;4363;9284;54820;23420;408050;368;255027;23042;54700;123803;9665,15
-1,1,16,14906734,16498084,1591350,100288332;23042;101059938;368;123803;9665;4629;123811;89927;4363;9284;54820;23420;408050;255027;54700,16
-1,1,16,14906734,16516109,1609375,100288332;23042;101059938;368;123803;9665;4629;123811;89927;4363;9284;54820;23420;408050;255027;54700,16
-1,1,16,14906845,16515901,1609056,100288332;23042;101059938;368;123803;9665;4629;123811;89927;4363;9284;54820;23420;408050;255027;54700,16
-1,1,16,14910116,16525348,1615232,100288332;23042;101059938;368;123803;9665;4629;123811;89927;4363;9284;54820;23420;408050;255027;54700,16
-1,1,16,14910205,16194578,1284373,4629;100288332;123811;89927;4363;9284;54820;23420;255027;23042;54700;123803;9665,13
-1,1,16,14910213,16525374,1615161,100288332;23042;101059938;368;123803;9665;4629;123811;89927;4363;9284;54820;23420;408050;255027;54700,16
-1,1,16,14910213,16742194,1831981,100288332;23042;101059938;368;123803;9665;4629;123811;89927;4363;9284;54820;23420;408050;255027;54700,16
-1,1,16,14968855,16127877,1159022,4629;100288332;123811;89927;4363;9284;54820;23420;255027;23042;54700;123803;9665,13
-1,1,16,15048751,16194578,1145827,4629;100288332;123811;89927;4363;54820;255027;23042;54700;123803;9665,11
-1,1,16,15048751,16292235,1243484,4629;100288332;123811;89927;4363;54820;368;255027;23042;54700;123803;9665,12
-1,-1,16,15048781,15073773,24992,23042,1
-1,-1,16,15048781,15073773,24992,23042,1
-1,-1,16,15048781,15116377,67596,23042,1
-1,1,16,15049968,16295900,1245932,4629;100288332;123811;89927;4363;54820;368;255027;23042;54700;123803;9665,12
-1,1,16,15049968,16391910,1341942,4629;100288332;123811;89927;4363;54820;408050;368;255027;23042;54700;123803;9665,13
1,1,16,15154687,18546759,3392072,100288332;23042;101059938;368;9665;4629;123811;64131;89927;4363;283820;54820;408050;101059953;255027;54700,16
-1,1,16,15404452,18306854,2902402,4629;100288332;123811;64131;89927;4363;54820;408050;255027;101059938;368;9665,12
-1,1,16,15420069,16388596,968527,4629;100288332;123811;89927;4363;54820;408050;255027;368;9665,10
-1,1,16,15422920,18181971,2759051,4629;100288332;123811;64131;89927;4363;54820;408050;255027;101059938;368;9665,12
-1,1,16,15449696,16319630,869934,4629;100288332;123811;89927;4363;54820;255027;368;9665,9
-1,1,16,15449696,16330627,880931,4629;100288332;123811;89927;4363;54820;408050;255027;368;9665,10
-1,1,16,15449696,16388596,938900,4629;100288332;123811;89927;4363;54820;408050;255027;368;9665,10
1,1,16,15449696,16391910,942214,4629;100288332;123811;89927;4363;54820;408050;255027;368;9665,10
-1,1,16,15449696,16514368,1064672,4629;100288332;123811;89927;4363;54820;408050;255027;101059938;368;9665,11
-1,1,16,15481747,16388244,906497,4629;123811;89927;4363;54820;408050;255027;368;9665,9
-1,1,16,15481920,16388244,906324,4629;123811;89927;4363;54820;408050;255027;368;9665,9
-1,1,16,15481920,18181971,2700051,4629;123811;64131;89927;4363;54820;408050;255027;101059938;368;9665,11
1,-1,16,15489920,15567615,77695,255027;89927,2
-1,1,16,15492307,16292235,799928,4629;123811;89927;4363;54820;255027;368;9665,8
-1,1,16,15492307,16292235,799928,4629;123811;89927;4363;54820;255027;368;9665,8
-1,1,16,15492307,16292235,799928,4629;123811;89927;4363;54820;255027;368;9665,8
-1,1,16,15492307,16305677,813370,4629;123811;89927;4363;54820;255027;368;9665,8
-1,1,16,15492307,16362707,870400,4629;123811;89927;4363;54820;408050;255027;368;9665,9
-1,1,16,15492307,18162167,2669860,4629;123811;64131;89927;4363;54820;408050;255027;101059938;368;9665,11
-1,1,16,15492307,18366738,2874431,4629;123811;64131;89927;4363;54820;408050;255027;101059938;368;9665,11
-1,1,16,15507164,16212672,705508,4363;54820;4629;123811;89927;9665,6
-1,1,16,15507164,16362703,855539,4629;123811;89927;4363;54820;408050;368;9665,8
-1,1,16,15507164,16400833,893669,4629;123811;89927;4363;54820;408050;368;9665,8
-1,1,16,15507164,16438224,931060,4629;123811;89927;4363;54820;408050;368;9665,8
-1,1,16,15507164,16544788,1037624,4629;123811;89927;4363;54820;408050;101059938;368;9665,9
-1,1,16,15494600,16327171,832571,4629;123811;89927;4363;54820;408050;255027;368;9665,9
-1,1,16,15494600,16327171,832571,4629;123811;89927;4363;54820;408050;255027;368;9665,9
-1,1,16,15509728,16330672,820944,4629;123811;89927;4363;54820;408050;368;9665,8
-1,1,16,15551062,18306841,2755779,4629;123811;64131;89927;4363;54820;408050;101059938;368;9665,10
-1,1,16,15551302,16194578,643276,4363;54820;4629;123811;89927;9665,6
-1,1,16,15551302,18141051,2589749,4629;123811;64131;89927;4363;54820;408050;101059938;368;9665,10
1,-1,16,15977824,16012820,34996,123811,1
1,-1,16,15977824,16012829,35005,123811,1
1,-1,16,15986060,16019877,33817,,0
1,-1,16,15986060,16019877,33817,,0
1,-1,16,15986060,16019877,33817,,0
1,-1,16,15986060,16041539,55479,,0
-1,-1,16,16245325,16259284,13959,368,1
1,-1,16,16252669,16327899,75230,408050;368,2
1,-1,16,16292245,16847701,555456,408050;101059938;368,3
1,-1,16,16305656,16847701,542045,408050;101059938;368,3
1,-1,16,16305656,16847701,542045,408050;101059938;368,3
1,-1,16,16305656,16847701,542045,408050;101059938;368,3
1,-1,16,16305656,16847701,542045,408050;101059938;368,3
1,-1,16,16305656,16847701,542045,408050;101059938;368,3
1,-1,16,16300012,16315139,15127,368,1
1,-1,16,16300012,16327171,27159,408050;368,2
-1,-1,16,16525289,16772370,247081,,0
1,-1,16,18242569,18779856,537287,283820;101059953,2
1,-1,16,18242569,18779856,537287,283820;101059953,2
1,-1,16,18242569,18779856,537287,283820;101059953,2
1,-1,16,18242569,18779856,537287,283820;101059953,2
1,-1,16,18242569,18779856,537287,283820;101059953,2
1,1,16,18238275,30177240,11938965,23049;343;6340;23247;83719;51704;7385;146177;124454;730094;79874;283820;146395;79447;728734;83985;55718;10368;51451;50615;6799;8663;27040;146378;162073;124446;728888;2813;57146;10261;5595;55623;112479;57149;29904;9956;9951;728741;1039;388228;9738;79831;257629;55567;23117;283899;197370;445329;728689;25970;226;51760;63928;100132247;115584;112869;9961;27327;107282092;1201;348158;5531;7284;9344;81691;3835;10595;55911;440345;8448;84516;101059953;57478;91949;2975;6817;342357;204474;57020;162083;552900;6296;116285;146183;487;23475;79728;10229;56061;83723;123876;400506;6338;6911;5579;653808;55114;51573;253980;123879;8479;23204;728276;930;84901;10423;54988;6693;4706;23214;5930;283897;26471;7369;253982;124274;1428;11273;112476;79838;6210;79153;255762;26470;4150;79905;246778;51108;23062;100507607;7783;3566;79008;5347;124152,135
1,1,16,19424115,30142220,10718105,204474;57020;343;162083;552900;6340;23247;83719;6296;116285;146183;487;51704;7385;23475;79728;146177;56061;124454;83723;123876;730094;400506;6338;79874;6911;146395;79447;728734;83985;5579;55718;10368;51451;50615;653808;55114;6799;8663;27040;51573;253980;146378;123879;124446;8479;728888;2813;57146;10261;5595;55623;112479;57149;29904;9956;9951;728741;930;84901;1039;388228;9738;10423;54988;79831;257629;6693;4706;23214;55567;5930;283897;23117;283899;26471;197370;445329;728689;25970;226;7369;253982;63928;124274;100132247;115584;1428;11273;112869;112476;9961;79838;27327;107282092;1201;79153;348158;255762;5531;26470;7284;9344;81691;3835;4150;246778;10595;51108;23062;100507607;7783;55911;440345;3566;79008;8448;5347;84516;57478;91949;2975;6817;124152;342357,125
1,1,16,21379628,29351826,7972198,343;162083;6340;23247;146183;487;79728;7385;146177;56061;124454;730094;6338;79874;146395;728734;83985;5579;55718;10368;51451;50615;55114;6799;8663;27040;10261;930;9956;29904;9951;728741;84901;1039;388228;79831;4706;23214;5930;23117;26471;197370;728689;25970;63928;11273;100132247;115584;112869;27327;1201;255762;7284;246778;23062;51108;10595;100507607;55911;440345;3566;5347;84516;57478;91949;2975;6817;342357,68
1,-1,16,21415521,21521511,105990,23117,1
-1,-1,16,21475047,21770456,295409,51108;10261;146183,3
-1,-1,16,21475047,21839326,364279,51108;10261;146183,3
-1,-1,16,21475039,21531511,56472,,0
-1,-1,16,21475039,21531511,56472,,0
-1,-1,16,21475039,21531511,56472,,0
-1,-1,16,21475039,21531511,56472,,0
-1,-1,16,21475039,21531511,56472,,0
-1,-1,16,21475039,21531511,56472,,0
-1,-1,16,21475039,21531511,56472,,0
-1,-1,16,21475039,21531511,56472,,0
-1,-1,16,21475039,21531511,56472,,0
-1,-1,16,21475039,21531511,56472,,0
-1,-1,16,21475039,21531511,56472,,0
-1,-1,16,21475039,21830004,354965,51108;10261;146183,3
1,-1,16,21475060,21837551,362491,51108;10261;146183,3
1,-1,16,21494870,21862393,367523,440345;51108;10261;146183,4
-1,-1,16,21536930,21837492,300562,51108;10261;146183,3
-1,-1,16,21574922,21837558,262636,51108;10261;146183,3
-1,-1,16,21574922,21839326,264404,51108;10261;146183,3
-1,-1,16,21574922,21839326,264404,51108;10261;146183,3
-1,-1,16,21574922,21839326,264404,51108;10261;146183,3
-1,-1,16,21596412,21839326,242914,51108;10261;146183,3
-1,-1,16,21596412,21839326,242914,51108;10261;146183,3
-1,1,16,21596299,30399167,8802868,654483;343;162083;552900;6340;23247;83719;26000;146183;23475;487;79728;7385;146177;56061;613037;124454;83723;730094;6338;79874;11151;146395;79447;6911;728734;83985;5579;197407;55718;10368;51451;50615;653808;55114;6799;8663;27040;253980;146378;8479;124446;1731;728888;10261;5595;930;9956;29904;9951;728741;84901;10423;1039;388228;29895;6693;79831;10421;4706;23214;5930;283897;283899;548593;26471;197370;445329;728689;25970;226;253982;63928;11273;100132247;115584;112476;112869;9961;27327;107282092;1201;79153;255762;5531;26470;7284;9344;3835;4150;246778;10595;23062;51108;100507607;55911;440345;3566;79008;8448;6818;5347;84516;57478;91949;2975;6817;342357,108
-1,-1,16,21596650,21728367,131717,51108;10261;146183,3
1,-1,16,21599687,21837551,237864,51108;10261;146183,3
-1,-1,16,21654404,21728426,74022,51108;10261;146183,3
-1,-1,16,21654404,21823813,169409,51108;10261;146183,3
-1,1,16,21761404,22431357,669953,730094;440345;29904;146183;7385;1039;146177;55718;255762,9
-1,1,16,21761404,22431357,669953,730094;440345;29904;146183;7385;1039;146177;55718;255762,9
-1,1,16,21801889,22431357,629468,730094;440345;29904;7385;1039;146177;55718;255762,8
-1,1,16,21801889,22431357,629468,730094;440345;29904;7385;1039;146177;55718;255762,8
-1,1,16,21801889,22710614,908725,730094;440345;100132247;29904;7385;1039;146177;55718;255762,9
-1,-1,16,21837292,22408072,570780,730094;440345;29904;7385;1039;146177;55718;255762,8
-1,1,16,21837492,22407931,570439,730094;440345;29904;7385;1039;146177;55718;255762,8
-1,1,16,21838419,22407951,569532,730094;440345;29904;7385;1039;146177;55718;255762,8
-1,1,16,21959950,22407951,448001,7385;730094;1039;146177;55718;29904;255762,7
-1,1,16,21986752,22407872,421120,7385;730094;1039;146177;55718;29904;255762,7
1,1,16,22718350,28858721,6140371,5930;343;162083;6340;23247;79728;26471;197370;56061;728689;25970;124454;63928;6338;11273;115584;146395;112869;728734;5579;27327;1201;51451;10368;50615;55114;6799;8663;7284;246778;10595;23062;100507607;55911;3566;9956;9951;5347;728741;84516;57478;91949;2975;388228;6817;79831;4706;23214;342357,49
1,1,16,23763368,31955076,8191708,100862671;146547;343;23247;26000;83719;29108;10847;79874;11151;146395;79447;728734;83985;339105;78994;7041;51451;10368;50615;64319;9726;6799;8663;27040;146378;124446;1731;728888;2521;5595;1339;728741;9951;388228;124411;79831;10421;22928;730183;283899;548593;197370;445329;728689;25970;226;63928;493829;79798;115584;112869;9961;9810;27327;107282092;79077;1201;5531;7284;9344;3835;9274;65988;55911;8448;6817;2975;342357;654483;162083;552900;23475;487;3681;613037;79724;83723;6810;6911;5579;197407;93129;9739;54620;653808;55114;146542;253980;8479;3687;5261;10308;23361;3683;930;84901;84148;79001;283933;10423;29895;6693;23214;5930;283897;112755;26471;1489;90835;253982;51333;11273;112476;79759;10295;115509;79153;5652;260434;51327;26470;80270;4150;246778;3684;100507607;146540;3566;6524;79008;6818;92595;64755,134
1,1,16,24406741,33853445,9446704,100862671;146547;343;23247;26000;83719;29108;10847;79874;11151;146395;79447;728734;83985;339105;78994;7041;51451;50615;64319;9726;6799;8663;27040;146378;124446;1731;728888;2521;5595;1339;653550;728741;9951;388228;124411;79831;10421;22928;730183;283899;548593;197370;445329;728689;25970;226;493829;79798;115584;112869;9961;9810;24150;27327;107282092;79077;1201;5531;7284;729264;9344;3835;9274;65988;55911;8448;6817;2975;342357;654483;162083;552900;23475;487;3681;613037;79724;83723;6810;6911;197407;93129;9739;54620;653808;55114;146542;253980;8479;3687;5261;10308;23361;3683;930;84901;84148;79001;283933;10423;29895;6693;23214;5930;283897;112755;26471;1489;90835;253982;51333;11273;112476;79759;729355;10295;115509;79153;5652;260434;51327;26470;80270;4150;246778;3684;100507607;146540;3566;6524;79008;6818;92595;64755,135
-1,-1,16,25961844,26020520,58676,9951,1
1,-1,16,26684264,26750184,65920,,0
1,1,16,27323067,31204727,3881660,100862671;146547;654483;552900;23247;26000;83719;23475;487;613037;10847;79724;83723;6810;6911;79874;11151;146395;79447;728734;83985;197407;339105;93129;78994;9739;50615;54620;653808;64319;9726;6799;146542;8663;27040;253980;146378;8479;124446;1731;728888;5261;2521;23361;3683;5595;930;728741;84901;84148;79001;10423;29895;388228;6693;10421;23214;283897;22928;730183;112755;283899;548593;26471;445329;1489;728689;25970;226;90835;253982;51333;11273;112476;112869;9961;9810;79759;10295;115509;107282092;79077;1201;79153;5652;5531;26470;7284;9344;3835;80270;4150;246778;9274;100507607;65988;55911;146540;3566;79008;8448;6818;92595;6817;2975,105
-1,1,16,28338667,29353391,1014724,6799;8663;27040;7284;487;26471;246778;728689;25970;100507607;55911;11273;79874;930;728741;112869;728734;84901;83985;6817;1201,21
-1,1,16,28384463,29343462,958999,6799;8663;27040;7284;487;26471;246778;728689;25970;100507607;55911;11273;79874;930;84901;112869;728734;83985;6817;1201,20
-1,1,16,28404177,30190593,1786416,552900;283897;83719;23475;283899;487;26471;445329;728689;25970;226;253982;83723;11273;79874;6911;79447;112476;112869;728734;9961;83985;107282092;1201;79153;653808;6799;5531;26470;8663;27040;253980;7284;146378;8479;124446;9344;3835;4150;246778;728888;100507607;55911;5595;79008;8448;930;84901;10423;6817;6693,51
-1,1,16,28404153,29182196,778043,6799;8663;27040;7284;487;26471;246778;728689;25970;100507607;55911;11273;79874;930;84901;112869;728734;83985;6817;1201,20
-1,1,16,28404153,29331350,927197,6799;8663;27040;7284;487;26471;246778;728689;25970;100507607;55911;11273;79874;930;84901;112869;728734;83985;6817;1201,20
-1,1,16,28404153,29353391,949238,6799;8663;27040;7284;487;26471;246778;728689;25970;100507607;55911;11273;79874;930;84901;112869;728734;83985;6817;1201,20
-1,1,16,28404153,30197341,1793188,552900;283897;83719;23475;283899;487;26471;445329;728689;25970;226;253982;83723;11273;79874;6911;79447;112476;112869;728734;11151;9961;83985;107282092;1201;79153;653808;6799;5531;26470;8663;27040;253980;7284;146378;8479;124446;9344;3835;4150;246778;728888;100507607;55911;5595;79008;8448;930;84901;10423;6817;6693,52
-1,1,16,28404153,30197341,1793188,552900;283897;83719;23475;283899;487;26471;445329;728689;25970;226;253982;83723;11273;79874;6911;79447;112476;112869;728734;11151;9961;83985;107282092;1201;79153;653808;6799;5531;26470;8663;27040;253980;7284;146378;8479;124446;9344;3835;4150;246778;728888;100507607;55911;5595;79008;8448;930;84901;10423;6817;6693,52
-1,1,16,28404153,30332014,1927861,654483;552900;283897;83719;23475;283899;487;548593;26471;445329;728689;25970;226;613037;253982;83723;11273;79874;6911;79447;112476;112869;728734;11151;9961;83985;107282092;1201;79153;653808;6799;5531;26470;8663;27040;253980;7284;146378;8479;124446;9344;3835;4150;246778;728888;100507607;55911;5595;79008;8448;6818;930;84901;10423;6817;6693,56
-1,1,16,28441538,30178406,1736868,552900;283897;83719;23475;283899;487;26471;445329;25970;226;253982;83723;11273;79874;6911;79447;112476;112869;728734;9961;83985;107282092;1201;79153;653808;6799;5531;26470;8663;27040;253980;7284;146378;8479;124446;9344;3835;4150;246778;728888;100507607;55911;5595;79008;8448;930;84901;10423;6817;6693,50
-1,1,16,28466730,29427247,960517,6799;8663;27040;7284;487;26471;246778;728888;25970;100507607;55911;11273;79874;930;84901;112869;728734;83985;6817;1201,20
-1,1,16,28486693,29048572,561879,6799;8663;27040;7284;487;26471;246778;25970;100507607;55911;11273;79874;930;84901;112869;728734;83985;6817;1201,19
-1,1,16,28486693,30197290,1710597,552900;283897;83719;23475;283899;487;26471;445329;25970;226;253982;83723;11273;79874;6911;79447;112476;112869;728734;11151;9961;83985;107282092;1201;79153;653808;6799;5531;26470;8663;27040;253980;7284;146378;8479;124446;9344;3835;4150;246778;728888;100507607;55911;5595;79008;8448;930;84901;10423;6817;6693,51
-1,1,16,28503824,30190593,1686769,552900;283897;83719;23475;283899;487;26471;445329;25970;226;253982;83723;11273;79874;6911;79447;112476;112869;728734;9961;83985;107282092;79153;653808;6799;5531;26470;8663;27040;253980;7284;146378;8479;124446;9344;3835;4150;246778;728888;100507607;55911;5595;79008;8448;930;84901;10423;6817;6693,49
-1,1,16,28503803,30190568,1686765,552900;283897;83719;23475;283899;487;26471;445329;25970;226;253982;83723;11273;79874;6911;79447;112476;112869;728734;9961;83985;107282092;79153;653808;6799;5531;26470;8663;27040;253980;7284;146378;8479;124446;9344;3835;4150;246778;728888;100507607;55911;5595;79008;8448;930;84901;10423;6817;6693,49
1,1,16,28503803,30190568,1686765,552900;283897;83719;23475;283899;487;26471;445329;25970;226;253982;83723;11273;79874;6911;79447;112476;112869;728734;9961;83985;107282092;79153;653808;6799;5531;26470;8663;27040;253980;7284;146378;8479;124446;9344;3835;4150;246778;728888;100507607;55911;5595;79008;8448;930;84901;10423;6817;6693,49
1,1,16,28631584,29095327,463743,100507607;8663;11273;79874;7284;930;84901;27040;728734;487;83985;6817;25970,13
1,1,16,28689085,29043450,354365,100507607;8663;11273;79874;7284;930;84901;27040;487;83985;25970,11
-1,1,16,28689085,29051191,362106,100507607;8663;11273;79874;7284;930;84901;27040;487;83985;25970,11
-1,1,16,28689085,29051191,362106,100507607;8663;11273;79874;7284;930;84901;27040;487;83985;25970,11
-1,1,16,28689085,29051191,362106,100507607;8663;11273;79874;7284;930;84901;27040;487;83985;25970,11
-1,1,16,28708173,29051191,343018,100507607;8663;11273;79874;7284;930;84901;27040;487;83985;25970,11
-1,1,16,28733739,29044776,311037,100507607;8663;11273;79874;7284;930;84901;27040;487;83985;25970,11
-1,1,16,28733739,29044776,311037,100507607;8663;11273;79874;7284;930;84901;27040;487;83985;25970,11
-1,1,16,28763834,29043863,280029,100507607;11273;79874;7284;930;84901;27040;487;83985;25970,10
1,1,16,28802397,29043450,241053,11273;79874;7284;930;84901;27040;487;83985;25970,9
1,1,16,28802397,29051191,248794,11273;79874;7284;930;84901;27040;487;83985;25970,9
1,1,16,28808193,29043863,235670,11273;79874;7284;930;84901;27040;487;83985;25970,9
1,1,16,28808193,29088624,280431,11273;79874;7284;930;84901;27040;487;83985;25970,9
1,1,16,28819028,29043863,224835,11273;79874;7284;930;84901;27040;487;83985;25970,9
-1,1,16,28819028,29043972,224944,11273;79874;7284;930;84901;27040;487;83985;25970,9
-1,1,16,28819028,29051191,232163,11273;79874;7284;930;84901;27040;487;83985;25970,9
-1,1,16,28819028,29051191,232163,11273;79874;7284;930;84901;27040;487;83985;25970,9
-1,1,16,28819028,29051191,232163,11273;79874;7284;930;84901;27040;487;83985;25970,9
-1,1,16,28819028,29051191,232163,11273;79874;7284;930;84901;27040;487;83985;25970,9
-1,1,16,28819028,29051191,232163,11273;79874;7284;930;84901;27040;487;83985;25970,9
-1,1,16,28819028,29051191,232163,11273;79874;7284;930;84901;27040;487;83985;25970,9
1,1,16,28819028,29051191,232163,11273;79874;7284;930;84901;27040;487;83985;25970,9
-1,1,16,28819028,29051191,232163,11273;79874;7284;930;84901;27040;487;83985;25970,9
-1,1,16,28819028,29051191,232163,11273;79874;7284;930;84901;27040;487;83985;25970,9
-1,1,16,28819028,29051191,232163,11273;79874;7284;930;84901;27040;487;83985;25970,9
-1,1,16,28819028,29051191,232163,11273;79874;7284;930;84901;27040;487;83985;25970,9
-1,1,16,28819028,29051191,232163,11273;79874;7284;930;84901;27040;487;83985;25970,9
-1,1,16,28819028,29051191,232163,11273;79874;7284;930;84901;27040;487;83985;25970,9
-1,1,16,28819028,29051191,232163,11273;79874;7284;930;84901;27040;487;83985;25970,9
-1,1,16,28819028,29051191,232163,11273;79874;7284;930;84901;27040;487;83985;25970,9
-1,1,16,28819028,29051191,232163,11273;79874;7284;930;84901;27040;487;83985;25970,9
-1,1,16,28819028,29051191,232163,11273;79874;7284;930;84901;27040;487;83985;25970,9
-1,1,16,28820743,29044776,224033,11273;79874;7284;930;84901;27040;487;83985;25970,9
1,1,16,28824794,29043901,219107,11273;79874;7284;930;84901;27040;487;83985;25970,9
-1,1,16,28824794,29043960,219166,11273;79874;7284;930;84901;27040;487;83985;25970,9
-1,1,16,28824794,29043960,219166,11273;79874;7284;930;84901;27040;487;83985;25970,9
-1,1,16,28824794,29044776,219982,11273;79874;7284;930;84901;27040;487;83985;25970,9
-1,1,16,28824794,29044776,219982,11273;79874;7284;930;84901;27040;487;83985;25970,9
-1,1,16,28824794,29044776,219982,11273;79874;7284;930;84901;27040;487;83985;25970,9
-1,1,16,28824794,29044776,219982,11273;79874;7284;930;84901;27040;487;83985;25970,9
-1,1,16,28824794,29044776,219982,11273;79874;7284;930;84901;27040;487;83985;25970,9
-1,1,16,28824794,29044776,219982,11273;79874;7284;930;84901;27040;487;83985;25970,9
1,1,16,28824857,29088624,263767,11273;79874;7284;930;84901;27040;487;83985;25970,9
-1,1,16,28843754,29044850,201096,11273;27040;79874;7284;930;84901;487;83985;25970,9
-1,1,16,28843754,29044850,201096,11273;27040;79874;7284;930;84901;487;83985;25970,9
-1,1,16,28843754,29044850,201096,11273;27040;79874;7284;930;84901;487;83985;25970,9
-1,1,16,28826162,29043901,217739,11273;79874;7284;930;84901;27040;487;83985;25970,9
-1,1,16,28843754,29031071,187317,11273;27040;79874;7284;930;84901;487;83985;25970,9
-1,1,16,28843754,29031071,187317,11273;27040;79874;7284;930;84901;487;83985;25970,9
-1,1,16,28861531,29031059,169528,27040;487;83985;930;25970;79874;84901,7
-1,1,16,28861531,29031059,169528,27040;487;83985;930;25970;79874;84901,7
-1,1,16,28861531,29043960,182429,27040;487;83985;930;25970;79874;84901,7
1,-1,16,29060171,29624872,564701,107282092;445329;552900;79008;728888,5
1,1,16,29060171,30197290,1137119,552900;283897;83719;23475;283899;445329;226;253982;83723;6911;11151;79447;112476;9961;107282092;79153;653808;5531;26470;253980;146378;8479;124446;9344;3835;4150;728888;5595;79008;8448;10423;6693,32
-1,1,16,29238593,30190568,951975,653808;5531;26470;552900;283897;253980;146378;8479;83719;23475;283899;124446;9344;3835;4150;445329;728888;226;253982;83723;5595;6911;79008;8448;79447;112476;6693;9961;10423;107282092;79153,31
-1,1,16,29238593,30190568,951975,653808;5531;26470;552900;283897;253980;146378;8479;83719;23475;283899;124446;9344;3835;4150;445329;728888;226;253982;83723;5595;6911;79008;8448;79447;112476;6693;9961;10423;107282092;79153,31
1,1,16,29238593,30190568,951975,653808;5531;26470;552900;283897;253980;146378;8479;83719;23475;283899;124446;9344;3835;4150;445329;728888;226;253982;83723;5595;6911;79008;8448;79447;112476;6693;9961;10423;107282092;79153,31
1,1,16,29329436,30190593,861157,653808;5531;26470;552900;283897;253980;146378;8479;83719;23475;283899;124446;9344;3835;4150;445329;728888;226;253982;83723;5595;6911;79008;8448;79447;112476;6693;9961;10423;107282092;79153,31
1,1,16,29329436,30332569,1003133,654483;552900;283897;83719;23475;283899;548593;445329;226;613037;253982;83723;6911;11151;79447;112476;9961;107282092;79153;653808;5531;26470;253980;146378;8479;124446;9344;3835;4150;728888;5595;79008;8448;6818;10423;6693,36
-1,1,16,29351826,30191848,840022,653808;5531;26470;552900;283897;253980;146378;8479;83719;23475;283899;124446;9344;3835;4150;445329;728888;226;253982;83723;5595;6911;79008;8448;79447;112476;6693;9961;10423;107282092;79153,31
1,1,16,29421694,30344958,923264,654483;552900;283897;83719;23475;283899;548593;445329;226;613037;253982;83723;6911;11151;79447;112476;9961;107282092;79153;653808;5531;26470;253980;146378;8479;124446;9344;3835;4150;5595;79008;8448;6818;10423;6693,35
1,1,16,29432212,30177240,745028,653808;5531;26470;552900;283897;253980;146378;8479;83719;23475;283899;124446;9344;3835;4150;445329;226;253982;83723;5595;6911;79008;8448;79447;112476;6693;9961;10423;107282092;79153,30
-1,1,16,29432212,30177916,745704,653808;5531;26470;552900;283897;253980;146378;8479;83719;23475;283899;124446;9344;3835;4150;445329;226;253982;83723;5595;6911;79008;8448;79447;112476;6693;9961;10423;107282092;79153,30
-1,1,16,29432212,30226930,794718,654483;552900;283897;83719;23475;283899;548593;445329;226;253982;83723;6911;11151;79447;112476;9961;107282092;79153;653808;5531;26470;253980;146378;8479;124446;9344;3835;4150;5595;79008;8448;6818;10423;6693,34
1,1,16,29432212,30332125,899913,654483;552900;283897;83719;23475;283899;548593;445329;226;613037;253982;83723;6911;11151;79447;112476;9961;107282092;79153;653808;5531;26470;253980;146378;8479;124446;9344;3835;4150;5595;79008;8448;6818;10423;6693,35
-1,1,16,29439269,30197341,758072,653808;5531;26470;552900;283897;253980;146378;8479;83719;23475;283899;124446;9344;3835;4150;445329;226;253982;83723;5595;6911;11151;79008;79447;112476;8448;6693;9961;10423;107282092;79153,31
1,1,16,29447842,30289652,841810,654483;552900;283897;83719;23475;283899;548593;445329;226;613037;253982;83723;6911;11151;79447;112476;9961;107282092;79153;653808;5531;26470;253980;146378;8479;124446;9344;3835;4150;5595;79008;8448;6818;10423;6693,35
1,1,16,29447842,30289652,841810,654483;552900;283897;83719;23475;283899;548593;445329;226;613037;253982;83723;6911;11151;79447;112476;9961;107282092;79153;653808;5531;26470;253980;146378;8479;124446;9344;3835;4150;5595;79008;8448;6818;10423;6693,35
-1,1,16,29478059,30190568,712509,653808;5531;26470;283897;253980;146378;8479;83719;23475;283899;124446;9344;3835;4150;226;253982;83723;5595;6911;8448;79447;112476;9961;10423;6693;79153,26
-1,1,16,29478059,30190568,712509,653808;5531;26470;283897;253980;146378;8479;83719;23475;283899;124446;9344;3835;4150;226;253982;83723;5595;6911;8448;79447;112476;9961;10423;6693;79153,26
1,1,16,29478060,30332569,854509,653808;654483;5531;26470;283897;253980;146378;8479;83719;23475;283899;548593;124446;9344;3835;4150;226;613037;253982;83723;5595;6911;11151;6818;79447;112476;8448;9961;10423;6693;79153,31
1,1,16,29567295,30177240,609945,653808;5531;26470;283897;253980;146378;8479;83719;23475;283899;124446;9344;3835;4150;226;253982;83723;5595;6911;8448;79447;112476;9961;10423;6693;79153,26
-1,1,16,29567295,30177240,609945,653808;5531;26470;283897;253980;146378;8479;83719;23475;283899;124446;9344;3835;4150;226;253982;83723;5595;6911;8448;79447;112476;9961;10423;6693;79153,26
-1,1,16,29567295,30177807,610512,653808;5531;26470;283897;253980;146378;8479;83719;23475;283899;124446;9344;3835;4150;226;253982;83723;5595;6911;8448;79447;112476;9961;10423;6693;79153,26
-1,1,16,29567295,30177807,610512,653808;5531;26470;283897;253980;146378;8479;83719;23475;283899;124446;9344;3835;4150;226;253982;83723;5595;6911;8448;79447;112476;9961;10423;6693;79153,26
-1,1,16,29567295,30177916,610621,653808;5531;26470;283897;253980;146378;8479;83719;23475;283899;124446;9344;3835;4150;226;253982;83723;5595;6911;8448;79447;112476;9961;10423;6693;79153,26
-1,1,16,29567295,30177916,610621,653808;5531;26470;283897;253980;146378;8479;83719;23475;283899;124446;9344;3835;4150;226;253982;83723;5595;6911;8448;79447;112476;9961;10423;6693;79153,26
-1,1,16,29567295,30177916,610621,653808;5531;26470;283897;253980;146378;8479;83719;23475;283899;124446;9344;3835;4150;226;253982;83723;5595;6911;8448;79447;112476;9961;10423;6693;79153,26
-1,1,16,29567295,30177916,610621,653808;5531;26470;283897;253980;146378;8479;83719;23475;283899;124446;9344;3835;4150;226;253982;83723;5595;6911;8448;79447;112476;9961;10423;6693;79153,26
-1,1,16,29567295,30177916,610621,653808;5531;26470;283897;253980;146378;8479;83719;23475;283899;124446;9344;3835;4150;226;253982;83723;5595;6911;8448;79447;112476;9961;10423;6693;79153,26
-1,1,16,29567295,30177916,610621,653808;5531;26470;283897;253980;146378;8479;83719;23475;283899;124446;9344;3835;4150;226;253982;83723;5595;6911;8448;79447;112476;9961;10423;6693;79153,26
-1,1,16,29567295,30177916,610621,653808;5531;26470;283897;253980;146378;8479;83719;23475;283899;124446;9344;3835;4150;226;253982;83723;5595;6911;8448;79447;112476;9961;10423;6693;79153,26
-1,1,16,29567295,30177916,610621,653808;5531;26470;283897;253980;146378;8479;83719;23475;283899;124446;9344;3835;4150;226;253982;83723;5595;6911;8448;79447;112476;9961;10423;6693;79153,26
-1,1,16,29567295,30177916,610621,653808;5531;26470;283897;253980;146378;8479;83719;23475;283899;124446;9344;3835;4150;226;253982;83723;5595;6911;8448;79447;112476;9961;10423;6693;79153,26
-1,1,16,29567295,30177916,610621,653808;5531;26470;283897;253980;146378;8479;83719;23475;283899;124446;9344;3835;4150;226;253982;83723;5595;6911;8448;79447;112476;9961;10423;6693;79153,26
-1,1,16,29567295,30177916,610621,653808;5531;26470;283897;253980;146378;8479;83719;23475;283899;124446;9344;3835;4150;226;253982;83723;5595;6911;8448;79447;112476;9961;10423;6693;79153,26
-1,1,16,29567295,30177916,610621,653808;5531;26470;283897;253980;146378;8479;83719;23475;283899;124446;9344;3835;4150;226;253982;83723;5595;6911;8448;79447;112476;9961;10423;6693;79153,26
-1,1,16,29567295,30177916,610621,653808;5531;26470;283897;253980;146378;8479;83719;23475;283899;124446;9344;3835;4150;226;253982;83723;5595;6911;8448;79447;112476;9961;10423;6693;79153,26
-1,1,16,29567295,30177916,610621,653808;5531;26470;283897;253980;146378;8479;83719;23475;283899;124446;9344;3835;4150;226;253982;83723;5595;6911;8448;79447;112476;9961;10423;6693;79153,26
-1,1,16,29567295,30177916,610621,653808;5531;26470;283897;253980;146378;8479;83719;23475;283899;124446;9344;3835;4150;226;253982;83723;5595;6911;8448;79447;112476;9961;10423;6693;79153,26
-1,1,16,29567295,30177916,610621,653808;5531;26470;283897;253980;146378;8479;83719;23475;283899;124446;9344;3835;4150;226;253982;83723;5595;6911;8448;79447;112476;9961;10423;6693;79153,26
-1,1,16,29567295,30177916,610621,653808;5531;26470;283897;253980;146378;8479;83719;23475;283899;124446;9344;3835;4150;226;253982;83723;5595;6911;8448;79447;112476;9961;10423;6693;79153,26
-1,1,16,29567295,30177916,610621,653808;5531;26470;283897;253980;146378;8479;83719;23475;283899;124446;9344;3835;4150;226;253982;83723;5595;6911;8448;79447;112476;9961;10423;6693;79153,26
-1,1,16,29567295,30177916,610621,653808;5531;26470;283897;253980;146378;8479;83719;23475;283899;124446;9344;3835;4150;226;253982;83723;5595;6911;8448;79447;112476;9961;10423;6693;79153,26
-1,1,16,29567295,30177916,610621,653808;5531;26470;283897;253980;146378;8479;83719;23475;283899;124446;9344;3835;4150;226;253982;83723;5595;6911;8448;79447;112476;9961;10423;6693;79153,26
-1,1,16,29567295,30177916,610621,653808;5531;26470;283897;253980;146378;8479;83719;23475;283899;124446;9344;3835;4150;226;253982;83723;5595;6911;8448;79447;112476;9961;10423;6693;79153,26
-1,1,16,29567295,30177999,610704,653808;5531;26470;283897;253980;146378;8479;83719;23475;283899;124446;9344;3835;4150;226;253982;83723;5595;6911;8448;79447;112476;9961;10423;6693;79153,26
-1,1,16,29567295,30177999,610704,653808;5531;26470;283897;253980;146378;8479;83719;23475;283899;124446;9344;3835;4150;226;253982;83723;5595;6911;8448;79447;112476;9961;10423;6693;79153,26
-1,1,16,29567295,30177999,610704,653808;5531;26470;283897;253980;146378;8479;83719;23475;283899;124446;9344;3835;4150;226;253982;83723;5595;6911;8448;79447;112476;9961;10423;6693;79153,26
-1,1,16,29567295,30177999,610704,653808;5531;26470;283897;253980;146378;8479;83719;23475;283899;124446;9344;3835;4150;226;253982;83723;5595;6911;8448;79447;112476;9961;10423;6693;79153,26
-1,1,16,29567295,30177999,610704,653808;5531;26470;283897;253980;146378;8479;83719;23475;283899;124446;9344;3835;4150;226;253982;83723;5595;6911;8448;79447;112476;9961;10423;6693;79153,26
-1,1,16,29567295,30177999,610704,653808;5531;26470;283897;253980;146378;8479;83719;23475;283899;124446;9344;3835;4150;226;253982;83723;5595;6911;8448;79447;112476;9961;10423;6693;79153,26
-1,1,16,29567295,30177999,610704,653808;5531;26470;283897;253980;146378;8479;83719;23475;283899;124446;9344;3835;4150;226;253982;83723;5595;6911;8448;79447;112476;9961;10423;6693;79153,26
-1,1,16,29567295,30177999,610704,653808;5531;26470;283897;253980;146378;8479;83719;23475;283899;124446;9344;3835;4150;226;253982;83723;5595;6911;8448;79447;112476;9961;10423;6693;79153,26
-1,1,16,29567295,30177999,610704,653808;5531;26470;283897;253980;146378;8479;83719;23475;283899;124446;9344;3835;4150;226;253982;83723;5595;6911;8448;79447;112476;9961;10423;6693;79153,26
-1,1,16,29567295,30177999,610704,653808;5531;26470;283897;253980;146378;8479;83719;23475;283899;124446;9344;3835;4150;226;253982;83723;5595;6911;8448;79447;112476;9961;10423;6693;79153,26
-1,1,16,29567295,30177999,610704,653808;5531;26470;283897;253980;146378;8479;83719;23475;283899;124446;9344;3835;4150;226;253982;83723;5595;6911;8448;79447;112476;9961;10423;6693;79153,26
-1,1,16,29567295,30177999,610704,653808;5531;26470;283897;253980;146378;8479;83719;23475;283899;124446;9344;3835;4150;226;253982;83723;5595;6911;8448;79447;112476;9961;10423;6693;79153,26
-1,1,16,29567295,30177999,610704,653808;5531;26470;283897;253980;146378;8479;83719;23475;283899;124446;9344;3835;4150;226;253982;83723;5595;6911;8448;79447;112476;9961;10423;6693;79153,26
-1,1,16,29567295,30177999,610704,653808;5531;26470;283897;253980;146378;8479;83719;23475;283899;124446;9344;3835;4150;226;253982;83723;5595;6911;8448;79447;112476;9961;10423;6693;79153,26
-1,1,16,29567295,30178406,611111,653808;5531;26470;283897;253980;146378;8479;83719;23475;283899;124446;9344;3835;4150;226;253982;83723;5595;6911;8448;79447;112476;9961;10423;6693;79153,26
-1,1,16,29567295,30178406,611111,653808;5531;26470;283897;253980;146378;8479;83719;23475;283899;124446;9344;3835;4150;226;253982;83723;5595;6911;8448;79447;112476;9961;10423;6693;79153,26
-1,1,16,29567295,30178406,611111,653808;5531;26470;283897;253980;146378;8479;83719;23475;283899;124446;9344;3835;4150;226;253982;83723;5595;6911;8448;79447;112476;9961;10423;6693;79153,26
-1,1,16,29567295,30178406,611111,653808;5531;26470;283897;253980;146378;8479;83719;23475;283899;124446;9344;3835;4150;226;253982;83723;5595;6911;8448;79447;112476;9961;10423;6693;79153,26
-1,1,16,29567295,30190029,622734,653808;5531;26470;283897;253980;146378;8479;83719;23475;283899;124446;9344;3835;4150;226;253982;83723;5595;6911;8448;79447;112476;9961;10423;6693;79153,26
-1,1,16,29567295,30190029,622734,653808;5531;26470;283897;253980;146378;8479;83719;23475;283899;124446;9344;3835;4150;226;253982;83723;5595;6911;8448;79447;112476;9961;10423;6693;79153,26
-1,1,16,29567295,30190029,622734,653808;5531;26470;283897;253980;146378;8479;83719;23475;283899;124446;9344;3835;4150;226;253982;83723;5595;6911;8448;79447;112476;9961;10423;6693;79153,26
-1,1,16,29567295,30190029,622734,653808;5531;26470;283897;253980;146378;8479;83719;23475;283899;124446;9344;3835;4150;226;253982;83723;5595;6911;8448;79447;112476;9961;10423;6693;79153,26
-1,1,16,29567295,30226930,659635,653808;654483;5531;26470;283897;253980;146378;8479;83719;23475;283899;548593;124446;9344;3835;4150;226;253982;83723;5595;6911;11151;6818;79447;112476;8448;9961;10423;6693;79153,30
-1,1,16,29567295,30243606,676311,653808;654483;5531;26470;283897;253980;146378;8479;83719;23475;283899;548593;124446;9344;3835;4150;226;613037;253982;83723;5595;6911;11151;6818;79447;112476;8448;9961;10423;6693;79153,31
-1,1,16,29567295,30320307,753012,653808;654483;5531;26470;283897;253980;146378;8479;83719;23475;283899;548593;124446;9344;3835;4150;226;613037;253982;83723;5595;6911;11151;6818;79447;112476;8448;9961;10423;6693;79153,31
1,1,16,29567295,30321320,754025,653808;654483;5531;26470;283897;253980;146378;8479;83719;23475;283899;548593;124446;9344;3835;4150;226;613037;253982;83723;5595;6911;11151;6818;79447;112476;8448;9961;10423;6693;79153,31
-1,1,16,29567295,30321320,754025,653808;654483;5531;26470;283897;253980;146378;8479;83719;23475;283899;548593;124446;9344;3835;4150;226;613037;253982;83723;5595;6911;11151;6818;79447;112476;8448;9961;10423;6693;79153,31
-1,1,16,29567296,30177807,610511,653808;5531;26470;283897;253980;146378;8479;83719;23475;283899;124446;9344;3835;4150;226;253982;83723;5595;6911;8448;79447;112476;9961;10423;6693;79153,26
-1,1,16,29567296,30177916,610620,653808;5531;26470;283897;253980;146378;8479;83719;23475;283899;124446;9344;3835;4150;226;253982;83723;5595;6911;8448;79447;112476;9961;10423;6693;79153,26
-1,1,16,29567296,30177999,610703,653808;5531;26470;283897;253980;146378;8479;83719;23475;283899;124446;9344;3835;4150;226;253982;83723;5595;6911;8448;79447;112476;9961;10423;6693;79153,26
-1,1,16,29567296,30178406,611110,653808;5531;26470;283897;253980;146378;8479;83719;23475;283899;124446;9344;3835;4150;226;253982;83723;5595;6911;8448;79447;112476;9961;10423;6693;79153,26
-1,1,16,29580020,30177240,597220,653808;5531;26470;283897;253980;146378;8479;83719;23475;283899;124446;9344;3835;4150;226;253982;83723;5595;6911;8448;79447;112476;9961;10423;6693;79153,26
-1,1,16,29580020,30177916,597896,653808;5531;26470;283897;253980;146378;8479;83719;23475;283899;124446;9344;3835;4150;226;253982;83723;5595;6911;8448;79447;112476;9961;10423;6693;79153,26
-1,1,16,29580020,30177916,597896,653808;5531;26470;283897;253980;146378;8479;83719;23475;283899;124446;9344;3835;4150;226;253982;83723;5595;6911;8448;79447;112476;9961;10423;6693;79153,26
-1,1,16,29580020,30177999,597979,653808;5531;26470;283897;253980;146378;8479;83719;23475;283899;124446;9344;3835;4150;226;253982;83723;5595;6911;8448;79447;112476;9961;10423;6693;79153,26
-1,1,16,29580020,30177999,597979,653808;5531;26470;283897;253980;146378;8479;83719;23475;283899;124446;9344;3835;4150;226;253982;83723;5595;6911;8448;79447;112476;9961;10423;6693;79153,26
-1,1,16,29580610,30177240,596630,653808;5531;26470;283897;253980;146378;8479;83719;23475;283899;124446;9344;3835;4150;226;253982;83723;5595;6911;8448;79447;112476;9961;10423;6693;79153,26
1,1,16,29592751,30190593,597842,653808;5531;26470;283897;253980;146378;8479;83719;23475;283899;124446;9344;3835;4150;226;253982;83723;5595;6911;8448;79447;112476;9961;10423;6693;79153,26
-1,1,16,29592751,30190593,597842,653808;5531;26470;283897;253980;146378;8479;83719;23475;283899;124446;9344;3835;4150;226;253982;83723;5595;6911;8448;79447;112476;9961;10423;6693;79153,26
-1,1,16,29590554,30190568,600014,653808;5531;26470;283897;253980;146378;8479;83719;23475;283899;124446;9344;3835;4150;226;253982;83723;5595;6911;8448;79447;112476;9961;10423;6693;79153,26
-1,1,16,29590554,30197341,606787,653808;5531;26470;283897;253980;146378;8479;83719;23475;283899;124446;9344;3835;4150;226;253982;83723;5595;6911;11151;8448;79447;112476;9961;10423;6693;79153,27
-1,1,16,29590554,30197341,606787,653808;5531;26470;283897;253980;146378;8479;83719;23475;283899;124446;9344;3835;4150;226;253982;83723;5595;6911;11151;8448;79447;112476;9961;10423;6693;79153,27
-1,1,16,29590554,30197341,606787,653808;5531;26470;283897;253980;146378;8479;83719;23475;283899;124446;9344;3835;4150;226;253982;83723;5595;6911;11151;8448;79447;112476;9961;10423;6693;79153,27
-1,1,16,29590554,30197341,606787,653808;5531;26470;283897;253980;146378;8479;83719;23475;283899;124446;9344;3835;4150;226;253982;83723;5595;6911;11151;8448;79447;112476;9961;10423;6693;79153,27
-1,1,16,29590554,30197341,606787,653808;5531;26470;283897;253980;146378;8479;83719;23475;283899;124446;9344;3835;4150;226;253982;83723;5595;6911;11151;8448;79447;112476;9961;10423;6693;79153,27
-1,1,16,29590554,30197341,606787,653808;5531;26470;283897;253980;146378;8479;83719;23475;283899;124446;9344;3835;4150;226;253982;83723;5595;6911;11151;8448;79447;112476;9961;10423;6693;79153,27
-1,1,16,29590554,30197341,606787,653808;5531;26470;283897;253980;146378;8479;83719;23475;283899;124446;9344;3835;4150;226;253982;83723;5595;6911;11151;8448;79447;112476;9961;10423;6693;79153,27
-1,1,16,29590554,30197341,606787,653808;5531;26470;283897;253980;146378;8479;83719;23475;283899;124446;9344;3835;4150;226;253982;83723;5595;6911;11151;8448;79447;112476;9961;10423;6693;79153,27
-1,1,16,29590554,30197341,606787,653808;5531;26470;283897;253980;146378;8479;83719;23475;283899;124446;9344;3835;4150;226;253982;83723;5595;6911;11151;8448;79447;112476;9961;10423;6693;79153,27
-1,1,16,29590554,30197341,606787,653808;5531;26470;283897;253980;146378;8479;83719;23475;283899;124446;9344;3835;4150;226;253982;83723;5595;6911;11151;8448;79447;112476;9961;10423;6693;79153,27
-1,1,16,29590554,30197341,606787,653808;5531;26470;283897;253980;146378;8479;83719;23475;283899;124446;9344;3835;4150;226;253982;83723;5595;6911;11151;8448;79447;112476;9961;10423;6693;79153,27
-1,1,16,29590554,30197341,606787,653808;5531;26470;283897;253980;146378;8479;83719;23475;283899;124446;9344;3835;4150;226;253982;83723;5595;6911;11151;8448;79447;112476;9961;10423;6693;79153,27
-1,1,16,29590554,30197341,606787,653808;5531;26470;283897;253980;146378;8479;83719;23475;283899;124446;9344;3835;4150;226;253982;83723;5595;6911;11151;8448;79447;112476;9961;10423;6693;79153,27
-1,1,16,29590554,30332014,741460,653808;654483;5531;26470;283897;253980;146378;8479;83719;23475;283899;548593;124446;9344;3835;4150;226;613037;253982;83723;5595;6911;11151;6818;79447;112476;8448;9961;10423;6693;79153,31
1,1,16,29591078,30177916,586838,653808;5531;26470;283897;253980;146378;8479;83719;23475;283899;124446;9344;3835;4150;226;253982;83723;5595;6911;8448;79447;112476;9961;10423;6693;79153,26
1,1,16,29591078,30240227,649149,653808;654483;5531;26470;283897;253980;146378;8479;83719;23475;283899;548593;124446;9344;3835;4150;226;613037;253982;83723;5595;6911;11151;6818;79447;112476;8448;9961;10423;6693;79153,31
-1,1,16,29592783,30190568,597785,653808;5531;26470;283897;253980;146378;8479;83719;23475;283899;124446;9344;3835;4150;226;253982;83723;5595;6911;8448;79447;112476;9961;10423;6693;79153,26
-1,1,16,29592783,30190568,597785,653808;5531;26470;283897;253980;146378;8479;83719;23475;283899;124446;9344;3835;4150;226;253982;83723;5595;6911;8448;79447;112476;9961;10423;6693;79153,26
-1,1,16,29592783,30190568,597785,653808;5531;26470;283897;253980;146378;8479;83719;23475;283899;124446;9344;3835;4150;226;253982;83723;5595;6911;8448;79447;112476;9961;10423;6693;79153,26
-1,1,16,29592783,30190568,597785,653808;5531;26470;283897;253980;146378;8479;83719;23475;283899;124446;9344;3835;4150;226;253982;83723;5595;6911;8448;79447;112476;9961;10423;6693;79153,26
1,1,16,29592783,30190568,597785,653808;5531;26470;283897;253980;146378;8479;83719;23475;283899;124446;9344;3835;4150;226;253982;83723;5595;6911;8448;79447;112476;9961;10423;6693;79153,26
1,1,16,29592783,30190568,597785,653808;5531;26470;283897;253980;146378;8479;83719;23475;283899;124446;9344;3835;4150;226;253982;83723;5595;6911;8448;79447;112476;9961;10423;6693;79153,26
-1,1,16,29592783,30190568,597785,653808;5531;26470;283897;253980;146378;8479;83719;23475;283899;124446;9344;3835;4150;226;253982;83723;5595;6911;8448;79447;112476;9961;10423;6693;79153,26
-1,1,16,29592783,30190568,597785,653808;5531;26470;283897;253980;146378;8479;83719;23475;283899;124446;9344;3835;4150;226;253982;83723;5595;6911;8448;79447;112476;9961;10423;6693;79153,26
1,1,16,29592783,30190568,597785,653808;5531;26470;283897;253980;146378;8479;83719;23475;283899;124446;9344;3835;4150;226;253982;83723;5595;6911;8448;79447;112476;9961;10423;6693;79153,26
-1,1,16,29592783,30190568,597785,653808;5531;26470;283897;253980;146378;8479;83719;23475;283899;124446;9344;3835;4150;226;253982;83723;5595;6911;8448;79447;112476;9961;10423;6693;79153,26
-1,1,16,29592783,30190568,597785,653808;5531;26470;283897;253980;146378;8479;83719;23475;283899;124446;9344;3835;4150;226;253982;83723;5595;6911;8448;79447;112476;9961;10423;6693;79153,26
-1,1,16,29592783,30190568,597785,653808;5531;26470;283897;253980;146378;8479;83719;23475;283899;124446;9344;3835;4150;226;253982;83723;5595;6911;8448;79447;112476;9961;10423;6693;79153,26
-1,1,16,29592783,30190568,597785,653808;5531;26470;283897;253980;146378;8479;83719;23475;283899;124446;9344;3835;4150;226;253982;83723;5595;6911;8448;79447;112476;9961;10423;6693;79153,26
-1,1,16,29592783,30190568,597785,653808;5531;26470;283897;253980;146378;8479;83719;23475;283899;124446;9344;3835;4150;226;253982;83723;5595;6911;8448;79447;112476;9961;10423;6693;79153,26
-1,1,16,29592783,30190568,597785,653808;5531;26470;283897;253980;146378;8479;83719;23475;283899;124446;9344;3835;4150;226;253982;83723;5595;6911;8448;79447;112476;9961;10423;6693;79153,26
-1,1,16,29592783,30190568,597785,653808;5531;26470;283897;253980;146378;8479;83719;23475;283899;124446;9344;3835;4150;226;253982;83723;5595;6911;8448;79447;112476;9961;10423;6693;79153,26
1,1,16,29592783,30197290,604507,653808;5531;26470;283897;253980;146378;8479;83719;23475;283899;124446;9344;3835;4150;226;253982;83723;5595;6911;11151;8448;79447;112476;9961;10423;6693;79153,27
-1,1,16,29592783,30332581,739798,653808;654483;5531;26470;283897;253980;146378;8479;83719;23475;283899;548593;124446;9344;3835;4150;226;613037;253982;83723;5595;6911;11151;6818;79447;112476;8448;9961;10423;6693;79153,31
-1,1,16,29592783,30332581,739798,653808;654483;5531;26470;283897;253980;146378;8479;83719;23475;283899;548593;124446;9344;3835;4150;226;613037;253982;83723;5595;6911;11151;6818;79447;112476;8448;9961;10423;6693;79153,31
-1,1,16,29592783,30332581,739798,653808;654483;5531;26470;283897;253980;146378;8479;83719;23475;283899;548593;124446;9344;3835;4150;226;613037;253982;83723;5595;6911;11151;6818;79447;112476;8448;9961;10423;6693;79153,31
1,1,16,29592783,30332581,739798,653808;654483;5531;26470;283897;253980;146378;8479;83719;23475;283899;548593;124446;9344;3835;4150;226;613037;253982;83723;5595;6911;11151;6818;79447;112476;8448;9961;10423;6693;79153,31
-1,1,16,29592783,30703233,1110450,654483;283897;22928;26000;83719;23475;283899;548593;226;613037;79724;253982;83723;51333;6911;11151;79447;112476;9961;197407;115509;79077;79153;78994;653808;64319;5531;146542;26470;253980;146378;8479;124446;9344;3835;1731;4150;65988;3683;5595;146540;6818;8448;92595;10423;29895;6693;10421,48
-1,1,16,29592791,30190593,597802,653808;5531;26470;283897;253980;146378;8479;83719;23475;283899;124446;9344;3835;4150;226;253982;83723;5595;6911;8448;79447;112476;9961;10423;6693;79153,26
-1,1,16,29592791,30190593,597802,653808;5531;26470;283897;253980;146378;8479;83719;23475;283899;124446;9344;3835;4150;226;253982;83723;5595;6911;8448;79447;112476;9961;10423;6693;79153,26
-1,1,16,29592791,30190593,597802,653808;5531;26470;283897;253980;146378;8479;83719;23475;283899;124446;9344;3835;4150;226;253982;83723;5595;6911;8448;79447;112476;9961;10423;6693;79153,26
1,1,16,29592791,30332569,739778,653808;654483;5531;26470;283897;253980;146378;8479;83719;23475;283899;548593;124446;9344;3835;4150;226;613037;253982;83723;5595;6911;11151;6818;79447;112476;8448;9961;10423;6693;79153,31
1,1,16,29620658,30190593,569935,653808;5531;26470;283897;253980;146378;8479;83719;23475;283899;124446;9344;3835;4150;226;253982;83723;5595;6911;8448;79447;112476;9961;10423;6693;79153,26
1,1,16,29620658,30190593,569935,653808;5531;26470;283897;253980;146378;8479;83719;23475;283899;124446;9344;3835;4150;226;253982;83723;5595;6911;8448;79447;112476;9961;10423;6693;79153,26
-1,1,16,29597822,30177240,579418,653808;5531;26470;283897;253980;146378;8479;83719;23475;283899;124446;9344;3835;4150;226;253982;83723;5595;6911;8448;79447;112476;9961;10423;6693;79153,26
1,1,16,29597822,30240227,642405,653808;654483;5531;26470;283897;253980;146378;8479;83719;23475;283899;548593;124446;9344;3835;4150;226;613037;253982;83723;5595;6911;11151;6818;79447;112476;8448;9961;10423;6693;79153,31
1,1,16,29609934,30177916,567982,653808;5531;26470;283897;253980;146378;8479;83719;23475;283899;124446;9344;3835;4150;226;253982;83723;5595;6911;8448;79447;112476;9961;10423;6693;79153,26
-1,1,16,29620689,30197290,576601,653808;5531;26470;283897;253980;146378;8479;83719;23475;283899;124446;9344;3835;4150;226;253982;83723;5595;6911;11151;8448;79447;112476;9961;10423;6693;79153,27
1,1,16,29656657,30190593,533936,653808;5531;26470;283897;253980;146378;8479;83719;23475;283899;124446;9344;3835;4150;226;253982;83723;5595;6911;8448;79447;112476;9961;10423;6693;79153,26
-1,1,16,29656657,30190593,533936,653808;5531;26470;283897;253980;146378;8479;83719;23475;283899;124446;9344;3835;4150;226;253982;83723;5595;6911;8448;79447;112476;9961;10423;6693;79153,26
-1,1,16,29656657,30190593,533936,653808;5531;26470;283897;253980;146378;8479;83719;23475;283899;124446;9344;3835;4150;226;253982;83723;5595;6911;8448;79447;112476;9961;10423;6693;79153,26
1,1,16,29656657,30190593,533936,653808;5531;26470;283897;253980;146378;8479;83719;23475;283899;124446;9344;3835;4150;226;253982;83723;5595;6911;8448;79447;112476;9961;10423;6693;79153,26
-1,1,16,29656657,30190593,533936,653808;5531;26470;283897;253980;146378;8479;83719;23475;283899;124446;9344;3835;4150;226;253982;83723;5595;6911;8448;79447;112476;9961;10423;6693;79153,26
-1,1,16,29656657,30190593,533936,653808;5531;26470;283897;253980;146378;8479;83719;23475;283899;124446;9344;3835;4150;226;253982;83723;5595;6911;8448;79447;112476;9961;10423;6693;79153,26
-1,1,16,29656657,30190593,533936,653808;5531;26470;283897;253980;146378;8479;83719;23475;283899;124446;9344;3835;4150;226;253982;83723;5595;6911;8448;79447;112476;9961;10423;6693;79153,26
-1,1,16,29656657,30197466,540809,653808;5531;26470;283897;253980;146378;8479;83719;23475;283899;124446;9344;3835;4150;226;253982;83723;5595;6911;11151;8448;79447;112476;9961;10423;6693;79153,27
-1,1,16,29656657,30197466,540809,653808;5531;26470;283897;253980;146378;8479;83719;23475;283899;124446;9344;3835;4150;226;253982;83723;5595;6911;11151;8448;79447;112476;9961;10423;6693;79153,27
-1,1,16,29656657,30197466,540809,653808;5531;26470;283897;253980;146378;8479;83719;23475;283899;124446;9344;3835;4150;226;253982;83723;5595;6911;11151;8448;79447;112476;9961;10423;6693;79153,27
1,1,16,29656657,30250660,594003,653808;654483;5531;26470;283897;253980;146378;8479;83719;23475;283899;548593;124446;9344;3835;4150;226;613037;253982;83723;5595;6911;11151;6818;79447;112476;8448;9961;10423;6693;79153,31
1,-1,16,29624765,29624872,107,,0
1,1,16,29624765,30197290,572525,653808;5531;26470;283897;253980;146378;8479;83719;23475;283899;124446;9344;3835;4150;226;253982;83723;5595;6911;11151;8448;79447;112476;9961;10423;6693;79153,27
1,1,16,29626499,30177240,550741,653808;5531;26470;283897;253980;146378;8479;83719;23475;283899;124446;9344;3835;4150;226;253982;83723;5595;6911;8448;79447;112476;9961;10423;6693;79153,26
-1,1,16,29646320,30197290,550970,653808;5531;26470;283897;253980;146378;8479;83719;23475;283899;124446;9344;3835;4150;226;253982;83723;5595;6911;11151;8448;79447;112476;9961;10423;6693;79153,27
-1,1,16,29646320,30197290,550970,653808;5531;26470;283897;253980;146378;8479;83719;23475;283899;124446;9344;3835;4150;226;253982;83723;5595;6911;11151;8448;79447;112476;9961;10423;6693;79153,27
-1,1,16,29646320,30197290,550970,653808;5531;26470;283897;253980;146378;8479;83719;23475;283899;124446;9344;3835;4150;226;253982;83723;5595;6911;11151;8448;79447;112476;9961;10423;6693;79153,27
-1,1,16,29646320,30197290,550970,653808;5531;26470;283897;253980;146378;8479;83719;23475;283899;124446;9344;3835;4150;226;253982;83723;5595;6911;11151;8448;79447;112476;9961;10423;6693;79153,27
-1,1,16,29646320,30197290,550970,653808;5531;26470;283897;253980;146378;8479;83719;23475;283899;124446;9344;3835;4150;226;253982;83723;5595;6911;11151;8448;79447;112476;9961;10423;6693;79153,27
-1,1,16,29646320,30197290,550970,653808;5531;26470;283897;253980;146378;8479;83719;23475;283899;124446;9344;3835;4150;226;253982;83723;5595;6911;11151;8448;79447;112476;9961;10423;6693;79153,27
-1,1,16,29646320,30197290,550970,653808;5531;26470;283897;253980;146378;8479;83719;23475;283899;124446;9344;3835;4150;226;253982;83723;5595;6911;11151;8448;79447;112476;9961;10423;6693;79153,27
1,1,16,29646320,30197290,550970,653808;5531;26470;283897;253980;146378;8479;83719;23475;283899;124446;9344;3835;4150;226;253982;83723;5595;6911;11151;8448;79447;112476;9961;10423;6693;79153,27
1,1,16,29646320,30197290,550970,653808;5531;26470;283897;253980;146378;8479;83719;23475;283899;124446;9344;3835;4150;226;253982;83723;5595;6911;11151;8448;79447;112476;9961;10423;6693;79153,27
1,1,16,29646320,30197290,550970,653808;5531;26470;283897;253980;146378;8479;83719;23475;283899;124446;9344;3835;4150;226;253982;83723;5595;6911;11151;8448;79447;112476;9961;10423;6693;79153,27
-1,1,16,29646320,30197290,550970,653808;5531;26470;283897;253980;146378;8479;83719;23475;283899;124446;9344;3835;4150;226;253982;83723;5595;6911;11151;8448;79447;112476;9961;10423;6693;79153,27
-1,1,16,29646320,30197290,550970,653808;5531;26470;283897;253980;146378;8479;83719;23475;283899;124446;9344;3835;4150;226;253982;83723;5595;6911;11151;8448;79447;112476;9961;10423;6693;79153,27
-1,1,16,29646320,30197290,550970,653808;5531;26470;283897;253980;146378;8479;83719;23475;283899;124446;9344;3835;4150;226;253982;83723;5595;6911;11151;8448;79447;112476;9961;10423;6693;79153,27
-1,1,16,29646320,30197290,550970,653808;5531;26470;283897;253980;146378;8479;83719;23475;283899;124446;9344;3835;4150;226;253982;83723;5595;6911;11151;8448;79447;112476;9961;10423;6693;79153,27
-1,1,16,29646320,30197290,550970,653808;5531;26470;283897;253980;146378;8479;83719;23475;283899;124446;9344;3835;4150;226;253982;83723;5595;6911;11151;8448;79447;112476;9961;10423;6693;79153,27
-1,1,16,29656684,30197290,540606,653808;5531;26470;283897;253980;146378;8479;83719;23475;283899;124446;9344;3835;4150;226;253982;83723;5595;6911;11151;8448;79447;112476;9961;10423;6693;79153,27
-1,1,16,29656684,30197290,540606,653808;5531;26470;283897;253980;146378;8479;83719;23475;283899;124446;9344;3835;4150;226;253982;83723;5595;6911;11151;8448;79447;112476;9961;10423;6693;79153,27
1,1,16,29656684,30197290,540606,653808;5531;26470;283897;253980;146378;8479;83719;23475;283899;124446;9344;3835;4150;226;253982;83723;5595;6911;11151;8448;79447;112476;9961;10423;6693;79153,27
1,1,16,29656684,30197290,540606,653808;5531;26470;283897;253980;146378;8479;83719;23475;283899;124446;9344;3835;4150;226;253982;83723;5595;6911;11151;8448;79447;112476;9961;10423;6693;79153,27
-1,1,16,29656684,30197341,540657,653808;5531;26470;283897;253980;146378;8479;83719;23475;283899;124446;9344;3835;4150;226;253982;83723;5595;6911;11151;8448;79447;112476;9961;10423;6693;79153,27
-1,1,16,29656684,30197341,540657,653808;5531;26470;283897;253980;146378;8479;83719;23475;283899;124446;9344;3835;4150;226;253982;83723;5595;6911;11151;8448;79447;112476;9961;10423;6693;79153,27
-1,1,16,29656684,30197341,540657,653808;5531;26470;283897;253980;146378;8479;83719;23475;283899;124446;9344;3835;4150;226;253982;83723;5595;6911;11151;8448;79447;112476;9961;10423;6693;79153,27
-1,1,16,29656684,30197341,540657,653808;5531;26470;283897;253980;146378;8479;83719;23475;283899;124446;9344;3835;4150;226;253982;83723;5595;6911;11151;8448;79447;112476;9961;10423;6693;79153,27
-1,1,16,29656684,30197341,540657,653808;5531;26470;283897;253980;146378;8479;83719;23475;283899;124446;9344;3835;4150;226;253982;83723;5595;6911;11151;8448;79447;112476;9961;10423;6693;79153,27
-1,1,16,29656684,30197341,540657,653808;5531;26470;283897;253980;146378;8479;83719;23475;283899;124446;9344;3835;4150;226;253982;83723;5595;6911;11151;8448;79447;112476;9961;10423;6693;79153,27
-1,1,16,29656684,30197341,540657,653808;5531;26470;283897;253980;146378;8479;83719;23475;283899;124446;9344;3835;4150;226;253982;83723;5595;6911;11151;8448;79447;112476;9961;10423;6693;79153,27
-1,1,16,29656684,30197341,540657,653808;5531;26470;283897;253980;146378;8479;83719;23475;283899;124446;9344;3835;4150;226;253982;83723;5595;6911;11151;8448;79447;112476;9961;10423;6693;79153,27
-1,1,16,29656684,30197341,540657,653808;5531;26470;283897;253980;146378;8479;83719;23475;283899;124446;9344;3835;4150;226;253982;83723;5595;6911;11151;8448;79447;112476;9961;10423;6693;79153,27
-1,1,16,29656684,30197341,540657,653808;5531;26470;283897;253980;146378;8479;83719;23475;283899;124446;9344;3835;4150;226;253982;83723;5595;6911;11151;8448;79447;112476;9961;10423;6693;79153,27
-1,1,16,29656684,30197341,540657,653808;5531;26470;283897;253980;146378;8479;83719;23475;283899;124446;9344;3835;4150;226;253982;83723;5595;6911;11151;8448;79447;112476;9961;10423;6693;79153,27
-1,1,16,29656684,30197341,540657,653808;5531;26470;283897;253980;146378;8479;83719;23475;283899;124446;9344;3835;4150;226;253982;83723;5595;6911;11151;8448;79447;112476;9961;10423;6693;79153,27
-1,1,16,29656684,30197341,540657,653808;5531;26470;283897;253980;146378;8479;83719;23475;283899;124446;9344;3835;4150;226;253982;83723;5595;6911;11151;8448;79447;112476;9961;10423;6693;79153,27
-1,1,16,29656684,30197341,540657,653808;5531;26470;283897;253980;146378;8479;83719;23475;283899;124446;9344;3835;4150;226;253982;83723;5595;6911;11151;8448;79447;112476;9961;10423;6693;79153,27
-1,1,16,29673954,30190509,516555,653808;5531;26470;283897;253980;146378;8479;83719;23475;283899;124446;9344;3835;4150;226;253982;83723;5595;6911;8448;79447;112476;9961;10423;6693;79153,26
-1,1,16,29673954,30190568,516614,653808;5531;26470;283897;253980;146378;8479;83719;23475;283899;124446;9344;3835;4150;226;253982;83723;5595;6911;8448;79447;112476;9961;10423;6693;79153,26
-1,1,16,29673954,30190568,516614,653808;5531;26470;283897;253980;146378;8479;83719;23475;283899;124446;9344;3835;4150;226;253982;83723;5595;6911;8448;79447;112476;9961;10423;6693;79153,26
-1,1,16,29673954,30190568,516614,653808;5531;26470;283897;253980;146378;8479;83719;23475;283899;124446;9344;3835;4150;226;253982;83723;5595;6911;8448;79447;112476;9961;10423;6693;79153,26
-1,1,16,29673954,30190568,516614,653808;5531;26470;283897;253980;146378;8479;83719;23475;283899;124446;9344;3835;4150;226;253982;83723;5595;6911;8448;79447;112476;9961;10423;6693;79153,26
-1,1,16,29673954,30190568,516614,653808;5531;26470;283897;253980;146378;8479;83719;23475;283899;124446;9344;3835;4150;226;253982;83723;5595;6911;8448;79447;112476;9961;10423;6693;79153,26
-1,1,16,29673954,30190568,516614,653808;5531;26470;283897;253980;146378;8479;83719;23475;283899;124446;9344;3835;4150;226;253982;83723;5595;6911;8448;79447;112476;9961;10423;6693;79153,26
-1,1,16,29673954,30190568,516614,653808;5531;26470;283897;253980;146378;8479;83719;23475;283899;124446;9344;3835;4150;226;253982;83723;5595;6911;8448;79447;112476;9961;10423;6693;79153,26
-1,1,16,29673954,30190568,516614,653808;5531;26470;283897;253980;146378;8479;83719;23475;283899;124446;9344;3835;4150;226;253982;83723;5595;6911;8448;79447;112476;9961;10423;6693;79153,26
-1,1,16,29673954,30190568,516614,653808;5531;26470;283897;253980;146378;8479;83719;23475;283899;124446;9344;3835;4150;226;253982;83723;5595;6911;8448;79447;112476;9961;10423;6693;79153,26
-1,1,16,29673954,30190568,516614,653808;5531;26470;283897;253980;146378;8479;83719;23475;283899;124446;9344;3835;4150;226;253982;83723;5595;6911;8448;79447;112476;9961;10423;6693;79153,26
-1,1,16,29673954,30190568,516614,653808;5531;26470;283897;253980;146378;8479;83719;23475;283899;124446;9344;3835;4150;226;253982;83723;5595;6911;8448;79447;112476;9961;10423;6693;79153,26
-1,1,16,29673954,30190568,516614,653808;5531;26470;283897;253980;146378;8479;83719;23475;283899;124446;9344;3835;4150;226;253982;83723;5595;6911;8448;79447;112476;9961;10423;6693;79153,26
1,1,16,29673954,30190568,516614,653808;5531;26470;283897;253980;146378;8479;83719;23475;283899;124446;9344;3835;4150;226;253982;83723;5595;6911;8448;79447;112476;9961;10423;6693;79153,26
-1,1,16,29673954,30190568,516614,653808;5531;26470;283897;253980;146378;8479;83719;23475;283899;124446;9344;3835;4150;226;253982;83723;5595;6911;8448;79447;112476;9961;10423;6693;79153,26
-1,1,16,29673954,30190568,516614,653808;5531;26470;283897;253980;146378;8479;83719;23475;283899;124446;9344;3835;4150;226;253982;83723;5595;6911;8448;79447;112476;9961;10423;6693;79153,26
-1,1,16,29673954,30190568,516614,653808;5531;26470;283897;253980;146378;8479;83719;23475;283899;124446;9344;3835;4150;226;253982;83723;5595;6911;8448;79447;112476;9961;10423;6693;79153,26
-1,1,16,29673954,30190568,516614,653808;5531;26470;283897;253980;146378;8479;83719;23475;283899;124446;9344;3835;4150;226;253982;83723;5595;6911;8448;79447;112476;9961;10423;6693;79153,26
-1,1,16,29673954,30190568,516614,653808;5531;26470;283897;253980;146378;8479;83719;23475;283899;124446;9344;3835;4150;226;253982;83723;5595;6911;8448;79447;112476;9961;10423;6693;79153,26
-1,1,16,29673954,30197341,523387,653808;5531;26470;283897;253980;146378;8479;83719;23475;283899;124446;9344;3835;4150;226;253982;83723;5595;6911;11151;8448;79447;112476;9961;10423;6693;79153,27
-1,1,16,29673954,30197341,523387,653808;5531;26470;283897;253980;146378;8479;83719;23475;283899;124446;9344;3835;4150;226;253982;83723;5595;6911;11151;8448;79447;112476;9961;10423;6693;79153,27
-1,-1,16,29673954,30198600,524646,653808;5531;26470;283897;253980;146378;8479;83719;23475;283899;124446;9344;3835;4150;226;253982;83723;5595;6911;11151;8448;79447;112476;9961;10423;6693;79153,27
-1,1,16,29673954,30198600,524646,653808;5531;26470;283897;253980;146378;8479;83719;23475;283899;124446;9344;3835;4150;226;253982;83723;5595;6911;11151;8448;79447;112476;9961;10423;6693;79153,27
-1,1,16,29673954,30332581,658627,653808;654483;5531;26470;283897;253980;146378;8479;83719;23475;283899;548593;124446;9344;3835;4150;226;613037;253982;83723;5595;6911;11151;6818;79447;112476;8448;9961;10423;6693;79153,31
1,1,16,29673954,30332581,658627,653808;654483;5531;26470;283897;253980;146378;8479;83719;23475;283899;548593;124446;9344;3835;4150;226;613037;253982;83723;5595;6911;11151;6818;79447;112476;8448;9961;10423;6693;79153,31
-1,1,16,29673967,30190593,516626,653808;5531;26470;283897;253980;146378;8479;83719;23475;283899;124446;9344;3835;4150;226;253982;83723;5595;6911;8448;79447;112476;9961;10423;6693;79153,26
-1,1,16,29673967,30190593,516626,653808;5531;26470;283897;253980;146378;8479;83719;23475;283899;124446;9344;3835;4150;226;253982;83723;5595;6911;8448;79447;112476;9961;10423;6693;79153,26
-1,1,16,29673967,30190593,516626,653808;5531;26470;283897;253980;146378;8479;83719;23475;283899;124446;9344;3835;4150;226;253982;83723;5595;6911;8448;79447;112476;9961;10423;6693;79153,26
1,1,16,29673967,30332569,658602,653808;654483;5531;26470;283897;253980;146378;8479;83719;23475;283899;548593;124446;9344;3835;4150;226;613037;253982;83723;5595;6911;11151;6818;79447;112476;8448;9961;10423;6693;79153,31
-1,-1,16,29725594,29738388,12794,,0
1,1,16,29920934,31450018,1529084,100862671;654483;146547;26000;83719;3681;613037;29108;79724;10847;83723;6810;6911;11151;197407;339105;93129;78994;9739;54620;64319;9726;146542;253980;146378;8479;124446;1731;3687;5261;2521;23361;3683;5595;1339;84148;79001;283933;29895;10421;22928;730183;112755;283899;548593;1489;226;90835;51333;493829;9810;79759;10295;115509;79077;79153;5652;260434;5531;9344;80270;3684;9274;65988;146540;6818;8448;92595,68
1,-1,16,29974678,29979311,4633,124446,1
1,1,16,30703233,35147508,4444275,100862671;146547;730183;112755;3681;1489;29108;90835;10847;6810;493829;79798;9810;79759;339105;93129;10295;24150;729355;9739;5652;54620;260434;7041;51327;9726;729264;3687;80270;3684;9274;5261;2521;10308;23361;1339;6524;653550;84148;79001;283933;124411;64755,43
1,-1,16,31891842,34201210,2309368,729355;24150;653550;729264;10308,5
-1,-1,16,31905717,33298169,1392452,729355;24150;653550;729264;10308,5
1,-1,16,31955098,32654375,699277,729264,1
1,-1,16,31955098,33782385,1827287,653550;729264;24150;729355,4
1,-1,16,31955098,33786268,1831170,653550;729264;24150;729355,4
1,-1,16,31955098,33798382,1843284,653550;729264;24150;729355,4
1,-1,16,31955098,33798382,1843284,653550;729264;24150;729355,4
1,-1,16,31955098,33853445,1898347,653550;729264;24150;729355,4
1,-1,16,31955098,33948472,1993374,653550;729264;24150;729355,4
-1,-1,16,31955106,33850611,1895505,653550;729264;24150;729355,4
1,-1,16,31986098,32746861,760763,729264;24150,2
1,-1,16,31986098,32786090,799992,729264;24150,2
1,-1,16,31986098,33780444,1794346,653550;729264;24150;729355,4
1,-1,16,31986098,33780444,1794346,653550;729264;24150;729355,4
1,-1,16,31986098,33781281,1795183,653550;729264;24150;729355,4
1,-1,16,31986098,33781506,1795408,653550;729264;24150;729355,4
1,-1,16,31986098,33785365,1799267,653550;729264;24150;729355,4
1,-1,16,31986098,33785365,1799267,653550;729264;24150;729355,4
1,-1,16,31986098,33785784,1799686,653550;729264;24150;729355,4
1,-1,16,31986098,33785784,1799686,653550;729264;24150;729355,4
1,-1,16,31986098,33785784,1799686,653550;729264;24150;729355,4
1,-1,16,31986098,33785784,1799686,653550;729264;24150;729355,4
1,-1,16,31986098,33785784,1799686,653550;729264;24150;729355,4
1,-1,16,31986098,33785784,1799686,653550;729264;24150;729355,4
1,-1,16,31986098,33786268,1800170,653550;729264;24150;729355,4
1,-1,16,31986098,33786268,1800170,653550;729264;24150;729355,4
1,-1,16,31986098,33798382,1812284,653550;729264;24150;729355,4
1,-1,16,31986098,33798382,1812284,653550;729264;24150;729355,4
1,-1,16,31986098,33798382,1812284,653550;729264;24150;729355,4
1,-1,16,31986098,33798382,1812284,653550;729264;24150;729355,4
1,-1,16,31986098,33798382,1812284,653550;729264;24150;729355,4
1,-1,16,31986098,33853445,1867347,653550;729264;24150;729355,4
1,-1,16,31986098,33853445,1867347,653550;729264;24150;729355,4
1,-1,16,31986098,33853445,1867347,653550;729264;24150;729355,4
1,-1,16,31986098,33853445,1867347,653550;729264;24150;729355,4
1,-1,16,31986098,33853445,1867347,653550;729264;24150;729355,4
1,-1,16,31986098,33853445,1867347,653550;729264;24150;729355,4
1,-1,16,31986098,33853445,1867347,653550;729264;24150;729355,4
1,-1,16,31986098,33853445,1867347,653550;729264;24150;729355,4
1,-1,16,31986098,33853445,1867347,653550;729264;24150;729355,4
1,-1,16,31986098,33853445,1867347,653550;729264;24150;729355,4
1,-1,16,31986098,33853445,1867347,653550;729264;24150;729355,4
1,-1,16,31986098,33853445,1867347,653550;729264;24150;729355,4
1,-1,16,31986098,33853445,1867347,653550;729264;24150;729355,4
1,-1,16,31986098,33853445,1867347,653550;729264;24150;729355,4
1,-1,16,31986098,33853445,1867347,653550;729264;24150;729355,4
1,-1,16,31986098,33853445,1867347,653550;729264;24150;729355,4
1,-1,16,31986098,33853445,1867347,653550;729264;24150;729355,4
1,-1,16,31986098,33853445,1867347,653550;729264;24150;729355,4
1,-1,16,31986098,33923118,1937020,653550;729264;24150;729355,4
1,-1,16,31986098,33923118,1937020,653550;729264;24150;729355,4
1,-1,16,31986098,33923118,1937020,653550;729264;24150;729355,4
1,-1,16,31986098,33923118,1937020,653550;729264;24150;729355,4
1,-1,16,31986098,33923118,1937020,653550;729264;24150;729355,4
1,-1,16,31986098,33923118,1937020,653550;729264;24150;729355,4
1,-1,16,31986098,33924190,1938092,653550;729264;24150;729355,4
1,-1,16,31986098,33924190,1938092,653550;729264;24150;729355,4
1,-1,16,31986098,33948472,1962374,653550;729264;24150;729355,4
1,-1,16,31955157,34197489,2242332,653550;729264;24150;729355,4
1,-1,16,31955157,34197489,2242332,653550;729264;24150;729355,4
1,-1,16,31955157,34197489,2242332,653550;729264;24150;729355,4
1,-1,16,31955157,34197489,2242332,653550;729264;24150;729355,4
1,-1,16,31955157,90294753,58339596,64785;1258;4490;6361;92154;23594;84560;6560;84752;25839;2300;763;197320;64779;92922;57019;146212;7571;1535;79007;124044;8720;51090;79786;114780;7567;4157;79583;10164;1540;84290;10725;1012;11345;643911;23568;27324;79567;9289;55282;729159;2775;27189;653550;197258;57338;23417;92806;221188;146198;85320;123970;146429;5934;57546;113;9764;388289;3281;8883;170692;10265;9709;55815;24150;54386;10328;4501;197259;51659;124491;3801;10204;374739;81831;16;123920;1013;1014;9057;8717;84706;55512;643802;2294;5681;81631;6483;93517;79190;80262;54957;10143;161931;94160;1459;91862;4775;27183;89970;9605;2303;6236;1006;10294;124359;100506581;23322;51647;64180;83693;29100;54550;4094;79650;9013;83716;388282;1327;5257;91807;84916;390748;29800;55737;6559;79767;348174;9798;54758;146456;55027;28987;23174;29948;1874;80205;26231;100287036;3250;463;80790;84229;100129697;342371;729355;8139;5713;348180;283847;84080;221191;54921;81620;54849;5119;869;55625;7014;10300;55794;55565;197322;3038;2588;29117;3299;55308;65057;100130958;54971;2175;23090;221184;6299;11269;162239;10200;3291;4502;388284;146433;84501;146223;84627;283849;10381;5699;64400;10428;1800;54920;1783;11060;4489;56942;23019;865;11105;255919;23659;79191;54496;51693;64146;1009;100529251;388276;9914;29109;79152;5336;25894;197257;404550;283927;79791;3294;353;64174;6477;146225;81577;2622;8140;6137;93107;29105;222487;342372;84937;146206;4313;83752;3735;79613;54947;4499;6898;6367;124245;9683;55066;23406;221223;79726;79068;9564;6376;3394;22879;146227;80777;164;27132;6645;84166;729264;4324;440387;57687;51673;267;84342;124045;54768;161882;4496;22980;146167;1003;81533;65009;2653;2806;55336;50855;85407;23035;283848;4495;55159;55238;115992;4597;181;123775;51741;100131303;64127;57017;1504;794;583;339145;23563;23644;79801;388272;57567;497190;7084;5432;999;23536;6553;84138;85445;123872;653319;283971;83449;8824;333929;1728;1071;64282;113540;80004;92822;51388;9688;80152;863;4504;123904;9114;4166;23199;1001;1723;79918;55239;6530;124460;4493;55715;11051;1066;8558;83657;55839;9780;766;53630;51192;23450;1506;3240;10664;57610;80011;55697;57707;440348;8996;23300;57215;23491;9785;6687;118460;4494;9100;29070;3931;2734;58189;29123;55783,370
1,-1,16,31986098,90294753,58308655,64785;1258;4490;6361;92154;23594;84560;6560;84752;25839;2300;763;197320;64779;92922;57019;146212;7571;1535;79007;124044;8720;51090;79786;114780;7567;4157;79583;10164;1540;84290;10725;1012;11345;643911;23568;27324;79567;9289;55282;729159;2775;27189;653550;197258;57338;23417;92806;221188;146198;85320;123970;146429;5934;57546;113;9764;388289;3281;8883;170692;10265;9709;55815;24150;54386;10328;4501;197259;51659;124491;3801;10204;374739;81831;16;123920;1013;1014;9057;8717;84706;55512;643802;2294;5681;81631;6483;93517;79190;80262;54957;10143;161931;94160;1459;91862;4775;27183;89970;9605;2303;6236;1006;10294;124359;100506581;23322;51647;64180;83693;29100;54550;4094;79650;9013;83716;388282;1327;5257;91807;84916;390748;29800;55737;6559;79767;348174;9798;54758;146456;55027;28987;23174;29948;1874;80205;26231;100287036;3250;463;80790;84229;100129697;342371;729355;8139;5713;348180;283847;84080;221191;54921;81620;54849;5119;869;55625;7014;10300;55794;55565;197322;3038;2588;29117;3299;55308;65057;100130958;54971;2175;23090;221184;6299;11269;162239;10200;3291;4502;388284;146433;84501;146223;84627;283849;10381;5699;64400;10428;1800;54920;1783;11060;4489;56942;23019;865;11105;255919;23659;79191;54496;51693;64146;1009;100529251;388276;9914;29109;79152;5336;25894;197257;404550;283927;79791;3294;353;64174;6477;146225;81577;2622;8140;6137;93107;29105;222487;342372;84937;146206;4313;83752;3735;79613;54947;4499;6898;6367;124245;9683;55066;23406;221223;79726;79068;9564;6376;3394;22879;146227;80777;164;27132;6645;84166;729264;4324;440387;57687;51673;267;84342;124045;54768;161882;4496;22980;146167;1003;81533;65009;2653;2806;55336;50855;85407;23035;283848;4495;55159;55238;115992;4597;181;123775;51741;100131303;64127;57017;1504;794;583;339145;23563;23644;79801;388272;57567;497190;7084;5432;999;23536;6553;84138;85445;123872;653319;283971;83449;8824;333929;1728;1071;64282;113540;80004;92822;51388;9688;80152;863;4504;123904;9114;4166;23199;1001;1723;79918;55239;6530;124460;4493;55715;11051;1066;8558;83657;55839;9780;766;53630;51192;23450;1506;3240;10664;57610;80011;55697;57707;440348;8996;23300;57215;23491;9785;6687;118460;4494;9100;29070;3931;2734;58189;29123;55783,370
1,-1,16,31986098,90294753,58308655,64785;1258;4490;6361;92154;23594;84560;6560;84752;25839;2300;763;197320;64779;92922;57019;146212;7571;1535;79007;124044;8720;51090;79786;114780;7567;4157;79583;10164;1540;84290;10725;1012;11345;643911;23568;27324;79567;9289;55282;729159;2775;27189;653550;197258;57338;23417;92806;221188;146198;85320;123970;146429;5934;57546;113;9764;388289;3281;8883;170692;10265;9709;55815;24150;54386;10328;4501;197259;51659;124491;3801;10204;374739;81831;16;123920;1013;1014;9057;8717;84706;55512;643802;2294;5681;81631;6483;93517;79190;80262;54957;10143;161931;94160;1459;91862;4775;27183;89970;9605;2303;6236;1006;10294;124359;100506581;23322;51647;64180;83693;29100;54550;4094;79650;9013;83716;388282;1327;5257;91807;84916;390748;29800;55737;6559;79767;348174;9798;54758;146456;55027;28987;23174;29948;1874;80205;26231;100287036;3250;463;80790;84229;100129697;342371;729355;8139;5713;348180;283847;84080;221191;54921;81620;54849;5119;869;55625;7014;10300;55794;55565;197322;3038;2588;29117;3299;55308;65057;100130958;54971;2175;23090;221184;6299;11269;162239;10200;3291;4502;388284;146433;84501;146223;84627;283849;10381;5699;64400;10428;1800;54920;1783;11060;4489;56942;23019;865;11105;255919;23659;79191;54496;51693;64146;1009;100529251;388276;9914;29109;79152;5336;25894;197257;404550;283927;79791;3294;353;64174;6477;146225;81577;2622;8140;6137;93107;29105;222487;342372;84937;146206;4313;83752;3735;79613;54947;4499;6898;6367;124245;9683;55066;23406;221223;79726;79068;9564;6376;3394;22879;146227;80777;164;27132;6645;84166;729264;4324;440387;57687;51673;267;84342;124045;54768;161882;4496;22980;146167;1003;81533;65009;2653;2806;55336;50855;85407;23035;283848;4495;55159;55238;115992;4597;181;123775;51741;100131303;64127;57017;1504;794;583;339145;23563;23644;79801;388272;57567;497190;7084;5432;999;23536;6553;84138;85445;123872;653319;283971;83449;8824;333929;1728;1071;64282;113540;80004;92822;51388;9688;80152;863;4504;123904;9114;4166;23199;1001;1723;79918;55239;6530;124460;4493;55715;11051;1066;8558;83657;55839;9780;766;53630;51192;23450;1506;3240;10664;57610;80011;55697;57707;440348;8996;23300;57215;23491;9785;6687;118460;4494;9100;29070;3931;2734;58189;29123;55783,370
1,-1,16,31986098,90294753,58308655,64785;1258;4490;6361;92154;23594;84560;6560;84752;25839;2300;763;197320;64779;92922;57019;146212;7571;1535;79007;124044;8720;51090;79786;114780;7567;4157;79583;10164;1540;84290;10725;1012;11345;643911;23568;27324;79567;9289;55282;729159;2775;27189;653550;197258;57338;23417;92806;221188;146198;85320;123970;146429;5934;57546;113;9764;388289;3281;8883;170692;10265;9709;55815;24150;54386;10328;4501;197259;51659;124491;3801;10204;374739;81831;16;123920;1013;1014;9057;8717;84706;55512;643802;2294;5681;81631;6483;93517;79190;80262;54957;10143;161931;94160;1459;91862;4775;27183;89970;9605;2303;6236;1006;10294;124359;100506581;23322;51647;64180;83693;29100;54550;4094;79650;9013;83716;388282;1327;5257;91807;84916;390748;29800;55737;6559;79767;348174;9798;54758;146456;55027;28987;23174;29948;1874;80205;26231;100287036;3250;463;80790;84229;100129697;342371;729355;8139;5713;348180;283847;84080;221191;54921;81620;54849;5119;869;55625;7014;10300;55794;55565;197322;3038;2588;29117;3299;55308;65057;100130958;54971;2175;23090;221184;6299;11269;162239;10200;3291;4502;388284;146433;84501;146223;84627;283849;10381;5699;64400;10428;1800;54920;1783;11060;4489;56942;23019;865;11105;255919;23659;79191;54496;51693;64146;1009;100529251;388276;9914;29109;79152;5336;25894;197257;404550;283927;79791;3294;353;64174;6477;146225;81577;2622;8140;6137;93107;29105;222487;342372;84937;146206;4313;83752;3735;79613;54947;4499;6898;6367;124245;9683;55066;23406;221223;79726;79068;9564;6376;3394;22879;146227;80777;164;27132;6645;84166;729264;4324;440387;57687;51673;267;84342;124045;54768;161882;4496;22980;146167;1003;81533;65009;2653;2806;55336;50855;85407;23035;283848;4495;55159;55238;115992;4597;181;123775;51741;100131303;64127;57017;1504;794;583;339145;23563;23644;79801;388272;57567;497190;7084;5432;999;23536;6553;84138;85445;123872;653319;283971;83449;8824;333929;1728;1071;64282;113540;80004;92822;51388;9688;80152;863;4504;123904;9114;4166;23199;1001;1723;79918;55239;6530;124460;4493;55715;11051;1066;8558;83657;55839;9780;766;53630;51192;23450;1506;3240;10664;57610;80011;55697;57707;440348;8996;23300;57215;23491;9785;6687;118460;4494;9100;29070;3931;2734;58189;29123;55783,370
1,-1,16,31986098,90294753,58308655,64785;1258;4490;6361;92154;23594;84560;6560;84752;25839;2300;763;197320;64779;92922;57019;146212;7571;1535;79007;124044;8720;51090;79786;114780;7567;4157;79583;10164;1540;84290;10725;1012;11345;643911;23568;27324;79567;9289;55282;729159;2775;27189;653550;197258;57338;23417;92806;221188;146198;85320;123970;146429;5934;57546;113;9764;388289;3281;8883;170692;10265;9709;55815;24150;54386;10328;4501;197259;51659;124491;3801;10204;374739;81831;16;123920;1013;1014;9057;8717;84706;55512;643802;2294;5681;81631;6483;93517;79190;80262;54957;10143;161931;94160;1459;91862;4775;27183;89970;9605;2303;6236;1006;10294;124359;100506581;23322;51647;64180;83693;29100;54550;4094;79650;9013;83716;388282;1327;5257;91807;84916;390748;29800;55737;6559;79767;348174;9798;54758;146456;55027;28987;23174;29948;1874;80205;26231;100287036;3250;463;80790;84229;100129697;342371;729355;8139;5713;348180;283847;84080;221191;54921;81620;54849;5119;869;55625;7014;10300;55794;55565;197322;3038;2588;29117;3299;55308;65057;100130958;54971;2175;23090;221184;6299;11269;162239;10200;3291;4502;388284;146433;84501;146223;84627;283849;10381;5699;64400;10428;1800;54920;1783;11060;4489;56942;23019;865;11105;255919;23659;79191;54496;51693;64146;1009;100529251;388276;9914;29109;79152;5336;25894;197257;404550;283927;79791;3294;353;64174;6477;146225;81577;2622;8140;6137;93107;29105;222487;342372;84937;146206;4313;83752;3735;79613;54947;4499;6898;6367;124245;9683;55066;23406;221223;79726;79068;9564;6376;3394;22879;146227;80777;164;27132;6645;84166;729264;4324;440387;57687;51673;267;84342;124045;54768;161882;4496;22980;146167;1003;81533;65009;2653;2806;55336;50855;85407;23035;283848;4495;55159;55238;115992;4597;181;123775;51741;100131303;64127;57017;1504;794;583;339145;23563;23644;79801;388272;57567;497190;7084;5432;999;23536;6553;84138;85445;123872;653319;283971;83449;8824;333929;1728;1071;64282;113540;80004;92822;51388;9688;80152;863;4504;123904;9114;4166;23199;1001;1723;79918;55239;6530;124460;4493;55715;11051;1066;8558;83657;55839;9780;766;53630;51192;23450;1506;3240;10664;57610;80011;55697;57707;440348;8996;23300;57215;23491;9785;6687;118460;4494;9100;29070;3931;2734;58189;29123;55783,370
1,-1,16,31986098,90294753,58308655,64785;1258;4490;6361;92154;23594;84560;6560;84752;25839;2300;763;197320;64779;92922;57019;146212;7571;1535;79007;124044;8720;51090;79786;114780;7567;4157;79583;10164;1540;84290;10725;1012;11345;643911;23568;27324;79567;9289;55282;729159;2775;27189;653550;197258;57338;23417;92806;221188;146198;85320;123970;146429;5934;57546;113;9764;388289;3281;8883;170692;10265;9709;55815;24150;54386;10328;4501;197259;51659;124491;3801;10204;374739;81831;16;123920;1013;1014;9057;8717;84706;55512;643802;2294;5681;81631;6483;93517;79190;80262;54957;10143;161931;94160;1459;91862;4775;27183;89970;9605;2303;6236;1006;10294;124359;100506581;23322;51647;64180;83693;29100;54550;4094;79650;9013;83716;388282;1327;5257;91807;84916;390748;29800;55737;6559;79767;348174;9798;54758;146456;55027;28987;23174;29948;1874;80205;26231;100287036;3250;463;80790;84229;100129697;342371;729355;8139;5713;348180;283847;84080;221191;54921;81620;54849;5119;869;55625;7014;10300;55794;55565;197322;3038;2588;29117;3299;55308;65057;100130958;54971;2175;23090;221184;6299;11269;162239;10200;3291;4502;388284;146433;84501;146223;84627;283849;10381;5699;64400;10428;1800;54920;1783;11060;4489;56942;23019;865;11105;255919;23659;79191;54496;51693;64146;1009;100529251;388276;9914;29109;79152;5336;25894;197257;404550;283927;79791;3294;353;64174;6477;146225;81577;2622;8140;6137;93107;29105;222487;342372;84937;146206;4313;83752;3735;79613;54947;4499;6898;6367;124245;9683;55066;23406;221223;79726;79068;9564;6376;3394;22879;146227;80777;164;27132;6645;84166;729264;4324;440387;57687;51673;267;84342;124045;54768;161882;4496;22980;146167;1003;81533;65009;2653;2806;55336;50855;85407;23035;283848;4495;55159;55238;115992;4597;181;123775;51741;100131303;64127;57017;1504;794;583;339145;23563;23644;79801;388272;57567;497190;7084;5432;999;23536;6553;84138;85445;123872;653319;283971;83449;8824;333929;1728;1071;64282;113540;80004;92822;51388;9688;80152;863;4504;123904;9114;4166;23199;1001;1723;79918;55239;6530;124460;4493;55715;11051;1066;8558;83657;55839;9780;766;53630;51192;23450;1506;3240;10664;57610;80011;55697;57707;440348;8996;23300;57215;23491;9785;6687;118460;4494;9100;29070;3931;2734;58189;29123;55783,370
1,-1,16,31986098,90294753,58308655,64785;1258;4490;6361;92154;23594;84560;6560;84752;25839;2300;763;197320;64779;92922;57019;146212;7571;1535;79007;124044;8720;51090;79786;114780;7567;4157;79583;10164;1540;84290;10725;1012;11345;643911;23568;27324;79567;9289;55282;729159;2775;27189;653550;197258;57338;23417;92806;221188;146198;85320;123970;146429;5934;57546;113;9764;388289;3281;8883;170692;10265;9709;55815;24150;54386;10328;4501;197259;51659;124491;3801;10204;374739;81831;16;123920;1013;1014;9057;8717;84706;55512;643802;2294;5681;81631;6483;93517;79190;80262;54957;10143;161931;94160;1459;91862;4775;27183;89970;9605;2303;6236;1006;10294;124359;100506581;23322;51647;64180;83693;29100;54550;4094;79650;9013;83716;388282;1327;5257;91807;84916;390748;29800;55737;6559;79767;348174;9798;54758;146456;55027;28987;23174;29948;1874;80205;26231;100287036;3250;463;80790;84229;100129697;342371;729355;8139;5713;348180;283847;84080;221191;54921;81620;54849;5119;869;55625;7014;10300;55794;55565;197322;3038;2588;29117;3299;55308;65057;100130958;54971;2175;23090;221184;6299;11269;162239;10200;3291;4502;388284;146433;84501;146223;84627;283849;10381;5699;64400;10428;1800;54920;1783;11060;4489;56942;23019;865;11105;255919;23659;79191;54496;51693;64146;1009;100529251;388276;9914;29109;79152;5336;25894;197257;404550;283927;79791;3294;353;64174;6477;146225;81577;2622;8140;6137;93107;29105;222487;342372;84937;146206;4313;83752;3735;79613;54947;4499;6898;6367;124245;9683;55066;23406;221223;79726;79068;9564;6376;3394;22879;146227;80777;164;27132;6645;84166;729264;4324;440387;57687;51673;267;84342;124045;54768;161882;4496;22980;146167;1003;81533;65009;2653;2806;55336;50855;85407;23035;283848;4495;55159;55238;115992;4597;181;123775;51741;100131303;64127;57017;1504;794;583;339145;23563;23644;79801;388272;57567;497190;7084;5432;999;23536;6553;84138;85445;123872;653319;283971;83449;8824;333929;1728;1071;64282;113540;80004;92822;51388;9688;80152;863;4504;123904;9114;4166;23199;1001;1723;79918;55239;6530;124460;4493;55715;11051;1066;8558;83657;55839;9780;766;53630;51192;23450;1506;3240;10664;57610;80011;55697;57707;440348;8996;23300;57215;23491;9785;6687;118460;4494;9100;29070;3931;2734;58189;29123;55783,370
-1,-1,16,31986157,32637879,651722,729264,1
1,-1,16,31994667,32654375,659708,729264,1
1,-1,16,31994667,32746861,752194,729264;24150,2
-1,-1,16,31986157,33773134,1786977,653550;729264;24150;729355,4
1,-1,16,31994667,33785151,1790484,653550;729264;24150;729355,4
1,-1,16,31994667,33785784,1791117,653550;729264;24150;729355,4
1,-1,16,31994667,33785784,1791117,653550;729264;24150;729355,4
1,-1,16,31994667,33785784,1791117,653550;729264;24150;729355,4
1,-1,16,31994667,33785784,1791117,653550;729264;24150;729355,4
1,-1,16,31994667,33786268,1791601,653550;729264;24150;729355,4
1,-1,16,31994667,33786268,1791601,653550;729264;24150;729355,4
1,-1,16,31994667,33786268,1791601,653550;729264;24150;729355,4
1,-1,16,31994667,33798382,1803715,653550;729264;24150;729355,4
1,-1,16,31994667,33798382,1803715,653550;729264;24150;729355,4
1,-1,16,31994667,33798382,1803715,653550;729264;24150;729355,4
1,-1,16,31994667,33798382,1803715,653550;729264;24150;729355,4
1,-1,16,31994667,33798382,1803715,653550;729264;24150;729355,4
1,-1,16,31994667,33798382,1803715,653550;729264;24150;729355,4
1,-1,16,31994667,33798382,1803715,653550;729264;24150;729355,4
1,-1,16,31994667,33798382,1803715,653550;729264;24150;729355,4
1,-1,16,31994667,33798382,1803715,653550;729264;24150;729355,4
1,-1,16,31994667,33798382,1803715,653550;729264;24150;729355,4
1,-1,16,31994667,33827494,1832827,653550;729264;24150;729355,4
1,-1,16,31994667,33850681,1856014,653550;729264;24150;729355,4
1,-1,16,31994667,33853445,1858778,653550;729264;24150;729355,4
1,-1,16,31994667,33853445,1858778,653550;729264;24150;729355,4
1,-1,16,31994667,33853445,1858778,653550;729264;24150;729355,4
1,-1,16,31994667,33853445,1858778,653550;729264;24150;729355,4
1,-1,16,31994667,33853445,1858778,653550;729264;24150;729355,4
1,-1,16,31994667,33853445,1858778,653550;729264;24150;729355,4
1,-1,16,31994667,33853445,1858778,653550;729264;24150;729355,4
1,-1,16,31994667,33853445,1858778,653550;729264;24150;729355,4
1,-1,16,31994667,33923118,1928451,653550;729264;24150;729355,4
1,-1,16,31994667,33923118,1928451,653550;729264;24150;729355,4
1,-1,16,31994667,33923118,1928451,653550;729264;24150;729355,4
1,-1,16,31994667,33923118,1928451,653550;729264;24150;729355,4
1,-1,16,31994667,33923118,1928451,653550;729264;24150;729355,4
1,-1,16,31994667,33923118,1928451,653550;729264;24150;729355,4
1,-1,16,31994667,33923118,1928451,653550;729264;24150;729355,4
1,-1,16,31994667,33924190,1929523,653550;729264;24150;729355,4
1,-1,16,31994667,33924190,1929523,653550;729264;24150;729355,4
1,-1,16,31994667,33948472,1953805,653550;729264;24150;729355,4
1,-1,16,31994667,34179903,2185236,653550;729264;24150;729355,4
1,-1,16,31994667,90294753,58300086,64785;1258;4490;6361;92154;23594;84560;6560;84752;25839;2300;763;197320;64779;92922;57019;146212;7571;1535;79007;124044;8720;51090;79786;114780;7567;4157;79583;10164;1540;84290;10725;1012;11345;643911;23568;27324;79567;9289;55282;729159;2775;27189;653550;197258;57338;23417;92806;221188;146198;85320;123970;146429;5934;57546;113;9764;388289;3281;8883;170692;10265;9709;55815;24150;54386;10328;4501;197259;51659;124491;3801;10204;374739;81831;16;123920;1013;1014;9057;8717;84706;55512;643802;2294;5681;81631;6483;93517;79190;80262;54957;10143;161931;94160;1459;91862;4775;27183;89970;9605;2303;6236;1006;10294;124359;100506581;23322;51647;64180;83693;29100;54550;4094;79650;9013;83716;388282;1327;5257;91807;84916;390748;29800;55737;6559;79767;348174;9798;54758;146456;55027;28987;23174;29948;1874;80205;26231;100287036;3250;463;80790;84229;100129697;342371;729355;8139;5713;348180;283847;84080;221191;54921;81620;54849;5119;869;55625;7014;10300;55794;55565;197322;3038;2588;29117;3299;55308;65057;100130958;54971;2175;23090;221184;6299;11269;162239;10200;3291;4502;388284;146433;84501;146223;84627;283849;10381;5699;64400;10428;1800;54920;1783;11060;4489;56942;23019;865;11105;255919;23659;79191;54496;51693;64146;1009;100529251;388276;9914;29109;79152;5336;25894;197257;404550;283927;79791;3294;353;64174;6477;146225;81577;2622;8140;6137;93107;29105;222487;342372;84937;146206;4313;83752;3735;79613;54947;4499;6898;6367;124245;9683;55066;23406;221223;79726;79068;9564;6376;3394;22879;146227;80777;164;27132;6645;84166;729264;4324;440387;57687;51673;267;84342;124045;54768;161882;4496;22980;146167;1003;81533;65009;2653;2806;55336;50855;85407;23035;283848;4495;55159;55238;115992;4597;181;123775;51741;100131303;64127;57017;1504;794;583;339145;23563;23644;79801;388272;57567;497190;7084;5432;999;23536;6553;84138;85445;123872;653319;283971;83449;8824;333929;1728;1071;64282;113540;80004;92822;51388;9688;80152;863;4504;123904;9114;4166;23199;1001;1723;79918;55239;6530;124460;4493;55715;11051;1066;8558;83657;55839;9780;766;53630;51192;23450;1506;3240;10664;57610;80011;55697;57707;440348;8996;23300;57215;23491;9785;6687;118460;4494;9100;29070;3931;2734;58189;29123;55783,370
1,-1,16,31994667,90294753,58300086,64785;1258;4490;6361;92154;23594;84560;6560;84752;25839;2300;763;197320;64779;92922;57019;146212;7571;1535;79007;124044;8720;51090;79786;114780;7567;4157;79583;10164;1540;84290;10725;1012;11345;643911;23568;27324;79567;9289;55282;729159;2775;27189;653550;197258;57338;23417;92806;221188;146198;85320;123970;146429;5934;57546;113;9764;388289;3281;8883;170692;10265;9709;55815;24150;54386;10328;4501;197259;51659;124491;3801;10204;374739;81831;16;123920;1013;1014;9057;8717;84706;55512;643802;2294;5681;81631;6483;93517;79190;80262;54957;10143;161931;94160;1459;91862;4775;27183;89970;9605;2303;6236;1006;10294;124359;100506581;23322;51647;64180;83693;29100;54550;4094;79650;9013;83716;388282;1327;5257;91807;84916;390748;29800;55737;6559;79767;348174;9798;54758;146456;55027;28987;23174;29948;1874;80205;26231;100287036;3250;463;80790;84229;100129697;342371;729355;8139;5713;348180;283847;84080;221191;54921;81620;54849;5119;869;55625;7014;10300;55794;55565;197322;3038;2588;29117;3299;55308;65057;100130958;54971;2175;23090;221184;6299;11269;162239;10200;3291;4502;388284;146433;84501;146223;84627;283849;10381;5699;64400;10428;1800;54920;1783;11060;4489;56942;23019;865;11105;255919;23659;79191;54496;51693;64146;1009;100529251;388276;9914;29109;79152;5336;25894;197257;404550;283927;79791;3294;353;64174;6477;146225;81577;2622;8140;6137;93107;29105;222487;342372;84937;146206;4313;83752;3735;79613;54947;4499;6898;6367;124245;9683;55066;23406;221223;79726;79068;9564;6376;3394;22879;146227;80777;164;27132;6645;84166;729264;4324;440387;57687;51673;267;84342;124045;54768;161882;4496;22980;146167;1003;81533;65009;2653;2806;55336;50855;85407;23035;283848;4495;55159;55238;115992;4597;181;123775;51741;100131303;64127;57017;1504;794;583;339145;23563;23644;79801;388272;57567;497190;7084;5432;999;23536;6553;84138;85445;123872;653319;283971;83449;8824;333929;1728;1071;64282;113540;80004;92822;51388;9688;80152;863;4504;123904;9114;4166;23199;1001;1723;79918;55239;6530;124460;4493;55715;11051;1066;8558;83657;55839;9780;766;53630;51192;23450;1506;3240;10664;57610;80011;55697;57707;440348;8996;23300;57215;23491;9785;6687;118460;4494;9100;29070;3931;2734;58189;29123;55783,370
-1,-1,16,32051494,33654328,1602834,653550;729264;24150;729355,4
-1,-1,16,32066967,32573867,506900,729264,1
-1,-1,16,32066967,33465560,1398593,653550;729264;24150;729355,4
1,-1,16,32066967,33773134,1706167,653550;729264;24150;729355,4
1,-1,16,32143401,33827494,1684093,653550;729264;24150;729355,4
1,-1,16,32300741,33773134,1472393,653550;24150;729355,3
1,-1,16,32440875,33853445,1412570,653550;24150;729355,3
1,-1,16,32440875,90294753,57853878,64785;1258;4490;6361;92154;23594;84560;6560;84752;25839;2300;763;197320;64779;92922;57019;146212;7571;1535;79007;124044;8720;51090;79786;114780;7567;4157;79583;10164;1540;84290;10725;1012;11345;643911;23568;27324;79567;9289;55282;729159;2775;27189;653550;197258;57338;23417;92806;221188;146198;85320;123970;146429;5934;57546;113;9764;388289;3281;8883;170692;10265;9709;55815;24150;54386;10328;4501;197259;51659;124491;3801;10204;374739;81831;16;123920;1013;1014;9057;8717;84706;55512;643802;2294;5681;81631;6483;93517;79190;80262;54957;10143;161931;94160;1459;91862;4775;27183;89970;9605;2303;6236;1006;10294;124359;100506581;23322;51647;64180;83693;29100;54550;4094;79650;9013;83716;388282;1327;5257;91807;84916;390748;29800;55737;6559;79767;348174;9798;54758;146456;55027;28987;23174;29948;1874;80205;26231;100287036;3250;463;80790;84229;100129697;342371;729355;8139;5713;348180;283847;84080;221191;54921;81620;54849;5119;869;55625;7014;10300;55794;55565;197322;3038;2588;29117;3299;55308;65057;100130958;54971;2175;23090;221184;6299;11269;162239;10200;3291;4502;388284;146433;84501;146223;84627;283849;10381;5699;64400;10428;1800;54920;1783;11060;4489;56942;23019;865;11105;255919;23659;79191;54496;51693;64146;1009;100529251;388276;9914;29109;79152;5336;25894;197257;404550;283927;79791;3294;353;64174;6477;146225;81577;2622;8140;6137;93107;29105;222487;342372;84937;146206;4313;83752;3735;79613;54947;4499;6898;6367;124245;9683;55066;23406;221223;79726;79068;9564;6376;3394;22879;146227;80777;164;27132;6645;84166;4324;440387;57687;51673;267;84342;124045;54768;161882;4496;22980;146167;1003;81533;65009;2653;2806;55336;50855;85407;23035;283848;4495;55159;55238;115992;4597;181;123775;51741;100131303;64127;57017;1504;794;583;339145;23563;23644;79801;388272;57567;497190;7084;5432;999;23536;6553;84138;85445;123872;653319;283971;83449;8824;333929;1728;1071;64282;113540;80004;92822;51388;9688;80152;863;4504;123904;9114;4166;23199;1001;1723;79918;55239;6530;124460;4493;55715;11051;1066;8558;83657;55839;9780;766;53630;51192;23450;1506;3240;10664;57610;80011;55697;57707;440348;8996;23300;57215;23491;9785;6687;118460;4494;9100;29070;3931;2734;58189;29123;55783,369
1,-1,16,32470624,33798382,1327758,653550;24150;729355,3
1,-1,16,32470624,33924190,1453566,653550;24150;729355,3
-1,-1,16,32470625,33773134,1302509,653550;24150;729355,3
-1,-1,16,32470655,32637879,167224,,0
-1,-1,16,32470655,33298169,827514,653550;24150;729355,3
1,-1,16,32486838,33853445,1366607,653550;24150;729355,3
1,-1,16,32486838,34179903,1693065,653550;24150;729355,3
-1,-1,16,32486849,32654347,167498,,0
1,-1,16,32486849,33785709,1298860,653550;24150;729355,3
1,-1,16,32491714,33299481,807767,653550;24150;729355,3
1,-1,16,32491714,33786268,1294554,653550;24150;729355,3
-1,-1,16,32573813,32833950,260137,24150,1
1,-1,16,32676790,33780444,1103654,653550;24150;729355,3
1,-1,16,32573813,33786268,1212455,653550;24150;729355,3
1,-1,16,32573813,33786268,1212455,653550;24150;729355,3
1,-1,16,32676790,33798382,1121592,653550;24150;729355,3
1,-1,16,32676790,33798382,1121592,653550;24150;729355,3
1,-1,16,32573813,33798382,1224569,653550;24150;729355,3
1,-1,16,32676790,33853445,1176655,653550;24150;729355,3
1,-1,16,32676790,33923118,1246328,653550;24150;729355,3
1,-1,16,32676790,33924190,1247400,653550;24150;729355,3
1,-1,16,32573813,32746843,173030,24150,1
1,-1,16,32573813,90294753,57720940,64785;1258;4490;6361;92154;23594;84560;6560;84752;25839;2300;763;197320;64779;92922;57019;146212;7571;1535;79007;124044;8720;51090;79786;114780;7567;4157;79583;10164;1540;84290;10725;1012;11345;643911;23568;27324;79567;9289;55282;729159;2775;27189;653550;197258;57338;23417;92806;221188;146198;85320;123970;146429;5934;57546;113;9764;388289;3281;8883;170692;10265;9709;55815;24150;54386;10328;4501;197259;51659;124491;3801;10204;374739;81831;16;123920;1013;1014;9057;8717;84706;55512;643802;2294;5681;81631;6483;93517;79190;80262;54957;10143;161931;94160;1459;91862;4775;27183;89970;9605;2303;6236;1006;10294;124359;100506581;23322;51647;64180;83693;29100;54550;4094;79650;9013;83716;388282;1327;5257;91807;84916;390748;29800;55737;6559;79767;348174;9798;54758;146456;55027;28987;23174;29948;1874;80205;26231;100287036;3250;463;80790;84229;100129697;342371;729355;8139;5713;348180;283847;84080;221191;54921;81620;54849;5119;869;55625;7014;10300;55794;55565;197322;3038;2588;29117;3299;55308;65057;100130958;54971;2175;23090;221184;6299;11269;162239;10200;3291;4502;388284;146433;84501;146223;84627;283849;10381;5699;64400;10428;1800;54920;1783;11060;4489;56942;23019;865;11105;255919;23659;79191;54496;51693;64146;1009;100529251;388276;9914;29109;79152;5336;25894;197257;404550;283927;79791;3294;353;64174;6477;146225;81577;2622;8140;6137;93107;29105;222487;342372;84937;146206;4313;83752;3735;79613;54947;4499;6898;6367;124245;9683;55066;23406;221223;79726;79068;9564;6376;3394;22879;146227;80777;164;27132;6645;84166;4324;440387;57687;51673;267;84342;124045;54768;161882;4496;22980;146167;1003;81533;65009;2653;2806;55336;50855;85407;23035;283848;4495;55159;55238;115992;4597;181;123775;51741;100131303;64127;57017;1504;794;583;339145;23563;23644;79801;388272;57567;497190;7084;5432;999;23536;6553;84138;85445;123872;653319;283971;83449;8824;333929;1728;1071;64282;113540;80004;92822;51388;9688;80152;863;4504;123904;9114;4166;23199;1001;1723;79918;55239;6530;124460;4493;55715;11051;1066;8558;83657;55839;9780;766;53630;51192;23450;1506;3240;10664;57610;80011;55697;57707;440348;8996;23300;57215;23491;9785;6687;118460;4494;9100;29070;3931;2734;58189;29123;55783,369
1,-1,16,32573813,90294753,57720940,64785;1258;4490;6361;92154;23594;84560;6560;84752;25839;2300;763;197320;64779;92922;57019;146212;7571;1535;79007;124044;8720;51090;79786;114780;7567;4157;79583;10164;1540;84290;10725;1012;11345;643911;23568;27324;79567;9289;55282;729159;2775;27189;653550;197258;57338;23417;92806;221188;146198;85320;123970;146429;5934;57546;113;9764;388289;3281;8883;170692;10265;9709;55815;24150;54386;10328;4501;197259;51659;124491;3801;10204;374739;81831;16;123920;1013;1014;9057;8717;84706;55512;643802;2294;5681;81631;6483;93517;79190;80262;54957;10143;161931;94160;1459;91862;4775;27183;89970;9605;2303;6236;1006;10294;124359;100506581;23322;51647;64180;83693;29100;54550;4094;79650;9013;83716;388282;1327;5257;91807;84916;390748;29800;55737;6559;79767;348174;9798;54758;146456;55027;28987;23174;29948;1874;80205;26231;100287036;3250;463;80790;84229;100129697;342371;729355;8139;5713;348180;283847;84080;221191;54921;81620;54849;5119;869;55625;7014;10300;55794;55565;197322;3038;2588;29117;3299;55308;65057;100130958;54971;2175;23090;221184;6299;11269;162239;10200;3291;4502;388284;146433;84501;146223;84627;283849;10381;5699;64400;10428;1800;54920;1783;11060;4489;56942;23019;865;11105;255919;23659;79191;54496;51693;64146;1009;100529251;388276;9914;29109;79152;5336;25894;197257;404550;283927;79791;3294;353;64174;6477;146225;81577;2622;8140;6137;93107;29105;222487;342372;84937;146206;4313;83752;3735;79613;54947;4499;6898;6367;124245;9683;55066;23406;221223;79726;79068;9564;6376;3394;22879;146227;80777;164;27132;6645;84166;4324;440387;57687;51673;267;84342;124045;54768;161882;4496;22980;146167;1003;81533;65009;2653;2806;55336;50855;85407;23035;283848;4495;55159;55238;115992;4597;181;123775;51741;100131303;64127;57017;1504;794;583;339145;23563;23644;79801;388272;57567;497190;7084;5432;999;23536;6553;84138;85445;123872;653319;283971;83449;8824;333929;1728;1071;64282;113540;80004;92822;51388;9688;80152;863;4504;123904;9114;4166;23199;1001;1723;79918;55239;6530;124460;4493;55715;11051;1066;8558;83657;55839;9780;766;53630;51192;23450;1506;3240;10664;57610;80011;55697;57707;440348;8996;23300;57215;23491;9785;6687;118460;4494;9100;29070;3931;2734;58189;29123;55783,369
1,-1,16,32621995,90294753,57672758,64785;1258;4490;6361;92154;23594;84560;6560;84752;25839;2300;763;197320;64779;92922;57019;146212;7571;1535;79007;124044;8720;51090;79786;114780;7567;4157;79583;10164;1540;84290;10725;1012;11345;643911;23568;27324;79567;9289;55282;729159;2775;27189;653550;197258;57338;23417;92806;221188;146198;85320;123970;146429;5934;57546;113;9764;388289;3281;8883;170692;10265;9709;55815;24150;54386;10328;4501;197259;51659;124491;3801;10204;374739;81831;16;123920;1013;1014;9057;8717;84706;55512;643802;2294;5681;81631;6483;93517;79190;80262;54957;10143;161931;94160;1459;91862;4775;27183;89970;9605;2303;6236;1006;10294;124359;100506581;23322;51647;64180;83693;29100;54550;4094;79650;9013;83716;388282;1327;5257;91807;84916;390748;29800;55737;6559;79767;348174;9798;54758;146456;55027;28987;23174;29948;1874;80205;26231;100287036;3250;463;80790;84229;100129697;342371;729355;8139;5713;348180;283847;84080;221191;54921;81620;54849;5119;869;55625;7014;10300;55794;55565;197322;3038;2588;29117;3299;55308;65057;100130958;54971;2175;23090;221184;6299;11269;162239;10200;3291;4502;388284;146433;84501;146223;84627;283849;10381;5699;64400;10428;1800;54920;1783;11060;4489;56942;23019;865;11105;255919;23659;79191;54496;51693;64146;1009;100529251;388276;9914;29109;79152;5336;25894;197257;404550;283927;79791;3294;353;64174;6477;146225;81577;2622;8140;6137;93107;29105;222487;342372;84937;146206;4313;83752;3735;79613;54947;4499;6898;6367;124245;9683;55066;23406;221223;79726;79068;9564;6376;3394;22879;146227;80777;164;27132;6645;84166;4324;440387;57687;51673;267;84342;124045;54768;161882;4496;22980;146167;1003;81533;65009;2653;2806;55336;50855;85407;23035;283848;4495;55159;55238;115992;4597;181;123775;51741;100131303;64127;57017;1504;794;583;339145;23563;23644;79801;388272;57567;497190;7084;5432;999;23536;6553;84138;85445;123872;653319;283971;83449;8824;333929;1728;1071;64282;113540;80004;92822;51388;9688;80152;863;4504;123904;9114;4166;23199;1001;1723;79918;55239;6530;124460;4493;55715;11051;1066;8558;83657;55839;9780;766;53630;51192;23450;1506;3240;10664;57610;80011;55697;57707;440348;8996;23300;57215;23491;9785;6687;118460;4494;9100;29070;3931;2734;58189;29123;55783,369
-1,-1,16,32651055,33654328,1003273,653550;24150;729355,3
1,-1,16,32654316,33853445,1199129,653550;24150;729355,3
1,-1,16,32676790,33798382,1121592,653550;24150;729355,3
1,-1,16,32722515,33853445,1130930,653550;729355,2
-1,-1,16,32890035,33465531,575496,653550;729355,2
1,-1,16,32892940,33781506,888566,653550;729355,2
1,-1,16,32894346,33781506,887160,653550;729355,2
1,-1,16,32894346,33781506,887160,653550;729355,2
1,-1,16,32894346,33781506,887160,653550;729355,2
1,-1,16,32894346,33781506,887160,653550;729355,2
1,-1,16,32894888,33780444,885556,653550;729355,2
1,-1,16,32894888,33780444,885556,653550;729355,2
1,-1,16,32894888,33780444,885556,653550;729355,2
1,-1,16,32894888,33780990,886102,653550;729355,2
1,-1,16,32894888,33781281,886393,653550;729355,2
1,-1,16,32894888,33781506,886618,653550;729355,2
1,-1,16,32894888,33781506,886618,653550;729355,2
1,-1,16,32894888,33781506,886618,653550;729355,2
1,-1,16,32894888,33781506,886618,653550;729355,2
1,-1,16,32895593,33779735,884142,653550;729355,2
1,-1,16,32895593,33780125,884532,653550;729355,2
1,-1,16,32895807,33779518,883711,653550;729355,2
1,-1,16,32895807,33780125,884318,653550;729355,2
1,-1,16,32993227,33779518,786291,653550;729355,2
1,-1,16,33107015,33620020,513005,653550;729355,2
-1,-1,16,33380842,33633240,252398,,0
1,-1,16,33373287,33444401,71114,,0
-1,-1,16,33444401,33654328,209927,,0
1,1,16,34197492,64509054,30311562,643802;64785;2806;1258;4490;6361;85407;23594;79190;4489;4495;84560;23019;55238;255919;64127;92922;79191;57019;57017;94160;1459;583;388276;51090;79801;388272;89970;57567;1006;10294;23322;1540;5432;84290;6477;643911;23568;79650;27324;9289;729159;29105;2775;222487;388282;1071;5257;64282;91807;4313;83752;9688;55737;6559;221188;85320;55027;4504;123970;54947;4499;6367;5934;113;55239;6530;9683;79918;124460;80205;4493;55715;10265;221223;84229;11051;79068;9709;1066;6376;221191;869;4501;84166;10300;80011;4324;267;3801;29117;81831;374739;23090;4494;221184;6299;29070;4496;4502;84706;64400;81533;65009,104
1,-1,16,34427859,34682448,254589,,0
1,-1,16,34427916,34727365,299449,,0
1,-1,16,34427916,34727365,299449,,0
1,-1,16,34481842,34727492,245650,,0
1,-1,16,34482042,34682448,200406,,0
1,-1,16,34482042,34727349,245307,,0
1,-1,16,34482042,34727349,245307,,0
1,-1,16,34482042,34727349,245307,,0
1,-1,16,34482042,34727349,245307,,0
1,-1,16,34482042,34727349,245307,,0
1,-1,16,34482042,34727349,245307,,0
1,-1,16,34482042,34727349,245307,,0
1,-1,16,34482072,34727321,245249,,0
1,-1,16,34482072,34727365,245293,,0
1,-1,16,34482072,34727365,245293,,0
1,-1,16,34482072,34727365,245293,,0
1,-1,16,34482072,34727365,245293,,0
1,-1,16,34482072,34727365,245293,,0
1,-1,16,34482072,34727365,245293,,0
1,-1,16,34482072,34727365,245293,,0
1,-1,16,34482072,34727365,245293,,0
1,-1,16,34482072,34727365,245293,,0
1,-1,16,34482072,34727365,245293,,0
1,-1,16,34482072,34727365,245293,,0
1,-1,16,34482072,34727365,245293,,0
1,-1,16,34482072,34727365,245293,,0
1,-1,16,34482072,34727365,245293,,0
1,-1,16,34482072,34727365,245293,,0
1,-1,16,34482072,34727365,245293,,0
1,-1,16,34482072,34727365,245293,,0
1,-1,16,34482072,34727365,245293,,0
-1,-1,16,34482072,34727365,245293,,0
1,-1,16,34482072,34727365,245293,,0
1,-1,16,34482072,34727365,245293,,0
1,-1,16,34482072,34727365,245293,,0
1,-1,16,34482072,34727365,245293,,0
1,-1,16,34482072,34727365,245293,,0
1,-1,16,34482072,34727365,245293,,0
1,-1,16,34482072,34727365,245293,,0
-1,-1,16,34482072,34727365,245293,,0
1,-1,16,34482072,34727365,245293,,0
1,-1,16,34482072,34727365,245293,,0
1,-1,16,34482072,34727365,245293,,0
1,-1,16,34482072,34727365,245293,,0
1,-1,16,34482072,34727365,245293,,0
1,-1,16,34482072,34727365,245293,,0
1,-1,16,34482072,34727365,245293,,0
1,-1,16,34482072,34727365,245293,,0
1,-1,16,34482072,34727365,245293,,0
1,-1,16,34482072,34727365,245293,,0
1,-1,16,34482072,34727365,245293,,0
1,-1,16,34482072,34727365,245293,,0
1,-1,16,34482072,34727365,245293,,0
1,-1,16,34482072,34727365,245293,,0
1,-1,16,34482072,34727365,245293,,0
1,-1,16,34482072,34727365,245293,,0
1,-1,16,34482072,34727365,245293,,0
1,-1,16,34482072,34727365,245293,,0
1,-1,16,34482072,34727365,245293,,0
1,-1,16,34482072,34727365,245293,,0
1,-1,16,34482072,34727365,245293,,0
1,-1,16,34482072,34727365,245293,,0
1,-1,16,34482072,34727365,245293,,0
1,-1,16,34482072,34727365,245293,,0
1,-1,16,34482072,34727365,245293,,0
1,-1,16,34482072,34727365,245293,,0
1,-1,16,34482072,34727365,245293,,0
1,-1,16,34482072,34727365,245293,,0
1,-1,16,34482072,34727365,245293,,0
1,-1,16,34482072,34727365,245293,,0
1,-1,16,34482072,34727365,245293,,0
1,-1,16,34482072,34727365,245293,,0
1,-1,16,34482072,34727365,245293,,0
1,-1,16,34482072,34727365,245293,,0
1,-1,16,34482072,34727365,245293,,0
1,-1,16,34482072,34727365,245293,,0
1,-1,16,34482072,34727365,245293,,0
1,-1,16,34482072,34727531,245459,,0
1,-1,16,34517838,34701953,184115,,0
1,-1,16,34539683,34609385,69702,,0
1,-1,16,34625151,34747559,122408,,0
-1,-1,16,35020750,35039170,18420,,0
1,-1,16,35020750,35068935,48185,,0
1,1,16,46464488,90155062,43690574,64785;1258;4490;6361;92154;23594;84560;6560;84752;25839;2300;763;197320;64779;92922;57019;146212;7571;1535;79007;124044;8720;51090;79786;114780;7567;4157;79583;10164;1540;84290;10725;1012;11345;643911;23568;27324;79567;9289;55282;729159;2775;27189;197258;57338;23417;92806;221188;146198;85320;123970;146429;5934;57546;113;9764;388289;3281;8883;170692;10265;9709;55815;54386;10328;4501;197259;51659;124491;3801;10204;374739;81831;16;123920;1013;1014;9057;8717;84706;55512;643802;2294;5681;81631;6483;93517;79190;80262;54957;10143;161931;94160;1459;91862;4775;27183;89970;9605;2303;6236;1006;10294;124359;100506581;23322;51647;64180;83693;29100;54550;4094;79650;9013;83716;388282;1327;5257;91807;84916;390748;29800;55737;6559;79767;348174;9798;54758;146456;55027;28987;23174;29948;1874;80205;26231;100287036;3250;463;80790;84229;100129697;342371;348180;8139;5713;283847;84080;221191;54921;81620;54849;5119;869;55625;7014;10300;55794;55565;197322;3038;2588;29117;3299;55308;65057;100130958;54971;2175;23090;221184;6299;11269;162239;10200;3291;4502;388284;146433;84501;146223;84627;283849;10381;5699;64400;10428;1800;54920;1783;11060;4489;56942;23019;865;11105;255919;23659;79191;54496;51693;64146;1009;100529251;388276;9914;29109;79152;5336;25894;197257;404550;283927;79791;3294;353;64174;6477;146225;81577;2622;8140;6137;93107;29105;222487;342372;84937;146206;4313;83752;3735;79613;54947;4499;6898;6367;124245;9683;55066;23406;221223;79726;79068;9564;6376;3394;22879;146227;80777;164;27132;6645;84166;4324;440387;57687;51673;267;84342;124045;54768;161882;4496;22980;146167;1003;81533;65009;2653;2806;55336;50855;85407;23035;283848;4495;55159;55238;115992;4597;181;123775;51741;100131303;64127;57017;1504;794;583;339145;23563;23644;79801;388272;57567;497190;7084;5432;999;23536;6553;84138;85445;123872;653319;283971;83449;8824;333929;1728;1071;64282;113540;80004;92822;51388;9688;80152;863;4504;123904;9114;4166;23199;1001;1723;79918;55239;6530;124460;4493;55715;11051;1066;8558;83657;55839;9780;766;53630;51192;23450;1506;3240;10664;57610;80011;55697;57707;440348;8996;23300;57215;23491;9785;6687;118460;4494;9100;29070;3931;2734;58189;29123;55783,366
1,1,16,46500741,52389705,5888964,85320;55027;85407;1540;23594;123970;6477;255919;113;29117;81831;64127;9683;124460;94160;23090;6299;388276;5257;64282;79801;388272;84706;91807;81533;83752;55737;10294;869,29
-1,1,16,46500741,52456082,5955341,85320;55027;85407;1540;23594;123970;6477;255919;113;29117;81831;64127;9683;124460;94160;23090;6299;388276;5257;64282;79801;388272;84706;91807;81533;83752;55737;10294;869,29
-1,1,16,46737110,51838691,5101581,85320;55027;85407;1540;123970;6477;255919;113;29117;81831;64127;9683;124460;94160;23090;6299;5257;64282;388272;91807;84706;81533;83752;10294;869,25
-1,1,16,49604464,53500977,3896513,643802;55027;85407;1540;5934;255919;113;29117;27324;64127;124460;80205;23090;6299;388276;64282,16
1,1,16,49719432,68435615,18716183,64785;54920;1258;4490;6361;1783;4489;84560;23019;865;84752;6560;255919;92922;79191;57019;146212;23659;54496;1009;388276;100529251;51090;29109;25894;64174;1540;84290;643911;146225;81577;23568;27324;79567;9289;729159;29105;2775;55282;222487;146206;4313;221188;54947;4499;6367;5934;57546;113;8883;10265;221223;79068;9709;55815;6376;146227;4501;84166;4324;51673;267;3801;10204;374739;123920;1014;9057;8717;4496;1003;65009;643802;2806;55336;55512;50855;5681;85407;79190;283848;80262;4495;55238;181;100131303;64127;57017;1459;583;23644;4775;89970;57567;7084;1006;6236;23322;51647;5432;64180;6553;29100;84138;79650;653319;8824;388282;1071;64282;113540;80004;9688;79767;6559;29800;80152;55027;4504;123904;9114;55239;6530;79918;1874;124460;80205;4493;26231;55715;84229;11051;1066;283847;766;221191;84080;51192;1506;10300;10664;80011;57610;55794;8996;57215;29117;23491;3299;65057;23090;4494;221184;6299;29070;4502;146223;283849;64400;3291;388284;3931;5699,163
1,1,16,52933095,90155062,37221967,64785;1258;4490;6361;92154;84560;6560;84752;25839;2300;763;197320;64779;92922;57019;146212;7571;1535;79007;124044;8720;51090;79786;114780;7567;4157;79583;10164;84290;10725;1012;11345;643911;23568;79567;9289;55282;729159;2775;27189;197258;57338;23417;92806;221188;146198;146429;5934;57546;9764;388289;3281;8883;170692;10265;9709;55815;54386;10328;4501;197259;51659;124491;3801;10204;374739;16;123920;1013;1014;9057;8717;55512;643802;2294;5681;81631;6483;93517;79190;80262;54957;10143;161931;1459;91862;4775;27183;89970;9605;2303;6236;1006;124359;100506581;23322;51647;64180;83693;29100;54550;4094;79650;9013;83716;388282;1327;84916;390748;29800;79767;6559;348174;9798;54758;146456;28987;23174;29948;1874;80205;26231;100287036;3250;463;80790;84229;100129697;342371;348180;8139;5713;283847;84080;221191;54921;81620;54849;5119;55625;7014;10300;55794;55565;197322;3038;2588;3299;55308;65057;100130958;54971;2175;221184;11269;162239;10200;3291;4502;388284;146433;84501;146223;84627;283849;10381;5699;64400;10428;1800;54920;1783;11060;4489;56942;23019;865;11105;23659;79191;54496;51693;64146;1009;100529251;9914;29109;79152;5336;25894;197257;404550;283927;79791;3294;353;64174;146225;81577;2622;8140;6137;93107;29105;222487;342372;84937;146206;4313;3735;79613;54947;4499;6898;6367;124245;55066;23406;221223;79726;79068;9564;6376;3394;22879;146227;80777;164;27132;6645;84166;4324;440387;57687;51673;267;84342;124045;54768;161882;4496;22980;146167;1003;65009;2653;2806;55336;50855;23035;283848;4495;55159;55238;115992;4597;181;123775;51741;100131303;57017;1504;794;583;339145;23563;23644;57567;497190;7084;5432;999;23536;6553;84138;85445;123872;653319;283971;83449;8824;333929;1728;1071;113540;80004;92822;51388;9688;80152;863;4504;123904;9114;4166;23199;1001;1723;79918;55239;6530;4493;55715;11051;1066;8558;83657;55839;9780;766;53630;51192;23450;1506;3240;10664;57610;80011;55697;57707;440348;8996;23300;57215;23491;9785;6687;118460;4494;9100;29070;3931;2734;58189;29123;55783,336
-1,1,16,55491389,63875526,8384137,64785;2806;1258;4490;6361;4489;4495;84560;23019;55238;92922;57017;57019;1459;583;51090;89970;57567;1006;5432;84290;23568;79650;9289;729159;29105;2775;222487;388282;1071;4313;9688;6559;221188;4504;54947;4499;6367;55239;6530;79918;4493;55715;84229;221223;11051;1066;9709;6376;221191;4501;84166;10300;80011;4324;267;3801;374739;4494;221184;29070;4502;4496;65009,64
-1,1,16,55491389,63875526,8384137,64785;2806;1258;4490;6361;4489;4495;84560;23019;55238;92922;57017;57019;1459;583;51090;89970;57567;1006;5432;84290;23568;79650;9289;729159;29105;2775;222487;388282;1071;4313;9688;6559;221188;4504;54947;4499;6367;55239;6530;79918;4493;55715;84229;221223;11051;1066;9709;6376;221191;4501;84166;10300;80011;4324;267;3801;374739;4494;221184;29070;4502;4496;65009,64
1,1,16,57051473,89797669,32746196,64785;1258;6361;92154;6560;84752;25839;2300;763;197320;92922;64779;57019;146212;7571;1535;124044;8720;51090;79786;114780;7567;79583;10164;10725;1012;11345;23568;79567;55282;9289;729159;27189;197258;57338;23417;221188;146198;57546;146429;9764;388289;3281;8883;170692;55815;54386;10328;197259;51659;124491;3801;10204;374739;16;123920;1014;1013;9057;8717;55512;2294;5681;6483;81631;93517;80262;54957;10143;161931;1459;91862;4775;27183;89970;9605;2303;6236;1006;124359;100506581;51647;64180;83693;29100;54550;4094;79650;9013;83716;388282;1327;84916;390748;79767;29800;348174;9798;54758;146456;28987;23174;29948;1874;26231;463;100287036;3250;80790;84229;100129697;342371;348180;8139;5713;283847;84080;5119;221191;54921;81620;7014;10300;55625;29123;55794;55565;197322;3038;2588;3299;55308;65057;100130958;54971;221184;11269;162239;10200;3291;146223;388284;283849;146433;84627;1800;10428;5699;54920;1783;11060;56942;23019;865;23659;54496;51693;64146;1009;100529251;9914;29109;79152;25894;5336;197257;404550;283927;79791;3294;353;64174;146225;81577;8140;6137;93107;29105;222487;342372;84937;146206;3735;79613;6898;6367;124245;55066;23406;79726;9564;6376;3394;146227;22879;80777;164;27132;84166;6645;4324;440387;57687;51673;84342;54768;146167;161882;1003;124045;65009;2653;2806;55336;50855;23035;283848;55159;55238;181;123775;4597;115992;51741;100131303;57017;794;1504;23563;339145;23644;57567;7084;497190;5432;999;23536;6553;84138;85445;123872;653319;283971;83449;8824;1728;333929;113540;80004;92822;51388;80152;863;123904;9114;4166;23199;1001;1723;79918;55715;83657;55839;9780;766;53630;51192;1506;23450;3240;10664;80011;57610;55697;57707;440348;8996;23300;57215;23491;9785;118460;6687;9100;29070;3931;2734;58189;8558;55783,290
-1,-1,16,60419108,60942833,523725,,0
1,1,16,62959833,84619401,21659568,54920;92154;1783;11060;56942;6560;865;84752;25839;23659;146212;54496;7571;64146;1009;100529251;9914;8720;29109;79152;25894;5336;197257;114780;7567;79583;283927;3294;10164;64174;10725;1012;11345;146225;81577;79567;55282;93107;197258;23417;342372;84937;146206;3735;146198;79613;6898;57546;388289;3281;8883;55066;170692;23406;79726;9564;55815;146227;54386;80777;22879;164;6645;197259;10428;440387;57687;124491;51673;10204;84342;16;123920;1014;9057;54768;146167;8717;1003;2653;55512;55336;50855;5681;6483;93517;23035;283848;80262;55159;54957;181;123775;51741;100131303;10143;161931;794;1504;91862;23563;23644;4775;27183;6236;7084;497190;124359;51647;64180;999;23536;83693;6553;29100;84138;54550;85445;4094;123872;653319;9013;283971;83449;8824;1728;113540;80004;84916;51388;29800;79767;348174;9798;80152;146456;28987;123904;9114;29948;4166;1001;1723;1874;26231;463;3250;80790;342371;83657;8139;5713;55839;766;283847;84080;54921;51192;1506;23450;53630;7014;3240;10664;57610;55794;55697;55565;57707;440348;3038;8996;23300;57215;23491;3299;55308;65057;9785;118460;100130958;11269;162239;10200;3291;146223;388284;283849;3931;146433;2734;58189;5699;55783,194
-1,-1,16,63466967,63573954,106987,,0
1,1,16,64423281,90148393,25725112,92154;6560;84752;25839;2300;763;197320;64779;146212;7571;1535;79007;124044;8720;79786;114780;7567;4157;79583;10164;10725;1012;11345;79567;55282;27189;197258;57338;23417;92806;146198;57546;146429;9764;388289;3281;8883;170692;55815;54386;10328;197259;51659;124491;10204;16;123920;1014;1013;9057;8717;55512;2294;5681;6483;81631;93517;80262;54957;10143;161931;91862;4775;27183;9605;2303;6236;124359;100506581;51647;64180;83693;29100;54550;4094;9013;83716;1327;84916;390748;29800;79767;348174;9798;54758;146456;28987;23174;29948;1874;26231;463;100287036;3250;80790;100129697;342371;348180;8139;5713;283847;84080;81620;54921;5119;54849;7014;55625;29123;55794;55565;197322;3038;2588;3299;55308;65057;100130958;54971;2175;11269;162239;10200;84501;3291;146223;388284;283849;146433;84627;10381;1800;10428;5699;54920;1783;11060;56942;11105;865;23659;54496;51693;64146;1009;100529251;9914;29109;79152;25894;5336;197257;404550;283927;79791;3294;353;64174;146225;81577;2622;8140;6137;93107;342372;84937;146206;3735;79613;6898;124245;55066;23406;79726;9564;3394;146227;22879;80777;164;27132;6645;440387;57687;51673;84342;54768;146167;161882;1003;124045;22980;2653;55336;50855;23035;283848;55159;181;123775;4597;115992;51741;100131303;794;1504;23563;339145;23644;7084;497190;999;23536;6553;84138;85445;123872;653319;283971;83449;8824;1728;333929;113540;80004;92822;51388;80152;863;123904;9114;4166;23199;1001;1723;83657;55839;9780;766;53630;51192;1506;23450;3240;10664;57610;55697;57707;440348;8996;23300;57215;23491;9785;118460;6687;9100;3931;2734;58189;8558;55783,262
1,1,16,65545386,90163403,24618017,92154;6560;84752;25839;2300;763;197320;64779;146212;7571;1535;79007;124044;8720;79786;114780;7567;4157;79583;10164;10725;1012;11345;79567;55282;27189;197258;57338;23417;92806;146198;57546;146429;9764;388289;3281;8883;170692;55815;54386;10328;197259;51659;124491;10204;16;123920;1014;1013;9057;8717;55512;2294;5681;6483;81631;93517;80262;54957;10143;161931;91862;4775;27183;9605;2303;6236;124359;100506581;51647;64180;83693;29100;54550;4094;9013;83716;1327;84916;390748;29800;79767;348174;9798;54758;146456;28987;23174;29948;1874;26231;463;100287036;3250;80790;100129697;342371;348180;8139;5713;283847;84080;81620;54921;5119;54849;7014;55625;29123;55794;55565;197322;3038;2588;3299;55308;65057;100130958;54971;2175;11269;162239;10200;84501;3291;146223;388284;283849;146433;84627;10381;1800;10428;5699;54920;1783;11060;56942;11105;865;23659;54496;51693;64146;100529251;9914;29109;79152;25894;5336;197257;404550;283927;79791;3294;353;64174;146225;81577;2622;8140;6137;93107;342372;84937;146206;3735;79613;6898;124245;55066;23406;79726;9564;3394;146227;22879;80777;164;27132;6645;440387;57687;51673;84342;54768;146167;161882;1003;124045;22980;2653;55336;50855;23035;283848;55159;181;123775;4597;115992;51741;100131303;794;1504;23563;339145;23644;7084;497190;999;23536;6553;84138;85445;123872;653319;283971;83449;8824;1728;333929;113540;80004;92822;51388;80152;863;123904;9114;4166;23199;1001;1723;83657;55839;9780;766;53630;51192;1506;23450;3240;10664;57610;55697;57707;440348;8996;23300;57215;23491;9785;118460;6687;9100;3931;2734;58189;8558;55783,261
1,1,16,65991732,83645048,17653316,54920;92154;1783;11060;56942;6560;865;84752;25839;23659;146212;54496;7571;64146;100529251;29109;79152;25894;5336;197257;114780;7567;79583;283927;3294;10164;64174;10725;1012;11345;146225;81577;79567;55282;197258;342372;84937;146206;3735;146198;79613;6898;57546;388289;8883;55066;170692;79726;9564;55815;146227;54386;80777;22879;164;6645;197259;10428;440387;57687;124491;51673;10204;84342;16;123920;1014;9057;54768;8717;1003;2653;55512;55336;50855;5681;6483;93517;23035;283848;80262;55159;54957;181;123775;51741;100131303;10143;794;1504;91862;23563;23644;4775;27183;6236;7084;497190;124359;51647;64180;999;23536;6553;29100;84138;85445;4094;653319;283971;83449;8824;1728;113540;80004;84916;51388;29800;79767;348174;9798;80152;146456;28987;123904;9114;4166;1001;1723;1874;26231;463;3250;80790;342371;83657;8139;5713;55839;766;283847;84080;54921;51192;1506;23450;53630;7014;3240;10664;57610;55794;55697;55565;440348;3038;8996;23300;57215;23491;3299;55308;65057;9785;118460;100130958;11269;162239;10200;3291;146223;388284;283849;3931;146433;2734;5699;55783,178
-1,1,16,66279791,67506926,1227135,55336;1783;283848;80262;9114;865;84752;57546;1874;26231;8883;146212;29800;100529251;29109;146227;25894;766;283847;6236;7084;51192;51647;6553;29100;146225;8996;51673;23491;3299;653319;55282;123920;1014;8824;113540;1003;146223;8717;283849;3291;79767,42
1,1,16,69087360,83308286,14220926,2653;92154;6483;93517;11060;23035;55159;56942;54957;123775;25839;51741;10143;794;1504;7571;91862;64146;23563;5336;79152;27183;197257;114780;7567;497190;79583;283927;124359;3294;10164;10725;1012;23536;11345;85445;4094;283971;83449;1728;197258;342372;84937;84916;51388;3735;348174;9798;146456;28987;79613;6898;4166;388289;1723;170692;55066;463;3250;80790;79726;9564;342371;83657;8139;54386;22879;80777;5713;55839;53630;54921;23450;164;7014;6645;3240;197259;55697;55565;440348;440387;57687;3038;124491;23300;84342;16;55308;100130958;9785;118460;11269;162239;54768;10200;146433;2734;10428;55783,100
-1,1,16,69590043,75939743,6349700,6483;92154;28987;11060;23035;55159;6898;54957;25839;4166;1723;388289;463;55066;794;7571;3250;9798;91862;79726;1504;23563;9564;342371;79152;5713;54386;197257;7567;497190;23450;164;79583;3240;10164;197259;10725;55697;55565;23536;440348;440387;11345;3735;124491;55308;16;9785;118460;283971;83449;1728;11269;197258;54768;162239;146433;2734;342372;84937;10428;348174;55783,63
-1,-1,16,70052164,70193942,141778,55066,1
1,-1,16,70121905,70196755,74850,55066,1
1,-1,16,70148761,70196755,47994,55066,1
1,-1,16,70284178,70285129,951,118460,1
-1,1,16,70448476,84941726,14493250,2653;6483;92154;93517;23035;55159;56942;54957;123775;25839;51741;10143;161931;794;1504;7571;91862;23563;9914;8720;5336;79152;79786;197257;114780;7567;497190;79583;283927;124359;3294;10164;1012;23536;83693;11345;54550;85445;4094;123872;93107;9013;83716;83449;197258;23417;342372;84937;3735;9798;6898;29948;4166;388289;1723;3281;170692;463;23406;3250;80790;79726;9564;342371;83657;8139;54386;22879;5713;55839;53630;23450;164;3240;197259;55697;55565;57707;440348;440387;57687;124491;23300;100130958;9785;9100;162239;54768;146167;10200;146433;2734;58189;10428;55783,95
1,-1,16,70740804,71120139,379335,55697;54768,2
1,1,16,70783301,90163403,19380102,56942;11105;2300;763;197320;64779;7571;1535;51693;79007;124044;9914;8720;5336;79152;79786;197257;114780;7567;4157;79583;404550;283927;79791;3294;353;10164;1012;11345;2622;8140;6137;93107;27189;57338;23417;342372;84937;92806;3735;6898;146429;9764;124245;388289;3281;170692;23406;79726;9564;3394;54386;22879;10328;164;27132;197259;10428;51659;440387;57687;124491;1013;54768;146167;161882;124045;22980;2653;2294;81631;93517;23035;55159;54957;123775;4597;115992;51741;10143;161931;794;1504;91862;23563;339145;9605;2303;497190;124359;100506581;23536;83693;54550;85445;4094;123872;9013;83716;83449;333929;1327;92822;390748;9798;54758;863;23174;29948;4166;23199;1723;463;100287036;3250;80790;100129697;342371;83657;8139;5713;55839;348180;9780;53630;81620;5119;54849;55625;3240;29123;55697;55565;57707;440348;197322;2588;23300;100130958;9785;6687;54971;2175;9100;162239;10200;84501;2734;84627;58189;10381;1800;8558;55783,154
-1,-1,16,70860486,71196477,335991,54768,1
-1,-1,16,70929925,71196477,266552,54768,1
1,-1,16,72093025,72110913,17888,3250;3240,2
1,-1,16,72093025,72110913,17888,3250;3240,2
1,-1,16,72093025,72110913,17888,3250;3240,2
1,-1,16,72093025,72110913,17888,3250;3240,2
1,-1,16,72093025,72110913,17888,3250;3240,2
1,-1,16,72093025,72110913,17888,3250;3240,2
1,-1,16,72093025,72110913,17888,3250;3240,2
1,-1,16,72093025,72119382,26357,3250;3240;54957,3
1,-1,16,72107854,72110913,3059,3250,1
1,-1,16,72887051,73410660,523609,463;388289,2
1,1,16,75411879,90148400,14736521,2653;2294;81631;93517;1800;56942;11105;123775;4597;115992;2300;51741;763;10143;161931;197320;64779;1535;51693;79007;124044;23563;339145;9914;8720;5336;79786;114780;4157;9605;2303;79583;404550;283927;79791;124359;3294;100506581;353;1012;23536;83693;11345;2622;54550;85445;8140;4094;6137;123872;93107;9013;27189;83716;333929;1327;57338;23417;92822;92806;390748;3735;54758;863;23174;29948;146429;4166;9764;124245;23199;3281;170692;100287036;23406;80790;100129697;3394;83657;8139;54386;22879;55839;348180;9780;10328;81620;53630;5119;54849;55625;27132;29123;57707;51659;197322;57687;2588;124491;23300;100130958;6687;54971;2175;1013;9100;146167;124045;161882;10200;22980;84501;84627;58189;10381;10428;8558,117
-1,1,16,75575400,79188037,3612637,283927;170692;23536;11345;57687;54386;22879;85445;3735;51741;10143;79583;100130958,13
1,1,16,76370100,90155062,13784962,2653;2294;81631;93517;56942;11105;115992;123775;4597;2300;51741;763;10143;161931;197320;64779;1535;51693;79007;124044;339145;9914;8720;5336;79786;114780;4157;9605;2303;404550;283927;79791;124359;3294;100506581;353;1012;83693;2622;54550;85445;8140;4094;6137;123872;93107;9013;27189;83716;333929;1327;57338;23417;92822;92806;390748;54758;863;23174;29948;146429;9764;124245;23199;3281;170692;100287036;23406;80790;100129697;3394;348180;83657;22879;8139;55839;9780;81620;10328;53630;5119;54849;55625;27132;29123;57707;51659;197322;57687;2588;23300;100130958;6687;54971;2175;1013;9100;146167;124045;161882;10200;22980;84501;84627;58189;10381;1800;8558,108
1,1,16,76370100,90155062,13784962,2653;2294;81631;93517;56942;11105;115992;123775;4597;2300;51741;763;10143;161931;197320;64779;1535;51693;79007;124044;339145;9914;8720;5336;79786;114780;4157;9605;2303;404550;283927;79791;124359;3294;100506581;353;1012;83693;2622;54550;85445;8140;4094;6137;123872;93107;9013;27189;83716;333929;1327;57338;23417;92822;92806;390748;54758;863;23174;29948;146429;9764;124245;23199;3281;170692;100287036;23406;80790;100129697;3394;348180;83657;22879;8139;55839;9780;81620;10328;53630;5119;54849;55625;27132;29123;57707;51659;197322;57687;2588;23300;100130958;6687;54971;2175;1013;9100;146167;124045;161882;10200;22980;84501;84627;58189;10381;1800;8558,108
-1,1,16,78180603,78208482,27879,51741,1
-1,1,16,78180603,78208482,27879,51741,1
-1,-1,16,78658225,78745720,87495,51741,1
-1,1,16,78824347,83289026,4464679,2653;124359;3294;93517;1012;56942;123775;23300;4094;51741;80790;10200;83657;8139;55839;5336;53630;114780,18
1,1,16,80101212,90124279,10023067,2653;2294;81631;93517;56942;11105;123775;4597;115992;2300;763;161931;197320;64779;1535;51693;79007;124044;339145;9914;8720;5336;79786;114780;4157;9605;2303;404550;79791;124359;100506581;3294;353;1012;83693;2622;54550;8140;6137;123872;93107;9013;27189;83716;333929;1327;57338;23417;92822;92806;390748;54758;863;23174;29948;146429;9764;124245;23199;3281;100287036;23406;80790;100129697;3394;348180;83657;8139;55839;9780;81620;53630;10328;5119;54849;55625;27132;29123;57707;51659;197322;2588;23300;6687;54971;2175;1013;9100;146167;124045;161882;10200;22980;84501;84627;58189;10381;1800;8558,99
1,1,16,80751188,90163070,9411882,2653;2294;81631;93517;56942;11105;123775;4597;115992;2300;763;161931;197320;64779;1535;51693;79007;124044;339145;9914;8720;5336;79786;114780;4157;9605;2303;404550;79791;124359;100506581;3294;353;1012;83693;2622;54550;8140;6137;123872;93107;9013;27189;83716;333929;1327;57338;23417;92822;92806;390748;54758;863;23174;29948;146429;9764;124245;23199;3281;100287036;23406;80790;100129697;3394;348180;8139;55839;9780;81620;53630;10328;5119;54849;55625;27132;29123;57707;51659;197322;2588;23300;6687;54971;2175;1013;9100;146167;124045;161882;10200;22980;84501;84627;58189;10381;1800;8558,98
1,1,16,80980556,90148393,9167837,2653;2294;81631;93517;56942;11105;123775;4597;115992;2300;763;161931;197320;64779;1535;51693;79007;124044;339145;9914;8720;5336;79786;114780;4157;9605;2303;404550;79791;100506581;3294;353;1012;83693;2622;54550;8140;6137;123872;93107;9013;27189;83716;333929;1327;57338;23417;92822;92806;390748;54758;863;23174;29948;146429;9764;124245;23199;3281;100287036;23406;80790;100129697;3394;348180;8139;55839;9780;81620;53630;10328;5119;54849;55625;27132;29123;57707;51659;197322;2588;23300;6687;54971;2175;1013;9100;146167;124045;161882;10200;22980;84501;84627;58189;10381;1800;8558,97
1,-1,16,81050917,81076406,25489,55839;23300,2
-1,1,16,83432665,84941726,1509061,1012;83693;57707;54550;29948;161931;3281;123872;9013;93107;23406;83716;9100;146167;9914;8720;23417;79786;58189,19
-1,1,16,83721255,86106846,2385591,55625;1012;83693;57707;51659;29948;54550;9764;23199;161931;3281;123872;9013;23406;93107;83716;9100;339145;1327;146167;9914;8720;79786;3394;23417;58189;10328;404550,28
1,-1,16,83986845,84014686,27841,54550;29948,2
1,-1,16,84097011,84438495,341484,123872;9013;93107;83693;9914;8720;58189;161931,8
-1,-1,16,84619342,84641841,22499,23406,1
-1,1,16,85491404,87883528,2392124,79791;100506581;54758;2294;81631;51659;23174;8140;2300;23199;64779;10328;1327;57338;3394;2303;404550,17
1,1,16,85586582,90163403,4576821,54758;2294;863;81631;23174;11105;115992;4597;146429;2300;763;23199;124245;197320;64779;100287036;1535;51693;79007;100129697;8558;124044;3394;348180;9780;81620;9605;2303;10328;5119;4157;404550;54849;79791;100506581;27132;353;51659;197322;2588;2622;8140;6137;6687;54971;2175;27189;1013;333929;1327;124045;161882;57338;84501;22980;92822;92806;84627;390748;10381;1800;29123,62
1,1,16,85838574,90155062,4316488,54758;2294;863;81631;23174;11105;115992;4597;146429;2300;763;124245;197320;64779;100287036;1535;51693;79007;100129697;124044;3394;348180;9780;81620;9605;2303;5119;4157;54849;79791;100506581;27132;353;29123;197322;2588;2622;8140;6137;6687;54971;2175;27189;1013;333929;1327;124045;161882;57338;84501;22980;92822;92806;84627;390748;10381;1800;8558,58
1,-1,16,86519903,86536742,16839,,0
1,-1,16,86519903,86536742,16839,,0
1,-1,16,86519903,86542583,22680,,0
-1,1,16,86983712,89402222,2418510,54758;863;81631;23174;115992;4597;146429;763;124245;197320;100287036;1535;51693;100129697;348180;9780;81620;79791;100506581;353;197322;2588;8140;54971;27189;1013;333929;161882;57338;84627;390748;29123,32
-1,1,16,88116155,89524926,1408771,863;353;197322;2588;115992;4597;146429;124245;197320;100287036;27189;1013;1535;51693;333929;100129697;161882;348180;9780;84627;81620;390748;29123,23
1,-1,16,88506907,88590613,83706,161882;84627,2
-1,-1,16,88729110,88785985,56875,348180;9780;4597;333929;115992,5
1,1,16,89249149,89336307,87158,146429;29123;1013;197320,4
-1,-1,16,89283689,89603390,319701,6687;100287036;29123;197320,4
-1,1,16,89296939,89420254,123315,100287036;29123,2
-1,1,16,89434509,89490401,55892,29123,1
-1,1,16,89474299,89525832,51533,29123,1
-1,1,16,89539973,89570635,30662,29123,1
1,-1,16,89648650,89660320,11670,27132,1
1,-1,16,89648650,89689822,41172,1800;27132,2
1,-1,16,89648650,89701883,53233,1800;27132,2
1,-1,16,89648650,89701883,53233,1800;27132,2
1,-1,16,89648650,89701883,53233,1800;27132,2
1,-1,16,89648650,89701883,53233,1800;27132,2
1,-1,16,89648650,89701883,53233,1800;27132,2
1,-1,16,89648650,89701883,53233,1800;27132,2
1,-1,16,89648650,89701883,53233,1800;27132,2
1,-1,16,89660320,89689822,29502,1800;27132,2
1,-1,16,89660320,89689822,29502,1800;27132,2
1,-1,16,89660320,89689822,29502,1800;27132,2
1,-1,16,89660320,89689822,29502,1800;27132,2
1,-1,16,90016428,90030233,13805,54849,1
1,-1,16,90038122,90049044,10922,92806,1
-1,-1,16,90086851,90148400,61549,11105;2622,2
1,-1,16,90103155,90133246,30091,11105;2622,2
1,-1,16,90111208,90127921,16713,11105;2622,2
1,-1,16,90111208,90133246,22038,11105;2622,2
1,-1,16,90123933,90274381,150448,11105,1
1,1,17,525,1874153,1873628,10594;51031;50628;29928;286753;124935;727910;5345;29;400566;8578;359845;55178;4641;146760;55275;114826;83547;124997;5176;100506388;1398;79850;8447;7531;5306;727857;9501;64359;6117;51763,31
-1,1,17,525,1968434,1967909,10594;51031;50628;286753;5345;400566;55178;146760;114826;124641;100506388;1398;23293;727857;9501;64359;6117;29928;124935;727910;29;8578;359845;4641;55275;83547;124997;5176;1801;79850;8447;7531;5306;3090;51763,35
-1,1,17,525,2092064,2091539,10594;51031;50628;286753;5345;400566;55178;146760;114826;124641;100506388;1398;23293;727857;9501;64359;6117;29928;124935;727910;29;8578;359845;4641;55275;83547;124997;5176;1801;79850;8447;7531;5306;3090;51763,35
-1,1,17,525,2264023,2263498,10594;51031;50628;286753;63826;5345;400566;55178;146760;114826;9905;124641;100506388;1398;23293;727857;9501;64359;6117;55720;29928;124935;727910;29;8578;359845;4641;55275;83547;124997;5176;1801;79850;8447;7531;5306;3090;51763,38
-1,1,17,525,2363548,2363023,10594;51031;50628;286753;63826;5345;400566;55178;146760;114826;9905;124641;100506388;1398;23293;727857;9501;64359;6117;55720;29928;124935;727910;29;8578;359845;79066;4641;55275;83547;4335;124997;5176;1801;79850;8447;7531;5306;3090;51763,40
-1,1,17,525,2518160,2517635,10594;51031;50628;286753;63826;5345;400566;55178;146760;114826;9905;124641;100506388;1398;23293;727857;9501;64359;6117;55720;29928;124935;727910;29;8578;359845;79066;4641;55275;83547;4335;124997;5176;1801;79850;8447;7531;5306;3090;5048;51763,41
-1,1,17,525,2750745,2750220,10594;51031;50628;286753;63826;5345;400566;55178;146760;114826;9905;124641;100506388;1398;23293;727857;9501;23108;64359;6117;23277;55720;29928;124935;727910;29;8578;359845;79066;4641;55275;83547;4335;124997;5176;1801;79850;8447;7531;5306;3090;5048;51763,43
-1,1,17,525,2891302,2890777,10594;51031;50628;286753;63826;5345;400566;55178;146760;114826;9905;124641;100506388;1398;23293;727857;9501;23108;64359;6117;23277;55720;29928;124935;727910;29;8578;359845;79066;4641;55275;83547;4335;124997;5176;1801;79850;8447;7531;5306;3090;5048;51763,43
-1,1,17,525,3146162,3145637,10594;51031;50628;286753;63826;5345;400566;26189;55178;146760;114826;9905;124641;100506388;1398;23293;727857;8386;9501;8390;23108;64359;6117;23277;55720;29928;124935;727910;29;8578;359845;79066;4641;55275;83547;4335;124997;5176;1801;8383;79850;8447;7531;5306;3090;4991;5048;51763,48
-1,1,17,525,3825428,3824903,10594;8388;50628;5023;400566;55178;146760;114826;55421;124641;100506388;84254;83460;8386;8390;23108;55720;1497;29928;727910;29;8578;359845;4641;4335;124997;5176;4995;7531;83903;5026;5048;51763;51031;286753;63826;443;5345;26189;162514;9905;1398;23293;7442;727857;9501;64359;6117;84690;30851;23277;4994;124935;8387;79066;55275;83547;1801;8383;79850;8447;8392;23729;5306;3090;4991;3682,67
1,1,17,525,4151421,4150896,10594;8388;50628;5023;400566;55178;146760;114826;55421;124641;100506388;84254;83460;8386;8390;23108;23140;55720;1497;29928;727910;29;8578;359845;4641;4335;124936;124997;5176;4995;7531;51479;83903;5026;5048;51763;51031;286753;63826;443;5345;26189;162514;9905;1398;23293;7442;727857;9501;64359;6117;84690;30851;23277;4994;124935;8387;79066;55275;83547;1801;8383;79850;489;8447;8392;23729;5306;3090;4991;3682,71
-1,1,17,525,5838697,5838172,708;10594;8388;84622;50628;10514;5023;7326;5338;400566;55178;146760;124961;114826;55421;124641;100506388;26001;9552;84254;83460;9135;22861;2027;8386;8390;246;23108;388324;23140;10749;55720;55065;1497;29928;5216;23125;727910;728392;29;359845;8578;4641;124936;8402;4335;124997;5176;124976;4995;4927;51479;7531;83903;2811;5026;5048;400569;51763;51031;286753;443;63826;5345;162514;26189;100130311;9905;7775;388323;1398;124975;23293;79003;7442;727857;9501;409;84268;388325;64359;6117;84690;9098;30851;23277;342527;4994;1145;124935;8387;5694;79066;83547;55275;56919;8383;1801;9032;50488;79850;489;8447;8392;23729;5306;3090;27043;201305;4991;58191;84225;284013;51009;3682,115
1,1,17,525,14667519,14666994,84622;6517;201243;50628;10514;5023;5338;284114;51087;9955;56985;26001;83460;3000;5198;22861;2027;433;8386;8390;246;643664;23108;23140;10749;6844;57659;5216;23125;727910;728392;6154;359845;37;407977;4641;124936;8402;124997;124976;4995;4927;2256;51479;23302;8711;201232;57555;2811;9526;23399;80169;5026;54739;1366;9851;146849;51763;146852;1352;9423;8735;8742;54785;51031;5187;286753;23746;5345;124637;6665;162514;55135;146822;482;59344;9905;9212;7775;388323;23135;9953;146850;58485;124975;23293;79003;440400;432;727857;9501;1949;409;388325;64359;6117;162517;239;644139;1742;4619;9098;23277;342527;4994;1140;1107;83547;57048;8383;147040;9032;7157;489;8392;23729;968;27043;84461;201140;51009;81565;4628;644070;708;10594;8388;388333;23533;643904;7326;400566;55178;388327;146760;124961;114826;6416;93649;55421;124641;100506388;6341;9552;84254;9513;9135;26168;374768;51003;388336;1984;1973;9340;5957;388324;124944;22899;10462;84314;9912;55720;55065;284111;1497;29928;83394;29;8578;162515;4622;4335;5176;6462;7531;84316;83903;124751;23587;5048;400569;399512;124739;9744;5430;146754;60528;92162;443;63826;84817;7566;1856;26189;100130311;100996842;254863;1398;4621;8522;7442;83659;339168;146845;116840;84268;4620;84690;79142;112483;30851;162387;1145;54478;124935;8387;5694;247;84667;8741;79066;29098;9482;55275;56919;1801;50488;388335;255877;79850;1770;8447;2874;9196;5306;3090;201305;4991;58191;84225;284013;11337;242;3682;4626,245
1,1,17,525,15027737,15027212,84622;6517;201243;50628;10514;5023;5338;284114;51087;9955;56985;26001;83460;3000;5198;22861;2027;433;8386;8390;246;643664;23108;23140;10749;6844;57659;5216;23125;727910;728392;6154;359845;37;407977;4641;124936;8402;124997;124976;4995;4927;2256;51479;23302;8711;201232;57555;2811;9526;23399;80169;5026;54739;1366;9851;146849;51763;146852;1352;9423;8735;8742;54785;51031;5187;286753;23746;5345;124637;6665;162514;55135;146822;482;59344;9905;9212;7775;388323;23135;9953;146850;58485;124975;23293;79003;440400;432;727857;9501;1949;409;388325;64359;6117;162517;239;644139;1742;4619;9098;23277;342527;4994;1140;1107;83547;57048;8383;147040;9032;7157;489;8392;23729;968;27043;84461;201140;51009;81565;4628;644070;708;10594;8388;388333;23533;643904;7326;400566;55178;388327;146760;124961;114826;6416;93649;55421;124641;100506388;6341;9552;84254;9513;9135;26168;374768;51003;388336;1984;1973;9340;5957;388324;124944;22899;10462;84314;9912;55720;55065;284111;1497;29928;83394;29;8578;162515;4622;4335;5176;6462;7531;84316;83903;124751;23587;5048;400569;399512;124739;9744;5430;146754;60528;92162;443;63826;84817;7566;1856;26189;100130311;100996842;254863;1398;4621;8522;7442;83659;339168;146845;116840;84268;4620;84690;79142;112483;30851;162387;1145;54478;124935;8387;5694;247;84667;8741;79066;29098;9482;55275;56919;1801;50488;388335;255877;79850;1770;8447;2874;9196;5306;3090;201305;4991;58191;84225;284013;11337;242;3682;4626,245
1,1,17,526,81041938,81041412,84622;83900;91608;83899;9931;51087;2688;146853;8678;147183;7343;348235;332;10750;7448;786;6844;1442;5216;10966;728392;85285;3728;57597;100130370;91647;80179;3872;201164;9020;55244;80022;3131;28958;3607;283991;5606;9123;7473;400591;146850;9400;5881;1949;3690;92579;100506084;146909;317719;6388;728255;284071;2302;8687;9032;64122;25926;8392;125061;11056;9703;9625;708;672;84951;51649;284119;400566;342510;146760;54883;2064;1277;55421;23131;10513;146664;9552;84669;9513;22834;1655;57409;9021;147007;6613;9912;8578;162515;8834;516;5176;474170;6426;114897;7531;3219;124751;26073;5048;3292;4591;60528;81851;5573;5914;752;3487;30833;8165;3691;84961;9618;79922;10609;8714;644815;84616;100505724;79755;6774;27091;94103;54478;79066;85291;5175;55275;2232;256933;10693;2874;9196;11337;124872;11143;7732;54474;4137;8153;6169;125170;57125;54902;79170;5705;283985;124512;147111;7314;2905;5198;9110;80039;1411;6358;255061;360205;9058;57659;339184;4843;57332;23125;10266;642;51326;4215;57003;23531;10349;162333;84643;9526;252983;4097;3996;2584;146852;146894;1352;23326;8313;5187;55135;54799;59344;7706;9212;10209;100505591;283999;9953;23135;25979;92736;25984;162517;8456;239;201254;654346;9349;342527;2826;768206;56970;146779;10350;7157;728279;23729;5376;255275;56953;644070;2648;146956;64847;9862;10594;5889;5718;55106;80221;100130520;201191;23533;643904;6416;3980;100506388;79058;162605;9135;26168;30850;388364;124923;9256;7716;83394;9572;9267;100130933;124773;79157;5831;284001;84152;146754;390790;3927;6427;30009;6143;85302;26189;388394;162461;100996842;4779;254863;374786;3837;9755;4830;116840;5636;84690;79142;6532;8396;3675;60681;27077;6730;9482;81871;56919;83538;284161;404093;79701;54752;11072;201305;535;11267;51747;84687;9487;10514;350383;5023;83895;84336;6362;83460;2027;6352;146862;256223;51030;5245;399687;55036;342538;124925;101927581;407977;9144;124976;4927;51755;51081;57555;10614;1362;100505753;2811;4763;83755;3882;100134934;6665;146822;6351;124817;482;124583;92521;58485;124975;163;5469;727857;5034;9501;782;84514;409;23512;3212;146723;201181;26574;4619;6830;7283;23098;26083;55175;4642;2695;55316;84461;6448;146802;8405;9527;7326;79148;55890;55178;124961;93649;11232;124641;23265;10351;3884;10140;3886;6155;10476;29928;57690;9146;10237;5717;4353;728224;5697;2118;85280;10610;23415;6348;116729;23587;3060;6605;5608;116238;5430;79915;92162;9969;63826;7566;6359;1856;47;4621;996;51264;339168;100533177;23210;84299;84268;4761;1145;146722;3396;8387;10052;11011;31;114757;85294;348262;100170841;284040;100533496;57336;3885;8493;26151;146705;192666;645027;379;55062;6517;10900;50628;3975;84923;7077;284114;57674;55803;643664;2886;8811;2642;2124;284184;37;51393;284098;3860;91369;9560;645832;51136;23510;9851;146849;79736;201299;9775;4669;84073;162514;115024;9905;8535;10400;114804;5709;284004;79003;432;29916;23580;79089;100506736;146712;6117;94005;326624;9098;162540;4831;23277;23163;57636;201176;100507608;990;1107;4905;147040;146691;55288;9772;339221;11322;147015;3965;9220;314;6603;85293;5193;117584;2314;6776;90410;10481;6329;79990;3861;15;80233;147184;84314;124989;6355;9043;29;4622;100129396;140775;4185;3959;79777;114881;80774;1018;79132;443;284058;80279;56270;84074;3218;7442;94086;64132;23164;353174;63893;10517;4356;1748;162387;283989;162282;124935;54549;3217;247;29098;256957;4025;9241;124538;79850;162394;104909134;2837;3682;6442;400581;284110;5338;2896;55040;26502;9955;91107;439921;5598;201292;51655;57508;1394;1659;10749;727910;2793;6154;51181;65264;113235;124936;54757;84440;100132386;80169;23399;100462977;5026;284129;51629;64750;9423;8742;54785;51031;5345;55731;55181;81558;22905;117246;100996259;284067;1468;353149;9094;388325;64359;10458;7756;90507;1444;374819;388341;51529;8851;489;84313;4222;3213;8631;64772;125206;23495;27043;201140;2689;4628;54894;9570;284021;10493;10615;6928;388403;388327;974;3216;347741;6904;6521;6909;388336;51003;246744;2081;2194;5957;83990;64518;201158;55720;146713;4335;80755;730755;22843;7126;3858;79154;6752;400569;399512;4239;124912;5691;2125;3866;6368;79999;100130311;124599;79877;26284;22794;81870;162466;51195;3993;4620;112483;3868;22994;10871;5694;80725;29893;8741;124540;6470;440435;26022;8447;10197;284013;8557;3211;4991;2670;125111;242;9720;201243;92591;81671;728318;100506650;6349;26001;218;101060321;60386;23140;350;125113;57521;90506;284086;57547;79637;4995;91607;64149;6356;51479;6945;79415;388419;94015;8632;353288;1353;51321;8639;124801;8877;6397;11248;124637;6354;3880;7484;51204;7775;54890;9706;92340;388323;3838;284018;55808;8148;51547;11276;342667;284076;5414;1742;11325;2873;55876;1140;201255;6720;55666;9489;26115;85290;6777;51009;2145;10948;147011;81565;50964;114826;51379;3021;100134391;84940;83902;6871;388324;339230;57335;1236;284111;4804;140735;51;85464;2319;51225;2548;83903;27092;9368;9382;84282;9326;4836;9611;55090;4884;28964;284194;83659;2538;51701;284099;57602;84667;4974;80347;7067;50488;388335;3215;26118;4635;136;388389;1267;100885850;92335;3430;4626;91603;9842;654364;26207;10801;339231;653240;11216;57151;124602;22861;339263;8390;201294;246;23108;100131439;3674;7266;359845;4641;64978;8402;8161;57513;51651;78995;2256;79643;124995;9496;1366;124842;2520;125058;6357;51763;8735;124783;6662;23746;9121;5409;1443;83901;147179;64118;3857;284207;55379;25794;23293;440400;6198;57551;124565;51168;8844;162417;6668;5986;4994;54903;57649;28511;56934;201266;57048;8383;81033;342618;201134;113026;8388;5164;388333;1747;256302;51751;55028;254272;6347;85451;8533;2186;414059;1984;1973;2123;7156;124944;22899;162494;113277;10462;6346;55065;10743;5578;9520;390792;22806;339210;84316;55771;51268;84081;4355;40;124739;9744;8787;230;124535;1845;924;71;3768;124857;1398;8522;729288;146845;83871;101060376;2885;11314;8506;80174;124930;56155;124808;5539;79651;1801;3384;51155;284131;6398;5306;8526;642843;23558;3881;762;58488;79672;10241;100653515;100885848;339287;84366;79893;7153;10882;1213;283987;388381;55852;10672;9120;56985;116236;83882;29115;388407;55813;3000;8689;433;8386;146923;59342;54475;30837;3859;81872;26689;162427;3883;2535;8913;57532;63897;55273;6827;124997;1534;6182;8288;23302;8711;201232;9343;5148;147166;10642;5892;23461;54739;65266;9884;5878;10014;286753;27346;83897;729877;83896;54828;729873;10040;9902;4302;146861;1636;79092;400629;81850;90313;644139;5635;79902;3773;201229;284186;83547;51174;55352;968;339175;124590;10238;90799;93210;124626;284069;10189;1440;79665;84733;79018;100132476;146857;6341;84254;374768;224;9340;100141515;201163;85289;84311;1497;494188;8688;51096;374286;10626;6462;1819;342574;114659;414062;6147;201161;3214;3759;284083;5833;84817;22901;284106;64446;124790;80320;6360;83450;54868;125150;125115;30851;339229;388436;414060;9001;396;23460;55163;729220;147138;1453;255877;1770;643008;51226;4077;27175;7083;3090;58191;10951;84225;7703;246176;1101,1142
1,1,17,526,81041938,81041412,84622;83900;91608;83899;9931;51087;2688;146853;8678;147183;7343;348235;332;10750;7448;786;6844;1442;5216;10966;728392;85285;3728;57597;100130370;91647;80179;3872;201164;9020;55244;80022;3131;28958;3607;283991;5606;9123;7473;400591;146850;9400;5881;1949;3690;92579;100506084;146909;317719;6388;728255;284071;2302;8687;9032;64122;25926;8392;125061;11056;9703;9625;708;672;84951;51649;284119;400566;342510;146760;54883;2064;1277;55421;23131;10513;146664;9552;84669;9513;22834;1655;57409;9021;147007;6613;9912;8578;162515;8834;516;5176;474170;6426;114897;7531;3219;124751;26073;5048;3292;4591;60528;81851;5573;5914;752;3487;30833;8165;3691;84961;9618;79922;10609;8714;644815;84616;100505724;79755;6774;27091;94103;54478;79066;85291;5175;55275;2232;256933;10693;2874;9196;11337;124872;11143;7732;54474;4137;8153;6169;125170;57125;54902;79170;5705;283985;124512;147111;7314;2905;5198;9110;80039;1411;6358;255061;360205;9058;57659;339184;4843;57332;23125;10266;642;51326;4215;57003;23531;10349;162333;84643;9526;252983;4097;3996;2584;146852;146894;1352;23326;8313;5187;55135;54799;59344;7706;9212;10209;100505591;283999;9953;23135;25979;92736;25984;162517;8456;239;201254;654346;9349;342527;2826;768206;56970;146779;10350;7157;728279;23729;5376;255275;56953;644070;2648;146956;64847;9862;10594;5889;5718;55106;80221;100130520;201191;23533;643904;6416;3980;100506388;79058;162605;9135;26168;30850;388364;124923;9256;7716;83394;9572;9267;100130933;124773;79157;5831;284001;84152;146754;390790;3927;6427;30009;6143;85302;26189;388394;162461;100996842;4779;254863;374786;3837;9755;4830;116840;5636;84690;79142;6532;8396;3675;60681;27077;6730;9482;81871;56919;83538;284161;404093;79701;54752;11072;201305;535;11267;51747;84687;9487;10514;350383;5023;83895;84336;6362;83460;2027;6352;146862;256223;51030;5245;399687;55036;342538;124925;101927581;407977;9144;124976;4927;51755;51081;57555;10614;1362;100505753;2811;4763;83755;3882;100134934;6665;146822;6351;124817;482;124583;92521;58485;124975;163;5469;727857;5034;9501;782;84514;409;23512;3212;146723;201181;26574;4619;6830;7283;23098;26083;55175;4642;2695;55316;84461;6448;146802;8405;9527;7326;79148;55890;55178;124961;93649;11232;124641;23265;10351;3884;10140;3886;6155;10476;29928;57690;9146;10237;5717;4353;728224;5697;2118;85280;10610;23415;6348;116729;23587;3060;6605;5608;116238;5430;79915;92162;9969;63826;7566;6359;1856;47;4621;996;51264;339168;100533177;23210;84299;84268;4761;1145;146722;3396;8387;10052;11011;31;114757;85294;348262;100170841;284040;100533496;57336;3885;8493;26151;146705;192666;645027;379;55062;6517;10900;50628;3975;84923;7077;284114;57674;55803;643664;2886;8811;2642;2124;284184;37;51393;284098;3860;91369;9560;645832;51136;23510;9851;146849;79736;201299;9775;4669;84073;162514;115024;9905;8535;10400;114804;5709;284004;79003;432;29916;23580;79089;100506736;146712;6117;94005;326624;9098;162540;4831;23277;23163;57636;201176;100507608;990;1107;4905;147040;146691;55288;9772;339221;11322;147015;3965;9220;314;6603;85293;5193;117584;2314;6776;90410;10481;6329;79990;3861;15;80233;147184;84314;124989;6355;9043;29;4622;100129396;140775;4185;3959;79777;114881;80774;1018;79132;443;284058;80279;56270;84074;3218;7442;94086;64132;23164;353174;63893;10517;4356;1748;162387;283989;162282;124935;54549;3217;247;29098;256957;4025;9241;124538;79850;162394;104909134;2837;3682;6442;400581;284110;5338;2896;55040;26502;9955;91107;439921;5598;201292;51655;57508;1394;1659;10749;727910;2793;6154;51181;65264;113235;124936;54757;84440;100132386;80169;23399;100462977;5026;284129;51629;64750;9423;8742;54785;51031;5345;55731;55181;81558;22905;117246;100996259;284067;1468;353149;9094;388325;64359;10458;7756;90507;1444;374819;388341;51529;8851;489;84313;4222;3213;8631;64772;125206;23495;27043;201140;2689;4628;54894;9570;284021;10493;10615;6928;388403;388327;974;3216;347741;6904;6521;6909;388336;51003;246744;2081;2194;5957;83990;64518;201158;55720;146713;4335;80755;730755;22843;7126;3858;79154;6752;400569;399512;4239;124912;5691;2125;3866;6368;79999;100130311;124599;79877;26284;22794;81870;162466;51195;3993;4620;112483;3868;22994;10871;5694;80725;29893;8741;124540;6470;440435;26022;8447;10197;284013;8557;3211;4991;2670;125111;242;9720;201243;92591;81671;728318;100506650;6349;26001;218;101060321;60386;23140;350;125113;57521;90506;284086;57547;79637;4995;91607;64149;6356;51479;6945;79415;388419;94015;8632;353288;1353;51321;8639;124801;8877;6397;11248;124637;6354;3880;7484;51204;7775;54890;9706;92340;388323;3838;284018;55808;8148;51547;11276;342667;284076;5414;1742;11325;2873;55876;1140;201255;6720;55666;9489;26115;85290;6777;51009;2145;10948;147011;81565;50964;114826;51379;3021;100134391;84940;83902;6871;388324;339230;57335;1236;284111;4804;140735;51;85464;2319;51225;2548;83903;27092;9368;9382;84282;9326;4836;9611;55090;4884;28964;284194;83659;2538;51701;284099;57602;84667;4974;80347;7067;50488;388335;3215;26118;4635;136;388389;1267;100885850;92335;3430;4626;91603;9842;654364;26207;10801;339231;653240;11216;57151;124602;22861;339263;8390;201294;246;23108;100131439;3674;7266;359845;4641;64978;8402;8161;57513;51651;78995;2256;79643;124995;9496;1366;124842;2520;125058;6357;51763;8735;124783;6662;23746;9121;5409;1443;83901;147179;64118;3857;284207;55379;25794;23293;440400;6198;57551;124565;51168;8844;162417;6668;5986;4994;54903;57649;28511;56934;201266;57048;8383;81033;342618;201134;113026;8388;5164;388333;1747;256302;51751;55028;254272;6347;85451;8533;2186;414059;1984;1973;2123;7156;124944;22899;162494;113277;10462;6346;55065;10743;5578;9520;390792;22806;339210;84316;55771;51268;84081;4355;40;124739;9744;8787;230;124535;1845;924;71;3768;124857;1398;8522;729288;146845;83871;101060376;2885;11314;8506;80174;124930;56155;124808;5539;79651;1801;3384;51155;284131;6398;5306;8526;642843;23558;3881;762;58488;79672;10241;100653515;100885848;339287;84366;79893;7153;10882;1213;283987;388381;55852;10672;9120;56985;116236;83882;29115;388407;55813;3000;8689;433;8386;146923;59342;54475;30837;3859;81872;26689;162427;3883;2535;8913;57532;63897;55273;6827;124997;1534;6182;8288;23302;8711;201232;9343;5148;147166;10642;5892;23461;54739;65266;9884;5878;10014;286753;27346;83897;729877;83896;54828;729873;10040;9902;4302;146861;1636;79092;400629;81850;90313;644139;5635;79902;3773;201229;284186;83547;51174;55352;968;339175;124590;10238;90799;93210;124626;284069;10189;1440;79665;84733;79018;100132476;146857;6341;84254;374768;224;9340;100141515;201163;85289;84311;1497;494188;8688;51096;374286;10626;6462;1819;342574;114659;414062;6147;201161;3214;3759;284083;5833;84817;22901;284106;64446;124790;80320;6360;83450;54868;125150;125115;30851;339229;388436;414060;9001;396;23460;55163;729220;147138;1453;255877;1770;643008;51226;4077;27175;7083;3090;58191;10951;84225;7703;246176;1101,1142
1,-1,17,6160,264204,258044,100506388;9501;8447;400566,4
1,1,17,6160,2002365,1996205,10594;51031;50628;286753;5345;400566;55178;146760;114826;124641;100506388;1398;23293;727857;9501;64359;6117;29928;124935;727910;29;8578;359845;4641;55275;83547;124997;5176;1801;79850;8447;7531;5306;3090;51763,35
-1,1,17,45835,2204282,2158447,10594;51031;50628;286753;5345;400566;55178;146760;114826;124641;100506388;1398;23293;727857;9501;64359;6117;29928;124935;727910;29;8578;359845;4641;55275;83547;124997;5176;1801;79850;7531;5306;3090;51763,34
1,1,17,45835,2913975,2868140,10594;51031;50628;286753;63826;5345;400566;55178;146760;114826;9905;124641;100506388;1398;23293;727857;9501;23108;64359;6117;23277;55720;29928;124935;727910;29;8578;359845;79066;4641;55275;83547;4335;124997;5176;1801;79850;7531;5306;3090;5048;51763,42
-1,1,17,45835,6862369,6816534,708;10594;8388;84622;50628;10514;5023;7326;5338;400566;55178;388327;146760;124961;114826;55421;124641;100506388;26001;9552;84254;83460;9135;22861;2027;51003;8386;8390;246;23108;388324;23140;10749;55720;55065;284111;1497;29928;5216;23125;727910;83394;728392;29;359845;8578;4641;124936;8402;4335;124997;5176;124976;4995;4927;51479;23302;7531;83903;2811;5026;54739;9851;5048;400569;51763;51031;286753;443;23746;5345;63826;84817;162514;26189;100130311;9905;7775;388323;1398;124975;23293;79003;7442;83659;727857;9501;409;84268;388325;64359;6117;162517;84690;9098;30851;23277;342527;4994;1145;54478;124935;8387;5694;79066;83547;55275;56919;8383;1801;9032;50488;79850;489;8392;23729;5306;3090;27043;201305;4991;58191;84225;284013;51009;3682,126
-1,1,17,45835,7600330,7554495,84622;6517;201243;50628;10514;5023;5338;284114;51087;26001;83460;22861;2027;433;8386;8390;246;643664;23108;23140;10749;57659;5216;23125;727910;728392;359845;37;407977;4641;124936;8402;124997;124976;4995;4927;2256;51479;23302;8711;201232;57555;2811;9526;23399;5026;54739;1366;9851;51763;8742;51031;286753;23746;5345;6665;162514;55135;482;9905;7775;388323;124975;23293;79003;440400;432;727857;9501;409;388325;64359;6117;162517;239;1742;9098;23277;342527;4994;1140;83547;57048;8383;147040;9032;7157;489;8392;23729;968;27043;84461;51009;708;10594;8388;7326;400566;55178;388327;146760;124961;114826;55421;124641;100506388;9552;84254;9513;9135;26168;374768;51003;1984;1973;388324;124944;10462;55720;55065;284111;1497;29928;83394;29;8578;162515;4335;5176;6462;7531;83903;23587;5048;400569;9744;5430;443;63826;84817;1856;26189;100130311;100996842;254863;1398;7442;83659;339168;84268;84690;79142;112483;30851;1145;54478;124935;8387;5694;8741;79066;55275;56919;1801;50488;255877;79850;2874;5306;3090;201305;4991;58191;84225;284013;11337;3682,178
1,1,17,45835,12247218,12201383,84622;6517;201243;50628;10514;5023;5338;284114;51087;56985;26001;83460;3000;5198;22861;2027;433;8386;8390;246;643664;23108;23140;10749;6844;57659;5216;23125;727910;728392;6154;359845;37;407977;4641;124936;8402;124997;124976;4995;4927;2256;51479;23302;8711;201232;57555;2811;9526;23399;80169;5026;54739;1366;9851;146849;51763;146852;9423;8735;8742;54785;51031;5187;286753;23746;5345;124637;6665;162514;55135;482;59344;9905;9212;7775;388323;23135;146850;58485;124975;23293;79003;440400;432;727857;9501;1949;409;388325;64359;6117;162517;239;644139;1742;4619;9098;23277;342527;4994;1140;1107;83547;57048;8383;147040;9032;7157;489;8392;23729;968;27043;84461;201140;51009;81565;4628;644070;708;10594;8388;388333;23533;643904;7326;400566;55178;388327;146760;124961;114826;6416;55421;124641;100506388;6341;9552;84254;9513;9135;26168;374768;51003;388336;1984;1973;9340;5957;388324;124944;22899;10462;84314;55720;55065;284111;1497;29928;83394;29;8578;162515;4622;4335;5176;6462;7531;84316;83903;124751;23587;5048;400569;399512;124739;9744;5430;146754;92162;443;63826;84817;7566;1856;26189;100130311;100996842;254863;1398;4621;8522;7442;83659;339168;146845;116840;84268;4620;84690;79142;112483;30851;162387;1145;54478;124935;8387;5694;247;84667;8741;79066;29098;9482;55275;56919;1801;50488;388335;255877;79850;1770;2874;9196;5306;3090;201305;4991;58191;84225;284013;11337;242;3682;4626,237
-1,1,17,48858,2940028,2891170,10594;51031;50628;286753;63826;5345;400566;55178;146760;114826;9905;124641;100506388;1398;23293;727857;9501;23108;64359;6117;23277;55720;29928;124935;727910;29;8578;359845;79066;4641;55275;83547;4335;124997;5176;1801;79850;7531;5306;3090;5048;51763,42
-1,1,17,48858,3379400,3330542,10594;8388;51031;50628;286753;63826;443;5345;400566;26189;55178;146760;114826;9905;124641;100506388;1398;23293;727857;8386;9501;8390;23108;64359;6117;84690;23277;55720;4994;29928;124935;8387;727910;29;8578;359845;79066;4641;55275;83547;4335;124997;5176;1801;8383;4995;79850;7531;8392;5306;3090;4991;5048;51763,54
-1,1,17,50690,1824246,1773556,10594;51031;50628;29928;286753;124935;727910;5345;29;400566;8578;359845;55178;4641;55275;83547;114826;124997;5176;100506388;1398;79850;7531;5306;727857;9501;64359;6117;51763,29
-1,1,17,50690,2588655,2537965,10594;51031;50628;286753;63826;5345;400566;55178;146760;114826;9905;124641;100506388;1398;23293;727857;9501;64359;6117;55720;29928;124935;727910;29;8578;359845;79066;4641;55275;83547;4335;124997;5176;1801;79850;7531;5306;3090;5048;51763,40
-1,1,17,50690,4168935,4118245,10594;8388;50628;5023;400566;55178;146760;114826;55421;124641;100506388;84254;83460;8386;8390;23108;23140;55720;1497;29928;727910;29;8578;359845;4641;4335;124936;124997;5176;4995;7531;51479;83903;5026;5048;51763;51031;286753;63826;443;5345;26189;162514;9905;1398;23293;7442;727857;9501;64359;6117;84690;30851;23277;4994;124935;8387;79066;55275;83547;1801;8383;79850;489;8392;23729;5306;3090;4991;3682,70
1,1,17,50690,5048327,4997637,10594;8388;50628;10514;5023;7326;5338;400566;55178;146760;124961;114826;55421;124641;100506388;26001;9552;84254;83460;2027;8386;8390;246;23108;388324;23140;10749;55720;55065;1497;29928;5216;23125;727910;29;8578;359845;4641;124936;8402;4335;124997;5176;124976;4995;51479;7531;83903;2811;5026;5048;400569;51763;51031;286753;443;63826;5345;162514;26189;100130311;9905;7775;388323;1398;124975;23293;7442;727857;9501;409;64359;6117;84690;9098;30851;23277;342527;4994;1145;124935;8387;5694;79066;83547;55275;8383;1801;9032;50488;79850;489;8392;23729;5306;3090;27043;201305;4991;58191;84225;284013;3682,103
1,1,17,50690,7394448,7343758,84622;6517;201243;50628;10514;5023;5338;284114;51087;26001;83460;22861;2027;433;8386;8390;246;643664;23108;23140;10749;57659;5216;23125;727910;728392;359845;37;4641;124936;8402;124997;124976;4995;4927;2256;51479;23302;8711;201232;57555;2811;23399;5026;54739;1366;9851;51763;51031;286753;23746;5345;162514;9905;7775;388323;124975;23293;79003;440400;432;727857;9501;409;388325;64359;6117;162517;239;1742;9098;23277;342527;4994;1140;83547;57048;8383;147040;9032;489;8392;23729;27043;84461;51009;708;10594;8388;7326;400566;55178;388327;146760;124961;114826;55421;124641;100506388;9552;84254;9135;374768;51003;1984;388324;124944;10462;55720;55065;284111;1497;29928;83394;29;8578;162515;4335;5176;7531;83903;23587;5048;400569;9744;5430;443;63826;84817;1856;26189;100130311;254863;1398;7442;83659;339168;84268;84690;79142;30851;1145;54478;124935;8387;5694;79066;55275;56919;1801;50488;255877;79850;2874;5306;3090;201305;4991;58191;84225;284013;11337;3682,163
1,-1,17,96559,161423,64864,9501,1
1,-1,17,192700,249192,56492,9501,1
1,-1,17,199921,264204,64283,400566;9501,2
1,-1,17,199921,264204,64283,400566;9501,2
1,1,17,396627,726714,330087,79850;55178;51031;55275;50628;64359,6
1,1,17,396627,783601,386974,79850;55178;51031;55275;50628;64359,6
-1,1,17,396627,3558393,3161766,10594;8388;51031;50628;286753;63826;443;5345;26189;55178;162514;146760;114826;9905;124641;1398;23293;7442;727857;8386;8390;23108;64359;6117;84690;23277;55720;4994;1497;29928;124935;8387;727910;29;8578;79066;4641;83547;55275;4335;124997;5176;1801;8383;4995;79850;7531;8392;23729;5306;3090;4991;5048;51763,54
-1,1,17,396627,4638828,4242201,10594;8388;50628;10514;5023;7326;55178;146760;114826;55421;124641;84254;83460;8386;8390;246;23108;23140;55720;1497;29928;727910;29;8578;4641;124936;4335;124997;5176;124976;4995;51479;7531;83903;5026;400569;5048;51763;51031;286753;443;63826;5345;162514;26189;9905;1398;124975;23293;7442;727857;409;64359;6117;84690;30851;23277;342527;4994;124935;8387;79066;83547;55275;8383;1801;79850;489;8392;23729;5306;3090;27043;201305;4991;58191;3682,77
1,-1,17,751195,872943,121748,64359,1
1,-1,17,751195,887645,136450,64359,1
1,1,17,751195,1544895,793700,1398;7531;29928;5306;286753;124935;29;727857;8578;4641;64359;51763,12
-1,1,17,800049,2390454,1590405,10594;55720;29928;286753;63826;124935;5345;727910;29;8578;79066;4641;146760;83547;114826;9905;4335;124997;5176;1801;124641;1398;7531;23293;5306;3090;727857;64359;6117;51763,30
1,1,17,874171,2306440,1432269,10594;55720;29928;286753;63826;124935;5345;727910;29;8578;4641;146760;83547;114826;9905;4335;124997;5176;1801;124641;1398;7531;23293;5306;3090;727857;64359;6117;51763,29
1,1,17,1017065,1544906,527841,1398;7531;5306;286753;124935;29;727857;8578;4641;51763,10
1,1,17,1061434,1515760,454326,1398;7531;5306;286753;124935;29;727857;4641;51763,9
1,1,17,1113102,1834395,721293,10594;286753;124935;727910;5345;29;8578;4641;83547;114826;124997;5176;1398;7531;5306;727857;6117;51763,18
1,1,17,1113102,6742486,5629384,708;10594;8388;84622;10514;5023;7326;5338;388327;146760;124961;114826;55421;124641;26001;9552;84254;83460;9135;22861;2027;51003;8386;8390;246;23108;388324;23140;10749;55720;55065;284111;1497;5216;23125;727910;83394;29;728392;8578;4641;124936;8402;4335;124997;5176;124976;4995;4927;51479;23302;7531;83903;2811;5026;54739;9851;400569;5048;51763;286753;443;23746;5345;63826;84817;162514;26189;100130311;9905;7775;388323;1398;124975;23293;79003;7442;83659;727857;409;84268;388325;6117;162517;84690;9098;30851;23277;342527;4994;1145;54478;124935;8387;5694;79066;83547;56919;8383;1801;9032;50488;489;8392;23729;5306;3090;27043;201305;4991;58191;84225;284013;51009;3682,115
-1,1,17,1114083,1784979,670896,10594;286753;124935;727910;5345;29;8578;4641;83547;114826;124997;5176;1398;7531;5306;727857;6117;51763,18
-1,1,17,1130686,2165287,1034601,10594;286753;124935;727910;5345;29;8578;4641;146760;83547;114826;124997;1801;5176;124641;1398;7531;23293;5306;3090;727857;6117;51763,23
1,1,17,1229079,1348455,119376,1398;7531,2
-1,1,17,1263628,1483869,220241,1398;7531;4641;5306;124935;51763,6
-1,1,17,1277162,1505103,227941,1398;7531;4641;5306;124935;51763,6
-1,1,17,1645999,2855558,1209559,23277;55720;63826;5345;79066;4335;146760;9905;114826;1801;5176;124641;23293;3090;23108;5048;6117,17
-1,-1,17,1703045,1859251,156206,146760;114826;6117,3
-1,1,17,1751557,5378509,3626952,708;8388;84622;10514;5023;7326;5338;146760;124961;55421;124641;26001;9552;84254;83460;9135;2027;8386;8390;246;23108;388324;23140;10749;55720;55065;1497;5216;23125;124936;4335;8402;124976;4995;4927;51479;83903;2811;5026;400569;5048;443;63826;162514;26189;100130311;9905;7775;388323;124975;23293;7442;409;84268;388325;6117;84690;9098;30851;23277;342527;4994;1145;8387;5694;79066;56919;8383;1801;9032;50488;489;8392;23729;284013;3090;27043;201305;4991;58191;84225;51009;3682,83
-1,1,17,1915993,2548152,632159,124641;4335;55720;23293;3090;63826;79066;9905;146760;5048;1801,11
-1,1,17,1936753,2901448,964695,124641;4335;23277;55720;23293;3090;63826;79066;9905;23108;5048;1801,12
-1,1,17,1965674,5161635,3195961,8388;84622;10514;5023;7326;5338;124961;55421;26001;84254;9552;83460;2027;8386;8390;246;23108;388324;23140;10749;55720;55065;1497;5216;23125;124936;4335;8402;124976;4995;51479;83903;2811;5026;400569;5048;443;63826;26189;162514;100130311;9905;7775;388323;124975;23293;7442;409;388325;84690;30851;9098;23277;342527;4994;1145;8387;5694;79066;8383;50488;9032;489;8392;23729;284013;201305;27043;4991;58191;84225;3682,72
-1,1,17,1965674,5161635,3195961,8388;84622;10514;5023;7326;5338;124961;55421;26001;84254;9552;83460;2027;8386;8390;246;23108;388324;23140;10749;55720;55065;1497;5216;23125;124936;4335;8402;124976;4995;51479;83903;2811;5026;400569;5048;443;63826;26189;162514;100130311;9905;7775;388323;124975;23293;7442;409;388325;84690;30851;9098;23277;342527;4994;1145;8387;5694;79066;8383;50488;9032;489;8392;23729;284013;201305;27043;4991;58191;84225;3682,72
1,1,17,1965723,4045177,2079454,8388;443;63826;5023;26189;162514;9905;55421;23293;84254;83460;7442;8386;8390;23108;23140;84690;30851;23277;55720;4994;1497;8387;79066;4335;8383;4995;489;8392;23729;83903;4991;5048;5026;3682,35
-1,1,17,1997443,2825460,828017,4335;23277;55720;23293;63826;79066;9905;23108;5048,9
-1,-1,17,2157929,2234362,76433,23293;63826;55720,3
-1,1,17,2201586,2631484,429898,23277;55720;23293;63826;79066;9905;4335;5048,8
1,1,17,2318075,2625846,307771,23277;5048;79066,3
1,1,17,2339561,2588596,249035,5048;79066,2
-1,1,17,2484513,2670859,186346,5048;23277,2
-1,1,17,2496180,2512300,16120,5048,1
1,1,17,2502864,2528223,25359,5048,1
-1,1,17,2522288,2579941,57653,5048,1
1,1,17,2826023,3339732,513709,4995;8388;4994;8392;8387;4991;8386;8390;26189;23108;8383,11
-1,-1,17,3058762,3447162,388400,4995;8388;4994;8392;8387;443;84690;26189;162514;8383,10
-1,-1,17,3505485,3558334,52849,23729;1497;7442,3
-1,-1,17,3505485,3558334,52849,23729;1497;7442,3
-1,-1,17,3527845,3558334,30489,23729;1497,2
-1,-1,17,3527845,3558334,30489,23729;1497,2
-1,-1,17,3540345,3561266,20921,1497,1
-1,-1,17,3540391,3561146,20755,1497,1
-1,-1,17,3540391,3561146,20755,1497,1
-1,-1,17,3543464,3560089,16625,1497,1
-1,-1,17,3543464,3560089,16625,1497,1
1,-1,17,5441311,5711877,270566,22861,1
1,1,17,5636273,11998666,6362393,6517;201243;388333;23533;643904;388327;6416;284114;51087;56985;6341;9513;3000;5198;26168;433;374768;51003;388336;1984;1973;9340;5957;643664;124944;22899;10462;84314;6844;57659;284111;83394;6154;37;162515;4622;407977;6462;2256;23302;8711;201232;57555;84316;9526;80169;23399;124751;23587;54739;1366;9851;124739;146849;399512;146852;5430;9744;9423;8735;8742;54785;146754;92162;5187;84817;23746;124637;7566;6665;55135;1856;482;59344;9212;100996842;254863;23135;146850;58485;432;440400;4621;8522;339168;83659;146845;242;116840;1949;4620;162517;239;644139;79142;1742;4619;112483;162387;54478;1140;247;1107;84667;8741;29098;9482;57048;147040;388335;7157;255877;1770;968;2874;9196;11337;84461;201140;81565;4628;644070;4626,123
-1,1,17,6564810,6660724,95914,284111;54739,2
-1,1,17,7241916,8692213,1450297,146754;388333;201243;8742;54785;92162;5187;643904;124637;146852;6665;55135;482;59344;100996842;284114;9212;254863;23135;58485;5430;9513;26168;339168;374768;3000;5198;1973;116840;1949;643664;399512;22899;112483;84314;6844;57659;6154;1140;247;8741;1107;407977;84667;29098;57048;147040;6462;7157;2256;8711;968;9196;57555;84316;9526;80169;124751;81565;4628;242;146849;9744,63
-1,1,17,10237826,10803633,565807,56985;4619;8735;6341;4621;4622;388335;4620;4626;644139,10
-1,1,17,10771948,21510992,10739044,9487;2314;9720;125170;54902;11216;79018;256302;6416;93649;9955;254272;7314;8533;388336;5598;218;224;339263;80039;51655;256223;201163;7156;51030;10750;64518;57335;9912;201158;339184;10743;374286;100129396;10626;140775;8834;51393;57547;1819;147166;91647;201161;3996;201164;4239;1352;23326;55244;60528;7566;9611;55090;645027;5606;146822;79999;284194;10400;54890;9706;3768;9953;92521;400581;22905;25979;100996259;729288;23164;83450;353149;51168;5636;644815;125150;10517;654346;388436;27077;388341;6470;6720;146691;1770;284040;125206;5376;23495;100533496;136;57336;146802;56953;7732,95
-1,1,17,14111972,15442178,1330206,1352;64518;9953;201158;284040;100533496;5376;146822,8
1,1,17,14111972,15442178,1330206,1352;64518;9953;201158;284040;100533496;5376;146822,8
1,1,17,14083054,15463054,1380000,1352;64518;9953;201158;284040;100533496;5376;146822,8
-1,1,17,14083054,15475087,1392033,1352;64518;9953;201158;284040;100533496;5376;374286;146822,9
1,1,17,14083054,15491532,1408478,1352;64518;9953;201158;284040;100533496;5376;374286;146822,9
1,1,17,14083054,15491533,1408479,1352;64518;9953;201158;284040;100533496;5376;374286;146822,9
1,1,17,14083054,15567669,1484615,1352;64518;9953;201158;284040;100533496;5376;374286;146822;10626,10
-1,1,17,14087787,15473312,1385525,1352;64518;9953;201158;284040;100533496;5376;374286;146822,9
-1,1,17,14087787,15483608,1395821,1352;64518;9953;201158;284040;100533496;5376;374286;146822,9
-1,1,17,14087787,15490100,1402313,1352;64518;9953;201158;284040;100533496;5376;374286;146822,9
1,1,17,14087933,15437330,1349397,1352;64518;9953;201158;284040;100533496;5376;146822,8
1,1,17,14087933,15484358,1396425,1352;64518;9953;201158;284040;100533496;5376;374286;146822,9
-1,1,17,14087933,15484858,1396925,1352;64518;9953;201158;284040;100533496;5376;374286;146822,9
1,1,17,14087933,15484858,1396925,1352;64518;9953;201158;284040;100533496;5376;374286;146822,9
1,1,17,14087933,15484858,1396925,1352;64518;9953;201158;284040;100533496;5376;374286;146822,9
1,1,17,14087933,15484858,1396925,1352;64518;9953;201158;284040;100533496;5376;374286;146822,9
-1,1,17,14087933,15484859,1396926,1352;64518;9953;201158;284040;100533496;5376;374286;146822,9
1,1,17,14087933,15490100,1402167,1352;64518;9953;201158;284040;100533496;5376;374286;146822,9
-1,1,17,14087933,15491532,1403599,1352;64518;9953;201158;284040;100533496;5376;374286;146822,9
1,1,17,14087933,15491532,1403599,1352;64518;9953;201158;284040;100533496;5376;374286;146822,9
1,1,17,14087933,15500645,1412712,1352;64518;9953;201158;284040;100533496;5376;374286;146822,9
1,1,17,14087933,15500645,1412712,1352;64518;9953;201158;284040;100533496;5376;374286;146822,9
1,1,17,14090300,15473590,1383290,1352;64518;9953;201158;284040;100533496;5376;374286;146822,9
-1,1,17,14098660,15500645,1401985,1352;64518;9953;201158;284040;100533496;5376;374286;146822,9
1,1,17,14098660,15501133,1402473,1352;64518;9953;201158;284040;100533496;5376;374286;146822,9
-1,1,17,14100118,15455238,1355120,1352;64518;9953;201158;284040;100533496;5376;146822,8
-1,1,17,14100118,15455238,1355120,1352;64518;9953;201158;284040;100533496;5376;146822,8
1,1,17,14100118,15458649,1358531,1352;64518;9953;201158;284040;100533496;5376;146822,8
1,1,17,14100118,15492400,1392282,1352;64518;9953;201158;284040;100533496;5376;374286;146822,9
1,1,17,14111772,15442066,1330294,1352;64518;9953;201158;284040;100533496;5376;146822,8
1,1,17,14111772,15442066,1330294,1352;64518;9953;201158;284040;100533496;5376;146822,8
-1,1,17,14111772,15442066,1330294,1352;64518;9953;201158;284040;100533496;5376;146822,8
1,1,17,14111772,15442066,1330294,1352;64518;9953;201158;284040;100533496;5376;146822,8
-1,1,17,14111772,15442066,1330294,1352;64518;9953;201158;284040;100533496;5376;146822,8
-1,1,17,14111772,15442066,1330294,1352;64518;9953;201158;284040;100533496;5376;146822,8
1,1,17,14111772,15442066,1330294,1352;64518;9953;201158;284040;100533496;5376;146822,8
-1,1,17,14111772,15442066,1330294,1352;64518;9953;201158;284040;100533496;5376;146822,8
-1,1,17,14111772,15442066,1330294,1352;64518;9953;201158;284040;100533496;5376;146822,8
-1,1,17,14111772,15442066,1330294,1352;64518;9953;201158;284040;100533496;5376;146822,8
1,1,17,14111772,15442066,1330294,1352;64518;9953;201158;284040;100533496;5376;146822,8
1,1,17,14111772,15442066,1330294,1352;64518;9953;201158;284040;100533496;5376;146822,8
-1,1,17,14111772,15442069,1330297,1352;64518;9953;201158;284040;100533496;5376;146822,8
1,1,17,14111772,15442069,1330297,1352;64518;9953;201158;284040;100533496;5376;146822,8
1,1,17,14111772,15442069,1330297,1352;64518;9953;201158;284040;100533496;5376;146822,8
-1,1,17,14111772,15442069,1330297,1352;64518;9953;201158;284040;100533496;5376;146822,8
1,1,17,14111772,15482872,1371100,1352;64518;9953;201158;284040;100533496;5376;374286;146822,9
1,1,17,14111772,15482872,1371100,1352;64518;9953;201158;284040;100533496;5376;374286;146822,9
1,1,17,14111772,15482872,1371100,1352;64518;9953;201158;284040;100533496;5376;374286;146822,9
1,1,17,14111772,15482872,1371100,1352;64518;9953;201158;284040;100533496;5376;374286;146822,9
1,1,17,14111772,15482872,1371100,1352;64518;9953;201158;284040;100533496;5376;374286;146822,9
-1,1,17,14111772,15482872,1371100,1352;64518;9953;201158;284040;100533496;5376;374286;146822,9
-1,1,17,14111772,15491748,1379976,1352;64518;9953;201158;284040;100533496;5376;374286;146822,9
-1,1,17,14131948,15442178,1310230,64518;9953;201158;146822;284040;100533496;5376,7
1,-1,17,14368263,14423007,54744,,0
-1,1,17,14574435,15856310,1281875,64518;57335;201158;284040;100533496;5376;136;374286;353149;10626,10
-1,1,17,14970116,17375771,2405655,9487;64518;9720;57335;201158;9611;54902;374286;201161;100129396;10626;388341;51393;57547;7314;8533;284040;100533496;5376;136;57336;23495;23164;353149;56953;201163;125150;201164,28
1,1,17,15093600,15856310,762710,64518;57335;201158;284040;100533496;5376;136;374286;353149;10626,10
1,1,17,15113717,18184130,3070413,9487;2314;9720;125170;9611;54902;55090;79018;10400;54890;7314;8533;23164;83450;353149;51168;51655;201163;7156;125150;64518;57335;201158;10743;374286;100129396;10626;388341;51393;57547;6720;146691;1819;284040;100533496;5376;136;57336;23495;91647;56953;201161;3996;201164,44
1,1,17,15455676,18917513,3461837,9487;2314;9720;125170;9611;54902;55090;79018;10400;54890;254272;7314;8533;729288;23164;83450;353149;51168;80039;51655;201163;7156;51030;5636;125150;644815;10517;57335;654346;201158;10743;374286;100129396;10626;140775;388341;51393;57547;6720;146691;1819;6470;100533496;136;23495;57336;125206;147166;91647;56953;201161;645027;3996;201164,54
-1,1,17,15633207,20413564,4780357,9487;2314;9720;125170;54902;11216;79018;254272;7314;8533;5598;218;224;80039;51655;201163;7156;51030;10750;10743;100129396;140775;51393;57547;1819;147166;7732;91647;201161;3996;4239;201164;55244;9611;55090;645027;79999;284194;10400;54890;9706;92521;22905;729288;100996259;23164;83450;353149;51168;5636;644815;125150;10517;654346;388436;27077;388341;6470;6720;146691;136;23495;57336;125206;146802;56953;400581,67
1,-1,17,15633426,15648509,15083,353149,1
1,-1,17,15633426,15648509,15083,353149,1
1,-1,17,15633426,15648509,15083,353149,1
1,-1,17,15633426,15648509,15083,353149,1
1,-1,17,15633426,15648509,15083,353149,1
1,-1,17,15633426,15648509,15083,353149,1
-1,-1,17,15633426,15664206,30780,353149,1
-1,-1,17,15633426,15664206,30780,353149,1
-1,-1,17,15633426,15664206,30780,353149,1
1,-1,17,15637681,15674162,36481,353149,1
1,-1,17,15637681,15674162,36481,353149,1
1,-1,17,15638231,15648509,10278,353149,1
1,-1,17,15638231,15648509,10278,353149,1
1,-1,17,15638231,15648509,10278,353149,1
1,-1,17,15638231,15648509,10278,353149,1
1,-1,17,15638231,15648509,10278,353149,1
1,-1,17,15638231,15648509,10278,353149,1
1,-1,17,15638231,15648509,10278,353149,1
1,-1,17,15638231,15648509,10278,353149,1
1,-1,17,15638231,15648509,10278,353149,1
1,-1,17,15638231,15648509,10278,353149,1
1,-1,17,15638231,15664206,25975,353149,1
1,-1,17,15638231,15664206,25975,353149,1
1,-1,17,15648509,15674162,25653,,0
1,-1,17,15648509,15674162,25653,,0
-1,-1,17,15680229,15696860,16631,,0
1,1,17,15713010,20581410,4868400,9487;2314;9720;125170;54902;11216;79018;254272;7314;8533;5598;218;224;80039;51655;256223;201163;7156;51030;10750;10743;100129396;140775;51393;57547;1819;147166;7732;91647;201161;3996;4239;201164;55244;9611;55090;645027;79999;284194;10400;54890;9706;92521;22905;729288;100996259;23164;83450;51168;5636;644815;125150;10517;654346;388436;27077;388341;6470;6720;146691;136;23495;57336;125206;146802;56953;400581,67
-1,1,17,15745315,20261191,4515876,9487;2314;9720;125170;54902;11216;79018;254272;7314;8533;5598;218;224;80039;51655;201163;7156;51030;10750;10743;100129396;140775;51393;57547;1819;147166;7732;91647;201161;3996;4239;201164;55244;9611;55090;645027;79999;10400;54890;9706;92521;22905;729288;23164;83450;51168;5636;644815;125150;10517;654346;388436;27077;388341;6470;6720;146691;136;23495;57336;125206;146802;56953;400581,64
-1,1,17,15754173,20552548,4798375,9487;2314;9720;125170;54902;11216;79018;254272;7314;8533;5598;218;224;80039;51655;256223;201163;7156;51030;10750;10743;100129396;140775;51393;57547;1819;147166;7732;91647;201161;3996;4239;201164;55244;9611;55090;645027;79999;284194;10400;54890;9706;92521;22905;729288;100996259;23164;83450;51168;5636;644815;125150;10517;654346;388436;27077;388341;6470;6720;146691;136;23495;57336;125206;146802;56953;400581,67
-1,1,17,15763752,20615408,4851656,9487;2314;9720;125170;54902;11216;79018;254272;7314;8533;5598;218;224;80039;51655;256223;201163;7156;51030;10750;10743;100129396;140775;51393;57547;1819;147166;7732;91647;201161;3996;4239;201164;55244;9611;55090;645027;79999;284194;10400;54890;9706;92521;22905;729288;100996259;23164;83450;51168;5636;644815;125150;10517;654346;388436;27077;388341;6470;6720;146691;136;23495;57336;125206;146802;56953;400581,67
-1,1,17,15786351,20524013,4737662,9487;2314;9720;125170;54902;11216;79018;254272;7314;8533;5598;218;224;80039;51655;256223;201163;7156;51030;10750;10743;100129396;140775;51393;57547;1819;147166;7732;91647;201161;3996;4239;201164;55244;9611;55090;645027;79999;284194;10400;54890;9706;92521;22905;729288;100996259;23164;83450;51168;5636;644815;125150;10517;654346;388436;27077;388341;6470;6720;146691;136;23495;57336;125206;146802;56953;400581,67
-1,1,17,15786351,20561331,4774980,9487;2314;9720;125170;54902;11216;79018;254272;7314;8533;5598;218;224;80039;51655;256223;201163;7156;51030;10750;10743;100129396;140775;51393;57547;1819;147166;7732;91647;201161;3996;4239;201164;55244;9611;55090;645027;79999;284194;10400;54890;9706;92521;22905;729288;100996259;23164;83450;51168;5636;644815;125150;10517;654346;388436;27077;388341;6470;6720;146691;136;23495;57336;125206;146802;56953;400581,67
1,1,17,16329947,20901901,4571954,2314;9720;55244;125170;55090;11216;79018;79999;284194;645027;10400;54890;254272;9706;92521;8533;22905;729288;100996259;5598;218;23164;83450;224;51168;80039;51655;256223;201163;7156;51030;5636;644815;10750;10517;654346;339184;10743;388436;27077;100129396;140775;388341;51393;57547;146691;6720;1819;6470;125206;23495;57336;147166;7732;146802;91647;56953;201164;400581;3996;4239,61
1,-1,17,16527734,16722779,195045,9720;57547;100129396,3
-1,1,17,16559476,20294010,3734534,2314;9720;55244;125170;55090;11216;79018;79999;10400;54890;254272;9706;400581;92521;8533;22905;729288;5598;218;23164;83450;224;51168;80039;51655;201163;7156;51030;5636;644815;10750;4239;10517;654346;10743;388436;27077;100129396;140775;6470;146691;1819;6720;125206;23495;147166;7732;146802;91647;56953;645027;3996;201164,53
1,-1,17,16581147,16631051,49904,9720,1
1,1,17,16581524,20376764,3795240,2314;9720;55244;125170;55090;11216;79018;79999;284194;10400;54890;254272;9706;400581;92521;8533;22905;729288;100996259;5598;218;23164;83450;224;51168;80039;51655;201163;7156;51030;5636;644815;10750;4239;10517;654346;10743;388436;27077;100129396;140775;6470;146691;1819;6720;125206;23495;147166;7732;146802;91647;56953;645027;3996;201164,55
-1,1,17,16581524,20434651,3853127,2314;9720;55244;125170;55090;11216;79018;79999;284194;10400;54890;254272;9706;400581;92521;8533;22905;729288;100996259;5598;218;23164;83450;224;51168;80039;51655;201163;7156;51030;5636;644815;10750;4239;10517;654346;10743;388436;27077;100129396;140775;6470;146691;1819;6720;125206;23495;147166;7732;146802;91647;56953;645027;3996;201164,55
-1,1,17,16581524,20464320,3882796,2314;9720;55244;125170;55090;11216;79018;79999;284194;10400;54890;254272;9706;400581;92521;8533;22905;729288;100996259;5598;218;23164;83450;224;51168;80039;51655;201163;7156;51030;5636;644815;10750;4239;10517;654346;10743;388436;27077;100129396;140775;6470;146691;1819;6720;125206;23495;147166;7732;146802;91647;56953;645027;3996;201164,55
1,1,17,16591260,20473937,3882677,2314;9720;55244;125170;55090;11216;79018;79999;284194;10400;54890;254272;9706;400581;92521;8533;22905;729288;100996259;5598;218;23164;83450;224;51168;80039;51655;201163;7156;51030;5636;644815;10750;4239;10517;654346;10743;388436;27077;100129396;140775;6470;146691;1819;6720;125206;23495;147166;7732;146802;91647;56953;645027;3996;201164,55
1,1,17,16600022,20396173,3796151,2314;9720;55244;125170;55090;11216;79018;79999;284194;645027;10400;54890;254272;9706;92521;8533;22905;729288;100996259;5598;218;23164;83450;224;51168;80039;51655;201163;7156;51030;5636;644815;10750;10517;654346;10743;388436;27077;100129396;140775;6470;146691;1819;6720;125206;23495;147166;7732;146802;91647;56953;201164;400581;3996;4239,55
1,1,17,16603008,20433959,3830951,2314;9720;55244;125170;55090;11216;79018;79999;284194;645027;10400;54890;254272;9706;92521;8533;22905;729288;100996259;5598;218;23164;83450;224;51168;80039;51655;201163;7156;51030;5636;644815;10750;10517;654346;10743;388436;27077;100129396;140775;6470;146691;1819;6720;125206;23495;147166;7732;146802;91647;56953;201164;400581;3996;4239,55
-1,1,17,16603130,20261191,3658061,2314;9720;55244;125170;55090;11216;79018;79999;645027;10400;54890;254272;9706;92521;8533;22905;729288;5598;218;23164;83450;224;51168;80039;51655;201163;7156;51030;5636;644815;10750;10517;654346;10743;388436;27077;100129396;140775;6470;146691;1819;6720;125206;23495;147166;7732;146802;91647;56953;201164;400581;3996;4239,53
-1,1,17,16603130,20294038,3690908,2314;9720;55244;125170;55090;11216;79018;79999;645027;10400;54890;254272;9706;92521;8533;22905;729288;5598;218;23164;83450;224;51168;80039;51655;201163;7156;51030;5636;644815;10750;10517;654346;10743;388436;27077;100129396;140775;6470;146691;1819;6720;125206;23495;147166;7732;146802;91647;56953;201164;400581;3996;4239,53
-1,1,17,16603130,20331605,3728475,2314;9720;55244;125170;55090;11216;79018;79999;645027;10400;54890;254272;9706;92521;8533;22905;729288;100996259;5598;218;23164;83450;224;51168;80039;51655;201163;7156;51030;5636;644815;10750;10517;654346;10743;388436;27077;100129396;140775;6470;146691;1819;6720;125206;23495;147166;7732;146802;91647;56953;201164;400581;3996;4239,54
1,1,17,16603130,20395527,3792397,2314;9720;55244;125170;55090;11216;79018;79999;284194;645027;10400;54890;254272;9706;92521;8533;22905;729288;100996259;5598;218;23164;83450;224;51168;80039;51655;201163;7156;51030;5636;644815;10750;10517;654346;10743;388436;27077;100129396;140775;6470;146691;1819;6720;125206;23495;147166;7732;146802;91647;56953;201164;400581;3996;4239,55
1,1,17,16621729,20449523,3827794,2314;9720;55244;125170;55090;11216;79018;79999;284194;645027;10400;54890;254272;9706;92521;8533;22905;729288;100996259;5598;218;23164;83450;224;51168;80039;51655;201163;7156;51030;5636;644815;10750;10517;654346;10743;388436;27077;100129396;140775;6470;146691;1819;6720;125206;23495;147166;7732;146802;91647;56953;201164;400581;3996;4239,55
-1,1,17,16637872,20294010,3656138,2314;9720;55244;125170;55090;11216;79018;79999;645027;10400;54890;254272;9706;92521;8533;22905;729288;5598;218;23164;83450;224;51168;80039;51655;201163;7156;51030;5636;644815;10750;10517;654346;10743;388436;27077;100129396;140775;6470;146691;1819;6720;125206;23495;147166;7732;146802;91647;56953;201164;400581;3996;4239,53
1,1,17,16637872,20294010,3656138,2314;9720;55244;125170;55090;11216;79018;79999;645027;10400;54890;254272;9706;92521;8533;22905;729288;5598;218;23164;83450;224;51168;80039;51655;201163;7156;51030;5636;644815;10750;10517;654346;10743;388436;27077;100129396;140775;6470;146691;1819;6720;125206;23495;147166;7732;146802;91647;56953;201164;400581;3996;4239,53
-1,1,17,16637902,18236686,1598784,2314;9720;7156;10743;125170;55090;79018;100129396;140775;10400;54890;6470;146691;1819;6720;8533;56953;23495;23164;83450;51168;51655;91647;201163;3996;201164,26
-1,1,17,16637902,18738016,2100114,2314;9720;125170;55090;79018;10400;54890;254272;8533;729288;23164;83450;51168;80039;51655;201163;7156;51030;10517;654346;10743;100129396;140775;6470;146691;1819;6720;23495;147166;91647;56953;645027;3996;201164,34
-1,1,17,16637902,20219464,3581562,2314;9720;55244;125170;55090;11216;79018;79999;645027;10400;54890;254272;9706;92521;8533;22905;729288;5598;218;23164;83450;224;51168;80039;51655;201163;7156;51030;5636;644815;10750;10517;654346;10743;388436;27077;100129396;140775;6470;146691;1819;6720;125206;23495;147166;7732;146802;91647;56953;201164;400581;3996;4239,53
-1,1,17,16637902,20261250,3623348,2314;9720;55244;125170;55090;11216;79018;79999;645027;10400;54890;254272;9706;92521;8533;22905;729288;5598;218;23164;83450;224;51168;80039;51655;201163;7156;51030;5636;644815;10750;10517;654346;10743;388436;27077;100129396;140775;6470;146691;1819;6720;125206;23495;147166;7732;146802;91647;56953;201164;400581;3996;4239,53
-1,1,17,16637902,20294038,3656136,2314;9720;55244;125170;55090;11216;79018;79999;645027;10400;54890;254272;9706;92521;8533;22905;729288;5598;218;23164;83450;224;51168;80039;51655;201163;7156;51030;5636;644815;10750;10517;654346;10743;388436;27077;100129396;140775;6470;146691;1819;6720;125206;23495;147166;7732;146802;91647;56953;201164;400581;3996;4239,53
-1,1,17,16637902,20294038,3656136,2314;9720;55244;125170;55090;11216;79018;79999;645027;10400;54890;254272;9706;92521;8533;22905;729288;5598;218;23164;83450;224;51168;80039;51655;201163;7156;51030;5636;644815;10750;10517;654346;10743;388436;27077;100129396;140775;6470;146691;1819;6720;125206;23495;147166;7732;146802;91647;56953;201164;400581;3996;4239,53
-1,1,17,16637902,20294038,3656136,2314;9720;55244;125170;55090;11216;79018;79999;645027;10400;54890;254272;9706;92521;8533;22905;729288;5598;218;23164;83450;224;51168;80039;51655;201163;7156;51030;5636;644815;10750;10517;654346;10743;388436;27077;100129396;140775;6470;146691;1819;6720;125206;23495;147166;7732;146802;91647;56953;201164;400581;3996;4239,53
-1,1,17,16637902,20294038,3656136,2314;9720;55244;125170;55090;11216;79018;79999;645027;10400;54890;254272;9706;92521;8533;22905;729288;5598;218;23164;83450;224;51168;80039;51655;201163;7156;51030;5636;644815;10750;10517;654346;10743;388436;27077;100129396;140775;6470;146691;1819;6720;125206;23495;147166;7732;146802;91647;56953;201164;400581;3996;4239,53
-1,1,17,16651292,18722974,2071682,2314;9720;125170;55090;79018;10400;54890;254272;8533;729288;23164;83450;51168;80039;51655;201163;7156;51030;10517;654346;10743;100129396;140775;6470;146691;1819;6720;23495;147166;91647;56953;645027;3996;201164,34
1,1,17,16651292,20437532,3786240,2314;9720;55244;125170;55090;11216;79018;79999;284194;645027;10400;54890;254272;9706;92521;8533;22905;729288;100996259;5598;218;23164;83450;224;51168;80039;51655;201163;7156;51030;5636;644815;10750;10517;654346;10743;388436;27077;100129396;140775;6470;146691;1819;6720;125206;23495;147166;7732;146802;91647;56953;201164;400581;3996;4239,55
1,-1,17,16691204,16722779,31575,100129396,1
1,-1,17,16691204,16722779,31575,100129396,1
1,-1,17,16691204,16722779,31575,100129396,1
1,-1,17,16691204,16722779,31575,100129396,1
1,-1,17,16697042,16722779,25737,,0
1,-1,17,16697042,16722779,25737,,0
-1,1,17,16727264,20395889,3668625,2314;55244;125170;55090;11216;79018;79999;284194;10400;54890;254272;9706;400581;92521;8533;22905;729288;100996259;5598;218;23164;83450;224;51168;80039;51655;201163;7156;51030;5636;644815;10750;4239;10517;654346;10743;388436;27077;140775;6470;146691;1819;6720;125206;23495;147166;7732;146802;91647;56953;645027;3996;201164,53
-1,1,17,16727264,20413564,3686300,2314;55244;125170;55090;11216;79018;79999;284194;10400;54890;254272;9706;400581;92521;8533;22905;729288;100996259;5598;218;23164;83450;224;51168;80039;51655;201163;7156;51030;5636;644815;10750;4239;10517;654346;10743;388436;27077;140775;6470;146691;1819;6720;125206;23495;147166;7732;146802;91647;56953;645027;3996;201164,53
1,1,17,16738161,20338182,3600021,2314;55244;125170;55090;11216;79018;79999;10400;54890;254272;9706;400581;92521;8533;22905;729288;100996259;5598;218;23164;83450;224;51168;80039;51655;201163;7156;51030;5636;644815;10750;4239;10517;654346;10743;388436;27077;140775;6470;146691;1819;6720;125206;23495;147166;7732;146802;91647;56953;645027;3996;201164,52
1,1,17,16740141,20261191,3521050,2314;55244;125170;55090;11216;79018;79999;10400;54890;254272;9706;400581;92521;8533;22905;729288;5598;218;23164;83450;224;51168;80039;51655;201163;7156;51030;5636;644815;10750;4239;10517;654346;10743;388436;27077;140775;6470;146691;1819;6720;125206;23495;147166;7732;146802;91647;56953;645027;3996;201164,51
-1,1,17,16741411,20304154,3562743,2314;55244;125170;55090;11216;79018;79999;10400;54890;254272;9706;400581;92521;8533;22905;729288;5598;218;23164;83450;224;51168;80039;51655;201163;7156;51030;5636;644815;10750;4239;10517;654346;10743;388436;27077;140775;6470;146691;1819;6720;125206;23495;147166;7732;146802;91647;56953;645027;3996;201164,51
-1,1,17,16741411,20339728,3598317,2314;55244;125170;55090;11216;79018;79999;10400;54890;254272;9706;400581;92521;8533;22905;729288;100996259;5598;218;23164;83450;224;51168;80039;51655;201163;7156;51030;5636;644815;10750;4239;10517;654346;10743;388436;27077;140775;6470;146691;1819;6720;125206;23495;147166;7732;146802;91647;56953;645027;3996;201164,52
-1,1,17,16741411,20408379,3666968,2314;55244;125170;55090;11216;79018;79999;284194;10400;54890;254272;9706;400581;92521;8533;22905;729288;100996259;5598;218;23164;83450;224;51168;80039;51655;201163;7156;51030;5636;644815;10750;4239;10517;654346;10743;388436;27077;140775;6470;146691;1819;6720;125206;23495;147166;7732;146802;91647;56953;645027;3996;201164,53
-1,1,17,16741411,20410218,3668807,2314;55244;125170;55090;11216;79018;79999;284194;10400;54890;254272;9706;400581;92521;8533;22905;729288;100996259;5598;218;23164;83450;224;51168;80039;51655;201163;7156;51030;5636;644815;10750;4239;10517;654346;10743;388436;27077;140775;6470;146691;1819;6720;125206;23495;147166;7732;146802;91647;56953;645027;3996;201164,53
-1,1,17,16741411,20449523,3708112,2314;55244;125170;55090;11216;79018;79999;284194;10400;54890;254272;9706;400581;92521;8533;22905;729288;100996259;5598;218;23164;83450;224;51168;80039;51655;201163;7156;51030;5636;644815;10750;4239;10517;654346;10743;388436;27077;140775;6470;146691;1819;6720;125206;23495;147166;7732;146802;91647;56953;645027;3996;201164,53
-1,1,17,16741411,20489023,3747612,2314;55244;125170;55090;11216;79018;79999;284194;10400;54890;254272;9706;400581;92521;8533;22905;729288;100996259;5598;218;23164;83450;224;51168;80039;51655;256223;201163;7156;51030;5636;644815;10750;4239;10517;654346;10743;388436;27077;140775;6470;146691;1819;6720;125206;23495;147166;7732;146802;91647;56953;645027;3996;201164,54
1,1,17,16741771,20430791,3689020,2314;55244;125170;55090;11216;79018;79999;284194;10400;54890;254272;9706;400581;92521;8533;22905;729288;100996259;5598;218;23164;83450;224;51168;80039;51655;201163;7156;51030;5636;644815;10750;4239;10517;654346;10743;388436;27077;140775;6470;146691;1819;6720;125206;23495;147166;7732;146802;91647;56953;645027;3996;201164,53
-1,1,17,16745600,20396173,3650573,2314;55244;125170;55090;11216;79018;79999;284194;10400;54890;254272;9706;400581;92521;8533;22905;729288;100996259;5598;218;23164;83450;224;51168;80039;51655;201163;7156;51030;5636;644815;10750;4239;10517;654346;10743;388436;27077;140775;6470;146691;1819;6720;125206;23495;147166;7732;146802;91647;56953;645027;3996;201164,53
-1,1,17,16756434,20339795,3583361,2314;55244;125170;55090;11216;79018;79999;10400;54890;254272;9706;400581;92521;8533;22905;729288;100996259;5598;218;23164;83450;224;51168;80039;51655;201163;7156;51030;5636;644815;10750;4239;10517;654346;10743;388436;27077;140775;6470;146691;1819;6720;125206;23495;147166;7732;146802;91647;56953;645027;3996;201164,52
1,1,17,16757563,81048189,64290626,83900;91608;2896;55040;83899;26502;9931;2688;91107;439921;146853;5598;8678;201292;147183;7343;51655;57508;348235;332;10750;1394;7448;1659;786;1442;10966;2793;85285;51181;65264;113235;3728;57597;100130370;54757;84440;100132386;100462977;91647;284129;51629;80179;3872;64750;201164;9020;55244;80022;3131;28958;3607;283991;5606;9123;7473;55731;55181;81558;400591;22905;117246;100996259;284067;1468;9400;5881;9094;3690;10458;7756;90507;92579;100506084;146909;317719;6388;728255;284071;1444;374819;2302;8687;51529;8851;25926;84313;4222;3213;64122;8631;125061;64772;125206;23495;11056;2689;54894;9570;9703;284021;10493;9625;10615;672;6928;84951;51649;388403;284119;342510;974;54883;2064;1277;23131;10513;3216;146664;347741;84669;6521;22834;6909;6904;1655;246744;2081;57409;147007;9021;6613;2194;83990;146713;80755;8834;516;474170;730755;6426;22843;114897;7126;3858;3219;79154;26073;6752;3292;4239;124912;5691;4591;2125;81851;5573;5914;3866;752;6368;79999;3487;30833;8165;124599;79877;26284;22794;81870;162466;3691;84961;51195;3993;9618;79922;10609;8714;644815;84616;100505724;79755;6774;3868;22994;10871;27091;94103;29893;80725;5175;85291;2232;124540;256933;6470;10693;440435;26022;10197;8557;3211;2670;124872;125111;11143;7732;54474;4137;8153;6169;92591;125170;57125;79170;81671;728318;100506650;5705;283985;124512;147111;6349;2905;218;101060321;9110;60386;80039;1411;6358;350;255061;360205;125113;9058;339184;4843;57332;57521;10266;90506;642;51326;4215;57003;284086;23531;79637;91607;64149;6356;6945;10349;79415;162333;388419;94015;84643;8632;353288;1353;252983;8639;3996;124801;51321;2584;146894;4097;8877;23326;8313;6397;11248;6354;54799;3880;7484;51204;7706;10209;9706;54890;92340;100505591;283999;3838;25979;284018;55808;8148;51547;11276;92736;342667;25984;8456;284076;5414;201254;11325;654346;9349;55876;2826;768206;2873;56970;146779;201255;6720;10350;55666;728279;9489;26115;85290;6777;2145;255275;10948;147011;56953;2648;64847;146956;9862;5889;5718;55106;80221;100130520;201191;50964;51379;3980;3021;100134391;79058;84940;162605;30850;83902;388364;6871;124923;9256;339230;7716;1236;4804;140735;51;9572;85464;9267;2319;51225;100130933;124773;2548;79157;5831;27092;9368;9382;84282;284001;84152;9326;390790;3927;6427;4836;30009;6143;55090;4884;85302;28964;284194;388394;162461;4779;374786;3837;9755;4830;2538;51701;5636;284099;6532;8396;3675;60681;57602;27077;4974;80347;7067;81871;83538;284161;6730;404093;3215;26118;79701;54752;4635;11072;535;388389;1267;100885850;11267;92335;51747;3430;84687;91603;9842;654364;26207;10801;350383;339231;653240;11216;57151;124602;83895;84336;6362;339263;6352;146862;201294;256223;51030;5245;399687;55036;342538;124925;100131439;3674;7266;101927581;64978;8161;9144;57513;51651;51755;78995;51081;79643;10614;1362;100505753;124995;9496;4763;124842;83755;2520;125058;6357;3882;124783;6662;100134934;9121;5409;1443;124817;6351;83901;124583;147179;64118;3857;284207;55379;92521;25794;6198;163;5469;84514;57551;782;51168;124565;8844;23512;162417;3212;146723;5034;6668;201181;26574;5986;6830;7283;54903;57649;23098;28511;26083;56934;201266;55175;4642;81033;2695;55316;6448;146802;8405;342618;201134;113026;5164;1747;9527;79148;55890;256302;51751;55028;254272;11232;6347;85451;8533;23265;10351;3884;414059;2186;2123;10140;3886;7156;162494;113277;6155;10476;6346;10743;5578;57690;9146;9520;5717;10237;4353;728224;390792;5697;2118;85280;22806;339210;10610;23415;55771;6348;51268;116729;84081;4355;40;6605;3060;5608;116238;79915;8787;9969;230;6359;124535;1845;924;47;3768;71;124857;996;729288;100533177;51264;23210;83871;101060376;84299;2885;11314;8506;4761;80174;124930;146722;3396;56155;124808;10052;5539;11011;79651;31;3384;51155;85294;114757;284131;348262;100170841;6398;8526;642843;3885;3881;8493;762;23558;26151;58488;146705;192666;79672;645027;379;10241;100653515;55062;10900;100885848;339287;3975;84366;84923;79893;7153;10882;1213;283987;7077;388381;55852;10672;9120;116236;83882;29115;388407;55813;57674;8689;146923;55803;59342;54475;30837;3859;2886;81872;26689;8811;162427;2642;2124;284184;3883;2535;8913;57532;63897;55273;6827;1534;6182;8288;284098;3860;91369;9343;9560;5148;147166;10642;645832;5892;51136;23461;23510;65266;9884;79736;201299;5878;9775;4669;10014;84073;27346;83897;729877;83896;54828;115024;8535;729873;10400;114804;5709;284004;29916;10040;9902;4302;23580;146861;1636;79092;400629;81850;79089;100506736;146712;94005;90313;326624;5635;162540;4831;79902;3773;23163;57636;201176;201229;284186;100507608;990;4905;146691;51174;55288;9772;339221;55352;339175;11322;147015;124590;3965;9220;314;10238;90799;6603;93210;85293;5193;124626;117584;2314;284069;10189;1440;79665;6776;90410;84733;10481;79018;100132476;6329;146857;79990;3861;224;15;100141515;201163;80233;147184;85289;124989;6355;84311;8688;494188;9043;51096;140775;4185;1819;342574;3959;114659;414062;79777;6147;3214;3759;284083;5833;114881;80774;1018;79132;284058;22901;284106;80279;56270;84074;2837;3218;64446;124790;80320;94086;64132;6360;23164;83450;54868;353174;63893;10517;125115;4356;1748;339229;283989;388436;162282;54549;414060;9001;3217;396;256957;23460;55163;4025;9241;729220;147138;124538;1453;643008;51226;4077;27175;7083;10951;7703;162394;104909134;6442;400581;284110;246176;1101,875
-1,1,17,16757564,20261191,3503627,2314;55244;125170;55090;11216;79018;79999;10400;54890;254272;9706;400581;92521;8533;22905;729288;5598;218;23164;83450;224;51168;80039;51655;201163;7156;51030;5636;644815;10750;4239;10517;654346;10743;388436;27077;140775;6470;146691;1819;6720;125206;23495;147166;7732;146802;91647;56953;645027;3996;201164,51
1,1,17,16757564,20395482,3637918,2314;55244;125170;55090;11216;79018;79999;284194;10400;54890;254272;9706;400581;92521;8533;22905;729288;100996259;5598;218;23164;83450;224;51168;80039;51655;201163;7156;51030;5636;644815;10750;4239;10517;654346;10743;388436;27077;140775;6470;146691;1819;6720;125206;23495;147166;7732;146802;91647;56953;645027;3996;201164,53
1,1,17,16757564,20395527,3637963,2314;55244;125170;55090;11216;79018;79999;284194;10400;54890;254272;9706;400581;92521;8533;22905;729288;100996259;5598;218;23164;83450;224;51168;80039;51655;201163;7156;51030;5636;644815;10750;4239;10517;654346;10743;388436;27077;140775;6470;146691;1819;6720;125206;23495;147166;7732;146802;91647;56953;645027;3996;201164,53
1,1,17,16757564,20463361,3705797,2314;55244;125170;55090;11216;79018;79999;284194;10400;54890;254272;9706;400581;92521;8533;22905;729288;100996259;5598;218;23164;83450;224;51168;80039;51655;201163;7156;51030;5636;644815;10750;4239;10517;654346;10743;388436;27077;140775;6470;146691;1819;6720;125206;23495;147166;7732;146802;91647;56953;645027;3996;201164,53
-1,1,17,16761814,20304295,3542481,2314;55244;125170;55090;11216;79018;79999;10400;54890;254272;9706;400581;92521;8533;22905;729288;5598;218;23164;83450;224;51168;80039;51655;201163;7156;51030;5636;644815;10750;4239;10517;654346;10743;388436;27077;140775;6470;146691;1819;6720;125206;23495;147166;7732;146802;91647;56953;645027;3996;201164,51
1,1,17,16761814,20339795,3577981,2314;55244;125170;55090;11216;79018;79999;10400;54890;254272;9706;400581;92521;8533;22905;729288;100996259;5598;218;23164;83450;224;51168;80039;51655;201163;7156;51030;5636;644815;10750;4239;10517;654346;10743;388436;27077;140775;6470;146691;1819;6720;125206;23495;147166;7732;146802;91647;56953;645027;3996;201164,52
-1,1,17,16761814,20462650,3700836,2314;55244;125170;55090;11216;79018;79999;284194;10400;54890;254272;9706;400581;92521;8533;22905;729288;100996259;5598;218;23164;83450;224;51168;80039;51655;201163;7156;51030;5636;644815;10750;4239;10517;654346;10743;388436;27077;140775;6470;146691;1819;6720;125206;23495;147166;7732;146802;91647;56953;645027;3996;201164,53
-1,1,17,16761814,20462723,3700909,2314;55244;125170;55090;11216;79018;79999;284194;10400;54890;254272;9706;400581;92521;8533;22905;729288;100996259;5598;218;23164;83450;224;51168;80039;51655;201163;7156;51030;5636;644815;10750;4239;10517;654346;10743;388436;27077;140775;6470;146691;1819;6720;125206;23495;147166;7732;146802;91647;56953;645027;3996;201164,53
1,1,17,16761814,20474268,3712454,2314;55244;125170;55090;11216;79018;79999;284194;10400;54890;254272;9706;400581;92521;8533;22905;729288;100996259;5598;218;23164;83450;224;51168;80039;51655;201163;7156;51030;5636;644815;10750;4239;10517;654346;10743;388436;27077;140775;6470;146691;1819;6720;125206;23495;147166;7732;146802;91647;56953;645027;3996;201164,53
-1,1,17,16772264,20297091,3524827,2314;55244;125170;55090;11216;79018;79999;10400;54890;254272;9706;400581;92521;8533;22905;729288;5598;218;23164;83450;224;51168;80039;51655;201163;7156;51030;5636;644815;10750;4239;10517;654346;10743;388436;27077;140775;6470;146691;1819;6720;125206;23495;147166;7732;146802;91647;56953;645027;3996;201164,51
1,1,17,16772264,20433502,3661238,2314;55244;125170;55090;11216;79018;79999;284194;10400;54890;254272;9706;400581;92521;8533;22905;729288;100996259;5598;218;23164;83450;224;51168;80039;51655;201163;7156;51030;5636;644815;10750;4239;10517;654346;10743;388436;27077;140775;6470;146691;1819;6720;125206;23495;147166;7732;146802;91647;56953;645027;3996;201164,53
1,1,17,16777242,20395476,3618234,2314;55244;125170;55090;11216;79018;79999;284194;10400;54890;254272;9706;400581;92521;8533;22905;729288;100996259;5598;218;23164;83450;224;51168;80039;51655;201163;7156;51030;5636;644815;10750;4239;10517;654346;10743;388436;27077;140775;6470;146691;1819;6720;125206;23495;147166;7732;146802;91647;56953;645027;3996;201164,53
1,1,17,16782546,20219464,3436918,2314;55244;125170;55090;11216;79018;79999;10400;54890;254272;9706;400581;92521;8533;22905;729288;5598;218;23164;83450;224;51168;80039;51655;201163;7156;51030;5636;644815;10750;4239;10517;654346;10743;388436;27077;140775;6470;146691;1819;6720;125206;23495;147166;7732;146802;91647;56953;645027;3996;201164,51
1,1,17,16782546,20219464,3436918,2314;55244;125170;55090;11216;79018;79999;10400;54890;254272;9706;400581;92521;8533;22905;729288;5598;218;23164;83450;224;51168;80039;51655;201163;7156;51030;5636;644815;10750;4239;10517;654346;10743;388436;27077;140775;6470;146691;1819;6720;125206;23495;147166;7732;146802;91647;56953;645027;3996;201164,51
-1,1,17,16782547,20294010,3511463,2314;55244;125170;55090;11216;79018;79999;10400;54890;254272;9706;400581;92521;8533;22905;729288;5598;218;23164;83450;224;51168;80039;51655;201163;7156;51030;5636;644815;10750;4239;10517;654346;10743;388436;27077;140775;6470;146691;1819;6720;125206;23495;147166;7732;146802;91647;56953;645027;3996;201164,51
-1,1,17,16892401,20274129,3381728,2314;55244;125170;55090;11216;79018;79999;10400;54890;254272;9706;400581;92521;8533;22905;729288;5598;218;23164;83450;224;51168;80039;51655;201163;7156;51030;5636;644815;10750;4239;10517;654346;10743;388436;27077;140775;6470;146691;1819;6720;125206;147166;7732;146802;91647;56953;645027;3996;201164,50
-1,1,17,16922265,20051943,3129678,2314;55244;125170;55090;11216;79018;79999;10400;54890;254272;9706;400581;92521;8533;22905;729288;5598;218;23164;83450;224;51168;80039;51655;201163;7156;51030;5636;644815;10750;4239;10517;654346;10743;388436;27077;140775;6470;146691;1819;6720;125206;147166;7732;146802;91647;56953;645027;3996;201164,50
-1,1,17,16971147,18922732,1951585,2314;125170;55090;79018;10400;54890;254272;8533;729288;23164;83450;51168;80039;51655;201163;7156;51030;5636;644815;10517;654346;10743;140775;6470;146691;1819;6720;125206;147166;91647;56953;645027;3996;201164,34
-1,1,17,17200426,21900910,4700484,2314;23326;55244;125170;55090;11216;79018;79999;284194;256302;5606;10400;54890;254272;9706;3768;400581;92521;22905;25979;729288;100996259;5598;218;83450;224;339263;51168;80039;51655;256223;7156;5636;51030;644815;10750;10517;654346;339184;10743;388436;27077;140775;8834;6470;146691;1819;6720;125206;147166;7732;146802;91647;56953;645027;3996;4239,57
1,1,17,17234825,18921097,1686272,10517;2314;654346;3996;10743;125170;55090;645027;79018;140775;10400;54890;254272;6470;146691;1819;6720;729288;125206;147166;83450;51168;80039;51655;56953;7156;5636;51030;644815;91647,30
-1,1,17,17234825,19925841,2691016,2314;55244;125170;55090;11216;79018;79999;645027;10400;54890;254272;9706;92521;22905;729288;5598;218;83450;224;51168;80039;51655;7156;5636;51030;644815;10750;10517;654346;10743;388436;27077;140775;6470;146691;1819;6720;125206;147166;7732;146802;91647;56953;400581;3996;4239,46
1,1,17,17262786,18250574,987788,2314;10743;125170;55090;79018;140775;10400;6470;146691;1819;54890;6720;83450;51168;51655;91647;7156;3996,18
-1,-1,17,17310100,17344539,34439,,0
-1,1,17,17627289,17627351,62,10743,1
-1,1,17,17691726,18236686,544960,2314;10743;125170;79018;140775;6470;6720;1819;54890;146691;83450;51168;91647;7156;3996,15
1,1,17,17980441,18424702,444261,6470;2314;654346;125170;140775;51168;7156;645027;3996;54890;1819,11
1,-1,17,18265938,18284408,18470,645027;6470,2
1,-1,17,18605287,18858079,252792,10517;5636;51030;125206;147166,5
1,-1,17,18752653,18925454,172801,5636;125206;10750;644815,4
-1,1,17,18775930,20219464,1443534,55244;388436;27077;11216;79999;9706;400581;92521;22905;125206;5598;218;224;146802;5636;7732;644815;10750;4239,19
-1,1,17,18775930,20219464,1443534,55244;388436;27077;11216;79999;9706;400581;92521;22905;125206;5598;218;224;146802;5636;7732;644815;10750;4239,19
1,-1,17,18852748,18925454,72706,125206;10750;644815,3
1,-1,17,18852748,18925454,72706,125206;10750;644815,3
-1,-1,17,18934579,19051450,116871,400581;10750,2
-1,1,17,19494823,19563018,68195,224,1
-1,-1,17,19504649,19536309,31660,,0
-1,-1,17,19504649,19536309,31660,,0
-1,-1,17,19504649,19536309,31660,,0
-1,-1,17,19504649,19536309,31660,,0
-1,-1,17,19504649,19536309,31660,,0
-1,-1,17,19504649,19536309,31660,,0
-1,-1,17,19504649,19536309,31660,,0
-1,-1,17,19504649,19536309,31660,,0
-1,-1,17,19504649,19536309,31660,,0
-1,-1,17,19504649,19536309,31660,,0
-1,-1,17,19504649,19536309,31660,,0
-1,-1,17,19504649,19536309,31660,,0
-1,-1,17,19504649,19536309,31660,,0
-1,-1,17,19504649,19536309,31660,,0
-1,-1,17,19504649,19536309,31660,,0
-1,-1,17,19504649,19536309,31660,,0
-1,-1,17,19504649,19536309,31660,,0
-1,-1,17,19504649,19536309,31660,,0
-1,-1,17,19504649,19536309,31660,,0
-1,-1,17,19504649,19536309,31660,,0
-1,-1,17,19504649,19536309,31660,,0
-1,-1,17,19504649,19536309,31660,,0
-1,-1,17,19504649,19536309,31660,,0
-1,-1,17,19504649,19536309,31660,,0
-1,-1,17,19504649,19536309,31660,,0
-1,-1,17,19504649,19536309,31660,,0
-1,-1,17,19504649,19536309,31660,,0
-1,-1,17,19504649,19536309,31660,,0
-1,-1,17,19504649,19536309,31660,,0
-1,-1,17,19504649,19536309,31660,,0
-1,-1,17,19504649,19536309,31660,,0
-1,-1,17,19504649,19536309,31660,,0
-1,-1,17,19504649,19536309,31660,,0
-1,-1,17,19504649,19546080,41431,,0
1,-1,17,19947875,19986611,38736,92521,1
-1,-1,17,20351046,20581470,230424,284194;256223,2
1,-1,17,21381527,21501929,120402,339263,1
1,-1,17,21433385,21703526,270141,339263,1
1,-1,17,21529633,22263006,733373,100462977,1
1,-1,17,21529633,22263006,733373,100462977,1
1,-1,17,21529633,22263006,733373,100462977,1
1,-1,17,21531335,22263006,731671,100462977,1
1,-1,17,21531335,22263006,731671,100462977,1
1,-1,17,21553854,22174114,620260,100462977,1
1,-1,17,21556872,22174114,617242,100462977,1
1,-1,17,21736290,22174114,437824,100462977,1
-1,-1,17,21736290,22174114,437824,100462977,1
1,-1,17,25401773,25658315,256542,26118,1
1,-1,17,25958205,26093532,135327,4843;3965,2
1,-1,17,25991972,26061973,70001,,0
1,-1,17,25991972,26061973,70001,,0
1,-1,17,26610151,27231415,621264,7448;6830;10615;9058;230;27346;90410;6388;23098;113235;55731;284086;2319;26284;7126;147015;9618;645832;26073;147007;9094;83871;6147;124923;147011;9703;94005;8456;116238,29
-1,1,17,27274843,30817038,3542195,79915;79736;9527;28964;51379;116236;374786;84940;55813;2123;57551;55803;388364;23512;1411;162494;90313;6532;399687;7756;124925;124930;2124;57532;57649;4974;26083;85464;642;5717;8851;55288;64149;55352;114659;9220;84440;1362;51268;84081;4763;84282,42
-1,1,17,28952286,30386515,1434229,79915;79736;55352;114659;55813;2124;84440;2123;55803;4974;4763;23512;84282;51379,14
-1,1,17,28959760,30367155,1407395,79915;79736;55352;114659;55813;2124;84440;2123;55803;4974;4763;23512;84282;51379,14
-1,1,17,28993036,30386515,1393479,79915;79736;55352;114659;55813;2124;84440;2123;55803;4974;4763;23512;84282;51379,14
-1,1,17,28993036,30412788,1419752,79915;79736;55352;114659;55813;2124;84440;2123;55803;4974;4763;23512;84282;51379,14
-1,1,17,28993036,30412788,1419752,79915;79736;55352;114659;55813;2124;84440;2123;55803;4974;4763;23512;84282;51379,14
-1,1,17,28997791,30386515,1388724,79915;79736;55352;114659;55813;2124;84440;2123;55803;4974;4763;23512;84282;51379,14
-1,1,17,28997893,30408615,1410722,79915;79736;55352;114659;55813;2124;84440;2123;55803;4974;4763;23512;84282;51379,14
-1,1,17,29005171,30400885,1395714,79915;79736;55352;114659;55813;2124;84440;2123;55803;4974;4763;23512;84282;51379,14
-1,1,17,29011937,30348421,1336484,79915;79736;55352;114659;55813;2124;84440;2123;55803;4974;4763;23512;84282;51379,14
-1,1,17,29033863,30326952,1293089,79915;79736;55352;55813;2124;84440;2123;55803;4974;4763;23512;84282;51379,13
-1,1,17,29033863,30326952,1293089,79915;79736;55352;55813;2124;84440;2123;55803;4974;4763;23512;84282;51379,13
-1,1,17,29103348,30298773,1195425,79915;79736;55352;55813;2124;84440;2123;55803;4974;4763;23512;84282;51379,13
-1,1,17,29131151,30259046,1127895,79915;79736;55352;55813;2124;84440;2123;55803;4974;4763;84282;51379,12
-1,1,17,29325832,29326647,815,84282,1
-1,1,17,29428900,30326958,898058,55352;55813;2124;84440;2123;4974;4763;23512,8
-1,1,17,29519017,29577999,58982,4763,1
-1,1,17,29533283,29588731,55448,4763,1
-1,1,17,29578241,32142196,2563955,7756;2124;4974;5717;8851;55288;4642;26022;64149;55352;114659;55813;84440;2123;4763;23512;40;162494;124912,19
-1,-1,17,33685101,33754832,69731,91607;55106,2
-1,-1,17,33685101,33754832,69731,91607;55106,2
-1,-1,17,33685101,33754832,69731,91607;55106,2
-1,-1,17,33685101,33754832,69731,91607;55106,2
-1,-1,17,33687356,33738467,51111,91607;55106,2
-1,-1,17,33687356,33767930,80574,91607;146857;55106,3
-1,-1,17,33687356,33767930,80574,91607;146857;55106,3
-1,-1,17,33687356,33767930,80574,91607;146857;55106,3
-1,-1,17,33687356,33767930,80574,91607;146857;55106,3
1,-1,17,34205640,34245061,39421,6352,1
-1,1,17,34360168,36248859,1888691,26574;9326;6928;3975;414060;79893;729877;6351;31;6349;80179;6362;284098;11072;9560;414062;101060321;414059;79922;11276;79154;6348;11056;6871;284099,25
-1,-1,17,34419138,34750759,331621,6349;729877;414062;6351;9560;414060;414059,7
-1,-1,17,34419138,34750759,331621,6349;729877;414062;6351;9560;414060;414059,7
-1,-1,17,34419138,34750759,331621,6349;729877;414062;6351;9560;414060;414059,7
-1,-1,17,34419138,34750759,331621,6349;729877;414062;6351;9560;414060;414059,7
-1,-1,17,34419138,34750759,331621,6349;729877;414062;6351;9560;414060;414059,7
1,1,17,34425362,36410559,1985197,26574;9326;6928;3975;414060;79893;729877;6351;31;729873;6349;80179;284098;11072;9560;414062;101060321;414059;79922;11276;79154;11056;101060376;6871;284099,25
-1,-1,17,34431826,34766807,334981,6349;729877;414062;6351;9560;414060;414059,7
-1,-1,17,34437505,34611377,173872,414060;9560;414062;414059,4
-1,1,17,34447113,36283612,1836499,26574;9326;6928;3975;414060;79893;729877;31;6349;80179;284098;11072;9560;414062;101060321;414059;79922;11276;79154;11056;6871;284099,22
-1,1,17,34475679,36283612,1807933,26574;9326;6928;3975;414060;79893;729877;31;6349;80179;284098;11072;9560;414062;101060321;414059;79922;11276;79154;11056;6871;284099,22
1,-1,17,34508117,34611388,103271,414060;9560;414062,3
-1,-1,17,34508117,34766807,258690,6349;729877;414062;9560;414060,5
-1,-1,17,34508117,34766807,258690,6349;729877;414062;9560;414060,5
-1,-1,17,34508117,34766807,258690,6349;729877;414062;9560;414060,5
-1,-1,17,34508117,34790209,282092,6349;729877;414062;9560;414060,5
-1,-1,17,34508117,34790209,282092,6349;729877;414062;9560;414060,5
-1,-1,17,34508117,34817400,309283,6349;729877;414062;9560;414060;101060321,6
-1,-1,17,34508117,34817400,309283,6349;729877;414062;9560;414060;101060321,6
-1,-1,17,34508117,34817400,309283,6349;729877;414062;9560;414060;101060321,6
-1,-1,17,34508117,34817400,309283,6349;729877;414062;9560;414060;101060321,6
-1,-1,17,34508117,34817400,309283,6349;729877;414062;9560;414060;101060321,6
1,1,17,34508117,36248918,1740801,26574;9326;6928;3975;414060;79893;729877;31;6349;80179;284098;11072;9560;414062;101060321;79922;11276;79154;11056;6871;284099,21
-1,1,17,34508117,36248918,1740801,26574;9326;6928;3975;414060;79893;729877;31;6349;80179;284098;11072;9560;414062;101060321;79922;11276;79154;11056;6871;284099,21
-1,-1,17,34516300,34817400,301100,6349;729877;414062;9560;414060;101060321,6
1,1,17,34526601,36188734,1662133,26574;9326;6928;3975;414060;79893;729877;31;6349;80179;284098;11072;9560;79154;101060321;79922;11276;11056;6871;284099,20
1,1,17,34526601,36188734,1662133,26574;9326;6928;3975;414060;79893;729877;31;6349;80179;284098;11072;9560;79154;101060321;79922;11276;11056;6871;284099,20
-1,-1,17,34539912,34817400,277488,6349;729877;9560;414060;101060321,5
-1,1,17,34604364,36188734,1584370,26574;9326;6928;3975;79893;729877;31;6349;80179;284098;11072;79154;101060321;79922;11276;11056;6871;284099,18
1,1,17,34604364,36231917,1627553,26574;9326;6928;3975;79893;729877;31;6349;80179;284098;11072;79154;101060321;79922;11276;11056;6871;284099,18
1,1,17,34611352,36248918,1637566,26574;9326;6928;3975;79893;729877;31;6349;80179;284098;11072;79154;101060321;79922;11276;11056;6871;284099,18
1,1,17,34611352,36248918,1637566,26574;9326;6928;3975;79893;729877;31;6349;80179;284098;11072;79154;101060321;79922;11276;11056;6871;284099,18
-1,1,17,34611352,36248918,1637566,26574;9326;6928;3975;79893;729877;31;6349;80179;284098;11072;79154;101060321;79922;11276;11056;6871;284099,18
1,1,17,34750818,36263019,1512201,26574;9326;6928;3975;79893;729877;31;80179;284098;11072;79154;101060321;79922;11276;11056;6871;284099,17
-1,1,17,34750818,81048189,46297371,83900;2896;55040;83899;26502;9931;2688;91107;439921;8678;201292;147183;7343;57508;348235;332;1394;1659;786;1442;10966;2793;85285;51181;65264;3728;57597;100130370;54757;100132386;284129;51629;80179;3872;64750;9020;80022;3131;28958;3607;283991;9123;7473;55181;81558;117246;284067;1468;9400;5881;3690;10458;90507;92579;100506084;146909;317719;728255;284071;1444;374819;2302;8687;51529;25926;84313;4222;3213;64122;8631;125061;64772;11056;2689;54894;9570;284021;9625;10493;672;6928;84951;51649;388403;284119;342510;974;54883;2064;1277;23131;10513;3216;146664;347741;84669;6521;22834;6909;6904;1655;246744;2081;57409;9021;2194;6613;83990;146713;80755;516;474170;730755;6426;22843;114897;3858;3219;79154;6752;3292;5691;4591;2125;81851;5573;5914;3866;752;3487;30833;8165;124599;79877;22794;81870;162466;3691;84961;51195;3993;79922;10609;8714;84616;100505724;79755;6774;3868;22994;10871;27091;94103;29893;80725;5175;85291;2232;124540;256933;440435;10197;8557;3211;2670;124872;125111;11143;54474;4137;8153;6169;92591;57125;79170;81671;728318;100506650;5705;283985;124512;147111;2905;101060321;9110;60386;350;255061;360205;125113;57332;57521;10266;90506;51326;4215;57003;23531;79637;10349;6945;79415;162333;388419;94015;84643;8632;353288;1353;252983;8639;51321;124801;2584;4097;146894;8877;8313;6397;11248;54799;3880;7484;51204;7706;10209;92340;100505591;283999;3838;284018;55808;51547;11276;92736;342667;25984;284076;5414;201254;11325;9349;55876;768206;2826;2873;56970;146779;201255;10350;55666;728279;9489;26115;85290;6777;2145;255275;10948;2648;64847;146956;9862;5889;5718;100130520;80221;201191;50964;6442;3021;100134391;79058;162605;30850;83902;6871;9256;339230;7716;1236;4804;140735;51;9572;9267;51225;100130933;124773;2548;79157;5831;27092;9368;9382;284001;84152;9326;390790;3927;6427;4836;30009;6143;4884;85302;388394;162461;4779;3837;9755;4830;2538;284099;8396;3675;60681;57602;80347;7067;81871;83538;284161;6730;404093;3215;79701;4635;11072;535;388389;1267;100885850;11267;92335;51747;3430;84687;9842;654364;26207;10801;350383;339231;653240;124602;83895;84336;201294;5245;55036;342538;100131439;3674;7266;101927581;64978;8161;9144;57513;51651;51755;78995;51081;79643;10614;100505753;124995;9496;83755;2520;125058;3882;124783;6662;100134934;9121;5409;1443;124817;83901;124583;147179;64118;3857;284207;55379;25794;6198;5469;84514;5034;782;124565;146723;162417;3212;6668;201181;26574;5986;7283;54903;28511;56934;201266;55175;81033;2695;55316;6448;8405;201134;113026;5164;1747;55890;51751;55028;11232;85451;23265;10351;3884;2186;10140;3886;113277;6155;10476;5578;57690;9146;9520;10237;4353;728224;390792;5697;2118;85280;22806;339210;10610;23415;55771;116729;4355;3060;6605;5608;8787;9969;124535;1845;924;47;71;124857;996;51264;100533177;23210;84299;101060376;2885;11314;8506;4761;80174;146722;3396;56155;124808;10052;5539;11011;79651;31;3384;51155;85294;114757;284131;348262;100170841;6398;8526;642843;3885;3881;8493;762;23558;26151;58488;146705;192666;79672;379;10241;100653515;55062;10900;100885848;339287;3975;84366;84923;79893;7153;10882;1213;283987;7077;388381;55852;10672;9120;83882;29115;388407;57674;8689;146923;59342;30837;2886;3859;81872;26689;8811;162427;2642;284184;3883;2535;8913;63897;55273;6827;1534;6182;8288;284098;3860;91369;9343;5148;10642;23461;51136;23510;65266;9884;5878;9775;4669;10014;84073;83897;729877;83896;54828;115024;8535;729873;114804;5709;284004;29916;10040;9902;4302;23580;1636;400629;79092;81850;79089;146712;326624;5635;162540;4831;79902;3773;23163;57636;201176;284186;100507608;990;4905;51174;9772;339221;339175;11322;124590;314;10238;90799;6603;93210;85293;124626;284069;10189;1440;79665;6776;84733;10481;100132476;6329;79990;3861;15;100141515;80233;147184;85289;124989;84311;8688;494188;9043;51096;4185;342574;3959;79777;3214;3759;284083;5833;114881;80774;1018;79132;284058;22901;284106;80279;56270;84074;3218;64446;124790;80320;94086;64132;54868;353174;63893;125115;4356;1748;339229;283989;162282;54549;3217;9001;396;23460;55163;4025;9241;729220;147138;124538;1453;643008;51226;4077;27175;7083;10951;7703;104909134;2837;284110;1101,685
-1,1,17,34817422,36188700,1371278,26574;284099;9326;284098;11072;6928;79154;79922;3975;11276;79893;11056;6871;31;80179,15
-1,1,17,34817422,36188700,1371278,26574;284099;9326;284098;11072;6928;79154;79922;3975;11276;79893;11056;6871;31;80179,15
-1,1,17,34817422,36188700,1371278,26574;284099;9326;284098;11072;6928;79154;79922;3975;11276;79893;11056;6871;31;80179,15
-1,1,17,34817422,36248918,1431496,26574;284099;9326;284098;11072;6928;79154;79922;3975;11276;79893;11056;6871;31;80179,15
-1,1,17,34817422,36248918,1431496,26574;284099;9326;284098;11072;6928;79154;79922;3975;11276;79893;11056;6871;31;80179,15
-1,1,17,34817422,36248918,1431496,26574;284099;9326;284098;11072;6928;79154;79922;3975;11276;79893;11056;6871;31;80179,15
-1,1,17,34817422,36248918,1431496,26574;284099;9326;284098;11072;6928;79154;79922;3975;11276;79893;11056;6871;31;80179,15
-1,1,17,34817422,36248918,1431496,26574;284099;9326;284098;11072;6928;79154;79922;3975;11276;79893;11056;6871;31;80179,15
-1,1,17,34817422,36248918,1431496,26574;284099;9326;284098;11072;6928;79154;79922;3975;11276;79893;11056;6871;31;80179,15
-1,1,17,34817422,36248918,1431496,26574;284099;9326;284098;11072;6928;79154;79922;3975;11276;79893;11056;6871;31;80179,15
-1,1,17,34817422,36263019,1445597,26574;284099;9326;284098;11072;6928;79154;79922;3975;11276;79893;11056;6871;31;80179,15
-1,1,17,34822465,36244358,1421893,26574;284099;9326;284098;11072;6928;79154;79922;3975;11276;79893;11056;6871;31;80179,15
-1,1,17,34822465,36283612,1461147,26574;284099;9326;284098;11072;6928;79154;79922;3975;11276;79893;11056;6871;31;80179,15
-1,1,17,34822465,36283807,1461342,26574;284099;9326;284098;11072;6928;79154;79922;3975;11276;79893;11056;6871;31;80179,15
-1,1,17,34822465,36283807,1461342,26574;284099;9326;284098;11072;6928;79154;79922;3975;11276;79893;11056;6871;31;80179,15
-1,1,17,34822465,36283807,1461342,26574;284099;9326;284098;11072;6928;79154;79922;3975;11276;79893;11056;6871;31;80179,15
-1,1,17,34822465,36283807,1461342,26574;284099;9326;284098;11072;6928;79154;79922;3975;11276;79893;11056;6871;31;80179,15
-1,1,17,34822465,36283807,1461342,26574;284099;9326;284098;11072;6928;79154;79922;3975;11276;79893;11056;6871;31;80179,15
-1,1,17,34822465,36300630,1478165,26574;9326;6928;3975;79893;31;80179;284098;11072;79154;79922;11276;11056;101060376;6871;284099,16
-1,1,17,34822465,36300630,1478165,26574;9326;6928;3975;79893;31;80179;284098;11072;79154;79922;11276;11056;101060376;6871;284099,16
-1,1,17,34822465,36307773,1485308,26574;9326;6928;3975;79893;31;80179;284098;11072;79154;79922;11276;11056;101060376;6871;284099,16
1,1,17,34822465,36307773,1485308,26574;9326;6928;3975;79893;31;80179;284098;11072;79154;79922;11276;11056;101060376;6871;284099,16
-1,1,17,34822465,36316144,1493679,26574;9326;6928;3975;79893;31;80179;284098;11072;79154;79922;11276;11056;101060376;6871;284099,16
-1,1,17,34822465,36316161,1493696,26574;9326;6928;3975;79893;31;80179;284098;11072;79154;79922;11276;11056;101060376;6871;284099,16
1,1,17,34822465,36351919,1529454,26574;9326;6928;3975;79893;31;729873;80179;284098;11072;79154;79922;11276;11056;101060376;6871;284099,17
-1,1,17,34822465,36397323,1574858,26574;9326;6928;3975;79893;31;729873;80179;284098;11072;79154;79922;11276;11056;101060376;6871;284099,17
-1,1,17,34822466,36244358,1421892,26574;284099;9326;284098;11072;6928;79154;79922;3975;11276;79893;11056;6871;31;80179,15
-1,1,17,34822466,36283612,1461146,26574;284099;9326;284098;11072;6928;79154;79922;3975;11276;79893;11056;6871;31;80179,15
-1,1,17,34822466,36283807,1461341,26574;284099;9326;284098;11072;6928;79154;79922;3975;11276;79893;11056;6871;31;80179,15
-1,1,17,34822466,36283807,1461341,26574;284099;9326;284098;11072;6928;79154;79922;3975;11276;79893;11056;6871;31;80179,15
-1,1,17,34822466,36300466,1478000,26574;9326;6928;3975;79893;31;80179;284098;11072;79154;79922;11276;11056;101060376;6871;284099,16
-1,1,17,34822466,36307773,1485307,26574;9326;6928;3975;79893;31;80179;284098;11072;79154;79922;11276;11056;101060376;6871;284099,16
-1,1,17,34822466,36316161,1493695,26574;9326;6928;3975;79893;31;80179;284098;11072;79154;79922;11276;11056;101060376;6871;284099,16
-1,1,17,34822466,36351934,1529468,26574;9326;6928;3975;79893;31;729873;80179;284098;11072;79154;79922;11276;11056;101060376;6871;284099,17
-1,1,17,34822466,36393628,1571162,26574;9326;6928;3975;79893;31;729873;80179;284098;11072;79154;79922;11276;11056;101060376;6871;284099,17
-1,1,17,34822466,36404136,1581670,26574;9326;6928;3975;79893;31;729873;80179;284098;11072;79154;79922;11276;11056;101060376;6871;284099,17
-1,1,17,34822466,36404136,1581670,26574;9326;6928;3975;79893;31;729873;80179;284098;11072;79154;79922;11276;11056;101060376;6871;284099,17
-1,1,17,34822467,36307773,1485306,26574;9326;6928;3975;79893;31;80179;284098;11072;79154;79922;11276;11056;101060376;6871;284099,16
1,-1,17,34849849,34906608,56759,79893;9326;284098;80179,4
1,-1,17,34849849,34906608,56759,79893;9326;284098;80179,4
1,-1,17,34849849,34906608,56759,79893;9326;284098;80179,4
1,-1,17,34849849,34906608,56759,79893;9326;284098;80179,4
1,1,17,34849849,36151287,1301438,26574;9326;6928;3975;79893;31;80179;284098;11072;79154;79922;11276;11056;6871;284099,15
1,-1,17,34856055,34906608,50553,79893;80179;284098,3
1,-1,17,34856055,34906608,50553,79893;80179;284098,3
1,-1,17,34856055,34906608,50553,79893;80179;284098,3
1,1,17,34856055,36248859,1392804,26574;284099;284098;11072;6928;79154;79922;3975;11276;79893;11056;6871;31;80179,14
-1,1,17,34856055,36248859,1392804,26574;284099;284098;11072;6928;79154;79922;3975;11276;79893;11056;6871;31;80179,14
1,1,17,34856055,36248859,1392804,26574;284099;284098;11072;6928;79154;79922;3975;11276;79893;11056;6871;31;80179,14
-1,1,17,34856055,36248859,1392804,26574;284099;284098;11072;6928;79154;79922;3975;11276;79893;11056;6871;31;80179,14
-1,1,17,34856055,36248918,1392863,26574;284099;284098;11072;6928;79154;79922;3975;11276;79893;11056;6871;31;80179,14
-1,1,17,34856055,36248918,1392863,26574;284099;284098;11072;6928;79154;79922;3975;11276;79893;11056;6871;31;80179,14
1,1,17,34856055,36248918,1392863,26574;284099;284098;11072;6928;79154;79922;3975;11276;79893;11056;6871;31;80179,14
1,1,17,34856055,36248918,1392863,26574;284099;284098;11072;6928;79154;79922;3975;11276;79893;11056;6871;31;80179,14
-1,1,17,34856055,36248918,1392863,26574;284099;284098;11072;6928;79154;79922;3975;11276;79893;11056;6871;31;80179,14
1,1,17,34856055,36248918,1392863,26574;284099;284098;11072;6928;79154;79922;3975;11276;79893;11056;6871;31;80179,14
1,1,17,34856055,36248918,1392863,26574;284099;284098;11072;6928;79154;79922;3975;11276;79893;11056;6871;31;80179,14
1,1,17,34856055,36248918,1392863,26574;284099;284098;11072;6928;79154;79922;3975;11276;79893;11056;6871;31;80179,14
-1,1,17,34856305,36248926,1392621,26574;284099;284098;11072;6928;79154;79922;3975;11276;79893;11056;6871;31;80179,14
-1,1,17,35076189,36248926,1172737,26574;11072;6928;3975;11276;11056;6871;31;284099,9
1,-1,17,37381717,37596822,215105,5469;84961;342667,3
-1,1,17,41214475,41293060,78585,672,1
-1,1,17,42011535,42931393,919858,80174;10900;10014;92579;92591;3674;2535;284071;124808;10052;51751;2896;5539;56970;4185;5697;84336;23131;78995;6521;9343;79089;7343;162417;51629;124801;284069,27
1,1,17,42580684,81085615,38504931,9842;654364;26207;10801;350383;339231;55040;26502;9931;124602;2688;91107;439921;201292;201294;57508;348235;332;1394;5245;55036;786;342538;1442;100131439;10966;2793;51181;101927581;65264;64978;57597;8161;9144;57513;51651;100130370;51081;54757;79643;10614;124995;9496;284129;125058;64750;9020;124783;80022;3131;6662;3607;100134934;283991;9121;1443;9123;124583;7473;64118;55181;284207;81558;55379;117246;25794;6198;1468;9400;5881;5034;124565;146723;3212;3690;6668;5986;10458;90507;100506084;146909;54903;284071;56934;1444;374819;201266;2302;51529;25926;3213;64122;81033;2695;8631;125061;64772;55316;6448;8405;2689;54894;9570;284021;9625;201134;113026;5164;1747;51649;388403;342510;55890;51751;974;55028;1277;11232;23131;10513;3216;146664;85451;347741;84669;6904;22834;6909;23265;1655;10351;2186;246744;2081;57409;9021;2194;6613;10140;83990;10476;5578;57690;9146;146713;9520;10237;516;4353;474170;6426;22843;114897;3219;339210;10610;55771;6752;116729;5608;4591;8787;2125;9969;5573;124535;752;30833;8165;924;71;124599;79877;124857;162466;3691;996;51264;3993;23210;8714;2885;11314;79755;80174;22994;10871;27091;146722;3396;56155;124808;10052;5175;2232;11011;79651;124540;256933;3384;51155;114757;284131;348262;6398;8526;3211;642843;8493;23558;2670;124872;762;26151;58488;146705;79672;11143;10241;4137;100653515;55062;6169;84366;79170;84923;1213;81671;283987;10882;7077;100506650;55852;5705;10672;283985;9120;124512;147111;2905;83882;29115;388407;57674;9110;60386;59342;350;255061;26689;360205;8811;2642;57332;284184;57521;90506;2535;8913;63897;55273;6827;51326;4215;57003;23531;79637;1534;6182;8288;10349;79415;91369;9343;162333;388419;94015;84643;8632;5148;10642;23461;1353;51136;23510;252983;51321;2584;4097;9884;8877;9775;8313;84073;6397;11248;54799;7484;54828;51204;7706;8535;92340;114804;283999;284004;3838;284018;55808;29916;10040;9902;51547;23580;1636;400629;79092;92736;146712;284076;5414;326624;201254;11325;5635;162540;4831;2873;768206;79902;3773;23163;201176;284186;146779;201255;4905;51174;10350;55666;9772;9489;339221;339175;11322;124590;26115;10238;255275;90799;6603;64847;146956;10189;5889;5718;100130520;80221;201191;79665;84733;10481;6329;6442;3021;100134391;79058;30850;15;100141515;9256;339230;80233;7716;124989;4804;140735;9043;51;51096;9267;4185;51225;100130933;124773;2548;79157;3959;5831;27092;9368;79777;9382;3214;3759;284001;284083;5833;114881;80774;6427;4836;30009;1018;284058;4884;22901;85302;388394;80279;162461;56270;4779;84074;2837;3218;64446;3837;9755;4830;124790;80320;64132;54868;353174;63893;3675;1748;339229;283989;57602;162282;54549;3217;396;23460;284161;6730;55163;4025;9241;404093;729220;147138;124538;3215;79701;1453;643008;4635;51226;7083;388389;10951;104909134;11267;92335;51747;84687;1101,460
-1,1,17,43585760,44248995,663235,246744;162540;104909134;1394;4137;284058,6
-1,1,17,43593476,44224221,630745,246744;162540;104909134;1394;4137;284058,6
-1,1,17,43622197,44201470,579273,246744;162540;104909134;1394;4137;284058,6
-1,1,17,43629215,44399455,770240,246744;162540;104909134;9884;1394;4137;284058,7
-1,1,17,43648491,44214888,566397,246744;162540;104909134;1394;4137;284058,6
-1,1,17,43651731,44351152,699421,246744;162540;104909134;1394;4137;284058,6
-1,1,17,43651731,44351152,699421,246744;162540;104909134;1394;4137;284058,6
-1,1,17,43655747,44176717,520970,246744;162540;104909134;1394;4137;284058,6
-1,1,17,43655747,44224221,568474,246744;162540;104909134;1394;4137;284058,6
-1,1,17,43655747,44351152,695405,246744;162540;104909134;1394;4137;284058,6
-1,1,17,43655747,44351152,695405,246744;162540;104909134;1394;4137;284058,6
-1,1,17,43655747,44351152,695405,246744;162540;104909134;1394;4137;284058,6
-1,1,17,43656693,44176717,520024,246744;162540;104909134;1394;4137;284058,6
-1,1,17,43656693,44694311,1037618,162540;100506084;284058;246744;104909134;51326;4905;9884;1394;4137;474170,11
-1,1,17,43703800,44212416,508616,246744;162540;104909134;1394;4137;284058,6
-1,1,17,43703801,44187492,483691,246744;162540;104909134;1394;4137;284058,6
-1,1,17,43703801,44212416,508615,246744;162540;104909134;1394;4137;284058,6
-1,1,17,43703801,44212416,508615,246744;162540;104909134;1394;4137;284058,6
-1,1,17,43703801,44212416,508615,246744;162540;104909134;1394;4137;284058,6
1,1,17,43703801,44212416,508615,246744;162540;104909134;1394;4137;284058,6
-1,1,17,43703801,44212416,508615,246744;162540;104909134;1394;4137;284058,6
-1,1,17,43703801,44212824,509023,246744;162540;104909134;1394;4137;284058,6
-1,1,17,43703801,44225820,522019,246744;162540;104909134;1394;4137;284058,6
-1,1,17,43706886,44171947,465061,246744;162540;104909134;1394;4137;284058,6
-1,1,17,43706886,44176717,469831,246744;162540;104909134;1394;4137;284058,6
-1,1,17,43706886,44207977,501091,246744;162540;104909134;1394;4137;284058,6
-1,1,17,43706886,44351152,644266,246744;162540;104909134;1394;4137;284058,6
-1,1,17,43706886,44351152,644266,246744;162540;104909134;1394;4137;284058,6
-1,1,17,43706895,44762543,1055648,162540;9884;100506084;284058;246744;104909134;51326;4905;1394;4137;474170,11
1,1,17,43708346,44158662,450316,246744;162540;104909134;1394;4137;284058,6
-1,1,17,43710370,44212416,502046,246744;162540;104909134;1394;4137;284058,6
-1,1,17,43710370,44212416,502046,246744;162540;104909134;1394;4137;284058,6
-1,1,17,43717703,44345038,627335,246744;162540;104909134;1394;4137;284058,6
-1,-1,17,44156473,44462445,305972,100506084;9884;284058,3
-1,-1,17,44156473,44762543,606070,474170;100506084;51326;4905;9884;284058,6
-1,-1,17,44156473,44762543,606070,474170;100506084;51326;4905;9884;284058,6
1,-1,17,44156473,44762543,606070,474170;100506084;51326;4905;9884;284058,6
-1,-1,17,44156473,44762543,606070,474170;100506084;51326;4905;9884;284058,6
1,-1,17,44156473,44762543,606070,474170;100506084;51326;4905;9884;284058,6
-1,-1,17,44156473,44787644,631171,474170;100506084;51326;4905;9884;284058,6
-1,-1,17,44156473,44787644,631171,474170;100506084;51326;4905;9884;284058,6
-1,-1,17,44156473,44787644,631171,474170;100506084;51326;4905;9884;284058,6
-1,-1,17,44156473,44787644,631171,474170;100506084;51326;4905;9884;284058,6
-1,-1,17,44156473,44787644,631171,474170;100506084;51326;4905;9884;284058,6
1,-1,17,44156473,44787644,631171,474170;100506084;51326;4905;9884;284058,6
-1,-1,17,44156473,44787644,631171,474170;100506084;51326;4905;9884;284058,6
-1,-1,17,44156473,44787644,631171,474170;100506084;51326;4905;9884;284058,6
-1,-1,17,44156473,44787644,631171,474170;100506084;51326;4905;9884;284058,6
1,-1,17,44156473,44787644,631171,474170;100506084;51326;4905;9884;284058,6
-1,-1,17,44156473,44787644,631171,474170;100506084;51326;4905;9884;284058,6
-1,-1,17,44156473,44787644,631171,474170;100506084;51326;4905;9884;284058,6
-1,-1,17,44156473,44787644,631171,474170;100506084;51326;4905;9884;284058,6
1,-1,17,44156473,44787644,631171,474170;100506084;51326;4905;9884;284058,6
-1,-1,17,44156473,44787644,631171,474170;100506084;51326;4905;9884;284058,6
-1,-1,17,44156473,44787644,631171,474170;100506084;51326;4905;9884;284058,6
-1,-1,17,44156473,44787644,631171,474170;100506084;51326;4905;9884;284058,6
-1,-1,17,44156473,44787644,631171,474170;100506084;51326;4905;9884;284058,6
1,-1,17,44156473,44787644,631171,474170;100506084;51326;4905;9884;284058,6
1,-1,17,44171917,44325221,153304,284058,1
1,-1,17,44171917,44368862,196945,284058,1
1,-1,17,44171917,44368862,196945,284058,1
1,-1,17,44188471,44268724,80253,284058,1
-1,-1,17,44223908,44345038,121130,284058,1
1,-1,17,44223908,44345038,121130,284058,1
-1,-1,17,44223908,44368862,144954,284058,1
-1,-1,17,44223908,44485830,261922,100506084;9884;284058,3
1,-1,17,44223908,44485830,261922,100506084;9884;284058,3
-1,-1,17,44223908,44694283,470375,474170;100506084;51326;4905;9884;284058,6
-1,-1,17,44223908,44694283,470375,474170;100506084;51326;4905;9884;284058,6
-1,-1,17,44223908,44694283,470375,474170;100506084;51326;4905;9884;284058,6
-1,-1,17,44223908,44694283,470375,474170;100506084;51326;4905;9884;284058,6
-1,-1,17,44223908,44694283,470375,474170;100506084;51326;4905;9884;284058,6
-1,-1,17,44223908,44694283,470375,474170;100506084;51326;4905;9884;284058,6
-1,-1,17,44223908,44694283,470375,474170;100506084;51326;4905;9884;284058,6
-1,-1,17,44223908,44694283,470375,474170;100506084;51326;4905;9884;284058,6
1,-1,17,44223908,44694283,470375,474170;100506084;51326;4905;9884;284058,6
-1,-1,17,44223908,44694283,470375,474170;100506084;51326;4905;9884;284058,6
-1,-1,17,44223908,44694283,470375,474170;100506084;51326;4905;9884;284058,6
-1,-1,17,44223908,44694283,470375,474170;100506084;51326;4905;9884;284058,6
-1,-1,17,44223908,44694283,470375,474170;100506084;51326;4905;9884;284058,6
-1,-1,17,44223908,44694311,470403,474170;100506084;51326;4905;9884;284058,6
-1,-1,17,44223908,44694311,470403,474170;100506084;51326;4905;9884;284058,6
-1,-1,17,44223908,44694311,470403,474170;100506084;51326;4905;9884;284058,6
-1,-1,17,44223908,44787644,563736,474170;100506084;51326;4905;9884;284058,6
-1,-1,17,44223908,44787644,563736,474170;100506084;51326;4905;9884;284058,6
-1,-1,17,44223908,44787644,563736,474170;100506084;51326;4905;9884;284058,6
-1,-1,17,44223908,44787644,563736,474170;100506084;51326;4905;9884;284058,6
-1,-1,17,44223908,44787644,563736,474170;100506084;51326;4905;9884;284058,6
-1,-1,17,44223908,44787644,563736,474170;100506084;51326;4905;9884;284058,6
-1,-1,17,44223908,44787644,563736,474170;100506084;51326;4905;9884;284058,6
-1,-1,17,44223908,44787644,563736,474170;100506084;51326;4905;9884;284058,6
-1,-1,17,44223908,44787644,563736,474170;100506084;51326;4905;9884;284058,6
-1,-1,17,44223908,44787644,563736,474170;100506084;51326;4905;9884;284058,6
-1,-1,17,44223908,44787644,563736,474170;100506084;51326;4905;9884;284058,6
-1,-1,17,44223908,44787644,563736,474170;100506084;51326;4905;9884;284058,6
-1,-1,17,44223908,44787644,563736,474170;100506084;51326;4905;9884;284058,6
-1,-1,17,44223908,44787644,563736,474170;100506084;51326;4905;9884;284058,6
1,-1,17,44223908,44787644,563736,474170;100506084;51326;4905;9884;284058,6
-1,-1,17,44223908,44787644,563736,474170;100506084;51326;4905;9884;284058,6
-1,-1,17,44223908,44787644,563736,474170;100506084;51326;4905;9884;284058,6
-1,-1,17,44223908,44787644,563736,474170;100506084;51326;4905;9884;284058,6
-1,-1,17,44223908,44787644,563736,474170;100506084;51326;4905;9884;284058,6
-1,-1,17,44223908,44787644,563736,474170;100506084;51326;4905;9884;284058,6
-1,-1,17,44223908,44787644,563736,474170;100506084;51326;4905;9884;284058,6
-1,-1,17,44223908,44787644,563736,474170;100506084;51326;4905;9884;284058,6
-1,-1,17,44223908,44787644,563736,474170;100506084;51326;4905;9884;284058,6
1,-1,17,44223908,44787924,564016,474170;100506084;51326;4905;9884;284058,6
1,-1,17,44223908,44787924,564016,474170;100506084;51326;4905;9884;284058,6
-1,-1,17,44223908,44873614,649706,474170;100506084;51326;4905;7473;9884;284058,7
1,-1,17,44305975,44597336,291361,474170;9884;100506084;51326,4
-1,-1,17,44305975,44694283,388308,474170;51326;4905;9884;100506084,5
-1,-1,17,44305975,44762543,456568,474170;51326;4905;9884;100506084,5
-1,-1,17,44305975,44787644,481669,474170;51326;4905;9884;100506084,5
-1,-1,17,44305975,44787644,481669,474170;51326;4905;9884;100506084,5
-1,-1,17,44305975,44787644,481669,474170;51326;4905;9884;100506084,5
-1,-1,17,44305975,44787644,481669,474170;51326;4905;9884;100506084,5
-1,-1,17,44305975,44787644,481669,474170;51326;4905;9884;100506084,5
-1,-1,17,44305975,44787644,481669,474170;51326;4905;9884;100506084,5
-1,-1,17,44325222,44758916,433694,474170;51326;4905;9884;100506084,5
-1,-1,17,44347533,44787644,440111,474170;51326;4905;9884;100506084,5
1,-1,17,44351093,44628150,277057,474170;9884;100506084;51326,4
-1,-1,17,44351093,44694283,343190,474170;51326;4905;9884;100506084,5
-1,-1,17,44351093,44694283,343190,474170;51326;4905;9884;100506084,5
-1,-1,17,44354705,44762543,407838,474170;51326;4905;9884;100506084,5
-1,-1,17,44354705,44787644,432939,474170;51326;4905;9884;100506084,5
-1,-1,17,44354705,44787644,432939,474170;51326;4905;9884;100506084,5
-1,-1,17,44354705,44787644,432939,474170;51326;4905;9884;100506084,5
-1,-1,17,44354705,44787644,432939,474170;51326;4905;9884;100506084,5
-1,-1,17,44354705,44787644,432939,474170;51326;4905;9884;100506084,5
-1,-1,17,44354705,44787644,432939,474170;51326;4905;9884;100506084,5
-1,-1,17,44354705,44787644,432939,474170;51326;4905;9884;100506084,5
-1,-1,17,44354705,44787644,432939,474170;51326;4905;9884;100506084,5
-1,-1,17,44354705,44787644,432939,474170;51326;4905;9884;100506084,5
-1,-1,17,44354705,44787644,432939,474170;51326;4905;9884;100506084,5
-1,-1,17,44354705,44787644,432939,474170;51326;4905;9884;100506084,5
-1,-1,17,44354705,44787644,432939,474170;51326;4905;9884;100506084,5
-1,-1,17,44354705,44787644,432939,474170;51326;4905;9884;100506084,5
-1,-1,17,44354705,44787644,432939,474170;51326;4905;9884;100506084,5
-1,-1,17,44354705,44787644,432939,474170;51326;4905;9884;100506084,5
-1,-1,17,44375355,44787644,412289,474170;51326;4905;9884;100506084,5
-1,-1,17,44375355,44787644,412289,474170;51326;4905;9884;100506084,5
-1,-1,17,44375355,44787644,412289,474170;51326;4905;9884;100506084,5
-1,-1,17,44375355,44787644,412289,474170;51326;4905;9884;100506084,5
-1,-1,17,44375355,44787644,412289,474170;51326;4905;9884;100506084,5
-1,-1,17,44375355,44787644,412289,474170;51326;4905;9884;100506084,5
-1,-1,17,44375355,44787644,412289,474170;51326;4905;9884;100506084,5
-1,-1,17,44375355,44787644,412289,474170;51326;4905;9884;100506084,5
-1,-1,17,44375355,44787644,412289,474170;51326;4905;9884;100506084,5
-1,-1,17,44375355,44787644,412289,474170;51326;4905;9884;100506084,5
-1,-1,17,44375355,44787644,412289,474170;51326;4905;9884;100506084,5
-1,-1,17,44375355,44787644,412289,474170;51326;4905;9884;100506084,5
-1,-1,17,44375355,44787644,412289,474170;51326;4905;9884;100506084,5
-1,-1,17,44375355,44787644,412289,474170;51326;4905;9884;100506084,5
-1,-1,17,44375355,44787644,412289,474170;51326;4905;9884;100506084,5
-1,-1,17,44375355,44787644,412289,474170;51326;4905;9884;100506084,5
-1,-1,17,44375355,44787644,412289,474170;51326;4905;9884;100506084,5
-1,-1,17,44375355,44787644,412289,474170;51326;4905;9884;100506084,5
-1,-1,17,44375355,44787644,412289,474170;51326;4905;9884;100506084,5
-1,-1,17,44375355,44787644,412289,474170;51326;4905;9884;100506084,5
-1,-1,17,44375355,44787644,412289,474170;51326;4905;9884;100506084,5
-1,-1,17,44375355,44787644,412289,474170;51326;4905;9884;100506084,5
-1,-1,17,44375355,44787644,412289,474170;51326;4905;9884;100506084,5
-1,-1,17,44375355,44787644,412289,474170;51326;4905;9884;100506084,5
1,-1,17,44381698,44762741,381043,474170;51326;4905;9884;100506084,5
-1,-1,17,44399514,44787644,388130,474170;51326;4905;9884;100506084,5
-1,-1,17,44399514,44787644,388130,474170;51326;4905;9884;100506084,5
-1,-1,17,44399514,44787644,388130,474170;51326;4905;9884;100506084,5
-1,-1,17,44399514,44787644,388130,474170;51326;4905;9884;100506084,5
-1,-1,17,44399514,44787644,388130,474170;51326;4905;9884;100506084,5
-1,-1,17,44399514,44787644,388130,474170;51326;4905;9884;100506084,5
-1,-1,17,44424422,44528251,103829,100506084,1
1,-1,17,44485771,44694283,208512,4905;474170;51326,3
1,-1,17,44485771,44694283,208512,4905;474170;51326,3
1,-1,17,44485771,44694283,208512,4905;474170;51326,3
-1,-1,17,44485800,44758915,273115,4905;474170;51326,3
-1,-1,17,44485800,44758915,273115,4905;474170;51326,3
-1,-1,17,45481907,45567563,85656,124989,1
1,-1,17,45599998,45662523,62525,9520,1
1,-1,17,45599998,45662523,62525,9520,1
1,-1,17,45599998,45662523,62525,9520,1
1,-1,17,45599998,45662523,62525,9520,1
1,-1,17,45599998,45662523,62525,9520,1
1,-1,17,45599998,45662523,62525,9520,1
1,-1,17,45599998,45662523,62525,9520,1
1,-1,17,45599998,45662523,62525,9520,1
1,-1,17,45599998,45662523,62525,9520,1
-1,1,17,46064252,47406759,1342507,360205;84366;3217;2793;10481;65264;516;4779;51225;3218;162466;3215;3216;3213;51226;29916;22834;8631;3219;2695;3211;10951;10642;124872;11267;3212;3214;10241;284076,29
-1,1,17,47438517,48346801,908284,255061;5164;1748;3675;4804;1747;201191;5245;11248;10237;1277;729220;81558;22834;11143;8405;6442;84687,18
1,1,17,49076980,58740945,9663965,654364;5889;79665;51649;388403;1213;81671;100506650;10513;84669;9110;59342;9256;348235;7716;26689;140735;9043;101927581;51096;55273;63897;6827;8161;4353;23531;51651;6426;8288;22843;124773;339210;84643;55771;51136;1353;252983;284083;4591;3131;124535;54799;7706;8165;55181;4830;10040;6198;5414;4831;162282;54903;56155;56934;284161;4025;9241;124540;404093;51174;124538;8526;8493;762;58488;54894,66
-1,-1,17,50514419,50751079,236660,,0
1,1,17,52189051,57477162,5288111,5889;4591;3131;51649;388403;124535;8165;7706;55181;10040;9110;59342;9256;348235;7716;5414;26689;162282;140735;54903;56155;101927581;55273;6827;284161;4025;8161;124540;9241;404093;23531;4353;124538;6426;8288;22843;339210;8526;55771;1353;58488;252983;54894;284083,44
1,-1,17,52582241,53041465,459224,10040;1353,2
-1,1,17,54760866,56162300,1401434,6426;339210;8165;8526;51649;140735;101927581;7706;59342;8161;124540;7716;404093,13
-1,1,17,55496167,57812825,2316658,5889;4591;79665;51649;388403;124535;1213;81671;55181;9110;9256;348235;7716;5414;26689;140735;54903;56155;101927581;6827;284161;4025;124540;4353;404093;124538;51651;6426;8288;22843;55771;54894;284083,33
-1,1,17,56623275,60285107,3661832,5889;4591;342538;9969;79665;388403;56155;63897;1213;81671;54828;284161;55181;51174;51651;10513;22843;124773;84669;6198;388407;6909;55771;8493;9496;51136;762;57508;348235;83990,30
1,-1,17,57229181,57624852,395671,284161;348235;388403;55181;55771,5
1,1,17,57595736,73049225,15453489,55062;6169;26207;350383;84923;1213;81671;283987;55852;5705;9931;10672;9120;2688;124602;283985;2905;388407;57508;350;342538;786;1442;100131439;63897;4215;57003;1534;51651;10349;54757;162333;388419;94015;9496;23461;51136;23510;51321;64750;8313;6662;1443;54828;51204;92340;3838;117246;284018;6198;9902;23580;1636;92736;146723;326624;11325;3773;1444;374819;146779;201266;51174;10350;81033;25926;339175;124590;26115;10238;90799;6603;2689;201134;284021;5718;100130520;79665;55890;342510;974;55028;6329;11232;10513;100134391;347741;84669;10351;6909;1655;30850;2186;2081;83990;10476;5578;124773;27092;9368;6752;9382;3759;5608;8787;80774;9969;5573;22901;124599;64446;54868;11314;10871;27091;146722;3396;54549;23460;11011;5175;2232;3384;642843;8493;762;26151;92335,128
-1,1,17,58332553,60315303,1982750,10513;124773;342538;84669;388407;9969;6909;8493;9496;54828;57508;83990,12
-1,-1,17,62532634,62620233,87599,64750;90799,2
-1,1,17,62649313,65683004,3033691,8787;350;786;5718;8313;5578;27091;26207;27092;374819;201134;9931;64750;10672,14
1,1,17,64241326,81041938,16800612,55062;6169;26207;10801;350383;84923;339231;283987;7077;26502;9931;124602;9120;283985;91107;439921;124512;147111;2905;83882;29115;57674;201292;60386;201294;332;55036;786;8811;2642;57332;100131439;57521;284184;10966;51181;64978;57597;79637;9144;57513;6182;10349;51081;54757;79643;100130370;79415;388419;94015;8632;5148;23461;23510;284129;51321;2584;125058;4097;8877;9775;80022;6662;6397;100134934;3607;283991;9121;124583;9123;8535;64118;284207;114804;283999;284004;3838;284018;55808;23580;25794;51547;1468;400629;79092;9400;5881;5034;92736;124565;146723;146712;326624;201254;5986;5635;10458;79902;23163;3773;768206;2873;284186;201266;2302;201255;51529;10350;55666;25926;9772;9489;339221;64122;125061;11322;124590;64772;6448;255275;9625;10189;5718;100130520;84733;55890;342510;55028;3021;85451;100134391;146664;79058;347741;10351;23265;6904;30850;2186;57409;9021;2194;6613;15;100141515;80233;339230;10476;5578;57690;51;9146;146713;9267;100130933;114897;2548;79157;3959;10610;5831;27092;9368;6752;116729;9382;3759;5608;284001;5833;2125;6427;1018;5573;4884;22901;85302;30833;56270;924;71;124599;84074;64446;3691;3993;23210;54868;2885;353174;11314;63893;79755;339229;22994;10871;283989;27091;146722;3396;57602;54549;396;23460;2232;6730;79651;256933;1453;147138;114757;51155;284131;348262;79701;643008;7083;6398;642843;23558;26151;79672;146705;2837;100653515,225
-1,1,17,65580340,66636016,1055676,55062;25926;3838;26207;284018;54757;5573;2186;22901;51321;9120,11
1,-1,17,65990513,66076010,85497,3838,1
1,-1,17,65990513,66076010,85497,3838,1
-1,1,17,66416655,69347376,2930721,55062;10349;3773;54757;10351;5573;22901;23461;23460;3759;5608;10350,12
1,1,17,67002415,81041938,14039523,6169;10801;350383;84923;339231;283987;7077;26502;124602;283985;91107;439921;124512;147111;2905;83882;29115;57674;201292;60386;201294;332;55036;8811;2642;57332;100131439;57521;284184;10966;51181;64978;57597;79637;9144;57513;6182;10349;51081;79643;100130370;79415;388419;94015;8632;5148;23461;23510;284129;125058;2584;4097;8877;9775;80022;6662;6397;100134934;3607;283991;9121;124583;9123;8535;64118;284207;114804;283999;284004;55808;25794;23580;51547;1468;400629;79092;9400;5881;5034;92736;124565;146723;146712;326624;201254;5986;5635;10458;79902;23163;3773;768206;2873;284186;201266;2302;201255;51529;10350;55666;64122;9772;9489;339221;125061;11322;124590;64772;6448;255275;9625;10189;100130520;84733;55890;342510;55028;3021;85451;100134391;146664;79058;347741;23265;6904;30850;57409;9021;2194;6613;15;100141515;80233;339230;10476;57690;51;9146;146713;9267;100130933;114897;2548;79157;3959;10610;5831;9368;6752;116729;9382;3759;5608;284001;5833;2125;6427;1018;4884;85302;30833;56270;924;71;124599;84074;64446;3691;3993;23210;54868;2885;353174;11314;63893;79755;339229;22994;10871;283989;146722;3396;57602;54549;396;23460;2232;6730;79651;256933;1453;147138;114757;51155;284131;348262;79701;643008;7083;6398;642843;23558;26151;79672;146705;2837;100653515,207
1,1,17,67912576,81048189,13135613,6169;10801;350383;84923;339231;283987;7077;26502;124602;283985;91107;439921;124512;147111;2905;83882;29115;57674;201292;60386;201294;332;55036;8811;2642;57332;100131439;57521;284184;10966;51181;64978;57597;79637;9144;57513;6182;51081;79643;100130370;79415;388419;94015;8632;5148;23510;284129;125058;2584;4097;8877;9775;80022;6662;6397;100134934;3607;283991;9121;124583;9123;8535;64118;284207;114804;283999;284004;55808;25794;23580;51547;1468;400629;79092;9400;5881;5034;92736;124565;146723;146712;326624;201254;5986;5635;10458;79902;23163;3773;768206;2873;284186;201266;2302;201255;51529;55666;64122;9772;9489;339221;125061;11322;124590;64772;6448;255275;9625;10189;100130520;84733;55890;342510;55028;3021;85451;100134391;146664;79058;347741;23265;6904;30850;57409;9021;2194;6613;15;100141515;80233;339230;10476;57690;51;9146;146713;9267;100130933;114897;2548;79157;3959;10610;5831;9368;6752;116729;9382;3759;284001;5833;2125;6427;1018;4884;85302;30833;56270;924;71;124599;84074;64446;3691;3993;23210;54868;2885;353174;11314;63893;79755;339229;22994;10871;283989;146722;3396;57602;54549;396;2232;6730;79651;256933;1453;147138;114757;51155;284131;348262;79701;643008;7083;6398;642843;23558;26151;79672;146705;2837;100653515,202
1,-1,17,68450159,68618075,167916,,0
1,-1,17,70117099,70119330,2231,6662,1
1,-1,17,70118429,70120373,1944,6662,1
-1,-1,17,70880685,70939838,59153,201266,1
1,-1,17,71847857,72586839,738982,6169;10871;100130520;388419;100131439;94015;350383;55890;146723;11314;124599;124602;64446,13
1,-1,17,71847857,72648066,800209,6169;10871;100130520;388419;100131439;94015;350383;55890;342510;146723;11314;124599;124602;64446,14
1,-1,17,71847837,72606952,759115,6169;10871;100130520;388419;100131439;94015;350383;55890;342510;146723;11314;124599;124602;64446,14
1,-1,17,71847837,72606952,759115,6169;10871;100130520;388419;100131439;94015;350383;55890;342510;146723;11314;124599;124602;64446,14
1,-1,17,71847837,72606952,759115,6169;10871;100130520;388419;100131439;94015;350383;55890;342510;146723;11314;124599;124602;64446,14
1,-1,17,71847837,72606952,759115,6169;10871;100130520;388419;100131439;94015;350383;55890;342510;146723;11314;124599;124602;64446,14
1,-1,17,71847837,72647997,800160,6169;10871;100130520;388419;100131439;94015;350383;55890;342510;146723;11314;124599;124602;64446,14
1,-1,17,71847837,72647997,800160,6169;10871;100130520;388419;100131439;94015;350383;55890;342510;146723;11314;124599;124602;64446,14
1,-1,17,71847857,72607045,759188,6169;10871;100130520;388419;100131439;94015;350383;55890;342510;146723;11314;124599;124602;64446,14
1,-1,17,71863765,72648066,784301,6169;10871;100130520;388419;100131439;94015;350383;55890;342510;146723;11314;124599;124602;64446,14
1,-1,17,71863765,72648066,784301,6169;10871;100130520;388419;100131439;94015;350383;55890;342510;146723;11314;124599;124602;64446,14
1,-1,17,72537226,72541067,3841,10871,1
1,1,17,73951701,81041938,7090237,10801;339231;7077;26502;439921;124512;147111;83882;57674;332;55036;8811;2642;57332;284184;57521;10966;51181;57597;9144;6182;100130370;79643;79415;8632;5148;284129;125058;4097;8877;9775;6397;100134934;3607;283991;124583;9123;8535;64118;284207;114804;283999;284004;55808;25794;51547;1468;400629;79092;5881;5034;124565;146712;201254;5986;5635;10458;2873;768206;284186;2302;201255;51529;55666;64122;339221;9489;125061;11322;64772;6448;255275;9625;10189;84733;146664;79058;23265;6904;9021;2194;15;100141515;80233;339230;57690;51;9146;146713;9267;114897;2548;79157;3959;10610;5831;116729;284001;5833;2125;6427;1018;4884;56270;924;71;84074;23210;353174;63893;79755;339229;22994;57602;396;6730;79651;256933;1453;147138;114757;284131;348262;79701;7083;6398;79672;146705;2837;100653515,130
1,1,17,73951701,81041938,7090237,10801;339231;7077;26502;439921;124512;147111;83882;57674;332;55036;8811;2642;57332;284184;57521;10966;51181;57597;9144;6182;100130370;79643;79415;8632;5148;284129;125058;4097;8877;9775;6397;100134934;3607;283991;124583;9123;8535;64118;284207;114804;283999;284004;55808;25794;51547;1468;400629;79092;5881;5034;124565;146712;201254;5986;5635;10458;2873;768206;284186;2302;201255;51529;55666;64122;339221;9489;125061;11322;64772;6448;255275;9625;10189;84733;146664;79058;23265;6904;9021;2194;15;100141515;80233;339230;57690;51;9146;146713;9267;114897;2548;79157;3959;10610;5831;116729;284001;5833;2125;6427;1018;4884;56270;924;71;84074;23210;353174;63893;79755;339229;22994;57602;396;6730;79651;256933;1453;147138;114757;284131;348262;79701;7083;6398;79672;146705;2837;100653515,130
-1,1,17,78514452,81041938,2527486,339231;26502;147111;83882;79058;6904;2194;80233;339230;2642;284184;57521;9146;51181;10966;57597;6182;79643;100130370;79415;5831;5148;116729;4097;284001;5833;3607;9123;56270;924;71;64118;284207;284004;25794;51547;1468;400629;5881;5034;124565;146712;201254;5986;10458;79755;339229;22994;2873;284186;396;201255;256933;51529;1453;55666;348262;79701;64122;6398;255275;79672;146705;2837;9625;10189,66
1,1,17,78981996,81048189,2066193,339231;26502;147111;83882;79058;6904;2194;80233;339230;2642;284184;9146;51181;10966;57597;6182;100130370;79415;5831;5148;116729;4097;284001;5833;3607;9123;56270;924;71;64118;284207;284004;25794;51547;1468;400629;5881;5034;124565;146712;201254;5986;10458;79755;339229;22994;2873;284186;396;201255;256933;51529;1453;55666;348262;79701;64122;6398;255275;79672;146705;2837;9625;10189,64
1,-1,17,79119183,79225629,106446,124565;22994;146705;284184;9625,5
-1,-1,17,79371605,79482530,110925,57597;71,2
1,-1,17,79495582,79514678,19096,80233;25794,2
-1,-1,17,79518741,79601555,82814,55666;80233,2
1,-1,17,79817155,79829187,12032,5034;396,2
-1,-1,17,79817564,79975488,157924,5833;147111;79058;51547;5831;396;5034;255275;4097;256933;51529;10189,12
1,-1,17,79829409,79849387,19978,51529;10189,2
1,-1,17,80869490,81006643,137153,146712;6904,2
1,-1,17,81006643,81044494,37851,146712;284207,2
-1,1,18,1,15157836,15157835,116;23255;57132;8774;645369;125228;57045;103910;642597;84617;9097;7525;10650;3613;56984;65258;79822;84034;4729;23253;9663;9989;339291;9984;10928;162655;63895;201475;64863;342850;27098;646000;753;7541;55125;55556;10403;4158;84203;388468;147495;9218;5797;494514;1149;5771;10939;1068;79959;9229;7298;91133;11031;56907;7050;81929;4161;81035;2774;23347;10627;8731;8736;374860;284217;23136,66
-1,1,18,14275,8751794,8737519,91133;116;55556;10403;23255;9663;645369;103910;642597;7050;339291;9984;9097;7525;81035;23347;10627;5797;494514;201475;64863;1068;8736;9229;27098;284217;79822;84034;23136;7298;7541,31
-1,1,18,14275,12794384,12780109,116;55556;10403;23255;57132;8774;645369;84203;57045;103910;642597;84617;9097;7525;147495;10650;9218;3613;5797;494514;1149;56984;5771;10939;1068;65258;79959;9229;79822;84034;4729;7298;91133;11031;23253;9663;56907;9989;7050;339291;9984;81035;10928;2774;23347;63895;10627;201475;64863;8736;342850;27098;284217;646000;23136;7541,56
-1,1,18,14275,13626665,13612390,116;55556;10403;23255;57132;8774;645369;84203;57045;103910;642597;84617;9097;7525;147495;10650;9218;3613;5797;494514;1149;56984;5771;10939;1068;65258;79959;9229;79822;84034;4729;7298;91133;11031;23253;9663;56907;9989;7050;339291;81929;9984;81035;10928;2774;23347;63895;10627;201475;64863;8736;342850;27098;284217;646000;753;23136;7541;55125,59
-1,1,18,14275,18529906,18515631,116;23255;57132;8774;645369;125228;57045;103910;642597;84617;9097;7525;10650;3613;56984;65258;79822;84034;4729;23253;9663;9989;339291;9984;10928;162655;63895;201475;64863;342850;27098;646000;753;7541;55125;55556;10403;4158;84203;388468;147495;9218;6093;5797;494514;1149;5771;10939;1068;79959;9229;7298;91133;11031;56907;7050;81929;4161;81035;2774;23347;10627;8731;8736;374860;284217;23136,67
-1,1,18,14275,18529906,18515631,116;23255;57132;8774;645369;125228;57045;103910;642597;84617;9097;7525;10650;3613;56984;65258;79822;84034;4729;23253;9663;9989;339291;9984;10928;162655;63895;201475;64863;342850;27098;646000;753;7541;55125;55556;10403;4158;84203;388468;147495;9218;6093;5797;494514;1149;5771;10939;1068;79959;9229;7298;91133;11031;56907;7050;81929;4161;81035;2774;23347;10627;8731;8736;374860;284217;23136,67
1,-1,18,14316,69754,55438,,0
1,-1,18,14316,69754,55438,,0
-1,-1,18,14316,69754,55438,,0
1,-1,18,14316,69754,55438,,0
1,-1,18,14316,69754,55438,,0
1,-1,18,14316,69754,55438,,0
1,-1,18,14316,69754,55438,,0
1,-1,18,14316,69754,55438,,0
1,-1,18,14316,69754,55438,,0
1,-1,18,14316,69754,55438,,0
1,-1,18,14316,69754,55438,,0
1,-1,18,14316,69754,55438,,0
1,1,18,14316,14206224,14191908,116;23255;57132;8774;645369;125228;57045;103910;642597;84617;9097;7525;10650;3613;56984;65258;79822;84034;4729;23253;9663;9989;339291;9984;10928;162655;63895;201475;64863;342850;27098;646000;753;7541;55125;55556;10403;4158;84203;147495;9218;5797;494514;1149;5771;10939;1068;79959;9229;7298;91133;11031;56907;7050;81929;4161;81035;2774;23347;10627;8731;8736;284217;23136,64
-1,1,18,48782,14978075,14929293,116;23255;57132;8774;645369;125228;57045;103910;642597;84617;9097;7525;10650;3613;56984;65258;79822;84034;4729;23253;9663;9989;339291;9984;10928;162655;63895;201475;64863;342850;27098;646000;753;7541;55125;55556;10403;4158;84203;388468;147495;9218;5797;494514;1149;5771;10939;1068;79959;9229;7298;91133;11031;56907;7050;81929;4161;81035;2774;23347;10627;8731;8736;374860;284217;23136,66
-1,1,18,85432,7094699,7009267,91133;116;55556;10403;9663;645369;103910;642597;7050;9984;9097;7525;81035;23347;10627;494514;64863;1068;8736;9229;27098;284217;79822;84034;23136;7298;7541,27
-1,1,18,118760,4470508,4351748,116;55556;10403;9663;103910;7050;9984;9097;7525;81035;23347;10627;494514;64863;1068;8736;9229;27098;84034;7298,20
-1,1,18,118760,6275717,6156957,91133;116;55556;10403;9663;645369;103910;642597;7050;9984;9097;7525;81035;23347;10627;494514;64863;1068;8736;9229;27098;84034;23136;7298;7541,25
-1,1,18,118760,8999130,8880370,91133;116;55556;10403;23255;9663;645369;103910;642597;7050;339291;9984;9097;7525;81035;23347;10627;5797;494514;201475;64863;1068;8736;9229;27098;284217;79822;84034;23136;7298;7541,31
1,1,18,118760,14089409,13970649,116;55556;10403;23255;57132;4158;8774;645369;84203;125228;57045;103910;642597;84617;9097;7525;147495;10650;9218;3613;5797;494514;1149;56984;5771;10939;1068;65258;79959;9229;79822;84034;4729;7298;91133;11031;23253;9663;56907;9989;7050;339291;81929;4161;9984;81035;10928;2774;23347;63895;10627;8731;201475;64863;8736;342850;27098;284217;646000;753;23136;7541;55125,63
-1,1,18,118760,14089409,13970649,116;55556;10403;23255;57132;4158;8774;645369;84203;125228;57045;103910;642597;84617;9097;7525;147495;10650;9218;3613;5797;494514;1149;56984;5771;10939;1068;65258;79959;9229;79822;84034;4729;7298;91133;11031;23253;9663;56907;9989;7050;339291;81929;4161;9984;81035;10928;2774;23347;63895;10627;8731;201475;64863;8736;342850;27098;284217;646000;753;23136;7541;55125,63
-1,1,18,118760,14089409,13970649,116;55556;10403;23255;57132;4158;8774;645369;84203;125228;57045;103910;642597;84617;9097;7525;147495;10650;9218;3613;5797;494514;1149;56984;5771;10939;1068;65258;79959;9229;79822;84034;4729;7298;91133;11031;23253;9663;56907;9989;7050;339291;81929;4161;9984;81035;10928;2774;23347;63895;10627;8731;201475;64863;8736;342850;27098;284217;646000;753;23136;7541;55125,63
1,1,18,118760,14089409,13970649,116;55556;10403;23255;57132;4158;8774;645369;84203;125228;57045;103910;642597;84617;9097;7525;147495;10650;9218;3613;5797;494514;1149;56984;5771;10939;1068;65258;79959;9229;79822;84034;4729;7298;91133;11031;23253;9663;56907;9989;7050;339291;81929;4161;9984;81035;10928;2774;23347;63895;10627;8731;201475;64863;8736;342850;27098;284217;646000;753;23136;7541;55125,63
1,1,18,118760,14089409,13970649,116;55556;10403;23255;57132;4158;8774;645369;84203;125228;57045;103910;642597;84617;9097;7525;147495;10650;9218;3613;5797;494514;1149;56984;5771;10939;1068;65258;79959;9229;79822;84034;4729;7298;91133;11031;23253;9663;56907;9989;7050;339291;81929;4161;9984;81035;10928;2774;23347;63895;10627;8731;201475;64863;8736;342850;27098;284217;646000;753;23136;7541;55125,63
-1,1,18,118760,15024002,14905242,116;23255;57132;8774;645369;125228;57045;103910;642597;84617;9097;7525;10650;3613;56984;65258;79822;84034;4729;23253;9663;9989;339291;9984;10928;162655;63895;201475;64863;342850;27098;646000;753;7541;55125;55556;10403;4158;84203;388468;147495;9218;5797;494514;1149;5771;10939;1068;79959;9229;7298;91133;11031;56907;7050;81929;4161;81035;2774;23347;10627;8731;8736;374860;284217;23136,66
1,1,18,118760,78012829,77894069,100526842;1630;23255;57132;125228;642597;84735;284252;5596;7525;84064;284257;1005;83539;6139;101927322;9984;10928;162655;63895;162699;64863;342850;374868;7541;2587;26040;4200;64762;80000;114799;9658;147407;147495;9218;54877;81832;9229;7298;26251;91133;56907;92126;57724;7050;26256;8715;30827;23347;2627;10627;143471;8736;374860;171586;284217;23136;284266;100505549;85019;51046;8774;645369;494470;57045;728929;4152;652991;201501;9097;644041;10650;57565;5268;79822;100101467;8170;1830;23253;5289;54941;6875;201475;3909;125476;7776;374864;83473;10403;54495;1824;388468;115701;79863;8710;6860;25914;7572;114876;1829;147323;23327;28316;6093;1149;5771;57614;79959;6632;252884;57534;51124;7276;80148;81929;56853;6014;5205;125488;284273;284293;84552;55250;9388;220164;5366;116;89778;83876;55628;25941;4645;3998;8780;103910;147372;8792;4772;84617;4155;3613;56984;65258;2235;29919;91768;9663;5273;23239;339291;11201;4087;79839;55748;2589;753;2922;284274;55125;28513;1528;201456;84203;4864;55197;9306;9331;59340;80206;494514;55205;6925;4160;55364;54808;81035;220134;6563;147463;162681;9063;8731;10666;64693;100506888;51320;147381;5874;25925;1828;80323;1823;9480;5275;8932;27164;440498;498;89777;51444;4729;84034;4677;29906;9989;4089;23556;9150;1837;10194;220158;6317;125336;6318;4092;284254;115106;27098;10892;646000;90701;5271;29090;10907;9811;125704;55556;25800;4158;497661;400658;10982;51224;5932;5055;5797;10939;1068;6760;84307;80816;83608;55034;10449;147409;11031;361;55520;4161;30062;4225;23335;596;1000;339302;2774;22850;9050;147339;220136;220441;1825;57536;9525;2531;22878;9352,267
1,1,18,118760,78012829,77894069,100526842;1630;23255;57132;125228;642597;84735;284252;5596;7525;84064;284257;1005;83539;6139;101927322;9984;10928;162655;63895;162699;64863;342850;374868;7541;2587;26040;4200;64762;80000;114799;9658;147407;147495;9218;54877;81832;9229;7298;26251;91133;56907;92126;57724;7050;26256;8715;30827;23347;2627;10627;143471;8736;374860;171586;284217;23136;284266;100505549;85019;51046;8774;645369;494470;57045;728929;4152;652991;201501;9097;644041;10650;57565;5268;79822;100101467;8170;1830;23253;5289;54941;6875;201475;3909;125476;7776;374864;83473;10403;54495;1824;388468;115701;79863;8710;6860;25914;7572;114876;1829;147323;23327;28316;6093;1149;5771;57614;79959;6632;252884;57534;51124;7276;80148;81929;56853;6014;5205;125488;284273;284293;84552;55250;9388;220164;5366;116;89778;83876;55628;25941;4645;3998;8780;103910;147372;8792;4772;84617;4155;3613;56984;65258;2235;29919;91768;9663;5273;23239;339291;11201;4087;79839;55748;2589;753;2922;284274;55125;28513;1528;201456;84203;4864;55197;9306;9331;59340;80206;494514;55205;6925;4160;55364;54808;81035;220134;6563;147463;162681;9063;8731;10666;64693;100506888;51320;147381;5874;25925;1828;80323;1823;9480;5275;8932;27164;440498;498;89777;51444;4729;84034;4677;29906;9989;4089;23556;9150;1837;10194;220158;6317;125336;6318;4092;284254;115106;27098;10892;646000;90701;5271;29090;10907;9811;125704;55556;25800;4158;497661;400658;10982;51224;5932;5055;5797;10939;1068;6760;84307;80816;83608;55034;10449;147409;11031;361;55520;4161;30062;4225;23335;596;1000;339302;2774;22850;9050;147339;220136;220441;1825;57536;9525;2531;22878;9352,267
1,1,18,118760,78012829,77894069,100526842;1630;23255;57132;125228;642597;84735;284252;5596;7525;84064;284257;1005;83539;6139;101927322;9984;10928;162655;63895;162699;64863;342850;374868;7541;2587;26040;4200;64762;80000;114799;9658;147407;147495;9218;54877;81832;9229;7298;26251;91133;56907;92126;57724;7050;26256;8715;30827;23347;2627;10627;143471;8736;374860;171586;284217;23136;284266;100505549;85019;51046;8774;645369;494470;57045;728929;4152;652991;201501;9097;644041;10650;57565;5268;79822;100101467;8170;1830;23253;5289;54941;6875;201475;3909;125476;7776;374864;83473;10403;54495;1824;388468;115701;79863;8710;6860;25914;7572;114876;1829;147323;23327;28316;6093;1149;5771;57614;79959;6632;252884;57534;51124;7276;80148;81929;56853;6014;5205;125488;284273;284293;84552;55250;9388;220164;5366;116;89778;83876;55628;25941;4645;3998;8780;103910;147372;8792;4772;84617;4155;3613;56984;65258;2235;29919;91768;9663;5273;23239;339291;11201;4087;79839;55748;2589;753;2922;284274;55125;28513;1528;201456;84203;4864;55197;9306;9331;59340;80206;494514;55205;6925;4160;55364;54808;81035;220134;6563;147463;162681;9063;8731;10666;64693;100506888;51320;147381;5874;25925;1828;80323;1823;9480;5275;8932;27164;440498;498;89777;51444;4729;84034;4677;29906;9989;4089;23556;9150;1837;10194;220158;6317;125336;6318;4092;284254;115106;27098;10892;646000;90701;5271;29090;10907;9811;125704;55556;25800;4158;497661;400658;10982;51224;5932;5055;5797;10939;1068;6760;84307;80816;83608;55034;10449;147409;11031;361;55520;4161;30062;4225;23335;596;1000;339302;2774;22850;9050;147339;220136;220441;1825;57536;9525;2531;22878;9352,267
1,1,18,118760,78012829,77894069,100526842;1630;23255;57132;125228;642597;84735;284252;5596;7525;84064;284257;1005;83539;6139;101927322;9984;10928;162655;63895;162699;64863;342850;374868;7541;2587;26040;4200;64762;80000;114799;9658;147407;147495;9218;54877;81832;9229;7298;26251;91133;56907;92126;57724;7050;26256;8715;30827;23347;2627;10627;143471;8736;374860;171586;284217;23136;284266;100505549;85019;51046;8774;645369;494470;57045;728929;4152;652991;201501;9097;644041;10650;57565;5268;79822;100101467;8170;1830;23253;5289;54941;6875;201475;3909;125476;7776;374864;83473;10403;54495;1824;388468;115701;79863;8710;6860;25914;7572;114876;1829;147323;23327;28316;6093;1149;5771;57614;79959;6632;252884;57534;51124;7276;80148;81929;56853;6014;5205;125488;284273;284293;84552;55250;9388;220164;5366;116;89778;83876;55628;25941;4645;3998;8780;103910;147372;8792;4772;84617;4155;3613;56984;65258;2235;29919;91768;9663;5273;23239;339291;11201;4087;79839;55748;2589;753;2922;284274;55125;28513;1528;201456;84203;4864;55197;9306;9331;59340;80206;494514;55205;6925;4160;55364;54808;81035;220134;6563;147463;162681;9063;8731;10666;64693;100506888;51320;147381;5874;25925;1828;80323;1823;9480;5275;8932;27164;440498;498;89777;51444;4729;84034;4677;29906;9989;4089;23556;9150;1837;10194;220158;6317;125336;6318;4092;284254;115106;27098;10892;646000;90701;5271;29090;10907;9811;125704;55556;25800;4158;497661;400658;10982;51224;5932;5055;5797;10939;1068;6760;84307;80816;83608;55034;10449;147409;11031;361;55520;4161;30062;4225;23335;596;1000;339302;2774;22850;9050;147339;220136;220441;1825;57536;9525;2531;22878;9352,267
1,1,18,118760,78012829,77894069,100526842;1630;23255;57132;125228;642597;84735;284252;5596;7525;84064;284257;1005;83539;6139;101927322;9984;10928;162655;63895;162699;64863;342850;374868;7541;2587;26040;4200;64762;80000;114799;9658;147407;147495;9218;54877;81832;9229;7298;26251;91133;56907;92126;57724;7050;26256;8715;30827;23347;2627;10627;143471;8736;374860;171586;284217;23136;284266;100505549;85019;51046;8774;645369;494470;57045;728929;4152;652991;201501;9097;644041;10650;57565;5268;79822;100101467;8170;1830;23253;5289;54941;6875;201475;3909;125476;7776;374864;83473;10403;54495;1824;388468;115701;79863;8710;6860;25914;7572;114876;1829;147323;23327;28316;6093;1149;5771;57614;79959;6632;252884;57534;51124;7276;80148;81929;56853;6014;5205;125488;284273;284293;84552;55250;9388;220164;5366;116;89778;83876;55628;25941;4645;3998;8780;103910;147372;8792;4772;84617;4155;3613;56984;65258;2235;29919;91768;9663;5273;23239;339291;11201;4087;79839;55748;2589;753;2922;284274;55125;28513;1528;201456;84203;4864;55197;9306;9331;59340;80206;494514;55205;6925;4160;55364;54808;81035;220134;6563;147463;162681;9063;8731;10666;64693;100506888;51320;147381;5874;25925;1828;80323;1823;9480;5275;8932;27164;440498;498;89777;51444;4729;84034;4677;29906;9989;4089;23556;9150;1837;10194;220158;6317;125336;6318;4092;284254;115106;27098;10892;646000;90701;5271;29090;10907;9811;125704;55556;25800;4158;497661;400658;10982;51224;5932;5055;5797;10939;1068;6760;84307;80816;83608;55034;10449;147409;11031;361;55520;4161;30062;4225;23335;596;1000;339302;2774;22850;9050;147339;220136;220441;1825;57536;9525;2531;22878;9352,267
1,1,18,118760,78012829,77894069,100526842;1630;23255;57132;125228;642597;84735;284252;5596;7525;84064;284257;1005;83539;6139;101927322;9984;10928;162655;63895;162699;64863;342850;374868;7541;2587;26040;4200;64762;80000;114799;9658;147407;147495;9218;54877;81832;9229;7298;26251;91133;56907;92126;57724;7050;26256;8715;30827;23347;2627;10627;143471;8736;374860;171586;284217;23136;284266;100505549;85019;51046;8774;645369;494470;57045;728929;4152;652991;201501;9097;644041;10650;57565;5268;79822;100101467;8170;1830;23253;5289;54941;6875;201475;3909;125476;7776;374864;83473;10403;54495;1824;388468;115701;79863;8710;6860;25914;7572;114876;1829;147323;23327;28316;6093;1149;5771;57614;79959;6632;252884;57534;51124;7276;80148;81929;56853;6014;5205;125488;284273;284293;84552;55250;9388;220164;5366;116;89778;83876;55628;25941;4645;3998;8780;103910;147372;8792;4772;84617;4155;3613;56984;65258;2235;29919;91768;9663;5273;23239;339291;11201;4087;79839;55748;2589;753;2922;284274;55125;28513;1528;201456;84203;4864;55197;9306;9331;59340;80206;494514;55205;6925;4160;55364;54808;81035;220134;6563;147463;162681;9063;8731;10666;64693;100506888;51320;147381;5874;25925;1828;80323;1823;9480;5275;8932;27164;440498;498;89777;51444;4729;84034;4677;29906;9989;4089;23556;9150;1837;10194;220158;6317;125336;6318;4092;284254;115106;27098;10892;646000;90701;5271;29090;10907;9811;125704;55556;25800;4158;497661;400658;10982;51224;5932;5055;5797;10939;1068;6760;84307;80816;83608;55034;10449;147409;11031;361;55520;4161;30062;4225;23335;596;1000;339302;2774;22850;9050;147339;220136;220441;1825;57536;9525;2531;22878;9352,267
1,1,18,118760,78012829,77894069,100526842;1630;23255;57132;125228;642597;84735;284252;5596;7525;84064;284257;1005;83539;6139;101927322;9984;10928;162655;63895;162699;64863;342850;374868;7541;2587;26040;4200;64762;80000;114799;9658;147407;147495;9218;54877;81832;9229;7298;26251;91133;56907;92126;57724;7050;26256;8715;30827;23347;2627;10627;143471;8736;374860;171586;284217;23136;284266;100505549;85019;51046;8774;645369;494470;57045;728929;4152;652991;201501;9097;644041;10650;57565;5268;79822;100101467;8170;1830;23253;5289;54941;6875;201475;3909;125476;7776;374864;83473;10403;54495;1824;388468;115701;79863;8710;6860;25914;7572;114876;1829;147323;23327;28316;6093;1149;5771;57614;79959;6632;252884;57534;51124;7276;80148;81929;56853;6014;5205;125488;284273;284293;84552;55250;9388;220164;5366;116;89778;83876;55628;25941;4645;3998;8780;103910;147372;8792;4772;84617;4155;3613;56984;65258;2235;29919;91768;9663;5273;23239;339291;11201;4087;79839;55748;2589;753;2922;284274;55125;28513;1528;201456;84203;4864;55197;9306;9331;59340;80206;494514;55205;6925;4160;55364;54808;81035;220134;6563;147463;162681;9063;8731;10666;64693;100506888;51320;147381;5874;25925;1828;80323;1823;9480;5275;8932;27164;440498;498;89777;51444;4729;84034;4677;29906;9989;4089;23556;9150;1837;10194;220158;6317;125336;6318;4092;284254;115106;27098;10892;646000;90701;5271;29090;10907;9811;125704;55556;25800;4158;497661;400658;10982;51224;5932;5055;5797;10939;1068;6760;84307;80816;83608;55034;10449;147409;11031;361;55520;4161;30062;4225;23335;596;1000;339302;2774;22850;9050;147339;220136;220441;1825;57536;9525;2531;22878;9352,267
1,1,18,118760,78012829,77894069,100526842;1630;23255;57132;125228;642597;84735;284252;5596;7525;84064;284257;1005;83539;6139;101927322;9984;10928;162655;63895;162699;64863;342850;374868;7541;2587;26040;4200;64762;80000;114799;9658;147407;147495;9218;54877;81832;9229;7298;26251;91133;56907;92126;57724;7050;26256;8715;30827;23347;2627;10627;143471;8736;374860;171586;284217;23136;284266;100505549;85019;51046;8774;645369;494470;57045;728929;4152;652991;201501;9097;644041;10650;57565;5268;79822;100101467;8170;1830;23253;5289;54941;6875;201475;3909;125476;7776;374864;83473;10403;54495;1824;388468;115701;79863;8710;6860;25914;7572;114876;1829;147323;23327;28316;6093;1149;5771;57614;79959;6632;252884;57534;51124;7276;80148;81929;56853;6014;5205;125488;284273;284293;84552;55250;9388;220164;5366;116;89778;83876;55628;25941;4645;3998;8780;103910;147372;8792;4772;84617;4155;3613;56984;65258;2235;29919;91768;9663;5273;23239;339291;11201;4087;79839;55748;2589;753;2922;284274;55125;28513;1528;201456;84203;4864;55197;9306;9331;59340;80206;494514;55205;6925;4160;55364;54808;81035;220134;6563;147463;162681;9063;8731;10666;64693;100506888;51320;147381;5874;25925;1828;80323;1823;9480;5275;8932;27164;440498;498;89777;51444;4729;84034;4677;29906;9989;4089;23556;9150;1837;10194;220158;6317;125336;6318;4092;284254;115106;27098;10892;646000;90701;5271;29090;10907;9811;125704;55556;25800;4158;497661;400658;10982;51224;5932;5055;5797;10939;1068;6760;84307;80816;83608;55034;10449;147409;11031;361;55520;4161;30062;4225;23335;596;1000;339302;2774;22850;9050;147339;220136;220441;1825;57536;9525;2531;22878;9352,267
1,1,18,118760,78012829,77894069,100526842;1630;23255;57132;125228;642597;84735;284252;5596;7525;84064;284257;1005;83539;6139;101927322;9984;10928;162655;63895;162699;64863;342850;374868;7541;2587;26040;4200;64762;80000;114799;9658;147407;147495;9218;54877;81832;9229;7298;26251;91133;56907;92126;57724;7050;26256;8715;30827;23347;2627;10627;143471;8736;374860;171586;284217;23136;284266;100505549;85019;51046;8774;645369;494470;57045;728929;4152;652991;201501;9097;644041;10650;57565;5268;79822;100101467;8170;1830;23253;5289;54941;6875;201475;3909;125476;7776;374864;83473;10403;54495;1824;388468;115701;79863;8710;6860;25914;7572;114876;1829;147323;23327;28316;6093;1149;5771;57614;79959;6632;252884;57534;51124;7276;80148;81929;56853;6014;5205;125488;284273;284293;84552;55250;9388;220164;5366;116;89778;83876;55628;25941;4645;3998;8780;103910;147372;8792;4772;84617;4155;3613;56984;65258;2235;29919;91768;9663;5273;23239;339291;11201;4087;79839;55748;2589;753;2922;284274;55125;28513;1528;201456;84203;4864;55197;9306;9331;59340;80206;494514;55205;6925;4160;55364;54808;81035;220134;6563;147463;162681;9063;8731;10666;64693;100506888;51320;147381;5874;25925;1828;80323;1823;9480;5275;8932;27164;440498;498;89777;51444;4729;84034;4677;29906;9989;4089;23556;9150;1837;10194;220158;6317;125336;6318;4092;284254;115106;27098;10892;646000;90701;5271;29090;10907;9811;125704;55556;25800;4158;497661;400658;10982;51224;5932;5055;5797;10939;1068;6760;84307;80816;83608;55034;10449;147409;11031;361;55520;4161;30062;4225;23335;596;1000;339302;2774;22850;9050;147339;220136;220441;1825;57536;9525;2531;22878;9352,267
1,1,18,118760,78012829,77894069,100526842;1630;23255;57132;125228;642597;84735;284252;5596;7525;84064;284257;1005;83539;6139;101927322;9984;10928;162655;63895;162699;64863;342850;374868;7541;2587;26040;4200;64762;80000;114799;9658;147407;147495;9218;54877;81832;9229;7298;26251;91133;56907;92126;57724;7050;26256;8715;30827;23347;2627;10627;143471;8736;374860;171586;284217;23136;284266;100505549;85019;51046;8774;645369;494470;57045;728929;4152;652991;201501;9097;644041;10650;57565;5268;79822;100101467;8170;1830;23253;5289;54941;6875;201475;3909;125476;7776;374864;83473;10403;54495;1824;388468;115701;79863;8710;6860;25914;7572;114876;1829;147323;23327;28316;6093;1149;5771;57614;79959;6632;252884;57534;51124;7276;80148;81929;56853;6014;5205;125488;284273;284293;84552;55250;9388;220164;5366;116;89778;83876;55628;25941;4645;3998;8780;103910;147372;8792;4772;84617;4155;3613;56984;65258;2235;29919;91768;9663;5273;23239;339291;11201;4087;79839;55748;2589;753;2922;284274;55125;28513;1528;201456;84203;4864;55197;9306;9331;59340;80206;494514;55205;6925;4160;55364;54808;81035;220134;6563;147463;162681;9063;8731;10666;64693;100506888;51320;147381;5874;25925;1828;80323;1823;9480;5275;8932;27164;440498;498;89777;51444;4729;84034;4677;29906;9989;4089;23556;9150;1837;10194;220158;6317;125336;6318;4092;284254;115106;27098;10892;646000;90701;5271;29090;10907;9811;125704;55556;25800;4158;497661;400658;10982;51224;5932;5055;5797;10939;1068;6760;84307;80816;83608;55034;10449;147409;11031;361;55520;4161;30062;4225;23335;596;1000;339302;2774;22850;9050;147339;220136;220441;1825;57536;9525;2531;22878;9352,267
1,1,18,131500,4421014,4289514,116;55556;10403;9663;103910;7050;9984;9097;7525;81035;23347;10627;494514;64863;1068;8736;9229;27098;84034;7298,20
-1,1,18,133157,14089409,13956252,116;55556;10403;23255;57132;4158;8774;645369;84203;125228;57045;103910;642597;84617;9097;7525;147495;10650;9218;3613;5797;494514;1149;56984;5771;10939;1068;65258;79959;9229;79822;84034;4729;7298;91133;11031;23253;9663;56907;9989;7050;339291;81929;4161;9984;81035;10928;2774;23347;63895;10627;8731;201475;64863;8736;342850;27098;284217;646000;753;23136;7541;55125,63
-1,1,18,133157,14089409,13956252,116;55556;10403;23255;57132;4158;8774;645369;84203;125228;57045;103910;642597;84617;9097;7525;147495;10650;9218;3613;5797;494514;1149;56984;5771;10939;1068;65258;79959;9229;79822;84034;4729;7298;91133;11031;23253;9663;56907;9989;7050;339291;81929;4161;9984;81035;10928;2774;23347;63895;10627;8731;201475;64863;8736;342850;27098;284217;646000;753;23136;7541;55125,63
-1,1,18,136226,1742272,1606046,116;55556;494514;1068;7525;27098;9984;9097;7298;81035,10
-1,1,18,136226,2994134,2857908,116;55556;10403;23347;9663;494514;64863;1068;7525;27098;9984;84034;9097;7298;81035,15
-1,1,18,136226,3297143,3160917,116;55556;10403;9663;103910;9984;9097;7525;81035;23347;10627;494514;64863;1068;8736;27098;84034;7298,18
1,1,18,136226,3547887,3411661,116;55556;10403;9663;103910;7050;9984;9097;7525;81035;23347;10627;494514;64863;1068;8736;9229;27098;84034;7298,20
-1,1,18,136226,4002983,3866757,116;55556;10403;9663;103910;7050;9984;9097;7525;81035;23347;10627;494514;64863;1068;8736;9229;27098;84034;7298,20
-1,1,18,136226,4464955,4328729,116;55556;10403;9663;103910;7050;9984;9097;7525;81035;23347;10627;494514;64863;1068;8736;9229;27098;84034;7298,20
-1,1,18,136226,4802274,4666048,116;55556;10403;9663;103910;7050;9984;9097;7525;81035;23347;10627;494514;64863;1068;8736;9229;27098;84034;7298,20
-1,1,18,136226,5323941,5187715,116;55556;10403;9663;103910;642597;7050;9984;9097;7525;81035;23347;10627;494514;64863;1068;8736;9229;27098;84034;7298;7541,22
1,1,18,136226,9789368,9653142,116;55556;10403;23255;645369;57045;103910;642597;9097;7525;5797;494514;1068;9229;79822;84034;4729;7298;91133;11031;23253;9663;9989;7050;339291;9984;81035;10928;23347;10627;201475;64863;8736;27098;284217;23136;7541,37
1,1,18,136226,14337133,14200907,116;23255;57132;8774;645369;125228;57045;103910;642597;84617;9097;7525;10650;3613;56984;65258;79822;84034;4729;23253;9663;9989;339291;9984;10928;162655;63895;201475;64863;342850;27098;646000;753;7541;55125;55556;10403;4158;84203;147495;9218;5797;494514;1149;5771;10939;1068;79959;9229;7298;91133;11031;56907;7050;81929;4161;81035;2774;23347;10627;8731;8736;284217;23136,64
-1,1,18,136226,14983938,14847712,116;23255;57132;8774;645369;125228;57045;103910;642597;84617;9097;7525;10650;3613;56984;65258;79822;84034;4729;23253;9663;9989;339291;9984;10928;162655;63895;201475;64863;342850;27098;646000;753;7541;55125;55556;10403;4158;84203;388468;147495;9218;5797;494514;1149;5771;10939;1068;79959;9229;7298;91133;11031;56907;7050;81929;4161;81035;2774;23347;10627;8731;8736;374860;284217;23136,66
-1,1,18,136226,15157836,15021610,116;23255;57132;8774;645369;125228;57045;103910;642597;84617;9097;7525;10650;3613;56984;65258;79822;84034;4729;23253;9663;9989;339291;9984;10928;162655;63895;201475;64863;342850;27098;646000;753;7541;55125;55556;10403;4158;84203;388468;147495;9218;5797;494514;1149;5771;10939;1068;79959;9229;7298;91133;11031;56907;7050;81929;4161;81035;2774;23347;10627;8731;8736;374860;284217;23136,66
1,1,18,136226,15157836,15021610,116;23255;57132;8774;645369;125228;57045;103910;642597;84617;9097;7525;10650;3613;56984;65258;79822;84034;4729;23253;9663;9989;339291;9984;10928;162655;63895;201475;64863;342850;27098;646000;753;7541;55125;55556;10403;4158;84203;388468;147495;9218;5797;494514;1149;5771;10939;1068;79959;9229;7298;91133;11031;56907;7050;81929;4161;81035;2774;23347;10627;8731;8736;374860;284217;23136,66
-1,1,18,136226,15157836,15021610,116;23255;57132;8774;645369;125228;57045;103910;642597;84617;9097;7525;10650;3613;56984;65258;79822;84034;4729;23253;9663;9989;339291;9984;10928;162655;63895;201475;64863;342850;27098;646000;753;7541;55125;55556;10403;4158;84203;388468;147495;9218;5797;494514;1149;5771;10939;1068;79959;9229;7298;91133;11031;56907;7050;81929;4161;81035;2774;23347;10627;8731;8736;374860;284217;23136,66
1,1,18,136226,15175005,15038779,116;23255;57132;8774;645369;125228;57045;103910;642597;84617;9097;7525;10650;3613;56984;65258;79822;84034;4729;23253;9663;9989;339291;9984;10928;162655;63895;201475;64863;342850;27098;646000;753;7541;55125;55556;10403;4158;84203;388468;147495;9218;5797;494514;1149;5771;10939;1068;79959;9229;7298;91133;11031;56907;7050;81929;4161;81035;2774;23347;10627;8731;8736;374860;284217;23136,66
1,1,18,136226,15198990,15062764,116;23255;57132;8774;645369;125228;57045;103910;642597;84617;9097;7525;10650;3613;56984;65258;79822;84034;4729;23253;9663;9989;339291;9984;10928;162655;63895;201475;64863;342850;27098;646000;753;7541;55125;55556;10403;4158;84203;388468;147495;9218;5797;494514;1149;5771;10939;1068;79959;9229;7298;91133;11031;56907;7050;81929;4161;81035;2774;23347;10627;8731;8736;374860;284217;23136,66
1,1,18,136226,15198990,15062764,116;23255;57132;8774;645369;125228;57045;103910;642597;84617;9097;7525;10650;3613;56984;65258;79822;84034;4729;23253;9663;9989;339291;9984;10928;162655;63895;201475;64863;342850;27098;646000;753;7541;55125;55556;10403;4158;84203;388468;147495;9218;5797;494514;1149;5771;10939;1068;79959;9229;7298;91133;11031;56907;7050;81929;4161;81035;2774;23347;10627;8731;8736;374860;284217;23136,66
1,1,18,136226,15198990,15062764,116;23255;57132;8774;645369;125228;57045;103910;642597;84617;9097;7525;10650;3613;56984;65258;79822;84034;4729;23253;9663;9989;339291;9984;10928;162655;63895;201475;64863;342850;27098;646000;753;7541;55125;55556;10403;4158;84203;388468;147495;9218;5797;494514;1149;5771;10939;1068;79959;9229;7298;91133;11031;56907;7050;81929;4161;81035;2774;23347;10627;8731;8736;374860;284217;23136,66
-1,1,18,136226,15198990,15062764,116;23255;57132;8774;645369;125228;57045;103910;642597;84617;9097;7525;10650;3613;56984;65258;79822;84034;4729;23253;9663;9989;339291;9984;10928;162655;63895;201475;64863;342850;27098;646000;753;7541;55125;55556;10403;4158;84203;388468;147495;9218;5797;494514;1149;5771;10939;1068;79959;9229;7298;91133;11031;56907;7050;81929;4161;81035;2774;23347;10627;8731;8736;374860;284217;23136,66
-1,1,18,136226,15198990,15062764,116;23255;57132;8774;645369;125228;57045;103910;642597;84617;9097;7525;10650;3613;56984;65258;79822;84034;4729;23253;9663;9989;339291;9984;10928;162655;63895;201475;64863;342850;27098;646000;753;7541;55125;55556;10403;4158;84203;388468;147495;9218;5797;494514;1149;5771;10939;1068;79959;9229;7298;91133;11031;56907;7050;81929;4161;81035;2774;23347;10627;8731;8736;374860;284217;23136,66
-1,1,18,136226,15198990,15062764,116;23255;57132;8774;645369;125228;57045;103910;642597;84617;9097;7525;10650;3613;56984;65258;79822;84034;4729;23253;9663;9989;339291;9984;10928;162655;63895;201475;64863;342850;27098;646000;753;7541;55125;55556;10403;4158;84203;388468;147495;9218;5797;494514;1149;5771;10939;1068;79959;9229;7298;91133;11031;56907;7050;81929;4161;81035;2774;23347;10627;8731;8736;374860;284217;23136,66
1,1,18,136226,15198990,15062764,116;23255;57132;8774;645369;125228;57045;103910;642597;84617;9097;7525;10650;3613;56984;65258;79822;84034;4729;23253;9663;9989;339291;9984;10928;162655;63895;201475;64863;342850;27098;646000;753;7541;55125;55556;10403;4158;84203;388468;147495;9218;5797;494514;1149;5771;10939;1068;79959;9229;7298;91133;11031;56907;7050;81929;4161;81035;2774;23347;10627;8731;8736;374860;284217;23136,66
1,1,18,136226,15198990,15062764,116;23255;57132;8774;645369;125228;57045;103910;642597;84617;9097;7525;10650;3613;56984;65258;79822;84034;4729;23253;9663;9989;339291;9984;10928;162655;63895;201475;64863;342850;27098;646000;753;7541;55125;55556;10403;4158;84203;388468;147495;9218;5797;494514;1149;5771;10939;1068;79959;9229;7298;91133;11031;56907;7050;81929;4161;81035;2774;23347;10627;8731;8736;374860;284217;23136,66
-1,1,18,136226,15198990,15062764,116;23255;57132;8774;645369;125228;57045;103910;642597;84617;9097;7525;10650;3613;56984;65258;79822;84034;4729;23253;9663;9989;339291;9984;10928;162655;63895;201475;64863;342850;27098;646000;753;7541;55125;55556;10403;4158;84203;388468;147495;9218;5797;494514;1149;5771;10939;1068;79959;9229;7298;91133;11031;56907;7050;81929;4161;81035;2774;23347;10627;8731;8736;374860;284217;23136,66
1,1,18,136226,18521285,18385059,116;23255;57132;8774;645369;125228;57045;103910;642597;84617;9097;7525;10650;3613;56984;65258;79822;84034;4729;23253;9663;9989;339291;9984;10928;162655;63895;201475;64863;342850;27098;646000;753;7541;55125;55556;10403;4158;84203;388468;147495;9218;5797;494514;1149;5771;10939;1068;79959;9229;7298;91133;11031;56907;7050;81929;4161;81035;2774;23347;10627;8731;8736;374860;284217;23136,66
1,1,18,136226,18534784,18398558,116;23255;57132;8774;645369;125228;57045;103910;642597;84617;9097;7525;10650;3613;56984;65258;79822;84034;4729;23253;9663;9989;339291;9984;10928;162655;63895;201475;64863;342850;27098;646000;753;7541;55125;55556;10403;4158;84203;388468;147495;9218;6093;5797;494514;1149;5771;10939;1068;79959;9229;7298;91133;11031;56907;7050;81929;4161;81035;2774;23347;10627;8731;8736;374860;284217;23136,67
1,1,18,136226,21657790,21521564,116;85019;23255;57132;8774;645369;125228;57045;8780;103910;642597;84617;9097;7525;10650;3613;56984;65258;79822;84034;4729;29919;23253;91768;9663;9989;339291;9984;10928;162655;63895;201475;64863;3909;342850;27098;646000;753;7541;55125;55556;10403;4158;84203;4864;388468;80000;114799;5932;147495;9218;6093;494514;5797;1149;5771;10939;1068;79959;9229;6632;57534;7298;91133;11031;56907;7050;81929;4161;81035;125488;2774;23347;147463;2627;10627;8731;8736;374860;171586;284217;23136;64693,83
1,1,18,136226,78014123,77877897,100526842;1630;23255;57132;125228;642597;84735;284252;5596;7525;84064;284257;1005;83539;6139;101927322;9984;10928;162655;63895;162699;64863;342850;374868;7541;2587;26040;4200;64762;80000;114799;9658;147407;147495;9218;54877;81832;9229;7298;26251;91133;56907;92126;57724;7050;26256;8715;30827;23347;2627;10627;143471;8736;374860;171586;284217;23136;284266;100505549;85019;51046;8774;645369;494470;57045;728929;4152;652991;201501;9097;644041;10650;57565;5268;79822;100101467;8170;1830;23253;5289;54941;6875;201475;3909;125476;7776;374864;83473;10403;54495;1824;388468;115701;79863;8710;6860;25914;7572;114876;1829;147323;23327;28316;6093;1149;5771;57614;79959;6632;252884;57534;51124;7276;80148;81929;56853;6014;5205;125488;284273;284293;84552;55250;9388;220164;5366;116;89778;83876;55628;25941;4645;3998;8780;103910;147372;8792;4772;84617;4155;3613;56984;65258;2235;29919;91768;9663;5273;23239;339291;11201;4087;79839;55748;2589;753;2922;284274;55125;28513;1528;201456;84203;4864;55197;9306;9331;59340;80206;494514;55205;6925;4160;55364;54808;81035;220134;6563;147463;162681;9063;8731;10666;64693;100506888;51320;147381;5874;25925;1828;80323;1823;9480;5275;8932;27164;440498;498;89777;51444;4729;84034;4677;29906;9989;4089;23556;9150;1837;10194;220158;6317;125336;6318;4092;284254;115106;27098;10892;646000;90701;5271;29090;10907;9811;125704;55556;25800;4158;497661;400658;10982;51224;5932;5055;5797;10939;1068;6760;84307;80816;83608;55034;10449;147409;11031;361;55520;4161;30062;4225;23335;596;1000;339302;2774;22850;9050;147339;220136;220441;1825;57536;9525;2531;22878;9352,267
1,1,18,136226,78014123,77877897,100526842;1630;23255;57132;125228;642597;84735;284252;5596;7525;84064;284257;1005;83539;6139;101927322;9984;10928;162655;63895;162699;64863;342850;374868;7541;2587;26040;4200;64762;80000;114799;9658;147407;147495;9218;54877;81832;9229;7298;26251;91133;56907;92126;57724;7050;26256;8715;30827;23347;2627;10627;143471;8736;374860;171586;284217;23136;284266;100505549;85019;51046;8774;645369;494470;57045;728929;4152;652991;201501;9097;644041;10650;57565;5268;79822;100101467;8170;1830;23253;5289;54941;6875;201475;3909;125476;7776;374864;83473;10403;54495;1824;388468;115701;79863;8710;6860;25914;7572;114876;1829;147323;23327;28316;6093;1149;5771;57614;79959;6632;252884;57534;51124;7276;80148;81929;56853;6014;5205;125488;284273;284293;84552;55250;9388;220164;5366;116;89778;83876;55628;25941;4645;3998;8780;103910;147372;8792;4772;84617;4155;3613;56984;65258;2235;29919;91768;9663;5273;23239;339291;11201;4087;79839;55748;2589;753;2922;284274;55125;28513;1528;201456;84203;4864;55197;9306;9331;59340;80206;494514;55205;6925;4160;55364;54808;81035;220134;6563;147463;162681;9063;8731;10666;64693;100506888;51320;147381;5874;25925;1828;80323;1823;9480;5275;8932;27164;440498;498;89777;51444;4729;84034;4677;29906;9989;4089;23556;9150;1837;10194;220158;6317;125336;6318;4092;284254;115106;27098;10892;646000;90701;5271;29090;10907;9811;125704;55556;25800;4158;497661;400658;10982;51224;5932;5055;5797;10939;1068;6760;84307;80816;83608;55034;10449;147409;11031;361;55520;4161;30062;4225;23335;596;1000;339302;2774;22850;9050;147339;220136;220441;1825;57536;9525;2531;22878;9352,267
1,1,18,136226,78014123,77877897,100526842;1630;23255;57132;125228;642597;84735;284252;5596;7525;84064;284257;1005;83539;6139;101927322;9984;10928;162655;63895;162699;64863;342850;374868;7541;2587;26040;4200;64762;80000;114799;9658;147407;147495;9218;54877;81832;9229;7298;26251;91133;56907;92126;57724;7050;26256;8715;30827;23347;2627;10627;143471;8736;374860;171586;284217;23136;284266;100505549;85019;51046;8774;645369;494470;57045;728929;4152;652991;201501;9097;644041;10650;57565;5268;79822;100101467;8170;1830;23253;5289;54941;6875;201475;3909;125476;7776;374864;83473;10403;54495;1824;388468;115701;79863;8710;6860;25914;7572;114876;1829;147323;23327;28316;6093;1149;5771;57614;79959;6632;252884;57534;51124;7276;80148;81929;56853;6014;5205;125488;284273;284293;84552;55250;9388;220164;5366;116;89778;83876;55628;25941;4645;3998;8780;103910;147372;8792;4772;84617;4155;3613;56984;65258;2235;29919;91768;9663;5273;23239;339291;11201;4087;79839;55748;2589;753;2922;284274;55125;28513;1528;201456;84203;4864;55197;9306;9331;59340;80206;494514;55205;6925;4160;55364;54808;81035;220134;6563;147463;162681;9063;8731;10666;64693;100506888;51320;147381;5874;25925;1828;80323;1823;9480;5275;8932;27164;440498;498;89777;51444;4729;84034;4677;29906;9989;4089;23556;9150;1837;10194;220158;6317;125336;6318;4092;284254;115106;27098;10892;646000;90701;5271;29090;10907;9811;125704;55556;25800;4158;497661;400658;10982;51224;5932;5055;5797;10939;1068;6760;84307;80816;83608;55034;10449;147409;11031;361;55520;4161;30062;4225;23335;596;1000;339302;2774;22850;9050;147339;220136;220441;1825;57536;9525;2531;22878;9352,267
1,1,18,136226,78014123,77877897,100526842;1630;23255;57132;125228;642597;84735;284252;5596;7525;84064;284257;1005;83539;6139;101927322;9984;10928;162655;63895;162699;64863;342850;374868;7541;2587;26040;4200;64762;80000;114799;9658;147407;147495;9218;54877;81832;9229;7298;26251;91133;56907;92126;57724;7050;26256;8715;30827;23347;2627;10627;143471;8736;374860;171586;284217;23136;284266;100505549;85019;51046;8774;645369;494470;57045;728929;4152;652991;201501;9097;644041;10650;57565;5268;79822;100101467;8170;1830;23253;5289;54941;6875;201475;3909;125476;7776;374864;83473;10403;54495;1824;388468;115701;79863;8710;6860;25914;7572;114876;1829;147323;23327;28316;6093;1149;5771;57614;79959;6632;252884;57534;51124;7276;80148;81929;56853;6014;5205;125488;284273;284293;84552;55250;9388;220164;5366;116;89778;83876;55628;25941;4645;3998;8780;103910;147372;8792;4772;84617;4155;3613;56984;65258;2235;29919;91768;9663;5273;23239;339291;11201;4087;79839;55748;2589;753;2922;284274;55125;28513;1528;201456;84203;4864;55197;9306;9331;59340;80206;494514;55205;6925;4160;55364;54808;81035;220134;6563;147463;162681;9063;8731;10666;64693;100506888;51320;147381;5874;25925;1828;80323;1823;9480;5275;8932;27164;440498;498;89777;51444;4729;84034;4677;29906;9989;4089;23556;9150;1837;10194;220158;6317;125336;6318;4092;284254;115106;27098;10892;646000;90701;5271;29090;10907;9811;125704;55556;25800;4158;497661;400658;10982;51224;5932;5055;5797;10939;1068;6760;84307;80816;83608;55034;10449;147409;11031;361;55520;4161;30062;4225;23335;596;1000;339302;2774;22850;9050;147339;220136;220441;1825;57536;9525;2531;22878;9352,267
1,1,18,136226,78014123,77877897,100526842;1630;23255;57132;125228;642597;84735;284252;5596;7525;84064;284257;1005;83539;6139;101927322;9984;10928;162655;63895;162699;64863;342850;374868;7541;2587;26040;4200;64762;80000;114799;9658;147407;147495;9218;54877;81832;9229;7298;26251;91133;56907;92126;57724;7050;26256;8715;30827;23347;2627;10627;143471;8736;374860;171586;284217;23136;284266;100505549;85019;51046;8774;645369;494470;57045;728929;4152;652991;201501;9097;644041;10650;57565;5268;79822;100101467;8170;1830;23253;5289;54941;6875;201475;3909;125476;7776;374864;83473;10403;54495;1824;388468;115701;79863;8710;6860;25914;7572;114876;1829;147323;23327;28316;6093;1149;5771;57614;79959;6632;252884;57534;51124;7276;80148;81929;56853;6014;5205;125488;284273;284293;84552;55250;9388;220164;5366;116;89778;83876;55628;25941;4645;3998;8780;103910;147372;8792;4772;84617;4155;3613;56984;65258;2235;29919;91768;9663;5273;23239;339291;11201;4087;79839;55748;2589;753;2922;284274;55125;28513;1528;201456;84203;4864;55197;9306;9331;59340;80206;494514;55205;6925;4160;55364;54808;81035;220134;6563;147463;162681;9063;8731;10666;64693;100506888;51320;147381;5874;25925;1828;80323;1823;9480;5275;8932;27164;440498;498;89777;51444;4729;84034;4677;29906;9989;4089;23556;9150;1837;10194;220158;6317;125336;6318;4092;284254;115106;27098;10892;646000;90701;5271;29090;10907;9811;125704;55556;25800;4158;497661;400658;10982;51224;5932;5055;5797;10939;1068;6760;84307;80816;83608;55034;10449;147409;11031;361;55520;4161;30062;4225;23335;596;1000;339302;2774;22850;9050;147339;220136;220441;1825;57536;9525;2531;22878;9352,267
1,1,18,136226,78014123,77877897,100526842;1630;23255;57132;125228;642597;84735;284252;5596;7525;84064;284257;1005;83539;6139;101927322;9984;10928;162655;63895;162699;64863;342850;374868;7541;2587;26040;4200;64762;80000;114799;9658;147407;147495;9218;54877;81832;9229;7298;26251;91133;56907;92126;57724;7050;26256;8715;30827;23347;2627;10627;143471;8736;374860;171586;284217;23136;284266;100505549;85019;51046;8774;645369;494470;57045;728929;4152;652991;201501;9097;644041;10650;57565;5268;79822;100101467;8170;1830;23253;5289;54941;6875;201475;3909;125476;7776;374864;83473;10403;54495;1824;388468;115701;79863;8710;6860;25914;7572;114876;1829;147323;23327;28316;6093;1149;5771;57614;79959;6632;252884;57534;51124;7276;80148;81929;56853;6014;5205;125488;284273;284293;84552;55250;9388;220164;5366;116;89778;83876;55628;25941;4645;3998;8780;103910;147372;8792;4772;84617;4155;3613;56984;65258;2235;29919;91768;9663;5273;23239;339291;11201;4087;79839;55748;2589;753;2922;284274;55125;28513;1528;201456;84203;4864;55197;9306;9331;59340;80206;494514;55205;6925;4160;55364;54808;81035;220134;6563;147463;162681;9063;8731;10666;64693;100506888;51320;147381;5874;25925;1828;80323;1823;9480;5275;8932;27164;440498;498;89777;51444;4729;84034;4677;29906;9989;4089;23556;9150;1837;10194;220158;6317;125336;6318;4092;284254;115106;27098;10892;646000;90701;5271;29090;10907;9811;125704;55556;25800;4158;497661;400658;10982;51224;5932;5055;5797;10939;1068;6760;84307;80816;83608;55034;10449;147409;11031;361;55520;4161;30062;4225;23335;596;1000;339302;2774;22850;9050;147339;220136;220441;1825;57536;9525;2531;22878;9352,267
1,1,18,136226,78014123,77877897,100526842;1630;23255;57132;125228;642597;84735;284252;5596;7525;84064;284257;1005;83539;6139;101927322;9984;10928;162655;63895;162699;64863;342850;374868;7541;2587;26040;4200;64762;80000;114799;9658;147407;147495;9218;54877;81832;9229;7298;26251;91133;56907;92126;57724;7050;26256;8715;30827;23347;2627;10627;143471;8736;374860;171586;284217;23136;284266;100505549;85019;51046;8774;645369;494470;57045;728929;4152;652991;201501;9097;644041;10650;57565;5268;79822;100101467;8170;1830;23253;5289;54941;6875;201475;3909;125476;7776;374864;83473;10403;54495;1824;388468;115701;79863;8710;6860;25914;7572;114876;1829;147323;23327;28316;6093;1149;5771;57614;79959;6632;252884;57534;51124;7276;80148;81929;56853;6014;5205;125488;284273;284293;84552;55250;9388;220164;5366;116;89778;83876;55628;25941;4645;3998;8780;103910;147372;8792;4772;84617;4155;3613;56984;65258;2235;29919;91768;9663;5273;23239;339291;11201;4087;79839;55748;2589;753;2922;284274;55125;28513;1528;201456;84203;4864;55197;9306;9331;59340;80206;494514;55205;6925;4160;55364;54808;81035;220134;6563;147463;162681;9063;8731;10666;64693;100506888;51320;147381;5874;25925;1828;80323;1823;9480;5275;8932;27164;440498;498;89777;51444;4729;84034;4677;29906;9989;4089;23556;9150;1837;10194;220158;6317;125336;6318;4092;284254;115106;27098;10892;646000;90701;5271;29090;10907;9811;125704;55556;25800;4158;497661;400658;10982;51224;5932;5055;5797;10939;1068;6760;84307;80816;83608;55034;10449;147409;11031;361;55520;4161;30062;4225;23335;596;1000;339302;2774;22850;9050;147339;220136;220441;1825;57536;9525;2531;22878;9352,267
1,1,18,136227,46171053,46034826,116;23255;57132;25941;125228;8780;103910;642597;284252;84617;7525;84064;3613;56984;65258;83539;29919;91768;9663;339291;9984;10928;162655;4087;63895;162699;64863;342850;2589;753;7541;55125;26040;64762;84203;4864;55197;80000;114799;9331;59340;147407;147495;9218;80206;494514;9229;7298;91133;56907;55364;57724;7050;26256;8715;81035;23347;6563;147463;2627;9063;10627;8731;143471;8736;374860;171586;284217;23136;64693;284266;100506888;85019;8774;645369;494470;57045;25925;1828;1823;728929;652991;201501;9097;10650;57565;498;51444;79822;84034;4729;100101467;8170;1830;23253;29906;9989;5289;1837;54941;6875;125336;201475;3909;115106;27098;125476;646000;374864;9811;83473;55556;10403;25800;4158;1824;388468;10982;6860;7572;51224;114876;1829;5932;6093;5797;1149;5771;10939;1068;79959;6760;6632;252884;84307;80816;83608;57534;55034;147409;11031;51124;361;7276;81929;4161;4225;56853;6014;1000;125488;2774;9050;147339;1825;57536;55250;22878,158
1,1,18,136227,78014123,77877896,100526842;1630;23255;57132;125228;642597;84735;284252;5596;7525;84064;284257;1005;83539;6139;101927322;9984;10928;162655;63895;162699;64863;342850;374868;7541;2587;26040;4200;64762;80000;114799;9658;147407;147495;9218;54877;81832;9229;7298;26251;91133;56907;92126;57724;7050;26256;8715;30827;23347;2627;10627;143471;8736;374860;171586;284217;23136;284266;100505549;85019;51046;8774;645369;494470;57045;728929;4152;652991;201501;9097;644041;10650;57565;5268;79822;100101467;8170;1830;23253;5289;54941;6875;201475;3909;125476;7776;374864;83473;10403;54495;1824;388468;115701;79863;8710;6860;25914;7572;114876;1829;147323;23327;28316;6093;1149;5771;57614;79959;6632;252884;57534;51124;7276;80148;81929;56853;6014;5205;125488;284273;284293;84552;55250;9388;220164;5366;116;89778;83876;55628;25941;4645;3998;8780;103910;147372;8792;4772;84617;4155;3613;56984;65258;2235;29919;91768;9663;5273;23239;339291;11201;4087;79839;55748;2589;753;2922;284274;55125;28513;1528;201456;84203;4864;55197;9306;9331;59340;80206;494514;55205;6925;4160;55364;54808;81035;220134;6563;147463;162681;9063;8731;10666;64693;100506888;51320;147381;5874;25925;1828;80323;1823;9480;5275;8932;27164;440498;498;89777;51444;4729;84034;4677;29906;9989;4089;23556;9150;1837;10194;220158;6317;125336;6318;4092;284254;115106;27098;10892;646000;90701;5271;29090;10907;9811;125704;55556;25800;4158;497661;400658;10982;51224;5932;5055;5797;10939;1068;6760;84307;80816;83608;55034;10449;147409;11031;361;55520;4161;30062;4225;23335;596;1000;339302;2774;22850;9050;147339;220136;220441;1825;57536;9525;2531;22878;9352,267
1,1,18,136227,78014123,77877896,100526842;1630;23255;57132;125228;642597;84735;284252;5596;7525;84064;284257;1005;83539;6139;101927322;9984;10928;162655;63895;162699;64863;342850;374868;7541;2587;26040;4200;64762;80000;114799;9658;147407;147495;9218;54877;81832;9229;7298;26251;91133;56907;92126;57724;7050;26256;8715;30827;23347;2627;10627;143471;8736;374860;171586;284217;23136;284266;100505549;85019;51046;8774;645369;494470;57045;728929;4152;652991;201501;9097;644041;10650;57565;5268;79822;100101467;8170;1830;23253;5289;54941;6875;201475;3909;125476;7776;374864;83473;10403;54495;1824;388468;115701;79863;8710;6860;25914;7572;114876;1829;147323;23327;28316;6093;1149;5771;57614;79959;6632;252884;57534;51124;7276;80148;81929;56853;6014;5205;125488;284273;284293;84552;55250;9388;220164;5366;116;89778;83876;55628;25941;4645;3998;8780;103910;147372;8792;4772;84617;4155;3613;56984;65258;2235;29919;91768;9663;5273;23239;339291;11201;4087;79839;55748;2589;753;2922;284274;55125;28513;1528;201456;84203;4864;55197;9306;9331;59340;80206;494514;55205;6925;4160;55364;54808;81035;220134;6563;147463;162681;9063;8731;10666;64693;100506888;51320;147381;5874;25925;1828;80323;1823;9480;5275;8932;27164;440498;498;89777;51444;4729;84034;4677;29906;9989;4089;23556;9150;1837;10194;220158;6317;125336;6318;4092;284254;115106;27098;10892;646000;90701;5271;29090;10907;9811;125704;55556;25800;4158;497661;400658;10982;51224;5932;5055;5797;10939;1068;6760;84307;80816;83608;55034;10449;147409;11031;361;55520;4161;30062;4225;23335;596;1000;339302;2774;22850;9050;147339;220136;220441;1825;57536;9525;2531;22878;9352,267
1,1,18,136227,78014123,77877896,100526842;1630;23255;57132;125228;642597;84735;284252;5596;7525;84064;284257;1005;83539;6139;101927322;9984;10928;162655;63895;162699;64863;342850;374868;7541;2587;26040;4200;64762;80000;114799;9658;147407;147495;9218;54877;81832;9229;7298;26251;91133;56907;92126;57724;7050;26256;8715;30827;23347;2627;10627;143471;8736;374860;171586;284217;23136;284266;100505549;85019;51046;8774;645369;494470;57045;728929;4152;652991;201501;9097;644041;10650;57565;5268;79822;100101467;8170;1830;23253;5289;54941;6875;201475;3909;125476;7776;374864;83473;10403;54495;1824;388468;115701;79863;8710;6860;25914;7572;114876;1829;147323;23327;28316;6093;1149;5771;57614;79959;6632;252884;57534;51124;7276;80148;81929;56853;6014;5205;125488;284273;284293;84552;55250;9388;220164;5366;116;89778;83876;55628;25941;4645;3998;8780;103910;147372;8792;4772;84617;4155;3613;56984;65258;2235;29919;91768;9663;5273;23239;339291;11201;4087;79839;55748;2589;753;2922;284274;55125;28513;1528;201456;84203;4864;55197;9306;9331;59340;80206;494514;55205;6925;4160;55364;54808;81035;220134;6563;147463;162681;9063;8731;10666;64693;100506888;51320;147381;5874;25925;1828;80323;1823;9480;5275;8932;27164;440498;498;89777;51444;4729;84034;4677;29906;9989;4089;23556;9150;1837;10194;220158;6317;125336;6318;4092;284254;115106;27098;10892;646000;90701;5271;29090;10907;9811;125704;55556;25800;4158;497661;400658;10982;51224;5932;5055;5797;10939;1068;6760;84307;80816;83608;55034;10449;147409;11031;361;55520;4161;30062;4225;23335;596;1000;339302;2774;22850;9050;147339;220136;220441;1825;57536;9525;2531;22878;9352,267
1,1,18,136227,78014123,77877896,100526842;1630;23255;57132;125228;642597;84735;284252;5596;7525;84064;284257;1005;83539;6139;101927322;9984;10928;162655;63895;162699;64863;342850;374868;7541;2587;26040;4200;64762;80000;114799;9658;147407;147495;9218;54877;81832;9229;7298;26251;91133;56907;92126;57724;7050;26256;8715;30827;23347;2627;10627;143471;8736;374860;171586;284217;23136;284266;100505549;85019;51046;8774;645369;494470;57045;728929;4152;652991;201501;9097;644041;10650;57565;5268;79822;100101467;8170;1830;23253;5289;54941;6875;201475;3909;125476;7776;374864;83473;10403;54495;1824;388468;115701;79863;8710;6860;25914;7572;114876;1829;147323;23327;28316;6093;1149;5771;57614;79959;6632;252884;57534;51124;7276;80148;81929;56853;6014;5205;125488;284273;284293;84552;55250;9388;220164;5366;116;89778;83876;55628;25941;4645;3998;8780;103910;147372;8792;4772;84617;4155;3613;56984;65258;2235;29919;91768;9663;5273;23239;339291;11201;4087;79839;55748;2589;753;2922;284274;55125;28513;1528;201456;84203;4864;55197;9306;9331;59340;80206;494514;55205;6925;4160;55364;54808;81035;220134;6563;147463;162681;9063;8731;10666;64693;100506888;51320;147381;5874;25925;1828;80323;1823;9480;5275;8932;27164;440498;498;89777;51444;4729;84034;4677;29906;9989;4089;23556;9150;1837;10194;220158;6317;125336;6318;4092;284254;115106;27098;10892;646000;90701;5271;29090;10907;9811;125704;55556;25800;4158;497661;400658;10982;51224;5932;5055;5797;10939;1068;6760;84307;80816;83608;55034;10449;147409;11031;361;55520;4161;30062;4225;23335;596;1000;339302;2774;22850;9050;147339;220136;220441;1825;57536;9525;2531;22878;9352,267
1,1,18,136227,78014123,77877896,100526842;1630;23255;57132;125228;642597;84735;284252;5596;7525;84064;284257;1005;83539;6139;101927322;9984;10928;162655;63895;162699;64863;342850;374868;7541;2587;26040;4200;64762;80000;114799;9658;147407;147495;9218;54877;81832;9229;7298;26251;91133;56907;92126;57724;7050;26256;8715;30827;23347;2627;10627;143471;8736;374860;171586;284217;23136;284266;100505549;85019;51046;8774;645369;494470;57045;728929;4152;652991;201501;9097;644041;10650;57565;5268;79822;100101467;8170;1830;23253;5289;54941;6875;201475;3909;125476;7776;374864;83473;10403;54495;1824;388468;115701;79863;8710;6860;25914;7572;114876;1829;147323;23327;28316;6093;1149;5771;57614;79959;6632;252884;57534;51124;7276;80148;81929;56853;6014;5205;125488;284273;284293;84552;55250;9388;220164;5366;116;89778;83876;55628;25941;4645;3998;8780;103910;147372;8792;4772;84617;4155;3613;56984;65258;2235;29919;91768;9663;5273;23239;339291;11201;4087;79839;55748;2589;753;2922;284274;55125;28513;1528;201456;84203;4864;55197;9306;9331;59340;80206;494514;55205;6925;4160;55364;54808;81035;220134;6563;147463;162681;9063;8731;10666;64693;100506888;51320;147381;5874;25925;1828;80323;1823;9480;5275;8932;27164;440498;498;89777;51444;4729;84034;4677;29906;9989;4089;23556;9150;1837;10194;220158;6317;125336;6318;4092;284254;115106;27098;10892;646000;90701;5271;29090;10907;9811;125704;55556;25800;4158;497661;400658;10982;51224;5932;5055;5797;10939;1068;6760;84307;80816;83608;55034;10449;147409;11031;361;55520;4161;30062;4225;23335;596;1000;339302;2774;22850;9050;147339;220136;220441;1825;57536;9525;2531;22878;9352,267
1,1,18,136227,78014123,77877896,100526842;1630;23255;57132;125228;642597;84735;284252;5596;7525;84064;284257;1005;83539;6139;101927322;9984;10928;162655;63895;162699;64863;342850;374868;7541;2587;26040;4200;64762;80000;114799;9658;147407;147495;9218;54877;81832;9229;7298;26251;91133;56907;92126;57724;7050;26256;8715;30827;23347;2627;10627;143471;8736;374860;171586;284217;23136;284266;100505549;85019;51046;8774;645369;494470;57045;728929;4152;652991;201501;9097;644041;10650;57565;5268;79822;100101467;8170;1830;23253;5289;54941;6875;201475;3909;125476;7776;374864;83473;10403;54495;1824;388468;115701;79863;8710;6860;25914;7572;114876;1829;147323;23327;28316;6093;1149;5771;57614;79959;6632;252884;57534;51124;7276;80148;81929;56853;6014;5205;125488;284273;284293;84552;55250;9388;220164;5366;116;89778;83876;55628;25941;4645;3998;8780;103910;147372;8792;4772;84617;4155;3613;56984;65258;2235;29919;91768;9663;5273;23239;339291;11201;4087;79839;55748;2589;753;2922;284274;55125;28513;1528;201456;84203;4864;55197;9306;9331;59340;80206;494514;55205;6925;4160;55364;54808;81035;220134;6563;147463;162681;9063;8731;10666;64693;100506888;51320;147381;5874;25925;1828;80323;1823;9480;5275;8932;27164;440498;498;89777;51444;4729;84034;4677;29906;9989;4089;23556;9150;1837;10194;220158;6317;125336;6318;4092;284254;115106;27098;10892;646000;90701;5271;29090;10907;9811;125704;55556;25800;4158;497661;400658;10982;51224;5932;5055;5797;10939;1068;6760;84307;80816;83608;55034;10449;147409;11031;361;55520;4161;30062;4225;23335;596;1000;339302;2774;22850;9050;147339;220136;220441;1825;57536;9525;2531;22878;9352,267
1,1,18,136227,78014123,77877896,100526842;1630;23255;57132;125228;642597;84735;284252;5596;7525;84064;284257;1005;83539;6139;101927322;9984;10928;162655;63895;162699;64863;342850;374868;7541;2587;26040;4200;64762;80000;114799;9658;147407;147495;9218;54877;81832;9229;7298;26251;91133;56907;92126;57724;7050;26256;8715;30827;23347;2627;10627;143471;8736;374860;171586;284217;23136;284266;100505549;85019;51046;8774;645369;494470;57045;728929;4152;652991;201501;9097;644041;10650;57565;5268;79822;100101467;8170;1830;23253;5289;54941;6875;201475;3909;125476;7776;374864;83473;10403;54495;1824;388468;115701;79863;8710;6860;25914;7572;114876;1829;147323;23327;28316;6093;1149;5771;57614;79959;6632;252884;57534;51124;7276;80148;81929;56853;6014;5205;125488;284273;284293;84552;55250;9388;220164;5366;116;89778;83876;55628;25941;4645;3998;8780;103910;147372;8792;4772;84617;4155;3613;56984;65258;2235;29919;91768;9663;5273;23239;339291;11201;4087;79839;55748;2589;753;2922;284274;55125;28513;1528;201456;84203;4864;55197;9306;9331;59340;80206;494514;55205;6925;4160;55364;54808;81035;220134;6563;147463;162681;9063;8731;10666;64693;100506888;51320;147381;5874;25925;1828;80323;1823;9480;5275;8932;27164;440498;498;89777;51444;4729;84034;4677;29906;9989;4089;23556;9150;1837;10194;220158;6317;125336;6318;4092;284254;115106;27098;10892;646000;90701;5271;29090;10907;9811;125704;55556;25800;4158;497661;400658;10982;51224;5932;5055;5797;10939;1068;6760;84307;80816;83608;55034;10449;147409;11031;361;55520;4161;30062;4225;23335;596;1000;339302;2774;22850;9050;147339;220136;220441;1825;57536;9525;2531;22878;9352,267
1,1,18,136227,78014123,77877896,100526842;1630;23255;57132;125228;642597;84735;284252;5596;7525;84064;284257;1005;83539;6139;101927322;9984;10928;162655;63895;162699;64863;342850;374868;7541;2587;26040;4200;64762;80000;114799;9658;147407;147495;9218;54877;81832;9229;7298;26251;91133;56907;92126;57724;7050;26256;8715;30827;23347;2627;10627;143471;8736;374860;171586;284217;23136;284266;100505549;85019;51046;8774;645369;494470;57045;728929;4152;652991;201501;9097;644041;10650;57565;5268;79822;100101467;8170;1830;23253;5289;54941;6875;201475;3909;125476;7776;374864;83473;10403;54495;1824;388468;115701;79863;8710;6860;25914;7572;114876;1829;147323;23327;28316;6093;1149;5771;57614;79959;6632;252884;57534;51124;7276;80148;81929;56853;6014;5205;125488;284273;284293;84552;55250;9388;220164;5366;116;89778;83876;55628;25941;4645;3998;8780;103910;147372;8792;4772;84617;4155;3613;56984;65258;2235;29919;91768;9663;5273;23239;339291;11201;4087;79839;55748;2589;753;2922;284274;55125;28513;1528;201456;84203;4864;55197;9306;9331;59340;80206;494514;55205;6925;4160;55364;54808;81035;220134;6563;147463;162681;9063;8731;10666;64693;100506888;51320;147381;5874;25925;1828;80323;1823;9480;5275;8932;27164;440498;498;89777;51444;4729;84034;4677;29906;9989;4089;23556;9150;1837;10194;220158;6317;125336;6318;4092;284254;115106;27098;10892;646000;90701;5271;29090;10907;9811;125704;55556;25800;4158;497661;400658;10982;51224;5932;5055;5797;10939;1068;6760;84307;80816;83608;55034;10449;147409;11031;361;55520;4161;30062;4225;23335;596;1000;339302;2774;22850;9050;147339;220136;220441;1825;57536;9525;2531;22878;9352,267
1,1,18,136227,78014123,77877896,100526842;1630;23255;57132;125228;642597;84735;284252;5596;7525;84064;284257;1005;83539;6139;101927322;9984;10928;162655;63895;162699;64863;342850;374868;7541;2587;26040;4200;64762;80000;114799;9658;147407;147495;9218;54877;81832;9229;7298;26251;91133;56907;92126;57724;7050;26256;8715;30827;23347;2627;10627;143471;8736;374860;171586;284217;23136;284266;100505549;85019;51046;8774;645369;494470;57045;728929;4152;652991;201501;9097;644041;10650;57565;5268;79822;100101467;8170;1830;23253;5289;54941;6875;201475;3909;125476;7776;374864;83473;10403;54495;1824;388468;115701;79863;8710;6860;25914;7572;114876;1829;147323;23327;28316;6093;1149;5771;57614;79959;6632;252884;57534;51124;7276;80148;81929;56853;6014;5205;125488;284273;284293;84552;55250;9388;220164;5366;116;89778;83876;55628;25941;4645;3998;8780;103910;147372;8792;4772;84617;4155;3613;56984;65258;2235;29919;91768;9663;5273;23239;339291;11201;4087;79839;55748;2589;753;2922;284274;55125;28513;1528;201456;84203;4864;55197;9306;9331;59340;80206;494514;55205;6925;4160;55364;54808;81035;220134;6563;147463;162681;9063;8731;10666;64693;100506888;51320;147381;5874;25925;1828;80323;1823;9480;5275;8932;27164;440498;498;89777;51444;4729;84034;4677;29906;9989;4089;23556;9150;1837;10194;220158;6317;125336;6318;4092;284254;115106;27098;10892;646000;90701;5271;29090;10907;9811;125704;55556;25800;4158;497661;400658;10982;51224;5932;5055;5797;10939;1068;6760;84307;80816;83608;55034;10449;147409;11031;361;55520;4161;30062;4225;23335;596;1000;339302;2774;22850;9050;147339;220136;220441;1825;57536;9525;2531;22878;9352,267
1,1,18,136227,78014123,77877896,100526842;1630;23255;57132;125228;642597;84735;284252;5596;7525;84064;284257;1005;83539;6139;101927322;9984;10928;162655;63895;162699;64863;342850;374868;7541;2587;26040;4200;64762;80000;114799;9658;147407;147495;9218;54877;81832;9229;7298;26251;91133;56907;92126;57724;7050;26256;8715;30827;23347;2627;10627;143471;8736;374860;171586;284217;23136;284266;100505549;85019;51046;8774;645369;494470;57045;728929;4152;652991;201501;9097;644041;10650;57565;5268;79822;100101467;8170;1830;23253;5289;54941;6875;201475;3909;125476;7776;374864;83473;10403;54495;1824;388468;115701;79863;8710;6860;25914;7572;114876;1829;147323;23327;28316;6093;1149;5771;57614;79959;6632;252884;57534;51124;7276;80148;81929;56853;6014;5205;125488;284273;284293;84552;55250;9388;220164;5366;116;89778;83876;55628;25941;4645;3998;8780;103910;147372;8792;4772;84617;4155;3613;56984;65258;2235;29919;91768;9663;5273;23239;339291;11201;4087;79839;55748;2589;753;2922;284274;55125;28513;1528;201456;84203;4864;55197;9306;9331;59340;80206;494514;55205;6925;4160;55364;54808;81035;220134;6563;147463;162681;9063;8731;10666;64693;100506888;51320;147381;5874;25925;1828;80323;1823;9480;5275;8932;27164;440498;498;89777;51444;4729;84034;4677;29906;9989;4089;23556;9150;1837;10194;220158;6317;125336;6318;4092;284254;115106;27098;10892;646000;90701;5271;29090;10907;9811;125704;55556;25800;4158;497661;400658;10982;51224;5932;5055;5797;10939;1068;6760;84307;80816;83608;55034;10449;147409;11031;361;55520;4161;30062;4225;23335;596;1000;339302;2774;22850;9050;147339;220136;220441;1825;57536;9525;2531;22878;9352,267
1,1,18,136227,78014123,77877896,100526842;1630;23255;57132;125228;642597;84735;284252;5596;7525;84064;284257;1005;83539;6139;101927322;9984;10928;162655;63895;162699;64863;342850;374868;7541;2587;26040;4200;64762;80000;114799;9658;147407;147495;9218;54877;81832;9229;7298;26251;91133;56907;92126;57724;7050;26256;8715;30827;23347;2627;10627;143471;8736;374860;171586;284217;23136;284266;100505549;85019;51046;8774;645369;494470;57045;728929;4152;652991;201501;9097;644041;10650;57565;5268;79822;100101467;8170;1830;23253;5289;54941;6875;201475;3909;125476;7776;374864;83473;10403;54495;1824;388468;115701;79863;8710;6860;25914;7572;114876;1829;147323;23327;28316;6093;1149;5771;57614;79959;6632;252884;57534;51124;7276;80148;81929;56853;6014;5205;125488;284273;284293;84552;55250;9388;220164;5366;116;89778;83876;55628;25941;4645;3998;8780;103910;147372;8792;4772;84617;4155;3613;56984;65258;2235;29919;91768;9663;5273;23239;339291;11201;4087;79839;55748;2589;753;2922;284274;55125;28513;1528;201456;84203;4864;55197;9306;9331;59340;80206;494514;55205;6925;4160;55364;54808;81035;220134;6563;147463;162681;9063;8731;10666;64693;100506888;51320;147381;5874;25925;1828;80323;1823;9480;5275;8932;27164;440498;498;89777;51444;4729;84034;4677;29906;9989;4089;23556;9150;1837;10194;220158;6317;125336;6318;4092;284254;115106;27098;10892;646000;90701;5271;29090;10907;9811;125704;55556;25800;4158;497661;400658;10982;51224;5932;5055;5797;10939;1068;6760;84307;80816;83608;55034;10449;147409;11031;361;55520;4161;30062;4225;23335;596;1000;339302;2774;22850;9050;147339;220136;220441;1825;57536;9525;2531;22878;9352,267
1,1,18,136227,78014123,77877896,100526842;1630;23255;57132;125228;642597;84735;284252;5596;7525;84064;284257;1005;83539;6139;101927322;9984;10928;162655;63895;162699;64863;342850;374868;7541;2587;26040;4200;64762;80000;114799;9658;147407;147495;9218;54877;81832;9229;7298;26251;91133;56907;92126;57724;7050;26256;8715;30827;23347;2627;10627;143471;8736;374860;171586;284217;23136;284266;100505549;85019;51046;8774;645369;494470;57045;728929;4152;652991;201501;9097;644041;10650;57565;5268;79822;100101467;8170;1830;23253;5289;54941;6875;201475;3909;125476;7776;374864;83473;10403;54495;1824;388468;115701;79863;8710;6860;25914;7572;114876;1829;147323;23327;28316;6093;1149;5771;57614;79959;6632;252884;57534;51124;7276;80148;81929;56853;6014;5205;125488;284273;284293;84552;55250;9388;220164;5366;116;89778;83876;55628;25941;4645;3998;8780;103910;147372;8792;4772;84617;4155;3613;56984;65258;2235;29919;91768;9663;5273;23239;339291;11201;4087;79839;55748;2589;753;2922;284274;55125;28513;1528;201456;84203;4864;55197;9306;9331;59340;80206;494514;55205;6925;4160;55364;54808;81035;220134;6563;147463;162681;9063;8731;10666;64693;100506888;51320;147381;5874;25925;1828;80323;1823;9480;5275;8932;27164;440498;498;89777;51444;4729;84034;4677;29906;9989;4089;23556;9150;1837;10194;220158;6317;125336;6318;4092;284254;115106;27098;10892;646000;90701;5271;29090;10907;9811;125704;55556;25800;4158;497661;400658;10982;51224;5932;5055;5797;10939;1068;6760;84307;80816;83608;55034;10449;147409;11031;361;55520;4161;30062;4225;23335;596;1000;339302;2774;22850;9050;147339;220136;220441;1825;57536;9525;2531;22878;9352,267
1,1,18,136227,78014123,77877896,100526842;1630;23255;57132;125228;642597;84735;284252;5596;7525;84064;284257;1005;83539;6139;101927322;9984;10928;162655;63895;162699;64863;342850;374868;7541;2587;26040;4200;64762;80000;114799;9658;147407;147495;9218;54877;81832;9229;7298;26251;91133;56907;92126;57724;7050;26256;8715;30827;23347;2627;10627;143471;8736;374860;171586;284217;23136;284266;100505549;85019;51046;8774;645369;494470;57045;728929;4152;652991;201501;9097;644041;10650;57565;5268;79822;100101467;8170;1830;23253;5289;54941;6875;201475;3909;125476;7776;374864;83473;10403;54495;1824;388468;115701;79863;8710;6860;25914;7572;114876;1829;147323;23327;28316;6093;1149;5771;57614;79959;6632;252884;57534;51124;7276;80148;81929;56853;6014;5205;125488;284273;284293;84552;55250;9388;220164;5366;116;89778;83876;55628;25941;4645;3998;8780;103910;147372;8792;4772;84617;4155;3613;56984;65258;2235;29919;91768;9663;5273;23239;339291;11201;4087;79839;55748;2589;753;2922;284274;55125;28513;1528;201456;84203;4864;55197;9306;9331;59340;80206;494514;55205;6925;4160;55364;54808;81035;220134;6563;147463;162681;9063;8731;10666;64693;100506888;51320;147381;5874;25925;1828;80323;1823;9480;5275;8932;27164;440498;498;89777;51444;4729;84034;4677;29906;9989;4089;23556;9150;1837;10194;220158;6317;125336;6318;4092;284254;115106;27098;10892;646000;90701;5271;29090;10907;9811;125704;55556;25800;4158;497661;400658;10982;51224;5932;5055;5797;10939;1068;6760;84307;80816;83608;55034;10449;147409;11031;361;55520;4161;30062;4225;23335;596;1000;339302;2774;22850;9050;147339;220136;220441;1825;57536;9525;2531;22878;9352,267
1,1,18,136227,78014123,77877896,100526842;1630;23255;57132;125228;642597;84735;284252;5596;7525;84064;284257;1005;83539;6139;101927322;9984;10928;162655;63895;162699;64863;342850;374868;7541;2587;26040;4200;64762;80000;114799;9658;147407;147495;9218;54877;81832;9229;7298;26251;91133;56907;92126;57724;7050;26256;8715;30827;23347;2627;10627;143471;8736;374860;171586;284217;23136;284266;100505549;85019;51046;8774;645369;494470;57045;728929;4152;652991;201501;9097;644041;10650;57565;5268;79822;100101467;8170;1830;23253;5289;54941;6875;201475;3909;125476;7776;374864;83473;10403;54495;1824;388468;115701;79863;8710;6860;25914;7572;114876;1829;147323;23327;28316;6093;1149;5771;57614;79959;6632;252884;57534;51124;7276;80148;81929;56853;6014;5205;125488;284273;284293;84552;55250;9388;220164;5366;116;89778;83876;55628;25941;4645;3998;8780;103910;147372;8792;4772;84617;4155;3613;56984;65258;2235;29919;91768;9663;5273;23239;339291;11201;4087;79839;55748;2589;753;2922;284274;55125;28513;1528;201456;84203;4864;55197;9306;9331;59340;80206;494514;55205;6925;4160;55364;54808;81035;220134;6563;147463;162681;9063;8731;10666;64693;100506888;51320;147381;5874;25925;1828;80323;1823;9480;5275;8932;27164;440498;498;89777;51444;4729;84034;4677;29906;9989;4089;23556;9150;1837;10194;220158;6317;125336;6318;4092;284254;115106;27098;10892;646000;90701;5271;29090;10907;9811;125704;55556;25800;4158;497661;400658;10982;51224;5932;5055;5797;10939;1068;6760;84307;80816;83608;55034;10449;147409;11031;361;55520;4161;30062;4225;23335;596;1000;339302;2774;22850;9050;147339;220136;220441;1825;57536;9525;2531;22878;9352,267
1,1,18,136227,78014123,77877896,100526842;1630;23255;57132;125228;642597;84735;284252;5596;7525;84064;284257;1005;83539;6139;101927322;9984;10928;162655;63895;162699;64863;342850;374868;7541;2587;26040;4200;64762;80000;114799;9658;147407;147495;9218;54877;81832;9229;7298;26251;91133;56907;92126;57724;7050;26256;8715;30827;23347;2627;10627;143471;8736;374860;171586;284217;23136;284266;100505549;85019;51046;8774;645369;494470;57045;728929;4152;652991;201501;9097;644041;10650;57565;5268;79822;100101467;8170;1830;23253;5289;54941;6875;201475;3909;125476;7776;374864;83473;10403;54495;1824;388468;115701;79863;8710;6860;25914;7572;114876;1829;147323;23327;28316;6093;1149;5771;57614;79959;6632;252884;57534;51124;7276;80148;81929;56853;6014;5205;125488;284273;284293;84552;55250;9388;220164;5366;116;89778;83876;55628;25941;4645;3998;8780;103910;147372;8792;4772;84617;4155;3613;56984;65258;2235;29919;91768;9663;5273;23239;339291;11201;4087;79839;55748;2589;753;2922;284274;55125;28513;1528;201456;84203;4864;55197;9306;9331;59340;80206;494514;55205;6925;4160;55364;54808;81035;220134;6563;147463;162681;9063;8731;10666;64693;100506888;51320;147381;5874;25925;1828;80323;1823;9480;5275;8932;27164;440498;498;89777;51444;4729;84034;4677;29906;9989;4089;23556;9150;1837;10194;220158;6317;125336;6318;4092;284254;115106;27098;10892;646000;90701;5271;29090;10907;9811;125704;55556;25800;4158;497661;400658;10982;51224;5932;5055;5797;10939;1068;6760;84307;80816;83608;55034;10449;147409;11031;361;55520;4161;30062;4225;23335;596;1000;339302;2774;22850;9050;147339;220136;220441;1825;57536;9525;2531;22878;9352,267
1,1,18,136227,78014123,77877896,100526842;1630;23255;57132;125228;642597;84735;284252;5596;7525;84064;284257;1005;83539;6139;101927322;9984;10928;162655;63895;162699;64863;342850;374868;7541;2587;26040;4200;64762;80000;114799;9658;147407;147495;9218;54877;81832;9229;7298;26251;91133;56907;92126;57724;7050;26256;8715;30827;23347;2627;10627;143471;8736;374860;171586;284217;23136;284266;100505549;85019;51046;8774;645369;494470;57045;728929;4152;652991;201501;9097;644041;10650;57565;5268;79822;100101467;8170;1830;23253;5289;54941;6875;201475;3909;125476;7776;374864;83473;10403;54495;1824;388468;115701;79863;8710;6860;25914;7572;114876;1829;147323;23327;28316;6093;1149;5771;57614;79959;6632;252884;57534;51124;7276;80148;81929;56853;6014;5205;125488;284273;284293;84552;55250;9388;220164;5366;116;89778;83876;55628;25941;4645;3998;8780;103910;147372;8792;4772;84617;4155;3613;56984;65258;2235;29919;91768;9663;5273;23239;339291;11201;4087;79839;55748;2589;753;2922;284274;55125;28513;1528;201456;84203;4864;55197;9306;9331;59340;80206;494514;55205;6925;4160;55364;54808;81035;220134;6563;147463;162681;9063;8731;10666;64693;100506888;51320;147381;5874;25925;1828;80323;1823;9480;5275;8932;27164;440498;498;89777;51444;4729;84034;4677;29906;9989;4089;23556;9150;1837;10194;220158;6317;125336;6318;4092;284254;115106;27098;10892;646000;90701;5271;29090;10907;9811;125704;55556;25800;4158;497661;400658;10982;51224;5932;5055;5797;10939;1068;6760;84307;80816;83608;55034;10449;147409;11031;361;55520;4161;30062;4225;23335;596;1000;339302;2774;22850;9050;147339;220136;220441;1825;57536;9525;2531;22878;9352,267
1,1,18,136227,78014123,77877896,100526842;1630;23255;57132;125228;642597;84735;284252;5596;7525;84064;284257;1005;83539;6139;101927322;9984;10928;162655;63895;162699;64863;342850;374868;7541;2587;26040;4200;64762;80000;114799;9658;147407;147495;9218;54877;81832;9229;7298;26251;91133;56907;92126;57724;7050;26256;8715;30827;23347;2627;10627;143471;8736;374860;171586;284217;23136;284266;100505549;85019;51046;8774;645369;494470;57045;728929;4152;652991;201501;9097;644041;10650;57565;5268;79822;100101467;8170;1830;23253;5289;54941;6875;201475;3909;125476;7776;374864;83473;10403;54495;1824;388468;115701;79863;8710;6860;25914;7572;114876;1829;147323;23327;28316;6093;1149;5771;57614;79959;6632;252884;57534;51124;7276;80148;81929;56853;6014;5205;125488;284273;284293;84552;55250;9388;220164;5366;116;89778;83876;55628;25941;4645;3998;8780;103910;147372;8792;4772;84617;4155;3613;56984;65258;2235;29919;91768;9663;5273;23239;339291;11201;4087;79839;55748;2589;753;2922;284274;55125;28513;1528;201456;84203;4864;55197;9306;9331;59340;80206;494514;55205;6925;4160;55364;54808;81035;220134;6563;147463;162681;9063;8731;10666;64693;100506888;51320;147381;5874;25925;1828;80323;1823;9480;5275;8932;27164;440498;498;89777;51444;4729;84034;4677;29906;9989;4089;23556;9150;1837;10194;220158;6317;125336;6318;4092;284254;115106;27098;10892;646000;90701;5271;29090;10907;9811;125704;55556;25800;4158;497661;400658;10982;51224;5932;5055;5797;10939;1068;6760;84307;80816;83608;55034;10449;147409;11031;361;55520;4161;30062;4225;23335;596;1000;339302;2774;22850;9050;147339;220136;220441;1825;57536;9525;2531;22878;9352,267
1,1,18,136227,78014123,77877896,100526842;1630;23255;57132;125228;642597;84735;284252;5596;7525;84064;284257;1005;83539;6139;101927322;9984;10928;162655;63895;162699;64863;342850;374868;7541;2587;26040;4200;64762;80000;114799;9658;147407;147495;9218;54877;81832;9229;7298;26251;91133;56907;92126;57724;7050;26256;8715;30827;23347;2627;10627;143471;8736;374860;171586;284217;23136;284266;100505549;85019;51046;8774;645369;494470;57045;728929;4152;652991;201501;9097;644041;10650;57565;5268;79822;100101467;8170;1830;23253;5289;54941;6875;201475;3909;125476;7776;374864;83473;10403;54495;1824;388468;115701;79863;8710;6860;25914;7572;114876;1829;147323;23327;28316;6093;1149;5771;57614;79959;6632;252884;57534;51124;7276;80148;81929;56853;6014;5205;125488;284273;284293;84552;55250;9388;220164;5366;116;89778;83876;55628;25941;4645;3998;8780;103910;147372;8792;4772;84617;4155;3613;56984;65258;2235;29919;91768;9663;5273;23239;339291;11201;4087;79839;55748;2589;753;2922;284274;55125;28513;1528;201456;84203;4864;55197;9306;9331;59340;80206;494514;55205;6925;4160;55364;54808;81035;220134;6563;147463;162681;9063;8731;10666;64693;100506888;51320;147381;5874;25925;1828;80323;1823;9480;5275;8932;27164;440498;498;89777;51444;4729;84034;4677;29906;9989;4089;23556;9150;1837;10194;220158;6317;125336;6318;4092;284254;115106;27098;10892;646000;90701;5271;29090;10907;9811;125704;55556;25800;4158;497661;400658;10982;51224;5932;5055;5797;10939;1068;6760;84307;80816;83608;55034;10449;147409;11031;361;55520;4161;30062;4225;23335;596;1000;339302;2774;22850;9050;147339;220136;220441;1825;57536;9525;2531;22878;9352,267
-1,1,18,148963,1949962,1800999,116;55556;494514;1068;7525;27098;9984;9097;7298;81035,10
1,1,18,148963,2221286,2072323,116;55556;494514;1068;7525;27098;9984;9097;7298;81035,10
-1,1,18,148963,2313457,2164494,116;55556;494514;1068;7525;27098;9984;9097;7298;81035,10
-1,1,18,148963,6086667,5937704,91133;116;55556;10403;9663;645369;103910;642597;7050;9984;9097;7525;81035;23347;10627;494514;64863;1068;8736;9229;27098;84034;23136;7298;7541,25
-1,1,18,148963,10900515,10751552,116;55556;10403;23255;8774;645369;84203;57045;103910;642597;9097;7525;147495;9218;5797;494514;1068;9229;79822;84034;4729;7298;91133;11031;23253;9663;9989;7050;339291;9984;81035;10928;23347;63895;10627;201475;64863;8736;27098;284217;23136;7541,42
-1,1,18,148963,10900515,10751552,116;55556;10403;23255;8774;645369;84203;57045;103910;642597;9097;7525;147495;9218;5797;494514;1068;9229;79822;84034;4729;7298;91133;11031;23253;9663;9989;7050;339291;9984;81035;10928;23347;63895;10627;201475;64863;8736;27098;284217;23136;7541,42
-1,1,18,148963,10900515,10751552,116;55556;10403;23255;8774;645369;84203;57045;103910;642597;9097;7525;147495;9218;5797;494514;1068;9229;79822;84034;4729;7298;91133;11031;23253;9663;9989;7050;339291;9984;81035;10928;23347;63895;10627;201475;64863;8736;27098;284217;23136;7541,42
-1,1,18,148963,14081887,13932924,116;55556;10403;23255;57132;4158;8774;645369;84203;125228;57045;103910;642597;84617;9097;7525;147495;10650;9218;3613;5797;494514;1149;56984;5771;10939;1068;65258;79959;9229;79822;84034;4729;7298;91133;11031;23253;9663;56907;9989;7050;339291;81929;4161;9984;81035;10928;2774;23347;63895;10627;8731;201475;64863;8736;342850;27098;284217;646000;753;23136;7541;55125,63
-1,1,18,148963,14081887,13932924,116;55556;10403;23255;57132;4158;8774;645369;84203;125228;57045;103910;642597;84617;9097;7525;147495;10650;9218;3613;5797;494514;1149;56984;5771;10939;1068;65258;79959;9229;79822;84034;4729;7298;91133;11031;23253;9663;56907;9989;7050;339291;81929;4161;9984;81035;10928;2774;23347;63895;10627;8731;201475;64863;8736;342850;27098;284217;646000;753;23136;7541;55125,63
1,1,18,148963,14081887,13932924,116;55556;10403;23255;57132;4158;8774;645369;84203;125228;57045;103910;642597;84617;9097;7525;147495;10650;9218;3613;5797;494514;1149;56984;5771;10939;1068;65258;79959;9229;79822;84034;4729;7298;91133;11031;23253;9663;56907;9989;7050;339291;81929;4161;9984;81035;10928;2774;23347;63895;10627;8731;201475;64863;8736;342850;27098;284217;646000;753;23136;7541;55125,63
-1,1,18,148963,14081887,13932924,116;55556;10403;23255;57132;4158;8774;645369;84203;125228;57045;103910;642597;84617;9097;7525;147495;10650;9218;3613;5797;494514;1149;56984;5771;10939;1068;65258;79959;9229;79822;84034;4729;7298;91133;11031;23253;9663;56907;9989;7050;339291;81929;4161;9984;81035;10928;2774;23347;63895;10627;8731;201475;64863;8736;342850;27098;284217;646000;753;23136;7541;55125,63
-1,1,18,148963,14081887,13932924,116;55556;10403;23255;57132;4158;8774;645369;84203;125228;57045;103910;642597;84617;9097;7525;147495;10650;9218;3613;5797;494514;1149;56984;5771;10939;1068;65258;79959;9229;79822;84034;4729;7298;91133;11031;23253;9663;56907;9989;7050;339291;81929;4161;9984;81035;10928;2774;23347;63895;10627;8731;201475;64863;8736;342850;27098;284217;646000;753;23136;7541;55125,63
-1,1,18,148963,14081887,13932924,116;55556;10403;23255;57132;4158;8774;645369;84203;125228;57045;103910;642597;84617;9097;7525;147495;10650;9218;3613;5797;494514;1149;56984;5771;10939;1068;65258;79959;9229;79822;84034;4729;7298;91133;11031;23253;9663;56907;9989;7050;339291;81929;4161;9984;81035;10928;2774;23347;63895;10627;8731;201475;64863;8736;342850;27098;284217;646000;753;23136;7541;55125,63
1,1,18,148963,78010032,77861069,100526842;1630;23255;57132;125228;642597;84735;284252;5596;7525;84064;284257;1005;83539;6139;101927322;9984;10928;162655;63895;162699;64863;342850;374868;7541;2587;26040;4200;64762;80000;114799;9658;147407;147495;9218;54877;81832;9229;7298;26251;91133;56907;92126;57724;7050;26256;8715;30827;23347;2627;10627;143471;8736;374860;171586;284217;23136;284266;100505549;85019;51046;8774;645369;494470;57045;728929;4152;652991;201501;9097;644041;10650;57565;5268;79822;100101467;8170;1830;23253;5289;54941;6875;201475;3909;125476;7776;374864;83473;10403;54495;1824;388468;115701;79863;8710;6860;25914;7572;114876;1829;147323;23327;28316;6093;1149;5771;57614;79959;6632;252884;57534;51124;7276;80148;81929;56853;6014;5205;125488;284273;284293;84552;55250;9388;220164;5366;116;89778;83876;55628;25941;4645;3998;8780;103910;147372;8792;4772;84617;4155;3613;56984;65258;2235;29919;91768;9663;5273;23239;339291;11201;4087;79839;55748;2589;753;2922;284274;55125;28513;1528;201456;84203;4864;55197;9306;9331;59340;80206;494514;55205;6925;4160;55364;54808;81035;220134;6563;147463;162681;9063;8731;10666;64693;100506888;51320;147381;5874;25925;1828;80323;1823;9480;5275;8932;27164;440498;498;89777;51444;4729;84034;4677;29906;9989;4089;23556;9150;1837;10194;220158;6317;125336;6318;4092;284254;115106;27098;10892;646000;90701;5271;29090;10907;9811;125704;55556;25800;4158;497661;400658;10982;51224;5932;5055;5797;10939;1068;6760;84307;80816;83608;55034;10449;147409;11031;361;55520;4161;30062;4225;23335;596;1000;339302;2774;22850;9050;147339;220136;220441;1825;57536;9525;2531;22878;9352,267
1,1,18,148963,78010032,77861069,100526842;1630;23255;57132;125228;642597;84735;284252;5596;7525;84064;284257;1005;83539;6139;101927322;9984;10928;162655;63895;162699;64863;342850;374868;7541;2587;26040;4200;64762;80000;114799;9658;147407;147495;9218;54877;81832;9229;7298;26251;91133;56907;92126;57724;7050;26256;8715;30827;23347;2627;10627;143471;8736;374860;171586;284217;23136;284266;100505549;85019;51046;8774;645369;494470;57045;728929;4152;652991;201501;9097;644041;10650;57565;5268;79822;100101467;8170;1830;23253;5289;54941;6875;201475;3909;125476;7776;374864;83473;10403;54495;1824;388468;115701;79863;8710;6860;25914;7572;114876;1829;147323;23327;28316;6093;1149;5771;57614;79959;6632;252884;57534;51124;7276;80148;81929;56853;6014;5205;125488;284273;284293;84552;55250;9388;220164;5366;116;89778;83876;55628;25941;4645;3998;8780;103910;147372;8792;4772;84617;4155;3613;56984;65258;2235;29919;91768;9663;5273;23239;339291;11201;4087;79839;55748;2589;753;2922;284274;55125;28513;1528;201456;84203;4864;55197;9306;9331;59340;80206;494514;55205;6925;4160;55364;54808;81035;220134;6563;147463;162681;9063;8731;10666;64693;100506888;51320;147381;5874;25925;1828;80323;1823;9480;5275;8932;27164;440498;498;89777;51444;4729;84034;4677;29906;9989;4089;23556;9150;1837;10194;220158;6317;125336;6318;4092;284254;115106;27098;10892;646000;90701;5271;29090;10907;9811;125704;55556;25800;4158;497661;400658;10982;51224;5932;5055;5797;10939;1068;6760;84307;80816;83608;55034;10449;147409;11031;361;55520;4161;30062;4225;23335;596;1000;339302;2774;22850;9050;147339;220136;220441;1825;57536;9525;2531;22878;9352,267
1,1,18,148963,78010032,77861069,100526842;1630;23255;57132;125228;642597;84735;284252;5596;7525;84064;284257;1005;83539;6139;101927322;9984;10928;162655;63895;162699;64863;342850;374868;7541;2587;26040;4200;64762;80000;114799;9658;147407;147495;9218;54877;81832;9229;7298;26251;91133;56907;92126;57724;7050;26256;8715;30827;23347;2627;10627;143471;8736;374860;171586;284217;23136;284266;100505549;85019;51046;8774;645369;494470;57045;728929;4152;652991;201501;9097;644041;10650;57565;5268;79822;100101467;8170;1830;23253;5289;54941;6875;201475;3909;125476;7776;374864;83473;10403;54495;1824;388468;115701;79863;8710;6860;25914;7572;114876;1829;147323;23327;28316;6093;1149;5771;57614;79959;6632;252884;57534;51124;7276;80148;81929;56853;6014;5205;125488;284273;284293;84552;55250;9388;220164;5366;116;89778;83876;55628;25941;4645;3998;8780;103910;147372;8792;4772;84617;4155;3613;56984;65258;2235;29919;91768;9663;5273;23239;339291;11201;4087;79839;55748;2589;753;2922;284274;55125;28513;1528;201456;84203;4864;55197;9306;9331;59340;80206;494514;55205;6925;4160;55364;54808;81035;220134;6563;147463;162681;9063;8731;10666;64693;100506888;51320;147381;5874;25925;1828;80323;1823;9480;5275;8932;27164;440498;498;89777;51444;4729;84034;4677;29906;9989;4089;23556;9150;1837;10194;220158;6317;125336;6318;4092;284254;115106;27098;10892;646000;90701;5271;29090;10907;9811;125704;55556;25800;4158;497661;400658;10982;51224;5932;5055;5797;10939;1068;6760;84307;80816;83608;55034;10449;147409;11031;361;55520;4161;30062;4225;23335;596;1000;339302;2774;22850;9050;147339;220136;220441;1825;57536;9525;2531;22878;9352,267
1,1,18,148963,78010032,77861069,100526842;1630;23255;57132;125228;642597;84735;284252;5596;7525;84064;284257;1005;83539;6139;101927322;9984;10928;162655;63895;162699;64863;342850;374868;7541;2587;26040;4200;64762;80000;114799;9658;147407;147495;9218;54877;81832;9229;7298;26251;91133;56907;92126;57724;7050;26256;8715;30827;23347;2627;10627;143471;8736;374860;171586;284217;23136;284266;100505549;85019;51046;8774;645369;494470;57045;728929;4152;652991;201501;9097;644041;10650;57565;5268;79822;100101467;8170;1830;23253;5289;54941;6875;201475;3909;125476;7776;374864;83473;10403;54495;1824;388468;115701;79863;8710;6860;25914;7572;114876;1829;147323;23327;28316;6093;1149;5771;57614;79959;6632;252884;57534;51124;7276;80148;81929;56853;6014;5205;125488;284273;284293;84552;55250;9388;220164;5366;116;89778;83876;55628;25941;4645;3998;8780;103910;147372;8792;4772;84617;4155;3613;56984;65258;2235;29919;91768;9663;5273;23239;339291;11201;4087;79839;55748;2589;753;2922;284274;55125;28513;1528;201456;84203;4864;55197;9306;9331;59340;80206;494514;55205;6925;4160;55364;54808;81035;220134;6563;147463;162681;9063;8731;10666;64693;100506888;51320;147381;5874;25925;1828;80323;1823;9480;5275;8932;27164;440498;498;89777;51444;4729;84034;4677;29906;9989;4089;23556;9150;1837;10194;220158;6317;125336;6318;4092;284254;115106;27098;10892;646000;90701;5271;29090;10907;9811;125704;55556;25800;4158;497661;400658;10982;51224;5932;5055;5797;10939;1068;6760;84307;80816;83608;55034;10449;147409;11031;361;55520;4161;30062;4225;23335;596;1000;339302;2774;22850;9050;147339;220136;220441;1825;57536;9525;2531;22878;9352,267
1,1,18,148963,78010032,77861069,100526842;1630;23255;57132;125228;642597;84735;284252;5596;7525;84064;284257;1005;83539;6139;101927322;9984;10928;162655;63895;162699;64863;342850;374868;7541;2587;26040;4200;64762;80000;114799;9658;147407;147495;9218;54877;81832;9229;7298;26251;91133;56907;92126;57724;7050;26256;8715;30827;23347;2627;10627;143471;8736;374860;171586;284217;23136;284266;100505549;85019;51046;8774;645369;494470;57045;728929;4152;652991;201501;9097;644041;10650;57565;5268;79822;100101467;8170;1830;23253;5289;54941;6875;201475;3909;125476;7776;374864;83473;10403;54495;1824;388468;115701;79863;8710;6860;25914;7572;114876;1829;147323;23327;28316;6093;1149;5771;57614;79959;6632;252884;57534;51124;7276;80148;81929;56853;6014;5205;125488;284273;284293;84552;55250;9388;220164;5366;116;89778;83876;55628;25941;4645;3998;8780;103910;147372;8792;4772;84617;4155;3613;56984;65258;2235;29919;91768;9663;5273;23239;339291;11201;4087;79839;55748;2589;753;2922;284274;55125;28513;1528;201456;84203;4864;55197;9306;9331;59340;80206;494514;55205;6925;4160;55364;54808;81035;220134;6563;147463;162681;9063;8731;10666;64693;100506888;51320;147381;5874;25925;1828;80323;1823;9480;5275;8932;27164;440498;498;89777;51444;4729;84034;4677;29906;9989;4089;23556;9150;1837;10194;220158;6317;125336;6318;4092;284254;115106;27098;10892;646000;90701;5271;29090;10907;9811;125704;55556;25800;4158;497661;400658;10982;51224;5932;5055;5797;10939;1068;6760;84307;80816;83608;55034;10449;147409;11031;361;55520;4161;30062;4225;23335;596;1000;339302;2774;22850;9050;147339;220136;220441;1825;57536;9525;2531;22878;9352,267
1,1,18,148963,78010032,77861069,100526842;1630;23255;57132;125228;642597;84735;284252;5596;7525;84064;284257;1005;83539;6139;101927322;9984;10928;162655;63895;162699;64863;342850;374868;7541;2587;26040;4200;64762;80000;114799;9658;147407;147495;9218;54877;81832;9229;7298;26251;91133;56907;92126;57724;7050;26256;8715;30827;23347;2627;10627;143471;8736;374860;171586;284217;23136;284266;100505549;85019;51046;8774;645369;494470;57045;728929;4152;652991;201501;9097;644041;10650;57565;5268;79822;100101467;8170;1830;23253;5289;54941;6875;201475;3909;125476;7776;374864;83473;10403;54495;1824;388468;115701;79863;8710;6860;25914;7572;114876;1829;147323;23327;28316;6093;1149;5771;57614;79959;6632;252884;57534;51124;7276;80148;81929;56853;6014;5205;125488;284273;284293;84552;55250;9388;220164;5366;116;89778;83876;55628;25941;4645;3998;8780;103910;147372;8792;4772;84617;4155;3613;56984;65258;2235;29919;91768;9663;5273;23239;339291;11201;4087;79839;55748;2589;753;2922;284274;55125;28513;1528;201456;84203;4864;55197;9306;9331;59340;80206;494514;55205;6925;4160;55364;54808;81035;220134;6563;147463;162681;9063;8731;10666;64693;100506888;51320;147381;5874;25925;1828;80323;1823;9480;5275;8932;27164;440498;498;89777;51444;4729;84034;4677;29906;9989;4089;23556;9150;1837;10194;220158;6317;125336;6318;4092;284254;115106;27098;10892;646000;90701;5271;29090;10907;9811;125704;55556;25800;4158;497661;400658;10982;51224;5932;5055;5797;10939;1068;6760;84307;80816;83608;55034;10449;147409;11031;361;55520;4161;30062;4225;23335;596;1000;339302;2774;22850;9050;147339;220136;220441;1825;57536;9525;2531;22878;9352,267
-1,1,18,149089,1754474,1605385,116;55556;494514;1068;7525;27098;9984;9097;7298;81035,10
-1,1,18,149089,5276566,5127477,116;55556;10403;9663;103910;642597;7050;9984;9097;7525;81035;23347;10627;494514;64863;1068;8736;9229;27098;84034;7298,21
1,1,18,149089,5458471,5309382,116;55556;10403;9663;103910;642597;7050;9984;9097;7525;81035;23347;10627;494514;64863;1068;8736;9229;27098;84034;23136;7298;7541,23
1,1,18,149089,77992274,77843185,100526842;1630;23255;57132;125228;642597;84735;284252;5596;7525;84064;284257;1005;83539;6139;101927322;9984;10928;162655;63895;162699;64863;342850;374868;7541;2587;26040;4200;64762;80000;114799;9658;147407;147495;9218;54877;81832;9229;7298;26251;91133;56907;92126;57724;7050;26256;8715;30827;23347;2627;10627;143471;8736;374860;171586;284217;23136;284266;100505549;85019;51046;8774;645369;494470;57045;728929;4152;652991;201501;9097;644041;10650;57565;5268;79822;100101467;8170;1830;23253;5289;54941;6875;201475;3909;125476;7776;374864;83473;10403;54495;1824;388468;115701;79863;8710;6860;25914;7572;114876;1829;147323;23327;28316;6093;1149;5771;57614;79959;6632;252884;57534;51124;7276;80148;81929;56853;6014;5205;125488;284273;284293;84552;55250;9388;220164;5366;116;89778;83876;55628;25941;4645;3998;8780;103910;147372;8792;4772;84617;4155;3613;56984;65258;2235;29919;91768;9663;5273;23239;339291;11201;4087;79839;55748;2589;753;2922;284274;55125;28513;1528;201456;84203;4864;55197;9306;9331;59340;80206;494514;55205;6925;4160;55364;54808;81035;220134;6563;147463;162681;9063;8731;10666;64693;100506888;51320;147381;5874;25925;1828;80323;1823;9480;5275;8932;27164;440498;498;89777;51444;4729;84034;4677;29906;9989;4089;23556;9150;1837;10194;220158;6317;125336;6318;4092;284254;115106;27098;10892;646000;90701;5271;29090;10907;9811;125704;55556;25800;4158;497661;400658;10982;51224;5932;5055;5797;10939;1068;6760;84307;80816;83608;55034;10449;147409;11031;361;55520;4161;30062;4225;23335;596;1000;339302;2774;22850;9050;147339;220136;220441;1825;57536;9525;2531;22878;9352,267
1,1,18,149089,78012819,77863730,100526842;1630;23255;57132;125228;642597;84735;284252;5596;7525;84064;284257;1005;83539;6139;101927322;9984;10928;162655;63895;162699;64863;342850;374868;7541;2587;26040;4200;64762;80000;114799;9658;147407;147495;9218;54877;81832;9229;7298;26251;91133;56907;92126;57724;7050;26256;8715;30827;23347;2627;10627;143471;8736;374860;171586;284217;23136;284266;100505549;85019;51046;8774;645369;494470;57045;728929;4152;652991;201501;9097;644041;10650;57565;5268;79822;100101467;8170;1830;23253;5289;54941;6875;201475;3909;125476;7776;374864;83473;10403;54495;1824;388468;115701;79863;8710;6860;25914;7572;114876;1829;147323;23327;28316;6093;1149;5771;57614;79959;6632;252884;57534;51124;7276;80148;81929;56853;6014;5205;125488;284273;284293;84552;55250;9388;220164;5366;116;89778;83876;55628;25941;4645;3998;8780;103910;147372;8792;4772;84617;4155;3613;56984;65258;2235;29919;91768;9663;5273;23239;339291;11201;4087;79839;55748;2589;753;2922;284274;55125;28513;1528;201456;84203;4864;55197;9306;9331;59340;80206;494514;55205;6925;4160;55364;54808;81035;220134;6563;147463;162681;9063;8731;10666;64693;100506888;51320;147381;5874;25925;1828;80323;1823;9480;5275;8932;27164;440498;498;89777;51444;4729;84034;4677;29906;9989;4089;23556;9150;1837;10194;220158;6317;125336;6318;4092;284254;115106;27098;10892;646000;90701;5271;29090;10907;9811;125704;55556;25800;4158;497661;400658;10982;51224;5932;5055;5797;10939;1068;6760;84307;80816;83608;55034;10449;147409;11031;361;55520;4161;30062;4225;23335;596;1000;339302;2774;22850;9050;147339;220136;220441;1825;57536;9525;2531;22878;9352,267
1,1,18,163323,78005185,77841862,100526842;1630;23255;57132;125228;642597;84735;284252;5596;7525;84064;284257;1005;83539;6139;101927322;9984;10928;162655;63895;162699;64863;342850;374868;7541;2587;26040;4200;64762;80000;114799;9658;147407;147495;9218;54877;81832;9229;7298;26251;91133;56907;92126;57724;7050;26256;8715;30827;23347;2627;10627;143471;8736;374860;171586;284217;23136;284266;100505549;85019;51046;8774;645369;494470;57045;728929;4152;652991;201501;9097;644041;10650;57565;5268;79822;100101467;8170;1830;23253;5289;54941;6875;201475;3909;125476;7776;374864;83473;10403;54495;1824;388468;115701;79863;8710;6860;25914;7572;114876;1829;147323;23327;28316;6093;1149;5771;57614;79959;6632;252884;57534;51124;7276;80148;81929;56853;6014;5205;125488;284273;284293;84552;55250;9388;220164;5366;116;89778;83876;55628;25941;4645;3998;8780;103910;147372;8792;4772;84617;4155;3613;56984;65258;2235;29919;91768;9663;5273;23239;339291;11201;4087;79839;55748;2589;753;2922;284274;55125;28513;1528;201456;84203;4864;55197;9306;9331;59340;80206;494514;55205;6925;4160;55364;54808;81035;220134;6563;147463;162681;9063;8731;10666;64693;100506888;51320;147381;5874;25925;1828;80323;1823;9480;5275;8932;27164;440498;498;89777;51444;4729;84034;4677;29906;9989;4089;23556;9150;1837;10194;220158;6317;125336;6318;4092;284254;115106;27098;10892;646000;90701;5271;29090;10907;9811;125704;55556;25800;4158;497661;400658;10982;51224;5932;5055;5797;10939;1068;6760;84307;80816;83608;55034;10449;147409;11031;361;55520;4161;30062;4225;23335;596;1000;339302;2774;22850;9050;147339;220136;220441;1825;57536;9525;2531;22878;9352,267
1,1,18,163323,78005185,77841862,100526842;1630;23255;57132;125228;642597;84735;284252;5596;7525;84064;284257;1005;83539;6139;101927322;9984;10928;162655;63895;162699;64863;342850;374868;7541;2587;26040;4200;64762;80000;114799;9658;147407;147495;9218;54877;81832;9229;7298;26251;91133;56907;92126;57724;7050;26256;8715;30827;23347;2627;10627;143471;8736;374860;171586;284217;23136;284266;100505549;85019;51046;8774;645369;494470;57045;728929;4152;652991;201501;9097;644041;10650;57565;5268;79822;100101467;8170;1830;23253;5289;54941;6875;201475;3909;125476;7776;374864;83473;10403;54495;1824;388468;115701;79863;8710;6860;25914;7572;114876;1829;147323;23327;28316;6093;1149;5771;57614;79959;6632;252884;57534;51124;7276;80148;81929;56853;6014;5205;125488;284273;284293;84552;55250;9388;220164;5366;116;89778;83876;55628;25941;4645;3998;8780;103910;147372;8792;4772;84617;4155;3613;56984;65258;2235;29919;91768;9663;5273;23239;339291;11201;4087;79839;55748;2589;753;2922;284274;55125;28513;1528;201456;84203;4864;55197;9306;9331;59340;80206;494514;55205;6925;4160;55364;54808;81035;220134;6563;147463;162681;9063;8731;10666;64693;100506888;51320;147381;5874;25925;1828;80323;1823;9480;5275;8932;27164;440498;498;89777;51444;4729;84034;4677;29906;9989;4089;23556;9150;1837;10194;220158;6317;125336;6318;4092;284254;115106;27098;10892;646000;90701;5271;29090;10907;9811;125704;55556;25800;4158;497661;400658;10982;51224;5932;5055;5797;10939;1068;6760;84307;80816;83608;55034;10449;147409;11031;361;55520;4161;30062;4225;23335;596;1000;339302;2774;22850;9050;147339;220136;220441;1825;57536;9525;2531;22878;9352,267
1,1,18,163323,78005185,77841862,100526842;1630;23255;57132;125228;642597;84735;284252;5596;7525;84064;284257;1005;83539;6139;101927322;9984;10928;162655;63895;162699;64863;342850;374868;7541;2587;26040;4200;64762;80000;114799;9658;147407;147495;9218;54877;81832;9229;7298;26251;91133;56907;92126;57724;7050;26256;8715;30827;23347;2627;10627;143471;8736;374860;171586;284217;23136;284266;100505549;85019;51046;8774;645369;494470;57045;728929;4152;652991;201501;9097;644041;10650;57565;5268;79822;100101467;8170;1830;23253;5289;54941;6875;201475;3909;125476;7776;374864;83473;10403;54495;1824;388468;115701;79863;8710;6860;25914;7572;114876;1829;147323;23327;28316;6093;1149;5771;57614;79959;6632;252884;57534;51124;7276;80148;81929;56853;6014;5205;125488;284273;284293;84552;55250;9388;220164;5366;116;89778;83876;55628;25941;4645;3998;8780;103910;147372;8792;4772;84617;4155;3613;56984;65258;2235;29919;91768;9663;5273;23239;339291;11201;4087;79839;55748;2589;753;2922;284274;55125;28513;1528;201456;84203;4864;55197;9306;9331;59340;80206;494514;55205;6925;4160;55364;54808;81035;220134;6563;147463;162681;9063;8731;10666;64693;100506888;51320;147381;5874;25925;1828;80323;1823;9480;5275;8932;27164;440498;498;89777;51444;4729;84034;4677;29906;9989;4089;23556;9150;1837;10194;220158;6317;125336;6318;4092;284254;115106;27098;10892;646000;90701;5271;29090;10907;9811;125704;55556;25800;4158;497661;400658;10982;51224;5932;5055;5797;10939;1068;6760;84307;80816;83608;55034;10449;147409;11031;361;55520;4161;30062;4225;23335;596;1000;339302;2774;22850;9050;147339;220136;220441;1825;57536;9525;2531;22878;9352,267
1,1,18,163323,78005185,77841862,100526842;1630;23255;57132;125228;642597;84735;284252;5596;7525;84064;284257;1005;83539;6139;101927322;9984;10928;162655;63895;162699;64863;342850;374868;7541;2587;26040;4200;64762;80000;114799;9658;147407;147495;9218;54877;81832;9229;7298;26251;91133;56907;92126;57724;7050;26256;8715;30827;23347;2627;10627;143471;8736;374860;171586;284217;23136;284266;100505549;85019;51046;8774;645369;494470;57045;728929;4152;652991;201501;9097;644041;10650;57565;5268;79822;100101467;8170;1830;23253;5289;54941;6875;201475;3909;125476;7776;374864;83473;10403;54495;1824;388468;115701;79863;8710;6860;25914;7572;114876;1829;147323;23327;28316;6093;1149;5771;57614;79959;6632;252884;57534;51124;7276;80148;81929;56853;6014;5205;125488;284273;284293;84552;55250;9388;220164;5366;116;89778;83876;55628;25941;4645;3998;8780;103910;147372;8792;4772;84617;4155;3613;56984;65258;2235;29919;91768;9663;5273;23239;339291;11201;4087;79839;55748;2589;753;2922;284274;55125;28513;1528;201456;84203;4864;55197;9306;9331;59340;80206;494514;55205;6925;4160;55364;54808;81035;220134;6563;147463;162681;9063;8731;10666;64693;100506888;51320;147381;5874;25925;1828;80323;1823;9480;5275;8932;27164;440498;498;89777;51444;4729;84034;4677;29906;9989;4089;23556;9150;1837;10194;220158;6317;125336;6318;4092;284254;115106;27098;10892;646000;90701;5271;29090;10907;9811;125704;55556;25800;4158;497661;400658;10982;51224;5932;5055;5797;10939;1068;6760;84307;80816;83608;55034;10449;147409;11031;361;55520;4161;30062;4225;23335;596;1000;339302;2774;22850;9050;147339;220136;220441;1825;57536;9525;2531;22878;9352,267
-1,1,18,180229,10762630,10582401,116;55556;10403;23255;8774;645369;84203;57045;103910;642597;9097;7525;147495;9218;5797;494514;1068;9229;79822;84034;4729;7298;91133;11031;23253;9663;9989;7050;339291;9984;81035;10928;23347;63895;10627;201475;64863;8736;27098;284217;23136;7541,42
1,-1,18,374344,699626,325282,1068;55556;27098;494514;7298;81035,6
-1,1,18,958975,11954934,10995959,10403;23255;57132;8774;645369;84203;57045;103910;642597;147495;9218;5797;65258;9229;79822;84034;4729;91133;11031;23253;9663;9989;7050;339291;10928;2774;23347;63895;10627;201475;64863;8736;284217;646000;23136;7541,36
1,-1,18,1664567,1783663,119096,,0
-1,-1,18,1725225,1828442,103217,,0
-1,-1,18,1725225,1828442,103217,,0
-1,-1,18,1919685,1980787,61102,,0
-1,-1,18,1919685,1980787,61102,,0
-1,-1,18,1919685,1980787,61102,,0
-1,-1,18,1919685,1980787,61102,,0
-1,-1,18,1919685,1980787,61102,,0
-1,-1,18,1919685,1980787,61102,,0
-1,-1,18,1919685,1980787,61102,,0
-1,-1,18,1919685,1980787,61102,,0
-1,-1,18,1919685,1980787,61102,,0
-1,-1,18,1919685,1980787,61102,,0
-1,-1,18,1919685,1980787,61102,,0
-1,-1,18,1919685,1980787,61102,,0
1,-1,18,1919685,1980787,61102,,0
-1,-1,18,1919685,1980787,61102,,0
-1,-1,18,1919685,1980787,61102,,0
-1,-1,18,1919685,1980787,61102,,0
1,1,18,2425506,11904117,9478611,10403;23255;57132;8774;645369;84203;57045;103910;642597;147495;9218;5797;65258;9229;79822;84034;4729;91133;11031;23253;9663;9989;7050;339291;10928;2774;23347;63895;10627;201475;64863;8736;284217;646000;23136;7541,36
-1,1,18,2666704,5267842,2601138,23347;9663;10627;8736;103910;7050;9229;642597;84034,9
1,1,18,2737126,9660466,6923340,91133;23253;23255;9663;645369;9989;57045;103910;642597;7050;339291;10928;23347;10627;5797;201475;8736;9229;284217;4729;79822;84034;23136;7541,24
1,-1,18,2741687,2918018,176331,84034;23347;9663,3
1,1,18,4465872,15198990,10733118,23255;57132;4158;8774;645369;84203;125228;388468;57045;642597;84617;147495;10650;9218;3613;5797;1149;56984;5771;10939;65258;79959;4729;79822;91133;11031;23253;56907;9989;81929;339291;4161;10928;162655;2774;63895;8731;201475;342850;374860;284217;646000;753;23136;7541;55125,46
1,-1,18,8293083,8402122,109039,5797,1
1,1,18,8779841,22265343,13485502,85019;23255;57132;4158;8774;84203;388468;125228;4864;57045;8780;80000;84617;114799;114876;59340;5932;147495;10650;9218;3613;56984;1149;5771;6093;10939;65258;79959;6632;4729;57534;11031;23253;29919;91768;56907;55364;9989;81929;4161;26256;10928;162655;2774;63895;125488;147463;2627;8731;3909;342850;374860;171586;646000;753;64693;55125,57
1,1,18,10077654,14081887,4004233,57132;4158;8774;56907;125228;81929;4161;84617;2774;63895;147495;10650;3613;56984;1149;5771;8731;10939;342850;65258;79959;646000;753;55125,24
1,1,18,12159445,12739784,580339,10939;79959;10650;84617;56984;1149;56907,7
1,1,18,12254327,23262749,11008422,85019;4158;388468;125228;4864;8780;25925;80000;84617;114799;114876;59340;5932;10650;6093;1149;56984;5771;10939;79959;6632;57534;29919;91768;56907;55364;81929;4161;26256;162655;125488;147463;2627;8731;3909;374860;171586;753;64693;55125,40
1,1,18,13340111,20989843,7649732,85019;91768;4158;388468;125228;4161;80000;114799;162655;5932;2627;6093;8731;374860;171586;6632;753;57534;64693,19
1,-1,18,14076307,15102539,1026232,162655;374860;388468,3
1,-1,18,14444782,14511925,67143,388468,1
1,-1,18,14695718,15165151,469433,374860,1
1,-1,18,14695718,15215782,520064,374860,1
1,-1,18,14807929,14837135,29206,374860,1
1,-1,18,14807929,14850046,42117,374860,1
1,-1,18,14807929,14850046,42117,374860,1
1,-1,18,14807929,14850046,42117,374860,1
1,-1,18,14807929,14850046,42117,374860,1
1,1,18,14869204,78014123,63144919,100526842;1630;89778;83876;55628;25941;4645;3998;8780;147372;8792;84735;4772;284252;5596;4155;84064;284257;1005;2235;83539;29919;91768;5273;6139;23239;11201;101927322;4087;162699;79839;55748;374868;2589;2922;284274;2587;26040;4200;28513;1528;64762;201456;4864;55197;80000;114799;9306;9331;59340;9658;147407;80206;54877;81832;55205;26251;6925;4160;9388;55364;92126;57724;54808;26256;8715;220134;30827;6563;147463;162681;2627;9063;143471;10666;171586;64693;284266;100506888;51320;100505549;85019;5874;51046;147381;494470;25925;1828;80323;1823;728929;652991;201501;4152;9480;5275;644041;8932;57565;27164;440498;5268;498;89777;51444;100101467;8170;1830;4677;29906;23556;5289;4089;9150;1837;10194;220158;6317;54941;6875;125336;6318;4092;284254;3909;115106;125476;10892;90701;5271;29090;10907;7776;374864;9811;125704;83473;54495;25800;497661;1824;115701;79863;400658;10982;8710;6860;25914;7572;51224;114876;1829;5932;147323;5055;23327;28316;6093;57614;6760;6632;252884;84307;80816;83608;57534;55034;10449;147409;51124;361;7276;55520;80148;30062;4225;56853;6014;1000;23335;339302;596;5205;125488;284273;284293;22850;9050;147339;220136;220441;1825;84552;57536;9525;2531;55250;22878;220164;5366;9352,201
1,1,18,15380696,78016181,62635485,100526842;1630;89778;83876;55628;25941;4645;3998;8780;147372;8792;84735;4772;284252;5596;4155;84064;284257;1005;2235;83539;29919;91768;5273;6139;23239;11201;101927322;4087;162699;79839;55748;374868;2589;2922;284274;2587;26040;4200;28513;1528;64762;201456;4864;55197;80000;114799;9306;9331;59340;9658;147407;80206;54877;81832;55205;26251;6925;4160;9388;55364;92126;57724;54808;26256;8715;220134;30827;6563;147463;162681;2627;9063;143471;10666;171586;64693;284266;100506888;51320;100505549;85019;5874;51046;147381;494470;25925;1828;80323;1823;728929;652991;201501;4152;9480;5275;644041;8932;57565;27164;440498;5268;498;89777;51444;100101467;8170;1830;4677;29906;23556;5289;4089;9150;1837;10194;220158;6317;54941;6875;125336;6318;4092;284254;3909;115106;125476;10892;90701;5271;29090;10907;7776;374864;9811;125704;83473;54495;25800;497661;1824;115701;79863;400658;10982;8710;6860;25914;7572;51224;114876;1829;5932;147323;5055;23327;28316;6093;57614;6760;6632;252884;84307;80816;83608;57534;55034;10449;147409;51124;361;7276;55520;80148;30062;4225;56853;6014;1000;23335;339302;596;5205;125488;284273;284293;22850;9050;147339;220136;220441;1825;84552;57536;9525;2531;55250;22878;220164;5366;9352,201
1,1,18,18521285,37940584,19419299,85019;25941;8780;25925;1828;1823;284252;57565;51444;83539;100101467;29919;1830;91768;1837;54941;6875;3909;125476;2589;374864;25800;64762;1824;4864;10982;55197;80000;7572;114799;9331;114876;59340;5932;1829;147407;80206;6093;6760;6632;252884;84307;80816;83608;57534;55034;147409;361;7276;55364;26256;4225;8715;1000;56853;125488;147463;2627;143471;1825;171586;57536;55250;22878;64693,65
1,1,18,18521285,64495798,45974513,100526842;1630;89778;83876;25941;4645;3998;8780;147372;8792;284252;5596;84064;284257;1005;2235;83539;29919;91768;5273;6139;23239;11201;101927322;4087;162699;2589;2922;26040;4200;28513;64762;4864;55197;80000;114799;9331;59340;147407;80206;54877;55205;6925;4160;9388;55364;57724;54808;26256;8715;220134;30827;6563;147463;162681;2627;9063;143471;171586;64693;284266;100506888;51320;100505549;85019;5874;51046;494470;25925;1828;80323;1823;728929;652991;201501;4152;9480;5275;8932;57565;5268;498;89777;51444;100101467;8170;1830;4677;29906;23556;5289;4089;1837;6317;54941;6875;125336;6318;4092;284254;3909;115106;125476;10892;90701;5271;374864;9811;83473;25800;497661;1824;115701;10982;8710;6860;7572;51224;114876;1829;5932;147323;5055;23327;28316;6093;57614;6760;6632;252884;84307;80816;83608;57534;55034;10449;147409;51124;361;7276;55520;30062;4225;56853;6014;1000;23335;339302;596;5205;125488;284293;9050;147339;220136;220441;1825;57536;9525;2531;55250;22878;5366;9352,164
1,1,18,18529339,31943419,13414080,85019;64762;1824;4864;8780;25925;1828;80000;284252;1823;114799;9331;114876;59340;5932;1829;147407;57565;6093;6760;6632;51444;80816;83539;57534;147409;29919;1830;91768;361;7276;55364;26256;4225;8715;1000;125488;6875;54941;147463;2627;3909;143471;1825;171586;22878;374864;64693,48
1,1,18,18542080,72403402,53861322,100526842;1630;89778;83876;55628;25941;4645;3998;8780;147372;8792;84735;284252;5596;84064;284257;1005;2235;83539;29919;91768;5273;6139;23239;11201;101927322;4087;162699;79839;55748;2589;2922;26040;4200;28513;1528;64762;201456;4864;55197;80000;114799;9306;9331;59340;22878;147407;80206;54877;81832;55205;6925;4160;55364;92126;57724;54808;26256;8715;220134;30827;6563;147463;162681;2627;9063;143471;10666;171586;64693;284266;100506888;51320;100505549;85019;5874;51046;147381;494470;25925;1828;80323;1823;728929;652991;201501;4152;9480;5275;644041;8932;57565;5268;498;89777;51444;100101467;8170;1830;4677;29906;23556;5289;4089;1837;220158;6317;54941;6875;125336;6318;4092;284254;3909;115106;125476;10892;90701;5271;29090;374864;9811;125704;83473;54495;25800;497661;1824;115701;10982;8710;6860;25914;7572;51224;114876;1829;5932;147323;5055;23327;28316;6093;57614;6760;6632;252884;84307;80816;83608;57534;55034;10449;147409;51124;361;7276;55520;30062;4225;56853;6014;1000;23335;339302;596;5205;125488;284293;9050;147339;220136;220441;1825;57536;9525;2531;55250;9388;220164;5366;9352,182
-1,1,18,20069932,36887326,16817394,85019;25800;64762;25941;1824;4864;8780;25925;1828;10982;55197;1823;284252;7572;9331;114876;59340;5932;1829;147407;57565;80206;6760;51444;252884;84307;80816;83539;83608;55034;147409;100101467;29919;1830;91768;361;7276;55364;1837;26256;4225;8715;1000;56853;125488;6875;54941;147463;3909;143471;1825;125476;2589;57536;55250;22878;374864,57
-1,1,18,26945022,28816268,1871246,1823;1825;1824,3
-1,-1,18,28972140,29019935,47795,147409,1
1,1,18,29703068,78010032,48306964,100526842;1630;89778;83876;55628;25941;4645;3998;147372;8792;84735;4772;5596;4155;84064;284257;1005;2235;5273;6139;23239;11201;101927322;4087;162699;79839;55748;374868;2589;2922;284274;2587;26040;4200;28513;1528;64762;201456;55197;9306;9658;80206;54877;81832;55205;26251;6925;4160;92126;57724;54808;8715;220134;30827;6563;162681;9063;10666;284266;100506888;51320;100505549;147381;5874;51046;494470;80323;728929;4152;652991;201501;9480;5275;644041;8932;57565;27164;440498;5268;498;89777;51444;100101467;8170;4677;29906;23556;5289;4089;9150;1837;10194;220158;6317;125336;6318;4092;284254;115106;125476;10892;90701;5271;29090;10907;7776;9811;374864;125704;83473;54495;25800;497661;115701;79863;400658;10982;8710;6860;25914;7572;51224;147323;5055;23327;28316;57614;252884;84307;83608;55034;80816;10449;51124;55520;80148;30062;4225;56853;6014;23335;596;339302;5205;284273;284293;22850;9050;147339;220136;220441;84552;57536;9525;2531;55250;9388;220164;5366;9352,160
-1,-1,18,30042619,32043220,2000601,8715;57565;64762;80816;374864,5
1,1,18,31879854,78014123,46134269,100526842;1630;89778;83876;55628;25941;4645;3998;147372;8792;84735;4772;5596;4155;84064;284257;1005;2235;5273;6139;23239;11201;101927322;4087;162699;79839;55748;374868;2589;2922;284274;2587;26040;4200;28513;1528;201456;55197;9306;9658;80206;54877;81832;55205;26251;6925;4160;92126;57724;54808;220134;30827;6563;162681;9063;10666;284266;100506888;51320;100505549;147381;5874;51046;494470;80323;728929;4152;652991;201501;9480;5275;644041;8932;27164;440498;5268;498;89777;100101467;8170;4677;29906;23556;5289;4089;9150;1837;10194;220158;6317;125336;6318;4092;284254;115106;125476;10892;90701;5271;29090;10907;7776;9811;125704;83473;54495;25800;497661;115701;79863;400658;10982;8710;6860;25914;7572;51224;147323;5055;23327;28316;57614;252884;84307;83608;55034;10449;51124;55520;80148;30062;23335;56853;6014;596;339302;5205;284273;284293;22850;9050;147339;220136;220441;84552;57536;9525;2531;55250;9388;220164;5366;9352,153
1,1,18,33417216,78014123,44596907,100526842;1630;89778;83876;55628;25941;4645;3998;147372;8792;84735;4772;5596;4155;84064;284257;1005;2235;5273;6139;23239;11201;101927322;4087;162699;79839;55748;374868;2922;284274;2587;26040;4200;28513;1528;201456;55197;9306;9658;80206;54877;81832;55205;26251;6925;4160;92126;57724;54808;220134;30827;6563;162681;9063;10666;284266;100506888;51320;100505549;147381;5874;51046;494470;80323;728929;4152;652991;201501;9480;5275;644041;8932;27164;440498;5268;498;89777;8170;4677;29906;23556;5289;4089;9150;10194;220158;6317;125336;6318;4092;284254;115106;10892;90701;5271;29090;10907;7776;9811;125704;83473;54495;25800;497661;115701;79863;400658;8710;6860;25914;51224;147323;5055;23327;28316;57614;83608;55034;10449;51124;55520;80148;30062;23335;56853;6014;596;339302;5205;284273;284293;22850;9050;147339;220136;220441;84552;57536;9525;2531;55250;9388;220164;5366;9352,145
1,-1,18,34378358,34851799,473441,56853;25941;57536,3
1,1,18,36374692,63300040,26925348,284266;100526842;1630;100506888;51320;100505549;5874;89778;83876;51046;4645;494470;3998;147372;8792;80323;728929;4152;652991;201501;5596;9480;5275;8932;84064;5268;284257;498;89777;2235;8170;4677;5273;29906;6139;23239;23556;5289;4089;11201;101927322;6317;4087;125336;162699;6318;4092;284254;115106;10892;90701;5271;2922;9811;26040;4200;83473;497661;115701;8710;6860;51224;147323;5055;23327;28316;54877;57614;55205;10449;6925;51124;4160;55520;57724;54808;30062;23335;6014;596;339302;220134;30827;5205;6563;162681;9063;284293;9050;147339;220136;220441;9525;2531;9388;5366;9352,97
-1,-1,18,37050859,37400276,349417,,0
-1,-1,18,37063132,37251629,188497,,0
1,1,18,37947419,78014123,40066704,100526842;1630;89778;83876;55628;4645;3998;147372;8792;84735;4772;5596;4155;84064;284257;1005;2235;5273;6139;23239;11201;101927322;4087;162699;79839;55748;374868;2922;284274;2587;26040;4200;28513;1528;201456;9306;9658;54877;81832;55205;26251;6925;4160;92126;57724;54808;220134;30827;6563;162681;9063;10666;284266;100506888;51320;100505549;147381;5874;51046;494470;80323;728929;4152;652991;201501;9480;5275;644041;8932;27164;440498;5268;498;89777;8170;4677;29906;23556;5289;4089;9150;10194;220158;6317;125336;6318;4092;284254;115106;10892;90701;5271;29090;10907;7776;9811;125704;83473;54495;497661;115701;79863;400658;8710;6860;25914;51224;147323;5055;23327;28316;57614;10449;51124;55520;80148;30062;23335;6014;596;339302;5205;284273;284293;22850;9050;147339;220136;220441;84552;9525;2531;9388;220164;5366;9352,136
-1,1,18,39302787,46570257,7267470,284266;100506888;8170;26040;83473;29906;51124;494470;5289;57724;54808;6860;728929;51224;652991;201501;6014;125336;4087;6563;162699;84064;9063;4092;9050;147339;498;115106;9811,29
-1,1,18,39915139,44306423,4391284,284266;8170;125336;26040;6563;29906;9050;147339;494470;57724;498;115106;6860;6014,14
1,1,18,40231357,78012829,37781472,100526842;1630;89778;83876;55628;4645;3998;147372;8792;84735;4772;5596;4155;84064;284257;1005;2235;5273;6139;23239;11201;101927322;4087;162699;79839;55748;374868;2922;284274;2587;26040;4200;28513;1528;201456;9306;9658;54877;81832;55205;26251;6925;4160;92126;57724;54808;220134;30827;6563;162681;9063;10666;284266;100506888;51320;100505549;147381;5874;51046;494470;80323;728929;4152;652991;201501;9480;5275;644041;8932;27164;440498;5268;498;89777;8170;4677;29906;23556;4089;9150;10194;220158;6317;125336;6318;4092;284254;115106;10892;90701;5271;29090;10907;7776;9811;125704;83473;54495;497661;115701;79863;400658;8710;6860;25914;51224;147323;5055;23327;28316;57614;10449;51124;55520;80148;30062;23335;6014;596;339302;5205;284273;284293;22850;9050;147339;220136;220441;84552;9525;2531;9388;220164;5366;9352,135
-1,1,18,41413445,43724104,2310659,284266;8170;26040;6563;9050;57724;498;115106,8
1,1,18,42930373,78014123,35083750,100526842;1630;89778;83876;55628;4645;3998;147372;8792;84735;4772;5596;4155;84064;284257;1005;2235;5273;6139;23239;11201;101927322;4087;162699;79839;55748;374868;2922;284274;2587;4200;28513;1528;201456;9306;9658;54877;81832;55205;26251;6925;4160;92126;57724;54808;220134;30827;6563;162681;9063;10666;284266;100506888;51320;100505549;147381;5874;51046;494470;80323;728929;4152;652991;201501;9480;5275;644041;8932;27164;440498;5268;498;89777;8170;4677;29906;23556;4089;9150;10194;220158;6317;125336;6318;4092;284254;115106;10892;90701;5271;29090;10907;7776;9811;125704;83473;54495;497661;115701;79863;400658;8710;25914;51224;147323;5055;23327;28316;57614;10449;51124;55520;80148;30062;23335;596;339302;5205;284273;284293;22850;9050;147339;220136;220441;84552;9525;2531;9388;220164;5366;9352,132
1,1,18,43776770,78014123,34237353,100506888;100526842;1630;51320;100505549;147381;5874;89778;83876;55628;51046;4645;494470;3998;147372;8792;84735;4772;80323;728929;4152;5596;201501;652991;9480;5275;644041;8932;4155;84064;27164;440498;5268;284257;89777;1005;2235;4677;5273;29906;6139;23239;23556;4089;9150;11201;101927322;10194;220158;6317;4087;125336;162699;6318;79839;4092;284254;55748;374868;10892;90701;5271;29090;10907;2922;284274;7776;9811;2587;125704;4200;83473;28513;54495;1528;201456;497661;115701;79863;400658;8710;25914;51224;9306;9658;147323;5055;23327;28316;54877;81832;57614;55205;10449;26251;6925;51124;4160;55520;92126;54808;80148;30062;23335;596;339302;220134;30827;5205;284273;162681;9063;284293;22850;220441;147339;220136;10666;84552;9525;2531;9388;220164;5366;9352,125
1,-1,18,44543250,44559113,15863,100506888;83473;162699;728929;51224,5
1,-1,18,44543250,44560442,17192,100506888;83473;162699;728929;51224,5
1,-1,18,44543250,44560442,17192,100506888;83473;162699;728929;51224,5
1,-1,18,44543250,44560442,17192,100506888;83473;162699;728929;51224,5
1,-1,18,44543250,44560442,17192,100506888;83473;162699;728929;51224,5
1,-1,18,44543250,44560442,17192,100506888;83473;162699;728929;51224,5
1,-1,18,44543250,44560442,17192,100506888;83473;162699;728929;51224,5
1,-1,18,44543250,44560442,17192,100506888;83473;162699;728929;51224,5
1,-1,18,44543250,44569729,26479,100506888;83473;162699;728929;51224,5
1,-1,18,44543250,44569729,26479,100506888;83473;162699;728929;51224,5
1,-1,18,44560400,44561897,1497,51224;83473,2
-1,1,18,46177798,78014123,31836325,100526842;1630;51320;100505549;147381;5874;89778;83876;55628;51046;4645;3998;147372;8792;84735;4772;80323;4152;9480;5596;5275;644041;8932;4155;27164;440498;5268;284257;89777;1005;2235;4677;5273;6139;23239;23556;4089;9150;11201;101927322;10194;220158;6317;6318;79839;4092;284254;55748;374868;10892;90701;5271;29090;10907;2922;284274;7776;9811;2587;125704;4200;54495;28513;1528;201456;497661;115701;79863;400658;8710;25914;9306;9658;147323;5055;23327;28316;54877;81832;57614;55205;10449;26251;6925;4160;55520;92126;54808;80148;30062;23335;596;339302;220134;30827;5205;284273;162681;284293;22850;220441;220136;10666;84552;9525;2531;9388;220164;5366;9352,110
1,1,18,46725781,78012829,31287048,100526842;1630;51320;100505549;147381;5874;89778;83876;55628;51046;4645;3998;147372;8792;84735;4772;80323;4152;9480;5596;5275;644041;8932;4155;27164;440498;5268;284257;89777;1005;2235;4677;5273;6139;23239;23556;4089;9150;11201;101927322;10194;220158;6317;6318;79839;284254;55748;374868;10892;90701;5271;29090;10907;2922;284274;7776;2587;125704;4200;54495;28513;1528;201456;497661;115701;79863;400658;8710;25914;9306;9658;147323;5055;23327;28316;54877;81832;57614;55205;10449;26251;6925;4160;55520;92126;54808;80148;30062;23335;596;339302;220134;30827;5205;284273;162681;284293;22850;220441;220136;10666;84552;9525;2531;9388;220164;5366;9352,108
1,-1,18,47015598,47015643,45,6139;100526842,2
1,-1,18,47015598,47015679,81,6139;100526842,2
1,-1,18,47015598,47015679,81,6139;100526842,2
1,-1,18,47015598,47015679,81,6139;100526842,2
1,1,18,47454437,78014123,30559686,1630;51320;100505549;147381;5874;51046;89778;83876;55628;4645;3998;147372;8792;84735;4772;80323;4152;9480;5596;5275;644041;8932;4155;27164;440498;5268;284257;89777;1005;2235;4677;5273;23239;23556;4089;9150;11201;101927322;10194;220158;6317;6318;79839;284254;55748;374868;10892;90701;5271;29090;10907;2922;284274;7776;2587;125704;4200;54495;28513;1528;201456;115701;79863;400658;8710;25914;9306;9658;147323;5055;23327;28316;54877;81832;57614;55205;26251;6925;4160;55520;92126;80148;30062;23335;596;339302;220134;30827;5205;284273;162681;284293;22850;220441;220136;10666;84552;9525;2531;220164;5366;9352,102
-1,1,18,47656799,78014123,30357324,1630;51320;100505549;147381;5874;51046;89778;83876;55628;4645;3998;147372;8792;84735;4772;80323;4152;9480;5596;5275;644041;8932;4155;27164;440498;5268;284257;89777;1005;2235;4677;5273;23239;23556;4089;9150;11201;101927322;10194;220158;6317;6318;79839;284254;55748;374868;10892;90701;5271;29090;10907;2922;284274;7776;2587;125704;4200;54495;28513;1528;201456;115701;79863;400658;8710;25914;9306;9658;147323;5055;23327;28316;54877;81832;57614;55205;26251;6925;4160;55520;92126;80148;30062;23335;596;339302;220134;30827;5205;284273;162681;284293;22850;220441;220136;10666;84552;9525;2531;220164;5366;9352,102
-1,1,18,48693529,78014123,29320594,1630;51320;100505549;147381;5874;51046;89778;55628;3998;147372;8792;84735;4772;80323;644041;9480;5275;8932;4155;27164;440498;5268;284257;89777;1005;2235;4677;5273;23239;23556;9150;11201;101927322;10194;220158;6317;6318;79839;284254;55748;374868;10892;90701;5271;29090;10907;2922;284274;7776;2587;125704;54495;28513;1528;201456;115701;79863;400658;8710;25914;9306;9658;147323;5055;23327;28316;54877;81832;57614;55205;26251;6925;4160;80148;92126;30062;23335;596;339302;5205;284273;162681;284293;22850;220441;10666;84552;9525;2531;220164;5366;9352,92
-1,1,18,48716799,78010032,29293233,51320;1630;100505549;147381;5874;51046;89778;55628;3998;147372;8792;84735;4772;80323;644041;9480;5275;8932;4155;27164;440498;5268;284257;89777;1005;2235;4677;5273;23239;23556;9150;11201;101927322;10194;220158;6317;6318;79839;284254;55748;374868;10892;90701;5271;29090;10907;2922;284274;7776;2587;125704;54495;28513;1528;201456;115701;79863;400658;8710;25914;9306;9658;147323;5055;23327;28316;54877;81832;57614;55205;26251;6925;4160;80148;92126;30062;23335;596;339302;5205;284273;162681;284293;22850;220441;10666;84552;9525;2531;220164;5366;9352,92
-1,1,18,49947422,78012829,28065407,1630;100505549;147381;5874;51046;89778;55628;3998;147372;8792;84735;4772;80323;644041;9480;5275;8932;4155;27164;440498;5268;284257;89777;1005;2235;4677;5273;23239;23556;9150;11201;101927322;10194;220158;6317;6318;79839;284254;55748;374868;10892;90701;5271;29090;10907;2922;284274;7776;2587;125704;54495;28513;1528;201456;115701;79863;400658;8710;25914;9306;9658;147323;5055;23327;28316;54877;81832;57614;55205;26251;6925;4160;80148;92126;30062;23335;596;339302;5205;284273;162681;284293;22850;220441;10666;84552;9525;2531;220164;5366;9352,91
-1,1,18,50739715,63705988,12966273,1630;100505549;5874;51046;89778;115701;3998;80323;147372;8792;8710;9480;5275;8932;147323;5055;23327;28316;54877;5268;57614;284257;89777;55205;1005;2235;4677;6925;5273;4160;23556;23239;30062;11201;23335;101927322;596;339302;6317;5205;6318;162681;284293;284254;220441;10892;90701;9525;5271;2531;2922;5366;9352,53
-1,1,18,51391427,78010032,26618605,100505549;147381;5874;51046;89778;55628;3998;147372;8792;84735;4772;80323;644041;9480;5275;8932;4155;27164;440498;5268;284257;89777;1005;2235;4677;5273;23239;23556;9150;11201;101927322;10194;220158;6317;6318;79839;284254;55748;374868;10892;90701;5271;29090;10907;2922;284274;7776;2587;125704;54495;28513;1528;201456;115701;79863;400658;8710;25914;9306;9658;147323;5055;23327;28316;54877;81832;57614;55205;26251;6925;4160;80148;92126;30062;23335;596;339302;5205;284273;162681;284293;22850;220441;10666;84552;9525;2531;220164;5366;9352,90
1,1,18,51486198,78012819,26526621,100505549;147381;5874;51046;89778;55628;3998;147372;8792;84735;4772;80323;644041;9480;5275;8932;4155;27164;440498;5268;284257;89777;1005;2235;4677;5273;23239;23556;9150;11201;101927322;10194;220158;6317;6318;79839;284254;55748;374868;10892;90701;5271;29090;10907;2922;284274;7776;2587;125704;54495;28513;1528;201456;115701;79863;400658;8710;25914;9306;9658;147323;5055;23327;28316;54877;81832;57614;55205;26251;6925;4160;80148;92126;30062;23335;596;339302;5205;284273;162681;284293;22850;220441;10666;84552;9525;2531;220164;5366;9352,90
-1,1,18,51994667,53616240,1621573,80323;284254;5874;6925,4
1,-1,18,52008963,52258392,249429,284254,1
-1,1,18,52524987,58257864,5732877,100505549;5874;51046;4677;6925;4160;115701;3998;80323;147372;30062;23335;9480;101927322;339302;5205;23327;284257;10892;55205;90701;2235;2922;5366;9352,25
-1,1,18,52759345,52961970,202625,6925,1
-1,1,18,52837852,77989426,25151574,100505549;147381;51046;89778;55628;3998;147372;8792;84735;4772;644041;9480;5275;4155;27164;440498;5268;284257;89777;1005;2235;4677;5273;23239;23556;9150;101927322;10194;220158;6317;6318;79839;55748;374868;10892;90701;5271;29090;10907;2922;284274;7776;2587;125704;54495;28513;1528;201456;115701;79863;400658;8710;25914;9306;9658;5055;23327;28316;54877;81832;57614;55205;26251;6925;4160;80148;92126;30062;23335;596;339302;5205;284273;284293;22850;220441;10666;84552;9525;2531;220164;5366;9352,83
-1,1,18,52846595,78012829,25166234,100505549;147381;51046;89778;55628;3998;147372;8792;84735;4772;644041;9480;5275;4155;27164;440498;5268;284257;89777;1005;2235;4677;5273;23239;23556;9150;101927322;10194;220158;6317;6318;79839;55748;374868;10892;90701;5271;29090;10907;2922;284274;7776;2587;125704;54495;28513;1528;201456;115701;79863;400658;8710;25914;9306;9658;5055;23327;28316;54877;81832;57614;55205;26251;6925;4160;80148;92126;30062;23335;596;339302;5205;284273;284293;22850;220441;10666;84552;9525;2531;220164;5366;9352,83
-1,1,18,53100584,78014123,24913539,100505549;147381;51046;89778;55628;3998;147372;8792;84735;4772;644041;9480;5275;4155;27164;440498;5268;284257;89777;1005;2235;4677;5273;23239;23556;9150;101927322;10194;220158;6317;6318;79839;55748;374868;10892;90701;5271;29090;10907;2922;284274;7776;2587;125704;54495;28513;1528;201456;115701;79863;400658;8710;25914;9306;9658;5055;23327;28316;54877;81832;57614;55205;26251;6925;4160;80148;92126;30062;23335;596;339302;5205;284273;284293;22850;220441;10666;84552;9525;2531;220164;5366;9352,83
-1,1,18,53214922,53346803,131881,6925,1
-1,1,18,54462182,78014123,23551941,100505549;147381;51046;89778;55628;3998;147372;8792;84735;4772;644041;9480;5275;4155;27164;440498;5268;284257;89777;1005;2235;4677;5273;23239;23556;9150;101927322;10194;220158;6317;6318;79839;55748;374868;10892;90701;5271;29090;10907;2922;284274;7776;2587;125704;54495;28513;1528;201456;115701;79863;400658;8710;25914;9306;9658;5055;23327;28316;54877;81832;57614;55205;26251;4160;80148;92126;30062;23335;596;339302;5205;284273;284293;22850;220441;10666;84552;9525;2531;220164;5366,81
-1,1,18,54876647,78016181,23139534,100505549;147381;51046;89778;55628;3998;147372;8792;84735;4772;644041;9480;5275;4155;27164;440498;5268;89777;1005;2235;4677;5273;23239;23556;9150;101927322;10194;220158;6317;6318;79839;55748;374868;10892;90701;5271;29090;10907;2922;284274;7776;2587;125704;54495;28513;1528;201456;115701;79863;400658;8710;25914;9306;9658;5055;23327;28316;54877;81832;57614;55205;26251;4160;80148;92126;30062;596;339302;5205;284273;284293;22850;220441;10666;84552;9525;2531;220164;5366,79
-1,1,18,55793243,68705548,12912305,54495;28513;89778;115701;3998;147372;8792;8710;25914;5275;9306;5055;23327;28316;54877;5268;57614;89777;55205;1005;5273;4160;23556;23239;92126;30062;101927322;596;220158;339302;6317;6318;284293;79839;220441;10666;10892;90701;9525;5271;2531;2922;220164;5366,44
-1,1,18,57234913,78010032,20775119,125704;54495;28513;147381;89778;1528;55628;201456;79863;400658;147372;8792;8710;25914;644041;5275;84735;4772;9306;9658;5055;4155;28316;54877;81832;5268;27164;440498;57614;89777;1005;26251;5366;5273;4160;80148;23556;23239;92126;9150;10194;596;220158;6317;6318;284273;284293;79839;22850;220441;10666;84552;55748;374868;9525;5271;2531;10907;29090;284274;7776;220164;2587,63
-1,1,18,57234913,78010032,20775119,125704;54495;28513;147381;89778;1528;55628;201456;79863;400658;147372;8792;8710;25914;644041;5275;84735;4772;9306;9658;5055;4155;28316;54877;81832;5268;27164;440498;57614;89777;1005;26251;5366;5273;4160;80148;23556;23239;92126;9150;10194;596;220158;6317;6318;284273;284293;79839;22850;220441;10666;84552;55748;374868;9525;5271;2531;10907;29090;284274;7776;220164;2587,63
-1,1,18,57664166,78012829,20348663,125704;54495;28513;147381;89778;1528;55628;201456;79863;400658;8792;8710;25914;644041;5275;84735;4772;9306;9658;5055;4155;28316;54877;81832;5268;27164;440498;57614;89777;10907;1005;26251;5273;4160;80148;23556;23239;92126;9150;10194;596;220158;6317;6318;284273;284293;79839;22850;220441;10666;84552;55748;374868;9525;5271;2531;29090;284274;7776;220164;2587,61
-1,1,18,58768873,78014123,19245250,125704;54495;28513;147381;89778;1528;55628;201456;79863;400658;8792;8710;25914;644041;5275;84735;4772;9306;9658;5055;4155;28316;54877;81832;5268;27164;440498;57614;89777;10907;1005;26251;5273;80148;23556;23239;92126;9150;10194;596;220158;6317;6318;284273;284293;79839;22850;220441;10666;84552;55748;374868;9525;5271;2531;29090;284274;7776;220164;2587,60
-1,1,18,59243242,78010032,18766790,125704;54495;28513;147381;89778;1528;55628;201456;79863;400658;8792;8710;25914;644041;5275;84735;4772;9306;9658;5055;4155;27164;54877;81832;5268;440498;57614;89777;10907;1005;26251;5273;80148;23556;23239;92126;9150;10194;596;220158;6317;6318;284273;284293;79839;22850;220441;10666;84552;55748;374868;9525;5271;2531;29090;284274;7776;220164;2587,59
-1,1,18,59280571,78009973,18729402,125704;54495;28513;147381;89778;1528;55628;201456;79863;400658;8792;8710;25914;644041;5275;84735;4772;9306;9658;5055;4155;27164;54877;81832;5268;440498;57614;89777;10907;1005;26251;5273;80148;23556;23239;92126;9150;10194;596;220158;6317;6318;284273;284293;79839;22850;220441;10666;84552;55748;374868;9525;5271;2531;29090;284274;7776;220164;2587,59
-1,1,18,59332806,78014123,18681317,125704;54495;28513;147381;89778;1528;55628;201456;79863;400658;8792;8710;25914;644041;5275;84735;4772;9306;9658;5055;4155;27164;54877;81832;5268;440498;57614;89777;10907;1005;26251;5273;80148;23556;23239;92126;9150;10194;596;220158;6317;6318;284273;284293;79839;22850;220441;10666;84552;55748;374868;9525;5271;2531;29090;284274;7776;220164;2587,59
-1,1,18,59494344,78010032,18515688,125704;54495;28513;147381;89778;1528;55628;201456;79863;400658;8792;8710;25914;644041;5275;84735;4772;9306;9658;5055;4155;27164;54877;81832;5268;440498;57614;89777;1005;26251;5273;80148;23556;23239;92126;9150;10194;596;220158;6317;6318;284273;284293;79839;22850;220441;10666;84552;55748;374868;9525;5271;2531;10907;29090;284274;7776;220164;2587,59
-1,1,18,59809990,78014123,18204133,125704;54495;28513;147381;89778;1528;55628;201456;79863;400658;8792;8710;25914;644041;5275;84735;4772;9306;9658;5055;4155;27164;54877;81832;5268;440498;57614;89777;1005;26251;5273;80148;23556;23239;92126;9150;10194;596;220158;6317;6318;284273;284293;79839;22850;10666;84552;55748;374868;9525;5271;2531;10907;29090;284274;7776;220164;2587,58
-1,1,18,59876469,78014123,18137654,125704;54495;28513;147381;89778;1528;55628;201456;79863;400658;8792;8710;25914;644041;5275;84735;4772;9306;9658;5055;4155;27164;54877;81832;5268;440498;57614;89777;1005;26251;5273;80148;23239;92126;9150;10194;596;220158;6317;6318;284273;284293;79839;22850;10666;84552;55748;374868;9525;5271;2531;10907;29090;284274;7776;220164;2587,57
-1,1,18,60641553,78014123,17372570,125704;54495;28513;147381;89778;1528;55628;201456;79863;400658;8710;25914;84735;644041;5275;4772;9306;9658;5055;4155;27164;440498;81832;5268;89777;1005;26251;5273;80148;23239;92126;9150;10194;596;220158;6317;6318;284273;284293;79839;22850;10666;84552;55748;374868;9525;5271;2531;10907;29090;284274;7776;220164;2587,54
-1,1,18,60796196,78014123,17217927,125704;54495;28513;147381;89778;1528;55628;201456;79863;400658;8710;25914;84735;644041;5275;4772;9306;9658;5055;4155;27164;440498;81832;5268;89777;1005;26251;5273;80148;92126;9150;10194;596;220158;6317;6318;284273;284293;79839;22850;10666;84552;55748;374868;9525;5271;2531;10907;29090;284274;7776;220164;2587,53
-1,1,18,60973433,78010032,17036599,125704;54495;28513;147381;89778;1528;55628;201456;79863;400658;8710;25914;84735;644041;5275;4772;9306;9658;5055;4155;27164;440498;81832;5268;89777;1005;26251;5273;80148;92126;9150;10194;596;220158;6317;6318;284273;284293;79839;22850;10666;84552;55748;374868;9525;5271;2531;10907;29090;284274;7776;220164;2587,53
-1,1,18,61424150,78012829,16588679,125704;54495;28513;147381;1528;55628;201456;79863;400658;8710;4772;25914;84735;644041;9306;9658;5055;4155;27164;440498;81832;1005;26251;5273;80148;92126;9150;10194;220158;284273;284293;79839;22850;10666;84552;55748;374868;5271;29090;10907;284274;7776;220164;2587,44
-1,1,18,61513707,64226011,2712304,5055;284293;5273;28513;5271;1005,6
-1,1,18,61673145,78014123,16340978,125704;54495;28513;147381;1528;55628;201456;79863;400658;4772;25914;84735;644041;9306;9658;4155;27164;440498;81832;1005;26251;80148;92126;9150;10194;220158;284273;79839;22850;10666;84552;55748;374868;29090;10907;284274;7776;220164;2587,39
-1,1,18,62414964,78012829,15597865,125704;54495;28513;147381;1528;55628;201456;79863;400658;4772;25914;84735;644041;9306;9658;4155;27164;440498;81832;1005;26251;80148;92126;9150;10194;220158;284273;79839;22850;10666;84552;55748;374868;29090;10907;284274;7776;220164;2587,39
-1,1,18,62492471,78016181,15523710,125704;54495;28513;147381;1528;55628;201456;79863;400658;4772;25914;84735;644041;9306;9658;4155;27164;440498;81832;1005;26251;80148;92126;9150;10194;220158;284273;79839;22850;10666;84552;55748;374868;29090;10907;284274;7776;220164;2587,39
-1,1,18,63326060,78012829,14686769,125704;54495;28513;147381;1528;55628;201456;79863;400658;4772;25914;84735;644041;9306;9658;4155;27164;440498;81832;1005;26251;80148;92126;9150;10194;220158;284273;79839;22850;10666;84552;55748;374868;29090;10907;284274;7776;220164;2587,39
-1,1,18,63360824,78010032,14649208,125704;54495;28513;147381;1528;55628;201456;79863;400658;4772;25914;84735;644041;9306;9658;4155;27164;440498;81832;1005;26251;80148;92126;9150;10194;220158;284273;79839;22850;10666;84552;55748;374868;29090;10907;284274;7776;220164;2587,39
-1,1,18,63857253,78012829,14155576,125704;54495;28513;147381;1528;55628;201456;79863;400658;4772;25914;84735;644041;9306;9658;4155;27164;440498;81832;26251;80148;92126;9150;10194;220158;284273;79839;22850;10666;84552;55748;374868;29090;10907;284274;7776;220164;2587,38
-1,1,18,64123586,78014123,13890537,125704;54495;28513;147381;1528;55628;201456;79863;400658;4772;25914;84735;644041;9306;9658;4155;27164;440498;81832;26251;80148;92126;9150;10194;220158;284273;79839;22850;10666;84552;55748;374868;29090;10907;284274;7776;220164;2587,38
-1,1,18,64316464,78012819,13696355,125704;54495;147381;1528;55628;201456;79863;400658;4772;25914;84735;644041;9306;9658;4155;27164;440498;81832;26251;80148;92126;9150;10194;220158;284273;79839;22850;10666;84552;55748;374868;29090;10907;284274;7776;220164;2587,37
-1,1,18,64524888,78014123,13489235,125704;54495;147381;1528;55628;201456;79863;400658;4772;25914;84735;644041;9306;9658;4155;27164;440498;81832;26251;80148;92126;9150;10194;220158;284273;79839;22850;10666;84552;55748;374868;29090;10907;284274;7776;220164;2587,37
-1,-1,18,64570466,64669306,98840,,0
1,1,18,65353599,78010032,12656433,125704;54495;147381;1528;55628;201456;79863;400658;4772;25914;84735;644041;9306;9658;4155;27164;440498;81832;26251;80148;9150;10194;220158;284273;79839;22850;10666;84552;55748;374868;29090;10907;284274;7776;220164;2587,36
-1,1,18,65439813,78010032,12570219,125704;54495;147381;1528;55628;201456;79863;400658;4772;25914;84735;644041;9306;9658;4155;27164;440498;81832;26251;80148;9150;10194;220158;284273;79839;22850;10666;84552;55748;374868;29090;10907;284274;7776;220164;2587,36
-1,-1,18,65648458,65772355,123897,,0
-1,1,18,65648458,78005185,12356727,125704;54495;147381;1528;55628;201456;79863;400658;4772;25914;84735;644041;9306;9658;4155;27164;440498;81832;26251;80148;9150;10194;220158;284273;79839;22850;10666;84552;55748;374868;29090;10907;284274;7776;220164;2587,36
-1,1,18,66007239,78014123,12006884,125704;54495;147381;1528;55628;201456;79863;400658;4772;25914;84735;644041;9306;9658;4155;27164;440498;81832;26251;80148;9150;10194;220158;284273;79839;22850;10666;84552;55748;374868;29090;10907;284274;7776;220164;2587,36
-1,1,18,66084833,78010032,11925199,125704;54495;147381;1528;55628;201456;79863;400658;4772;25914;84735;644041;9306;9658;4155;27164;440498;81832;26251;80148;9150;10194;220158;284273;79839;22850;10666;84552;55748;374868;29090;10907;284274;7776;220164;2587,36
-1,1,18,66230659,78012829,11782170,125704;54495;147381;1528;55628;201456;79863;400658;4772;25914;84735;644041;9306;9658;4155;27164;440498;81832;26251;80148;9150;10194;220158;284273;79839;22850;10666;84552;55748;374868;29090;10907;284274;7776;220164;2587,36
-1,1,18,66497471,78012829,11515358,125704;147381;1528;55628;201456;79863;400658;4772;25914;84735;644041;9306;9658;4155;27164;440498;81832;26251;80148;9150;10194;220158;284273;79839;22850;10666;84552;55748;374868;29090;10907;284274;7776;220164;2587,35
-1,1,18,66525141,78014123,11488982,125704;147381;1528;55628;201456;79863;400658;4772;25914;84735;644041;9306;9658;4155;27164;440498;81832;26251;80148;9150;10194;220158;284273;79839;22850;10666;84552;55748;374868;29090;10907;284274;7776;220164;2587,35
-1,1,18,66593317,78014123,11420806,125704;147381;1528;55628;201456;79863;400658;4772;25914;84735;644041;9306;9658;4155;27164;440498;81832;26251;80148;9150;10194;220158;284273;79839;22850;10666;84552;55748;374868;29090;10907;284274;7776;220164;2587,35
-1,1,18,66593317,78014123,11420806,125704;147381;1528;55628;201456;79863;400658;4772;25914;84735;644041;9306;9658;4155;27164;440498;81832;26251;80148;9150;10194;220158;284273;79839;22850;10666;84552;55748;374868;29090;10907;284274;7776;220164;2587,35
-1,1,18,66625843,78014123,11388280,125704;147381;1528;55628;201456;79863;400658;4772;25914;84735;644041;9306;9658;4155;27164;440498;81832;26251;80148;9150;10194;220158;284273;79839;22850;10666;84552;55748;374868;29090;10907;284274;7776;220164;2587,35
-1,1,18,66867826,78010032,11142206,125704;147381;1528;55628;201456;79863;400658;4772;25914;84735;644041;9306;9658;4155;27164;440498;81832;26251;80148;9150;10194;220158;284273;22850;10666;84552;55748;374868;29090;10907;284274;7776;220164;2587,34
-1,1,18,67318038,78012829,10694791,125704;147381;1528;55628;201456;79863;400658;4772;25914;84735;644041;9306;9658;4155;27164;440498;81832;26251;80148;9150;10194;220158;284273;22850;10666;84552;55748;374868;29090;10907;284274;7776;220164;2587,34
-1,1,18,67431406,78014123,10582717,125704;147381;1528;55628;201456;79863;400658;4772;25914;84735;644041;9306;9658;4155;27164;440498;81832;26251;80148;9150;10194;220158;284273;22850;10666;84552;55748;374868;29090;10907;284274;7776;220164;2587,34
-1,1,18,68735040,78010032,9274992,125704;26251;147381;1528;55628;201456;79863;80148;400658;9150;4772;84735;644041;10194;9658;284273;4155;27164;440498;81832;22850;84552;55748;374868;29090;10907;284274;7776;2587,29
-1,-1,18,68956411,69131423,175012,,0
1,1,18,69540119,78012829,8472710,125704;26251;147381;1528;55628;201456;79863;80148;400658;9150;4772;84735;644041;10194;9658;284273;4155;27164;440498;81832;22850;84552;55748;374868;29090;10907;284274;7776;2587,29
-1,1,18,69711141,78012819,8301678,125704;26251;147381;1528;55628;201456;79863;80148;400658;9150;4772;84735;644041;10194;9658;284273;4155;27164;440498;81832;22850;84552;55748;374868;29090;10907;284274;7776;2587,29
-1,1,18,70093947,78010032,7916085,125704;26251;147381;1528;55628;201456;79863;80148;400658;9150;4772;84735;644041;10194;9658;284273;4155;27164;440498;81832;22850;84552;55748;374868;29090;10907;284274;7776;2587,29
-1,1,18,70306575,78012829,7706254,125704;26251;1528;55628;201456;79863;80148;400658;9150;4772;84735;644041;10194;9658;284273;4155;27164;440498;81832;22850;84552;55748;374868;29090;10907;284274;7776;2587,28
-1,1,18,70340543,78014123,7673580,125704;26251;1528;55628;201456;79863;80148;400658;9150;4772;84735;644041;10194;9658;284273;4155;27164;440498;81832;22850;84552;55748;374868;29090;10907;284274;7776;2587,28
-1,1,18,71000074,78012829,7012755,125704;26251;1528;55628;201456;79863;80148;400658;9150;4772;84735;644041;10194;9658;284273;4155;27164;440498;22850;84552;55748;374868;29090;10907;284274;7776;2587,27
1,1,18,71000074,78012829,7012755,125704;26251;1528;55628;201456;79863;80148;400658;9150;4772;84735;644041;10194;9658;284273;4155;27164;440498;22850;84552;55748;374868;29090;10907;284274;7776;2587,27
1,-1,18,72165066,72343451,178385,55628;55748;84735,3
-1,1,18,72942828,78016181,5073353,26251;79863;80148;400658;9150;4772;10194;9658;4155;27164;440498;22850;84552;374868;10907;284274;7776;2587,18
-1,1,18,73136006,77982126,4846120,26251;79863;80148;400658;9150;4772;9658;4155;27164;440498;22850;84552;374868;10907;284274;7776;2587,17
-1,1,18,73389017,78016181,4627164,26251;79863;80148;400658;9150;4772;9658;4155;27164;440498;22850;84552;374868;10907;7776;2587,16
-1,1,18,73587460,78009973,4422513,26251;79863;80148;400658;9150;4772;9658;4155;27164;440498;22850;84552;374868;10907;7776;2587,16
-1,1,18,73658861,78010032,4351171,26251;79863;80148;400658;9150;4772;9658;4155;27164;440498;22850;84552;374868;10907;7776;2587,16
-1,1,18,73700832,78010032,4309200,26251;79863;80148;400658;9150;4772;9658;4155;27164;440498;22850;84552;374868;10907;7776;2587,16
1,1,18,74064964,78014123,3949159,26251;79863;80148;400658;9150;4772;9658;4155;27164;440498;22850;84552;374868;10907;7776;2587,16
1,-1,18,74118672,74251404,132732,400658;9658,2
1,-1,18,74347427,74439776,92349,,0
-1,1,18,74347427,78010032,3662605,26251;4155;27164;440498;22850;79863;80148;9150;84552;374868;4772;10907;7776;2587,14
-1,1,18,74975665,78010032,3034367,26251;27164;440498;22850;79863;80148;9150;84552;374868;4772;10907;2587,12
-1,1,18,74975665,78010032,3034367,26251;27164;440498;22850;79863;80148;9150;84552;374868;4772;10907;2587,12
-1,1,18,75968374,78016181,2047807,26251;27164;440498;22850;79863;80148;9150;84552;374868;4772;10907,11
-1,1,18,76553781,78016181,1462400,26251;27164;440498;22850;79863;80148;9150;84552;374868;4772;10907,11
-1,1,18,76869103,78016181,1147078,26251;440498;22850;79863;80148;9150;84552;374868;4772;10907,10
-1,1,18,77098565,78014123,915558,26251;440498;22850;79863;80148;9150;84552;374868;4772;10907,10
-1,1,18,77682576,78010032,327456,84552;10907;440498;22850;79863;80148,6
-1,1,18,77682576,78010032,327456,84552;10907;440498;22850;79863;80148,6
-1,1,18,77682576,78010032,327456,84552;10907;440498;22850;79863;80148,6
1,-1,18,77762403,77844770,82367,10907;79863,2
1,-1,19,61112,113418,52306,81099,1
-1,-1,19,61112,113418,52306,81099,1
1,-1,19,61112,113418,52306,81099,1
1,-1,19,61112,113418,52306,81099,1
1,-1,19,61112,113418,52306,81099,1
1,-1,19,61112,113418,52306,81099,1
1,-1,19,61112,168688,107576,81099,1
1,-1,19,61112,168688,107576,81099,1
1,-1,19,61112,168688,107576,81099,1
-1,-1,19,61112,186241,125129,81099,1
1,-1,19,61112,186241,125129,81099,1
1,-1,19,61112,202952,141840,81099,1
-1,-1,19,74459,113418,38959,81099,1
1,-1,19,74459,113418,38959,81099,1
-1,-1,19,74503,113418,38915,81099,1
1,-1,19,91171,127601,36430,81099,1
1,-1,19,91171,127601,36430,81099,1
1,-1,19,91171,131425,40254,81099,1
1,-1,19,91171,156185,65014,81099,1
1,-1,19,91171,168688,77517,81099,1
1,-1,19,91171,202952,111781,81099,1
1,-1,19,127601,138477,10876,,0
1,-1,19,127601,156185,28584,,0
1,1,19,259395,2068506,1809111,566;51298;400668;374291;1943;54760;8612;26528;6929;55643;1153;10347;55009;116444;5657;148223;1991;57455;91978;6209;399664;113179;22904;284451;339366;81926;5064;27006;79948;23526;513;148229;10025;84939;2879;610;83855;126567;1265;126520;91304;997;53615;113178;3004;10297;54531;91300;84634;92840;55658;10272;1820;25759;1675;90007;390874;6794;682;8174;255057;10975;57418;2593;1455;5442;126353;5434;2872;5725,70
1,1,19,259395,6795622,6536227,566;126259;6294;51298;400668;374291;55111;80032;1943;58492;5605;100131094;51343;8612;26528;8175;56931;55620;55643;1153;2527;84266;84839;116444;148252;4782;23396;4298;1991;113179;4946;22904;9667;8698;83475;92359;4616;56961;5064;374872;79085;79948;23526;513;729359;23217;51690;2525;26517;9322;6449;84939;148022;29128;828;610;5623;126567;56926;1265;970;163154;997;56928;9546;10226;125981;3004;125988;374875;10297;126295;25873;56927;54531;116541;9361;79958;91300;84634;92840;8943;79187;56005;51548;10272;8744;4902;27134;8174;170961;6455;55527;255057;10975;84699;1455;115196;148066;27231;718;8570;2872;55702;85300;58509;126326;60680;81616;6915;126328;126306;54760;645191;6929;400673;284427;10045;10347;80700;55009;10036;5657;148223;91039;57455;166;84954;5802;91978;6209;399664;126308;257062;2767;1938;284451;10501;339366;100128569;8740;81926;2788;10382;27006;645432;148229;84717;148254;5990;2962;10025;2879;83855;51341;7409;4145;126321;126520;1613;91304;53615;113178;10362;84444;79816;390877;2769;23030;8498;55658;360200;440503;1820;25759;84823;116844;1675;90007;390874;6794;682;29985;7089;57418;2593;284422;268;126282;5442;126353;5434;7064;113177;10148;8192;5725;2528;51588,199
1,1,19,260912,58956888,58695976,2204;390940;55111;9437;3276;388566;439;54854;163227;114335;1153;6237;1553;23547;147719;162979;10859;23396;57343;79603;374897;147687;126248;10331;1;9230;404037;148266;728361;55659;126206;56729;147657;5064;374872;84330;23581;3270;79948;100131801;374918;64100;100131137;51690;2525;2015;7766;728485;10994;374920;7594;25818;973;58513;4909;5623;3978;374900;89887;26121;22809;997;125988;8463;3004;115727;57615;8625;112398;284340;4606;374877;79958;7562;9441;8725;1054;79042;390892;1725;147710;84671;282616;10975;91664;23645;1455;148066;341;1463;57794;65251;55311;126326;6234;388523;114770;259307;126526;6915;55588;100507003;3748;126298;78992;5671;284427;284366;53637;653499;7770;282617;53635;29950;256126;5518;91039;201514;9253;80726;126133;148109;126308;125958;25796;85569;5653;2906;284451;390882;90317;8740;23636;284312;5348;64344;404217;116115;7576;10382;645432;27076;4818;84717;57693;148156;342897;84467;284406;90338;94027;22870;3802;147949;125875;51398;6626;84444;100529240;55260;3661;27294;147929;54958;342918;81;56971;2769;26145;5672;55658;22835;27300;83983;115950;8677;162972;84823;116844;204801;83546;11006;23354;83639;268;84527;3589;376497;10148;7064;148170;284417;163131;79143;126259;26065;400668;64763;100131094;2357;171169;6618;23031;79891;503835;56931;92285;503834;7644;5050;2512;26093;10945;11284;9545;51477;811;6158;100287226;1991;808;2068;284339;4946;388507;5424;3640;22847;55851;4207;339344;105372280;147744;7554;126541;27033;60385;79085;59283;284352;163049;29128;1994;79709;1340;79149;7733;1265;9668;57469;26538;162962;85360;10990;55723;171392;83743;79713;5349;160;100130519;388553;2524;84634;100170229;79760;5585;93436;4793;643669;126205;8744;26659;10794;27106;79939;29997;43849;6625;8174;89858;388552;558;54;2872;55900;6510;7638;388564;5819;79784;84807;4099;7515;23373;400673;27113;147991;5650;147965;644096;57348;148223;9141;7288;166;83596;79036;147872;90594;399664;29998;55101;7297;90576;5794;4650;10849;55769;147948;114336;170463;4701;2091;348;147912;148254;26539;11012;284346;4680;80110;84914;79414;7409;1264;51171;126321;5680;388559;84292;10362;100049587;692312;91663;826;5609;56917;89790;3036;79788;23030;284361;126014;3903;360200;147670;126231;84658;9244;284306;390874;2696;23149;79575;147746;593;63934;199746;374879;1572;57573;1084;5704;100271846;374887;53916;79973;126129;7710;342931;51343;148268;342933;79230;8612;81890;27338;10782;114823;10567;25804;400720;284323;53345;100271849;2359;10469;91442;64981;7620;57474;10848;79818;11140;3337;90589;26664;83475;8698;81856;56961;4696;51710;11025;29903;729359;84449;8857;255043;3949;9745;1311;4713;100293516;55554;163071;126567;102724279;2523;56926;284415;23383;163154;80207;9546;25959;84063;9294;23309;56269;56927;1777;54531;57572;93233;147686;2997;6205;5589;5714;22900;56005;10172;10272;30835;4784;354;9817;84964;646457;3770;7408;1050;718;3594;84335;148206;85300;3982;199704;163051;6320;3811;126328;342908;84337;30817;84518;284443;10224;125919;162963;11136;11129;1549;10053;140467;10775;84261;57455;284297;91978;6209;11027;126382;339366;100128569;50509;30846;7691;8529;27006;147685;5990;30000;256949;4849;51341;7728;284402;84971;1785;162998;5536;64857;53615;26532;8178;126208;729440;9170;946;57130;84787;10054;7705;339327;7673;2909;126068;1209;55422;2067;6794;83854;29985;1346;284418;284391;2593;284422;342898;641649;2217;58506;8192;7757;55908;342977;10715;117579;58492;1628;1943;5438;84258;6370;8425;94030;55643;27202;25999;5817;9534;2527;84266;116444;388531;83483;54811;57663;4782;3743;90480;8907;84705;57834;199720;634;3812;5655;2931;92359;83889;125972;9704;10452;147808;92960;24139;126374;100507527;9002;58491;147945;9322;6449;399473;1178;348327;610;7643;163183;162967;163050;284355;6813;84306;646862;51295;333;64377;199777;59348;5639;56342;11133;7771;79629;80271;8943;4670;93323;10683;57616;64748;57655;1155;199745;57664;54814;7561;3191;51293;729991;126375;126272;84699;100129842;199800;115098;115861;255809;148137;6217;342909;11316;26974;10908;10856;53822;126123;54938;388536;645191;5329;92799;57479;581;84922;6142;6203;57677;10535;9710;352909;602;100529215;4051;54929;2323;374907;2358;8190;51291;338321;10437;90485;284358;100170765;284382;10520;1087;93099;9454;9149;59285;4218;3805;6193;11338;59286;170958;444882;93145;29785;29086;10653;440503;1820;56891;11283;682;147646;100129543;2063;25850;51231;344;2864;126006;28974;7730;79673;92283;84798;684;374291;1048;54850;7711;6633;976;5678;388561;93343;147807;163059;729767;125893;3718;54776;7376;400713;93659;3904;100506012;113179;653583;84902;390927;26658;4861;51206;126402;57716;57191;513;54831;6511;23217;10298;388555;770;51276;91646;2639;84939;828;51599;90333;4125;9310;126119;56928;199692;10297;3386;147694;84245;125962;10780;147798;163255;84167;84079;92840;50944;79187;3963;51548;653656;55201;91661;199786;5143;79047;22933;54807;126204;284369;7773;54869;6141;27120;115196;27231;7769;10430;126370;6689;94235;933;79165;126299;3385;2867;773;23646;147920;10270;374882;79935;10332;147700;10347;388551;5657;80199;81492;80776;51079;257062;2767;65982;10501;23094;8666;23152;3171;84446;4037;170959;3783;2962;554235;2879;90580;79156;390883;112812;5670;26330;55295;91304;113178;388558;9466;951;148014;9535;5669;57139;23521;112724;3804;11184;208;23546;100507588;64073;7305;27181;7392;7171;2109;29888;57192;125950;126282;5442;5434;147650;113177;339345;478;342979;83987;147968;79735;566;51298;5605;7087;346;26528;58525;6183;51129;148252;729974;27151;115948;5739;22904;23619;101927572;3960;51073;27335;126147;59284;57828;7040;440533;4924;147923;90353;126017;199713;79086;4854;112401;10661;90592;10226;125981;25873;115704;729747;6829;6861;7311;5300;84924;126364;5141;6820;90273;9422;26333;10055;79744;388512;51545;55527;57153;3809;4868;79883;84911;10870;26526;56301;55702;117286;3780;81857;29911;114026;56848;60680;9592;126306;2057;284309;730087;10045;29844;80700;91662;4542;342945;284349;3727;85509;4059;653657;84954;5802;51070;84775;646643;79171;6261;1938;126003;83878;284325;7767;114132;126075;10755;2788;148198;50700;7568;8775;79016;55850;284459;10025;10498;55011;85415;94025;729956;1613;2208;374899;54555;23624;10147;81931;6223;84436;29124;79763;1089;255783;113835;1995;6253;3991;199699;284338;125965;11024;2854;54795;9476;126432;5673;23370;7639;6543;126433;126353;55786;284359;22859;140612;9757;163081;23403;10288;5989;6294;54922;1088;147741;7652;55620;56242;80714;284428;57731;7137;84215;57787;26291;125963;115653;7001;402665;7138;147837;6795;5886;9667;353355;116412;64926;29946;388533;4616;163126;390916;284348;945;2077;56344;282618;1548;26517;2014;23640;29924;2821;5675;54862;27036;90233;7565;317703;126295;6324;11100;90332;1032;23476;9266;6822;65249;4066;57126;2354;1175;163033;57030;81576;342926;79934;55150;3972;1082;28968;100507290;27134;284390;3817;6455;7694;1954;54815;255057;148003;81794;7675;8193;56915;8570;43847;100125288;91120;79173;79147;3383;730051;58509;10781;256051;90324;126074;92609;90075;80131;55957;199731;10036;495;1760;162966;7772;163115;284433;66002;147699;23770;57333;63946;645;57622;148229;2657;5184;339390;126069;284434;284383;3609;2116;79852;390928;148103;1406;112703;10365;51157;55337;84503;148113;79816;5676;390877;25888;8498;8993;728;90007;284307;113230;7596;93134;7538;57418;26017;342892;100130827;440515;23474;201516;147658;2528;51588;5032;3726;80032;79088;353088;26993;3643;57719;8175;163087;8189;54623;84839;284370;126393;57817;284371;4298;2865;8778;6597;126549;388567;55049;9518;5452;5178;53827;23526;94274;23025;55228;162993;1555;374928;148022;339324;390980;970;6528;90321;27180;9524;90378;57711;374875;11202;162968;2193;115703;25865;147645;147906;1786;284403;116541;9361;22983;56006;7768;284439;342865;91300;6415;163175;26085;5971;57662;65095;4902;80095;1158;170961;3816;79041;5864;112939;84106;23211;113091;64130;11045;147664;55095;80164;348303;81616;54760;6929;7386;90379;9622;2828;55009;55762;1762;125997;56949;4294;898;10212;55552;5582;90522;81926;5731;284353;84769;9424;79898;114783;115290;199675;54858;147660;147841;79002;126070;83855;84941;10523;4145;7695;80264;4858;55655;126520;51257;94059;163223;55621;83636;1891;5296;94039;126410;162989;90649;84765;5976;148213;441864;57106;5566;25759;8541;1675;58510;9138;79090;93650;11018;7693;7089;55094;26648;339318;79177;3249;587;2901;94115;5725;317701;342900;25789;125931;100129083;8605,1365
1,1,19,260912,58956888,58695976,2204;390940;55111;9437;3276;388566;439;54854;163227;114335;1153;6237;1553;23547;147719;162979;10859;23396;57343;79603;374897;147687;126248;10331;1;9230;404037;148266;728361;55659;126206;56729;147657;5064;374872;84330;23581;3270;79948;100131801;374918;64100;100131137;51690;2525;2015;7766;728485;10994;374920;7594;25818;973;58513;4909;5623;3978;374900;89887;26121;22809;997;125988;8463;3004;115727;57615;8625;112398;284340;4606;374877;79958;7562;9441;8725;1054;79042;390892;1725;147710;84671;282616;10975;91664;23645;1455;148066;341;1463;57794;65251;55311;126326;6234;388523;114770;259307;126526;6915;55588;100507003;3748;126298;78992;5671;284427;284366;53637;653499;7770;282617;53635;29950;256126;5518;91039;201514;9253;80726;126133;148109;126308;125958;25796;85569;5653;2906;284451;390882;90317;8740;23636;284312;5348;64344;404217;116115;7576;10382;645432;27076;4818;84717;57693;148156;342897;84467;284406;90338;94027;22870;3802;147949;125875;51398;6626;84444;100529240;55260;3661;27294;147929;54958;342918;81;56971;2769;26145;5672;55658;22835;27300;83983;115950;8677;162972;84823;116844;204801;83546;11006;23354;83639;268;84527;3589;376497;10148;7064;148170;284417;163131;79143;126259;26065;400668;64763;100131094;2357;171169;6618;23031;79891;503835;56931;92285;503834;7644;5050;2512;26093;10945;11284;9545;51477;811;6158;100287226;1991;808;2068;284339;4946;388507;5424;3640;22847;55851;4207;339344;105372280;147744;7554;126541;27033;60385;79085;59283;284352;163049;29128;1994;79709;1340;79149;7733;1265;9668;57469;26538;162962;85360;10990;55723;171392;83743;79713;5349;160;100130519;388553;2524;84634;100170229;79760;5585;93436;4793;643669;126205;8744;26659;10794;27106;79939;29997;43849;6625;8174;89858;388552;558;54;2872;55900;6510;7638;388564;5819;79784;84807;4099;7515;23373;400673;27113;147991;5650;147965;644096;57348;148223;9141;7288;166;83596;79036;147872;90594;399664;29998;55101;7297;90576;5794;4650;10849;55769;147948;114336;170463;4701;2091;348;147912;148254;26539;11012;284346;4680;80110;84914;79414;7409;1264;51171;126321;5680;388559;84292;10362;100049587;692312;91663;826;5609;56917;89790;3036;79788;23030;284361;126014;3903;360200;147670;126231;84658;9244;284306;390874;2696;23149;79575;147746;593;63934;199746;374879;1572;57573;1084;5704;100271846;374887;53916;79973;126129;7710;342931;51343;148268;342933;79230;8612;81890;27338;10782;114823;10567;25804;400720;284323;53345;100271849;2359;10469;91442;64981;7620;57474;10848;79818;11140;3337;90589;26664;83475;8698;81856;56961;4696;51710;11025;29903;729359;84449;8857;255043;3949;9745;1311;4713;100293516;55554;163071;126567;102724279;2523;56926;284415;23383;163154;80207;9546;25959;84063;9294;23309;56269;56927;1777;54531;57572;93233;147686;2997;6205;5589;5714;22900;56005;10172;10272;30835;4784;354;9817;84964;646457;3770;7408;1050;718;3594;84335;148206;85300;3982;199704;163051;6320;3811;126328;342908;84337;30817;84518;284443;10224;125919;162963;11136;11129;1549;10053;140467;10775;84261;57455;284297;91978;6209;11027;126382;339366;100128569;50509;30846;7691;8529;27006;147685;5990;30000;256949;4849;51341;7728;284402;84971;1785;162998;5536;64857;53615;26532;8178;126208;729440;9170;946;57130;84787;10054;7705;339327;7673;2909;126068;1209;55422;2067;6794;83854;29985;1346;284418;284391;2593;284422;342898;641649;2217;58506;8192;7757;55908;342977;10715;117579;58492;1628;1943;5438;84258;6370;8425;94030;55643;27202;25999;5817;9534;2527;84266;116444;388531;83483;54811;57663;4782;3743;90480;8907;84705;57834;199720;634;3812;5655;2931;92359;83889;125972;9704;10452;147808;92960;24139;126374;100507527;9002;58491;147945;9322;6449;399473;1178;348327;610;7643;163183;162967;163050;284355;6813;84306;646862;51295;333;64377;199777;59348;5639;56342;11133;7771;79629;80271;8943;4670;93323;10683;57616;64748;57655;1155;199745;57664;54814;7561;3191;51293;729991;126375;126272;84699;100129842;199800;115098;115861;255809;148137;6217;342909;11316;26974;10908;10856;53822;126123;54938;388536;645191;5329;92799;57479;581;84922;6142;6203;57677;10535;9710;352909;602;100529215;4051;54929;2323;374907;2358;8190;51291;338321;10437;90485;284358;100170765;284382;10520;1087;93099;9454;9149;59285;4218;3805;6193;11338;59286;170958;444882;93145;29785;29086;10653;440503;1820;56891;11283;682;147646;100129543;2063;25850;51231;344;2864;126006;28974;7730;79673;92283;84798;684;374291;1048;54850;7711;6633;976;5678;388561;93343;147807;163059;729767;125893;3718;54776;7376;400713;93659;3904;100506012;113179;653583;84902;390927;26658;4861;51206;126402;57716;57191;513;54831;6511;23217;10298;388555;770;51276;91646;2639;84939;828;51599;90333;4125;9310;126119;56928;199692;10297;3386;147694;84245;125962;10780;147798;163255;84167;84079;92840;50944;79187;3963;51548;653656;55201;91661;199786;5143;79047;22933;54807;126204;284369;7773;54869;6141;27120;115196;27231;7769;10430;126370;6689;94235;933;79165;126299;3385;2867;773;23646;147920;10270;374882;79935;10332;147700;10347;388551;5657;80199;81492;80776;51079;257062;2767;65982;10501;23094;8666;23152;3171;84446;4037;170959;3783;2962;554235;2879;90580;79156;390883;112812;5670;26330;55295;91304;113178;388558;9466;951;148014;9535;5669;57139;23521;112724;3804;11184;208;23546;100507588;64073;7305;27181;7392;7171;2109;29888;57192;125950;126282;5442;5434;147650;113177;339345;478;342979;83987;147968;79735;566;51298;5605;7087;346;26528;58525;6183;51129;148252;729974;27151;115948;5739;22904;23619;101927572;3960;51073;27335;126147;59284;57828;7040;440533;4924;147923;90353;126017;199713;79086;4854;112401;10661;90592;10226;125981;25873;115704;729747;6829;6861;7311;5300;84924;126364;5141;6820;90273;9422;26333;10055;79744;388512;51545;55527;57153;3809;4868;79883;84911;10870;26526;56301;55702;117286;3780;81857;29911;114026;56848;60680;9592;126306;2057;284309;730087;10045;29844;80700;91662;4542;342945;284349;3727;85509;4059;653657;84954;5802;51070;84775;646643;79171;6261;1938;126003;83878;284325;7767;114132;126075;10755;2788;148198;50700;7568;8775;79016;55850;284459;10025;10498;55011;85415;94025;729956;1613;2208;374899;54555;23624;10147;81931;6223;84436;29124;79763;1089;255783;113835;1995;6253;3991;199699;284338;125965;11024;2854;54795;9476;126432;5673;23370;7639;6543;126433;126353;55786;284359;22859;140612;9757;163081;23403;10288;5989;6294;54922;1088;147741;7652;55620;56242;80714;284428;57731;7137;84215;57787;26291;125963;115653;7001;402665;7138;147837;6795;5886;9667;353355;116412;64926;29946;388533;4616;163126;390916;284348;945;2077;56344;282618;1548;26517;2014;23640;29924;2821;5675;54862;27036;90233;7565;317703;126295;6324;11100;90332;1032;23476;9266;6822;65249;4066;57126;2354;1175;163033;57030;81576;342926;79934;55150;3972;1082;28968;100507290;27134;284390;3817;6455;7694;1954;54815;255057;148003;81794;7675;8193;56915;8570;43847;100125288;91120;79173;79147;3383;730051;58509;10781;256051;90324;126074;92609;90075;80131;55957;199731;10036;495;1760;162966;7772;163115;284433;66002;147699;23770;57333;63946;645;57622;148229;2657;5184;339390;126069;284434;284383;3609;2116;79852;390928;148103;1406;112703;10365;51157;55337;84503;148113;79816;5676;390877;25888;8498;8993;728;90007;284307;113230;7596;93134;7538;57418;26017;342892;100130827;440515;23474;201516;147658;2528;51588;5032;3726;80032;79088;353088;26993;3643;57719;8175;163087;8189;54623;84839;284370;126393;57817;284371;4298;2865;8778;6597;126549;388567;55049;9518;5452;5178;53827;23526;94274;23025;55228;162993;1555;374928;148022;339324;390980;970;6528;90321;27180;9524;90378;57711;374875;11202;162968;2193;115703;25865;147645;147906;1786;284403;116541;9361;22983;56006;7768;284439;342865;91300;6415;163175;26085;5971;57662;65095;4902;80095;1158;170961;3816;79041;5864;112939;84106;23211;113091;64130;11045;147664;55095;80164;348303;81616;54760;6929;7386;90379;9622;2828;55009;55762;1762;125997;56949;4294;898;10212;55552;5582;90522;81926;5731;284353;84769;9424;79898;114783;115290;199675;54858;147660;147841;79002;126070;83855;84941;10523;4145;7695;80264;4858;55655;126520;51257;94059;163223;55621;83636;1891;5296;94039;126410;162989;90649;84765;5976;148213;441864;57106;5566;25759;8541;1675;58510;9138;79090;93650;11018;7693;7089;55094;26648;339318;79177;3249;587;2901;94115;5725;317701;342900;25789;125931;100129083;8605,1365
1,-1,19,260928,307812,46884,8612;54531,2
1,1,19,275925,1892275,1616350,566;51298;400668;374291;1943;54760;8612;26528;6929;1153;10347;55009;116444;5657;148223;1991;57455;91978;6209;399664;22904;284451;339366;81926;5064;27006;79948;23526;513;148229;10025;84939;2879;610;83855;126567;1265;126520;91304;997;53615;3004;10297;54531;91300;84634;92840;55658;10272;1820;25759;1675;90007;390874;6794;682;8174;255057;10975;57418;2593;5442;126353;5434;5725,65
1,-1,19,277373,291274,13901,8612,1
1,-1,19,277373,291274,13901,8612,1
1,-1,19,293260,314516,21256,54531,1
1,-1,19,405501,425585,20084,25759;126567,2
1,-1,19,474645,508220,33575,91978;8174;284451,3
1,-1,19,474645,509267,34622,91978;8174;284451,3
1,-1,19,548651,571351,22700,682;3004,2
1,-1,19,548651,579366,30715,682;3004,2
-1,1,19,786550,1297499,510949,566;22904;1675;1943;90007;1265;6794;91304;1153;255057;10347;57418;55009;116444;79948;23526;513;5657;5434;1991;91300;84634;5725;10025;2879;1820,26
-1,1,19,839492,995557,156065,1675;57418;5657;1991;91300;84634;10025;1820,8
1,-1,19,985898,1002665,16767,116444;57418,2
1,-1,19,1102683,1144296,41613,2879;22904,2
1,-1,19,1102683,1144296,41613,2879;22904,2
1,-1,19,1102683,1161675,58992,2879;22904,2
1,-1,19,1102683,1161675,58992,2879;22904,2
1,-1,19,1121303,1161675,40372,22904,1
1,-1,19,1228274,1282855,54581,55009;513;1153;90007;255057;6794,6
1,-1,19,1228274,1282855,54581,55009;513;1153;90007;255057;6794,6
1,-1,19,1228274,1282855,54581,55009;513;1153;90007;255057;6794,6
1,-1,19,1239074,1282855,43781,1153;55009;90007;513,4
-1,1,19,1549143,4288717,2739574,60680;55111;80032;58492;5605;6915;126306;51343;8175;645191;6929;55643;84839;148252;4782;23396;57455;166;126308;399664;113179;4946;2767;1938;8698;83475;100128569;4616;56961;81926;2788;374872;148229;23217;51690;148254;26517;6449;83855;51341;56926;4145;126321;1613;56928;9546;53615;113178;10362;84444;126295;116541;79816;2769;8943;360200;51548;84823;390874;27134;29985;170961;10975;7089;84699;1455;115196;284422;27231;268;2872;55702;10148;85300;7064;113177;51588;58509;126326,79
1,-1,19,1911809,1952590,40781,1455;113179;113178,3
-1,-1,19,1952590,2050814,98224,1455;55643;2872,3
-1,1,19,3338022,4833151,1495129,126259;51341;6915;100131094;5605;4145;126321;1613;51343;55620;9546;10362;84839;80700;10036;116541;4782;23396;91039;84954;79187;56005;51548;440503;1938;116844;10501;83475;27134;100128569;56961;6455;170961;55527;84699;284422;27231;729359;126282;84717;23217;10148;55702;85300;51588;58509;126326;148022,48
-1,1,19,3437994,4039215,601221,6915;1938;4145;126321;1613;83475;51343;27134;100128569;9546;10362;84839;284422;27231;116541;4782;23396;23217;85300;51588;58509;126326,22
1,-1,19,3767254,3771952,4698,84839;116541,2
1,-1,19,3767254,3771952,4698,84839;116541,2
1,-1,19,6870116,7103355,233239,79230;653656;653657;125997;2015;284428,6
1,-1,19,6916239,7103296,187057,79230;653656;653657;2015;125997;284428,6
1,-1,19,6916239,7103355,187116,79230;653656;653657;2015;125997;284428,6
1,-1,19,7989408,7990287,879,404217,1
1,-1,19,8143599,8373452,229853,79603;51293;84467,3
1,1,19,9678768,14853426,5174658,5989;117579;7087;54850;79973;976;439;81890;163059;811;9545;54811;7001;147837;90480;7620;6597;115948;57474;388507;5886;11140;3337;90589;105372280;51710;51073;54831;84449;162993;3949;2639;163049;4713;54862;10661;4125;163050;9524;90592;90378;25959;9294;51295;3386;199692;1777;2193;57572;84245;1786;55723;1032;22983;729747;65249;56342;5589;4066;5300;5585;81576;64748;5141;1725;4784;65095;9817;388512;284390;646457;57153;79883;7675;54;112939;26526;100125288;255809;29911;3383;79173;3385;163051;773;126074;9592;342977;55908;2057;78992;84337;30817;90379;374882;10224;53637;256126;10535;84261;10053;90594;7297;90576;10212;55552;126075;50509;10755;5731;8666;50700;7568;30000;147841;90580;79002;10498;112812;126070;126069;3609;1264;84971;1785;7695;51398;84292;55621;692312;59286;55337;9466;93145;57139;1995;115950;8677;5566;84658;126068;83854;199699;113230;93134;11018;83546;284391;125950;28974;342979;22859;5032;3726,154
-1,1,19,9846119,11338677,1492558,112812;3609;7087;54850;84971;1785;78992;81890;25959;9294;3386;692312;59286;53637;55337;57572;1786;1032;93145;56342;10053;6597;5300;5141;11140;7297;65095;83854;9817;11018;50509;8666;57153;51073;50700;125950;100125288;162993;255809;3949;3383;147841;90580;5032;3385;10498,46
1,1,19,10267082,11000364,733282,112812;5141;3609;7087;11140;7297;65095;84971;1785;9817;81890;11018;57153;9294;51073;3386;53637;1786;125950;1032;10053;100125288;255809;3383;3385;10498,26
-1,1,19,10286133,11040457,754324,112812;5141;3609;7087;11140;7297;65095;84971;1785;9817;78992;81890;11018;57153;9294;51073;3386;53637;1786;125950;1032;10053;100125288;255809;3383;90580;3385;10498,28
-1,1,19,10396803,13068208,2671405,7087;126074;79973;439;2057;78992;81890;84337;374882;10224;163059;811;53637;9545;256126;7001;10535;84261;10053;147837;90480;7620;6597;115948;90594;57474;388507;5886;11140;7297;90576;55552;90589;126075;105372280;51710;7568;54831;3949;2639;30000;147841;90580;163049;79002;10498;112812;126070;126069;3609;1264;10661;84971;1785;7695;4125;163050;51398;84292;90592;25959;199692;51295;3386;1777;2193;57572;1032;22983;729747;5589;57139;3385;64748;1995;5141;1725;115950;126068;65095;9817;11018;284390;83546;57153;284391;125950;54;26526;100125288;255809;29911;3383;55908;3726;163051,96
-1,1,19,10430150,13888674,3458524,773;126074;9592;79973;439;2057;78992;81890;84337;374882;10224;163059;811;53637;9545;256126;7001;10535;84261;10053;147837;90480;7620;6597;115948;90594;57474;388507;5886;11140;7297;90576;55552;90589;126075;105372280;51710;7568;54831;3949;2639;30000;147841;90580;163049;79002;10498;126070;126069;3609;1264;10661;84971;1785;7695;4125;163050;51398;84292;90592;25959;199692;51295;55621;1777;2193;57572;84245;1032;22983;729747;5589;4066;57139;81576;3385;64748;1995;5141;1725;115950;8677;4784;126068;65095;199699;9817;11018;284390;83546;57153;284391;125950;54;112939;26526;255809;28974;29911;55908;3726;163051,102
1,1,19,11338618,45129651,33791033,684;390940;1048;7711;976;5678;439;163227;93343;163059;1553;147719;374897;3718;126248;10331;653583;84902;404037;390927;148266;26658;728361;126402;57716;23581;54831;6511;10298;51276;91646;728485;10994;2639;7594;7766;51599;973;58513;374900;4125;9310;199692;115727;57615;8625;84245;112398;10780;284340;163255;84167;84079;7562;9441;8725;1054;3963;390892;1725;55201;147710;199786;5143;79047;22933;282616;7773;7769;1463;57794;126370;10430;933;126299;114770;388523;126526;2867;773;55588;126298;23646;10270;5671;374882;79935;653499;7770;282617;256126;29950;9253;80726;148109;80776;25796;51079;23094;5348;116115;23152;27076;4037;170959;3783;342897;79156;284406;26330;5670;55295;51398;6626;147929;9466;81;148014;9535;5669;5672;22835;57139;83983;115950;8677;11184;208;7305;64073;83546;7392;7171;23354;83639;376497;478;342979;147968;26065;163131;64763;23031;92285;7644;5050;58525;811;9545;51477;6183;100287226;27151;115948;284339;388507;3640;22847;55851;4207;101927572;3960;105372280;27335;126541;27033;57828;7040;440533;147923;163049;79086;4854;79709;1340;7733;10661;26538;90592;85360;55723;171392;79713;5349;729747;100130519;6829;7311;100170229;5585;93436;84924;4793;126364;643669;26659;90273;27106;26333;79939;388512;4868;79883;84911;558;10870;54;26526;56301;117286;55900;3780;29911;7638;9592;84807;2057;4099;7515;23373;730087;147991;147965;644096;284349;3727;9141;79036;84775;90594;55101;79171;6261;90576;4650;83878;284325;7767;126075;10755;170463;148198;2091;7568;79016;26539;55850;284459;284346;4680;85415;79414;1264;5680;84292;374899;826;54555;10147;81931;6223;29124;1089;113835;1995;126231;84658;9244;3991;199699;284338;79575;23149;147746;593;199746;1572;126432;5673;1084;7639;5704;126433;374887;22859;9757;163081;5989;53916;1088;79973;148268;7652;56242;80714;10567;57731;25804;284323;53345;100271849;7001;91442;147837;64981;7620;57474;5886;353355;3337;90589;26664;64926;29946;388533;163126;51710;390916;284348;2077;84449;282618;1548;8857;9745;1311;4713;2821;54862;5675;102724279;23383;23309;84063;56269;1777;6324;11100;57572;23476;65249;5589;4066;57126;5714;81576;4784;79934;284390;84964;1954;646457;54815;148003;1050;8193;3594;56915;148206;91120;79173;90324;199704;163051;126074;92609;342908;90075;55957;84337;30817;84518;284443;10224;199731;11136;495;84261;10775;1549;7772;163115;284433;126382;66002;23770;63946;645;57622;8529;2657;5184;30000;126069;284434;284402;2116;79852;390928;148103;64857;26532;8178;10365;9170;84503;57130;148113;5676;10054;7705;339327;7673;126068;113230;1346;7596;7538;284391;26017;342892;342898;641649;440515;23474;7757;342977;55908;10715;3726;117579;5438;353088;26993;57719;163087;8425;54623;25999;9534;126393;83483;388531;57817;2865;90480;8907;84705;126549;57834;199720;634;55049;2931;9518;83889;125972;5452;53827;94274;23025;100507527;126374;9002;1555;399473;339324;1178;7643;6528;163183;163050;9524;90378;57711;84306;51295;333;2193;115703;199777;64377;284403;22983;56006;7768;284439;342865;7771;79629;80271;163175;93323;10683;64748;57616;57655;199745;1155;7561;3191;729991;126375;126272;100129842;79041;5864;112939;115098;115861;11045;148137;11316;6217;342909;55095;26974;348303;53822;54938;388536;5329;92799;90379;7386;6142;10535;57677;9710;4051;4294;54929;374907;898;10212;55552;8190;51291;10437;90522;5731;100170765;84769;9424;1087;115290;9454;54858;93099;9149;79002;126070;4218;84941;10523;7695;80264;163223;55621;83636;5296;1891;94039;126410;162989;90649;29785;29086;5976;148213;10653;5566;56891;11283;58510;9138;100129543;2063;55094;25850;3249;339318;2901;79177;2864;28974;25789;125931;342900;92283,590
-1,1,19,11635978,14265833,2629855,5989;117579;773;9592;342977;79973;439;84337;90379;10224;163059;811;256126;7001;10535;84261;147837;90480;7620;90594;57474;388507;5886;90576;55552;90589;105372280;51710;7568;54831;2639;30000;163049;79002;54862;126070;126069;1264;10661;7695;4125;163050;51398;84292;90592;90378;199692;51295;55621;1777;2193;9466;55723;84245;22983;729747;65249;4066;81576;8677;5566;1725;4784;126068;199699;113230;284390;83546;646457;284391;79883;54;112939;28974;342979;29911;79173;22859;3726;163051,80
-1,1,19,12204632,13497073,1292441,773;9592;79973;10661;439;7695;4125;163050;51398;84292;10224;55621;1777;2193;811;256126;22983;7001;84261;10535;147837;4066;90480;57474;8677;1725;388507;5886;4784;90576;90589;199699;83546;105372280;51710;7568;112939;54831;79002;29911;30000;2639;163049;3726;163051,45
-1,1,19,12574343,14726197,2151854,5989;773;117579;9592;342977;976;439;90379;811;256126;10535;84261;7001;90480;57474;5886;3337;10212;10755;5731;105372280;54831;30000;2639;163049;4713;79002;54862;10661;4125;163050;51398;9524;84292;90378;55621;1777;2193;9466;55723;84245;22983;65249;4066;5585;81576;8677;5566;1725;4784;199699;388512;113230;83546;646457;79883;112939;28974;342979;29911;79173;22859;3726;163051,64
-1,1,19,12691241,14853485,2162244,5989;773;117579;9592;342977;976;439;30817;90379;811;256126;7001;84261;10535;90480;57474;5886;3337;10212;10755;5731;105372280;54831;84449;30000;2639;163049;4713;79002;54862;10661;4125;51398;9524;84292;90378;55621;1777;2193;9466;55723;84245;22983;65249;4066;5585;81576;8677;5566;1725;84658;4784;199699;388512;113230;83546;646457;79883;112939;28974;342979;29911;79173;22859;3726,65
1,-1,19,13006740,13007077,337,2639,1
1,-1,19,13006847,13007077,230,2639,1
-1,1,19,13085208,13519400,434192,8677;4784;773;9592;112939;199699;4066;55621,8
-1,1,19,13145480,13394500,249020,8677;4066;4784;773;9592;112939;55621,7
-1,1,19,13644739,15481900,1837161,5989;4854;117579;342977;976;9524;79852;30817;90379;90378;10270;85360;9466;55723;84245;23476;65249;5585;81576;390892;5566;84658;26659;3337;10212;26333;26658;26664;388512;113230;126402;10755;5731;646457;79883;23581;84449;6511;126370;28974;342979;79173;10994;22859;4713;54862,46
-1,1,19,14124666,16431349,2306683,4854;114770;4218;84941;117579;102724279;976;26993;9524;79852;30817;90378;10270;26538;26532;85360;58525;9466;55723;23476;126410;8907;5585;57834;390892;4051;5566;284433;84658;26659;11283;66002;3337;10212;26333;26658;26664;388512;113230;64926;126402;10755;5731;646457;8529;23581;126541;7171;26017;84449;6511;126370;117286;26539;342979;10994;22859;4713,58
-1,1,19,14265774,17025123,2759349,4854;114770;4218;284434;84941;58513;102724279;10523;976;26993;9524;79852;30817;10270;26538;26532;4713;23309;85360;58525;10365;23476;126410;84167;27151;8907;5585;57834;9441;390892;4051;284433;84658;26659;11283;66002;3337;10212;26333;26658;26664;79939;388512;64926;126402;125972;10755;5731;8529;23581;126541;7171;26017;79041;84449;6511;126370;117286;9002;26539;10994;22859;79086,63
-1,1,19,14883158,16788770,1905612,4854;114770;4218;84941;58513;102724279;10523;26993;79852;30817;10270;26538;26532;85360;58525;10365;23476;126410;84167;8907;9441;57834;390892;4051;284433;26659;11283;66002;26658;26333;26664;79939;64926;126402;125972;8529;23581;126541;7171;26017;79041;6511;126370;117286;26539;10994;79086,47
1,1,19,15244405,24376393,9131988,684;23031;26993;353088;57719;163227;7652;56242;80714;7644;93343;9534;58525;25804;51477;53345;100271849;83483;100287226;3718;64981;27151;8907;84705;126549;57834;10331;404037;3640;55049;4207;64926;9518;125972;126541;23025;9002;7594;1311;79086;4854;58513;79709;7643;102724279;6528;23383;26538;23309;57615;8625;171392;199777;23476;84167;100130519;284439;79629;7562;7311;93323;9441;93436;126364;55201;199786;5143;27106;79939;7561;54815;729991;100129842;79041;5864;3594;1463;115098;57794;148206;117286;115861;3780;91120;11316;114770;388523;10270;23373;284443;730087;6142;3727;80726;79036;4051;25796;54929;51079;284433;126382;66002;4650;83878;51291;10437;23770;170463;148198;8529;84769;9454;54858;2657;170959;79016;26539;55850;4218;284434;84941;10523;55295;80264;79852;26532;8178;163223;10365;9170;5296;54555;10147;57130;81931;148113;94039;126410;90649;29086;5976;148213;113835;83983;9244;11283;79575;23149;100129543;2063;7171;7639;26017;376497;440515;374887;25789;7757;10715,159
1,-1,19,15803290,15824046,20756,66002,1
-1,-1,19,17003240,17037020,33780,9002;27151,2
1,-1,19,18304742,18311144,6402,84769;5864,2
1,-1,19,20278152,20308753,30601,90649,1
-1,-1,19,20385317,20484861,99544,,0
-1,-1,19,20630766,20682607,51841,,0
-1,-1,19,20641426,20718976,77550,,0
1,-1,19,20830072,20946600,116528,199777,1
1,-1,19,20830072,20946600,116528,199777,1
1,-1,19,20830072,20946600,116528,199777,1
1,-1,19,20830072,20946600,116528,199777,1
1,-1,19,20830072,20946600,116528,199777,1
1,-1,19,20830072,20946600,116528,199777,1
1,-1,19,20830072,20946600,116528,199777,1
1,-1,19,20830072,21001149,171077,199777,1
1,-1,19,21774679,22985475,1210796,7594;100287226;148198;163227;7652;7757;163223;113835;57615,9
1,-1,19,21774679,23013344,1238665,7594;100287226;148198;163227;7652;7757;163223;113835;57615,9
-1,-1,19,22253865,22301793,47928,113835,1
-1,-1,19,22253865,22301793,47928,113835,1
1,-1,19,22396734,22444256,47522,,0
-1,-1,19,23624528,24311535,687007,148213;9534;171392;730087,4
-1,-1,19,23624807,24043127,418320,148213;171392,2
1,-1,19,28272497,28483449,210952,,0
1,-1,19,28290018,28330525,40507,,0
1,-1,19,28408804,28512197,103393,,0
-1,-1,19,29140834,29531957,391123,,0
-1,1,19,30152765,38605363,8452598,26065;5438;148268;92285;163087;25999;126393;388531;57817;2865;91442;374897;126248;84902;390927;148266;22847;55851;728361;101927572;83889;388533;390916;53827;27033;126374;100507527;147923;51276;91646;728485;9745;2821;339324;51599;1340;374900;163183;57711;84306;84063;333;6324;115703;64377;284403;79713;5349;163255;84079;163175;84924;8725;1054;57616;57655;199745;1155;79047;163081;84964;126375;4868;84911;1050;10870;10430;56301;55900;11045;148137;933;199704;2867;53822;84807;4099;388536;90075;55957;147991;644096;11136;92283;495;57677;9141;9710;148109;84775;79171;163115;898;23094;5348;93099;4037;284459;5184;79156;284406;26330;85415;284402;79414;2116;148103;374899;83636;147929;826;84503;10054;7705;22835;126231;7305;58510;1346;199746;55094;7392;23354;3249;339318;25850;342892;2864;9757,129
-1,1,19,30162231,38393630,8231399,26065;5438;148268;92285;163087;25999;126393;388531;57817;2865;91442;374897;126248;84902;390927;148266;22847;55851;728361;101927572;83889;388533;390916;53827;27033;126374;100507527;147923;51276;91646;728485;9745;2821;339324;51599;1340;374900;163183;57711;84306;84063;333;6324;115703;64377;284403;79713;5349;163255;84079;163175;84924;8725;1054;57616;57655;199745;1155;79047;9757;84964;126375;4868;84911;1050;10870;10430;56301;55900;11045;148137;933;199704;2867;53822;84807;4099;388536;90075;55957;147991;644096;11136;92283;495;57677;9141;9710;148109;84775;79171;163115;898;5348;93099;4037;284459;5184;79156;284406;26330;85415;284402;79414;2116;148103;374899;83636;147929;826;84503;10054;7705;22835;126231;7305;58510;1346;199746;55094;7392;23354;3249;339318;25850;342892;2864;163081,128
1,1,19,30735448,36120396,5384948,26065;51599;85415;26330;2867;284402;53822;4099;90075;148103;84306;6324;147991;64377;388531;11136;57817;5349;2865;91442;10054;9141;374897;495;84079;9710;163175;148109;126248;1054;57616;79171;84902;57655;22847;79047;388533;5348;390916;55094;126375;53827;7392;3249;1050;339318;23354;2864;126374;100507527;93099;4037;56301;10430;55900;91646;5184;9745;933;2821,60
1,-1,19,31087430,31784588,697158,57616,1
-1,1,19,31858259,35908000,4049741,26065;51599;85415;284402;53822;4099;90075;148103;84306;6324;147991;64377;388531;11136;57817;5349;2865;91442;10054;9141;84079;9710;163175;148109;126248;1054;84902;57655;22847;79047;5348;390916;55094;126375;53827;7392;3249;1050;339318;2864;126374;100507527;4037;56301;55900;91646;5184;933;2821,49
1,-1,19,34366153,34688730,322577,26065,1
1,-1,19,37130813,37342652,211839,163081;342892;728485;25850;92283;388536,6
1,-1,19,39262641,39281318,18677,653499;3963,2
1,-1,19,39262641,39281318,18677,653499;3963,2
1,-1,19,39262641,39281318,18677,653499;3963,2
1,-1,19,39262641,39281318,18677,653499;3963,2
1,-1,19,41350886,41381485,30599,1548;1549,2
-1,-1,19,41448821,41510949,62128,1555,1
-1,-1,19,41448821,41510949,62128,1555,1
-1,-1,19,41448821,41510949,62128,1555,1
-1,-1,19,41450201,41512853,62652,1555,1
1,-1,19,43200136,43709209,509073,5670;440533;5676;5680;5669;5671;5672;5673;5675,9
1,-1,19,43200136,43709209,509073,5670;440533;5676;5680;5669;5671;5672;5673;5675,9
1,-1,19,43200136,43772170,572034,5670;440533;5676;5678;5680;5669;5671;5672;5673;5675,10
-1,-1,19,43214850,43709209,494359,5670;440533;5676;5680;5669;5671;5672;5673;5675,9
-1,-1,19,43214850,43709209,494359,5670;440533;5676;5680;5669;5671;5672;5673;5675,9
1,-1,19,43214850,43746146,531296,5670;440533;5676;5680;5669;5671;5672;5673;5675,9
-1,-1,19,43214850,43746146,531296,5670;440533;5676;5680;5669;5671;5672;5673;5675,9
-1,-1,19,43214850,43746146,531296,5670;440533;5676;5680;5669;5671;5672;5673;5675,9
1,-1,19,43214850,43746146,531296,5670;440533;5676;5680;5669;5671;5672;5673;5675,9
1,-1,19,43214850,43772170,557320,5670;440533;5676;5678;5680;5669;5671;5672;5673;5675,10
1,-1,19,43214850,43772170,557320,5670;440533;5676;5678;5680;5669;5671;5672;5673;5675,10
1,-1,19,43214850,43772170,557320,5670;440533;5676;5678;5680;5669;5671;5672;5673;5675,10
-1,-1,19,43214850,43772170,557320,5670;440533;5676;5678;5680;5669;5671;5672;5673;5675,10
-1,-1,19,43214850,43772170,557320,5670;440533;5676;5678;5680;5669;5671;5672;5673;5675,10
1,-1,19,43214850,43772170,557320,5670;440533;5676;5678;5680;5669;5671;5672;5673;5675,10
1,-1,19,43214850,43772170,557320,5670;440533;5676;5678;5680;5669;5671;5672;5673;5675,10
1,-1,19,43214850,43772170,557320,5670;440533;5676;5678;5680;5669;5671;5672;5673;5675,10
1,-1,19,43214850,43772170,557320,5670;440533;5676;5678;5680;5669;5671;5672;5673;5675,10
-1,-1,19,43214850,43772170,557320,5670;440533;5676;5678;5680;5669;5671;5672;5673;5675,10
1,-1,19,43214850,43772170,557320,5670;440533;5676;5678;5680;5669;5671;5672;5673;5675,10
1,-1,19,43214850,43772170,557320,5670;440533;5676;5678;5680;5669;5671;5672;5673;5675,10
1,-1,19,43214850,43772170,557320,5670;440533;5676;5678;5680;5669;5671;5672;5673;5675,10
1,-1,19,43214850,43772170,557320,5670;440533;5676;5678;5680;5669;5671;5672;5673;5675,10
-1,-1,19,43214850,43772170,557320,5670;440533;5676;5678;5680;5669;5671;5672;5673;5675,10
1,-1,19,43214850,43772170,557320,5670;440533;5676;5678;5680;5669;5671;5672;5673;5675,10
1,-1,19,43214850,43772170,557320,5670;440533;5676;5678;5680;5669;5671;5672;5673;5675,10
1,-1,19,43214850,43772170,557320,5670;440533;5676;5678;5680;5669;5671;5672;5673;5675,10
1,-1,19,43214850,43772170,557320,5670;440533;5676;5678;5680;5669;5671;5672;5673;5675,10
1,-1,19,43214850,43772170,557320,5670;440533;5676;5678;5680;5669;5671;5672;5673;5675,10
1,-1,19,43214850,43772170,557320,5670;440533;5676;5678;5680;5669;5671;5672;5673;5675,10
-1,-1,19,43214850,43772170,557320,5670;440533;5676;5678;5680;5669;5671;5672;5673;5675,10
1,-1,19,43214850,43820878,606028,5670;440533;5676;5678;5680;5669;5671;5672;5673;5675,10
1,-1,19,43214850,43820878,606028,5670;440533;5676;5678;5680;5669;5671;5672;5673;5675,10
1,-1,19,43214850,43820878,606028,5670;440533;5676;5678;5680;5669;5671;5672;5673;5675,10
1,-1,19,43214850,43820878,606028,5670;440533;5676;5678;5680;5669;5671;5672;5673;5675,10
1,-1,19,43242595,43530001,287406,440533;5669;5671;5675;5676;5680,6
-1,-1,19,43242795,43741310,498515,5670;440533;5676;5680;5669;5671;5672;5673;5675,9
1,-1,19,43242795,43741310,498515,5670;440533;5676;5680;5669;5671;5672;5673;5675,9
-1,-1,19,43242811,43529887,287076,440533;5669;5671;5675;5676;5680,6
-1,-1,19,43242811,43741714,498903,5670;440533;5676;5680;5669;5671;5672;5673;5675,9
-1,-1,19,43316938,43530666,213728,5676;5680;5669;5675,4
-1,-1,19,43316938,43530666,213728,5676;5680;5669;5675,4
-1,-1,19,43316938,43530666,213728,5676;5680;5669;5675,4
-1,-1,19,43316938,43530666,213728,5676;5680;5669;5675,4
-1,-1,19,43316938,43530666,213728,5676;5680;5669;5675,4
-1,-1,19,43316938,43530666,213728,5676;5680;5669;5675,4
-1,-1,19,43354259,43645608,291349,5670;5669;5675;5676;5680,5
-1,-1,19,43354259,43645608,291349,5670;5669;5675;5676;5680,5
-1,-1,19,43354259,43741310,387051,5670;5669;5675;5672;5676;5673;5680,7
-1,-1,19,43442934,43772170,329236,5670;5672;5678;5673;5680,5
-1,-1,19,43514125,43746146,232021,5672;5670;5673;5680,4
-1,-1,19,43514125,43746146,232021,5672;5670;5673;5680,4
1,-1,19,43529801,43741310,211509,5672;5670;5673;5680,4
1,-1,19,43529801,43741310,211509,5672;5670;5673;5680,4
-1,-1,19,43564107,43842435,278328,5672;5670;5678;5673,4
-1,-1,19,43690000,43757736,67736,5672;5678;5673,3
-1,-1,19,43691306,43746118,54812,5672,1
-1,-1,19,43691306,43757736,66430,5672;5678,2
-1,-1,19,43708962,43757736,48774,5672;5678,2
-1,-1,19,45351707,45385809,34102,5819,1
-1,-1,19,45351707,45385809,34102,5819,1
1,1,19,45474677,48760659,3285982,6633;147920;8189;27202;147700;2828;27113;26093;84215;57787;162979;1762;11129;1760;808;81492;2068;100506012;29998;10848;5739;147699;4861;339344;10849;30846;64344;284353;9704;147912;24139;374918;64100;3171;55228;56344;8775;100131137;388555;284352;374920;3978;57469;4858;5536;80207;284355;1406;729440;147906;25865;54958;444882;56917;90332;6822;388553;11133;6415;26145;2354;1175;79760;22900;255783;8993;728;5971;6253;1209;54814;2909;2067;10055;2696;79090;29997;1158;7408;6543;388552;29888;23211;339345;79147;94235;83987;6510;23403;8605,90
1,-1,19,46713522,46721782,8260,,0
1,-1,19,46713522,46721782,8260,,0
1,-1,19,48807201,48846153,38952,2014;93233;55260,3
1,-1,19,49030319,49114045,83726,54854;6820;171169,3
-1,-1,19,49185469,49206253,20784,2524,1
1,-1,19,49519850,49558959,39109,94027;114335;94115;93659;114336;1082;3972,7
1,-1,19,49535281,49540108,4827,114335;114336,2
1,-1,19,50126530,50250620,124090,60385;3276;199800;58506;126129;83596;6237;57479;3661,9
1,1,19,50489390,59095359,8605969,84798;2204;9437;342931;388566;7710;27338;342933;388561;10782;114823;147807;23547;10155;400720;7137;729767;2359;115653;10859;402665;125893;400713;7376;54776;7138;57343;147687;3904;6795;1;79818;116412;55659;126206;81856;51206;4696;147657;57191;11025;945;9040;29903;255043;23640;29924;25818;100293516;55554;27036;90333;90233;89887;284415;7565;26121;126119;317703;147694;147686;147798;4606;50944;79042;163033;10172;342926;354;91661;84671;100507290;54807;126204;3817;284369;7694;91664;54869;43847;6689;65251;3982;79165;55311;256051;730051;6320;3811;3748;125919;284366;5518;162963;201514;284297;162966;11027;85569;5653;65982;90317;284312;7691;7576;147685;4818;84446;554235;4849;90338;55663;7728;22870;3802;147949;125875;126208;388558;112703;100529240;51157;946;342918;84787;25888;112724;140612;3804;27300;162972;204801;55422;27181;284307;284418;11006;2109;100130827;3589;201516;147650;147658;148170;284417;79143;2357;79891;84258;503835;503834;94030;284370;6158;284371;57663;729974;8778;388567;3812;5424;5655;23619;147744;5178;7554;59284;147808;59283;58491;147945;90353;126017;374928;199713;390980;348327;79149;112401;27180;90321;162967;9668;162962;646862;11202;162968;10990;147645;59348;6861;26085;126205;9422;10794;79744;51545;80095;43849;84878;3809;89858;3816;25799;114026;147664;388564;79784;126123;9622;284309;84922;29844;27243;7593;91662;342945;5650;57348;55762;6203;352909;646643;388569;2358;5794;5582;338321;10998;55769;147948;90485;10520;79898;147660;11012;59285;80110;3805;84914;729956;55655;388559;6193;100049587;94059;11338;91663;170958;89790;3036;84436;79788;79763;84765;284361;441864;126014;3903;57106;147670;284306;125965;147646;11024;2854;9476;63934;57573;7693;51231;100271846;55786;317701;93650;79673;100129083;10288,278
1,1,19,50655777,59092570,8436793,84798;2204;9437;342931;388566;7710;27338;342933;388561;10782;114823;147807;23547;10155;400720;7137;729767;2359;115653;10859;402665;125893;400713;7376;54776;7138;57343;147687;3904;6795;1;79818;116412;55659;126206;81856;51206;4696;147657;57191;11025;945;9040;29903;255043;23640;29924;25818;100293516;55554;27036;90333;90233;89887;284415;7565;26121;126119;317703;147694;147686;147798;4606;50944;79042;163033;10172;342926;354;91661;84671;100507290;54807;126204;3817;284369;7694;91664;54869;43847;6689;65251;3982;79165;55311;256051;730051;6320;3811;3748;125919;284366;5518;162963;201514;284297;162966;11027;85569;5653;65982;90317;284312;7691;7576;147685;4818;84446;554235;4849;90338;55663;7728;22870;3802;147949;125875;126208;388558;112703;100529240;51157;946;342918;84787;112724;140612;3804;27300;162972;204801;55422;27181;284307;284418;11006;2109;100130827;3589;201516;147650;147658;148170;284417;79143;2357;79891;84258;503835;503834;94030;284370;6158;284371;57663;729974;8778;388567;3812;5424;5655;23619;147744;5178;7554;59284;147808;59283;58491;147945;90353;126017;374928;199713;390980;348327;79149;112401;27180;90321;162967;9668;162962;646862;11202;162968;10990;147645;59348;6861;26085;126205;9422;10794;79744;51545;80095;43849;84878;3809;89858;3816;25799;114026;147664;388564;79784;126123;9622;284309;84922;29844;27243;7593;91662;342945;5650;57348;55762;6203;352909;646643;388569;2358;5794;5582;338321;10998;55769;147948;90485;10520;79898;147660;11012;59285;80110;3805;84914;729956;55655;388559;6193;100049587;94059;11338;91663;170958;89790;3036;84436;79788;79763;84765;284361;441864;126014;3903;57106;147670;284306;125965;147646;11024;2854;9476;63934;57573;7693;100271846;55786;317701;93650;79673;100129083;10288,276
1,-1,19,52224551,52328897,104346,3036;2359;2358;2357,4
1,-1,19,52272356,52627403,355047,80110;284370;2358;2359;79898;284371;90317;59348;9668;84765;65251,11
1,-1,19,52368797,52616696,247899,80110;284370;79898;284371;90317;59348;9668;84765;65251,9
1,1,19,52647126,58956888,6309762,79143;2204;9437;342931;388566;7710;503835;79891;27338;342933;503834;388561;10782;114823;147807;23547;400720;7137;6158;115653;10859;729974;57663;125893;7138;400713;54776;57343;147687;3904;388567;6795;1;3812;79818;23619;116412;55659;126206;81856;51206;4696;147657;147744;5178;57191;11025;7554;59284;147808;29903;59283;255043;147945;58491;126017;23640;199713;29924;374928;100293516;390980;348327;79149;112401;90333;90233;89887;90321;284415;162967;7565;26121;162962;646862;162968;317703;10990;147694;79673;147686;147798;6861;79042;163033;10172;342926;126205;91661;9422;84671;10794;100507290;79744;54807;51545;80095;126204;7694;3809;91664;54869;114026;147664;79165;55311;730051;256051;388564;3811;284309;125919;84922;29844;91662;342945;57348;5518;55762;6203;162963;201514;284297;162966;11027;352909;646643;85569;65982;5794;5582;338321;55769;147948;90485;284312;7691;7576;147685;10520;84446;147660;59285;4849;90338;3805;84914;729956;22870;3802;147949;55655;388559;6193;126208;388558;94059;100529240;11338;51157;91663;170958;84436;79788;84787;79763;441864;126014;3903;112724;57106;3804;147670;27300;162972;284306;204801;55422;284307;125965;11024;284418;63934;57573;11006;7693;100130827;100271846;3589;201516;55786;147658;148170;317701;140612;10288;284417,197
-1,-1,19,52798800,52890248,91448,147657;400713;162963,3
1,1,19,53115685,59092570,5976885,79143;2204;9437;342931;388566;7710;503835;79891;27338;342933;503834;388561;10782;114823;147807;23547;10155;400720;7137;6158;115653;10859;729974;57663;125893;7138;57343;54776;147687;3904;388567;6795;1;3812;79818;23619;116412;55659;126206;81856;51206;4696;147744;5178;57191;11025;7554;59284;147808;9040;29903;59283;255043;147945;58491;126017;23640;199713;29924;374928;100293516;390980;348327;79149;112401;90333;90233;89887;284415;7565;162967;26121;646862;162968;317703;10990;147694;147686;147798;6861;79042;163033;10172;342926;126205;91661;9422;84671;10794;100507290;79744;54807;51545;80095;126204;84878;7694;3809;91664;54869;25799;114026;147664;79165;55311;730051;256051;388564;3811;284309;125919;84922;29844;27243;7593;91662;342945;57348;6203;201514;284297;162966;11027;352909;646643;85569;388569;65982;5794;5582;338321;10998;55769;90485;147948;284312;7691;7576;147685;10520;84446;59285;4849;90338;3805;84914;55663;729956;22870;3802;147949;55655;388559;6193;126208;94059;100529240;11338;51157;91663;170958;79788;84787;79763;441864;126014;3903;112724;57106;3804;147670;27300;162972;140612;284306;204801;55422;284307;125965;11024;284418;63934;57573;11006;7693;100130827;100271846;3589;201516;55786;148170;317701;79673;10288;284417,195
1,-1,19,53328041,53352600,24559,90333,1
1,1,19,53458309,59092570,5634261,79143;2204;9437;342931;388566;7710;503835;79891;27338;342933;503834;388561;10782;114823;147807;23547;10155;400720;7137;6158;115653;10859;729974;57663;125893;7138;57343;54776;147687;3904;388567;6795;1;3812;79818;23619;116412;55659;126206;51206;4696;147744;5178;57191;11025;7554;59284;147808;9040;29903;59283;255043;147945;58491;126017;23640;199713;29924;374928;100293516;390980;348327;79149;112401;90233;89887;284415;7565;26121;646862;162968;317703;10990;147694;147686;147798;6861;79042;163033;10172;342926;126205;91661;9422;84671;10794;100507290;79744;54807;51545;80095;126204;84878;7694;3809;91664;54869;25799;114026;147664;79165;55311;730051;256051;388564;3811;284309;125919;84922;29844;27243;7593;91662;342945;57348;6203;201514;284297;11027;352909;646643;85569;388569;65982;5794;5582;338321;10998;90485;147948;284312;7691;147685;10520;84446;59285;4849;90338;3805;84914;55663;729956;22870;3802;147949;55655;6193;126208;94059;100529240;11338;51157;91663;170958;79788;84787;79763;441864;126014;3903;112724;57106;3804;147670;27300;162972;140612;284306;204801;55422;284307;125965;11024;284418;63934;57573;11006;7693;100130827;100271846;3589;201516;55786;148170;317701;79673;10288;284417,188
1,-1,19,53606604,53636067,29463,90338;55786,2
1,-1,19,53606604,53636067,29463,90338;55786,2
1,1,19,54344821,58956888,4612067,79143;2204;9437;342931;388566;7710;503835;79891;27338;342933;10782;114823;147807;23547;400720;7137;6158;115653;10859;729974;57663;7138;57343;54776;147687;3904;388567;6795;1;3812;79818;23619;116412;55659;126206;51206;4696;147744;5178;57191;11025;7554;59284;147808;29903;59283;255043;147945;58491;23640;199713;29924;374928;100293516;390980;348327;79149;90233;89887;284415;7565;26121;646862;162968;79673;10990;147694;147686;147798;6861;79042;163033;10172;126205;9422;10794;100507290;79744;54807;51545;80095;126204;7694;3809;54869;114026;55311;79165;730051;256051;388564;3811;284309;125919;84922;29844;342945;57348;6203;201514;284297;11027;352909;646643;85569;65982;5794;5582;338321;90485;147948;284312;7691;147685;10520;84446;59285;4849;3805;84914;729956;22870;3802;147949;55655;6193;126208;94059;11338;51157;91663;84787;79763;441864;126014;3903;112724;57106;3804;147670;27300;162972;284306;204801;284307;125965;11024;284418;63934;57573;11006;7693;100130827;3589;201516;148170;140612;10288;284417,159
-1,-1,19,54726783,54744331,17548,11025,1
1,-1,19,54726783,54746032,19249,11025,1
1,-1,19,54726783,54746032,19249,11025,1
1,-1,19,54726783,54746032,19249,11025,1
-1,-1,19,54726783,54746032,19249,11025,1
-1,-1,19,54726783,54746032,19249,11025,1
1,-1,19,54726783,54746032,19249,11025,1
1,-1,19,54726783,54844690,117907,11025;10990;23547;10288,4
1,-1,19,54726783,54844690,117907,11025;10990;23547;10288,4
1,-1,19,54769799,54835745,65946,10288,1
-1,-1,19,55028722,55148430,119708,11027;11024;10859,3
-1,-1,19,55116560,55164779,48219,10859,1
1,-1,19,55148430,55176347,27917,11006;10859,2
-1,-1,19,55148430,55176347,27917,11006;10859,2
1,-1,19,55587736,55602281,14545,54776;54869,2
1,-1,19,57966534,57968833,2299,57191,1
1,-1,19,57988849,58015974,27125,400720;374928;79744,3
1,-1,19,57988849,58015974,27125,400720;374928;79744,3
1,-1,19,57988849,58015974,27125,400720;374928;79744,3
1,-1,19,57988849,58015974,27125,400720;374928;79744,3
1,-1,19,58336963,58362366,25403,100293516;84914,2
1,-1,19,58336963,58362366,25403,100293516;84914,2
1,-1,19,59060208,59092570,32362,10155;9040;27243;7593,4
1,-1,19,59060208,59092570,32362,10155;9040;27243;7593,4
1,-1,20,60734,108266,47532,245938,1
-1,1,20,60734,1227410,1166676,140680;245938;10616;1457;343637;57761;83541;55321;140850;245939;85508;85364;9491;128637;6939;400831;81623;642636;140881;51378;400830;140809;113278;6666;80023,25
1,1,20,60734,6366659,6305925,140680;57593;10616;1457;54498;57761;10326;140850;5786;80332;9762;64773;84515;551;5621;9751;5020;113278;343641;117532;56265;146;245938;1059;8760;343637;51605;6628;11237;9770;388780;85508;3704;64601;64096;9491;128637;83959;54976;400830;140809;80023;56261;116835;128646;64949;80025;9962;149840;55317;83541;55968;128653;55321;55612;10528;81623;23627;140881;51378;8455;54675;22888;29058;7053;164312;140885;128674;2797;60493;245939;6614;85364;3420;25876;1114;5173;65992;400831;6939;2280;25943;5111;642636;57506;140901;55423;100288797;284759;6666;27111;79175;994,93
1,-1,20,60747,151608,90861,245938;81623;140850,3
1,1,20,60747,13010049,12949302,140680;57593;10616;1457;54498;57761;10326;140850;5786;80332;9762;64773;22903;84515;551;5621;9751;23236;5020;113278;343641;117532;56265;146;245938;1059;8760;343637;51605;6628;63926;8195;11237;9770;5332;388780;85508;3704;64601;64096;9491;128637;83959;54976;650;182;400830;57144;140809;80023;56261;116835;128646;64949;80025;9962;149840;55317;83541;55968;24141;128653;55321;55612;56255;6616;55304;54363;10528;81623;23627;140881;51378;8455;54675;22888;29058;7053;164312;140885;128674;2797;60493;245939;6614;85364;3420;25876;1114;5173;65992;128710;400831;6939;2280;25943;5111;642636;57506;140901;55423;100288797;284759;6666;27111;79175;994,107
1,1,20,60747,29462103,29401356,57761;10326;3642;140850;5786;63908;6754;9762;100303755;551;5621;64412;9751;23236;1469;343641;146;5075;245938;8760;57325;63926;631;5332;388780;29107;1473;100128496;54453;128637;23767;54976;650;57144;140809;79953;57136;128821;128646;64949;5834;80343;22981;55317;83541;55968;7692;10741;128653;55321;55612;56255;6616;55614;55304;55617;56914;5126;54363;4821;81623;140881;55184;140856;10047;22888;29058;51340;140885;22803;60493;245939;85364;3420;22918;1114;140862;1472;55857;65992;128710;6939;57186;2280;25943;92675;27111;994;92086;140733;140680;57593;10616;51126;8530;1457;54498;1470;80332;64773;26074;26152;22903;7056;84515;5020;113278;644524;140836;117532;56265;1059;343637;51605;6628;8195;11237;9770;85508;3704;64601;64096;9491;83959;955;92667;182;400830;80023;56261;116835;6629;80025;9962;149840;26090;140838;1471;24141;140880;10528;23627;30813;51378;6238;8455;54675;11034;9837;7053;57419;164312;3170;128674;2797;10483;6614;25876;27131;5173;128822;400831;58495;5111;79133;642636;57506;140901;10621;55423;100288797;284759;84532;6666;79175;51575;128817,177
-1,1,20,61568,431502,369934,245938;140680;10616;128637;81623;57761;140881;140850;400830;245939;6666;85364;80023,13
-1,1,20,61568,1513319,1451751,140680;245938;10616;1457;343637;57761;83541;55968;55321;140850;245939;85508;85364;9491;128637;6939;400831;2280;81623;642636;140881;51378;9751;400830;113278;140809;284759;6666;27111;80023,30
-1,1,20,61568,1823540,1761972,140680;10616;1457;57761;83541;55968;10326;55321;140850;81623;140881;51378;9751;113278;245938;343637;245939;85508;85364;9491;128637;6939;400831;2280;642636;400830;55423;140809;284759;6666;27111;80023;128646,33
1,1,20,61568,4904599,4843031,140680;57593;10616;1457;54498;57761;10326;140850;5786;80332;9762;64773;551;5621;9751;5020;113278;343641;117532;56265;146;245938;1059;343637;6628;11237;9770;388780;85508;3704;64601;64096;9491;128637;83959;54976;400830;140809;80023;116835;128646;64949;80025;9962;55317;83541;55968;128653;55321;10528;81623;23627;140881;51378;8455;22888;7053;140885;2797;60493;245939;6614;85364;3420;25876;5173;65992;400831;6939;2280;25943;642636;57506;140901;55423;100288797;284759;6666;27111;79175;994,81
1,1,20,61568,4914872,4853304,140680;57593;10616;1457;54498;57761;10326;140850;5786;80332;9762;64773;551;5621;9751;5020;113278;343641;117532;56265;146;245938;1059;343637;6628;11237;9770;388780;85508;3704;64601;64096;9491;128637;83959;54976;400830;140809;80023;116835;128646;64949;80025;9962;55317;83541;55968;128653;55321;10528;81623;23627;140881;51378;8455;22888;7053;140885;2797;60493;245939;6614;85364;3420;25876;5173;65992;400831;6939;2280;25943;642636;57506;140901;55423;100288797;284759;6666;27111;79175;994,81
1,1,20,61568,26305479,26243911,57761;10326;3642;140850;5786;63908;6754;9762;100303755;551;5621;64412;9751;23236;1469;343641;146;5075;245938;8760;57325;63926;631;5332;388780;29107;1473;100128496;54453;128637;23767;54976;650;57144;140809;79953;57136;128821;128646;64949;5834;80343;22981;55317;83541;55968;7692;10741;128653;55321;55612;56255;6616;55614;55304;55617;56914;5126;54363;4821;81623;140881;55184;140856;10047;22888;29058;51340;140885;22803;60493;245939;85364;3420;22918;1114;140862;1472;55857;65992;128710;6939;57186;2280;25943;92675;27111;994;92086;140733;140680;57593;10616;51126;8530;1457;54498;1470;80332;64773;26074;26152;22903;7056;84515;5020;113278;644524;140836;117532;56265;1059;343637;51605;6628;8195;11237;9770;85508;3704;64601;64096;9491;83959;955;92667;182;400830;80023;56261;116835;6629;80025;9962;149840;26090;140838;1471;24141;140880;10528;23627;30813;51378;6238;8455;54675;11034;9837;7053;57419;164312;3170;128674;2797;10483;6614;25876;27131;5173;128822;400831;58495;5111;79133;642636;57506;140901;10621;55423;100288797;284759;84532;6666;79175;51575;128817,177
1,1,20,61568,26305479,26243911,57761;10326;3642;140850;5786;63908;6754;9762;100303755;551;5621;64412;9751;23236;1469;343641;146;5075;245938;8760;57325;63926;631;5332;388780;29107;1473;100128496;54453;128637;23767;54976;650;57144;140809;79953;57136;128821;128646;64949;5834;80343;22981;55317;83541;55968;7692;10741;128653;55321;55612;56255;6616;55614;55304;55617;56914;5126;54363;4821;81623;140881;55184;140856;10047;22888;29058;51340;140885;22803;60493;245939;85364;3420;22918;1114;140862;1472;55857;65992;128710;6939;57186;2280;25943;92675;27111;994;92086;140733;140680;57593;10616;51126;8530;1457;54498;1470;80332;64773;26074;26152;22903;7056;84515;5020;113278;644524;140836;117532;56265;1059;343637;51605;6628;8195;11237;9770;85508;3704;64601;64096;9491;83959;955;92667;182;400830;80023;56261;116835;6629;80025;9962;149840;26090;140838;1471;24141;140880;10528;23627;30813;51378;6238;8455;54675;11034;9837;7053;57419;164312;3170;128674;2797;10483;6614;25876;27131;5173;128822;400831;58495;5111;79133;642636;57506;140901;10621;55423;100288797;284759;84532;6666;79175;51575;128817,177
1,1,20,61569,18668675,18607106,57761;10326;140850;5786;9762;100303755;551;5621;9751;23236;343641;146;245938;8760;57325;63926;631;5332;388780;128637;23767;54976;650;57144;140809;128646;64949;80343;55317;83541;55968;7692;10741;128653;55321;55612;56255;6616;55614;55304;55617;56914;5126;54363;81623;140881;55184;22888;29058;140885;60493;245939;85364;3420;1114;140862;65992;128710;6939;2280;25943;92675;27111;994;140733;140680;57593;10616;1457;54498;80332;64773;22903;84515;5020;113278;140836;117532;56265;1059;343637;51605;6628;8195;11237;9770;85508;3704;64601;64096;9491;83959;92667;182;400830;80023;56261;116835;6629;80025;9962;149840;24141;10528;23627;51378;6238;8455;54675;11034;7053;164312;128674;2797;10483;6614;25876;27131;5173;400831;58495;5111;79133;642636;57506;140901;10621;55423;100288797;284759;6666;79175;51575,133
1,1,20,61569,62915555,62853986,198437;10326;6754;1869;10564;3055;6615;23236;7125;64849;63910;8760;100506115;63926;245929;64900;2691;54915;80331;24148;23767;57144;1917;128497;191;51497;6590;128821;55968;51012;7692;55321;56255;55614;81502;10137;128853;55304;9935;11142;128602;4773;4923;3911;11190;84557;79716;8480;23509;60493;22918;55661;79444;6939;2280;25943;81030;140683;57148;54923;10616;8530;140870;1470;2832;10388;85441;22903;245936;79025;8675;116092;140687;3755;8200;55738;6628;164395;9770;245932;26133;85508;60598;140873;64601;27296;27304;387522;55734;400830;128408;26164;56261;128486;149840;90204;140838;1299;24141;3692;100132911;140880;4826;51604;10528;81610;55902;51654;57642;63925;7053;79183;5476;9334;164312;10483;5173;598;400831;56731;100527943;79913;79133;8785;57506;140901;387521;100288797;284759;55905;140690;51575;79144;10110;7150;8904;57761;3642;140730;140850;22974;63908;149685;140731;8839;6407;551;1469;6725;245938;57325;100;388780;1473;51282;57091;54453;26013;140876;54976;11264;140809;958;128488;10741;60625;55612;4987;140894;4821;55251;57169;5933;2778;140881;22888;51340;55257;9777;5360;85364;6714;128710;92675;58490;994;80341;81928;140680;84612;3785;1457;1522;80332;359710;26074;80336;26152;112858;7056;63935;116154;140685;5020;113278;164237;6874;140836;117532;56265;6185;343637;51614;128506;60437;84181;149699;51750;116151;63939;92667;182;140706;140831;80023;5266;54345;26090;22839;6790;9371;128866;200232;8771;4605;90187;51378;51006;50861;8455;2307;64405;55713;9825;9139;140893;2797;3172;55653;140825;58495;10398;23315;391253;63941;128817;4318;1591;5786;6385;284805;79980;5621;128611;83737;9054;259239;10544;23054;29107;434;100128496;140823;128637;245937;57167;79953;57136;140732;55959;10955;280664;64949;22981;80343;6919;245934;140700;128653;28231;140902;55617;4159;22919;5126;54363;5335;81623;149708;51230;25939;10047;51526;5753;140710;140689;140885;5509;128826;22803;128434;245939;1114;55969;140862;1472;6406;1051;140688;140733;51126;90203;10079;11317;7052;84905;10893;84515;26051;2036;51098;6780;81572;57468;100462983;1059;51605;1477;128859;3704;64096;9491;22913;10406;284739;955;28954;90196;128869;116835;6629;80025;9962;1789;9885;1471;514;1002;6640;3397;6431;140832;128414;63916;140701;671;84969;11034;7529;1908;57419;3787;128674;3929;6614;56259;84701;128553;642636;55423;128876;11122;79175;128861;6789;5326;6676;9762;100303755;64412;9751;56937;343641;10904;146;5075;245930;170487;388799;140679;57119;631;5332;81031;7022;57446;57644;650;10953;2686;149951;128646;5834;55317;83541;1137;10287;57580;6616;55544;8894;56914;149986;51297;26039;11083;23051;54994;55184;140856;1434;29058;63905;7165;81027;655;92747;26205;3745;140711;3420;83658;100526773;90199;55857;65992;58476;140628;57186;54963;84174;27111;55245;92086;8537;57593;60436;171023;54498;23626;85449;5105;64773;25980;10816;78997;8813;644524;84619;8195;8202;11237;10005;51507;5203;117285;11255;83959;343578;57473;2139;128864;2937;9217;284756;10732;9675;10139;149954;140699;11047;11054;23613;11065;164284;7335;23627;30813;6238;54675;5770;9837;55741;5688;6227;343702;140686;3170;23394;57403;27131;25876;7764;128822;259240;55816;5111;5740;9584;10621;84532;57727;4661;6666;85366;57158;55861,527
1,1,20,61569,62915555,62853986,198437;10326;6754;1869;10564;3055;6615;23236;7125;64849;63910;8760;100506115;63926;245929;64900;2691;54915;80331;24148;23767;57144;1917;128497;191;51497;6590;128821;55968;51012;7692;55321;56255;55614;81502;10137;128853;55304;9935;11142;128602;4773;4923;3911;11190;84557;79716;8480;23509;60493;22918;55661;79444;6939;2280;25943;81030;140683;57148;54923;10616;8530;140870;1470;2832;10388;85441;22903;245936;79025;8675;116092;140687;3755;8200;55738;6628;164395;9770;245932;26133;85508;60598;140873;64601;27296;27304;387522;55734;400830;128408;26164;56261;128486;149840;90204;140838;1299;24141;3692;100132911;140880;4826;51604;10528;81610;55902;51654;57642;63925;7053;79183;5476;9334;164312;10483;5173;598;400831;56731;100527943;79913;79133;8785;57506;140901;387521;100288797;284759;55905;140690;51575;79144;10110;7150;8904;57761;3642;140730;140850;22974;63908;149685;140731;8839;6407;551;1469;6725;245938;57325;100;388780;1473;51282;57091;54453;26013;140876;54976;11264;140809;958;128488;10741;60625;55612;4987;140894;4821;55251;57169;5933;2778;140881;22888;51340;55257;9777;5360;85364;6714;128710;92675;58490;994;80341;81928;140680;84612;3785;1457;1522;80332;359710;26074;80336;26152;112858;7056;63935;116154;140685;5020;113278;164237;6874;140836;117532;56265;6185;343637;51614;128506;60437;84181;149699;51750;116151;63939;92667;182;140706;140831;80023;5266;54345;26090;22839;6790;9371;128866;200232;8771;4605;90187;51378;51006;50861;8455;2307;64405;55713;9825;9139;140893;2797;3172;55653;140825;58495;10398;23315;391253;63941;128817;4318;1591;5786;6385;284805;79980;5621;128611;83737;9054;259239;10544;23054;29107;434;100128496;140823;128637;245937;57167;79953;57136;140732;55959;10955;280664;64949;22981;80343;6919;245934;140700;128653;28231;140902;55617;4159;22919;5126;54363;5335;81623;149708;51230;25939;10047;51526;5753;140710;140689;140885;5509;128826;22803;128434;245939;1114;55969;140862;1472;6406;1051;140688;140733;51126;90203;10079;11317;7052;84905;10893;84515;26051;2036;51098;6780;81572;57468;100462983;1059;51605;1477;128859;3704;64096;9491;22913;10406;284739;955;28954;90196;128869;116835;6629;80025;9962;1789;9885;1471;514;1002;6640;3397;6431;140832;128414;63916;140701;671;84969;11034;7529;1908;57419;3787;128674;3929;6614;56259;84701;128553;642636;55423;128876;11122;79175;128861;6789;5326;6676;9762;100303755;64412;9751;56937;343641;10904;146;5075;245930;170487;388799;140679;57119;631;5332;81031;7022;57446;57644;650;10953;2686;149951;128646;5834;55317;83541;1137;10287;57580;6616;55544;8894;56914;149986;51297;26039;11083;23051;54994;55184;140856;1434;29058;63905;7165;81027;655;92747;26205;3745;140711;3420;83658;100526773;90199;55857;65992;58476;140628;57186;54963;84174;27111;55245;92086;8537;57593;60436;171023;54498;23626;85449;5105;64773;25980;10816;78997;8813;644524;84619;8195;8202;11237;10005;51507;5203;117285;11255;83959;343578;57473;2139;128864;2937;9217;284756;10732;9675;10139;149954;140699;11047;11054;23613;11065;164284;7335;23627;30813;6238;54675;5770;9837;55741;5688;6227;343702;140686;3170;23394;57403;27131;25876;7764;128822;259240;55816;5111;5740;9584;10621;84532;57727;4661;6666;85366;57158;55861,527
1,1,20,65043,6139725,6074682,140680;57593;10616;1457;54498;57761;10326;140850;5786;80332;9762;64773;84515;551;5621;9751;5020;113278;343641;117532;56265;146;245938;1059;8760;343637;51605;6628;11237;9770;388780;85508;3704;64601;64096;9491;128637;83959;54976;400830;140809;80023;56261;116835;128646;64949;80025;9962;149840;55317;83541;55968;128653;55321;55612;10528;81623;23627;140881;51378;8455;54675;22888;29058;7053;164312;140885;128674;2797;60493;245939;6614;85364;3420;25876;1114;5173;65992;400831;6939;2280;25943;5111;642636;57506;140901;55423;100288797;284759;6666;27111;79175;994,93
-1,1,20,70580,344879,274299,245938;140680;81623;140881;140850;400830;245939;6666;85364;80023,10
-1,1,20,70580,1474759,1404179,245938;140680;10616;1457;343637;57761;83541;55968;55321;140850;245939;85508;85364;9491;128637;6939;400831;2280;81623;642636;140881;51378;9751;400830;113278;140809;284759;6666;27111;80023,30
-1,1,20,70580,1833123,1762543,140680;10616;1457;57761;83541;55968;10326;55321;140850;81623;140881;51378;9751;113278;245938;343637;245939;85508;85364;9491;128637;6939;400831;2280;642636;400830;55423;140809;284759;6666;27111;80023;128646,33
1,1,20,70580,29519992,29449412,57761;10326;3642;140850;5786;63908;6754;9762;100303755;551;5621;64412;9751;23236;1469;343641;146;5075;245938;8760;57325;63926;631;5332;388780;29107;1473;100128496;54453;128637;23767;54976;650;57144;140809;79953;57136;128821;128646;64949;5834;80343;22981;55317;83541;55968;7692;10741;128653;55321;55612;56255;6616;55614;55304;55617;56914;5126;54363;4821;81623;140881;55184;140856;10047;22888;29058;51340;140885;22803;60493;245939;85364;3420;22918;1114;140862;1472;55857;65992;128710;6939;57186;2280;25943;92675;27111;994;92086;140733;140680;57593;10616;51126;8530;1457;54498;1470;80332;64773;26074;26152;22903;7056;84515;5020;113278;644524;140836;117532;56265;1059;343637;51605;6628;8195;11237;9770;85508;3704;64601;64096;9491;83959;955;92667;182;400830;80023;56261;116835;6629;80025;9962;149840;26090;140838;1471;24141;140880;10528;23627;30813;51378;6238;8455;54675;11034;9837;7053;57419;164312;3170;128674;2797;10483;6614;25876;27131;5173;128822;400831;58495;5111;79133;642636;57506;140901;10621;55423;100288797;284759;84532;6666;79175;51575;128817,177
1,1,20,80198,62908674,62828476,198437;10326;6754;1869;10564;3055;6615;23236;7125;64849;63910;8760;100506115;63926;245929;64900;2691;54915;80331;24148;23767;57144;1917;128497;191;51497;6590;128821;55968;51012;7692;55321;56255;55614;81502;10137;128853;55304;9935;11142;128602;4773;4923;3911;11190;84557;79716;8480;23509;60493;22918;55661;79444;6939;2280;25943;81030;140683;57148;54923;10616;8530;140870;1470;2832;10388;85441;22903;245936;79025;8675;116092;140687;3755;8200;55738;6628;164395;9770;245932;26133;85508;60598;140873;64601;27296;27304;387522;55734;400830;128408;26164;56261;128486;149840;90204;140838;1299;24141;3692;100132911;140880;4826;51604;10528;81610;55902;51654;57642;63925;7053;79183;5476;9334;164312;10483;5173;598;400831;56731;100527943;79913;79133;8785;57506;140901;387521;100288797;284759;55905;140690;51575;79144;10110;7150;8904;57761;3642;140730;140850;22974;63908;149685;140731;8839;6407;551;1469;6725;57325;100;388780;1473;51282;57091;54453;26013;140876;54976;11264;140809;958;128488;10741;60625;55612;4987;140894;4821;55251;57169;5933;2778;140881;22888;51340;55257;9777;5360;85364;6714;128710;92675;58490;994;80341;81928;140680;84612;3785;1457;1522;80332;359710;26074;80336;26152;112858;7056;63935;116154;140685;5020;113278;164237;6874;140836;117532;56265;6185;343637;51614;128506;60437;84181;149699;51750;116151;63939;92667;182;140706;140831;80023;5266;54345;26090;22839;6790;9371;128866;200232;8771;4605;90187;51378;51006;50861;8455;2307;64405;55713;9825;9139;140893;2797;3172;55653;140825;58495;10398;23315;391253;63941;128817;4318;1591;5786;6385;284805;79980;5621;128611;83737;9054;259239;10544;23054;29107;434;100128496;140823;128637;245937;57167;79953;57136;140732;55959;10955;280664;64949;22981;80343;6919;245934;140700;128653;28231;140902;55617;4159;22919;5126;54363;5335;81623;149708;51230;25939;10047;51526;5753;140710;140689;140885;5509;128826;22803;128434;245939;1114;55969;140862;1472;6406;1051;140688;140733;51126;90203;10079;11317;7052;84905;10893;84515;26051;2036;51098;6780;81572;57468;100462983;1059;51605;1477;128859;3704;64096;9491;22913;10406;284739;955;28954;90196;128869;116835;6629;80025;9962;1789;9885;1471;514;1002;6640;3397;6431;140832;128414;63916;140701;671;84969;11034;7529;1908;57419;3787;128674;3929;6614;56259;84701;128553;642636;55423;128876;11122;79175;128861;6789;5326;6676;9762;100303755;64412;9751;56937;343641;10904;146;5075;245930;170487;388799;140679;57119;631;5332;81031;7022;57446;57644;650;10953;2686;149951;128646;5834;55317;83541;1137;10287;57580;6616;55544;8894;56914;149986;51297;26039;11083;23051;54994;55184;140856;1434;29058;63905;7165;81027;655;92747;26205;3745;140711;3420;83658;100526773;90199;55857;65992;58476;140628;57186;54963;84174;27111;55245;92086;8537;57593;60436;171023;54498;23626;85449;5105;64773;25980;10816;78997;8813;644524;84619;8195;8202;11237;10005;51507;5203;117285;11255;83959;343578;57473;2139;128864;2937;9217;284756;10732;9675;10139;149954;140699;11047;11054;23613;11065;164284;7335;23627;30813;6238;54675;5770;9837;55741;5688;6227;343702;140686;3170;23394;57403;27131;25876;7764;128822;259240;55816;5111;5740;9584;10621;84532;57727;4661;6666;85366;57158;55861,526
-1,1,20,121521,2073612,1952091,140680;10616;1457;57761;83541;55968;10326;55321;140850;81623;140881;51378;9751;113278;343637;140885;245939;85508;85364;5173;9491;128637;6939;400831;2280;642636;400830;55423;140809;284759;6666;27111;80023;128646,34
1,-1,20,571151,642377,71226,140809;85508;6939,3
1,1,20,1249947,8607558,7357611,57593;54498;10326;5786;80332;64773;9762;84515;551;5621;9751;23236;5020;343641;117532;56265;146;1059;8760;51605;6628;11237;9770;388780;3704;64601;64096;83959;54976;650;56261;116835;128646;64949;80025;9962;149840;55317;55968;128653;56255;55612;54363;10528;23627;8455;54675;22888;29058;7053;164312;140885;128674;2797;60493;6614;3420;25876;5173;1114;65992;2280;25943;5111;57506;140901;55423;100288797;284759;79175;27111;994,72
1,-1,20,1563728,1591178,27450,10326,1
1,-1,20,1563728,1591178,27450,10326,1
1,-1,20,1563728,1591178,27450,10326,1
1,-1,20,1563728,1591178,27450,10326,1
1,-1,20,1563728,1591178,27450,10326,1
1,-1,20,1563728,1591178,27450,10326,1
-1,1,20,2463101,8185680,5722579,64949;57593;80025;9962;149840;55317;54498;128653;56255;55612;5786;80332;9762;64773;84515;10528;551;5621;54363;23627;23236;5020;8455;54675;22888;56265;117532;146;29058;1059;8760;51605;164312;128674;11237;9770;2797;60493;6614;3420;3704;25876;64601;64096;1114;65992;83959;25943;5111;57506;54976;650;100288797;79175;994;56261;116835,57
-1,1,20,4323680,6892377,2568697,9962;149840;8760;51605;164312;128674;9770;55612;1114;84515;5621;5111;23627;650;54675;56261;29058,17
-1,1,20,4392930,12667768,8274838,9962;149840;8760;51605;164312;63926;128674;8195;24141;9770;56255;55612;6616;5332;1114;128710;22903;84515;54363;5621;5111;23627;650;182;23236;57144;54675;56261;29058,29
1,-1,20,5472181,5761701,289520,149840;56261,2
-1,1,20,6598342,13373206,6774864,8195;63926;24141;56255;5332;6616;55304;140862;55617;128710;22903;54363;650;182;23236;57144,16
-1,1,20,6713937,7303989,590052,650,1
1,1,20,7103757,8558193,1454436,56255;23236;54363,3
-1,-1,20,8196584,8256690,60106,23236,1
-1,1,20,9121901,16858469,7736568,140733;6629;80343;8195;63926;24141;5332;6616;55614;55304;140862;55617;56914;128710;22903;79133;23767;182;57144;51575,20
-1,1,20,9531622,12064082,2532460,57144;128710;22903;6616;8195;63926;182,7
-1,-1,20,14700040,14838217,138177,140733,1
-1,-1,20,14700040,14838217,138177,140733,1
-1,-1,20,14700040,14884729,184689,140733,1
-1,-1,20,14700040,14910957,210917,140733,1
-1,-1,20,14734607,15041530,306923,140733,1
-1,-1,20,14734411,14838217,103806,140733,1
-1,-1,20,14734411,14875711,141300,140733,1
-1,-1,20,14734411,15098434,364023,140733,1
-1,-1,20,14734411,15154704,420293,140733,1
-1,-1,20,14756393,14799098,42705,140733,1
-1,-1,20,14776687,14991571,214884,140733,1
-1,-1,20,14756520,14817895,61375,140733,1
-1,-1,20,14756520,14910957,154437,140733,1
-1,-1,20,14756520,15199338,442818,140733,1
-1,-1,20,14776880,14928568,151688,140733,1
-1,-1,20,14991493,15154704,163211,140733,1
-1,-1,20,15041479,15154704,113225,140733,1
1,-1,20,16053735,16609376,555641,55614,1
-1,1,20,17753416,21407427,3654011,51126;51340;57325;57419;3642;7692;10741;22803;10483;27131;100303755;26074;100128496;55857;54453;57186;58495;92675;92667;10621;55184;140856;644524,23
-1,1,20,18500917,25847320,7346403,51126;5834;22981;8530;26090;1470;140838;3642;1471;63908;6754;140880;26074;26152;4821;7056;64412;30813;1469;140856;10047;644524;9837;5075;51340;57419;3170;22803;10483;29107;22918;1473;1472;100128496;55857;54453;128822;57186;955;92675;84532;79953;57136;92086;128821;128817,46
1,-1,20,23805934,23814845,8911,1470,1
1,-1,20,25435258,25562423,127165,22981,1
1,-1,20,25466406,25593286,126880,22981,1
1,-1,20,25466406,25593296,126890,22981,1
1,-1,20,25466406,25593296,126890,22981,1
1,-1,20,25466406,25593296,126890,22981,1
1,-1,20,25745618,26066998,321380,,0
1,-1,20,25745618,26066998,321380,,0
1,-1,20,25755038,26062991,307953,,0
1,-1,20,25755038,26066998,311960,,0
1,-1,20,25755038,26066998,311960,,0
1,-1,20,25755038,26066998,311960,,0
1,-1,20,25755038,26066998,311960,,0
1,-1,20,25755038,26066998,311960,,0
1,-1,20,25755038,26066998,311960,,0
1,-1,20,25755038,26066998,311960,,0
1,-1,20,25755038,26066998,311960,,0
1,-1,20,25755038,26066998,311960,,0
1,-1,20,25755038,26066998,311960,,0
1,1,20,25755100,39058066,13302966,60436;171023;8904;85449;5326;22974;7052;149685;6676;25980;1869;359710;84905;284805;79980;10893;245936;3055;26051;2036;81572;10904;6185;245930;170487;8200;83737;140679;9054;51614;164395;10544;245932;26133;245929;128859;23054;2691;140873;434;51282;117285;22913;140823;57446;57644;245937;343578;128864;28954;11264;57148;2937;140706;140732;2686;191;128869;9675;149951;1789;149954;245934;10398;140699;60625;3692;22839;81502;10137;6640;128853;3397;9371;4826;128866;8894;140894;51297;22919;81610;55902;51654;5933;51230;25939;671;11190;2307;84557;55741;140710;343702;63905;23509;9139;3929;9777;128434;92747;140711;56259;83658;55969;63941;58476;6714;598;100527943;79913;84701;9584;128876;84174;58490;85366;55245;80341;140683;128861;140688,121
1,-1,20,25773783,26066998,293215,,0
1,-1,20,25773783,26066998,293215,,0
1,-1,20,25776170,26225123,448953,,0
-1,-1,20,26128860,26225123,96263,,0
-1,-1,20,26128860,26225123,96263,,0
-1,-1,20,26154923,26225123,70200,,0
1,-1,20,29446093,29647301,201208,,0
1,-1,20,29446093,29647301,201208,,0
1,-1,20,29446093,29647301,201208,,0
1,-1,20,29446093,29647301,201208,,0
1,-1,20,29446093,29647301,201208,,0
1,-1,20,29446093,29647359,201266,,0
1,-1,20,29486144,29647301,161157,,0
1,-1,20,29614695,29647301,32606,,0
1,-1,20,29614695,29647301,32606,,0
1,-1,20,29614695,29647301,32606,,0
1,-1,20,29614695,29647301,32606,,0
1,-1,20,29614695,29647301,32606,,0
1,-1,20,29614695,29647301,32606,,0
1,-1,20,29614695,29647301,32606,,0
1,-1,20,29614695,29647301,32606,,0
1,1,20,29842786,31163090,1320304,245930;245934;171023;343702;23509;164395;5326;9777;81502;22974;245932;245929;3397;128853;9371;117285;598;245936;245937;3055;84701;28954;140706;85366;81572;2307;140688,27
1,1,20,29842786,32060886,2218100,1789;149954;245934;171023;5326;81502;22974;6640;3397;128853;9371;359710;284805;51297;22919;245936;3055;51654;81572;2307;245930;343702;23509;164395;9777;245932;92747;245929;128859;117285;598;245937;84701;28954;140706;140732;85366;80341;140683;128861;149951;140688,42
1,1,20,30650571,34494528,3843957,1789;149954;171023;8904;3692;5326;6676;6640;9371;10137;359710;1869;128866;8894;84905;284805;51297;22919;10893;3055;55902;51654;51230;11190;84557;55741;170487;8200;83737;9054;23509;51614;9139;10544;9777;92747;26133;128859;23054;83658;140873;434;22913;58476;140823;140688;57644;128864;11264;2937;9584;128876;140732;2686;191;128869;55245;80341;140683;128861;149951;63941,62
-1,1,20,30824541,46297763,15473222,7150;6789;8904;4318;140730;149685;6676;1869;6385;284805;8839;6407;79980;7125;10904;64849;170487;83737;140679;9054;259239;100;10544;57119;64900;23054;2691;81031;434;51282;140823;57446;26013;57644;11264;10953;140732;2686;128497;191;55959;958;6590;149951;10955;280664;128488;60625;10137;9935;8894;140894;140902;11142;51297;22919;5335;23051;5933;149708;51230;25939;11190;84557;51526;140710;63905;23509;128434;92747;5360;140711;83658;100526773;55969;6406;90199;58476;6714;84174;58490;55245;80341;140683;57148;140688;90203;60436;140870;171023;11317;85449;7052;25980;359710;80336;84905;10816;78997;112858;10893;63935;26051;2036;51098;164237;116092;57468;6185;8200;51614;8202;128506;84181;26133;10005;128859;149699;60598;140873;27296;10406;22913;343578;2139;128864;90196;2937;140831;128869;9675;5266;128486;1789;149954;90204;140699;3692;22839;23613;11065;6640;9371;4826;51604;128866;6431;81610;55902;51654;4605;90187;140832;51006;63925;63916;671;84969;7529;64405;55713;55741;79183;140686;5476;3787;9139;3929;3172;56259;259240;100527943;79913;8785;140825;9584;57727;128876;11122;57158;55861;10398;128861;391253;10110;63941,186
1,-1,20,31590721,31652979,62258,80341;140732;359710;128859,4
-1,1,20,32020169,35450284,3430115,60436;8904;3692;22839;6676;6640;10137;25980;1869;128866;8894;84905;140894;79980;10893;55902;2036;51230;11190;84557;55741;170487;140710;8200;83737;9054;51614;9139;10544;26133;23054;83658;140873;55969;434;51282;22913;58476;140823;57446;57644;100527943;128864;11264;2937;9584;128876;2686;84174;191;128869;55245;10398;63941,54
1,-1,20,32452247,32528867,76620,,0
1,-1,20,32452247,32528867,76620,,0
-1,1,20,33825749,46260562,12434813,7150;6789;8904;4318;140730;149685;6676;6385;8839;6407;79980;7125;10904;64849;140679;9054;259239;100;57119;64900;2691;81031;51282;140823;57446;26013;10953;128497;958;6590;10955;280664;128488;60625;10137;9935;140902;140894;11142;5335;23051;5933;149708;51230;25939;11190;51526;140710;63905;128434;5360;140711;100526773;55969;6406;90199;6714;84174;58490;55245;57148;90203;60436;140870;11317;85449;7052;25980;80336;10816;78997;112858;10893;63935;26051;2036;51098;164237;116092;57468;6185;8200;51614;8202;128506;84181;10005;149699;60598;140873;27296;10406;343578;2139;90196;140831;9675;5266;128486;90204;140699;3692;22839;23613;11065;4826;51604;6431;81610;4605;90187;140832;51006;63925;63916;671;84969;7529;64405;55713;79183;140686;5476;3787;3929;3172;56259;259240;100527943;79913;8785;140825;9584;57727;128876;11122;57158;55861;10398;391253;10110,141
-1,1,20,33873527,34332759,459232,140823;8200;9054;51614;8904;9584;128876;6676;10137;55245;11190;140873,12
-1,-1,20,36908452,36948558,40106,671,1
1,-1,20,41067417,41107347,39930,11122,1
-1,-1,20,41224904,41312488,87584,11122,1
1,-1,20,43933602,44003301,69699,11317;8785;27296;6385;90196,5
-1,-1,20,44350693,44370415,19722,391253,1
1,-1,20,46494494,47131037,636543,,0
-1,1,20,47627844,52045480,4417636,84612;3755;10079;9825;23315;9334;100506115;23394;3745;55661;10564;27304;387522;8813;4773;55653;140876;7335;128553;57167;57169;55734;5740;6615;387521;6780;1051;55905;1434;5770,30
-1,1,20,49398527,51409386,2010859,3755;8813;55653;4773;10079;57167;55734;23394;27304,9
-1,1,20,53211427,56765639,3554212,388799;100462983;8480;140689;23626;1477;5105;655;6790;55544;51507;116151;7022;57091;4159;55816;200232;128602;140690;56937;81030;140687,22
1,1,20,54773088,62908674,8135586,198437;3785;23626;2832;10388;5105;1522;140731;85441;116154;140685;79025;56937;6874;8675;6725;84619;63910;140687;388799;128611;100462983;55738;1477;60437;51507;51750;116151;284739;7022;57091;54915;11255;63939;80331;24148;57473;9217;10732;284756;1917;128408;26164;51497;54345;6919;10139;9885;1137;51012;140700;10287;11047;1299;11054;514;1002;100132911;6790;55544;164284;28231;4987;4159;149986;128602;26039;11083;4923;200232;8771;55251;54994;2778;128414;57642;50861;140701;3911;5753;1908;55257;5688;6227;79716;8480;7165;5509;128826;81027;140893;655;26205;57403;79444;140628;54963;56731;140690;4661;81030;79144;54923;81928,104
1,1,20,55804471,62904442,7099971,198437;3785;23626;2832;10388;5105;1522;140731;85441;116154;140685;79025;56937;6874;8675;6725;84619;63910;128611;100462983;55738;60437;51750;284739;54915;11255;63939;80331;24148;57473;9217;10732;284756;1917;128408;26164;51497;54345;6919;10139;9885;1137;51012;140700;10287;11047;1299;11054;514;1002;100132911;55544;164284;28231;4987;149986;26039;128602;11083;8771;4923;55251;54994;2778;128414;57642;50861;140701;3911;5753;1908;55257;5688;6227;79716;8480;7165;5509;128826;81027;140893;655;26205;57403;79444;140628;54963;56731;140690;4661;81030;79144;54923;81928,94
1,-1,20,57425665,57426598,933,2778,1
1,-1,20,57462934,57465925,2991,2778,1
1,-1,20,57463534,57464754,1220,2778,1
1,1,20,57617021,62908674,5291653,3785;198437;2832;10388;85441;116154;140685;79025;6874;6725;84619;63910;128611;55738;60437;51750;284739;54915;11255;63939;80331;57473;24148;10732;284756;1917;128408;26164;54345;6919;10139;9885;11047;51012;1299;11054;1002;1137;140700;10287;100132911;28231;4987;149986;26039;11083;8771;4923;55251;54994;128414;57642;50861;140701;3911;1908;5753;55257;5688;6227;7165;5509;128826;140893;26205;79444;140628;56731;54963;4661;79144;54923;81928,73
1,1,20,59901605,62908679,3007074,3785;198437;2832;85441;140685;79025;6874;6725;84619;63910;55738;51750;284739;54915;11255;80331;57473;24148;10732;1917;128408;26164;54345;6919;10139;9885;11047;1299;11054;1002;1137;140700;10287;100132911;28231;4987;149986;26039;11083;8771;4923;55251;54994;128414;57642;50861;140701;3911;5753;55257;5688;6227;7165;128826;140893;26205;79444;140628;56731;54963;4661;79144;54923;81928,64
1,-1,20,60711779,60772528,60749,26039;5688;26164,3
1,-1,20,61040925,61121437,80512,140628,1
1,-1,20,61040925,61131437,90512,140628,1
-1,1,20,61179280,62915555,1736275,54345;6919;10139;3785;198437;1137;1299;11054;140700;10287;2832;100132911;28231;85441;4987;11083;8771;4923;55251;54994;54923;128414;57642;79025;50861;140685;140701;6725;84619;63910;5753;55257;55738;7165;26205;51750;284739;54915;79444;56731;80331;54963;57473;24148;10732;1917;128408;4661;79144,49
-1,1,20,61211869,62908674,1696805,54345;6919;10139;3785;198437;1137;1299;11054;140700;10287;2832;100132911;28231;85441;4987;11083;8771;4923;55251;54994;54923;128414;57642;79025;50861;140685;140701;6725;84619;63910;5753;55257;55738;7165;26205;51750;284739;54915;79444;56731;80331;54963;57473;24148;10732;1917;128408;4661;79144,49
-1,1,20,61294659,62915555,1620896,54345;6919;10139;3785;198437;1137;1299;11054;140700;10287;2832;100132911;28231;85441;4987;11083;8771;4923;55251;54994;140685;128414;57642;79025;50861;140701;6725;84619;63910;5753;55257;55738;7165;26205;51750;284739;54915;79444;56731;80331;54963;57473;24148;10732;1917;128408;4661;79144;54923,49
-1,1,20,61465730,62298789,833059,3785;55738;1137;1299;100132911;26205;51750;85441;54915;11083;79444;54994;10732;128414;57642;79025;50861;1917;128408;79144;6725;63910;5753,23
-1,1,20,61540307,62965520,1425213,54345;6919;10139;3785;198437;1137;140700;10287;2832;85441;4987;11083;8771;55251;54994;140685;128414;57642;79025;50861;140701;6725;84619;63910;5753;55738;7165;26205;51750;284739;54915;79444;56731;80331;54963;57473;24148;1917;128408;4661;79144;54923,42
1,-1,20,61595624,61637326,41702,63910,1
-1,1,20,61785315,62908674,1123359,54345;6919;10139;3785;198437;1137;140700;10287;2832;85441;4987;8771;55251;54923;128414;57642;79025;50861;140685;140701;84619;6725;5753;55738;7165;26205;51750;284739;54915;79444;56731;80331;54963;57473;24148;1917;4661;79144,38
-1,1,20,61827144,62907467,1080323,54345;6919;10139;3785;198437;1137;140700;10287;2832;85441;4987;8771;55251;140685;128414;57642;79025;50861;54923;140701;84619;6725;5753;55738;7165;26205;51750;284739;54915;79444;56731;80331;54963;57473;24148;1917;4661;79144,38
-1,1,20,61884113,62915555,1031442,54345;6919;10139;3785;198437;1137;140700;10287;2832;85441;4987;8771;55251;140685;128414;79025;57642;50861;54923;140701;84619;6725;5753;55738;7165;26205;51750;284739;56731;80331;54963;57473;24148;1917;4661;79144,36
-1,1,20,62090403,62318983,228580,3785;79025;1917;26205;50861;79144;51750;6725;85441;5753,10
-1,1,20,62090403,62318983,228580,3785;79025;1917;26205;50861;79144;51750;6725;85441;5753,10
-1,1,20,62654677,62893130,238453,54345;6919;24148;198437;55251;10287;2832;4661;4987;284739,10
1,-1,20,62731576,62907467,175891,55251;2832;4661;4987,4
1,-1,20,62762136,62908674,146538,55251;4661,2
1,-1,21,9734796,10205155,470359,,0
1,-1,21,9734796,10944001,1209205,7179,1
1,-1,21,9734796,10944001,1209205,7179,1
1,-1,21,9734796,10944001,1209205,7179,1
1,1,21,10697897,48090972,37393075,54148;4599;5316;337882;106865373;1409;54101;9875;1826;9073;386679;874;51227;10950;337970;101928147;386681;56245;54943;643812;326;5121;1476;9946;116448;1292;64699;11077;1827;3150;63977;10281;149998;337973;8566;26046;7307;7113;54014;116159;56683;150094;85395;59271;386685;23515;337878;8624;29980;386683;337979;8568;100288323;54149;6450;4731;6493;539;104;54093;5822;6453;4047;54039;337985;7033;353333;23181;3454;25825;23275;2618;337976;2078;3455;1525;140258;56246;64968;49854;89766;754;3460;6647;54065;150051;58494;80781;7327;10785;337879;10841;54033;3753;337972;6782;150084;643803;728299;9992;386672;5211;861;11096;2897;56894;54084;6285;3689;8209;1859;29104;337960;7485;386676;571;386680;7267;53347;7074;5152;10311;150082;3772;3275;54059;8208;9510;10317;5116;84221;29947;337959;4685;6612;337968;85319;755;1291;351;875;10069;7032;100131902;522;53820;9980;337963;337967;353323;7031;3588;6526;10215;7109;140578;386674;386675;23076;6573;3763;2114;353332;3141;4600;337971;54058;8204;386677;89765;30811;337974;337977;5651;337969;388813;57466;140290;54069;2551;757;10600;90625;7179;23562;26285;10694;23308;386678;337975;337880;100288287;54102;317754;6651;8867;8888;94104;64092;25966;54020;337966;9619;386684;388818;337978;386682;254950;54097;56911;873;29761;284827;81543;7226,215
-1,-1,21,10864216,11033703,169487,7179;85319,2
-1,-1,21,10898991,11047451,148460,7179;85319,2
-1,-1,21,10915083,11176283,261200,7179;85319,2
1,1,21,10944001,48090972,37146971,54148;4599;5316;337882;106865373;1409;54101;9875;1826;9073;386679;874;51227;10950;337970;101928147;386681;56245;54943;643812;326;5121;1476;9946;116448;1292;64699;11077;1827;3150;63977;10281;149998;337973;8566;26046;7307;7113;54014;116159;56683;150094;85395;59271;386685;23515;337878;8624;29980;386683;337979;8568;100288323;54149;6450;4731;6493;539;104;54093;5822;6453;4047;54039;337985;7033;353333;23181;3454;25825;23275;2618;337976;2078;3455;1525;140258;56246;64968;49854;89766;754;3460;6647;54065;150051;58494;80781;7327;10785;337879;10841;54033;3753;337972;6782;150084;643803;728299;9992;386672;5211;861;11096;2897;56894;54084;6285;3689;8209;1859;29104;337960;7485;386676;571;386680;7267;53347;7074;5152;10311;150082;3772;3275;54059;8208;9510;10317;5116;84221;29947;337959;4685;6612;337968;85319;755;1291;351;875;10069;7032;100131902;522;53820;9980;337963;337967;353323;7031;3588;6526;10215;7109;140578;386674;386675;23076;6573;3763;2114;353332;3141;4600;337971;54058;8204;386677;89765;30811;337974;337977;5651;337969;388813;57466;140290;54069;2551;757;10600;90625;7179;23562;23308;26285;10694;386678;337975;337880;100288287;54102;317754;6651;8867;8888;94104;64092;25966;54020;337966;9619;386684;388818;337978;386682;254950;54097;56911;873;29761;284827;81543;7226,215
1,-1,21,10991392,11096086,104694,85319,1
1,-1,21,10991392,11096086,104694,85319,1
1,-1,21,10991392,14417582,3426190,85319,1
-1,-1,21,11132929,11176283,43354,,0
1,1,21,14386013,48097372,33711359,54148;4599;5316;337882;106865373;1409;54101;9875;1826;9073;386679;874;51227;10950;337970;101928147;386681;56245;54943;643812;326;5121;1476;9946;116448;1292;64699;11077;1827;3150;63977;10281;149998;337973;8566;26046;7307;7113;54014;116159;56683;150094;85395;59271;386685;23515;337878;8624;29980;386683;337979;8568;100288323;54149;6450;4731;6493;539;104;54093;5822;6453;4047;54039;337985;7033;353333;23181;3454;25825;23275;2618;337976;2078;3455;1525;140258;56246;64968;49854;89766;754;3460;6647;54065;150051;58494;80781;7327;10785;337879;10841;54033;3753;337972;6782;150084;643803;728299;9992;386672;5211;861;11096;2897;56894;54084;6285;3689;8209;1859;29104;337960;7485;386676;571;386680;7267;53347;7074;5152;10311;150082;3772;3275;54059;8208;9510;10317;5116;84221;29947;337959;4685;6612;337968;755;1291;351;875;10069;7032;100131902;522;53820;9980;337963;337967;353323;7031;3588;6526;10215;7109;140578;386674;386675;23076;6573;3763;2114;353332;3141;4600;337971;54058;8204;386677;89765;30811;337974;337977;5651;337969;388813;57466;140290;54069;2551;757;10600;90625;23562;23308;26285;10694;386678;337975;337880;100288287;54102;317754;6651;8867;8888;94104;64092;25966;54020;337966;9619;386684;388818;337978;386682;254950;54097;56911;873;29761;284827;81543;7226,213
1,1,21,14577835,48069743,33491908,54148;4599;5316;337882;106865373;1409;54101;9875;1826;9073;386679;874;51227;10950;337970;101928147;386681;56245;54943;643812;326;5121;1476;9946;116448;1292;64699;11077;1827;3150;63977;10281;149998;337973;8566;26046;7307;7113;54014;116159;56683;150094;85395;59271;386685;23515;337878;8624;29980;386683;337979;8568;100288323;54149;6450;4731;6493;539;104;54093;5822;6453;4047;54039;337985;7033;353333;23181;3454;25825;23275;2618;337976;2078;3455;1525;140258;56246;64968;49854;89766;754;3460;6647;54065;150051;58494;80781;7327;10785;337879;10841;54033;3753;337972;6782;150084;643803;728299;9992;386672;5211;861;11096;2897;56894;54084;6285;3689;8209;1859;29104;337960;7485;386676;571;386680;7267;53347;7074;5152;10311;150082;3772;3275;54059;8208;9510;10317;5116;84221;29947;337959;4685;6612;337968;755;1291;351;875;10069;7032;100131902;522;53820;9980;337963;337967;353323;7031;3588;6526;10215;7109;140578;386674;386675;23076;6573;3763;2114;353332;3141;4600;337971;54058;8204;386677;89765;30811;337974;337977;5651;337969;388813;57466;140290;54069;2551;757;10600;90625;23562;23308;26285;10694;386678;337975;337880;100288287;54102;317754;6651;8867;8888;94104;64092;25966;54020;337966;9619;386684;388818;337978;386682;254950;54097;56911;873;29761;284827;81543;7226,213
1,1,21,14577835,48118159,33540324,54148;4599;5316;337882;106865373;1409;54101;9875;1826;9073;386679;874;51227;10950;337970;101928147;386681;56245;54943;643812;326;5121;1476;9946;116448;1292;64699;11077;1827;3150;63977;10281;149998;337973;8566;26046;7307;7113;54014;116159;56683;150094;85395;59271;386685;23515;337878;8624;29980;386683;337979;8568;100288323;54149;6450;4731;6493;539;104;54093;5822;6453;4047;54039;337985;7033;353333;23181;3454;25825;23275;2618;337976;2078;3455;1525;140258;56246;64968;49854;89766;754;3460;6647;54065;150051;58494;80781;7327;10785;337879;10841;54033;3753;337972;6782;150084;643803;728299;9992;386672;5211;861;11096;2897;56894;54084;6285;3689;8209;1859;29104;337960;7485;386676;571;386680;7267;53347;7074;5152;10311;150082;3772;3275;54059;8208;9510;10317;5116;84221;29947;337959;4685;6612;337968;755;1291;351;875;10069;7032;100131902;522;53820;9980;337963;337967;353323;7031;3588;6526;10215;7109;140578;386674;386675;23076;6573;3763;2114;353332;3141;4600;337971;54058;8204;386677;89765;30811;337974;337977;5651;337969;388813;57466;140290;54069;2551;757;10600;90625;23562;23308;26285;10694;386678;337975;337880;100288287;54102;317754;6651;8867;8888;94104;64092;25966;54020;337966;9619;386684;388818;337978;386682;254950;54097;56911;873;29761;284827;81543;7226,213
1,1,21,14577894,48090258,33512364,54148;4599;5316;337882;106865373;1409;54101;9875;1826;9073;386679;874;51227;10950;337970;101928147;386681;56245;54943;643812;326;5121;1476;9946;116448;1292;64699;11077;1827;3150;63977;10281;149998;337973;8566;26046;7307;7113;54014;116159;56683;150094;85395;59271;386685;23515;337878;8624;29980;386683;337979;8568;100288323;54149;6450;4731;6493;539;104;54093;5822;6453;4047;54039;337985;7033;353333;23181;3454;25825;23275;2618;337976;2078;3455;1525;140258;56246;64968;49854;89766;754;3460;6647;54065;150051;58494;80781;7327;10785;337879;10841;54033;3753;337972;6782;150084;643803;728299;9992;386672;5211;861;11096;2897;56894;54084;6285;3689;8209;1859;29104;337960;7485;386676;571;386680;7267;53347;7074;5152;10311;150082;3772;3275;54059;8208;9510;10317;5116;84221;29947;337959;4685;6612;337968;755;1291;351;875;10069;7032;100131902;522;53820;9980;337963;337967;353323;7031;3588;6526;10215;7109;140578;386674;386675;23076;6573;3763;2114;353332;3141;4600;337971;54058;8204;386677;89765;30811;337974;337977;5651;337969;388813;57466;140290;54069;2551;757;10600;90625;23562;23308;26285;10694;386678;337975;337880;100288287;54102;317754;6651;8867;8888;94104;64092;25966;54020;337966;9619;386684;388818;337978;386682;254950;54097;56911;873;29761;284827;81543;7226,213
1,1,21,14771770,48080867,33309097,54148;4599;5316;337882;106865373;1409;54101;9875;1826;9073;386679;874;51227;10950;337970;101928147;386681;56245;54943;643812;326;5121;1476;9946;116448;1292;64699;11077;1827;3150;63977;10281;149998;337973;8566;26046;7307;7113;54014;116159;56683;150094;85395;59271;386685;23515;337878;8624;29980;386683;337979;8568;100288323;54149;6450;4731;6493;539;104;54093;5822;6453;4047;54039;337985;7033;353333;23181;3454;25825;23275;2618;337976;2078;3455;1525;140258;56246;64968;49854;89766;754;3460;6647;54065;150051;58494;80781;7327;10785;337879;10841;54033;3753;337972;6782;150084;643803;728299;9992;386672;5211;861;11096;2897;56894;54084;6285;3689;8209;1859;29104;337960;7485;386676;571;386680;7267;53347;7074;5152;10311;150082;3772;3275;54059;8208;9510;10317;5116;84221;29947;337959;4685;6612;337968;755;1291;351;875;10069;7032;100131902;522;53820;9980;337963;337967;353323;7031;3588;6526;10215;7109;140578;386674;386675;23076;6573;3763;2114;353332;3141;4600;337971;54058;8204;386677;89765;30811;337974;337977;5651;337969;388813;57466;140290;54069;2551;757;10600;90625;23562;23308;26285;10694;386678;337975;337880;100288287;54102;317754;6651;8867;8888;94104;64092;25966;54020;337966;9619;386684;388818;337978;386682;254950;54097;56911;873;29761;284827;81543;7226,213
-1,1,21,15006457,19583516,4577059,149998;8204;140578;10950;54149;54033;29761;317754;64092;388813;6782;1525,12
-1,1,21,15006457,29225300,14218843,140578;54148;54149;11096;9510;317754;64092;58494;6782;4685;149998;8204;10950;54033;29761;351;116159;5651;522;388813;2551;1525,22
1,1,21,15006457,43598570,28592113,54148;4599;337882;106865373;54101;9875;1826;9073;874;51227;10950;337970;101928147;56245;54943;643812;5121;9946;116448;1827;3150;63977;10281;149998;337973;26046;7113;54014;116159;56683;59271;23515;337878;8624;29980;337979;100288323;54149;6450;6493;539;54093;6453;337985;3454;25825;2618;337976;2078;3455;1525;140258;56246;64968;49854;89766;3460;6647;54065;150051;58494;337879;54033;3753;337972;6782;150084;643803;728299;9992;861;11096;2897;1859;29104;337960;7485;571;7267;7074;10311;150082;3772;8208;9510;10317;337959;4685;337968;351;10069;100131902;522;53820;9980;337963;337967;3588;6526;10215;140578;3763;2114;3141;4600;337971;8204;30811;337974;337977;5651;337969;388813;57466;140290;54069;2551;757;10600;23562;26285;10694;337975;337880;100288287;54102;317754;6651;8867;94104;64092;25966;337966;388818;337978;254950;54097;56911;873;29761;284827,141
1,1,21,15006457,44827632,29821175,54148;4599;5316;337882;106865373;1409;54101;9875;1826;9073;874;51227;10950;337970;101928147;56245;54943;643812;5121;9946;116448;64699;1827;3150;63977;10281;149998;337973;26046;7307;7113;54014;116159;56683;59271;23515;337878;8624;29980;337979;100288323;54149;6450;4731;6493;539;54093;6453;337985;7033;3454;25825;2618;337976;2078;3455;1525;140258;56246;64968;49854;89766;3460;6647;54065;150051;58494;10785;337879;54033;3753;337972;6782;150084;643803;728299;9992;861;11096;2897;1859;29104;337960;7485;571;7267;53347;7074;5152;10311;150082;3772;8208;9510;10317;337959;4685;337968;351;875;10069;7032;100131902;522;53820;9980;337963;337967;7031;3588;6526;10215;140578;3763;2114;3141;4600;337971;8204;89765;30811;337974;337977;5651;337969;388813;57466;140290;54069;2551;757;10600;90625;23562;26285;10694;337975;337880;100288287;54102;317754;6651;8867;94104;64092;25966;54020;337966;9619;388818;337978;254950;54097;56911;873;29761;284827,157
1,1,21,15006457,48097372,33090915,54148;4599;5316;337882;106865373;1409;54101;9875;1826;9073;386679;874;51227;10950;337970;101928147;386681;56245;54943;643812;326;5121;1476;9946;116448;1292;64699;11077;1827;3150;63977;10281;149998;337973;8566;26046;7307;7113;54014;116159;56683;150094;85395;59271;386685;23515;337878;8624;29980;386683;337979;8568;100288323;54149;6450;4731;6493;539;104;54093;5822;6453;4047;54039;337985;7033;353333;23181;3454;25825;23275;2618;337976;2078;3455;1525;140258;56246;64968;49854;89766;754;3460;6647;54065;150051;58494;80781;7327;10785;337879;10841;54033;3753;337972;6782;150084;643803;728299;9992;386672;5211;861;11096;2897;56894;54084;6285;3689;8209;1859;29104;337960;7485;386676;571;386680;7267;53347;7074;5152;10311;150082;3772;3275;54059;8208;9510;10317;5116;84221;29947;337959;4685;6612;337968;755;1291;351;875;10069;7032;100131902;522;53820;9980;337963;337967;353323;7031;3588;6526;10215;7109;140578;386674;386675;23076;6573;3763;2114;353332;3141;4600;337971;54058;8204;386677;89765;30811;337974;337977;5651;337969;388813;57466;140290;54069;2551;757;10600;90625;23562;23308;26285;10694;386678;337975;337880;100288287;54102;317754;6651;8888;8867;94104;64092;25966;54020;337966;9619;386684;388818;337978;386682;254950;54097;56911;873;29761;284827;81543;7226,213
1,1,21,15006457,48097372,33090915,54148;4599;5316;337882;106865373;1409;54101;9875;1826;9073;386679;874;51227;10950;337970;101928147;386681;56245;54943;643812;326;5121;1476;9946;116448;1292;64699;11077;1827;3150;63977;10281;149998;337973;8566;26046;7307;7113;54014;116159;56683;150094;85395;59271;386685;23515;337878;8624;29980;386683;337979;8568;100288323;54149;6450;4731;6493;539;104;54093;5822;6453;4047;54039;337985;7033;353333;23181;3454;25825;23275;2618;337976;2078;3455;1525;140258;56246;64968;49854;89766;754;3460;6647;54065;150051;58494;80781;7327;10785;337879;10841;54033;3753;337972;6782;150084;643803;728299;9992;386672;5211;861;11096;2897;56894;54084;6285;3689;8209;1859;29104;337960;7485;386676;571;386680;7267;53347;7074;5152;10311;150082;3772;3275;54059;8208;9510;10317;5116;84221;29947;337959;4685;6612;337968;755;1291;351;875;10069;7032;100131902;522;53820;9980;337963;337967;353323;7031;3588;6526;10215;7109;140578;386674;386675;23076;6573;3763;2114;353332;3141;4600;337971;54058;8204;386677;89765;30811;337974;337977;5651;337969;388813;57466;140290;54069;2551;757;10600;90625;23562;23308;26285;10694;386678;337975;337880;100288287;54102;317754;6651;8888;8867;94104;64092;25966;54020;337966;9619;386684;388818;337978;386682;254950;54097;56911;873;29761;284827;81543;7226,213
1,1,21,15006457,48097372,33090915,54148;4599;5316;337882;106865373;1409;54101;9875;1826;9073;386679;874;51227;10950;337970;101928147;386681;56245;54943;643812;326;5121;1476;9946;116448;1292;64699;11077;1827;3150;63977;10281;149998;337973;8566;26046;7307;7113;54014;116159;56683;150094;85395;59271;386685;23515;337878;8624;29980;386683;337979;8568;100288323;54149;6450;4731;6493;539;104;54093;5822;6453;4047;54039;337985;7033;353333;23181;3454;25825;23275;2618;337976;2078;3455;1525;140258;56246;64968;49854;89766;754;3460;6647;54065;150051;58494;80781;7327;10785;337879;10841;54033;3753;337972;6782;150084;643803;728299;9992;386672;5211;861;11096;2897;56894;54084;6285;3689;8209;1859;29104;337960;7485;386676;571;386680;7267;53347;7074;5152;10311;150082;3772;3275;54059;8208;9510;10317;5116;84221;29947;337959;4685;6612;337968;755;1291;351;875;10069;7032;100131902;522;53820;9980;337963;337967;353323;7031;3588;6526;10215;7109;140578;386674;386675;23076;6573;3763;2114;353332;3141;4600;337971;54058;8204;386677;89765;30811;337974;337977;5651;337969;388813;57466;140290;54069;2551;757;10600;90625;23562;23308;26285;10694;386678;337975;337880;100288287;54102;317754;6651;8888;8867;94104;64092;25966;54020;337966;9619;386684;388818;337978;386682;254950;54097;56911;873;29761;284827;81543;7226,213
1,1,21,15006457,48097372,33090915,54148;4599;5316;337882;106865373;1409;54101;9875;1826;9073;386679;874;51227;10950;337970;101928147;386681;56245;54943;643812;326;5121;1476;9946;116448;1292;64699;11077;1827;3150;63977;10281;149998;337973;8566;26046;7307;7113;54014;116159;56683;150094;85395;59271;386685;23515;337878;8624;29980;386683;337979;8568;100288323;54149;6450;4731;6493;539;104;54093;5822;6453;4047;54039;337985;7033;353333;23181;3454;25825;23275;2618;337976;2078;3455;1525;140258;56246;64968;49854;89766;754;3460;6647;54065;150051;58494;80781;7327;10785;337879;10841;54033;3753;337972;6782;150084;643803;728299;9992;386672;5211;861;11096;2897;56894;54084;6285;3689;8209;1859;29104;337960;7485;386676;571;386680;7267;53347;7074;5152;10311;150082;3772;3275;54059;8208;9510;10317;5116;84221;29947;337959;4685;6612;337968;755;1291;351;875;10069;7032;100131902;522;53820;9980;337963;337967;353323;7031;3588;6526;10215;7109;140578;386674;386675;23076;6573;3763;2114;353332;3141;4600;337971;54058;8204;386677;89765;30811;337974;337977;5651;337969;388813;57466;140290;54069;2551;757;10600;90625;23562;23308;26285;10694;386678;337975;337880;100288287;54102;317754;6651;8888;8867;94104;64092;25966;54020;337966;9619;386684;388818;337978;386682;254950;54097;56911;873;29761;284827;81543;7226,213
1,1,21,15006457,48097372,33090915,54148;4599;5316;337882;106865373;1409;54101;9875;1826;9073;386679;874;51227;10950;337970;101928147;386681;56245;54943;643812;326;5121;1476;9946;116448;1292;64699;11077;1827;3150;63977;10281;149998;337973;8566;26046;7307;7113;54014;116159;56683;150094;85395;59271;386685;23515;337878;8624;29980;386683;337979;8568;100288323;54149;6450;4731;6493;539;104;54093;5822;6453;4047;54039;337985;7033;353333;23181;3454;25825;23275;2618;337976;2078;3455;1525;140258;56246;64968;49854;89766;754;3460;6647;54065;150051;58494;80781;7327;10785;337879;10841;54033;3753;337972;6782;150084;643803;728299;9992;386672;5211;861;11096;2897;56894;54084;6285;3689;8209;1859;29104;337960;7485;386676;571;386680;7267;53347;7074;5152;10311;150082;3772;3275;54059;8208;9510;10317;5116;84221;29947;337959;4685;6612;337968;755;1291;351;875;10069;7032;100131902;522;53820;9980;337963;337967;353323;7031;3588;6526;10215;7109;140578;386674;386675;23076;6573;3763;2114;353332;3141;4600;337971;54058;8204;386677;89765;30811;337974;337977;5651;337969;388813;57466;140290;54069;2551;757;10600;90625;23562;23308;26285;10694;386678;337975;337880;100288287;54102;317754;6651;8888;8867;94104;64092;25966;54020;337966;9619;386684;388818;337978;386682;254950;54097;56911;873;29761;284827;81543;7226,213
1,1,21,15006457,48097372,33090915,54148;4599;5316;337882;106865373;1409;54101;9875;1826;9073;386679;874;51227;10950;337970;101928147;386681;56245;54943;643812;326;5121;1476;9946;116448;1292;64699;11077;1827;3150;63977;10281;149998;337973;8566;26046;7307;7113;54014;116159;56683;150094;85395;59271;386685;23515;337878;8624;29980;386683;337979;8568;100288323;54149;6450;4731;6493;539;104;54093;5822;6453;4047;54039;337985;7033;353333;23181;3454;25825;23275;2618;337976;2078;3455;1525;140258;56246;64968;49854;89766;754;3460;6647;54065;150051;58494;80781;7327;10785;337879;10841;54033;3753;337972;6782;150084;643803;728299;9992;386672;5211;861;11096;2897;56894;54084;6285;3689;8209;1859;29104;337960;7485;386676;571;386680;7267;53347;7074;5152;10311;150082;3772;3275;54059;8208;9510;10317;5116;84221;29947;337959;4685;6612;337968;755;1291;351;875;10069;7032;100131902;522;53820;9980;337963;337967;353323;7031;3588;6526;10215;7109;140578;386674;386675;23076;6573;3763;2114;353332;3141;4600;337971;54058;8204;386677;89765;30811;337974;337977;5651;337969;388813;57466;140290;54069;2551;757;10600;90625;23562;23308;26285;10694;386678;337975;337880;100288287;54102;317754;6651;8888;8867;94104;64092;25966;54020;337966;9619;386684;388818;337978;386682;254950;54097;56911;873;29761;284827;81543;7226,213
1,1,21,15006457,48097372,33090915,54148;4599;5316;337882;106865373;1409;54101;9875;1826;9073;386679;874;51227;10950;337970;101928147;386681;56245;54943;643812;326;5121;1476;9946;116448;1292;64699;11077;1827;3150;63977;10281;149998;337973;8566;26046;7307;7113;54014;116159;56683;150094;85395;59271;386685;23515;337878;8624;29980;386683;337979;8568;100288323;54149;6450;4731;6493;539;104;54093;5822;6453;4047;54039;337985;7033;353333;23181;3454;25825;23275;2618;337976;2078;3455;1525;140258;56246;64968;49854;89766;754;3460;6647;54065;150051;58494;80781;7327;10785;337879;10841;54033;3753;337972;6782;150084;643803;728299;9992;386672;5211;861;11096;2897;56894;54084;6285;3689;8209;1859;29104;337960;7485;386676;571;386680;7267;53347;7074;5152;10311;150082;3772;3275;54059;8208;9510;10317;5116;84221;29947;337959;4685;6612;337968;755;1291;351;875;10069;7032;100131902;522;53820;9980;337963;337967;353323;7031;3588;6526;10215;7109;140578;386674;386675;23076;6573;3763;2114;353332;3141;4600;337971;54058;8204;386677;89765;30811;337974;337977;5651;337969;388813;57466;140290;54069;2551;757;10600;90625;23562;23308;26285;10694;386678;337975;337880;100288287;54102;317754;6651;8888;8867;94104;64092;25966;54020;337966;9619;386684;388818;337978;386682;254950;54097;56911;873;29761;284827;81543;7226,213
1,1,21,15006457,48097372,33090915,54148;4599;5316;337882;106865373;1409;54101;9875;1826;9073;386679;874;51227;10950;337970;101928147;386681;56245;54943;643812;326;5121;1476;9946;116448;1292;64699;11077;1827;3150;63977;10281;149998;337973;8566;26046;7307;7113;54014;116159;56683;150094;85395;59271;386685;23515;337878;8624;29980;386683;337979;8568;100288323;54149;6450;4731;6493;539;104;54093;5822;6453;4047;54039;337985;7033;353333;23181;3454;25825;23275;2618;337976;2078;3455;1525;140258;56246;64968;49854;89766;754;3460;6647;54065;150051;58494;80781;7327;10785;337879;10841;54033;3753;337972;6782;150084;643803;728299;9992;386672;5211;861;11096;2897;56894;54084;6285;3689;8209;1859;29104;337960;7485;386676;571;386680;7267;53347;7074;5152;10311;150082;3772;3275;54059;8208;9510;10317;5116;84221;29947;337959;4685;6612;337968;755;1291;351;875;10069;7032;100131902;522;53820;9980;337963;337967;353323;7031;3588;6526;10215;7109;140578;386674;386675;23076;6573;3763;2114;353332;3141;4600;337971;54058;8204;386677;89765;30811;337974;337977;5651;337969;388813;57466;140290;54069;2551;757;10600;90625;23562;23308;26285;10694;386678;337975;337880;100288287;54102;317754;6651;8888;8867;94104;64092;25966;54020;337966;9619;386684;388818;337978;386682;254950;54097;56911;873;29761;284827;81543;7226,213
1,1,21,15006457,48097372,33090915,54148;4599;5316;337882;106865373;1409;54101;9875;1826;9073;386679;874;51227;10950;337970;101928147;386681;56245;54943;643812;326;5121;1476;9946;116448;1292;64699;11077;1827;3150;63977;10281;149998;337973;8566;26046;7307;7113;54014;116159;56683;150094;85395;59271;386685;23515;337878;8624;29980;386683;337979;8568;100288323;54149;6450;4731;6493;539;104;54093;5822;6453;4047;54039;337985;7033;353333;23181;3454;25825;23275;2618;337976;2078;3455;1525;140258;56246;64968;49854;89766;754;3460;6647;54065;150051;58494;80781;7327;10785;337879;10841;54033;3753;337972;6782;150084;643803;728299;9992;386672;5211;861;11096;2897;56894;54084;6285;3689;8209;1859;29104;337960;7485;386676;571;386680;7267;53347;7074;5152;10311;150082;3772;3275;54059;8208;9510;10317;5116;84221;29947;337959;4685;6612;337968;755;1291;351;875;10069;7032;100131902;522;53820;9980;337963;337967;353323;7031;3588;6526;10215;7109;140578;386674;386675;23076;6573;3763;2114;353332;3141;4600;337971;54058;8204;386677;89765;30811;337974;337977;5651;337969;388813;57466;140290;54069;2551;757;10600;90625;23562;23308;26285;10694;386678;337975;337880;100288287;54102;317754;6651;8888;8867;94104;64092;25966;54020;337966;9619;386684;388818;337978;386682;254950;54097;56911;873;29761;284827;81543;7226,213
1,1,21,15006457,48097372,33090915,54148;4599;5316;337882;106865373;1409;54101;9875;1826;9073;386679;874;51227;10950;337970;101928147;386681;56245;54943;643812;326;5121;1476;9946;116448;1292;64699;11077;1827;3150;63977;10281;149998;337973;8566;26046;7307;7113;54014;116159;56683;150094;85395;59271;386685;23515;337878;8624;29980;386683;337979;8568;100288323;54149;6450;4731;6493;539;104;54093;5822;6453;4047;54039;337985;7033;353333;23181;3454;25825;23275;2618;337976;2078;3455;1525;140258;56246;64968;49854;89766;754;3460;6647;54065;150051;58494;80781;7327;10785;337879;10841;54033;3753;337972;6782;150084;643803;728299;9992;386672;5211;861;11096;2897;56894;54084;6285;3689;8209;1859;29104;337960;7485;386676;571;386680;7267;53347;7074;5152;10311;150082;3772;3275;54059;8208;9510;10317;5116;84221;29947;337959;4685;6612;337968;755;1291;351;875;10069;7032;100131902;522;53820;9980;337963;337967;353323;7031;3588;6526;10215;7109;140578;386674;386675;23076;6573;3763;2114;353332;3141;4600;337971;54058;8204;386677;89765;30811;337974;337977;5651;337969;388813;57466;140290;54069;2551;757;10600;90625;23562;23308;26285;10694;386678;337975;337880;100288287;54102;317754;6651;8888;8867;94104;64092;25966;54020;337966;9619;386684;388818;337978;386682;254950;54097;56911;873;29761;284827;81543;7226,213
1,1,21,15006457,48097372,33090915,54148;4599;5316;337882;106865373;1409;54101;9875;1826;9073;386679;874;51227;10950;337970;101928147;386681;56245;54943;643812;326;5121;1476;9946;116448;1292;64699;11077;1827;3150;63977;10281;149998;337973;8566;26046;7307;7113;54014;116159;56683;150094;85395;59271;386685;23515;337878;8624;29980;386683;337979;8568;100288323;54149;6450;4731;6493;539;104;54093;5822;6453;4047;54039;337985;7033;353333;23181;3454;25825;23275;2618;337976;2078;3455;1525;140258;56246;64968;49854;89766;754;3460;6647;54065;150051;58494;80781;7327;10785;337879;10841;54033;3753;337972;6782;150084;643803;728299;9992;386672;5211;861;11096;2897;56894;54084;6285;3689;8209;1859;29104;337960;7485;386676;571;386680;7267;53347;7074;5152;10311;150082;3772;3275;54059;8208;9510;10317;5116;84221;29947;337959;4685;6612;337968;755;1291;351;875;10069;7032;100131902;522;53820;9980;337963;337967;353323;7031;3588;6526;10215;7109;140578;386674;386675;23076;6573;3763;2114;353332;3141;4600;337971;54058;8204;386677;89765;30811;337974;337977;5651;337969;388813;57466;140290;54069;2551;757;10600;90625;23562;23308;26285;10694;386678;337975;337880;100288287;54102;317754;6651;8888;8867;94104;64092;25966;54020;337966;9619;386684;388818;337978;386682;254950;54097;56911;873;29761;284827;81543;7226,213
1,1,21,15006457,48097372,33090915,54148;4599;5316;337882;106865373;1409;54101;9875;1826;9073;386679;874;51227;10950;337970;101928147;386681;56245;54943;643812;326;5121;1476;9946;116448;1292;64699;11077;1827;3150;63977;10281;149998;337973;8566;26046;7307;7113;54014;116159;56683;150094;85395;59271;386685;23515;337878;8624;29980;386683;337979;8568;100288323;54149;6450;4731;6493;539;104;54093;5822;6453;4047;54039;337985;7033;353333;23181;3454;25825;23275;2618;337976;2078;3455;1525;140258;56246;64968;49854;89766;754;3460;6647;54065;150051;58494;80781;7327;10785;337879;10841;54033;3753;337972;6782;150084;643803;728299;9992;386672;5211;861;11096;2897;56894;54084;6285;3689;8209;1859;29104;337960;7485;386676;571;386680;7267;53347;7074;5152;10311;150082;3772;3275;54059;8208;9510;10317;5116;84221;29947;337959;4685;6612;337968;755;1291;351;875;10069;7032;100131902;522;53820;9980;337963;337967;353323;7031;3588;6526;10215;7109;140578;386674;386675;23076;6573;3763;2114;353332;3141;4600;337971;54058;8204;386677;89765;30811;337974;337977;5651;337969;388813;57466;140290;54069;2551;757;10600;90625;23562;23308;26285;10694;386678;337975;337880;100288287;54102;317754;6651;8888;8867;94104;64092;25966;54020;337966;9619;386684;388818;337978;386682;254950;54097;56911;873;29761;284827;81543;7226,213
1,1,21,15006457,48097372,33090915,54148;4599;5316;337882;106865373;1409;54101;9875;1826;9073;386679;874;51227;10950;337970;101928147;386681;56245;54943;643812;326;5121;1476;9946;116448;1292;64699;11077;1827;3150;63977;10281;149998;337973;8566;26046;7307;7113;54014;116159;56683;150094;85395;59271;386685;23515;337878;8624;29980;386683;337979;8568;100288323;54149;6450;4731;6493;539;104;54093;5822;6453;4047;54039;337985;7033;353333;23181;3454;25825;23275;2618;337976;2078;3455;1525;140258;56246;64968;49854;89766;754;3460;6647;54065;150051;58494;80781;7327;10785;337879;10841;54033;3753;337972;6782;150084;643803;728299;9992;386672;5211;861;11096;2897;56894;54084;6285;3689;8209;1859;29104;337960;7485;386676;571;386680;7267;53347;7074;5152;10311;150082;3772;3275;54059;8208;9510;10317;5116;84221;29947;337959;4685;6612;337968;755;1291;351;875;10069;7032;100131902;522;53820;9980;337963;337967;353323;7031;3588;6526;10215;7109;140578;386674;386675;23076;6573;3763;2114;353332;3141;4600;337971;54058;8204;386677;89765;30811;337974;337977;5651;337969;388813;57466;140290;54069;2551;757;10600;90625;23562;23308;26285;10694;386678;337975;337880;100288287;54102;317754;6651;8888;8867;94104;64092;25966;54020;337966;9619;386684;388818;337978;386682;254950;54097;56911;873;29761;284827;81543;7226,213
1,1,21,15006457,48097372,33090915,54148;4599;5316;337882;106865373;1409;54101;9875;1826;9073;386679;874;51227;10950;337970;101928147;386681;56245;54943;643812;326;5121;1476;9946;116448;1292;64699;11077;1827;3150;63977;10281;149998;337973;8566;26046;7307;7113;54014;116159;56683;150094;85395;59271;386685;23515;337878;8624;29980;386683;337979;8568;100288323;54149;6450;4731;6493;539;104;54093;5822;6453;4047;54039;337985;7033;353333;23181;3454;25825;23275;2618;337976;2078;3455;1525;140258;56246;64968;49854;89766;754;3460;6647;54065;150051;58494;80781;7327;10785;337879;10841;54033;3753;337972;6782;150084;643803;728299;9992;386672;5211;861;11096;2897;56894;54084;6285;3689;8209;1859;29104;337960;7485;386676;571;386680;7267;53347;7074;5152;10311;150082;3772;3275;54059;8208;9510;10317;5116;84221;29947;337959;4685;6612;337968;755;1291;351;875;10069;7032;100131902;522;53820;9980;337963;337967;353323;7031;3588;6526;10215;7109;140578;386674;386675;23076;6573;3763;2114;353332;3141;4600;337971;54058;8204;386677;89765;30811;337974;337977;5651;337969;388813;57466;140290;54069;2551;757;10600;90625;23562;23308;26285;10694;386678;337975;337880;100288287;54102;317754;6651;8888;8867;94104;64092;25966;54020;337966;9619;386684;388818;337978;386682;254950;54097;56911;873;29761;284827;81543;7226,213
1,1,21,15006457,48097372,33090915,54148;4599;5316;337882;106865373;1409;54101;9875;1826;9073;386679;874;51227;10950;337970;101928147;386681;56245;54943;643812;326;5121;1476;9946;116448;1292;64699;11077;1827;3150;63977;10281;149998;337973;8566;26046;7307;7113;54014;116159;56683;150094;85395;59271;386685;23515;337878;8624;29980;386683;337979;8568;100288323;54149;6450;4731;6493;539;104;54093;5822;6453;4047;54039;337985;7033;353333;23181;3454;25825;23275;2618;337976;2078;3455;1525;140258;56246;64968;49854;89766;754;3460;6647;54065;150051;58494;80781;7327;10785;337879;10841;54033;3753;337972;6782;150084;643803;728299;9992;386672;5211;861;11096;2897;56894;54084;6285;3689;8209;1859;29104;337960;7485;386676;571;386680;7267;53347;7074;5152;10311;150082;3772;3275;54059;8208;9510;10317;5116;84221;29947;337959;4685;6612;337968;755;1291;351;875;10069;7032;100131902;522;53820;9980;337963;337967;353323;7031;3588;6526;10215;7109;140578;386674;386675;23076;6573;3763;2114;353332;3141;4600;337971;54058;8204;386677;89765;30811;337974;337977;5651;337969;388813;57466;140290;54069;2551;757;10600;90625;23562;23308;26285;10694;386678;337975;337880;100288287;54102;317754;6651;8888;8867;94104;64092;25966;54020;337966;9619;386684;388818;337978;386682;254950;54097;56911;873;29761;284827;81543;7226,213
1,1,21,15006457,48097372,33090915,54148;4599;5316;337882;106865373;1409;54101;9875;1826;9073;386679;874;51227;10950;337970;101928147;386681;56245;54943;643812;326;5121;1476;9946;116448;1292;64699;11077;1827;3150;63977;10281;149998;337973;8566;26046;7307;7113;54014;116159;56683;150094;85395;59271;386685;23515;337878;8624;29980;386683;337979;8568;100288323;54149;6450;4731;6493;539;104;54093;5822;6453;4047;54039;337985;7033;353333;23181;3454;25825;23275;2618;337976;2078;3455;1525;140258;56246;64968;49854;89766;754;3460;6647;54065;150051;58494;80781;7327;10785;337879;10841;54033;3753;337972;6782;150084;643803;728299;9992;386672;5211;861;11096;2897;56894;54084;6285;3689;8209;1859;29104;337960;7485;386676;571;386680;7267;53347;7074;5152;10311;150082;3772;3275;54059;8208;9510;10317;5116;84221;29947;337959;4685;6612;337968;755;1291;351;875;10069;7032;100131902;522;53820;9980;337963;337967;353323;7031;3588;6526;10215;7109;140578;386674;386675;23076;6573;3763;2114;353332;3141;4600;337971;54058;8204;386677;89765;30811;337974;337977;5651;337969;388813;57466;140290;54069;2551;757;10600;90625;23562;23308;26285;10694;386678;337975;337880;100288287;54102;317754;6651;8888;8867;94104;64092;25966;54020;337966;9619;386684;388818;337978;386682;254950;54097;56911;873;29761;284827;81543;7226,213
1,1,21,15006457,48097372,33090915,54148;4599;5316;337882;106865373;1409;54101;9875;1826;9073;386679;874;51227;10950;337970;101928147;386681;56245;54943;643812;326;5121;1476;9946;116448;1292;64699;11077;1827;3150;63977;10281;149998;337973;8566;26046;7307;7113;54014;116159;56683;150094;85395;59271;386685;23515;337878;8624;29980;386683;337979;8568;100288323;54149;6450;4731;6493;539;104;54093;5822;6453;4047;54039;337985;7033;353333;23181;3454;25825;23275;2618;337976;2078;3455;1525;140258;56246;64968;49854;89766;754;3460;6647;54065;150051;58494;80781;7327;10785;337879;10841;54033;3753;337972;6782;150084;643803;728299;9992;386672;5211;861;11096;2897;56894;54084;6285;3689;8209;1859;29104;337960;7485;386676;571;386680;7267;53347;7074;5152;10311;150082;3772;3275;54059;8208;9510;10317;5116;84221;29947;337959;4685;6612;337968;755;1291;351;875;10069;7032;100131902;522;53820;9980;337963;337967;353323;7031;3588;6526;10215;7109;140578;386674;386675;23076;6573;3763;2114;353332;3141;4600;337971;54058;8204;386677;89765;30811;337974;337977;5651;337969;388813;57466;140290;54069;2551;757;10600;90625;23562;23308;26285;10694;386678;337975;337880;100288287;54102;317754;6651;8888;8867;94104;64092;25966;54020;337966;9619;386684;388818;337978;386682;254950;54097;56911;873;29761;284827;81543;7226,213
1,1,21,15006457,48097372,33090915,54148;4599;5316;337882;106865373;1409;54101;9875;1826;9073;386679;874;51227;10950;337970;101928147;386681;56245;54943;643812;326;5121;1476;9946;116448;1292;64699;11077;1827;3150;63977;10281;149998;337973;8566;26046;7307;7113;54014;116159;56683;150094;85395;59271;386685;23515;337878;8624;29980;386683;337979;8568;100288323;54149;6450;4731;6493;539;104;54093;5822;6453;4047;54039;337985;7033;353333;23181;3454;25825;23275;2618;337976;2078;3455;1525;140258;56246;64968;49854;89766;754;3460;6647;54065;150051;58494;80781;7327;10785;337879;10841;54033;3753;337972;6782;150084;643803;728299;9992;386672;5211;861;11096;2897;56894;54084;6285;3689;8209;1859;29104;337960;7485;386676;571;386680;7267;53347;7074;5152;10311;150082;3772;3275;54059;8208;9510;10317;5116;84221;29947;337959;4685;6612;337968;755;1291;351;875;10069;7032;100131902;522;53820;9980;337963;337967;353323;7031;3588;6526;10215;7109;140578;386674;386675;23076;6573;3763;2114;353332;3141;4600;337971;54058;8204;386677;89765;30811;337974;337977;5651;337969;388813;57466;140290;54069;2551;757;10600;90625;23562;23308;26285;10694;386678;337975;337880;100288287;54102;317754;6651;8888;8867;94104;64092;25966;54020;337966;9619;386684;388818;337978;386682;254950;54097;56911;873;29761;284827;81543;7226,213
1,1,21,15006457,48097372,33090915,54148;4599;5316;337882;106865373;1409;54101;9875;1826;9073;386679;874;51227;10950;337970;101928147;386681;56245;54943;643812;326;5121;1476;9946;116448;1292;64699;11077;1827;3150;63977;10281;149998;337973;8566;26046;7307;7113;54014;116159;56683;150094;85395;59271;386685;23515;337878;8624;29980;386683;337979;8568;100288323;54149;6450;4731;6493;539;104;54093;5822;6453;4047;54039;337985;7033;353333;23181;3454;25825;23275;2618;337976;2078;3455;1525;140258;56246;64968;49854;89766;754;3460;6647;54065;150051;58494;80781;7327;10785;337879;10841;54033;3753;337972;6782;150084;643803;728299;9992;386672;5211;861;11096;2897;56894;54084;6285;3689;8209;1859;29104;337960;7485;386676;571;386680;7267;53347;7074;5152;10311;150082;3772;3275;54059;8208;9510;10317;5116;84221;29947;337959;4685;6612;337968;755;1291;351;875;10069;7032;100131902;522;53820;9980;337963;337967;353323;7031;3588;6526;10215;7109;140578;386674;386675;23076;6573;3763;2114;353332;3141;4600;337971;54058;8204;386677;89765;30811;337974;337977;5651;337969;388813;57466;140290;54069;2551;757;10600;90625;23562;23308;26285;10694;386678;337975;337880;100288287;54102;317754;6651;8888;8867;94104;64092;25966;54020;337966;9619;386684;388818;337978;386682;254950;54097;56911;873;29761;284827;81543;7226,213
1,1,21,15006457,48097372,33090915,54148;4599;5316;337882;106865373;1409;54101;9875;1826;9073;386679;874;51227;10950;337970;101928147;386681;56245;54943;643812;326;5121;1476;9946;116448;1292;64699;11077;1827;3150;63977;10281;149998;337973;8566;26046;7307;7113;54014;116159;56683;150094;85395;59271;386685;23515;337878;8624;29980;386683;337979;8568;100288323;54149;6450;4731;6493;539;104;54093;5822;6453;4047;54039;337985;7033;353333;23181;3454;25825;23275;2618;337976;2078;3455;1525;140258;56246;64968;49854;89766;754;3460;6647;54065;150051;58494;80781;7327;10785;337879;10841;54033;3753;337972;6782;150084;643803;728299;9992;386672;5211;861;11096;2897;56894;54084;6285;3689;8209;1859;29104;337960;7485;386676;571;386680;7267;53347;7074;5152;10311;150082;3772;3275;54059;8208;9510;10317;5116;84221;29947;337959;4685;6612;337968;755;1291;351;875;10069;7032;100131902;522;53820;9980;337963;337967;353323;7031;3588;6526;10215;7109;140578;386674;386675;23076;6573;3763;2114;353332;3141;4600;337971;54058;8204;386677;89765;30811;337974;337977;5651;337969;388813;57466;140290;54069;2551;757;10600;90625;23562;23308;26285;10694;386678;337975;337880;100288287;54102;317754;6651;8888;8867;94104;64092;25966;54020;337966;9619;386684;388818;337978;386682;254950;54097;56911;873;29761;284827;81543;7226,213
1,1,21,15006457,48097372,33090915,54148;4599;5316;337882;106865373;1409;54101;9875;1826;9073;386679;874;51227;10950;337970;101928147;386681;56245;54943;643812;326;5121;1476;9946;116448;1292;64699;11077;1827;3150;63977;10281;149998;337973;8566;26046;7307;7113;54014;116159;56683;150094;85395;59271;386685;23515;337878;8624;29980;386683;337979;8568;100288323;54149;6450;4731;6493;539;104;54093;5822;6453;4047;54039;337985;7033;353333;23181;3454;25825;23275;2618;337976;2078;3455;1525;140258;56246;64968;49854;89766;754;3460;6647;54065;150051;58494;80781;7327;10785;337879;10841;54033;3753;337972;6782;150084;643803;728299;9992;386672;5211;861;11096;2897;56894;54084;6285;3689;8209;1859;29104;337960;7485;386676;571;386680;7267;53347;7074;5152;10311;150082;3772;3275;54059;8208;9510;10317;5116;84221;29947;337959;4685;6612;337968;755;1291;351;875;10069;7032;100131902;522;53820;9980;337963;337967;353323;7031;3588;6526;10215;7109;140578;386674;386675;23076;6573;3763;2114;353332;3141;4600;337971;54058;8204;386677;89765;30811;337974;337977;5651;337969;388813;57466;140290;54069;2551;757;10600;90625;23562;23308;26285;10694;386678;337975;337880;100288287;54102;317754;6651;8888;8867;94104;64092;25966;54020;337966;9619;386684;388818;337978;386682;254950;54097;56911;873;29761;284827;81543;7226,213
1,1,21,15006457,48097372,33090915,54148;4599;5316;337882;106865373;1409;54101;9875;1826;9073;386679;874;51227;10950;337970;101928147;386681;56245;54943;643812;326;5121;1476;9946;116448;1292;64699;11077;1827;3150;63977;10281;149998;337973;8566;26046;7307;7113;54014;116159;56683;150094;85395;59271;386685;23515;337878;8624;29980;386683;337979;8568;100288323;54149;6450;4731;6493;539;104;54093;5822;6453;4047;54039;337985;7033;353333;23181;3454;25825;23275;2618;337976;2078;3455;1525;140258;56246;64968;49854;89766;754;3460;6647;54065;150051;58494;80781;7327;10785;337879;10841;54033;3753;337972;6782;150084;643803;728299;9992;386672;5211;861;11096;2897;56894;54084;6285;3689;8209;1859;29104;337960;7485;386676;571;386680;7267;53347;7074;5152;10311;150082;3772;3275;54059;8208;9510;10317;5116;84221;29947;337959;4685;6612;337968;755;1291;351;875;10069;7032;100131902;522;53820;9980;337963;337967;353323;7031;3588;6526;10215;7109;140578;386674;386675;23076;6573;3763;2114;353332;3141;4600;337971;54058;8204;386677;89765;30811;337974;337977;5651;337969;388813;57466;140290;54069;2551;757;10600;90625;23562;23308;26285;10694;386678;337975;337880;100288287;54102;317754;6651;8888;8867;94104;64092;25966;54020;337966;9619;386684;388818;337978;386682;254950;54097;56911;873;29761;284827;81543;7226,213
1,1,21,15006457,48097372,33090915,54148;4599;5316;337882;106865373;1409;54101;9875;1826;9073;386679;874;51227;10950;337970;101928147;386681;56245;54943;643812;326;5121;1476;9946;116448;1292;64699;11077;1827;3150;63977;10281;149998;337973;8566;26046;7307;7113;54014;116159;56683;150094;85395;59271;386685;23515;337878;8624;29980;386683;337979;8568;100288323;54149;6450;4731;6493;539;104;54093;5822;6453;4047;54039;337985;7033;353333;23181;3454;25825;23275;2618;337976;2078;3455;1525;140258;56246;64968;49854;89766;754;3460;6647;54065;150051;58494;80781;7327;10785;337879;10841;54033;3753;337972;6782;150084;643803;728299;9992;386672;5211;861;11096;2897;56894;54084;6285;3689;8209;1859;29104;337960;7485;386676;571;386680;7267;53347;7074;5152;10311;150082;3772;3275;54059;8208;9510;10317;5116;84221;29947;337959;4685;6612;337968;755;1291;351;875;10069;7032;100131902;522;53820;9980;337963;337967;353323;7031;3588;6526;10215;7109;140578;386674;386675;23076;6573;3763;2114;353332;3141;4600;337971;54058;8204;386677;89765;30811;337974;337977;5651;337969;388813;57466;140290;54069;2551;757;10600;90625;23562;23308;26285;10694;386678;337975;337880;100288287;54102;317754;6651;8888;8867;94104;64092;25966;54020;337966;9619;386684;388818;337978;386682;254950;54097;56911;873;29761;284827;81543;7226,213
1,1,21,15006457,48097372,33090915,54148;4599;5316;337882;106865373;1409;54101;9875;1826;9073;386679;874;51227;10950;337970;101928147;386681;56245;54943;643812;326;5121;1476;9946;116448;1292;64699;11077;1827;3150;63977;10281;149998;337973;8566;26046;7307;7113;54014;116159;56683;150094;85395;59271;386685;23515;337878;8624;29980;386683;337979;8568;100288323;54149;6450;4731;6493;539;104;54093;5822;6453;4047;54039;337985;7033;353333;23181;3454;25825;23275;2618;337976;2078;3455;1525;140258;56246;64968;49854;89766;754;3460;6647;54065;150051;58494;80781;7327;10785;337879;10841;54033;3753;337972;6782;150084;643803;728299;9992;386672;5211;861;11096;2897;56894;54084;6285;3689;8209;1859;29104;337960;7485;386676;571;386680;7267;53347;7074;5152;10311;150082;3772;3275;54059;8208;9510;10317;5116;84221;29947;337959;4685;6612;337968;755;1291;351;875;10069;7032;100131902;522;53820;9980;337963;337967;353323;7031;3588;6526;10215;7109;140578;386674;386675;23076;6573;3763;2114;353332;3141;4600;337971;54058;8204;386677;89765;30811;337974;337977;5651;337969;388813;57466;140290;54069;2551;757;10600;90625;23562;23308;26285;10694;386678;337975;337880;100288287;54102;317754;6651;8888;8867;94104;64092;25966;54020;337966;9619;386684;388818;337978;386682;254950;54097;56911;873;29761;284827;81543;7226,213
1,1,21,15006457,48097372,33090915,54148;4599;5316;337882;106865373;1409;54101;9875;1826;9073;386679;874;51227;10950;337970;101928147;386681;56245;54943;643812;326;5121;1476;9946;116448;1292;64699;11077;1827;3150;63977;10281;149998;337973;8566;26046;7307;7113;54014;116159;56683;150094;85395;59271;386685;23515;337878;8624;29980;386683;337979;8568;100288323;54149;6450;4731;6493;539;104;54093;5822;6453;4047;54039;337985;7033;353333;23181;3454;25825;23275;2618;337976;2078;3455;1525;140258;56246;64968;49854;89766;754;3460;6647;54065;150051;58494;80781;7327;10785;337879;10841;54033;3753;337972;6782;150084;643803;728299;9992;386672;5211;861;11096;2897;56894;54084;6285;3689;8209;1859;29104;337960;7485;386676;571;386680;7267;53347;7074;5152;10311;150082;3772;3275;54059;8208;9510;10317;5116;84221;29947;337959;4685;6612;337968;755;1291;351;875;10069;7032;100131902;522;53820;9980;337963;337967;353323;7031;3588;6526;10215;7109;140578;386674;386675;23076;6573;3763;2114;353332;3141;4600;337971;54058;8204;386677;89765;30811;337974;337977;5651;337969;388813;57466;140290;54069;2551;757;10600;90625;23562;23308;26285;10694;386678;337975;337880;100288287;54102;317754;6651;8888;8867;94104;64092;25966;54020;337966;9619;386684;388818;337978;386682;254950;54097;56911;873;29761;284827;81543;7226,213
1,1,21,15006457,48097372,33090915,54148;4599;5316;337882;106865373;1409;54101;9875;1826;9073;386679;874;51227;10950;337970;101928147;386681;56245;54943;643812;326;5121;1476;9946;116448;1292;64699;11077;1827;3150;63977;10281;149998;337973;8566;26046;7307;7113;54014;116159;56683;150094;85395;59271;386685;23515;337878;8624;29980;386683;337979;8568;100288323;54149;6450;4731;6493;539;104;54093;5822;6453;4047;54039;337985;7033;353333;23181;3454;25825;23275;2618;337976;2078;3455;1525;140258;56246;64968;49854;89766;754;3460;6647;54065;150051;58494;80781;7327;10785;337879;10841;54033;3753;337972;6782;150084;643803;728299;9992;386672;5211;861;11096;2897;56894;54084;6285;3689;8209;1859;29104;337960;7485;386676;571;386680;7267;53347;7074;5152;10311;150082;3772;3275;54059;8208;9510;10317;5116;84221;29947;337959;4685;6612;337968;755;1291;351;875;10069;7032;100131902;522;53820;9980;337963;337967;353323;7031;3588;6526;10215;7109;140578;386674;386675;23076;6573;3763;2114;353332;3141;4600;337971;54058;8204;386677;89765;30811;337974;337977;5651;337969;388813;57466;140290;54069;2551;757;10600;90625;23562;23308;26285;10694;386678;337975;337880;100288287;54102;317754;6651;8888;8867;94104;64092;25966;54020;337966;9619;386684;388818;337978;386682;254950;54097;56911;873;29761;284827;81543;7226,213
1,1,21,15006457,48097372,33090915,54148;4599;5316;337882;106865373;1409;54101;9875;1826;9073;386679;874;51227;10950;337970;101928147;386681;56245;54943;643812;326;5121;1476;9946;116448;1292;64699;11077;1827;3150;63977;10281;149998;337973;8566;26046;7307;7113;54014;116159;56683;150094;85395;59271;386685;23515;337878;8624;29980;386683;337979;8568;100288323;54149;6450;4731;6493;539;104;54093;5822;6453;4047;54039;337985;7033;353333;23181;3454;25825;23275;2618;337976;2078;3455;1525;140258;56246;64968;49854;89766;754;3460;6647;54065;150051;58494;80781;7327;10785;337879;10841;54033;3753;337972;6782;150084;643803;728299;9992;386672;5211;861;11096;2897;56894;54084;6285;3689;8209;1859;29104;337960;7485;386676;571;386680;7267;53347;7074;5152;10311;150082;3772;3275;54059;8208;9510;10317;5116;84221;29947;337959;4685;6612;337968;755;1291;351;875;10069;7032;100131902;522;53820;9980;337963;337967;353323;7031;3588;6526;10215;7109;140578;386674;386675;23076;6573;3763;2114;353332;3141;4600;337971;54058;8204;386677;89765;30811;337974;337977;5651;337969;388813;57466;140290;54069;2551;757;10600;90625;23562;23308;26285;10694;386678;337975;337880;100288287;54102;317754;6651;8888;8867;94104;64092;25966;54020;337966;9619;386684;388818;337978;386682;254950;54097;56911;873;29761;284827;81543;7226,213
1,1,21,15006457,48097372,33090915,54148;4599;5316;337882;106865373;1409;54101;9875;1826;9073;386679;874;51227;10950;337970;101928147;386681;56245;54943;643812;326;5121;1476;9946;116448;1292;64699;11077;1827;3150;63977;10281;149998;337973;8566;26046;7307;7113;54014;116159;56683;150094;85395;59271;386685;23515;337878;8624;29980;386683;337979;8568;100288323;54149;6450;4731;6493;539;104;54093;5822;6453;4047;54039;337985;7033;353333;23181;3454;25825;23275;2618;337976;2078;3455;1525;140258;56246;64968;49854;89766;754;3460;6647;54065;150051;58494;80781;7327;10785;337879;10841;54033;3753;337972;6782;150084;643803;728299;9992;386672;5211;861;11096;2897;56894;54084;6285;3689;8209;1859;29104;337960;7485;386676;571;386680;7267;53347;7074;5152;10311;150082;3772;3275;54059;8208;9510;10317;5116;84221;29947;337959;4685;6612;337968;755;1291;351;875;10069;7032;100131902;522;53820;9980;337963;337967;353323;7031;3588;6526;10215;7109;140578;386674;386675;23076;6573;3763;2114;353332;3141;4600;337971;54058;8204;386677;89765;30811;337974;337977;5651;337969;388813;57466;140290;54069;2551;757;10600;90625;23562;23308;26285;10694;386678;337975;337880;100288287;54102;317754;6651;8888;8867;94104;64092;25966;54020;337966;9619;386684;388818;337978;386682;254950;54097;56911;873;29761;284827;81543;7226,213
1,1,21,15006457,48097372,33090915,54148;4599;5316;337882;106865373;1409;54101;9875;1826;9073;386679;874;51227;10950;337970;101928147;386681;56245;54943;643812;326;5121;1476;9946;116448;1292;64699;11077;1827;3150;63977;10281;149998;337973;8566;26046;7307;7113;54014;116159;56683;150094;85395;59271;386685;23515;337878;8624;29980;386683;337979;8568;100288323;54149;6450;4731;6493;539;104;54093;5822;6453;4047;54039;337985;7033;353333;23181;3454;25825;23275;2618;337976;2078;3455;1525;140258;56246;64968;49854;89766;754;3460;6647;54065;150051;58494;80781;7327;10785;337879;10841;54033;3753;337972;6782;150084;643803;728299;9992;386672;5211;861;11096;2897;56894;54084;6285;3689;8209;1859;29104;337960;7485;386676;571;386680;7267;53347;7074;5152;10311;150082;3772;3275;54059;8208;9510;10317;5116;84221;29947;337959;4685;6612;337968;755;1291;351;875;10069;7032;100131902;522;53820;9980;337963;337967;353323;7031;3588;6526;10215;7109;140578;386674;386675;23076;6573;3763;2114;353332;3141;4600;337971;54058;8204;386677;89765;30811;337974;337977;5651;337969;388813;57466;140290;54069;2551;757;10600;90625;23562;23308;26285;10694;386678;337975;337880;100288287;54102;317754;6651;8888;8867;94104;64092;25966;54020;337966;9619;386684;388818;337978;386682;254950;54097;56911;873;29761;284827;81543;7226,213
1,1,21,15006457,48097372,33090915,54148;4599;5316;337882;106865373;1409;54101;9875;1826;9073;386679;874;51227;10950;337970;101928147;386681;56245;54943;643812;326;5121;1476;9946;116448;1292;64699;11077;1827;3150;63977;10281;149998;337973;8566;26046;7307;7113;54014;116159;56683;150094;85395;59271;386685;23515;337878;8624;29980;386683;337979;8568;100288323;54149;6450;4731;6493;539;104;54093;5822;6453;4047;54039;337985;7033;353333;23181;3454;25825;23275;2618;337976;2078;3455;1525;140258;56246;64968;49854;89766;754;3460;6647;54065;150051;58494;80781;7327;10785;337879;10841;54033;3753;337972;6782;150084;643803;728299;9992;386672;5211;861;11096;2897;56894;54084;6285;3689;8209;1859;29104;337960;7485;386676;571;386680;7267;53347;7074;5152;10311;150082;3772;3275;54059;8208;9510;10317;5116;84221;29947;337959;4685;6612;337968;755;1291;351;875;10069;7032;100131902;522;53820;9980;337963;337967;353323;7031;3588;6526;10215;7109;140578;386674;386675;23076;6573;3763;2114;353332;3141;4600;337971;54058;8204;386677;89765;30811;337974;337977;5651;337969;388813;57466;140290;54069;2551;757;10600;90625;23562;23308;26285;10694;386678;337975;337880;100288287;54102;317754;6651;8888;8867;94104;64092;25966;54020;337966;9619;386684;388818;337978;386682;254950;54097;56911;873;29761;284827;81543;7226,213
1,1,21,15006457,48097372,33090915,54148;4599;5316;337882;106865373;1409;54101;9875;1826;9073;386679;874;51227;10950;337970;101928147;386681;56245;54943;643812;326;5121;1476;9946;116448;1292;64699;11077;1827;3150;63977;10281;149998;337973;8566;26046;7307;7113;54014;116159;56683;150094;85395;59271;386685;23515;337878;8624;29980;386683;337979;8568;100288323;54149;6450;4731;6493;539;104;54093;5822;6453;4047;54039;337985;7033;353333;23181;3454;25825;23275;2618;337976;2078;3455;1525;140258;56246;64968;49854;89766;754;3460;6647;54065;150051;58494;80781;7327;10785;337879;10841;54033;3753;337972;6782;150084;643803;728299;9992;386672;5211;861;11096;2897;56894;54084;6285;3689;8209;1859;29104;337960;7485;386676;571;386680;7267;53347;7074;5152;10311;150082;3772;3275;54059;8208;9510;10317;5116;84221;29947;337959;4685;6612;337968;755;1291;351;875;10069;7032;100131902;522;53820;9980;337963;337967;353323;7031;3588;6526;10215;7109;140578;386674;386675;23076;6573;3763;2114;353332;3141;4600;337971;54058;8204;386677;89765;30811;337974;337977;5651;337969;388813;57466;140290;54069;2551;757;10600;90625;23562;23308;26285;10694;386678;337975;337880;100288287;54102;317754;6651;8888;8867;94104;64092;25966;54020;337966;9619;386684;388818;337978;386682;254950;54097;56911;873;29761;284827;81543;7226,213
1,1,21,15006457,48097372,33090915,54148;4599;5316;337882;106865373;1409;54101;9875;1826;9073;386679;874;51227;10950;337970;101928147;386681;56245;54943;643812;326;5121;1476;9946;116448;1292;64699;11077;1827;3150;63977;10281;149998;337973;8566;26046;7307;7113;54014;116159;56683;150094;85395;59271;386685;23515;337878;8624;29980;386683;337979;8568;100288323;54149;6450;4731;6493;539;104;54093;5822;6453;4047;54039;337985;7033;353333;23181;3454;25825;23275;2618;337976;2078;3455;1525;140258;56246;64968;49854;89766;754;3460;6647;54065;150051;58494;80781;7327;10785;337879;10841;54033;3753;337972;6782;150084;643803;728299;9992;386672;5211;861;11096;2897;56894;54084;6285;3689;8209;1859;29104;337960;7485;386676;571;386680;7267;53347;7074;5152;10311;150082;3772;3275;54059;8208;9510;10317;5116;84221;29947;337959;4685;6612;337968;755;1291;351;875;10069;7032;100131902;522;53820;9980;337963;337967;353323;7031;3588;6526;10215;7109;140578;386674;386675;23076;6573;3763;2114;353332;3141;4600;337971;54058;8204;386677;89765;30811;337974;337977;5651;337969;388813;57466;140290;54069;2551;757;10600;90625;23562;23308;26285;10694;386678;337975;337880;100288287;54102;317754;6651;8888;8867;94104;64092;25966;54020;337966;9619;386684;388818;337978;386682;254950;54097;56911;873;29761;284827;81543;7226,213
1,1,21,15006457,48097372,33090915,54148;4599;5316;337882;106865373;1409;54101;9875;1826;9073;386679;874;51227;10950;337970;101928147;386681;56245;54943;643812;326;5121;1476;9946;116448;1292;64699;11077;1827;3150;63977;10281;149998;337973;8566;26046;7307;7113;54014;116159;56683;150094;85395;59271;386685;23515;337878;8624;29980;386683;337979;8568;100288323;54149;6450;4731;6493;539;104;54093;5822;6453;4047;54039;337985;7033;353333;23181;3454;25825;23275;2618;337976;2078;3455;1525;140258;56246;64968;49854;89766;754;3460;6647;54065;150051;58494;80781;7327;10785;337879;10841;54033;3753;337972;6782;150084;643803;728299;9992;386672;5211;861;11096;2897;56894;54084;6285;3689;8209;1859;29104;337960;7485;386676;571;386680;7267;53347;7074;5152;10311;150082;3772;3275;54059;8208;9510;10317;5116;84221;29947;337959;4685;6612;337968;755;1291;351;875;10069;7032;100131902;522;53820;9980;337963;337967;353323;7031;3588;6526;10215;7109;140578;386674;386675;23076;6573;3763;2114;353332;3141;4600;337971;54058;8204;386677;89765;30811;337974;337977;5651;337969;388813;57466;140290;54069;2551;757;10600;90625;23562;23308;26285;10694;386678;337975;337880;100288287;54102;317754;6651;8888;8867;94104;64092;25966;54020;337966;9619;386684;388818;337978;386682;254950;54097;56911;873;29761;284827;81543;7226,213
1,1,21,15006457,48097372,33090915,54148;4599;5316;337882;106865373;1409;54101;9875;1826;9073;386679;874;51227;10950;337970;101928147;386681;56245;54943;643812;326;5121;1476;9946;116448;1292;64699;11077;1827;3150;63977;10281;149998;337973;8566;26046;7307;7113;54014;116159;56683;150094;85395;59271;386685;23515;337878;8624;29980;386683;337979;8568;100288323;54149;6450;4731;6493;539;104;54093;5822;6453;4047;54039;337985;7033;353333;23181;3454;25825;23275;2618;337976;2078;3455;1525;140258;56246;64968;49854;89766;754;3460;6647;54065;150051;58494;80781;7327;10785;337879;10841;54033;3753;337972;6782;150084;643803;728299;9992;386672;5211;861;11096;2897;56894;54084;6285;3689;8209;1859;29104;337960;7485;386676;571;386680;7267;53347;7074;5152;10311;150082;3772;3275;54059;8208;9510;10317;5116;84221;29947;337959;4685;6612;337968;755;1291;351;875;10069;7032;100131902;522;53820;9980;337963;337967;353323;7031;3588;6526;10215;7109;140578;386674;386675;23076;6573;3763;2114;353332;3141;4600;337971;54058;8204;386677;89765;30811;337974;337977;5651;337969;388813;57466;140290;54069;2551;757;10600;90625;23562;23308;26285;10694;386678;337975;337880;100288287;54102;317754;6651;8888;8867;94104;64092;25966;54020;337966;9619;386684;388818;337978;386682;254950;54097;56911;873;29761;284827;81543;7226,213
1,1,21,15006457,48097372,33090915,54148;4599;5316;337882;106865373;1409;54101;9875;1826;9073;386679;874;51227;10950;337970;101928147;386681;56245;54943;643812;326;5121;1476;9946;116448;1292;64699;11077;1827;3150;63977;10281;149998;337973;8566;26046;7307;7113;54014;116159;56683;150094;85395;59271;386685;23515;337878;8624;29980;386683;337979;8568;100288323;54149;6450;4731;6493;539;104;54093;5822;6453;4047;54039;337985;7033;353333;23181;3454;25825;23275;2618;337976;2078;3455;1525;140258;56246;64968;49854;89766;754;3460;6647;54065;150051;58494;80781;7327;10785;337879;10841;54033;3753;337972;6782;150084;643803;728299;9992;386672;5211;861;11096;2897;56894;54084;6285;3689;8209;1859;29104;337960;7485;386676;571;386680;7267;53347;7074;5152;10311;150082;3772;3275;54059;8208;9510;10317;5116;84221;29947;337959;4685;6612;337968;755;1291;351;875;10069;7032;100131902;522;53820;9980;337963;337967;353323;7031;3588;6526;10215;7109;140578;386674;386675;23076;6573;3763;2114;353332;3141;4600;337971;54058;8204;386677;89765;30811;337974;337977;5651;337969;388813;57466;140290;54069;2551;757;10600;90625;23562;23308;26285;10694;386678;337975;337880;100288287;54102;317754;6651;8888;8867;94104;64092;25966;54020;337966;9619;386684;388818;337978;386682;254950;54097;56911;873;29761;284827;81543;7226,213
1,1,21,15006457,48097372,33090915,54148;4599;5316;337882;106865373;1409;54101;9875;1826;9073;386679;874;51227;10950;337970;101928147;386681;56245;54943;643812;326;5121;1476;9946;116448;1292;64699;11077;1827;3150;63977;10281;149998;337973;8566;26046;7307;7113;54014;116159;56683;150094;85395;59271;386685;23515;337878;8624;29980;386683;337979;8568;100288323;54149;6450;4731;6493;539;104;54093;5822;6453;4047;54039;337985;7033;353333;23181;3454;25825;23275;2618;337976;2078;3455;1525;140258;56246;64968;49854;89766;754;3460;6647;54065;150051;58494;80781;7327;10785;337879;10841;54033;3753;337972;6782;150084;643803;728299;9992;386672;5211;861;11096;2897;56894;54084;6285;3689;8209;1859;29104;337960;7485;386676;571;386680;7267;53347;7074;5152;10311;150082;3772;3275;54059;8208;9510;10317;5116;84221;29947;337959;4685;6612;337968;755;1291;351;875;10069;7032;100131902;522;53820;9980;337963;337967;353323;7031;3588;6526;10215;7109;140578;386674;386675;23076;6573;3763;2114;353332;3141;4600;337971;54058;8204;386677;89765;30811;337974;337977;5651;337969;388813;57466;140290;54069;2551;757;10600;90625;23562;23308;26285;10694;386678;337975;337880;100288287;54102;317754;6651;8888;8867;94104;64092;25966;54020;337966;9619;386684;388818;337978;386682;254950;54097;56911;873;29761;284827;81543;7226,213
1,1,21,15006457,48097372,33090915,54148;4599;5316;337882;106865373;1409;54101;9875;1826;9073;386679;874;51227;10950;337970;101928147;386681;56245;54943;643812;326;5121;1476;9946;116448;1292;64699;11077;1827;3150;63977;10281;149998;337973;8566;26046;7307;7113;54014;116159;56683;150094;85395;59271;386685;23515;337878;8624;29980;386683;337979;8568;100288323;54149;6450;4731;6493;539;104;54093;5822;6453;4047;54039;337985;7033;353333;23181;3454;25825;23275;2618;337976;2078;3455;1525;140258;56246;64968;49854;89766;754;3460;6647;54065;150051;58494;80781;7327;10785;337879;10841;54033;3753;337972;6782;150084;643803;728299;9992;386672;5211;861;11096;2897;56894;54084;6285;3689;8209;1859;29104;337960;7485;386676;571;386680;7267;53347;7074;5152;10311;150082;3772;3275;54059;8208;9510;10317;5116;84221;29947;337959;4685;6612;337968;755;1291;351;875;10069;7032;100131902;522;53820;9980;337963;337967;353323;7031;3588;6526;10215;7109;140578;386674;386675;23076;6573;3763;2114;353332;3141;4600;337971;54058;8204;386677;89765;30811;337974;337977;5651;337969;388813;57466;140290;54069;2551;757;10600;90625;23562;23308;26285;10694;386678;337975;337880;100288287;54102;317754;6651;8888;8867;94104;64092;25966;54020;337966;9619;386684;388818;337978;386682;254950;54097;56911;873;29761;284827;81543;7226,213
1,1,21,15006457,48097372,33090915,54148;4599;5316;337882;106865373;1409;54101;9875;1826;9073;386679;874;51227;10950;337970;101928147;386681;56245;54943;643812;326;5121;1476;9946;116448;1292;64699;11077;1827;3150;63977;10281;149998;337973;8566;26046;7307;7113;54014;116159;56683;150094;85395;59271;386685;23515;337878;8624;29980;386683;337979;8568;100288323;54149;6450;4731;6493;539;104;54093;5822;6453;4047;54039;337985;7033;353333;23181;3454;25825;23275;2618;337976;2078;3455;1525;140258;56246;64968;49854;89766;754;3460;6647;54065;150051;58494;80781;7327;10785;337879;10841;54033;3753;337972;6782;150084;643803;728299;9992;386672;5211;861;11096;2897;56894;54084;6285;3689;8209;1859;29104;337960;7485;386676;571;386680;7267;53347;7074;5152;10311;150082;3772;3275;54059;8208;9510;10317;5116;84221;29947;337959;4685;6612;337968;755;1291;351;875;10069;7032;100131902;522;53820;9980;337963;337967;353323;7031;3588;6526;10215;7109;140578;386674;386675;23076;6573;3763;2114;353332;3141;4600;337971;54058;8204;386677;89765;30811;337974;337977;5651;337969;388813;57466;140290;54069;2551;757;10600;90625;23562;23308;26285;10694;386678;337975;337880;100288287;54102;317754;6651;8888;8867;94104;64092;25966;54020;337966;9619;386684;388818;337978;386682;254950;54097;56911;873;29761;284827;81543;7226,213
1,1,21,15006457,48097372,33090915,54148;4599;5316;337882;106865373;1409;54101;9875;1826;9073;386679;874;51227;10950;337970;101928147;386681;56245;54943;643812;326;5121;1476;9946;116448;1292;64699;11077;1827;3150;63977;10281;149998;337973;8566;26046;7307;7113;54014;116159;56683;150094;85395;59271;386685;23515;337878;8624;29980;386683;337979;8568;100288323;54149;6450;4731;6493;539;104;54093;5822;6453;4047;54039;337985;7033;353333;23181;3454;25825;23275;2618;337976;2078;3455;1525;140258;56246;64968;49854;89766;754;3460;6647;54065;150051;58494;80781;7327;10785;337879;10841;54033;3753;337972;6782;150084;643803;728299;9992;386672;5211;861;11096;2897;56894;54084;6285;3689;8209;1859;29104;337960;7485;386676;571;386680;7267;53347;7074;5152;10311;150082;3772;3275;54059;8208;9510;10317;5116;84221;29947;337959;4685;6612;337968;755;1291;351;875;10069;7032;100131902;522;53820;9980;337963;337967;353323;7031;3588;6526;10215;7109;140578;386674;386675;23076;6573;3763;2114;353332;3141;4600;337971;54058;8204;386677;89765;30811;337974;337977;5651;337969;388813;57466;140290;54069;2551;757;10600;90625;23562;23308;26285;10694;386678;337975;337880;100288287;54102;317754;6651;8888;8867;94104;64092;25966;54020;337966;9619;386684;388818;337978;386682;254950;54097;56911;873;29761;284827;81543;7226,213
1,1,21,15006457,48097372,33090915,54148;4599;5316;337882;106865373;1409;54101;9875;1826;9073;386679;874;51227;10950;337970;101928147;386681;56245;54943;643812;326;5121;1476;9946;116448;1292;64699;11077;1827;3150;63977;10281;149998;337973;8566;26046;7307;7113;54014;116159;56683;150094;85395;59271;386685;23515;337878;8624;29980;386683;337979;8568;100288323;54149;6450;4731;6493;539;104;54093;5822;6453;4047;54039;337985;7033;353333;23181;3454;25825;23275;2618;337976;2078;3455;1525;140258;56246;64968;49854;89766;754;3460;6647;54065;150051;58494;80781;7327;10785;337879;10841;54033;3753;337972;6782;150084;643803;728299;9992;386672;5211;861;11096;2897;56894;54084;6285;3689;8209;1859;29104;337960;7485;386676;571;386680;7267;53347;7074;5152;10311;150082;3772;3275;54059;8208;9510;10317;5116;84221;29947;337959;4685;6612;337968;755;1291;351;875;10069;7032;100131902;522;53820;9980;337963;337967;353323;7031;3588;6526;10215;7109;140578;386674;386675;23076;6573;3763;2114;353332;3141;4600;337971;54058;8204;386677;89765;30811;337974;337977;5651;337969;388813;57466;140290;54069;2551;757;10600;90625;23562;23308;26285;10694;386678;337975;337880;100288287;54102;317754;6651;8888;8867;94104;64092;25966;54020;337966;9619;386684;388818;337978;386682;254950;54097;56911;873;29761;284827;81543;7226,213
1,1,21,15006457,48097372,33090915,54148;4599;5316;337882;106865373;1409;54101;9875;1826;9073;386679;874;51227;10950;337970;101928147;386681;56245;54943;643812;326;5121;1476;9946;116448;1292;64699;11077;1827;3150;63977;10281;149998;337973;8566;26046;7307;7113;54014;116159;56683;150094;85395;59271;386685;23515;337878;8624;29980;386683;337979;8568;100288323;54149;6450;4731;6493;539;104;54093;5822;6453;4047;54039;337985;7033;353333;23181;3454;25825;23275;2618;337976;2078;3455;1525;140258;56246;64968;49854;89766;754;3460;6647;54065;150051;58494;80781;7327;10785;337879;10841;54033;3753;337972;6782;150084;643803;728299;9992;386672;5211;861;11096;2897;56894;54084;6285;3689;8209;1859;29104;337960;7485;386676;571;386680;7267;53347;7074;5152;10311;150082;3772;3275;54059;8208;9510;10317;5116;84221;29947;337959;4685;6612;337968;755;1291;351;875;10069;7032;100131902;522;53820;9980;337963;337967;353323;7031;3588;6526;10215;7109;140578;386674;386675;23076;6573;3763;2114;353332;3141;4600;337971;54058;8204;386677;89765;30811;337974;337977;5651;337969;388813;57466;140290;54069;2551;757;10600;90625;23562;23308;26285;10694;386678;337975;337880;100288287;54102;317754;6651;8888;8867;94104;64092;25966;54020;337966;9619;386684;388818;337978;386682;254950;54097;56911;873;29761;284827;81543;7226,213
1,1,21,15006457,48097372,33090915,54148;4599;5316;337882;106865373;1409;54101;9875;1826;9073;386679;874;51227;10950;337970;101928147;386681;56245;54943;643812;326;5121;1476;9946;116448;1292;64699;11077;1827;3150;63977;10281;149998;337973;8566;26046;7307;7113;54014;116159;56683;150094;85395;59271;386685;23515;337878;8624;29980;386683;337979;8568;100288323;54149;6450;4731;6493;539;104;54093;5822;6453;4047;54039;337985;7033;353333;23181;3454;25825;23275;2618;337976;2078;3455;1525;140258;56246;64968;49854;89766;754;3460;6647;54065;150051;58494;80781;7327;10785;337879;10841;54033;3753;337972;6782;150084;643803;728299;9992;386672;5211;861;11096;2897;56894;54084;6285;3689;8209;1859;29104;337960;7485;386676;571;386680;7267;53347;7074;5152;10311;150082;3772;3275;54059;8208;9510;10317;5116;84221;29947;337959;4685;6612;337968;755;1291;351;875;10069;7032;100131902;522;53820;9980;337963;337967;353323;7031;3588;6526;10215;7109;140578;386674;386675;23076;6573;3763;2114;353332;3141;4600;337971;54058;8204;386677;89765;30811;337974;337977;5651;337969;388813;57466;140290;54069;2551;757;10600;90625;23562;23308;26285;10694;386678;337975;337880;100288287;54102;317754;6651;8888;8867;94104;64092;25966;54020;337966;9619;386684;388818;337978;386682;254950;54097;56911;873;29761;284827;81543;7226,213
1,1,21,15006457,48097372,33090915,54148;4599;5316;337882;106865373;1409;54101;9875;1826;9073;386679;874;51227;10950;337970;101928147;386681;56245;54943;643812;326;5121;1476;9946;116448;1292;64699;11077;1827;3150;63977;10281;149998;337973;8566;26046;7307;7113;54014;116159;56683;150094;85395;59271;386685;23515;337878;8624;29980;386683;337979;8568;100288323;54149;6450;4731;6493;539;104;54093;5822;6453;4047;54039;337985;7033;353333;23181;3454;25825;23275;2618;337976;2078;3455;1525;140258;56246;64968;49854;89766;754;3460;6647;54065;150051;58494;80781;7327;10785;337879;10841;54033;3753;337972;6782;150084;643803;728299;9992;386672;5211;861;11096;2897;56894;54084;6285;3689;8209;1859;29104;337960;7485;386676;571;386680;7267;53347;7074;5152;10311;150082;3772;3275;54059;8208;9510;10317;5116;84221;29947;337959;4685;6612;337968;755;1291;351;875;10069;7032;100131902;522;53820;9980;337963;337967;353323;7031;3588;6526;10215;7109;140578;386674;386675;23076;6573;3763;2114;353332;3141;4600;337971;54058;8204;386677;89765;30811;337974;337977;5651;337969;388813;57466;140290;54069;2551;757;10600;90625;23562;23308;26285;10694;386678;337975;337880;100288287;54102;317754;6651;8888;8867;94104;64092;25966;54020;337966;9619;386684;388818;337978;386682;254950;54097;56911;873;29761;284827;81543;7226,213
1,1,21,15006457,48097372,33090915,54148;4599;5316;337882;106865373;1409;54101;9875;1826;9073;386679;874;51227;10950;337970;101928147;386681;56245;54943;643812;326;5121;1476;9946;116448;1292;64699;11077;1827;3150;63977;10281;149998;337973;8566;26046;7307;7113;54014;116159;56683;150094;85395;59271;386685;23515;337878;8624;29980;386683;337979;8568;100288323;54149;6450;4731;6493;539;104;54093;5822;6453;4047;54039;337985;7033;353333;23181;3454;25825;23275;2618;337976;2078;3455;1525;140258;56246;64968;49854;89766;754;3460;6647;54065;150051;58494;80781;7327;10785;337879;10841;54033;3753;337972;6782;150084;643803;728299;9992;386672;5211;861;11096;2897;56894;54084;6285;3689;8209;1859;29104;337960;7485;386676;571;386680;7267;53347;7074;5152;10311;150082;3772;3275;54059;8208;9510;10317;5116;84221;29947;337959;4685;6612;337968;755;1291;351;875;10069;7032;100131902;522;53820;9980;337963;337967;353323;7031;3588;6526;10215;7109;140578;386674;386675;23076;6573;3763;2114;353332;3141;4600;337971;54058;8204;386677;89765;30811;337974;337977;5651;337969;388813;57466;140290;54069;2551;757;10600;90625;23562;23308;26285;10694;386678;337975;337880;100288287;54102;317754;6651;8888;8867;94104;64092;25966;54020;337966;9619;386684;388818;337978;386682;254950;54097;56911;873;29761;284827;81543;7226,213
1,1,21,15006457,48097372,33090915,54148;4599;5316;337882;106865373;1409;54101;9875;1826;9073;386679;874;51227;10950;337970;101928147;386681;56245;54943;643812;326;5121;1476;9946;116448;1292;64699;11077;1827;3150;63977;10281;149998;337973;8566;26046;7307;7113;54014;116159;56683;150094;85395;59271;386685;23515;337878;8624;29980;386683;337979;8568;100288323;54149;6450;4731;6493;539;104;54093;5822;6453;4047;54039;337985;7033;353333;23181;3454;25825;23275;2618;337976;2078;3455;1525;140258;56246;64968;49854;89766;754;3460;6647;54065;150051;58494;80781;7327;10785;337879;10841;54033;3753;337972;6782;150084;643803;728299;9992;386672;5211;861;11096;2897;56894;54084;6285;3689;8209;1859;29104;337960;7485;386676;571;386680;7267;53347;7074;5152;10311;150082;3772;3275;54059;8208;9510;10317;5116;84221;29947;337959;4685;6612;337968;755;1291;351;875;10069;7032;100131902;522;53820;9980;337963;337967;353323;7031;3588;6526;10215;7109;140578;386674;386675;23076;6573;3763;2114;353332;3141;4600;337971;54058;8204;386677;89765;30811;337974;337977;5651;337969;388813;57466;140290;54069;2551;757;10600;90625;23562;23308;26285;10694;386678;337975;337880;100288287;54102;317754;6651;8888;8867;94104;64092;25966;54020;337966;9619;386684;388818;337978;386682;254950;54097;56911;873;29761;284827;81543;7226,213
1,1,21,15006457,48097372,33090915,54148;4599;5316;337882;106865373;1409;54101;9875;1826;9073;386679;874;51227;10950;337970;101928147;386681;56245;54943;643812;326;5121;1476;9946;116448;1292;64699;11077;1827;3150;63977;10281;149998;337973;8566;26046;7307;7113;54014;116159;56683;150094;85395;59271;386685;23515;337878;8624;29980;386683;337979;8568;100288323;54149;6450;4731;6493;539;104;54093;5822;6453;4047;54039;337985;7033;353333;23181;3454;25825;23275;2618;337976;2078;3455;1525;140258;56246;64968;49854;89766;754;3460;6647;54065;150051;58494;80781;7327;10785;337879;10841;54033;3753;337972;6782;150084;643803;728299;9992;386672;5211;861;11096;2897;56894;54084;6285;3689;8209;1859;29104;337960;7485;386676;571;386680;7267;53347;7074;5152;10311;150082;3772;3275;54059;8208;9510;10317;5116;84221;29947;337959;4685;6612;337968;755;1291;351;875;10069;7032;100131902;522;53820;9980;337963;337967;353323;7031;3588;6526;10215;7109;140578;386674;386675;23076;6573;3763;2114;353332;3141;4600;337971;54058;8204;386677;89765;30811;337974;337977;5651;337969;388813;57466;140290;54069;2551;757;10600;90625;23562;23308;26285;10694;386678;337975;337880;100288287;54102;317754;6651;8888;8867;94104;64092;25966;54020;337966;9619;386684;388818;337978;386682;254950;54097;56911;873;29761;284827;81543;7226,213
1,1,21,15006457,48097372,33090915,54148;4599;5316;337882;106865373;1409;54101;9875;1826;9073;386679;874;51227;10950;337970;101928147;386681;56245;54943;643812;326;5121;1476;9946;116448;1292;64699;11077;1827;3150;63977;10281;149998;337973;8566;26046;7307;7113;54014;116159;56683;150094;85395;59271;386685;23515;337878;8624;29980;386683;337979;8568;100288323;54149;6450;4731;6493;539;104;54093;5822;6453;4047;54039;337985;7033;353333;23181;3454;25825;23275;2618;337976;2078;3455;1525;140258;56246;64968;49854;89766;754;3460;6647;54065;150051;58494;80781;7327;10785;337879;10841;54033;3753;337972;6782;150084;643803;728299;9992;386672;5211;861;11096;2897;56894;54084;6285;3689;8209;1859;29104;337960;7485;386676;571;386680;7267;53347;7074;5152;10311;150082;3772;3275;54059;8208;9510;10317;5116;84221;29947;337959;4685;6612;337968;755;1291;351;875;10069;7032;100131902;522;53820;9980;337963;337967;353323;7031;3588;6526;10215;7109;140578;386674;386675;23076;6573;3763;2114;353332;3141;4600;337971;54058;8204;386677;89765;30811;337974;337977;5651;337969;388813;57466;140290;54069;2551;757;10600;90625;23562;23308;26285;10694;386678;337975;337880;100288287;54102;317754;6651;8888;8867;94104;64092;25966;54020;337966;9619;386684;388818;337978;386682;254950;54097;56911;873;29761;284827;81543;7226,213
1,1,21,15006457,48097372,33090915,54148;4599;5316;337882;106865373;1409;54101;9875;1826;9073;386679;874;51227;10950;337970;101928147;386681;56245;54943;643812;326;5121;1476;9946;116448;1292;64699;11077;1827;3150;63977;10281;149998;337973;8566;26046;7307;7113;54014;116159;56683;150094;85395;59271;386685;23515;337878;8624;29980;386683;337979;8568;100288323;54149;6450;4731;6493;539;104;54093;5822;6453;4047;54039;337985;7033;353333;23181;3454;25825;23275;2618;337976;2078;3455;1525;140258;56246;64968;49854;89766;754;3460;6647;54065;150051;58494;80781;7327;10785;337879;10841;54033;3753;337972;6782;150084;643803;728299;9992;386672;5211;861;11096;2897;56894;54084;6285;3689;8209;1859;29104;337960;7485;386676;571;386680;7267;53347;7074;5152;10311;150082;3772;3275;54059;8208;9510;10317;5116;84221;29947;337959;4685;6612;337968;755;1291;351;875;10069;7032;100131902;522;53820;9980;337963;337967;353323;7031;3588;6526;10215;7109;140578;386674;386675;23076;6573;3763;2114;353332;3141;4600;337971;54058;8204;386677;89765;30811;337974;337977;5651;337969;388813;57466;140290;54069;2551;757;10600;90625;23562;23308;26285;10694;386678;337975;337880;100288287;54102;317754;6651;8888;8867;94104;64092;25966;54020;337966;9619;386684;388818;337978;386682;254950;54097;56911;873;29761;284827;81543;7226,213
-1,1,21,15006458,29235160,14228702,140578;54148;54149;11096;9510;317754;64092;58494;6782;4685;149998;8204;10950;54033;29761;351;116159;5651;522;388813;2551;1525,22
1,1,21,15006458,48097372,33090914,54148;4599;5316;337882;106865373;1409;54101;9875;1826;9073;386679;874;51227;10950;337970;101928147;386681;56245;54943;643812;326;5121;1476;9946;116448;1292;64699;11077;1827;3150;63977;10281;149998;337973;8566;26046;7307;7113;54014;116159;56683;150094;85395;59271;386685;23515;337878;8624;29980;386683;337979;8568;100288323;54149;6450;4731;6493;539;104;54093;5822;6453;4047;54039;337985;7033;353333;23181;3454;25825;23275;2618;337976;2078;3455;1525;140258;56246;64968;49854;89766;754;3460;6647;54065;150051;58494;80781;7327;10785;337879;10841;54033;3753;337972;6782;150084;643803;728299;9992;386672;5211;861;11096;2897;56894;54084;6285;3689;8209;1859;29104;337960;7485;386676;571;386680;7267;53347;7074;5152;10311;150082;3772;3275;54059;8208;9510;10317;5116;84221;29947;337959;4685;6612;337968;755;1291;351;875;10069;7032;100131902;522;53820;9980;337963;337967;353323;7031;3588;6526;10215;7109;140578;386674;386675;23076;6573;3763;2114;353332;3141;4600;337971;54058;8204;386677;89765;30811;337974;337977;5651;337969;388813;57466;140290;54069;2551;757;10600;90625;23562;23308;26285;10694;386678;337975;337880;100288287;54102;317754;6651;8888;8867;94104;64092;25966;54020;337966;9619;386684;388818;337978;386682;254950;54097;56911;873;29761;284827;81543;7226,213
1,1,21,15006458,48097372,33090914,54148;4599;5316;337882;106865373;1409;54101;9875;1826;9073;386679;874;51227;10950;337970;101928147;386681;56245;54943;643812;326;5121;1476;9946;116448;1292;64699;11077;1827;3150;63977;10281;149998;337973;8566;26046;7307;7113;54014;116159;56683;150094;85395;59271;386685;23515;337878;8624;29980;386683;337979;8568;100288323;54149;6450;4731;6493;539;104;54093;5822;6453;4047;54039;337985;7033;353333;23181;3454;25825;23275;2618;337976;2078;3455;1525;140258;56246;64968;49854;89766;754;3460;6647;54065;150051;58494;80781;7327;10785;337879;10841;54033;3753;337972;6782;150084;643803;728299;9992;386672;5211;861;11096;2897;56894;54084;6285;3689;8209;1859;29104;337960;7485;386676;571;386680;7267;53347;7074;5152;10311;150082;3772;3275;54059;8208;9510;10317;5116;84221;29947;337959;4685;6612;337968;755;1291;351;875;10069;7032;100131902;522;53820;9980;337963;337967;353323;7031;3588;6526;10215;7109;140578;386674;386675;23076;6573;3763;2114;353332;3141;4600;337971;54058;8204;386677;89765;30811;337974;337977;5651;337969;388813;57466;140290;54069;2551;757;10600;90625;23562;23308;26285;10694;386678;337975;337880;100288287;54102;317754;6651;8888;8867;94104;64092;25966;54020;337966;9619;386684;388818;337978;386682;254950;54097;56911;873;29761;284827;81543;7226,213
1,1,21,15006458,48097372,33090914,54148;4599;5316;337882;106865373;1409;54101;9875;1826;9073;386679;874;51227;10950;337970;101928147;386681;56245;54943;643812;326;5121;1476;9946;116448;1292;64699;11077;1827;3150;63977;10281;149998;337973;8566;26046;7307;7113;54014;116159;56683;150094;85395;59271;386685;23515;337878;8624;29980;386683;337979;8568;100288323;54149;6450;4731;6493;539;104;54093;5822;6453;4047;54039;337985;7033;353333;23181;3454;25825;23275;2618;337976;2078;3455;1525;140258;56246;64968;49854;89766;754;3460;6647;54065;150051;58494;80781;7327;10785;337879;10841;54033;3753;337972;6782;150084;643803;728299;9992;386672;5211;861;11096;2897;56894;54084;6285;3689;8209;1859;29104;337960;7485;386676;571;386680;7267;53347;7074;5152;10311;150082;3772;3275;54059;8208;9510;10317;5116;84221;29947;337959;4685;6612;337968;755;1291;351;875;10069;7032;100131902;522;53820;9980;337963;337967;353323;7031;3588;6526;10215;7109;140578;386674;386675;23076;6573;3763;2114;353332;3141;4600;337971;54058;8204;386677;89765;30811;337974;337977;5651;337969;388813;57466;140290;54069;2551;757;10600;90625;23562;23308;26285;10694;386678;337975;337880;100288287;54102;317754;6651;8888;8867;94104;64092;25966;54020;337966;9619;386684;388818;337978;386682;254950;54097;56911;873;29761;284827;81543;7226,213
1,1,21,15006458,48097372,33090914,54148;4599;5316;337882;106865373;1409;54101;9875;1826;9073;386679;874;51227;10950;337970;101928147;386681;56245;54943;643812;326;5121;1476;9946;116448;1292;64699;11077;1827;3150;63977;10281;149998;337973;8566;26046;7307;7113;54014;116159;56683;150094;85395;59271;386685;23515;337878;8624;29980;386683;337979;8568;100288323;54149;6450;4731;6493;539;104;54093;5822;6453;4047;54039;337985;7033;353333;23181;3454;25825;23275;2618;337976;2078;3455;1525;140258;56246;64968;49854;89766;754;3460;6647;54065;150051;58494;80781;7327;10785;337879;10841;54033;3753;337972;6782;150084;643803;728299;9992;386672;5211;861;11096;2897;56894;54084;6285;3689;8209;1859;29104;337960;7485;386676;571;386680;7267;53347;7074;5152;10311;150082;3772;3275;54059;8208;9510;10317;5116;84221;29947;337959;4685;6612;337968;755;1291;351;875;10069;7032;100131902;522;53820;9980;337963;337967;353323;7031;3588;6526;10215;7109;140578;386674;386675;23076;6573;3763;2114;353332;3141;4600;337971;54058;8204;386677;89765;30811;337974;337977;5651;337969;388813;57466;140290;54069;2551;757;10600;90625;23562;23308;26285;10694;386678;337975;337880;100288287;54102;317754;6651;8888;8867;94104;64092;25966;54020;337966;9619;386684;388818;337978;386682;254950;54097;56911;873;29761;284827;81543;7226,213
1,1,21,15006458,48097372,33090914,54148;4599;5316;337882;106865373;1409;54101;9875;1826;9073;386679;874;51227;10950;337970;101928147;386681;56245;54943;643812;326;5121;1476;9946;116448;1292;64699;11077;1827;3150;63977;10281;149998;337973;8566;26046;7307;7113;54014;116159;56683;150094;85395;59271;386685;23515;337878;8624;29980;386683;337979;8568;100288323;54149;6450;4731;6493;539;104;54093;5822;6453;4047;54039;337985;7033;353333;23181;3454;25825;23275;2618;337976;2078;3455;1525;140258;56246;64968;49854;89766;754;3460;6647;54065;150051;58494;80781;7327;10785;337879;10841;54033;3753;337972;6782;150084;643803;728299;9992;386672;5211;861;11096;2897;56894;54084;6285;3689;8209;1859;29104;337960;7485;386676;571;386680;7267;53347;7074;5152;10311;150082;3772;3275;54059;8208;9510;10317;5116;84221;29947;337959;4685;6612;337968;755;1291;351;875;10069;7032;100131902;522;53820;9980;337963;337967;353323;7031;3588;6526;10215;7109;140578;386674;386675;23076;6573;3763;2114;353332;3141;4600;337971;54058;8204;386677;89765;30811;337974;337977;5651;337969;388813;57466;140290;54069;2551;757;10600;90625;23562;23308;26285;10694;386678;337975;337880;100288287;54102;317754;6651;8888;8867;94104;64092;25966;54020;337966;9619;386684;388818;337978;386682;254950;54097;56911;873;29761;284827;81543;7226,213
1,1,21,15006458,48097372,33090914,54148;4599;5316;337882;106865373;1409;54101;9875;1826;9073;386679;874;51227;10950;337970;101928147;386681;56245;54943;643812;326;5121;1476;9946;116448;1292;64699;11077;1827;3150;63977;10281;149998;337973;8566;26046;7307;7113;54014;116159;56683;150094;85395;59271;386685;23515;337878;8624;29980;386683;337979;8568;100288323;54149;6450;4731;6493;539;104;54093;5822;6453;4047;54039;337985;7033;353333;23181;3454;25825;23275;2618;337976;2078;3455;1525;140258;56246;64968;49854;89766;754;3460;6647;54065;150051;58494;80781;7327;10785;337879;10841;54033;3753;337972;6782;150084;643803;728299;9992;386672;5211;861;11096;2897;56894;54084;6285;3689;8209;1859;29104;337960;7485;386676;571;386680;7267;53347;7074;5152;10311;150082;3772;3275;54059;8208;9510;10317;5116;84221;29947;337959;4685;6612;337968;755;1291;351;875;10069;7032;100131902;522;53820;9980;337963;337967;353323;7031;3588;6526;10215;7109;140578;386674;386675;23076;6573;3763;2114;353332;3141;4600;337971;54058;8204;386677;89765;30811;337974;337977;5651;337969;388813;57466;140290;54069;2551;757;10600;90625;23562;23308;26285;10694;386678;337975;337880;100288287;54102;317754;6651;8888;8867;94104;64092;25966;54020;337966;9619;386684;388818;337978;386682;254950;54097;56911;873;29761;284827;81543;7226,213
1,1,21,15006458,48097372,33090914,54148;4599;5316;337882;106865373;1409;54101;9875;1826;9073;386679;874;51227;10950;337970;101928147;386681;56245;54943;643812;326;5121;1476;9946;116448;1292;64699;11077;1827;3150;63977;10281;149998;337973;8566;26046;7307;7113;54014;116159;56683;150094;85395;59271;386685;23515;337878;8624;29980;386683;337979;8568;100288323;54149;6450;4731;6493;539;104;54093;5822;6453;4047;54039;337985;7033;353333;23181;3454;25825;23275;2618;337976;2078;3455;1525;140258;56246;64968;49854;89766;754;3460;6647;54065;150051;58494;80781;7327;10785;337879;10841;54033;3753;337972;6782;150084;643803;728299;9992;386672;5211;861;11096;2897;56894;54084;6285;3689;8209;1859;29104;337960;7485;386676;571;386680;7267;53347;7074;5152;10311;150082;3772;3275;54059;8208;9510;10317;5116;84221;29947;337959;4685;6612;337968;755;1291;351;875;10069;7032;100131902;522;53820;9980;337963;337967;353323;7031;3588;6526;10215;7109;140578;386674;386675;23076;6573;3763;2114;353332;3141;4600;337971;54058;8204;386677;89765;30811;337974;337977;5651;337969;388813;57466;140290;54069;2551;757;10600;90625;23562;23308;26285;10694;386678;337975;337880;100288287;54102;317754;6651;8888;8867;94104;64092;25966;54020;337966;9619;386684;388818;337978;386682;254950;54097;56911;873;29761;284827;81543;7226,213
1,1,21,15006458,48097372,33090914,54148;4599;5316;337882;106865373;1409;54101;9875;1826;9073;386679;874;51227;10950;337970;101928147;386681;56245;54943;643812;326;5121;1476;9946;116448;1292;64699;11077;1827;3150;63977;10281;149998;337973;8566;26046;7307;7113;54014;116159;56683;150094;85395;59271;386685;23515;337878;8624;29980;386683;337979;8568;100288323;54149;6450;4731;6493;539;104;54093;5822;6453;4047;54039;337985;7033;353333;23181;3454;25825;23275;2618;337976;2078;3455;1525;140258;56246;64968;49854;89766;754;3460;6647;54065;150051;58494;80781;7327;10785;337879;10841;54033;3753;337972;6782;150084;643803;728299;9992;386672;5211;861;11096;2897;56894;54084;6285;3689;8209;1859;29104;337960;7485;386676;571;386680;7267;53347;7074;5152;10311;150082;3772;3275;54059;8208;9510;10317;5116;84221;29947;337959;4685;6612;337968;755;1291;351;875;10069;7032;100131902;522;53820;9980;337963;337967;353323;7031;3588;6526;10215;7109;140578;386674;386675;23076;6573;3763;2114;353332;3141;4600;337971;54058;8204;386677;89765;30811;337974;337977;5651;337969;388813;57466;140290;54069;2551;757;10600;90625;23562;23308;26285;10694;386678;337975;337880;100288287;54102;317754;6651;8888;8867;94104;64092;25966;54020;337966;9619;386684;388818;337978;386682;254950;54097;56911;873;29761;284827;81543;7226,213
1,1,21,15006458,48097372,33090914,54148;4599;5316;337882;106865373;1409;54101;9875;1826;9073;386679;874;51227;10950;337970;101928147;386681;56245;54943;643812;326;5121;1476;9946;116448;1292;64699;11077;1827;3150;63977;10281;149998;337973;8566;26046;7307;7113;54014;116159;56683;150094;85395;59271;386685;23515;337878;8624;29980;386683;337979;8568;100288323;54149;6450;4731;6493;539;104;54093;5822;6453;4047;54039;337985;7033;353333;23181;3454;25825;23275;2618;337976;2078;3455;1525;140258;56246;64968;49854;89766;754;3460;6647;54065;150051;58494;80781;7327;10785;337879;10841;54033;3753;337972;6782;150084;643803;728299;9992;386672;5211;861;11096;2897;56894;54084;6285;3689;8209;1859;29104;337960;7485;386676;571;386680;7267;53347;7074;5152;10311;150082;3772;3275;54059;8208;9510;10317;5116;84221;29947;337959;4685;6612;337968;755;1291;351;875;10069;7032;100131902;522;53820;9980;337963;337967;353323;7031;3588;6526;10215;7109;140578;386674;386675;23076;6573;3763;2114;353332;3141;4600;337971;54058;8204;386677;89765;30811;337974;337977;5651;337969;388813;57466;140290;54069;2551;757;10600;90625;23562;23308;26285;10694;386678;337975;337880;100288287;54102;317754;6651;8888;8867;94104;64092;25966;54020;337966;9619;386684;388818;337978;386682;254950;54097;56911;873;29761;284827;81543;7226,213
1,1,21,15006458,48097372,33090914,54148;4599;5316;337882;106865373;1409;54101;9875;1826;9073;386679;874;51227;10950;337970;101928147;386681;56245;54943;643812;326;5121;1476;9946;116448;1292;64699;11077;1827;3150;63977;10281;149998;337973;8566;26046;7307;7113;54014;116159;56683;150094;85395;59271;386685;23515;337878;8624;29980;386683;337979;8568;100288323;54149;6450;4731;6493;539;104;54093;5822;6453;4047;54039;337985;7033;353333;23181;3454;25825;23275;2618;337976;2078;3455;1525;140258;56246;64968;49854;89766;754;3460;6647;54065;150051;58494;80781;7327;10785;337879;10841;54033;3753;337972;6782;150084;643803;728299;9992;386672;5211;861;11096;2897;56894;54084;6285;3689;8209;1859;29104;337960;7485;386676;571;386680;7267;53347;7074;5152;10311;150082;3772;3275;54059;8208;9510;10317;5116;84221;29947;337959;4685;6612;337968;755;1291;351;875;10069;7032;100131902;522;53820;9980;337963;337967;353323;7031;3588;6526;10215;7109;140578;386674;386675;23076;6573;3763;2114;353332;3141;4600;337971;54058;8204;386677;89765;30811;337974;337977;5651;337969;388813;57466;140290;54069;2551;757;10600;90625;23562;23308;26285;10694;386678;337975;337880;100288287;54102;317754;6651;8888;8867;94104;64092;25966;54020;337966;9619;386684;388818;337978;386682;254950;54097;56911;873;29761;284827;81543;7226,213
1,1,21,15006458,48097372,33090914,54148;4599;5316;337882;106865373;1409;54101;9875;1826;9073;386679;874;51227;10950;337970;101928147;386681;56245;54943;643812;326;5121;1476;9946;116448;1292;64699;11077;1827;3150;63977;10281;149998;337973;8566;26046;7307;7113;54014;116159;56683;150094;85395;59271;386685;23515;337878;8624;29980;386683;337979;8568;100288323;54149;6450;4731;6493;539;104;54093;5822;6453;4047;54039;337985;7033;353333;23181;3454;25825;23275;2618;337976;2078;3455;1525;140258;56246;64968;49854;89766;754;3460;6647;54065;150051;58494;80781;7327;10785;337879;10841;54033;3753;337972;6782;150084;643803;728299;9992;386672;5211;861;11096;2897;56894;54084;6285;3689;8209;1859;29104;337960;7485;386676;571;386680;7267;53347;7074;5152;10311;150082;3772;3275;54059;8208;9510;10317;5116;84221;29947;337959;4685;6612;337968;755;1291;351;875;10069;7032;100131902;522;53820;9980;337963;337967;353323;7031;3588;6526;10215;7109;140578;386674;386675;23076;6573;3763;2114;353332;3141;4600;337971;54058;8204;386677;89765;30811;337974;337977;5651;337969;388813;57466;140290;54069;2551;757;10600;90625;23562;23308;26285;10694;386678;337975;337880;100288287;54102;317754;6651;8888;8867;94104;64092;25966;54020;337966;9619;386684;388818;337978;386682;254950;54097;56911;873;29761;284827;81543;7226,213
1,1,21,15006458,48097372,33090914,54148;4599;5316;337882;106865373;1409;54101;9875;1826;9073;386679;874;51227;10950;337970;101928147;386681;56245;54943;643812;326;5121;1476;9946;116448;1292;64699;11077;1827;3150;63977;10281;149998;337973;8566;26046;7307;7113;54014;116159;56683;150094;85395;59271;386685;23515;337878;8624;29980;386683;337979;8568;100288323;54149;6450;4731;6493;539;104;54093;5822;6453;4047;54039;337985;7033;353333;23181;3454;25825;23275;2618;337976;2078;3455;1525;140258;56246;64968;49854;89766;754;3460;6647;54065;150051;58494;80781;7327;10785;337879;10841;54033;3753;337972;6782;150084;643803;728299;9992;386672;5211;861;11096;2897;56894;54084;6285;3689;8209;1859;29104;337960;7485;386676;571;386680;7267;53347;7074;5152;10311;150082;3772;3275;54059;8208;9510;10317;5116;84221;29947;337959;4685;6612;337968;755;1291;351;875;10069;7032;100131902;522;53820;9980;337963;337967;353323;7031;3588;6526;10215;7109;140578;386674;386675;23076;6573;3763;2114;353332;3141;4600;337971;54058;8204;386677;89765;30811;337974;337977;5651;337969;388813;57466;140290;54069;2551;757;10600;90625;23562;23308;26285;10694;386678;337975;337880;100288287;54102;317754;6651;8888;8867;94104;64092;25966;54020;337966;9619;386684;388818;337978;386682;254950;54097;56911;873;29761;284827;81543;7226,213
1,1,21,15006458,48097372,33090914,54148;4599;5316;337882;106865373;1409;54101;9875;1826;9073;386679;874;51227;10950;337970;101928147;386681;56245;54943;643812;326;5121;1476;9946;116448;1292;64699;11077;1827;3150;63977;10281;149998;337973;8566;26046;7307;7113;54014;116159;56683;150094;85395;59271;386685;23515;337878;8624;29980;386683;337979;8568;100288323;54149;6450;4731;6493;539;104;54093;5822;6453;4047;54039;337985;7033;353333;23181;3454;25825;23275;2618;337976;2078;3455;1525;140258;56246;64968;49854;89766;754;3460;6647;54065;150051;58494;80781;7327;10785;337879;10841;54033;3753;337972;6782;150084;643803;728299;9992;386672;5211;861;11096;2897;56894;54084;6285;3689;8209;1859;29104;337960;7485;386676;571;386680;7267;53347;7074;5152;10311;150082;3772;3275;54059;8208;9510;10317;5116;84221;29947;337959;4685;6612;337968;755;1291;351;875;10069;7032;100131902;522;53820;9980;337963;337967;353323;7031;3588;6526;10215;7109;140578;386674;386675;23076;6573;3763;2114;353332;3141;4600;337971;54058;8204;386677;89765;30811;337974;337977;5651;337969;388813;57466;140290;54069;2551;757;10600;90625;23562;23308;26285;10694;386678;337975;337880;100288287;54102;317754;6651;8888;8867;94104;64092;25966;54020;337966;9619;386684;388818;337978;386682;254950;54097;56911;873;29761;284827;81543;7226,213
1,1,21,15006458,48097372,33090914,54148;4599;5316;337882;106865373;1409;54101;9875;1826;9073;386679;874;51227;10950;337970;101928147;386681;56245;54943;643812;326;5121;1476;9946;116448;1292;64699;11077;1827;3150;63977;10281;149998;337973;8566;26046;7307;7113;54014;116159;56683;150094;85395;59271;386685;23515;337878;8624;29980;386683;337979;8568;100288323;54149;6450;4731;6493;539;104;54093;5822;6453;4047;54039;337985;7033;353333;23181;3454;25825;23275;2618;337976;2078;3455;1525;140258;56246;64968;49854;89766;754;3460;6647;54065;150051;58494;80781;7327;10785;337879;10841;54033;3753;337972;6782;150084;643803;728299;9992;386672;5211;861;11096;2897;56894;54084;6285;3689;8209;1859;29104;337960;7485;386676;571;386680;7267;53347;7074;5152;10311;150082;3772;3275;54059;8208;9510;10317;5116;84221;29947;337959;4685;6612;337968;755;1291;351;875;10069;7032;100131902;522;53820;9980;337963;337967;353323;7031;3588;6526;10215;7109;140578;386674;386675;23076;6573;3763;2114;353332;3141;4600;337971;54058;8204;386677;89765;30811;337974;337977;5651;337969;388813;57466;140290;54069;2551;757;10600;90625;23562;23308;26285;10694;386678;337975;337880;100288287;54102;317754;6651;8888;8867;94104;64092;25966;54020;337966;9619;386684;388818;337978;386682;254950;54097;56911;873;29761;284827;81543;7226,213
1,1,21,15006458,48097372,33090914,54148;4599;5316;337882;106865373;1409;54101;9875;1826;9073;386679;874;51227;10950;337970;101928147;386681;56245;54943;643812;326;5121;1476;9946;116448;1292;64699;11077;1827;3150;63977;10281;149998;337973;8566;26046;7307;7113;54014;116159;56683;150094;85395;59271;386685;23515;337878;8624;29980;386683;337979;8568;100288323;54149;6450;4731;6493;539;104;54093;5822;6453;4047;54039;337985;7033;353333;23181;3454;25825;23275;2618;337976;2078;3455;1525;140258;56246;64968;49854;89766;754;3460;6647;54065;150051;58494;80781;7327;10785;337879;10841;54033;3753;337972;6782;150084;643803;728299;9992;386672;5211;861;11096;2897;56894;54084;6285;3689;8209;1859;29104;337960;7485;386676;571;386680;7267;53347;7074;5152;10311;150082;3772;3275;54059;8208;9510;10317;5116;84221;29947;337959;4685;6612;337968;755;1291;351;875;10069;7032;100131902;522;53820;9980;337963;337967;353323;7031;3588;6526;10215;7109;140578;386674;386675;23076;6573;3763;2114;353332;3141;4600;337971;54058;8204;386677;89765;30811;337974;337977;5651;337969;388813;57466;140290;54069;2551;757;10600;90625;23562;23308;26285;10694;386678;337975;337880;100288287;54102;317754;6651;8888;8867;94104;64092;25966;54020;337966;9619;386684;388818;337978;386682;254950;54097;56911;873;29761;284827;81543;7226,213
1,1,21,15006458,48097372,33090914,54148;4599;5316;337882;106865373;1409;54101;9875;1826;9073;386679;874;51227;10950;337970;101928147;386681;56245;54943;643812;326;5121;1476;9946;116448;1292;64699;11077;1827;3150;63977;10281;149998;337973;8566;26046;7307;7113;54014;116159;56683;150094;85395;59271;386685;23515;337878;8624;29980;386683;337979;8568;100288323;54149;6450;4731;6493;539;104;54093;5822;6453;4047;54039;337985;7033;353333;23181;3454;25825;23275;2618;337976;2078;3455;1525;140258;56246;64968;49854;89766;754;3460;6647;54065;150051;58494;80781;7327;10785;337879;10841;54033;3753;337972;6782;150084;643803;728299;9992;386672;5211;861;11096;2897;56894;54084;6285;3689;8209;1859;29104;337960;7485;386676;571;386680;7267;53347;7074;5152;10311;150082;3772;3275;54059;8208;9510;10317;5116;84221;29947;337959;4685;6612;337968;755;1291;351;875;10069;7032;100131902;522;53820;9980;337963;337967;353323;7031;3588;6526;10215;7109;140578;386674;386675;23076;6573;3763;2114;353332;3141;4600;337971;54058;8204;386677;89765;30811;337974;337977;5651;337969;388813;57466;140290;54069;2551;757;10600;90625;23562;23308;26285;10694;386678;337975;337880;100288287;54102;317754;6651;8888;8867;94104;64092;25966;54020;337966;9619;386684;388818;337978;386682;254950;54097;56911;873;29761;284827;81543;7226,213
1,1,21,15006458,48097372,33090914,54148;4599;5316;337882;106865373;1409;54101;9875;1826;9073;386679;874;51227;10950;337970;101928147;386681;56245;54943;643812;326;5121;1476;9946;116448;1292;64699;11077;1827;3150;63977;10281;149998;337973;8566;26046;7307;7113;54014;116159;56683;150094;85395;59271;386685;23515;337878;8624;29980;386683;337979;8568;100288323;54149;6450;4731;6493;539;104;54093;5822;6453;4047;54039;337985;7033;353333;23181;3454;25825;23275;2618;337976;2078;3455;1525;140258;56246;64968;49854;89766;754;3460;6647;54065;150051;58494;80781;7327;10785;337879;10841;54033;3753;337972;6782;150084;643803;728299;9992;386672;5211;861;11096;2897;56894;54084;6285;3689;8209;1859;29104;337960;7485;386676;571;386680;7267;53347;7074;5152;10311;150082;3772;3275;54059;8208;9510;10317;5116;84221;29947;337959;4685;6612;337968;755;1291;351;875;10069;7032;100131902;522;53820;9980;337963;337967;353323;7031;3588;6526;10215;7109;140578;386674;386675;23076;6573;3763;2114;353332;3141;4600;337971;54058;8204;386677;89765;30811;337974;337977;5651;337969;388813;57466;140290;54069;2551;757;10600;90625;23562;23308;26285;10694;386678;337975;337880;100288287;54102;317754;6651;8888;8867;94104;64092;25966;54020;337966;9619;386684;388818;337978;386682;254950;54097;56911;873;29761;284827;81543;7226,213
1,1,21,15006458,48097372,33090914,54148;4599;5316;337882;106865373;1409;54101;9875;1826;9073;386679;874;51227;10950;337970;101928147;386681;56245;54943;643812;326;5121;1476;9946;116448;1292;64699;11077;1827;3150;63977;10281;149998;337973;8566;26046;7307;7113;54014;116159;56683;150094;85395;59271;386685;23515;337878;8624;29980;386683;337979;8568;100288323;54149;6450;4731;6493;539;104;54093;5822;6453;4047;54039;337985;7033;353333;23181;3454;25825;23275;2618;337976;2078;3455;1525;140258;56246;64968;49854;89766;754;3460;6647;54065;150051;58494;80781;7327;10785;337879;10841;54033;3753;337972;6782;150084;643803;728299;9992;386672;5211;861;11096;2897;56894;54084;6285;3689;8209;1859;29104;337960;7485;386676;571;386680;7267;53347;7074;5152;10311;150082;3772;3275;54059;8208;9510;10317;5116;84221;29947;337959;4685;6612;337968;755;1291;351;875;10069;7032;100131902;522;53820;9980;337963;337967;353323;7031;3588;6526;10215;7109;140578;386674;386675;23076;6573;3763;2114;353332;3141;4600;337971;54058;8204;386677;89765;30811;337974;337977;5651;337969;388813;57466;140290;54069;2551;757;10600;90625;23562;23308;26285;10694;386678;337975;337880;100288287;54102;317754;6651;8888;8867;94104;64092;25966;54020;337966;9619;386684;388818;337978;386682;254950;54097;56911;873;29761;284827;81543;7226,213
1,1,21,15006458,48097372,33090914,54148;4599;5316;337882;106865373;1409;54101;9875;1826;9073;386679;874;51227;10950;337970;101928147;386681;56245;54943;643812;326;5121;1476;9946;116448;1292;64699;11077;1827;3150;63977;10281;149998;337973;8566;26046;7307;7113;54014;116159;56683;150094;85395;59271;386685;23515;337878;8624;29980;386683;337979;8568;100288323;54149;6450;4731;6493;539;104;54093;5822;6453;4047;54039;337985;7033;353333;23181;3454;25825;23275;2618;337976;2078;3455;1525;140258;56246;64968;49854;89766;754;3460;6647;54065;150051;58494;80781;7327;10785;337879;10841;54033;3753;337972;6782;150084;643803;728299;9992;386672;5211;861;11096;2897;56894;54084;6285;3689;8209;1859;29104;337960;7485;386676;571;386680;7267;53347;7074;5152;10311;150082;3772;3275;54059;8208;9510;10317;5116;84221;29947;337959;4685;6612;337968;755;1291;351;875;10069;7032;100131902;522;53820;9980;337963;337967;353323;7031;3588;6526;10215;7109;140578;386674;386675;23076;6573;3763;2114;353332;3141;4600;337971;54058;8204;386677;89765;30811;337974;337977;5651;337969;388813;57466;140290;54069;2551;757;10600;90625;23562;23308;26285;10694;386678;337975;337880;100288287;54102;317754;6651;8888;8867;94104;64092;25966;54020;337966;9619;386684;388818;337978;386682;254950;54097;56911;873;29761;284827;81543;7226,213
1,1,21,15006458,48097372,33090914,54148;4599;5316;337882;106865373;1409;54101;9875;1826;9073;386679;874;51227;10950;337970;101928147;386681;56245;54943;643812;326;5121;1476;9946;116448;1292;64699;11077;1827;3150;63977;10281;149998;337973;8566;26046;7307;7113;54014;116159;56683;150094;85395;59271;386685;23515;337878;8624;29980;386683;337979;8568;100288323;54149;6450;4731;6493;539;104;54093;5822;6453;4047;54039;337985;7033;353333;23181;3454;25825;23275;2618;337976;2078;3455;1525;140258;56246;64968;49854;89766;754;3460;6647;54065;150051;58494;80781;7327;10785;337879;10841;54033;3753;337972;6782;150084;643803;728299;9992;386672;5211;861;11096;2897;56894;54084;6285;3689;8209;1859;29104;337960;7485;386676;571;386680;7267;53347;7074;5152;10311;150082;3772;3275;54059;8208;9510;10317;5116;84221;29947;337959;4685;6612;337968;755;1291;351;875;10069;7032;100131902;522;53820;9980;337963;337967;353323;7031;3588;6526;10215;7109;140578;386674;386675;23076;6573;3763;2114;353332;3141;4600;337971;54058;8204;386677;89765;30811;337974;337977;5651;337969;388813;57466;140290;54069;2551;757;10600;90625;23562;23308;26285;10694;386678;337975;337880;100288287;54102;317754;6651;8888;8867;94104;64092;25966;54020;337966;9619;386684;388818;337978;386682;254950;54097;56911;873;29761;284827;81543;7226,213
1,1,21,15006458,48097372,33090914,54148;4599;5316;337882;106865373;1409;54101;9875;1826;9073;386679;874;51227;10950;337970;101928147;386681;56245;54943;643812;326;5121;1476;9946;116448;1292;64699;11077;1827;3150;63977;10281;149998;337973;8566;26046;7307;7113;54014;116159;56683;150094;85395;59271;386685;23515;337878;8624;29980;386683;337979;8568;100288323;54149;6450;4731;6493;539;104;54093;5822;6453;4047;54039;337985;7033;353333;23181;3454;25825;23275;2618;337976;2078;3455;1525;140258;56246;64968;49854;89766;754;3460;6647;54065;150051;58494;80781;7327;10785;337879;10841;54033;3753;337972;6782;150084;643803;728299;9992;386672;5211;861;11096;2897;56894;54084;6285;3689;8209;1859;29104;337960;7485;386676;571;386680;7267;53347;7074;5152;10311;150082;3772;3275;54059;8208;9510;10317;5116;84221;29947;337959;4685;6612;337968;755;1291;351;875;10069;7032;100131902;522;53820;9980;337963;337967;353323;7031;3588;6526;10215;7109;140578;386674;386675;23076;6573;3763;2114;353332;3141;4600;337971;54058;8204;386677;89765;30811;337974;337977;5651;337969;388813;57466;140290;54069;2551;757;10600;90625;23562;23308;26285;10694;386678;337975;337880;100288287;54102;317754;6651;8888;8867;94104;64092;25966;54020;337966;9619;386684;388818;337978;386682;254950;54097;56911;873;29761;284827;81543;7226,213
1,1,21,15006458,48097372,33090914,54148;4599;5316;337882;106865373;1409;54101;9875;1826;9073;386679;874;51227;10950;337970;101928147;386681;56245;54943;643812;326;5121;1476;9946;116448;1292;64699;11077;1827;3150;63977;10281;149998;337973;8566;26046;7307;7113;54014;116159;56683;150094;85395;59271;386685;23515;337878;8624;29980;386683;337979;8568;100288323;54149;6450;4731;6493;539;104;54093;5822;6453;4047;54039;337985;7033;353333;23181;3454;25825;23275;2618;337976;2078;3455;1525;140258;56246;64968;49854;89766;754;3460;6647;54065;150051;58494;80781;7327;10785;337879;10841;54033;3753;337972;6782;150084;643803;728299;9992;386672;5211;861;11096;2897;56894;54084;6285;3689;8209;1859;29104;337960;7485;386676;571;386680;7267;53347;7074;5152;10311;150082;3772;3275;54059;8208;9510;10317;5116;84221;29947;337959;4685;6612;337968;755;1291;351;875;10069;7032;100131902;522;53820;9980;337963;337967;353323;7031;3588;6526;10215;7109;140578;386674;386675;23076;6573;3763;2114;353332;3141;4600;337971;54058;8204;386677;89765;30811;337974;337977;5651;337969;388813;57466;140290;54069;2551;757;10600;90625;23562;23308;26285;10694;386678;337975;337880;100288287;54102;317754;6651;8888;8867;94104;64092;25966;54020;337966;9619;386684;388818;337978;386682;254950;54097;56911;873;29761;284827;81543;7226,213
1,1,21,15006458,48097372,33090914,54148;4599;5316;337882;106865373;1409;54101;9875;1826;9073;386679;874;51227;10950;337970;101928147;386681;56245;54943;643812;326;5121;1476;9946;116448;1292;64699;11077;1827;3150;63977;10281;149998;337973;8566;26046;7307;7113;54014;116159;56683;150094;85395;59271;386685;23515;337878;8624;29980;386683;337979;8568;100288323;54149;6450;4731;6493;539;104;54093;5822;6453;4047;54039;337985;7033;353333;23181;3454;25825;23275;2618;337976;2078;3455;1525;140258;56246;64968;49854;89766;754;3460;6647;54065;150051;58494;80781;7327;10785;337879;10841;54033;3753;337972;6782;150084;643803;728299;9992;386672;5211;861;11096;2897;56894;54084;6285;3689;8209;1859;29104;337960;7485;386676;571;386680;7267;53347;7074;5152;10311;150082;3772;3275;54059;8208;9510;10317;5116;84221;29947;337959;4685;6612;337968;755;1291;351;875;10069;7032;100131902;522;53820;9980;337963;337967;353323;7031;3588;6526;10215;7109;140578;386674;386675;23076;6573;3763;2114;353332;3141;4600;337971;54058;8204;386677;89765;30811;337974;337977;5651;337969;388813;57466;140290;54069;2551;757;10600;90625;23562;23308;26285;10694;386678;337975;337880;100288287;54102;317754;6651;8888;8867;94104;64092;25966;54020;337966;9619;386684;388818;337978;386682;254950;54097;56911;873;29761;284827;81543;7226,213
1,1,21,15006458,48097372,33090914,54148;4599;5316;337882;106865373;1409;54101;9875;1826;9073;386679;874;51227;10950;337970;101928147;386681;56245;54943;643812;326;5121;1476;9946;116448;1292;64699;11077;1827;3150;63977;10281;149998;337973;8566;26046;7307;7113;54014;116159;56683;150094;85395;59271;386685;23515;337878;8624;29980;386683;337979;8568;100288323;54149;6450;4731;6493;539;104;54093;5822;6453;4047;54039;337985;7033;353333;23181;3454;25825;23275;2618;337976;2078;3455;1525;140258;56246;64968;49854;89766;754;3460;6647;54065;150051;58494;80781;7327;10785;337879;10841;54033;3753;337972;6782;150084;643803;728299;9992;386672;5211;861;11096;2897;56894;54084;6285;3689;8209;1859;29104;337960;7485;386676;571;386680;7267;53347;7074;5152;10311;150082;3772;3275;54059;8208;9510;10317;5116;84221;29947;337959;4685;6612;337968;755;1291;351;875;10069;7032;100131902;522;53820;9980;337963;337967;353323;7031;3588;6526;10215;7109;140578;386674;386675;23076;6573;3763;2114;353332;3141;4600;337971;54058;8204;386677;89765;30811;337974;337977;5651;337969;388813;57466;140290;54069;2551;757;10600;90625;23562;23308;26285;10694;386678;337975;337880;100288287;54102;317754;6651;8888;8867;94104;64092;25966;54020;337966;9619;386684;388818;337978;386682;254950;54097;56911;873;29761;284827;81543;7226,213
1,1,21,15006458,48097372,33090914,54148;4599;5316;337882;106865373;1409;54101;9875;1826;9073;386679;874;51227;10950;337970;101928147;386681;56245;54943;643812;326;5121;1476;9946;116448;1292;64699;11077;1827;3150;63977;10281;149998;337973;8566;26046;7307;7113;54014;116159;56683;150094;85395;59271;386685;23515;337878;8624;29980;386683;337979;8568;100288323;54149;6450;4731;6493;539;104;54093;5822;6453;4047;54039;337985;7033;353333;23181;3454;25825;23275;2618;337976;2078;3455;1525;140258;56246;64968;49854;89766;754;3460;6647;54065;150051;58494;80781;7327;10785;337879;10841;54033;3753;337972;6782;150084;643803;728299;9992;386672;5211;861;11096;2897;56894;54084;6285;3689;8209;1859;29104;337960;7485;386676;571;386680;7267;53347;7074;5152;10311;150082;3772;3275;54059;8208;9510;10317;5116;84221;29947;337959;4685;6612;337968;755;1291;351;875;10069;7032;100131902;522;53820;9980;337963;337967;353323;7031;3588;6526;10215;7109;140578;386674;386675;23076;6573;3763;2114;353332;3141;4600;337971;54058;8204;386677;89765;30811;337974;337977;5651;337969;388813;57466;140290;54069;2551;757;10600;90625;23562;23308;26285;10694;386678;337975;337880;100288287;54102;317754;6651;8888;8867;94104;64092;25966;54020;337966;9619;386684;388818;337978;386682;254950;54097;56911;873;29761;284827;81543;7226,213
1,1,21,15006458,48097372,33090914,54148;4599;5316;337882;106865373;1409;54101;9875;1826;9073;386679;874;51227;10950;337970;101928147;386681;56245;54943;643812;326;5121;1476;9946;116448;1292;64699;11077;1827;3150;63977;10281;149998;337973;8566;26046;7307;7113;54014;116159;56683;150094;85395;59271;386685;23515;337878;8624;29980;386683;337979;8568;100288323;54149;6450;4731;6493;539;104;54093;5822;6453;4047;54039;337985;7033;353333;23181;3454;25825;23275;2618;337976;2078;3455;1525;140258;56246;64968;49854;89766;754;3460;6647;54065;150051;58494;80781;7327;10785;337879;10841;54033;3753;337972;6782;150084;643803;728299;9992;386672;5211;861;11096;2897;56894;54084;6285;3689;8209;1859;29104;337960;7485;386676;571;386680;7267;53347;7074;5152;10311;150082;3772;3275;54059;8208;9510;10317;5116;84221;29947;337959;4685;6612;337968;755;1291;351;875;10069;7032;100131902;522;53820;9980;337963;337967;353323;7031;3588;6526;10215;7109;140578;386674;386675;23076;6573;3763;2114;353332;3141;4600;337971;54058;8204;386677;89765;30811;337974;337977;5651;337969;388813;57466;140290;54069;2551;757;10600;90625;23562;23308;26285;10694;386678;337975;337880;100288287;54102;317754;6651;8888;8867;94104;64092;25966;54020;337966;9619;386684;388818;337978;386682;254950;54097;56911;873;29761;284827;81543;7226,213
1,1,21,15006458,48097372,33090914,54148;4599;5316;337882;106865373;1409;54101;9875;1826;9073;386679;874;51227;10950;337970;101928147;386681;56245;54943;643812;326;5121;1476;9946;116448;1292;64699;11077;1827;3150;63977;10281;149998;337973;8566;26046;7307;7113;54014;116159;56683;150094;85395;59271;386685;23515;337878;8624;29980;386683;337979;8568;100288323;54149;6450;4731;6493;539;104;54093;5822;6453;4047;54039;337985;7033;353333;23181;3454;25825;23275;2618;337976;2078;3455;1525;140258;56246;64968;49854;89766;754;3460;6647;54065;150051;58494;80781;7327;10785;337879;10841;54033;3753;337972;6782;150084;643803;728299;9992;386672;5211;861;11096;2897;56894;54084;6285;3689;8209;1859;29104;337960;7485;386676;571;386680;7267;53347;7074;5152;10311;150082;3772;3275;54059;8208;9510;10317;5116;84221;29947;337959;4685;6612;337968;755;1291;351;875;10069;7032;100131902;522;53820;9980;337963;337967;353323;7031;3588;6526;10215;7109;140578;386674;386675;23076;6573;3763;2114;353332;3141;4600;337971;54058;8204;386677;89765;30811;337974;337977;5651;337969;388813;57466;140290;54069;2551;757;10600;90625;23562;23308;26285;10694;386678;337975;337880;100288287;54102;317754;6651;8888;8867;94104;64092;25966;54020;337966;9619;386684;388818;337978;386682;254950;54097;56911;873;29761;284827;81543;7226,213
1,1,21,15006458,48097372,33090914,54148;4599;5316;337882;106865373;1409;54101;9875;1826;9073;386679;874;51227;10950;337970;101928147;386681;56245;54943;643812;326;5121;1476;9946;116448;1292;64699;11077;1827;3150;63977;10281;149998;337973;8566;26046;7307;7113;54014;116159;56683;150094;85395;59271;386685;23515;337878;8624;29980;386683;337979;8568;100288323;54149;6450;4731;6493;539;104;54093;5822;6453;4047;54039;337985;7033;353333;23181;3454;25825;23275;2618;337976;2078;3455;1525;140258;56246;64968;49854;89766;754;3460;6647;54065;150051;58494;80781;7327;10785;337879;10841;54033;3753;337972;6782;150084;643803;728299;9992;386672;5211;861;11096;2897;56894;54084;6285;3689;8209;1859;29104;337960;7485;386676;571;386680;7267;53347;7074;5152;10311;150082;3772;3275;54059;8208;9510;10317;5116;84221;29947;337959;4685;6612;337968;755;1291;351;875;10069;7032;100131902;522;53820;9980;337963;337967;353323;7031;3588;6526;10215;7109;140578;386674;386675;23076;6573;3763;2114;353332;3141;4600;337971;54058;8204;386677;89765;30811;337974;337977;5651;337969;388813;57466;140290;54069;2551;757;10600;90625;23562;23308;26285;10694;386678;337975;337880;100288287;54102;317754;6651;8888;8867;94104;64092;25966;54020;337966;9619;386684;388818;337978;386682;254950;54097;56911;873;29761;284827;81543;7226,213
1,1,21,15006458,48097372,33090914,54148;4599;5316;337882;106865373;1409;54101;9875;1826;9073;386679;874;51227;10950;337970;101928147;386681;56245;54943;643812;326;5121;1476;9946;116448;1292;64699;11077;1827;3150;63977;10281;149998;337973;8566;26046;7307;7113;54014;116159;56683;150094;85395;59271;386685;23515;337878;8624;29980;386683;337979;8568;100288323;54149;6450;4731;6493;539;104;54093;5822;6453;4047;54039;337985;7033;353333;23181;3454;25825;23275;2618;337976;2078;3455;1525;140258;56246;64968;49854;89766;754;3460;6647;54065;150051;58494;80781;7327;10785;337879;10841;54033;3753;337972;6782;150084;643803;728299;9992;386672;5211;861;11096;2897;56894;54084;6285;3689;8209;1859;29104;337960;7485;386676;571;386680;7267;53347;7074;5152;10311;150082;3772;3275;54059;8208;9510;10317;5116;84221;29947;337959;4685;6612;337968;755;1291;351;875;10069;7032;100131902;522;53820;9980;337963;337967;353323;7031;3588;6526;10215;7109;140578;386674;386675;23076;6573;3763;2114;353332;3141;4600;337971;54058;8204;386677;89765;30811;337974;337977;5651;337969;388813;57466;140290;54069;2551;757;10600;90625;23562;23308;26285;10694;386678;337975;337880;100288287;54102;317754;6651;8888;8867;94104;64092;25966;54020;337966;9619;386684;388818;337978;386682;254950;54097;56911;873;29761;284827;81543;7226,213
1,1,21,15006458,48097372,33090914,54148;4599;5316;337882;106865373;1409;54101;9875;1826;9073;386679;874;51227;10950;337970;101928147;386681;56245;54943;643812;326;5121;1476;9946;116448;1292;64699;11077;1827;3150;63977;10281;149998;337973;8566;26046;7307;7113;54014;116159;56683;150094;85395;59271;386685;23515;337878;8624;29980;386683;337979;8568;100288323;54149;6450;4731;6493;539;104;54093;5822;6453;4047;54039;337985;7033;353333;23181;3454;25825;23275;2618;337976;2078;3455;1525;140258;56246;64968;49854;89766;754;3460;6647;54065;150051;58494;80781;7327;10785;337879;10841;54033;3753;337972;6782;150084;643803;728299;9992;386672;5211;861;11096;2897;56894;54084;6285;3689;8209;1859;29104;337960;7485;386676;571;386680;7267;53347;7074;5152;10311;150082;3772;3275;54059;8208;9510;10317;5116;84221;29947;337959;4685;6612;337968;755;1291;351;875;10069;7032;100131902;522;53820;9980;337963;337967;353323;7031;3588;6526;10215;7109;140578;386674;386675;23076;6573;3763;2114;353332;3141;4600;337971;54058;8204;386677;89765;30811;337974;337977;5651;337969;388813;57466;140290;54069;2551;757;10600;90625;23562;23308;26285;10694;386678;337975;337880;100288287;54102;317754;6651;8888;8867;94104;64092;25966;54020;337966;9619;386684;388818;337978;386682;254950;54097;56911;873;29761;284827;81543;7226,213
1,1,21,15006458,48097372,33090914,54148;4599;5316;337882;106865373;1409;54101;9875;1826;9073;386679;874;51227;10950;337970;101928147;386681;56245;54943;643812;326;5121;1476;9946;116448;1292;64699;11077;1827;3150;63977;10281;149998;337973;8566;26046;7307;7113;54014;116159;56683;150094;85395;59271;386685;23515;337878;8624;29980;386683;337979;8568;100288323;54149;6450;4731;6493;539;104;54093;5822;6453;4047;54039;337985;7033;353333;23181;3454;25825;23275;2618;337976;2078;3455;1525;140258;56246;64968;49854;89766;754;3460;6647;54065;150051;58494;80781;7327;10785;337879;10841;54033;3753;337972;6782;150084;643803;728299;9992;386672;5211;861;11096;2897;56894;54084;6285;3689;8209;1859;29104;337960;7485;386676;571;386680;7267;53347;7074;5152;10311;150082;3772;3275;54059;8208;9510;10317;5116;84221;29947;337959;4685;6612;337968;755;1291;351;875;10069;7032;100131902;522;53820;9980;337963;337967;353323;7031;3588;6526;10215;7109;140578;386674;386675;23076;6573;3763;2114;353332;3141;4600;337971;54058;8204;386677;89765;30811;337974;337977;5651;337969;388813;57466;140290;54069;2551;757;10600;90625;23562;23308;26285;10694;386678;337975;337880;100288287;54102;317754;6651;8888;8867;94104;64092;25966;54020;337966;9619;386684;388818;337978;386682;254950;54097;56911;873;29761;284827;81543;7226,213
1,1,21,15006458,48097372,33090914,54148;4599;5316;337882;106865373;1409;54101;9875;1826;9073;386679;874;51227;10950;337970;101928147;386681;56245;54943;643812;326;5121;1476;9946;116448;1292;64699;11077;1827;3150;63977;10281;149998;337973;8566;26046;7307;7113;54014;116159;56683;150094;85395;59271;386685;23515;337878;8624;29980;386683;337979;8568;100288323;54149;6450;4731;6493;539;104;54093;5822;6453;4047;54039;337985;7033;353333;23181;3454;25825;23275;2618;337976;2078;3455;1525;140258;56246;64968;49854;89766;754;3460;6647;54065;150051;58494;80781;7327;10785;337879;10841;54033;3753;337972;6782;150084;643803;728299;9992;386672;5211;861;11096;2897;56894;54084;6285;3689;8209;1859;29104;337960;7485;386676;571;386680;7267;53347;7074;5152;10311;150082;3772;3275;54059;8208;9510;10317;5116;84221;29947;337959;4685;6612;337968;755;1291;351;875;10069;7032;100131902;522;53820;9980;337963;337967;353323;7031;3588;6526;10215;7109;140578;386674;386675;23076;6573;3763;2114;353332;3141;4600;337971;54058;8204;386677;89765;30811;337974;337977;5651;337969;388813;57466;140290;54069;2551;757;10600;90625;23562;23308;26285;10694;386678;337975;337880;100288287;54102;317754;6651;8888;8867;94104;64092;25966;54020;337966;9619;386684;388818;337978;386682;254950;54097;56911;873;29761;284827;81543;7226,213
1,1,21,15006458,48097372,33090914,54148;4599;5316;337882;106865373;1409;54101;9875;1826;9073;386679;874;51227;10950;337970;101928147;386681;56245;54943;643812;326;5121;1476;9946;116448;1292;64699;11077;1827;3150;63977;10281;149998;337973;8566;26046;7307;7113;54014;116159;56683;150094;85395;59271;386685;23515;337878;8624;29980;386683;337979;8568;100288323;54149;6450;4731;6493;539;104;54093;5822;6453;4047;54039;337985;7033;353333;23181;3454;25825;23275;2618;337976;2078;3455;1525;140258;56246;64968;49854;89766;754;3460;6647;54065;150051;58494;80781;7327;10785;337879;10841;54033;3753;337972;6782;150084;643803;728299;9992;386672;5211;861;11096;2897;56894;54084;6285;3689;8209;1859;29104;337960;7485;386676;571;386680;7267;53347;7074;5152;10311;150082;3772;3275;54059;8208;9510;10317;5116;84221;29947;337959;4685;6612;337968;755;1291;351;875;10069;7032;100131902;522;53820;9980;337963;337967;353323;7031;3588;6526;10215;7109;140578;386674;386675;23076;6573;3763;2114;353332;3141;4600;337971;54058;8204;386677;89765;30811;337974;337977;5651;337969;388813;57466;140290;54069;2551;757;10600;90625;23562;23308;26285;10694;386678;337975;337880;100288287;54102;317754;6651;8888;8867;94104;64092;25966;54020;337966;9619;386684;388818;337978;386682;254950;54097;56911;873;29761;284827;81543;7226,213
1,1,21,15006458,48097372,33090914,54148;4599;5316;337882;106865373;1409;54101;9875;1826;9073;386679;874;51227;10950;337970;101928147;386681;56245;54943;643812;326;5121;1476;9946;116448;1292;64699;11077;1827;3150;63977;10281;149998;337973;8566;26046;7307;7113;54014;116159;56683;150094;85395;59271;386685;23515;337878;8624;29980;386683;337979;8568;100288323;54149;6450;4731;6493;539;104;54093;5822;6453;4047;54039;337985;7033;353333;23181;3454;25825;23275;2618;337976;2078;3455;1525;140258;56246;64968;49854;89766;754;3460;6647;54065;150051;58494;80781;7327;10785;337879;10841;54033;3753;337972;6782;150084;643803;728299;9992;386672;5211;861;11096;2897;56894;54084;6285;3689;8209;1859;29104;337960;7485;386676;571;386680;7267;53347;7074;5152;10311;150082;3772;3275;54059;8208;9510;10317;5116;84221;29947;337959;4685;6612;337968;755;1291;351;875;10069;7032;100131902;522;53820;9980;337963;337967;353323;7031;3588;6526;10215;7109;140578;386674;386675;23076;6573;3763;2114;353332;3141;4600;337971;54058;8204;386677;89765;30811;337974;337977;5651;337969;388813;57466;140290;54069;2551;757;10600;90625;23562;23308;26285;10694;386678;337975;337880;100288287;54102;317754;6651;8888;8867;94104;64092;25966;54020;337966;9619;386684;388818;337978;386682;254950;54097;56911;873;29761;284827;81543;7226,213
1,1,21,15006458,48097372,33090914,54148;4599;5316;337882;106865373;1409;54101;9875;1826;9073;386679;874;51227;10950;337970;101928147;386681;56245;54943;643812;326;5121;1476;9946;116448;1292;64699;11077;1827;3150;63977;10281;149998;337973;8566;26046;7307;7113;54014;116159;56683;150094;85395;59271;386685;23515;337878;8624;29980;386683;337979;8568;100288323;54149;6450;4731;6493;539;104;54093;5822;6453;4047;54039;337985;7033;353333;23181;3454;25825;23275;2618;337976;2078;3455;1525;140258;56246;64968;49854;89766;754;3460;6647;54065;150051;58494;80781;7327;10785;337879;10841;54033;3753;337972;6782;150084;643803;728299;9992;386672;5211;861;11096;2897;56894;54084;6285;3689;8209;1859;29104;337960;7485;386676;571;386680;7267;53347;7074;5152;10311;150082;3772;3275;54059;8208;9510;10317;5116;84221;29947;337959;4685;6612;337968;755;1291;351;875;10069;7032;100131902;522;53820;9980;337963;337967;353323;7031;3588;6526;10215;7109;140578;386674;386675;23076;6573;3763;2114;353332;3141;4600;337971;54058;8204;386677;89765;30811;337974;337977;5651;337969;388813;57466;140290;54069;2551;757;10600;90625;23562;23308;26285;10694;386678;337975;337880;100288287;54102;317754;6651;8888;8867;94104;64092;25966;54020;337966;9619;386684;388818;337978;386682;254950;54097;56911;873;29761;284827;81543;7226,213
1,1,21,15006458,48097372,33090914,54148;4599;5316;337882;106865373;1409;54101;9875;1826;9073;386679;874;51227;10950;337970;101928147;386681;56245;54943;643812;326;5121;1476;9946;116448;1292;64699;11077;1827;3150;63977;10281;149998;337973;8566;26046;7307;7113;54014;116159;56683;150094;85395;59271;386685;23515;337878;8624;29980;386683;337979;8568;100288323;54149;6450;4731;6493;539;104;54093;5822;6453;4047;54039;337985;7033;353333;23181;3454;25825;23275;2618;337976;2078;3455;1525;140258;56246;64968;49854;89766;754;3460;6647;54065;150051;58494;80781;7327;10785;337879;10841;54033;3753;337972;6782;150084;643803;728299;9992;386672;5211;861;11096;2897;56894;54084;6285;3689;8209;1859;29104;337960;7485;386676;571;386680;7267;53347;7074;5152;10311;150082;3772;3275;54059;8208;9510;10317;5116;84221;29947;337959;4685;6612;337968;755;1291;351;875;10069;7032;100131902;522;53820;9980;337963;337967;353323;7031;3588;6526;10215;7109;140578;386674;386675;23076;6573;3763;2114;353332;3141;4600;337971;54058;8204;386677;89765;30811;337974;337977;5651;337969;388813;57466;140290;54069;2551;757;10600;90625;23562;23308;26285;10694;386678;337975;337880;100288287;54102;317754;6651;8888;8867;94104;64092;25966;54020;337966;9619;386684;388818;337978;386682;254950;54097;56911;873;29761;284827;81543;7226,213
1,1,21,15006458,48097372,33090914,54148;4599;5316;337882;106865373;1409;54101;9875;1826;9073;386679;874;51227;10950;337970;101928147;386681;56245;54943;643812;326;5121;1476;9946;116448;1292;64699;11077;1827;3150;63977;10281;149998;337973;8566;26046;7307;7113;54014;116159;56683;150094;85395;59271;386685;23515;337878;8624;29980;386683;337979;8568;100288323;54149;6450;4731;6493;539;104;54093;5822;6453;4047;54039;337985;7033;353333;23181;3454;25825;23275;2618;337976;2078;3455;1525;140258;56246;64968;49854;89766;754;3460;6647;54065;150051;58494;80781;7327;10785;337879;10841;54033;3753;337972;6782;150084;643803;728299;9992;386672;5211;861;11096;2897;56894;54084;6285;3689;8209;1859;29104;337960;7485;386676;571;386680;7267;53347;7074;5152;10311;150082;3772;3275;54059;8208;9510;10317;5116;84221;29947;337959;4685;6612;337968;755;1291;351;875;10069;7032;100131902;522;53820;9980;337963;337967;353323;7031;3588;6526;10215;7109;140578;386674;386675;23076;6573;3763;2114;353332;3141;4600;337971;54058;8204;386677;89765;30811;337974;337977;5651;337969;388813;57466;140290;54069;2551;757;10600;90625;23562;23308;26285;10694;386678;337975;337880;100288287;54102;317754;6651;8888;8867;94104;64092;25966;54020;337966;9619;386684;388818;337978;386682;254950;54097;56911;873;29761;284827;81543;7226,213
1,1,21,15006458,48097372,33090914,54148;4599;5316;337882;106865373;1409;54101;9875;1826;9073;386679;874;51227;10950;337970;101928147;386681;56245;54943;643812;326;5121;1476;9946;116448;1292;64699;11077;1827;3150;63977;10281;149998;337973;8566;26046;7307;7113;54014;116159;56683;150094;85395;59271;386685;23515;337878;8624;29980;386683;337979;8568;100288323;54149;6450;4731;6493;539;104;54093;5822;6453;4047;54039;337985;7033;353333;23181;3454;25825;23275;2618;337976;2078;3455;1525;140258;56246;64968;49854;89766;754;3460;6647;54065;150051;58494;80781;7327;10785;337879;10841;54033;3753;337972;6782;150084;643803;728299;9992;386672;5211;861;11096;2897;56894;54084;6285;3689;8209;1859;29104;337960;7485;386676;571;386680;7267;53347;7074;5152;10311;150082;3772;3275;54059;8208;9510;10317;5116;84221;29947;337959;4685;6612;337968;755;1291;351;875;10069;7032;100131902;522;53820;9980;337963;337967;353323;7031;3588;6526;10215;7109;140578;386674;386675;23076;6573;3763;2114;353332;3141;4600;337971;54058;8204;386677;89765;30811;337974;337977;5651;337969;388813;57466;140290;54069;2551;757;10600;90625;23562;23308;26285;10694;386678;337975;337880;100288287;54102;317754;6651;8888;8867;94104;64092;25966;54020;337966;9619;386684;388818;337978;386682;254950;54097;56911;873;29761;284827;81543;7226,213
1,1,21,15006458,48097372,33090914,54148;4599;5316;337882;106865373;1409;54101;9875;1826;9073;386679;874;51227;10950;337970;101928147;386681;56245;54943;643812;326;5121;1476;9946;116448;1292;64699;11077;1827;3150;63977;10281;149998;337973;8566;26046;7307;7113;54014;116159;56683;150094;85395;59271;386685;23515;337878;8624;29980;386683;337979;8568;100288323;54149;6450;4731;6493;539;104;54093;5822;6453;4047;54039;337985;7033;353333;23181;3454;25825;23275;2618;337976;2078;3455;1525;140258;56246;64968;49854;89766;754;3460;6647;54065;150051;58494;80781;7327;10785;337879;10841;54033;3753;337972;6782;150084;643803;728299;9992;386672;5211;861;11096;2897;56894;54084;6285;3689;8209;1859;29104;337960;7485;386676;571;386680;7267;53347;7074;5152;10311;150082;3772;3275;54059;8208;9510;10317;5116;84221;29947;337959;4685;6612;337968;755;1291;351;875;10069;7032;100131902;522;53820;9980;337963;337967;353323;7031;3588;6526;10215;7109;140578;386674;386675;23076;6573;3763;2114;353332;3141;4600;337971;54058;8204;386677;89765;30811;337974;337977;5651;337969;388813;57466;140290;54069;2551;757;10600;90625;23562;23308;26285;10694;386678;337975;337880;100288287;54102;317754;6651;8888;8867;94104;64092;25966;54020;337966;9619;386684;388818;337978;386682;254950;54097;56911;873;29761;284827;81543;7226,213
1,1,21,15006458,48097372,33090914,54148;4599;5316;337882;106865373;1409;54101;9875;1826;9073;386679;874;51227;10950;337970;101928147;386681;56245;54943;643812;326;5121;1476;9946;116448;1292;64699;11077;1827;3150;63977;10281;149998;337973;8566;26046;7307;7113;54014;116159;56683;150094;85395;59271;386685;23515;337878;8624;29980;386683;337979;8568;100288323;54149;6450;4731;6493;539;104;54093;5822;6453;4047;54039;337985;7033;353333;23181;3454;25825;23275;2618;337976;2078;3455;1525;140258;56246;64968;49854;89766;754;3460;6647;54065;150051;58494;80781;7327;10785;337879;10841;54033;3753;337972;6782;150084;643803;728299;9992;386672;5211;861;11096;2897;56894;54084;6285;3689;8209;1859;29104;337960;7485;386676;571;386680;7267;53347;7074;5152;10311;150082;3772;3275;54059;8208;9510;10317;5116;84221;29947;337959;4685;6612;337968;755;1291;351;875;10069;7032;100131902;522;53820;9980;337963;337967;353323;7031;3588;6526;10215;7109;140578;386674;386675;23076;6573;3763;2114;353332;3141;4600;337971;54058;8204;386677;89765;30811;337974;337977;5651;337969;388813;57466;140290;54069;2551;757;10600;90625;23562;23308;26285;10694;386678;337975;337880;100288287;54102;317754;6651;8888;8867;94104;64092;25966;54020;337966;9619;386684;388818;337978;386682;254950;54097;56911;873;29761;284827;81543;7226,213
1,1,21,15006458,48097372,33090914,54148;4599;5316;337882;106865373;1409;54101;9875;1826;9073;386679;874;51227;10950;337970;101928147;386681;56245;54943;643812;326;5121;1476;9946;116448;1292;64699;11077;1827;3150;63977;10281;149998;337973;8566;26046;7307;7113;54014;116159;56683;150094;85395;59271;386685;23515;337878;8624;29980;386683;337979;8568;100288323;54149;6450;4731;6493;539;104;54093;5822;6453;4047;54039;337985;7033;353333;23181;3454;25825;23275;2618;337976;2078;3455;1525;140258;56246;64968;49854;89766;754;3460;6647;54065;150051;58494;80781;7327;10785;337879;10841;54033;3753;337972;6782;150084;643803;728299;9992;386672;5211;861;11096;2897;56894;54084;6285;3689;8209;1859;29104;337960;7485;386676;571;386680;7267;53347;7074;5152;10311;150082;3772;3275;54059;8208;9510;10317;5116;84221;29947;337959;4685;6612;337968;755;1291;351;875;10069;7032;100131902;522;53820;9980;337963;337967;353323;7031;3588;6526;10215;7109;140578;386674;386675;23076;6573;3763;2114;353332;3141;4600;337971;54058;8204;386677;89765;30811;337974;337977;5651;337969;388813;57466;140290;54069;2551;757;10600;90625;23562;23308;26285;10694;386678;337975;337880;100288287;54102;317754;6651;8888;8867;94104;64092;25966;54020;337966;9619;386684;388818;337978;386682;254950;54097;56911;873;29761;284827;81543;7226,213
1,1,21,15006458,48097372,33090914,54148;4599;5316;337882;106865373;1409;54101;9875;1826;9073;386679;874;51227;10950;337970;101928147;386681;56245;54943;643812;326;5121;1476;9946;116448;1292;64699;11077;1827;3150;63977;10281;149998;337973;8566;26046;7307;7113;54014;116159;56683;150094;85395;59271;386685;23515;337878;8624;29980;386683;337979;8568;100288323;54149;6450;4731;6493;539;104;54093;5822;6453;4047;54039;337985;7033;353333;23181;3454;25825;23275;2618;337976;2078;3455;1525;140258;56246;64968;49854;89766;754;3460;6647;54065;150051;58494;80781;7327;10785;337879;10841;54033;3753;337972;6782;150084;643803;728299;9992;386672;5211;861;11096;2897;56894;54084;6285;3689;8209;1859;29104;337960;7485;386676;571;386680;7267;53347;7074;5152;10311;150082;3772;3275;54059;8208;9510;10317;5116;84221;29947;337959;4685;6612;337968;755;1291;351;875;10069;7032;100131902;522;53820;9980;337963;337967;353323;7031;3588;6526;10215;7109;140578;386674;386675;23076;6573;3763;2114;353332;3141;4600;337971;54058;8204;386677;89765;30811;337974;337977;5651;337969;388813;57466;140290;54069;2551;757;10600;90625;23562;23308;26285;10694;386678;337975;337880;100288287;54102;317754;6651;8888;8867;94104;64092;25966;54020;337966;9619;386684;388818;337978;386682;254950;54097;56911;873;29761;284827;81543;7226,213
1,1,21,15006458,48097372,33090914,54148;4599;5316;337882;106865373;1409;54101;9875;1826;9073;386679;874;51227;10950;337970;101928147;386681;56245;54943;643812;326;5121;1476;9946;116448;1292;64699;11077;1827;3150;63977;10281;149998;337973;8566;26046;7307;7113;54014;116159;56683;150094;85395;59271;386685;23515;337878;8624;29980;386683;337979;8568;100288323;54149;6450;4731;6493;539;104;54093;5822;6453;4047;54039;337985;7033;353333;23181;3454;25825;23275;2618;337976;2078;3455;1525;140258;56246;64968;49854;89766;754;3460;6647;54065;150051;58494;80781;7327;10785;337879;10841;54033;3753;337972;6782;150084;643803;728299;9992;386672;5211;861;11096;2897;56894;54084;6285;3689;8209;1859;29104;337960;7485;386676;571;386680;7267;53347;7074;5152;10311;150082;3772;3275;54059;8208;9510;10317;5116;84221;29947;337959;4685;6612;337968;755;1291;351;875;10069;7032;100131902;522;53820;9980;337963;337967;353323;7031;3588;6526;10215;7109;140578;386674;386675;23076;6573;3763;2114;353332;3141;4600;337971;54058;8204;386677;89765;30811;337974;337977;5651;337969;388813;57466;140290;54069;2551;757;10600;90625;23562;23308;26285;10694;386678;337975;337880;100288287;54102;317754;6651;8888;8867;94104;64092;25966;54020;337966;9619;386684;388818;337978;386682;254950;54097;56911;873;29761;284827;81543;7226,213
1,1,21,15006458,48097372,33090914,54148;4599;5316;337882;106865373;1409;54101;9875;1826;9073;386679;874;51227;10950;337970;101928147;386681;56245;54943;643812;326;5121;1476;9946;116448;1292;64699;11077;1827;3150;63977;10281;149998;337973;8566;26046;7307;7113;54014;116159;56683;150094;85395;59271;386685;23515;337878;8624;29980;386683;337979;8568;100288323;54149;6450;4731;6493;539;104;54093;5822;6453;4047;54039;337985;7033;353333;23181;3454;25825;23275;2618;337976;2078;3455;1525;140258;56246;64968;49854;89766;754;3460;6647;54065;150051;58494;80781;7327;10785;337879;10841;54033;3753;337972;6782;150084;643803;728299;9992;386672;5211;861;11096;2897;56894;54084;6285;3689;8209;1859;29104;337960;7485;386676;571;386680;7267;53347;7074;5152;10311;150082;3772;3275;54059;8208;9510;10317;5116;84221;29947;337959;4685;6612;337968;755;1291;351;875;10069;7032;100131902;522;53820;9980;337963;337967;353323;7031;3588;6526;10215;7109;140578;386674;386675;23076;6573;3763;2114;353332;3141;4600;337971;54058;8204;386677;89765;30811;337974;337977;5651;337969;388813;57466;140290;54069;2551;757;10600;90625;23562;23308;26285;10694;386678;337975;337880;100288287;54102;317754;6651;8888;8867;94104;64092;25966;54020;337966;9619;386684;388818;337978;386682;254950;54097;56911;873;29761;284827;81543;7226,213
1,1,21,15006458,48097372,33090914,54148;4599;5316;337882;106865373;1409;54101;9875;1826;9073;386679;874;51227;10950;337970;101928147;386681;56245;54943;643812;326;5121;1476;9946;116448;1292;64699;11077;1827;3150;63977;10281;149998;337973;8566;26046;7307;7113;54014;116159;56683;150094;85395;59271;386685;23515;337878;8624;29980;386683;337979;8568;100288323;54149;6450;4731;6493;539;104;54093;5822;6453;4047;54039;337985;7033;353333;23181;3454;25825;23275;2618;337976;2078;3455;1525;140258;56246;64968;49854;89766;754;3460;6647;54065;150051;58494;80781;7327;10785;337879;10841;54033;3753;337972;6782;150084;643803;728299;9992;386672;5211;861;11096;2897;56894;54084;6285;3689;8209;1859;29104;337960;7485;386676;571;386680;7267;53347;7074;5152;10311;150082;3772;3275;54059;8208;9510;10317;5116;84221;29947;337959;4685;6612;337968;755;1291;351;875;10069;7032;100131902;522;53820;9980;337963;337967;353323;7031;3588;6526;10215;7109;140578;386674;386675;23076;6573;3763;2114;353332;3141;4600;337971;54058;8204;386677;89765;30811;337974;337977;5651;337969;388813;57466;140290;54069;2551;757;10600;90625;23562;23308;26285;10694;386678;337975;337880;100288287;54102;317754;6651;8888;8867;94104;64092;25966;54020;337966;9619;386684;388818;337978;386682;254950;54097;56911;873;29761;284827;81543;7226,213
1,1,21,15006458,48097372,33090914,54148;4599;5316;337882;106865373;1409;54101;9875;1826;9073;386679;874;51227;10950;337970;101928147;386681;56245;54943;643812;326;5121;1476;9946;116448;1292;64699;11077;1827;3150;63977;10281;149998;337973;8566;26046;7307;7113;54014;116159;56683;150094;85395;59271;386685;23515;337878;8624;29980;386683;337979;8568;100288323;54149;6450;4731;6493;539;104;54093;5822;6453;4047;54039;337985;7033;353333;23181;3454;25825;23275;2618;337976;2078;3455;1525;140258;56246;64968;49854;89766;754;3460;6647;54065;150051;58494;80781;7327;10785;337879;10841;54033;3753;337972;6782;150084;643803;728299;9992;386672;5211;861;11096;2897;56894;54084;6285;3689;8209;1859;29104;337960;7485;386676;571;386680;7267;53347;7074;5152;10311;150082;3772;3275;54059;8208;9510;10317;5116;84221;29947;337959;4685;6612;337968;755;1291;351;875;10069;7032;100131902;522;53820;9980;337963;337967;353323;7031;3588;6526;10215;7109;140578;386674;386675;23076;6573;3763;2114;353332;3141;4600;337971;54058;8204;386677;89765;30811;337974;337977;5651;337969;388813;57466;140290;54069;2551;757;10600;90625;23562;23308;26285;10694;386678;337975;337880;100288287;54102;317754;6651;8888;8867;94104;64092;25966;54020;337966;9619;386684;388818;337978;386682;254950;54097;56911;873;29761;284827;81543;7226,213
1,1,21,15006458,48097372,33090914,54148;4599;5316;337882;106865373;1409;54101;9875;1826;9073;386679;874;51227;10950;337970;101928147;386681;56245;54943;643812;326;5121;1476;9946;116448;1292;64699;11077;1827;3150;63977;10281;149998;337973;8566;26046;7307;7113;54014;116159;56683;150094;85395;59271;386685;23515;337878;8624;29980;386683;337979;8568;100288323;54149;6450;4731;6493;539;104;54093;5822;6453;4047;54039;337985;7033;353333;23181;3454;25825;23275;2618;337976;2078;3455;1525;140258;56246;64968;49854;89766;754;3460;6647;54065;150051;58494;80781;7327;10785;337879;10841;54033;3753;337972;6782;150084;643803;728299;9992;386672;5211;861;11096;2897;56894;54084;6285;3689;8209;1859;29104;337960;7485;386676;571;386680;7267;53347;7074;5152;10311;150082;3772;3275;54059;8208;9510;10317;5116;84221;29947;337959;4685;6612;337968;755;1291;351;875;10069;7032;100131902;522;53820;9980;337963;337967;353323;7031;3588;6526;10215;7109;140578;386674;386675;23076;6573;3763;2114;353332;3141;4600;337971;54058;8204;386677;89765;30811;337974;337977;5651;337969;388813;57466;140290;54069;2551;757;10600;90625;23562;23308;26285;10694;386678;337975;337880;100288287;54102;317754;6651;8888;8867;94104;64092;25966;54020;337966;9619;386684;388818;337978;386682;254950;54097;56911;873;29761;284827;81543;7226,213
1,1,21,15006458,48097372,33090914,54148;4599;5316;337882;106865373;1409;54101;9875;1826;9073;386679;874;51227;10950;337970;101928147;386681;56245;54943;643812;326;5121;1476;9946;116448;1292;64699;11077;1827;3150;63977;10281;149998;337973;8566;26046;7307;7113;54014;116159;56683;150094;85395;59271;386685;23515;337878;8624;29980;386683;337979;8568;100288323;54149;6450;4731;6493;539;104;54093;5822;6453;4047;54039;337985;7033;353333;23181;3454;25825;23275;2618;337976;2078;3455;1525;140258;56246;64968;49854;89766;754;3460;6647;54065;150051;58494;80781;7327;10785;337879;10841;54033;3753;337972;6782;150084;643803;728299;9992;386672;5211;861;11096;2897;56894;54084;6285;3689;8209;1859;29104;337960;7485;386676;571;386680;7267;53347;7074;5152;10311;150082;3772;3275;54059;8208;9510;10317;5116;84221;29947;337959;4685;6612;337968;755;1291;351;875;10069;7032;100131902;522;53820;9980;337963;337967;353323;7031;3588;6526;10215;7109;140578;386674;386675;23076;6573;3763;2114;353332;3141;4600;337971;54058;8204;386677;89765;30811;337974;337977;5651;337969;388813;57466;140290;54069;2551;757;10600;90625;23562;23308;26285;10694;386678;337975;337880;100288287;54102;317754;6651;8888;8867;94104;64092;25966;54020;337966;9619;386684;388818;337978;386682;254950;54097;56911;873;29761;284827;81543;7226,213
1,1,21,15006458,48097372,33090914,54148;4599;5316;337882;106865373;1409;54101;9875;1826;9073;386679;874;51227;10950;337970;101928147;386681;56245;54943;643812;326;5121;1476;9946;116448;1292;64699;11077;1827;3150;63977;10281;149998;337973;8566;26046;7307;7113;54014;116159;56683;150094;85395;59271;386685;23515;337878;8624;29980;386683;337979;8568;100288323;54149;6450;4731;6493;539;104;54093;5822;6453;4047;54039;337985;7033;353333;23181;3454;25825;23275;2618;337976;2078;3455;1525;140258;56246;64968;49854;89766;754;3460;6647;54065;150051;58494;80781;7327;10785;337879;10841;54033;3753;337972;6782;150084;643803;728299;9992;386672;5211;861;11096;2897;56894;54084;6285;3689;8209;1859;29104;337960;7485;386676;571;386680;7267;53347;7074;5152;10311;150082;3772;3275;54059;8208;9510;10317;5116;84221;29947;337959;4685;6612;337968;755;1291;351;875;10069;7032;100131902;522;53820;9980;337963;337967;353323;7031;3588;6526;10215;7109;140578;386674;386675;23076;6573;3763;2114;353332;3141;4600;337971;54058;8204;386677;89765;30811;337974;337977;5651;337969;388813;57466;140290;54069;2551;757;10600;90625;23562;23308;26285;10694;386678;337975;337880;100288287;54102;317754;6651;8888;8867;94104;64092;25966;54020;337966;9619;386684;388818;337978;386682;254950;54097;56911;873;29761;284827;81543;7226,213
1,1,21,15006458,48097372,33090914,54148;4599;5316;337882;106865373;1409;54101;9875;1826;9073;386679;874;51227;10950;337970;101928147;386681;56245;54943;643812;326;5121;1476;9946;116448;1292;64699;11077;1827;3150;63977;10281;149998;337973;8566;26046;7307;7113;54014;116159;56683;150094;85395;59271;386685;23515;337878;8624;29980;386683;337979;8568;100288323;54149;6450;4731;6493;539;104;54093;5822;6453;4047;54039;337985;7033;353333;23181;3454;25825;23275;2618;337976;2078;3455;1525;140258;56246;64968;49854;89766;754;3460;6647;54065;150051;58494;80781;7327;10785;337879;10841;54033;3753;337972;6782;150084;643803;728299;9992;386672;5211;861;11096;2897;56894;54084;6285;3689;8209;1859;29104;337960;7485;386676;571;386680;7267;53347;7074;5152;10311;150082;3772;3275;54059;8208;9510;10317;5116;84221;29947;337959;4685;6612;337968;755;1291;351;875;10069;7032;100131902;522;53820;9980;337963;337967;353323;7031;3588;6526;10215;7109;140578;386674;386675;23076;6573;3763;2114;353332;3141;4600;337971;54058;8204;386677;89765;30811;337974;337977;5651;337969;388813;57466;140290;54069;2551;757;10600;90625;23562;23308;26285;10694;386678;337975;337880;100288287;54102;317754;6651;8888;8867;94104;64092;25966;54020;337966;9619;386684;388818;337978;386682;254950;54097;56911;873;29761;284827;81543;7226,213
1,1,21,15006458,48097372,33090914,54148;4599;5316;337882;106865373;1409;54101;9875;1826;9073;386679;874;51227;10950;337970;101928147;386681;56245;54943;643812;326;5121;1476;9946;116448;1292;64699;11077;1827;3150;63977;10281;149998;337973;8566;26046;7307;7113;54014;116159;56683;150094;85395;59271;386685;23515;337878;8624;29980;386683;337979;8568;100288323;54149;6450;4731;6493;539;104;54093;5822;6453;4047;54039;337985;7033;353333;23181;3454;25825;23275;2618;337976;2078;3455;1525;140258;56246;64968;49854;89766;754;3460;6647;54065;150051;58494;80781;7327;10785;337879;10841;54033;3753;337972;6782;150084;643803;728299;9992;386672;5211;861;11096;2897;56894;54084;6285;3689;8209;1859;29104;337960;7485;386676;571;386680;7267;53347;7074;5152;10311;150082;3772;3275;54059;8208;9510;10317;5116;84221;29947;337959;4685;6612;337968;755;1291;351;875;10069;7032;100131902;522;53820;9980;337963;337967;353323;7031;3588;6526;10215;7109;140578;386674;386675;23076;6573;3763;2114;353332;3141;4600;337971;54058;8204;386677;89765;30811;337974;337977;5651;337969;388813;57466;140290;54069;2551;757;10600;90625;23562;23308;26285;10694;386678;337975;337880;100288287;54102;317754;6651;8888;8867;94104;64092;25966;54020;337966;9619;386684;388818;337978;386682;254950;54097;56911;873;29761;284827;81543;7226,213
1,1,21,15006458,48097372,33090914,54148;4599;5316;337882;106865373;1409;54101;9875;1826;9073;386679;874;51227;10950;337970;101928147;386681;56245;54943;643812;326;5121;1476;9946;116448;1292;64699;11077;1827;3150;63977;10281;149998;337973;8566;26046;7307;7113;54014;116159;56683;150094;85395;59271;386685;23515;337878;8624;29980;386683;337979;8568;100288323;54149;6450;4731;6493;539;104;54093;5822;6453;4047;54039;337985;7033;353333;23181;3454;25825;23275;2618;337976;2078;3455;1525;140258;56246;64968;49854;89766;754;3460;6647;54065;150051;58494;80781;7327;10785;337879;10841;54033;3753;337972;6782;150084;643803;728299;9992;386672;5211;861;11096;2897;56894;54084;6285;3689;8209;1859;29104;337960;7485;386676;571;386680;7267;53347;7074;5152;10311;150082;3772;3275;54059;8208;9510;10317;5116;84221;29947;337959;4685;6612;337968;755;1291;351;875;10069;7032;100131902;522;53820;9980;337963;337967;353323;7031;3588;6526;10215;7109;140578;386674;386675;23076;6573;3763;2114;353332;3141;4600;337971;54058;8204;386677;89765;30811;337974;337977;5651;337969;388813;57466;140290;54069;2551;757;10600;90625;23562;23308;26285;10694;386678;337975;337880;100288287;54102;317754;6651;8888;8867;94104;64092;25966;54020;337966;9619;386684;388818;337978;386682;254950;54097;56911;873;29761;284827;81543;7226,213
1,1,21,15006458,48097372,33090914,54148;4599;5316;337882;106865373;1409;54101;9875;1826;9073;386679;874;51227;10950;337970;101928147;386681;56245;54943;643812;326;5121;1476;9946;116448;1292;64699;11077;1827;3150;63977;10281;149998;337973;8566;26046;7307;7113;54014;116159;56683;150094;85395;59271;386685;23515;337878;8624;29980;386683;337979;8568;100288323;54149;6450;4731;6493;539;104;54093;5822;6453;4047;54039;337985;7033;353333;23181;3454;25825;23275;2618;337976;2078;3455;1525;140258;56246;64968;49854;89766;754;3460;6647;54065;150051;58494;80781;7327;10785;337879;10841;54033;3753;337972;6782;150084;643803;728299;9992;386672;5211;861;11096;2897;56894;54084;6285;3689;8209;1859;29104;337960;7485;386676;571;386680;7267;53347;7074;5152;10311;150082;3772;3275;54059;8208;9510;10317;5116;84221;29947;337959;4685;6612;337968;755;1291;351;875;10069;7032;100131902;522;53820;9980;337963;337967;353323;7031;3588;6526;10215;7109;140578;386674;386675;23076;6573;3763;2114;353332;3141;4600;337971;54058;8204;386677;89765;30811;337974;337977;5651;337969;388813;57466;140290;54069;2551;757;10600;90625;23562;23308;26285;10694;386678;337975;337880;100288287;54102;317754;6651;8888;8867;94104;64092;25966;54020;337966;9619;386684;388818;337978;386682;254950;54097;56911;873;29761;284827;81543;7226,213
1,1,21,15006458,48097372,33090914,54148;4599;5316;337882;106865373;1409;54101;9875;1826;9073;386679;874;51227;10950;337970;101928147;386681;56245;54943;643812;326;5121;1476;9946;116448;1292;64699;11077;1827;3150;63977;10281;149998;337973;8566;26046;7307;7113;54014;116159;56683;150094;85395;59271;386685;23515;337878;8624;29980;386683;337979;8568;100288323;54149;6450;4731;6493;539;104;54093;5822;6453;4047;54039;337985;7033;353333;23181;3454;25825;23275;2618;337976;2078;3455;1525;140258;56246;64968;49854;89766;754;3460;6647;54065;150051;58494;80781;7327;10785;337879;10841;54033;3753;337972;6782;150084;643803;728299;9992;386672;5211;861;11096;2897;56894;54084;6285;3689;8209;1859;29104;337960;7485;386676;571;386680;7267;53347;7074;5152;10311;150082;3772;3275;54059;8208;9510;10317;5116;84221;29947;337959;4685;6612;337968;755;1291;351;875;10069;7032;100131902;522;53820;9980;337963;337967;353323;7031;3588;6526;10215;7109;140578;386674;386675;23076;6573;3763;2114;353332;3141;4600;337971;54058;8204;386677;89765;30811;337974;337977;5651;337969;388813;57466;140290;54069;2551;757;10600;90625;23562;23308;26285;10694;386678;337975;337880;100288287;54102;317754;6651;8888;8867;94104;64092;25966;54020;337966;9619;386684;388818;337978;386682;254950;54097;56911;873;29761;284827;81543;7226,213
1,1,21,15006458,48097372,33090914,54148;4599;5316;337882;106865373;1409;54101;9875;1826;9073;386679;874;51227;10950;337970;101928147;386681;56245;54943;643812;326;5121;1476;9946;116448;1292;64699;11077;1827;3150;63977;10281;149998;337973;8566;26046;7307;7113;54014;116159;56683;150094;85395;59271;386685;23515;337878;8624;29980;386683;337979;8568;100288323;54149;6450;4731;6493;539;104;54093;5822;6453;4047;54039;337985;7033;353333;23181;3454;25825;23275;2618;337976;2078;3455;1525;140258;56246;64968;49854;89766;754;3460;6647;54065;150051;58494;80781;7327;10785;337879;10841;54033;3753;337972;6782;150084;643803;728299;9992;386672;5211;861;11096;2897;56894;54084;6285;3689;8209;1859;29104;337960;7485;386676;571;386680;7267;53347;7074;5152;10311;150082;3772;3275;54059;8208;9510;10317;5116;84221;29947;337959;4685;6612;337968;755;1291;351;875;10069;7032;100131902;522;53820;9980;337963;337967;353323;7031;3588;6526;10215;7109;140578;386674;386675;23076;6573;3763;2114;353332;3141;4600;337971;54058;8204;386677;89765;30811;337974;337977;5651;337969;388813;57466;140290;54069;2551;757;10600;90625;23562;23308;26285;10694;386678;337975;337880;100288287;54102;317754;6651;8888;8867;94104;64092;25966;54020;337966;9619;386684;388818;337978;386682;254950;54097;56911;873;29761;284827;81543;7226,213
1,1,21,15006458,48097372,33090914,54148;4599;5316;337882;106865373;1409;54101;9875;1826;9073;386679;874;51227;10950;337970;101928147;386681;56245;54943;643812;326;5121;1476;9946;116448;1292;64699;11077;1827;3150;63977;10281;149998;337973;8566;26046;7307;7113;54014;116159;56683;150094;85395;59271;386685;23515;337878;8624;29980;386683;337979;8568;100288323;54149;6450;4731;6493;539;104;54093;5822;6453;4047;54039;337985;7033;353333;23181;3454;25825;23275;2618;337976;2078;3455;1525;140258;56246;64968;49854;89766;754;3460;6647;54065;150051;58494;80781;7327;10785;337879;10841;54033;3753;337972;6782;150084;643803;728299;9992;386672;5211;861;11096;2897;56894;54084;6285;3689;8209;1859;29104;337960;7485;386676;571;386680;7267;53347;7074;5152;10311;150082;3772;3275;54059;8208;9510;10317;5116;84221;29947;337959;4685;6612;337968;755;1291;351;875;10069;7032;100131902;522;53820;9980;337963;337967;353323;7031;3588;6526;10215;7109;140578;386674;386675;23076;6573;3763;2114;353332;3141;4600;337971;54058;8204;386677;89765;30811;337974;337977;5651;337969;388813;57466;140290;54069;2551;757;10600;90625;23562;23308;26285;10694;386678;337975;337880;100288287;54102;317754;6651;8888;8867;94104;64092;25966;54020;337966;9619;386684;388818;337978;386682;254950;54097;56911;873;29761;284827;81543;7226,213
1,1,21,15006458,48097372,33090914,54148;4599;5316;337882;106865373;1409;54101;9875;1826;9073;386679;874;51227;10950;337970;101928147;386681;56245;54943;643812;326;5121;1476;9946;116448;1292;64699;11077;1827;3150;63977;10281;149998;337973;8566;26046;7307;7113;54014;116159;56683;150094;85395;59271;386685;23515;337878;8624;29980;386683;337979;8568;100288323;54149;6450;4731;6493;539;104;54093;5822;6453;4047;54039;337985;7033;353333;23181;3454;25825;23275;2618;337976;2078;3455;1525;140258;56246;64968;49854;89766;754;3460;6647;54065;150051;58494;80781;7327;10785;337879;10841;54033;3753;337972;6782;150084;643803;728299;9992;386672;5211;861;11096;2897;56894;54084;6285;3689;8209;1859;29104;337960;7485;386676;571;386680;7267;53347;7074;5152;10311;150082;3772;3275;54059;8208;9510;10317;5116;84221;29947;337959;4685;6612;337968;755;1291;351;875;10069;7032;100131902;522;53820;9980;337963;337967;353323;7031;3588;6526;10215;7109;140578;386674;386675;23076;6573;3763;2114;353332;3141;4600;337971;54058;8204;386677;89765;30811;337974;337977;5651;337969;388813;57466;140290;54069;2551;757;10600;90625;23562;23308;26285;10694;386678;337975;337880;100288287;54102;317754;6651;8888;8867;94104;64092;25966;54020;337966;9619;386684;388818;337978;386682;254950;54097;56911;873;29761;284827;81543;7226,213
1,1,21,15006458,48097372,33090914,54148;4599;5316;337882;106865373;1409;54101;9875;1826;9073;386679;874;51227;10950;337970;101928147;386681;56245;54943;643812;326;5121;1476;9946;116448;1292;64699;11077;1827;3150;63977;10281;149998;337973;8566;26046;7307;7113;54014;116159;56683;150094;85395;59271;386685;23515;337878;8624;29980;386683;337979;8568;100288323;54149;6450;4731;6493;539;104;54093;5822;6453;4047;54039;337985;7033;353333;23181;3454;25825;23275;2618;337976;2078;3455;1525;140258;56246;64968;49854;89766;754;3460;6647;54065;150051;58494;80781;7327;10785;337879;10841;54033;3753;337972;6782;150084;643803;728299;9992;386672;5211;861;11096;2897;56894;54084;6285;3689;8209;1859;29104;337960;7485;386676;571;386680;7267;53347;7074;5152;10311;150082;3772;3275;54059;8208;9510;10317;5116;84221;29947;337959;4685;6612;337968;755;1291;351;875;10069;7032;100131902;522;53820;9980;337963;337967;353323;7031;3588;6526;10215;7109;140578;386674;386675;23076;6573;3763;2114;353332;3141;4600;337971;54058;8204;386677;89765;30811;337974;337977;5651;337969;388813;57466;140290;54069;2551;757;10600;90625;23562;23308;26285;10694;386678;337975;337880;100288287;54102;317754;6651;8888;8867;94104;64092;25966;54020;337966;9619;386684;388818;337978;386682;254950;54097;56911;873;29761;284827;81543;7226,213
1,1,21,15006458,48097372,33090914,54148;4599;5316;337882;106865373;1409;54101;9875;1826;9073;386679;874;51227;10950;337970;101928147;386681;56245;54943;643812;326;5121;1476;9946;116448;1292;64699;11077;1827;3150;63977;10281;149998;337973;8566;26046;7307;7113;54014;116159;56683;150094;85395;59271;386685;23515;337878;8624;29980;386683;337979;8568;100288323;54149;6450;4731;6493;539;104;54093;5822;6453;4047;54039;337985;7033;353333;23181;3454;25825;23275;2618;337976;2078;3455;1525;140258;56246;64968;49854;89766;754;3460;6647;54065;150051;58494;80781;7327;10785;337879;10841;54033;3753;337972;6782;150084;643803;728299;9992;386672;5211;861;11096;2897;56894;54084;6285;3689;8209;1859;29104;337960;7485;386676;571;386680;7267;53347;7074;5152;10311;150082;3772;3275;54059;8208;9510;10317;5116;84221;29947;337959;4685;6612;337968;755;1291;351;875;10069;7032;100131902;522;53820;9980;337963;337967;353323;7031;3588;6526;10215;7109;140578;386674;386675;23076;6573;3763;2114;353332;3141;4600;337971;54058;8204;386677;89765;30811;337974;337977;5651;337969;388813;57466;140290;54069;2551;757;10600;90625;23562;23308;26285;10694;386678;337975;337880;100288287;54102;317754;6651;8888;8867;94104;64092;25966;54020;337966;9619;386684;388818;337978;386682;254950;54097;56911;873;29761;284827;81543;7226,213
1,1,21,15006458,48097372,33090914,54148;4599;5316;337882;106865373;1409;54101;9875;1826;9073;386679;874;51227;10950;337970;101928147;386681;56245;54943;643812;326;5121;1476;9946;116448;1292;64699;11077;1827;3150;63977;10281;149998;337973;8566;26046;7307;7113;54014;116159;56683;150094;85395;59271;386685;23515;337878;8624;29980;386683;337979;8568;100288323;54149;6450;4731;6493;539;104;54093;5822;6453;4047;54039;337985;7033;353333;23181;3454;25825;23275;2618;337976;2078;3455;1525;140258;56246;64968;49854;89766;754;3460;6647;54065;150051;58494;80781;7327;10785;337879;10841;54033;3753;337972;6782;150084;643803;728299;9992;386672;5211;861;11096;2897;56894;54084;6285;3689;8209;1859;29104;337960;7485;386676;571;386680;7267;53347;7074;5152;10311;150082;3772;3275;54059;8208;9510;10317;5116;84221;29947;337959;4685;6612;337968;755;1291;351;875;10069;7032;100131902;522;53820;9980;337963;337967;353323;7031;3588;6526;10215;7109;140578;386674;386675;23076;6573;3763;2114;353332;3141;4600;337971;54058;8204;386677;89765;30811;337974;337977;5651;337969;388813;57466;140290;54069;2551;757;10600;90625;23562;23308;26285;10694;386678;337975;337880;100288287;54102;317754;6651;8888;8867;94104;64092;25966;54020;337966;9619;386684;388818;337978;386682;254950;54097;56911;873;29761;284827;81543;7226,213
1,1,21,15006458,48097372,33090914,54148;4599;5316;337882;106865373;1409;54101;9875;1826;9073;386679;874;51227;10950;337970;101928147;386681;56245;54943;643812;326;5121;1476;9946;116448;1292;64699;11077;1827;3150;63977;10281;149998;337973;8566;26046;7307;7113;54014;116159;56683;150094;85395;59271;386685;23515;337878;8624;29980;386683;337979;8568;100288323;54149;6450;4731;6493;539;104;54093;5822;6453;4047;54039;337985;7033;353333;23181;3454;25825;23275;2618;337976;2078;3455;1525;140258;56246;64968;49854;89766;754;3460;6647;54065;150051;58494;80781;7327;10785;337879;10841;54033;3753;337972;6782;150084;643803;728299;9992;386672;5211;861;11096;2897;56894;54084;6285;3689;8209;1859;29104;337960;7485;386676;571;386680;7267;53347;7074;5152;10311;150082;3772;3275;54059;8208;9510;10317;5116;84221;29947;337959;4685;6612;337968;755;1291;351;875;10069;7032;100131902;522;53820;9980;337963;337967;353323;7031;3588;6526;10215;7109;140578;386674;386675;23076;6573;3763;2114;353332;3141;4600;337971;54058;8204;386677;89765;30811;337974;337977;5651;337969;388813;57466;140290;54069;2551;757;10600;90625;23562;23308;26285;10694;386678;337975;337880;100288287;54102;317754;6651;8888;8867;94104;64092;25966;54020;337966;9619;386684;388818;337978;386682;254950;54097;56911;873;29761;284827;81543;7226,213
1,1,21,15006458,48097372,33090914,54148;4599;5316;337882;106865373;1409;54101;9875;1826;9073;386679;874;51227;10950;337970;101928147;386681;56245;54943;643812;326;5121;1476;9946;116448;1292;64699;11077;1827;3150;63977;10281;149998;337973;8566;26046;7307;7113;54014;116159;56683;150094;85395;59271;386685;23515;337878;8624;29980;386683;337979;8568;100288323;54149;6450;4731;6493;539;104;54093;5822;6453;4047;54039;337985;7033;353333;23181;3454;25825;23275;2618;337976;2078;3455;1525;140258;56246;64968;49854;89766;754;3460;6647;54065;150051;58494;80781;7327;10785;337879;10841;54033;3753;337972;6782;150084;643803;728299;9992;386672;5211;861;11096;2897;56894;54084;6285;3689;8209;1859;29104;337960;7485;386676;571;386680;7267;53347;7074;5152;10311;150082;3772;3275;54059;8208;9510;10317;5116;84221;29947;337959;4685;6612;337968;755;1291;351;875;10069;7032;100131902;522;53820;9980;337963;337967;353323;7031;3588;6526;10215;7109;140578;386674;386675;23076;6573;3763;2114;353332;3141;4600;337971;54058;8204;386677;89765;30811;337974;337977;5651;337969;388813;57466;140290;54069;2551;757;10600;90625;23562;23308;26285;10694;386678;337975;337880;100288287;54102;317754;6651;8888;8867;94104;64092;25966;54020;337966;9619;386684;388818;337978;386682;254950;54097;56911;873;29761;284827;81543;7226,213
1,1,21,15006458,48097372,33090914,54148;4599;5316;337882;106865373;1409;54101;9875;1826;9073;386679;874;51227;10950;337970;101928147;386681;56245;54943;643812;326;5121;1476;9946;116448;1292;64699;11077;1827;3150;63977;10281;149998;337973;8566;26046;7307;7113;54014;116159;56683;150094;85395;59271;386685;23515;337878;8624;29980;386683;337979;8568;100288323;54149;6450;4731;6493;539;104;54093;5822;6453;4047;54039;337985;7033;353333;23181;3454;25825;23275;2618;337976;2078;3455;1525;140258;56246;64968;49854;89766;754;3460;6647;54065;150051;58494;80781;7327;10785;337879;10841;54033;3753;337972;6782;150084;643803;728299;9992;386672;5211;861;11096;2897;56894;54084;6285;3689;8209;1859;29104;337960;7485;386676;571;386680;7267;53347;7074;5152;10311;150082;3772;3275;54059;8208;9510;10317;5116;84221;29947;337959;4685;6612;337968;755;1291;351;875;10069;7032;100131902;522;53820;9980;337963;337967;353323;7031;3588;6526;10215;7109;140578;386674;386675;23076;6573;3763;2114;353332;3141;4600;337971;54058;8204;386677;89765;30811;337974;337977;5651;337969;388813;57466;140290;54069;2551;757;10600;90625;23562;23308;26285;10694;386678;337975;337880;100288287;54102;317754;6651;8888;8867;94104;64092;25966;54020;337966;9619;386684;388818;337978;386682;254950;54097;56911;873;29761;284827;81543;7226,213
1,1,21,15006458,48097372,33090914,54148;4599;5316;337882;106865373;1409;54101;9875;1826;9073;386679;874;51227;10950;337970;101928147;386681;56245;54943;643812;326;5121;1476;9946;116448;1292;64699;11077;1827;3150;63977;10281;149998;337973;8566;26046;7307;7113;54014;116159;56683;150094;85395;59271;386685;23515;337878;8624;29980;386683;337979;8568;100288323;54149;6450;4731;6493;539;104;54093;5822;6453;4047;54039;337985;7033;353333;23181;3454;25825;23275;2618;337976;2078;3455;1525;140258;56246;64968;49854;89766;754;3460;6647;54065;150051;58494;80781;7327;10785;337879;10841;54033;3753;337972;6782;150084;643803;728299;9992;386672;5211;861;11096;2897;56894;54084;6285;3689;8209;1859;29104;337960;7485;386676;571;386680;7267;53347;7074;5152;10311;150082;3772;3275;54059;8208;9510;10317;5116;84221;29947;337959;4685;6612;337968;755;1291;351;875;10069;7032;100131902;522;53820;9980;337963;337967;353323;7031;3588;6526;10215;7109;140578;386674;386675;23076;6573;3763;2114;353332;3141;4600;337971;54058;8204;386677;89765;30811;337974;337977;5651;337969;388813;57466;140290;54069;2551;757;10600;90625;23562;23308;26285;10694;386678;337975;337880;100288287;54102;317754;6651;8888;8867;94104;64092;25966;54020;337966;9619;386684;388818;337978;386682;254950;54097;56911;873;29761;284827;81543;7226,213
1,1,21,15006458,48097372,33090914,54148;4599;5316;337882;106865373;1409;54101;9875;1826;9073;386679;874;51227;10950;337970;101928147;386681;56245;54943;643812;326;5121;1476;9946;116448;1292;64699;11077;1827;3150;63977;10281;149998;337973;8566;26046;7307;7113;54014;116159;56683;150094;85395;59271;386685;23515;337878;8624;29980;386683;337979;8568;100288323;54149;6450;4731;6493;539;104;54093;5822;6453;4047;54039;337985;7033;353333;23181;3454;25825;23275;2618;337976;2078;3455;1525;140258;56246;64968;49854;89766;754;3460;6647;54065;150051;58494;80781;7327;10785;337879;10841;54033;3753;337972;6782;150084;643803;728299;9992;386672;5211;861;11096;2897;56894;54084;6285;3689;8209;1859;29104;337960;7485;386676;571;386680;7267;53347;7074;5152;10311;150082;3772;3275;54059;8208;9510;10317;5116;84221;29947;337959;4685;6612;337968;755;1291;351;875;10069;7032;100131902;522;53820;9980;337963;337967;353323;7031;3588;6526;10215;7109;140578;386674;386675;23076;6573;3763;2114;353332;3141;4600;337971;54058;8204;386677;89765;30811;337974;337977;5651;337969;388813;57466;140290;54069;2551;757;10600;90625;23562;23308;26285;10694;386678;337975;337880;100288287;54102;317754;6651;8888;8867;94104;64092;25966;54020;337966;9619;386684;388818;337978;386682;254950;54097;56911;873;29761;284827;81543;7226,213
1,1,21,15006458,48097372,33090914,54148;4599;5316;337882;106865373;1409;54101;9875;1826;9073;386679;874;51227;10950;337970;101928147;386681;56245;54943;643812;326;5121;1476;9946;116448;1292;64699;11077;1827;3150;63977;10281;149998;337973;8566;26046;7307;7113;54014;116159;56683;150094;85395;59271;386685;23515;337878;8624;29980;386683;337979;8568;100288323;54149;6450;4731;6493;539;104;54093;5822;6453;4047;54039;337985;7033;353333;23181;3454;25825;23275;2618;337976;2078;3455;1525;140258;56246;64968;49854;89766;754;3460;6647;54065;150051;58494;80781;7327;10785;337879;10841;54033;3753;337972;6782;150084;643803;728299;9992;386672;5211;861;11096;2897;56894;54084;6285;3689;8209;1859;29104;337960;7485;386676;571;386680;7267;53347;7074;5152;10311;150082;3772;3275;54059;8208;9510;10317;5116;84221;29947;337959;4685;6612;337968;755;1291;351;875;10069;7032;100131902;522;53820;9980;337963;337967;353323;7031;3588;6526;10215;7109;140578;386674;386675;23076;6573;3763;2114;353332;3141;4600;337971;54058;8204;386677;89765;30811;337974;337977;5651;337969;388813;57466;140290;54069;2551;757;10600;90625;23562;23308;26285;10694;386678;337975;337880;100288287;54102;317754;6651;8888;8867;94104;64092;25966;54020;337966;9619;386684;388818;337978;386682;254950;54097;56911;873;29761;284827;81543;7226,213
1,1,21,15006458,48097372,33090914,54148;4599;5316;337882;106865373;1409;54101;9875;1826;9073;386679;874;51227;10950;337970;101928147;386681;56245;54943;643812;326;5121;1476;9946;116448;1292;64699;11077;1827;3150;63977;10281;149998;337973;8566;26046;7307;7113;54014;116159;56683;150094;85395;59271;386685;23515;337878;8624;29980;386683;337979;8568;100288323;54149;6450;4731;6493;539;104;54093;5822;6453;4047;54039;337985;7033;353333;23181;3454;25825;23275;2618;337976;2078;3455;1525;140258;56246;64968;49854;89766;754;3460;6647;54065;150051;58494;80781;7327;10785;337879;10841;54033;3753;337972;6782;150084;643803;728299;9992;386672;5211;861;11096;2897;56894;54084;6285;3689;8209;1859;29104;337960;7485;386676;571;386680;7267;53347;7074;5152;10311;150082;3772;3275;54059;8208;9510;10317;5116;84221;29947;337959;4685;6612;337968;755;1291;351;875;10069;7032;100131902;522;53820;9980;337963;337967;353323;7031;3588;6526;10215;7109;140578;386674;386675;23076;6573;3763;2114;353332;3141;4600;337971;54058;8204;386677;89765;30811;337974;337977;5651;337969;388813;57466;140290;54069;2551;757;10600;90625;23562;23308;26285;10694;386678;337975;337880;100288287;54102;317754;6651;8888;8867;94104;64092;25966;54020;337966;9619;386684;388818;337978;386682;254950;54097;56911;873;29761;284827;81543;7226,213
1,1,21,15006458,48097372,33090914,54148;4599;5316;337882;106865373;1409;54101;9875;1826;9073;386679;874;51227;10950;337970;101928147;386681;56245;54943;643812;326;5121;1476;9946;116448;1292;64699;11077;1827;3150;63977;10281;149998;337973;8566;26046;7307;7113;54014;116159;56683;150094;85395;59271;386685;23515;337878;8624;29980;386683;337979;8568;100288323;54149;6450;4731;6493;539;104;54093;5822;6453;4047;54039;337985;7033;353333;23181;3454;25825;23275;2618;337976;2078;3455;1525;140258;56246;64968;49854;89766;754;3460;6647;54065;150051;58494;80781;7327;10785;337879;10841;54033;3753;337972;6782;150084;643803;728299;9992;386672;5211;861;11096;2897;56894;54084;6285;3689;8209;1859;29104;337960;7485;386676;571;386680;7267;53347;7074;5152;10311;150082;3772;3275;54059;8208;9510;10317;5116;84221;29947;337959;4685;6612;337968;755;1291;351;875;10069;7032;100131902;522;53820;9980;337963;337967;353323;7031;3588;6526;10215;7109;140578;386674;386675;23076;6573;3763;2114;353332;3141;4600;337971;54058;8204;386677;89765;30811;337974;337977;5651;337969;388813;57466;140290;54069;2551;757;10600;90625;23562;23308;26285;10694;386678;337975;337880;100288287;54102;317754;6651;8888;8867;94104;64092;25966;54020;337966;9619;386684;388818;337978;386682;254950;54097;56911;873;29761;284827;81543;7226,213
1,1,21,15006458,48097372,33090914,54148;4599;5316;337882;106865373;1409;54101;9875;1826;9073;386679;874;51227;10950;337970;101928147;386681;56245;54943;643812;326;5121;1476;9946;116448;1292;64699;11077;1827;3150;63977;10281;149998;337973;8566;26046;7307;7113;54014;116159;56683;150094;85395;59271;386685;23515;337878;8624;29980;386683;337979;8568;100288323;54149;6450;4731;6493;539;104;54093;5822;6453;4047;54039;337985;7033;353333;23181;3454;25825;23275;2618;337976;2078;3455;1525;140258;56246;64968;49854;89766;754;3460;6647;54065;150051;58494;80781;7327;10785;337879;10841;54033;3753;337972;6782;150084;643803;728299;9992;386672;5211;861;11096;2897;56894;54084;6285;3689;8209;1859;29104;337960;7485;386676;571;386680;7267;53347;7074;5152;10311;150082;3772;3275;54059;8208;9510;10317;5116;84221;29947;337959;4685;6612;337968;755;1291;351;875;10069;7032;100131902;522;53820;9980;337963;337967;353323;7031;3588;6526;10215;7109;140578;386674;386675;23076;6573;3763;2114;353332;3141;4600;337971;54058;8204;386677;89765;30811;337974;337977;5651;337969;388813;57466;140290;54069;2551;757;10600;90625;23562;23308;26285;10694;386678;337975;337880;100288287;54102;317754;6651;8888;8867;94104;64092;25966;54020;337966;9619;386684;388818;337978;386682;254950;54097;56911;873;29761;284827;81543;7226,213
1,1,21,15006458,48097372,33090914,54148;4599;5316;337882;106865373;1409;54101;9875;1826;9073;386679;874;51227;10950;337970;101928147;386681;56245;54943;643812;326;5121;1476;9946;116448;1292;64699;11077;1827;3150;63977;10281;149998;337973;8566;26046;7307;7113;54014;116159;56683;150094;85395;59271;386685;23515;337878;8624;29980;386683;337979;8568;100288323;54149;6450;4731;6493;539;104;54093;5822;6453;4047;54039;337985;7033;353333;23181;3454;25825;23275;2618;337976;2078;3455;1525;140258;56246;64968;49854;89766;754;3460;6647;54065;150051;58494;80781;7327;10785;337879;10841;54033;3753;337972;6782;150084;643803;728299;9992;386672;5211;861;11096;2897;56894;54084;6285;3689;8209;1859;29104;337960;7485;386676;571;386680;7267;53347;7074;5152;10311;150082;3772;3275;54059;8208;9510;10317;5116;84221;29947;337959;4685;6612;337968;755;1291;351;875;10069;7032;100131902;522;53820;9980;337963;337967;353323;7031;3588;6526;10215;7109;140578;386674;386675;23076;6573;3763;2114;353332;3141;4600;337971;54058;8204;386677;89765;30811;337974;337977;5651;337969;388813;57466;140290;54069;2551;757;10600;90625;23562;23308;26285;10694;386678;337975;337880;100288287;54102;317754;6651;8888;8867;94104;64092;25966;54020;337966;9619;386684;388818;337978;386682;254950;54097;56911;873;29761;284827;81543;7226,213
1,1,21,15006458,48097372,33090914,54148;4599;5316;337882;106865373;1409;54101;9875;1826;9073;386679;874;51227;10950;337970;101928147;386681;56245;54943;643812;326;5121;1476;9946;116448;1292;64699;11077;1827;3150;63977;10281;149998;337973;8566;26046;7307;7113;54014;116159;56683;150094;85395;59271;386685;23515;337878;8624;29980;386683;337979;8568;100288323;54149;6450;4731;6493;539;104;54093;5822;6453;4047;54039;337985;7033;353333;23181;3454;25825;23275;2618;337976;2078;3455;1525;140258;56246;64968;49854;89766;754;3460;6647;54065;150051;58494;80781;7327;10785;337879;10841;54033;3753;337972;6782;150084;643803;728299;9992;386672;5211;861;11096;2897;56894;54084;6285;3689;8209;1859;29104;337960;7485;386676;571;386680;7267;53347;7074;5152;10311;150082;3772;3275;54059;8208;9510;10317;5116;84221;29947;337959;4685;6612;337968;755;1291;351;875;10069;7032;100131902;522;53820;9980;337963;337967;353323;7031;3588;6526;10215;7109;140578;386674;386675;23076;6573;3763;2114;353332;3141;4600;337971;54058;8204;386677;89765;30811;337974;337977;5651;337969;388813;57466;140290;54069;2551;757;10600;90625;23562;23308;26285;10694;386678;337975;337880;100288287;54102;317754;6651;8888;8867;94104;64092;25966;54020;337966;9619;386684;388818;337978;386682;254950;54097;56911;873;29761;284827;81543;7226,213
1,1,21,15006458,48097372,33090914,54148;4599;5316;337882;106865373;1409;54101;9875;1826;9073;386679;874;51227;10950;337970;101928147;386681;56245;54943;643812;326;5121;1476;9946;116448;1292;64699;11077;1827;3150;63977;10281;149998;337973;8566;26046;7307;7113;54014;116159;56683;150094;85395;59271;386685;23515;337878;8624;29980;386683;337979;8568;100288323;54149;6450;4731;6493;539;104;54093;5822;6453;4047;54039;337985;7033;353333;23181;3454;25825;23275;2618;337976;2078;3455;1525;140258;56246;64968;49854;89766;754;3460;6647;54065;150051;58494;80781;7327;10785;337879;10841;54033;3753;337972;6782;150084;643803;728299;9992;386672;5211;861;11096;2897;56894;54084;6285;3689;8209;1859;29104;337960;7485;386676;571;386680;7267;53347;7074;5152;10311;150082;3772;3275;54059;8208;9510;10317;5116;84221;29947;337959;4685;6612;337968;755;1291;351;875;10069;7032;100131902;522;53820;9980;337963;337967;353323;7031;3588;6526;10215;7109;140578;386674;386675;23076;6573;3763;2114;353332;3141;4600;337971;54058;8204;386677;89765;30811;337974;337977;5651;337969;388813;57466;140290;54069;2551;757;10600;90625;23562;23308;26285;10694;386678;337975;337880;100288287;54102;317754;6651;8888;8867;94104;64092;25966;54020;337966;9619;386684;388818;337978;386682;254950;54097;56911;873;29761;284827;81543;7226,213
1,1,21,15006458,48097372,33090914,54148;4599;5316;337882;106865373;1409;54101;9875;1826;9073;386679;874;51227;10950;337970;101928147;386681;56245;54943;643812;326;5121;1476;9946;116448;1292;64699;11077;1827;3150;63977;10281;149998;337973;8566;26046;7307;7113;54014;116159;56683;150094;85395;59271;386685;23515;337878;8624;29980;386683;337979;8568;100288323;54149;6450;4731;6493;539;104;54093;5822;6453;4047;54039;337985;7033;353333;23181;3454;25825;23275;2618;337976;2078;3455;1525;140258;56246;64968;49854;89766;754;3460;6647;54065;150051;58494;80781;7327;10785;337879;10841;54033;3753;337972;6782;150084;643803;728299;9992;386672;5211;861;11096;2897;56894;54084;6285;3689;8209;1859;29104;337960;7485;386676;571;386680;7267;53347;7074;5152;10311;150082;3772;3275;54059;8208;9510;10317;5116;84221;29947;337959;4685;6612;337968;755;1291;351;875;10069;7032;100131902;522;53820;9980;337963;337967;353323;7031;3588;6526;10215;7109;140578;386674;386675;23076;6573;3763;2114;353332;3141;4600;337971;54058;8204;386677;89765;30811;337974;337977;5651;337969;388813;57466;140290;54069;2551;757;10600;90625;23562;23308;26285;10694;386678;337975;337880;100288287;54102;317754;6651;8888;8867;94104;64092;25966;54020;337966;9619;386684;388818;337978;386682;254950;54097;56911;873;29761;284827;81543;7226,213
1,1,21,15006458,48097372,33090914,54148;4599;5316;337882;106865373;1409;54101;9875;1826;9073;386679;874;51227;10950;337970;101928147;386681;56245;54943;643812;326;5121;1476;9946;116448;1292;64699;11077;1827;3150;63977;10281;149998;337973;8566;26046;7307;7113;54014;116159;56683;150094;85395;59271;386685;23515;337878;8624;29980;386683;337979;8568;100288323;54149;6450;4731;6493;539;104;54093;5822;6453;4047;54039;337985;7033;353333;23181;3454;25825;23275;2618;337976;2078;3455;1525;140258;56246;64968;49854;89766;754;3460;6647;54065;150051;58494;80781;7327;10785;337879;10841;54033;3753;337972;6782;150084;643803;728299;9992;386672;5211;861;11096;2897;56894;54084;6285;3689;8209;1859;29104;337960;7485;386676;571;386680;7267;53347;7074;5152;10311;150082;3772;3275;54059;8208;9510;10317;5116;84221;29947;337959;4685;6612;337968;755;1291;351;875;10069;7032;100131902;522;53820;9980;337963;337967;353323;7031;3588;6526;10215;7109;140578;386674;386675;23076;6573;3763;2114;353332;3141;4600;337971;54058;8204;386677;89765;30811;337974;337977;5651;337969;388813;57466;140290;54069;2551;757;10600;90625;23562;23308;26285;10694;386678;337975;337880;100288287;54102;317754;6651;8888;8867;94104;64092;25966;54020;337966;9619;386684;388818;337978;386682;254950;54097;56911;873;29761;284827;81543;7226,213
1,1,21,15006458,48097372,33090914,54148;4599;5316;337882;106865373;1409;54101;9875;1826;9073;386679;874;51227;10950;337970;101928147;386681;56245;54943;643812;326;5121;1476;9946;116448;1292;64699;11077;1827;3150;63977;10281;149998;337973;8566;26046;7307;7113;54014;116159;56683;150094;85395;59271;386685;23515;337878;8624;29980;386683;337979;8568;100288323;54149;6450;4731;6493;539;104;54093;5822;6453;4047;54039;337985;7033;353333;23181;3454;25825;23275;2618;337976;2078;3455;1525;140258;56246;64968;49854;89766;754;3460;6647;54065;150051;58494;80781;7327;10785;337879;10841;54033;3753;337972;6782;150084;643803;728299;9992;386672;5211;861;11096;2897;56894;54084;6285;3689;8209;1859;29104;337960;7485;386676;571;386680;7267;53347;7074;5152;10311;150082;3772;3275;54059;8208;9510;10317;5116;84221;29947;337959;4685;6612;337968;755;1291;351;875;10069;7032;100131902;522;53820;9980;337963;337967;353323;7031;3588;6526;10215;7109;140578;386674;386675;23076;6573;3763;2114;353332;3141;4600;337971;54058;8204;386677;89765;30811;337974;337977;5651;337969;388813;57466;140290;54069;2551;757;10600;90625;23562;23308;26285;10694;386678;337975;337880;100288287;54102;317754;6651;8888;8867;94104;64092;25966;54020;337966;9619;386684;388818;337978;386682;254950;54097;56911;873;29761;284827;81543;7226,213
1,1,21,15285841,48097372,32811531,54148;4599;5316;337882;106865373;1409;54101;9875;1826;9073;386679;874;51227;10950;337970;101928147;386681;56245;54943;643812;326;5121;1476;9946;116448;1292;64699;11077;1827;3150;63977;10281;149998;337973;8566;26046;7307;7113;54014;116159;56683;150094;85395;59271;386685;23515;337878;8624;29980;386683;337979;8568;100288323;54149;6450;4731;6493;539;104;54093;5822;6453;4047;54039;337985;7033;353333;23181;3454;25825;23275;2618;337976;2078;3455;1525;140258;56246;64968;49854;89766;754;3460;6647;54065;150051;58494;80781;7327;10785;337879;10841;54033;3753;337972;6782;150084;643803;728299;9992;386672;5211;861;11096;2897;56894;54084;6285;3689;8209;1859;29104;337960;7485;386676;571;386680;7267;53347;7074;5152;10311;150082;3772;3275;54059;8208;9510;10317;5116;84221;29947;337959;4685;6612;337968;755;1291;351;875;10069;7032;100131902;522;53820;9980;337963;337967;353323;7031;3588;6526;10215;7109;140578;386674;386675;23076;6573;3763;2114;353332;3141;4600;337971;54058;8204;386677;89765;30811;337974;337977;5651;337969;388813;57466;140290;54069;2551;757;10600;90625;23562;23308;26285;10694;386678;337975;337880;100288287;54102;6651;8888;8867;94104;64092;25966;54020;337966;9619;386684;388818;337978;386682;254950;54097;56911;873;29761;284827;81543;7226,212
1,1,21,15442582,20723130,5280548,149998;8204;140578;10950;54149;54033;29761;5651;64092;388813;6782;1525,12
-1,1,21,15451032,39025955,23574923,9992;54148;861;337882;11096;2897;1859;9875;9073;29104;874;337960;51227;571;10950;337970;101928147;56245;54943;643812;7267;7074;10311;9946;757;8208;9510;116448;337959;1827;4685;337968;149998;337973;26046;351;10069;116159;56683;100131902;522;53820;9980;59271;337963;337967;23515;337878;29980;3588;6526;10215;337979;140578;100288323;54149;6493;3763;539;54093;3141;6453;337971;337985;8204;30811;3454;337974;337977;5651;337969;388813;2618;337976;57466;140290;54069;2551;3455;1525;140258;56246;64968;10600;23562;26285;10694;337975;337880;100288287;54102;3460;6651;6647;8867;54065;94104;150051;64092;58494;337966;388818;337978;337879;254950;56911;873;54033;29761;284827;3753;337972;6782;643803;728299,115
1,1,21,15451032,48090972,32639940,54148;4599;5316;337882;106865373;1409;54101;9875;1826;9073;386679;874;51227;10950;337970;101928147;386681;56245;54943;643812;326;5121;1476;9946;116448;1292;64699;11077;1827;3150;63977;10281;149998;337973;8566;26046;7307;7113;54014;116159;56683;150094;85395;59271;386685;23515;337878;8624;29980;386683;337979;8568;100288323;54149;6450;4731;6493;539;104;54093;5822;6453;4047;54039;337985;7033;353333;23181;3454;25825;23275;2618;337976;2078;3455;1525;140258;56246;64968;49854;89766;754;3460;6647;54065;150051;58494;80781;7327;10785;337879;10841;54033;3753;337972;6782;150084;643803;728299;9992;386672;5211;861;11096;2897;56894;54084;6285;3689;8209;1859;29104;337960;7485;386676;571;386680;7267;53347;7074;5152;10311;150082;3772;3275;54059;8208;9510;10317;5116;84221;29947;337959;4685;6612;337968;755;1291;351;875;10069;7032;100131902;522;53820;9980;337963;337967;353323;7031;3588;6526;10215;7109;140578;386674;386675;23076;6573;3763;2114;353332;3141;4600;337971;54058;8204;386677;89765;30811;337974;337977;5651;337969;388813;57466;140290;54069;2551;757;10600;90625;23562;23308;26285;10694;386678;337975;337880;100288287;54102;6651;8888;8867;94104;64092;25966;54020;337966;9619;386684;388818;337978;386682;254950;54097;56911;873;29761;284827;81543;7226,212
1,1,21,15451032,48090972,32639940,54148;4599;5316;337882;106865373;1409;54101;9875;1826;9073;386679;874;51227;10950;337970;101928147;386681;56245;54943;643812;326;5121;1476;9946;116448;1292;64699;11077;1827;3150;63977;10281;149998;337973;8566;26046;7307;7113;54014;116159;56683;150094;85395;59271;386685;23515;337878;8624;29980;386683;337979;8568;100288323;54149;6450;4731;6493;539;104;54093;5822;6453;4047;54039;337985;7033;353333;23181;3454;25825;23275;2618;337976;2078;3455;1525;140258;56246;64968;49854;89766;754;3460;6647;54065;150051;58494;80781;7327;10785;337879;10841;54033;3753;337972;6782;150084;643803;728299;9992;386672;5211;861;11096;2897;56894;54084;6285;3689;8209;1859;29104;337960;7485;386676;571;386680;7267;53347;7074;5152;10311;150082;3772;3275;54059;8208;9510;10317;5116;84221;29947;337959;4685;6612;337968;755;1291;351;875;10069;7032;100131902;522;53820;9980;337963;337967;353323;7031;3588;6526;10215;7109;140578;386674;386675;23076;6573;3763;2114;353332;3141;4600;337971;54058;8204;386677;89765;30811;337974;337977;5651;337969;388813;57466;140290;54069;2551;757;10600;90625;23562;23308;26285;10694;386678;337975;337880;100288287;54102;6651;8888;8867;94104;64092;25966;54020;337966;9619;386684;388818;337978;386682;254950;54097;56911;873;29761;284827;81543;7226,212
1,1,21,15451032,48090972,32639940,54148;4599;5316;337882;106865373;1409;54101;9875;1826;9073;386679;874;51227;10950;337970;101928147;386681;56245;54943;643812;326;5121;1476;9946;116448;1292;64699;11077;1827;3150;63977;10281;149998;337973;8566;26046;7307;7113;54014;116159;56683;150094;85395;59271;386685;23515;337878;8624;29980;386683;337979;8568;100288323;54149;6450;4731;6493;539;104;54093;5822;6453;4047;54039;337985;7033;353333;23181;3454;25825;23275;2618;337976;2078;3455;1525;140258;56246;64968;49854;89766;754;3460;6647;54065;150051;58494;80781;7327;10785;337879;10841;54033;3753;337972;6782;150084;643803;728299;9992;386672;5211;861;11096;2897;56894;54084;6285;3689;8209;1859;29104;337960;7485;386676;571;386680;7267;53347;7074;5152;10311;150082;3772;3275;54059;8208;9510;10317;5116;84221;29947;337959;4685;6612;337968;755;1291;351;875;10069;7032;100131902;522;53820;9980;337963;337967;353323;7031;3588;6526;10215;7109;140578;386674;386675;23076;6573;3763;2114;353332;3141;4600;337971;54058;8204;386677;89765;30811;337974;337977;5651;337969;388813;57466;140290;54069;2551;757;10600;90625;23562;23308;26285;10694;386678;337975;337880;100288287;54102;6651;8888;8867;94104;64092;25966;54020;337966;9619;386684;388818;337978;386682;254950;54097;56911;873;29761;284827;81543;7226,212
1,1,21,15451032,48090972,32639940,54148;4599;5316;337882;106865373;1409;54101;9875;1826;9073;386679;874;51227;10950;337970;101928147;386681;56245;54943;643812;326;5121;1476;9946;116448;1292;64699;11077;1827;3150;63977;10281;149998;337973;8566;26046;7307;7113;54014;116159;56683;150094;85395;59271;386685;23515;337878;8624;29980;386683;337979;8568;100288323;54149;6450;4731;6493;539;104;54093;5822;6453;4047;54039;337985;7033;353333;23181;3454;25825;23275;2618;337976;2078;3455;1525;140258;56246;64968;49854;89766;754;3460;6647;54065;150051;58494;80781;7327;10785;337879;10841;54033;3753;337972;6782;150084;643803;728299;9992;386672;5211;861;11096;2897;56894;54084;6285;3689;8209;1859;29104;337960;7485;386676;571;386680;7267;53347;7074;5152;10311;150082;3772;3275;54059;8208;9510;10317;5116;84221;29947;337959;4685;6612;337968;755;1291;351;875;10069;7032;100131902;522;53820;9980;337963;337967;353323;7031;3588;6526;10215;7109;140578;386674;386675;23076;6573;3763;2114;353332;3141;4600;337971;54058;8204;386677;89765;30811;337974;337977;5651;337969;388813;57466;140290;54069;2551;757;10600;90625;23562;23308;26285;10694;386678;337975;337880;100288287;54102;6651;8888;8867;94104;64092;25966;54020;337966;9619;386684;388818;337978;386682;254950;54097;56911;873;29761;284827;81543;7226,212
1,1,21,15451032,48090972,32639940,54148;4599;5316;337882;106865373;1409;54101;9875;1826;9073;386679;874;51227;10950;337970;101928147;386681;56245;54943;643812;326;5121;1476;9946;116448;1292;64699;11077;1827;3150;63977;10281;149998;337973;8566;26046;7307;7113;54014;116159;56683;150094;85395;59271;386685;23515;337878;8624;29980;386683;337979;8568;100288323;54149;6450;4731;6493;539;104;54093;5822;6453;4047;54039;337985;7033;353333;23181;3454;25825;23275;2618;337976;2078;3455;1525;140258;56246;64968;49854;89766;754;3460;6647;54065;150051;58494;80781;7327;10785;337879;10841;54033;3753;337972;6782;150084;643803;728299;9992;386672;5211;861;11096;2897;56894;54084;6285;3689;8209;1859;29104;337960;7485;386676;571;386680;7267;53347;7074;5152;10311;150082;3772;3275;54059;8208;9510;10317;5116;84221;29947;337959;4685;6612;337968;755;1291;351;875;10069;7032;100131902;522;53820;9980;337963;337967;353323;7031;3588;6526;10215;7109;140578;386674;386675;23076;6573;3763;2114;353332;3141;4600;337971;54058;8204;386677;89765;30811;337974;337977;5651;337969;388813;57466;140290;54069;2551;757;10600;90625;23562;23308;26285;10694;386678;337975;337880;100288287;54102;6651;8888;8867;94104;64092;25966;54020;337966;9619;386684;388818;337978;386682;254950;54097;56911;873;29761;284827;81543;7226,212
1,1,21,15451032,48090972,32639940,54148;4599;5316;337882;106865373;1409;54101;9875;1826;9073;386679;874;51227;10950;337970;101928147;386681;56245;54943;643812;326;5121;1476;9946;116448;1292;64699;11077;1827;3150;63977;10281;149998;337973;8566;26046;7307;7113;54014;116159;56683;150094;85395;59271;386685;23515;337878;8624;29980;386683;337979;8568;100288323;54149;6450;4731;6493;539;104;54093;5822;6453;4047;54039;337985;7033;353333;23181;3454;25825;23275;2618;337976;2078;3455;1525;140258;56246;64968;49854;89766;754;3460;6647;54065;150051;58494;80781;7327;10785;337879;10841;54033;3753;337972;6782;150084;643803;728299;9992;386672;5211;861;11096;2897;56894;54084;6285;3689;8209;1859;29104;337960;7485;386676;571;386680;7267;53347;7074;5152;10311;150082;3772;3275;54059;8208;9510;10317;5116;84221;29947;337959;4685;6612;337968;755;1291;351;875;10069;7032;100131902;522;53820;9980;337963;337967;353323;7031;3588;6526;10215;7109;140578;386674;386675;23076;6573;3763;2114;353332;3141;4600;337971;54058;8204;386677;89765;30811;337974;337977;5651;337969;388813;57466;140290;54069;2551;757;10600;90625;23562;23308;26285;10694;386678;337975;337880;100288287;54102;6651;8888;8867;94104;64092;25966;54020;337966;9619;386684;388818;337978;386682;254950;54097;56911;873;29761;284827;81543;7226,212
1,1,21,15451032,48090972,32639940,54148;4599;5316;337882;106865373;1409;54101;9875;1826;9073;386679;874;51227;10950;337970;101928147;386681;56245;54943;643812;326;5121;1476;9946;116448;1292;64699;11077;1827;3150;63977;10281;149998;337973;8566;26046;7307;7113;54014;116159;56683;150094;85395;59271;386685;23515;337878;8624;29980;386683;337979;8568;100288323;54149;6450;4731;6493;539;104;54093;5822;6453;4047;54039;337985;7033;353333;23181;3454;25825;23275;2618;337976;2078;3455;1525;140258;56246;64968;49854;89766;754;3460;6647;54065;150051;58494;80781;7327;10785;337879;10841;54033;3753;337972;6782;150084;643803;728299;9992;386672;5211;861;11096;2897;56894;54084;6285;3689;8209;1859;29104;337960;7485;386676;571;386680;7267;53347;7074;5152;10311;150082;3772;3275;54059;8208;9510;10317;5116;84221;29947;337959;4685;6612;337968;755;1291;351;875;10069;7032;100131902;522;53820;9980;337963;337967;353323;7031;3588;6526;10215;7109;140578;386674;386675;23076;6573;3763;2114;353332;3141;4600;337971;54058;8204;386677;89765;30811;337974;337977;5651;337969;388813;57466;140290;54069;2551;757;10600;90625;23562;23308;26285;10694;386678;337975;337880;100288287;54102;6651;8888;8867;94104;64092;25966;54020;337966;9619;386684;388818;337978;386682;254950;54097;56911;873;29761;284827;81543;7226,212
1,1,21,15451032,48090972,32639940,54148;4599;5316;337882;106865373;1409;54101;9875;1826;9073;386679;874;51227;10950;337970;101928147;386681;56245;54943;643812;326;5121;1476;9946;116448;1292;64699;11077;1827;3150;63977;10281;149998;337973;8566;26046;7307;7113;54014;116159;56683;150094;85395;59271;386685;23515;337878;8624;29980;386683;337979;8568;100288323;54149;6450;4731;6493;539;104;54093;5822;6453;4047;54039;337985;7033;353333;23181;3454;25825;23275;2618;337976;2078;3455;1525;140258;56246;64968;49854;89766;754;3460;6647;54065;150051;58494;80781;7327;10785;337879;10841;54033;3753;337972;6782;150084;643803;728299;9992;386672;5211;861;11096;2897;56894;54084;6285;3689;8209;1859;29104;337960;7485;386676;571;386680;7267;53347;7074;5152;10311;150082;3772;3275;54059;8208;9510;10317;5116;84221;29947;337959;4685;6612;337968;755;1291;351;875;10069;7032;100131902;522;53820;9980;337963;337967;353323;7031;3588;6526;10215;7109;140578;386674;386675;23076;6573;3763;2114;353332;3141;4600;337971;54058;8204;386677;89765;30811;337974;337977;5651;337969;388813;57466;140290;54069;2551;757;10600;90625;23562;23308;26285;10694;386678;337975;337880;100288287;54102;6651;8888;8867;94104;64092;25966;54020;337966;9619;386684;388818;337978;386682;254950;54097;56911;873;29761;284827;81543;7226,212
1,1,21,15451032,48090972,32639940,54148;4599;5316;337882;106865373;1409;54101;9875;1826;9073;386679;874;51227;10950;337970;101928147;386681;56245;54943;643812;326;5121;1476;9946;116448;1292;64699;11077;1827;3150;63977;10281;149998;337973;8566;26046;7307;7113;54014;116159;56683;150094;85395;59271;386685;23515;337878;8624;29980;386683;337979;8568;100288323;54149;6450;4731;6493;539;104;54093;5822;6453;4047;54039;337985;7033;353333;23181;3454;25825;23275;2618;337976;2078;3455;1525;140258;56246;64968;49854;89766;754;3460;6647;54065;150051;58494;80781;7327;10785;337879;10841;54033;3753;337972;6782;150084;643803;728299;9992;386672;5211;861;11096;2897;56894;54084;6285;3689;8209;1859;29104;337960;7485;386676;571;386680;7267;53347;7074;5152;10311;150082;3772;3275;54059;8208;9510;10317;5116;84221;29947;337959;4685;6612;337968;755;1291;351;875;10069;7032;100131902;522;53820;9980;337963;337967;353323;7031;3588;6526;10215;7109;140578;386674;386675;23076;6573;3763;2114;353332;3141;4600;337971;54058;8204;386677;89765;30811;337974;337977;5651;337969;388813;57466;140290;54069;2551;757;10600;90625;23562;23308;26285;10694;386678;337975;337880;100288287;54102;6651;8888;8867;94104;64092;25966;54020;337966;9619;386684;388818;337978;386682;254950;54097;56911;873;29761;284827;81543;7226,212
1,1,21,15451032,48090972,32639940,54148;4599;5316;337882;106865373;1409;54101;9875;1826;9073;386679;874;51227;10950;337970;101928147;386681;56245;54943;643812;326;5121;1476;9946;116448;1292;64699;11077;1827;3150;63977;10281;149998;337973;8566;26046;7307;7113;54014;116159;56683;150094;85395;59271;386685;23515;337878;8624;29980;386683;337979;8568;100288323;54149;6450;4731;6493;539;104;54093;5822;6453;4047;54039;337985;7033;353333;23181;3454;25825;23275;2618;337976;2078;3455;1525;140258;56246;64968;49854;89766;754;3460;6647;54065;150051;58494;80781;7327;10785;337879;10841;54033;3753;337972;6782;150084;643803;728299;9992;386672;5211;861;11096;2897;56894;54084;6285;3689;8209;1859;29104;337960;7485;386676;571;386680;7267;53347;7074;5152;10311;150082;3772;3275;54059;8208;9510;10317;5116;84221;29947;337959;4685;6612;337968;755;1291;351;875;10069;7032;100131902;522;53820;9980;337963;337967;353323;7031;3588;6526;10215;7109;140578;386674;386675;23076;6573;3763;2114;353332;3141;4600;337971;54058;8204;386677;89765;30811;337974;337977;5651;337969;388813;57466;140290;54069;2551;757;10600;90625;23562;23308;26285;10694;386678;337975;337880;100288287;54102;6651;8888;8867;94104;64092;25966;54020;337966;9619;386684;388818;337978;386682;254950;54097;56911;873;29761;284827;81543;7226,212
1,1,21,15451032,48090972,32639940,54148;4599;5316;337882;106865373;1409;54101;9875;1826;9073;386679;874;51227;10950;337970;101928147;386681;56245;54943;643812;326;5121;1476;9946;116448;1292;64699;11077;1827;3150;63977;10281;149998;337973;8566;26046;7307;7113;54014;116159;56683;150094;85395;59271;386685;23515;337878;8624;29980;386683;337979;8568;100288323;54149;6450;4731;6493;539;104;54093;5822;6453;4047;54039;337985;7033;353333;23181;3454;25825;23275;2618;337976;2078;3455;1525;140258;56246;64968;49854;89766;754;3460;6647;54065;150051;58494;80781;7327;10785;337879;10841;54033;3753;337972;6782;150084;643803;728299;9992;386672;5211;861;11096;2897;56894;54084;6285;3689;8209;1859;29104;337960;7485;386676;571;386680;7267;53347;7074;5152;10311;150082;3772;3275;54059;8208;9510;10317;5116;84221;29947;337959;4685;6612;337968;755;1291;351;875;10069;7032;100131902;522;53820;9980;337963;337967;353323;7031;3588;6526;10215;7109;140578;386674;386675;23076;6573;3763;2114;353332;3141;4600;337971;54058;8204;386677;89765;30811;337974;337977;5651;337969;388813;57466;140290;54069;2551;757;10600;90625;23562;23308;26285;10694;386678;337975;337880;100288287;54102;6651;8888;8867;94104;64092;25966;54020;337966;9619;386684;388818;337978;386682;254950;54097;56911;873;29761;284827;81543;7226,212
1,1,21,15451032,48090972,32639940,54148;4599;5316;337882;106865373;1409;54101;9875;1826;9073;386679;874;51227;10950;337970;101928147;386681;56245;54943;643812;326;5121;1476;9946;116448;1292;64699;11077;1827;3150;63977;10281;149998;337973;8566;26046;7307;7113;54014;116159;56683;150094;85395;59271;386685;23515;337878;8624;29980;386683;337979;8568;100288323;54149;6450;4731;6493;539;104;54093;5822;6453;4047;54039;337985;7033;353333;23181;3454;25825;23275;2618;337976;2078;3455;1525;140258;56246;64968;49854;89766;754;3460;6647;54065;150051;58494;80781;7327;10785;337879;10841;54033;3753;337972;6782;150084;643803;728299;9992;386672;5211;861;11096;2897;56894;54084;6285;3689;8209;1859;29104;337960;7485;386676;571;386680;7267;53347;7074;5152;10311;150082;3772;3275;54059;8208;9510;10317;5116;84221;29947;337959;4685;6612;337968;755;1291;351;875;10069;7032;100131902;522;53820;9980;337963;337967;353323;7031;3588;6526;10215;7109;140578;386674;386675;23076;6573;3763;2114;353332;3141;4600;337971;54058;8204;386677;89765;30811;337974;337977;5651;337969;388813;57466;140290;54069;2551;757;10600;90625;23562;23308;26285;10694;386678;337975;337880;100288287;54102;6651;8888;8867;94104;64092;25966;54020;337966;9619;386684;388818;337978;386682;254950;54097;56911;873;29761;284827;81543;7226,212
1,1,21,15451032,48090972,32639940,54148;4599;5316;337882;106865373;1409;54101;9875;1826;9073;386679;874;51227;10950;337970;101928147;386681;56245;54943;643812;326;5121;1476;9946;116448;1292;64699;11077;1827;3150;63977;10281;149998;337973;8566;26046;7307;7113;54014;116159;56683;150094;85395;59271;386685;23515;337878;8624;29980;386683;337979;8568;100288323;54149;6450;4731;6493;539;104;54093;5822;6453;4047;54039;337985;7033;353333;23181;3454;25825;23275;2618;337976;2078;3455;1525;140258;56246;64968;49854;89766;754;3460;6647;54065;150051;58494;80781;7327;10785;337879;10841;54033;3753;337972;6782;150084;643803;728299;9992;386672;5211;861;11096;2897;56894;54084;6285;3689;8209;1859;29104;337960;7485;386676;571;386680;7267;53347;7074;5152;10311;150082;3772;3275;54059;8208;9510;10317;5116;84221;29947;337959;4685;6612;337968;755;1291;351;875;10069;7032;100131902;522;53820;9980;337963;337967;353323;7031;3588;6526;10215;7109;140578;386674;386675;23076;6573;3763;2114;353332;3141;4600;337971;54058;8204;386677;89765;30811;337974;337977;5651;337969;388813;57466;140290;54069;2551;757;10600;90625;23562;23308;26285;10694;386678;337975;337880;100288287;54102;6651;8888;8867;94104;64092;25966;54020;337966;9619;386684;388818;337978;386682;254950;54097;56911;873;29761;284827;81543;7226,212
1,1,21,15451032,48090972,32639940,54148;4599;5316;337882;106865373;1409;54101;9875;1826;9073;386679;874;51227;10950;337970;101928147;386681;56245;54943;643812;326;5121;1476;9946;116448;1292;64699;11077;1827;3150;63977;10281;149998;337973;8566;26046;7307;7113;54014;116159;56683;150094;85395;59271;386685;23515;337878;8624;29980;386683;337979;8568;100288323;54149;6450;4731;6493;539;104;54093;5822;6453;4047;54039;337985;7033;353333;23181;3454;25825;23275;2618;337976;2078;3455;1525;140258;56246;64968;49854;89766;754;3460;6647;54065;150051;58494;80781;7327;10785;337879;10841;54033;3753;337972;6782;150084;643803;728299;9992;386672;5211;861;11096;2897;56894;54084;6285;3689;8209;1859;29104;337960;7485;386676;571;386680;7267;53347;7074;5152;10311;150082;3772;3275;54059;8208;9510;10317;5116;84221;29947;337959;4685;6612;337968;755;1291;351;875;10069;7032;100131902;522;53820;9980;337963;337967;353323;7031;3588;6526;10215;7109;140578;386674;386675;23076;6573;3763;2114;353332;3141;4600;337971;54058;8204;386677;89765;30811;337974;337977;5651;337969;388813;57466;140290;54069;2551;757;10600;90625;23562;23308;26285;10694;386678;337975;337880;100288287;54102;6651;8888;8867;94104;64092;25966;54020;337966;9619;386684;388818;337978;386682;254950;54097;56911;873;29761;284827;81543;7226,212
1,1,21,15451032,48090972,32639940,54148;4599;5316;337882;106865373;1409;54101;9875;1826;9073;386679;874;51227;10950;337970;101928147;386681;56245;54943;643812;326;5121;1476;9946;116448;1292;64699;11077;1827;3150;63977;10281;149998;337973;8566;26046;7307;7113;54014;116159;56683;150094;85395;59271;386685;23515;337878;8624;29980;386683;337979;8568;100288323;54149;6450;4731;6493;539;104;54093;5822;6453;4047;54039;337985;7033;353333;23181;3454;25825;23275;2618;337976;2078;3455;1525;140258;56246;64968;49854;89766;754;3460;6647;54065;150051;58494;80781;7327;10785;337879;10841;54033;3753;337972;6782;150084;643803;728299;9992;386672;5211;861;11096;2897;56894;54084;6285;3689;8209;1859;29104;337960;7485;386676;571;386680;7267;53347;7074;5152;10311;150082;3772;3275;54059;8208;9510;10317;5116;84221;29947;337959;4685;6612;337968;755;1291;351;875;10069;7032;100131902;522;53820;9980;337963;337967;353323;7031;3588;6526;10215;7109;140578;386674;386675;23076;6573;3763;2114;353332;3141;4600;337971;54058;8204;386677;89765;30811;337974;337977;5651;337969;388813;57466;140290;54069;2551;757;10600;90625;23562;23308;26285;10694;386678;337975;337880;100288287;54102;6651;8888;8867;94104;64092;25966;54020;337966;9619;386684;388818;337978;386682;254950;54097;56911;873;29761;284827;81543;7226,212
1,1,21,15451032,48090972,32639940,54148;4599;5316;337882;106865373;1409;54101;9875;1826;9073;386679;874;51227;10950;337970;101928147;386681;56245;54943;643812;326;5121;1476;9946;116448;1292;64699;11077;1827;3150;63977;10281;149998;337973;8566;26046;7307;7113;54014;116159;56683;150094;85395;59271;386685;23515;337878;8624;29980;386683;337979;8568;100288323;54149;6450;4731;6493;539;104;54093;5822;6453;4047;54039;337985;7033;353333;23181;3454;25825;23275;2618;337976;2078;3455;1525;140258;56246;64968;49854;89766;754;3460;6647;54065;150051;58494;80781;7327;10785;337879;10841;54033;3753;337972;6782;150084;643803;728299;9992;386672;5211;861;11096;2897;56894;54084;6285;3689;8209;1859;29104;337960;7485;386676;571;386680;7267;53347;7074;5152;10311;150082;3772;3275;54059;8208;9510;10317;5116;84221;29947;337959;4685;6612;337968;755;1291;351;875;10069;7032;100131902;522;53820;9980;337963;337967;353323;7031;3588;6526;10215;7109;140578;386674;386675;23076;6573;3763;2114;353332;3141;4600;337971;54058;8204;386677;89765;30811;337974;337977;5651;337969;388813;57466;140290;54069;2551;757;10600;90625;23562;23308;26285;10694;386678;337975;337880;100288287;54102;6651;8888;8867;94104;64092;25966;54020;337966;9619;386684;388818;337978;386682;254950;54097;56911;873;29761;284827;81543;7226,212
1,1,21,15451032,48090972,32639940,54148;4599;5316;337882;106865373;1409;54101;9875;1826;9073;386679;874;51227;10950;337970;101928147;386681;56245;54943;643812;326;5121;1476;9946;116448;1292;64699;11077;1827;3150;63977;10281;149998;337973;8566;26046;7307;7113;54014;116159;56683;150094;85395;59271;386685;23515;337878;8624;29980;386683;337979;8568;100288323;54149;6450;4731;6493;539;104;54093;5822;6453;4047;54039;337985;7033;353333;23181;3454;25825;23275;2618;337976;2078;3455;1525;140258;56246;64968;49854;89766;754;3460;6647;54065;150051;58494;80781;7327;10785;337879;10841;54033;3753;337972;6782;150084;643803;728299;9992;386672;5211;861;11096;2897;56894;54084;6285;3689;8209;1859;29104;337960;7485;386676;571;386680;7267;53347;7074;5152;10311;150082;3772;3275;54059;8208;9510;10317;5116;84221;29947;337959;4685;6612;337968;755;1291;351;875;10069;7032;100131902;522;53820;9980;337963;337967;353323;7031;3588;6526;10215;7109;140578;386674;386675;23076;6573;3763;2114;353332;3141;4600;337971;54058;8204;386677;89765;30811;337974;337977;5651;337969;388813;57466;140290;54069;2551;757;10600;90625;23562;23308;26285;10694;386678;337975;337880;100288287;54102;6651;8888;8867;94104;64092;25966;54020;337966;9619;386684;388818;337978;386682;254950;54097;56911;873;29761;284827;81543;7226,212
1,1,21,15451032,48090972,32639940,54148;4599;5316;337882;106865373;1409;54101;9875;1826;9073;386679;874;51227;10950;337970;101928147;386681;56245;54943;643812;326;5121;1476;9946;116448;1292;64699;11077;1827;3150;63977;10281;149998;337973;8566;26046;7307;7113;54014;116159;56683;150094;85395;59271;386685;23515;337878;8624;29980;386683;337979;8568;100288323;54149;6450;4731;6493;539;104;54093;5822;6453;4047;54039;337985;7033;353333;23181;3454;25825;23275;2618;337976;2078;3455;1525;140258;56246;64968;49854;89766;754;3460;6647;54065;150051;58494;80781;7327;10785;337879;10841;54033;3753;337972;6782;150084;643803;728299;9992;386672;5211;861;11096;2897;56894;54084;6285;3689;8209;1859;29104;337960;7485;386676;571;386680;7267;53347;7074;5152;10311;150082;3772;3275;54059;8208;9510;10317;5116;84221;29947;337959;4685;6612;337968;755;1291;351;875;10069;7032;100131902;522;53820;9980;337963;337967;353323;7031;3588;6526;10215;7109;140578;386674;386675;23076;6573;3763;2114;353332;3141;4600;337971;54058;8204;386677;89765;30811;337974;337977;5651;337969;388813;57466;140290;54069;2551;757;10600;90625;23562;23308;26285;10694;386678;337975;337880;100288287;54102;6651;8888;8867;94104;64092;25966;54020;337966;9619;386684;388818;337978;386682;254950;54097;56911;873;29761;284827;81543;7226,212
1,1,21,15451032,48090972,32639940,54148;4599;5316;337882;106865373;1409;54101;9875;1826;9073;386679;874;51227;10950;337970;101928147;386681;56245;54943;643812;326;5121;1476;9946;116448;1292;64699;11077;1827;3150;63977;10281;149998;337973;8566;26046;7307;7113;54014;116159;56683;150094;85395;59271;386685;23515;337878;8624;29980;386683;337979;8568;100288323;54149;6450;4731;6493;539;104;54093;5822;6453;4047;54039;337985;7033;353333;23181;3454;25825;23275;2618;337976;2078;3455;1525;140258;56246;64968;49854;89766;754;3460;6647;54065;150051;58494;80781;7327;10785;337879;10841;54033;3753;337972;6782;150084;643803;728299;9992;386672;5211;861;11096;2897;56894;54084;6285;3689;8209;1859;29104;337960;7485;386676;571;386680;7267;53347;7074;5152;10311;150082;3772;3275;54059;8208;9510;10317;5116;84221;29947;337959;4685;6612;337968;755;1291;351;875;10069;7032;100131902;522;53820;9980;337963;337967;353323;7031;3588;6526;10215;7109;140578;386674;386675;23076;6573;3763;2114;353332;3141;4600;337971;54058;8204;386677;89765;30811;337974;337977;5651;337969;388813;57466;140290;54069;2551;757;10600;90625;23562;23308;26285;10694;386678;337975;337880;100288287;54102;6651;8888;8867;94104;64092;25966;54020;337966;9619;386684;388818;337978;386682;254950;54097;56911;873;29761;284827;81543;7226,212
1,1,21,15451032,48090972,32639940,54148;4599;5316;337882;106865373;1409;54101;9875;1826;9073;386679;874;51227;10950;337970;101928147;386681;56245;54943;643812;326;5121;1476;9946;116448;1292;64699;11077;1827;3150;63977;10281;149998;337973;8566;26046;7307;7113;54014;116159;56683;150094;85395;59271;386685;23515;337878;8624;29980;386683;337979;8568;100288323;54149;6450;4731;6493;539;104;54093;5822;6453;4047;54039;337985;7033;353333;23181;3454;25825;23275;2618;337976;2078;3455;1525;140258;56246;64968;49854;89766;754;3460;6647;54065;150051;58494;80781;7327;10785;337879;10841;54033;3753;337972;6782;150084;643803;728299;9992;386672;5211;861;11096;2897;56894;54084;6285;3689;8209;1859;29104;337960;7485;386676;571;386680;7267;53347;7074;5152;10311;150082;3772;3275;54059;8208;9510;10317;5116;84221;29947;337959;4685;6612;337968;755;1291;351;875;10069;7032;100131902;522;53820;9980;337963;337967;353323;7031;3588;6526;10215;7109;140578;386674;386675;23076;6573;3763;2114;353332;3141;4600;337971;54058;8204;386677;89765;30811;337974;337977;5651;337969;388813;57466;140290;54069;2551;757;10600;90625;23562;23308;26285;10694;386678;337975;337880;100288287;54102;6651;8888;8867;94104;64092;25966;54020;337966;9619;386684;388818;337978;386682;254950;54097;56911;873;29761;284827;81543;7226,212
1,1,21,15451032,48090972,32639940,54148;4599;5316;337882;106865373;1409;54101;9875;1826;9073;386679;874;51227;10950;337970;101928147;386681;56245;54943;643812;326;5121;1476;9946;116448;1292;64699;11077;1827;3150;63977;10281;149998;337973;8566;26046;7307;7113;54014;116159;56683;150094;85395;59271;386685;23515;337878;8624;29980;386683;337979;8568;100288323;54149;6450;4731;6493;539;104;54093;5822;6453;4047;54039;337985;7033;353333;23181;3454;25825;23275;2618;337976;2078;3455;1525;140258;56246;64968;49854;89766;754;3460;6647;54065;150051;58494;80781;7327;10785;337879;10841;54033;3753;337972;6782;150084;643803;728299;9992;386672;5211;861;11096;2897;56894;54084;6285;3689;8209;1859;29104;337960;7485;386676;571;386680;7267;53347;7074;5152;10311;150082;3772;3275;54059;8208;9510;10317;5116;84221;29947;337959;4685;6612;337968;755;1291;351;875;10069;7032;100131902;522;53820;9980;337963;337967;353323;7031;3588;6526;10215;7109;140578;386674;386675;23076;6573;3763;2114;353332;3141;4600;337971;54058;8204;386677;89765;30811;337974;337977;5651;337969;388813;57466;140290;54069;2551;757;10600;90625;23562;23308;26285;10694;386678;337975;337880;100288287;54102;6651;8888;8867;94104;64092;25966;54020;337966;9619;386684;388818;337978;386682;254950;54097;56911;873;29761;284827;81543;7226,212
1,1,21,15451032,48090972,32639940,54148;4599;5316;337882;106865373;1409;54101;9875;1826;9073;386679;874;51227;10950;337970;101928147;386681;56245;54943;643812;326;5121;1476;9946;116448;1292;64699;11077;1827;3150;63977;10281;149998;337973;8566;26046;7307;7113;54014;116159;56683;150094;85395;59271;386685;23515;337878;8624;29980;386683;337979;8568;100288323;54149;6450;4731;6493;539;104;54093;5822;6453;4047;54039;337985;7033;353333;23181;3454;25825;23275;2618;337976;2078;3455;1525;140258;56246;64968;49854;89766;754;3460;6647;54065;150051;58494;80781;7327;10785;337879;10841;54033;3753;337972;6782;150084;643803;728299;9992;386672;5211;861;11096;2897;56894;54084;6285;3689;8209;1859;29104;337960;7485;386676;571;386680;7267;53347;7074;5152;10311;150082;3772;3275;54059;8208;9510;10317;5116;84221;29947;337959;4685;6612;337968;755;1291;351;875;10069;7032;100131902;522;53820;9980;337963;337967;353323;7031;3588;6526;10215;7109;140578;386674;386675;23076;6573;3763;2114;353332;3141;4600;337971;54058;8204;386677;89765;30811;337974;337977;5651;337969;388813;57466;140290;54069;2551;757;10600;90625;23562;23308;26285;10694;386678;337975;337880;100288287;54102;6651;8888;8867;94104;64092;25966;54020;337966;9619;386684;388818;337978;386682;254950;54097;56911;873;29761;284827;81543;7226,212
1,1,21,15451032,48090972,32639940,54148;4599;5316;337882;106865373;1409;54101;9875;1826;9073;386679;874;51227;10950;337970;101928147;386681;56245;54943;643812;326;5121;1476;9946;116448;1292;64699;11077;1827;3150;63977;10281;149998;337973;8566;26046;7307;7113;54014;116159;56683;150094;85395;59271;386685;23515;337878;8624;29980;386683;337979;8568;100288323;54149;6450;4731;6493;539;104;54093;5822;6453;4047;54039;337985;7033;353333;23181;3454;25825;23275;2618;337976;2078;3455;1525;140258;56246;64968;49854;89766;754;3460;6647;54065;150051;58494;80781;7327;10785;337879;10841;54033;3753;337972;6782;150084;643803;728299;9992;386672;5211;861;11096;2897;56894;54084;6285;3689;8209;1859;29104;337960;7485;386676;571;386680;7267;53347;7074;5152;10311;150082;3772;3275;54059;8208;9510;10317;5116;84221;29947;337959;4685;6612;337968;755;1291;351;875;10069;7032;100131902;522;53820;9980;337963;337967;353323;7031;3588;6526;10215;7109;140578;386674;386675;23076;6573;3763;2114;353332;3141;4600;337971;54058;8204;386677;89765;30811;337974;337977;5651;337969;388813;57466;140290;54069;2551;757;10600;90625;23562;23308;26285;10694;386678;337975;337880;100288287;54102;6651;8888;8867;94104;64092;25966;54020;337966;9619;386684;388818;337978;386682;254950;54097;56911;873;29761;284827;81543;7226,212
1,1,21,15451032,48090972,32639940,54148;4599;5316;337882;106865373;1409;54101;9875;1826;9073;386679;874;51227;10950;337970;101928147;386681;56245;54943;643812;326;5121;1476;9946;116448;1292;64699;11077;1827;3150;63977;10281;149998;337973;8566;26046;7307;7113;54014;116159;56683;150094;85395;59271;386685;23515;337878;8624;29980;386683;337979;8568;100288323;54149;6450;4731;6493;539;104;54093;5822;6453;4047;54039;337985;7033;353333;23181;3454;25825;23275;2618;337976;2078;3455;1525;140258;56246;64968;49854;89766;754;3460;6647;54065;150051;58494;80781;7327;10785;337879;10841;54033;3753;337972;6782;150084;643803;728299;9992;386672;5211;861;11096;2897;56894;54084;6285;3689;8209;1859;29104;337960;7485;386676;571;386680;7267;53347;7074;5152;10311;150082;3772;3275;54059;8208;9510;10317;5116;84221;29947;337959;4685;6612;337968;755;1291;351;875;10069;7032;100131902;522;53820;9980;337963;337967;353323;7031;3588;6526;10215;7109;140578;386674;386675;23076;6573;3763;2114;353332;3141;4600;337971;54058;8204;386677;89765;30811;337974;337977;5651;337969;388813;57466;140290;54069;2551;757;10600;90625;23562;23308;26285;10694;386678;337975;337880;100288287;54102;6651;8888;8867;94104;64092;25966;54020;337966;9619;386684;388818;337978;386682;254950;54097;56911;873;29761;284827;81543;7226,212
1,1,21,15451032,48090972,32639940,54148;4599;5316;337882;106865373;1409;54101;9875;1826;9073;386679;874;51227;10950;337970;101928147;386681;56245;54943;643812;326;5121;1476;9946;116448;1292;64699;11077;1827;3150;63977;10281;149998;337973;8566;26046;7307;7113;54014;116159;56683;150094;85395;59271;386685;23515;337878;8624;29980;386683;337979;8568;100288323;54149;6450;4731;6493;539;104;54093;5822;6453;4047;54039;337985;7033;353333;23181;3454;25825;23275;2618;337976;2078;3455;1525;140258;56246;64968;49854;89766;754;3460;6647;54065;150051;58494;80781;7327;10785;337879;10841;54033;3753;337972;6782;150084;643803;728299;9992;386672;5211;861;11096;2897;56894;54084;6285;3689;8209;1859;29104;337960;7485;386676;571;386680;7267;53347;7074;5152;10311;150082;3772;3275;54059;8208;9510;10317;5116;84221;29947;337959;4685;6612;337968;755;1291;351;875;10069;7032;100131902;522;53820;9980;337963;337967;353323;7031;3588;6526;10215;7109;140578;386674;386675;23076;6573;3763;2114;353332;3141;4600;337971;54058;8204;386677;89765;30811;337974;337977;5651;337969;388813;57466;140290;54069;2551;757;10600;90625;23562;23308;26285;10694;386678;337975;337880;100288287;54102;6651;8888;8867;94104;64092;25966;54020;337966;9619;386684;388818;337978;386682;254950;54097;56911;873;29761;284827;81543;7226,212
1,1,21,15451032,48090972,32639940,54148;4599;5316;337882;106865373;1409;54101;9875;1826;9073;386679;874;51227;10950;337970;101928147;386681;56245;54943;643812;326;5121;1476;9946;116448;1292;64699;11077;1827;3150;63977;10281;149998;337973;8566;26046;7307;7113;54014;116159;56683;150094;85395;59271;386685;23515;337878;8624;29980;386683;337979;8568;100288323;54149;6450;4731;6493;539;104;54093;5822;6453;4047;54039;337985;7033;353333;23181;3454;25825;23275;2618;337976;2078;3455;1525;140258;56246;64968;49854;89766;754;3460;6647;54065;150051;58494;80781;7327;10785;337879;10841;54033;3753;337972;6782;150084;643803;728299;9992;386672;5211;861;11096;2897;56894;54084;6285;3689;8209;1859;29104;337960;7485;386676;571;386680;7267;53347;7074;5152;10311;150082;3772;3275;54059;8208;9510;10317;5116;84221;29947;337959;4685;6612;337968;755;1291;351;875;10069;7032;100131902;522;53820;9980;337963;337967;353323;7031;3588;6526;10215;7109;140578;386674;386675;23076;6573;3763;2114;353332;3141;4600;337971;54058;8204;386677;89765;30811;337974;337977;5651;337969;388813;57466;140290;54069;2551;757;10600;90625;23562;23308;26285;10694;386678;337975;337880;100288287;54102;6651;8888;8867;94104;64092;25966;54020;337966;9619;386684;388818;337978;386682;254950;54097;56911;873;29761;284827;81543;7226,212
1,1,21,15451032,48090972,32639940,54148;4599;5316;337882;106865373;1409;54101;9875;1826;9073;386679;874;51227;10950;337970;101928147;386681;56245;54943;643812;326;5121;1476;9946;116448;1292;64699;11077;1827;3150;63977;10281;149998;337973;8566;26046;7307;7113;54014;116159;56683;150094;85395;59271;386685;23515;337878;8624;29980;386683;337979;8568;100288323;54149;6450;4731;6493;539;104;54093;5822;6453;4047;54039;337985;7033;353333;23181;3454;25825;23275;2618;337976;2078;3455;1525;140258;56246;64968;49854;89766;754;3460;6647;54065;150051;58494;80781;7327;10785;337879;10841;54033;3753;337972;6782;150084;643803;728299;9992;386672;5211;861;11096;2897;56894;54084;6285;3689;8209;1859;29104;337960;7485;386676;571;386680;7267;53347;7074;5152;10311;150082;3772;3275;54059;8208;9510;10317;5116;84221;29947;337959;4685;6612;337968;755;1291;351;875;10069;7032;100131902;522;53820;9980;337963;337967;353323;7031;3588;6526;10215;7109;140578;386674;386675;23076;6573;3763;2114;353332;3141;4600;337971;54058;8204;386677;89765;30811;337974;337977;5651;337969;388813;57466;140290;54069;2551;757;10600;90625;23562;23308;26285;10694;386678;337975;337880;100288287;54102;6651;8888;8867;94104;64092;25966;54020;337966;9619;386684;388818;337978;386682;254950;54097;56911;873;29761;284827;81543;7226,212
1,1,21,15451032,48090972,32639940,54148;4599;5316;337882;106865373;1409;54101;9875;1826;9073;386679;874;51227;10950;337970;101928147;386681;56245;54943;643812;326;5121;1476;9946;116448;1292;64699;11077;1827;3150;63977;10281;149998;337973;8566;26046;7307;7113;54014;116159;56683;150094;85395;59271;386685;23515;337878;8624;29980;386683;337979;8568;100288323;54149;6450;4731;6493;539;104;54093;5822;6453;4047;54039;337985;7033;353333;23181;3454;25825;23275;2618;337976;2078;3455;1525;140258;56246;64968;49854;89766;754;3460;6647;54065;150051;58494;80781;7327;10785;337879;10841;54033;3753;337972;6782;150084;643803;728299;9992;386672;5211;861;11096;2897;56894;54084;6285;3689;8209;1859;29104;337960;7485;386676;571;386680;7267;53347;7074;5152;10311;150082;3772;3275;54059;8208;9510;10317;5116;84221;29947;337959;4685;6612;337968;755;1291;351;875;10069;7032;100131902;522;53820;9980;337963;337967;353323;7031;3588;6526;10215;7109;140578;386674;386675;23076;6573;3763;2114;353332;3141;4600;337971;54058;8204;386677;89765;30811;337974;337977;5651;337969;388813;57466;140290;54069;2551;757;10600;90625;23562;23308;26285;10694;386678;337975;337880;100288287;54102;6651;8888;8867;94104;64092;25966;54020;337966;9619;386684;388818;337978;386682;254950;54097;56911;873;29761;284827;81543;7226,212
1,1,21,15451032,48090972,32639940,54148;4599;5316;337882;106865373;1409;54101;9875;1826;9073;386679;874;51227;10950;337970;101928147;386681;56245;54943;643812;326;5121;1476;9946;116448;1292;64699;11077;1827;3150;63977;10281;149998;337973;8566;26046;7307;7113;54014;116159;56683;150094;85395;59271;386685;23515;337878;8624;29980;386683;337979;8568;100288323;54149;6450;4731;6493;539;104;54093;5822;6453;4047;54039;337985;7033;353333;23181;3454;25825;23275;2618;337976;2078;3455;1525;140258;56246;64968;49854;89766;754;3460;6647;54065;150051;58494;80781;7327;10785;337879;10841;54033;3753;337972;6782;150084;643803;728299;9992;386672;5211;861;11096;2897;56894;54084;6285;3689;8209;1859;29104;337960;7485;386676;571;386680;7267;53347;7074;5152;10311;150082;3772;3275;54059;8208;9510;10317;5116;84221;29947;337959;4685;6612;337968;755;1291;351;875;10069;7032;100131902;522;53820;9980;337963;337967;353323;7031;3588;6526;10215;7109;140578;386674;386675;23076;6573;3763;2114;353332;3141;4600;337971;54058;8204;386677;89765;30811;337974;337977;5651;337969;388813;57466;140290;54069;2551;757;10600;90625;23562;23308;26285;10694;386678;337975;337880;100288287;54102;6651;8888;8867;94104;64092;25966;54020;337966;9619;386684;388818;337978;386682;254950;54097;56911;873;29761;284827;81543;7226,212
1,1,21,15451032,48090972,32639940,54148;4599;5316;337882;106865373;1409;54101;9875;1826;9073;386679;874;51227;10950;337970;101928147;386681;56245;54943;643812;326;5121;1476;9946;116448;1292;64699;11077;1827;3150;63977;10281;149998;337973;8566;26046;7307;7113;54014;116159;56683;150094;85395;59271;386685;23515;337878;8624;29980;386683;337979;8568;100288323;54149;6450;4731;6493;539;104;54093;5822;6453;4047;54039;337985;7033;353333;23181;3454;25825;23275;2618;337976;2078;3455;1525;140258;56246;64968;49854;89766;754;3460;6647;54065;150051;58494;80781;7327;10785;337879;10841;54033;3753;337972;6782;150084;643803;728299;9992;386672;5211;861;11096;2897;56894;54084;6285;3689;8209;1859;29104;337960;7485;386676;571;386680;7267;53347;7074;5152;10311;150082;3772;3275;54059;8208;9510;10317;5116;84221;29947;337959;4685;6612;337968;755;1291;351;875;10069;7032;100131902;522;53820;9980;337963;337967;353323;7031;3588;6526;10215;7109;140578;386674;386675;23076;6573;3763;2114;353332;3141;4600;337971;54058;8204;386677;89765;30811;337974;337977;5651;337969;388813;57466;140290;54069;2551;757;10600;90625;23562;23308;26285;10694;386678;337975;337880;100288287;54102;6651;8888;8867;94104;64092;25966;54020;337966;9619;386684;388818;337978;386682;254950;54097;56911;873;29761;284827;81543;7226,212
1,1,21,15451032,48090972,32639940,54148;4599;5316;337882;106865373;1409;54101;9875;1826;9073;386679;874;51227;10950;337970;101928147;386681;56245;54943;643812;326;5121;1476;9946;116448;1292;64699;11077;1827;3150;63977;10281;149998;337973;8566;26046;7307;7113;54014;116159;56683;150094;85395;59271;386685;23515;337878;8624;29980;386683;337979;8568;100288323;54149;6450;4731;6493;539;104;54093;5822;6453;4047;54039;337985;7033;353333;23181;3454;25825;23275;2618;337976;2078;3455;1525;140258;56246;64968;49854;89766;754;3460;6647;54065;150051;58494;80781;7327;10785;337879;10841;54033;3753;337972;6782;150084;643803;728299;9992;386672;5211;861;11096;2897;56894;54084;6285;3689;8209;1859;29104;337960;7485;386676;571;386680;7267;53347;7074;5152;10311;150082;3772;3275;54059;8208;9510;10317;5116;84221;29947;337959;4685;6612;337968;755;1291;351;875;10069;7032;100131902;522;53820;9980;337963;337967;353323;7031;3588;6526;10215;7109;140578;386674;386675;23076;6573;3763;2114;353332;3141;4600;337971;54058;8204;386677;89765;30811;337974;337977;5651;337969;388813;57466;140290;54069;2551;757;10600;90625;23562;23308;26285;10694;386678;337975;337880;100288287;54102;6651;8888;8867;94104;64092;25966;54020;337966;9619;386684;388818;337978;386682;254950;54097;56911;873;29761;284827;81543;7226,212
-1,1,21,15485038,22669593,7184555,149998;8204;140578;10950;54149;54033;29761;5651;64092;388813;6782;4685;1525,13
1,1,21,15485038,48072996,32587958,54148;4599;5316;337882;106865373;1409;54101;9875;1826;9073;386679;874;51227;10950;337970;101928147;386681;56245;54943;643812;326;5121;1476;9946;116448;1292;64699;11077;1827;3150;63977;10281;149998;337973;8566;26046;7307;7113;54014;116159;56683;150094;85395;59271;386685;23515;337878;8624;29980;386683;337979;8568;100288323;54149;6450;4731;6493;539;104;54093;5822;6453;4047;54039;337985;7033;353333;23181;3454;25825;23275;2618;337976;2078;3455;1525;140258;56246;64968;49854;89766;754;3460;6647;54065;150051;58494;80781;7327;10785;337879;10841;54033;3753;337972;6782;150084;643803;728299;9992;386672;5211;861;11096;2897;56894;54084;6285;3689;8209;1859;29104;337960;7485;386676;571;386680;7267;53347;7074;5152;10311;150082;3772;3275;54059;8208;9510;10317;5116;84221;29947;337959;4685;6612;337968;755;1291;351;875;10069;7032;100131902;522;53820;9980;337963;337967;353323;7031;3588;6526;10215;7109;140578;386674;386675;23076;6573;3763;2114;353332;3141;4600;337971;54058;8204;386677;89765;30811;337974;337977;5651;337969;388813;57466;140290;54069;2551;757;10600;90625;23562;23308;26285;10694;386678;337975;337880;100288287;54102;6651;8888;8867;94104;64092;25966;54020;337966;9619;386684;388818;337978;386682;254950;54097;56911;873;29761;284827;81543;7226,212
1,1,21,15485038,48072996,32587958,54148;4599;5316;337882;106865373;1409;54101;9875;1826;9073;386679;874;51227;10950;337970;101928147;386681;56245;54943;643812;326;5121;1476;9946;116448;1292;64699;11077;1827;3150;63977;10281;149998;337973;8566;26046;7307;7113;54014;116159;56683;150094;85395;59271;386685;23515;337878;8624;29980;386683;337979;8568;100288323;54149;6450;4731;6493;539;104;54093;5822;6453;4047;54039;337985;7033;353333;23181;3454;25825;23275;2618;337976;2078;3455;1525;140258;56246;64968;49854;89766;754;3460;6647;54065;150051;58494;80781;7327;10785;337879;10841;54033;3753;337972;6782;150084;643803;728299;9992;386672;5211;861;11096;2897;56894;54084;6285;3689;8209;1859;29104;337960;7485;386676;571;386680;7267;53347;7074;5152;10311;150082;3772;3275;54059;8208;9510;10317;5116;84221;29947;337959;4685;6612;337968;755;1291;351;875;10069;7032;100131902;522;53820;9980;337963;337967;353323;7031;3588;6526;10215;7109;140578;386674;386675;23076;6573;3763;2114;353332;3141;4600;337971;54058;8204;386677;89765;30811;337974;337977;5651;337969;388813;57466;140290;54069;2551;757;10600;90625;23562;23308;26285;10694;386678;337975;337880;100288287;54102;6651;8888;8867;94104;64092;25966;54020;337966;9619;386684;388818;337978;386682;254950;54097;56911;873;29761;284827;81543;7226,212
1,1,21,15485038,48072996,32587958,54148;4599;5316;337882;106865373;1409;54101;9875;1826;9073;386679;874;51227;10950;337970;101928147;386681;56245;54943;643812;326;5121;1476;9946;116448;1292;64699;11077;1827;3150;63977;10281;149998;337973;8566;26046;7307;7113;54014;116159;56683;150094;85395;59271;386685;23515;337878;8624;29980;386683;337979;8568;100288323;54149;6450;4731;6493;539;104;54093;5822;6453;4047;54039;337985;7033;353333;23181;3454;25825;23275;2618;337976;2078;3455;1525;140258;56246;64968;49854;89766;754;3460;6647;54065;150051;58494;80781;7327;10785;337879;10841;54033;3753;337972;6782;150084;643803;728299;9992;386672;5211;861;11096;2897;56894;54084;6285;3689;8209;1859;29104;337960;7485;386676;571;386680;7267;53347;7074;5152;10311;150082;3772;3275;54059;8208;9510;10317;5116;84221;29947;337959;4685;6612;337968;755;1291;351;875;10069;7032;100131902;522;53820;9980;337963;337967;353323;7031;3588;6526;10215;7109;140578;386674;386675;23076;6573;3763;2114;353332;3141;4600;337971;54058;8204;386677;89765;30811;337974;337977;5651;337969;388813;57466;140290;54069;2551;757;10600;90625;23562;23308;26285;10694;386678;337975;337880;100288287;54102;6651;8888;8867;94104;64092;25966;54020;337966;9619;386684;388818;337978;386682;254950;54097;56911;873;29761;284827;81543;7226,212
1,1,21,15485038,48084162,32599124,54148;4599;5316;337882;106865373;1409;54101;9875;1826;9073;386679;874;51227;10950;337970;101928147;386681;56245;54943;643812;326;5121;1476;9946;116448;1292;64699;11077;1827;3150;63977;10281;149998;337973;8566;26046;7307;7113;54014;116159;56683;150094;85395;59271;386685;23515;337878;8624;29980;386683;337979;8568;100288323;54149;6450;4731;6493;539;104;54093;5822;6453;4047;54039;337985;7033;353333;23181;3454;25825;23275;2618;337976;2078;3455;1525;140258;56246;64968;49854;89766;754;3460;6647;54065;150051;58494;80781;7327;10785;337879;10841;54033;3753;337972;6782;150084;643803;728299;9992;386672;5211;861;11096;2897;56894;54084;6285;3689;8209;1859;29104;337960;7485;386676;571;386680;7267;53347;7074;5152;10311;150082;3772;3275;54059;8208;9510;10317;5116;84221;29947;337959;4685;6612;337968;755;1291;351;875;10069;7032;100131902;522;53820;9980;337963;337967;353323;7031;3588;6526;10215;7109;140578;386674;386675;23076;6573;3763;2114;353332;3141;4600;337971;54058;8204;386677;89765;30811;337974;337977;5651;337969;388813;57466;140290;54069;2551;757;10600;90625;23562;23308;26285;10694;386678;337975;337880;100288287;54102;6651;8888;8867;94104;64092;25966;54020;337966;9619;386684;388818;337978;386682;254950;54097;56911;873;29761;284827;81543;7226,212
1,1,21,15485038,48090352,32605314,54148;4599;5316;337882;106865373;1409;54101;9875;1826;9073;386679;874;51227;10950;337970;101928147;386681;56245;54943;643812;326;5121;1476;9946;116448;1292;64699;11077;1827;3150;63977;10281;149998;337973;8566;26046;7307;7113;54014;116159;56683;150094;85395;59271;386685;23515;337878;8624;29980;386683;337979;8568;100288323;54149;6450;4731;6493;539;104;54093;5822;6453;4047;54039;337985;7033;353333;23181;3454;25825;23275;2618;337976;2078;3455;1525;140258;56246;64968;49854;89766;754;3460;6647;54065;150051;58494;80781;7327;10785;337879;10841;54033;3753;337972;6782;150084;643803;728299;9992;386672;5211;861;11096;2897;56894;54084;6285;3689;8209;1859;29104;337960;7485;386676;571;386680;7267;53347;7074;5152;10311;150082;3772;3275;54059;8208;9510;10317;5116;84221;29947;337959;4685;6612;337968;755;1291;351;875;10069;7032;100131902;522;53820;9980;337963;337967;353323;7031;3588;6526;10215;7109;140578;386674;386675;23076;6573;3763;2114;353332;3141;4600;337971;54058;8204;386677;89765;30811;337974;337977;5651;337969;388813;57466;140290;54069;2551;757;10600;90625;23562;23308;26285;10694;386678;337975;337880;100288287;54102;6651;8888;8867;94104;64092;25966;54020;337966;9619;386684;388818;337978;386682;254950;54097;56911;873;29761;284827;81543;7226,212
1,1,21,15485038,48090352,32605314,54148;4599;5316;337882;106865373;1409;54101;9875;1826;9073;386679;874;51227;10950;337970;101928147;386681;56245;54943;643812;326;5121;1476;9946;116448;1292;64699;11077;1827;3150;63977;10281;149998;337973;8566;26046;7307;7113;54014;116159;56683;150094;85395;59271;386685;23515;337878;8624;29980;386683;337979;8568;100288323;54149;6450;4731;6493;539;104;54093;5822;6453;4047;54039;337985;7033;353333;23181;3454;25825;23275;2618;337976;2078;3455;1525;140258;56246;64968;49854;89766;754;3460;6647;54065;150051;58494;80781;7327;10785;337879;10841;54033;3753;337972;6782;150084;643803;728299;9992;386672;5211;861;11096;2897;56894;54084;6285;3689;8209;1859;29104;337960;7485;386676;571;386680;7267;53347;7074;5152;10311;150082;3772;3275;54059;8208;9510;10317;5116;84221;29947;337959;4685;6612;337968;755;1291;351;875;10069;7032;100131902;522;53820;9980;337963;337967;353323;7031;3588;6526;10215;7109;140578;386674;386675;23076;6573;3763;2114;353332;3141;4600;337971;54058;8204;386677;89765;30811;337974;337977;5651;337969;388813;57466;140290;54069;2551;757;10600;90625;23562;23308;26285;10694;386678;337975;337880;100288287;54102;6651;8888;8867;94104;64092;25966;54020;337966;9619;386684;388818;337978;386682;254950;54097;56911;873;29761;284827;81543;7226,212
1,1,21,15485038,48090352,32605314,54148;4599;5316;337882;106865373;1409;54101;9875;1826;9073;386679;874;51227;10950;337970;101928147;386681;56245;54943;643812;326;5121;1476;9946;116448;1292;64699;11077;1827;3150;63977;10281;149998;337973;8566;26046;7307;7113;54014;116159;56683;150094;85395;59271;386685;23515;337878;8624;29980;386683;337979;8568;100288323;54149;6450;4731;6493;539;104;54093;5822;6453;4047;54039;337985;7033;353333;23181;3454;25825;23275;2618;337976;2078;3455;1525;140258;56246;64968;49854;89766;754;3460;6647;54065;150051;58494;80781;7327;10785;337879;10841;54033;3753;337972;6782;150084;643803;728299;9992;386672;5211;861;11096;2897;56894;54084;6285;3689;8209;1859;29104;337960;7485;386676;571;386680;7267;53347;7074;5152;10311;150082;3772;3275;54059;8208;9510;10317;5116;84221;29947;337959;4685;6612;337968;755;1291;351;875;10069;7032;100131902;522;53820;9980;337963;337967;353323;7031;3588;6526;10215;7109;140578;386674;386675;23076;6573;3763;2114;353332;3141;4600;337971;54058;8204;386677;89765;30811;337974;337977;5651;337969;388813;57466;140290;54069;2551;757;10600;90625;23562;23308;26285;10694;386678;337975;337880;100288287;54102;6651;8888;8867;94104;64092;25966;54020;337966;9619;386684;388818;337978;386682;254950;54097;56911;873;29761;284827;81543;7226,212
1,1,21,15485038,48090352,32605314,54148;4599;5316;337882;106865373;1409;54101;9875;1826;9073;386679;874;51227;10950;337970;101928147;386681;56245;54943;643812;326;5121;1476;9946;116448;1292;64699;11077;1827;3150;63977;10281;149998;337973;8566;26046;7307;7113;54014;116159;56683;150094;85395;59271;386685;23515;337878;8624;29980;386683;337979;8568;100288323;54149;6450;4731;6493;539;104;54093;5822;6453;4047;54039;337985;7033;353333;23181;3454;25825;23275;2618;337976;2078;3455;1525;140258;56246;64968;49854;89766;754;3460;6647;54065;150051;58494;80781;7327;10785;337879;10841;54033;3753;337972;6782;150084;643803;728299;9992;386672;5211;861;11096;2897;56894;54084;6285;3689;8209;1859;29104;337960;7485;386676;571;386680;7267;53347;7074;5152;10311;150082;3772;3275;54059;8208;9510;10317;5116;84221;29947;337959;4685;6612;337968;755;1291;351;875;10069;7032;100131902;522;53820;9980;337963;337967;353323;7031;3588;6526;10215;7109;140578;386674;386675;23076;6573;3763;2114;353332;3141;4600;337971;54058;8204;386677;89765;30811;337974;337977;5651;337969;388813;57466;140290;54069;2551;757;10600;90625;23562;23308;26285;10694;386678;337975;337880;100288287;54102;6651;8888;8867;94104;64092;25966;54020;337966;9619;386684;388818;337978;386682;254950;54097;56911;873;29761;284827;81543;7226,212
1,1,21,15485038,48090352,32605314,54148;4599;5316;337882;106865373;1409;54101;9875;1826;9073;386679;874;51227;10950;337970;101928147;386681;56245;54943;643812;326;5121;1476;9946;116448;1292;64699;11077;1827;3150;63977;10281;149998;337973;8566;26046;7307;7113;54014;116159;56683;150094;85395;59271;386685;23515;337878;8624;29980;386683;337979;8568;100288323;54149;6450;4731;6493;539;104;54093;5822;6453;4047;54039;337985;7033;353333;23181;3454;25825;23275;2618;337976;2078;3455;1525;140258;56246;64968;49854;89766;754;3460;6647;54065;150051;58494;80781;7327;10785;337879;10841;54033;3753;337972;6782;150084;643803;728299;9992;386672;5211;861;11096;2897;56894;54084;6285;3689;8209;1859;29104;337960;7485;386676;571;386680;7267;53347;7074;5152;10311;150082;3772;3275;54059;8208;9510;10317;5116;84221;29947;337959;4685;6612;337968;755;1291;351;875;10069;7032;100131902;522;53820;9980;337963;337967;353323;7031;3588;6526;10215;7109;140578;386674;386675;23076;6573;3763;2114;353332;3141;4600;337971;54058;8204;386677;89765;30811;337974;337977;5651;337969;388813;57466;140290;54069;2551;757;10600;90625;23562;23308;26285;10694;386678;337975;337880;100288287;54102;6651;8888;8867;94104;64092;25966;54020;337966;9619;386684;388818;337978;386682;254950;54097;56911;873;29761;284827;81543;7226,212
-1,1,21,15485038,48090352,32605314,54148;4599;5316;337882;106865373;1409;54101;9875;1826;9073;386679;874;51227;10950;337970;101928147;386681;56245;54943;643812;326;5121;1476;9946;116448;1292;64699;11077;1827;3150;63977;10281;149998;337973;8566;26046;7307;7113;54014;116159;56683;150094;85395;59271;386685;23515;337878;8624;29980;386683;337979;8568;100288323;54149;6450;4731;6493;539;104;54093;5822;6453;4047;54039;337985;7033;353333;23181;3454;25825;23275;2618;337976;2078;3455;1525;140258;56246;64968;49854;89766;754;3460;6647;54065;150051;58494;80781;7327;10785;337879;10841;54033;3753;337972;6782;150084;643803;728299;9992;386672;5211;861;11096;2897;56894;54084;6285;3689;8209;1859;29104;337960;7485;386676;571;386680;7267;53347;7074;5152;10311;150082;3772;3275;54059;8208;9510;10317;5116;84221;29947;337959;4685;6612;337968;755;1291;351;875;10069;7032;100131902;522;53820;9980;337963;337967;353323;7031;3588;6526;10215;7109;140578;386674;386675;23076;6573;3763;2114;353332;3141;4600;337971;54058;8204;386677;89765;30811;337974;337977;5651;337969;388813;57466;140290;54069;2551;757;10600;90625;23562;23308;26285;10694;386678;337975;337880;100288287;54102;6651;8888;8867;94104;64092;25966;54020;337966;9619;386684;388818;337978;386682;254950;54097;56911;873;29761;284827;81543;7226,212
1,1,21,15485038,48090352,32605314,54148;4599;5316;337882;106865373;1409;54101;9875;1826;9073;386679;874;51227;10950;337970;101928147;386681;56245;54943;643812;326;5121;1476;9946;116448;1292;64699;11077;1827;3150;63977;10281;149998;337973;8566;26046;7307;7113;54014;116159;56683;150094;85395;59271;386685;23515;337878;8624;29980;386683;337979;8568;100288323;54149;6450;4731;6493;539;104;54093;5822;6453;4047;54039;337985;7033;353333;23181;3454;25825;23275;2618;337976;2078;3455;1525;140258;56246;64968;49854;89766;754;3460;6647;54065;150051;58494;80781;7327;10785;337879;10841;54033;3753;337972;6782;150084;643803;728299;9992;386672;5211;861;11096;2897;56894;54084;6285;3689;8209;1859;29104;337960;7485;386676;571;386680;7267;53347;7074;5152;10311;150082;3772;3275;54059;8208;9510;10317;5116;84221;29947;337959;4685;6612;337968;755;1291;351;875;10069;7032;100131902;522;53820;9980;337963;337967;353323;7031;3588;6526;10215;7109;140578;386674;386675;23076;6573;3763;2114;353332;3141;4600;337971;54058;8204;386677;89765;30811;337974;337977;5651;337969;388813;57466;140290;54069;2551;757;10600;90625;23562;23308;26285;10694;386678;337975;337880;100288287;54102;6651;8888;8867;94104;64092;25966;54020;337966;9619;386684;388818;337978;386682;254950;54097;56911;873;29761;284827;81543;7226,212
1,1,21,15485038,48090352,32605314,54148;4599;5316;337882;106865373;1409;54101;9875;1826;9073;386679;874;51227;10950;337970;101928147;386681;56245;54943;643812;326;5121;1476;9946;116448;1292;64699;11077;1827;3150;63977;10281;149998;337973;8566;26046;7307;7113;54014;116159;56683;150094;85395;59271;386685;23515;337878;8624;29980;386683;337979;8568;100288323;54149;6450;4731;6493;539;104;54093;5822;6453;4047;54039;337985;7033;353333;23181;3454;25825;23275;2618;337976;2078;3455;1525;140258;56246;64968;49854;89766;754;3460;6647;54065;150051;58494;80781;7327;10785;337879;10841;54033;3753;337972;6782;150084;643803;728299;9992;386672;5211;861;11096;2897;56894;54084;6285;3689;8209;1859;29104;337960;7485;386676;571;386680;7267;53347;7074;5152;10311;150082;3772;3275;54059;8208;9510;10317;5116;84221;29947;337959;4685;6612;337968;755;1291;351;875;10069;7032;100131902;522;53820;9980;337963;337967;353323;7031;3588;6526;10215;7109;140578;386674;386675;23076;6573;3763;2114;353332;3141;4600;337971;54058;8204;386677;89765;30811;337974;337977;5651;337969;388813;57466;140290;54069;2551;757;10600;90625;23562;23308;26285;10694;386678;337975;337880;100288287;54102;6651;8888;8867;94104;64092;25966;54020;337966;9619;386684;388818;337978;386682;254950;54097;56911;873;29761;284827;81543;7226,212
1,1,21,15485038,48090352,32605314,54148;4599;5316;337882;106865373;1409;54101;9875;1826;9073;386679;874;51227;10950;337970;101928147;386681;56245;54943;643812;326;5121;1476;9946;116448;1292;64699;11077;1827;3150;63977;10281;149998;337973;8566;26046;7307;7113;54014;116159;56683;150094;85395;59271;386685;23515;337878;8624;29980;386683;337979;8568;100288323;54149;6450;4731;6493;539;104;54093;5822;6453;4047;54039;337985;7033;353333;23181;3454;25825;23275;2618;337976;2078;3455;1525;140258;56246;64968;49854;89766;754;3460;6647;54065;150051;58494;80781;7327;10785;337879;10841;54033;3753;337972;6782;150084;643803;728299;9992;386672;5211;861;11096;2897;56894;54084;6285;3689;8209;1859;29104;337960;7485;386676;571;386680;7267;53347;7074;5152;10311;150082;3772;3275;54059;8208;9510;10317;5116;84221;29947;337959;4685;6612;337968;755;1291;351;875;10069;7032;100131902;522;53820;9980;337963;337967;353323;7031;3588;6526;10215;7109;140578;386674;386675;23076;6573;3763;2114;353332;3141;4600;337971;54058;8204;386677;89765;30811;337974;337977;5651;337969;388813;57466;140290;54069;2551;757;10600;90625;23562;23308;26285;10694;386678;337975;337880;100288287;54102;6651;8888;8867;94104;64092;25966;54020;337966;9619;386684;388818;337978;386682;254950;54097;56911;873;29761;284827;81543;7226,212
1,1,21,15485038,48090352,32605314,54148;4599;5316;337882;106865373;1409;54101;9875;1826;9073;386679;874;51227;10950;337970;101928147;386681;56245;54943;643812;326;5121;1476;9946;116448;1292;64699;11077;1827;3150;63977;10281;149998;337973;8566;26046;7307;7113;54014;116159;56683;150094;85395;59271;386685;23515;337878;8624;29980;386683;337979;8568;100288323;54149;6450;4731;6493;539;104;54093;5822;6453;4047;54039;337985;7033;353333;23181;3454;25825;23275;2618;337976;2078;3455;1525;140258;56246;64968;49854;89766;754;3460;6647;54065;150051;58494;80781;7327;10785;337879;10841;54033;3753;337972;6782;150084;643803;728299;9992;386672;5211;861;11096;2897;56894;54084;6285;3689;8209;1859;29104;337960;7485;386676;571;386680;7267;53347;7074;5152;10311;150082;3772;3275;54059;8208;9510;10317;5116;84221;29947;337959;4685;6612;337968;755;1291;351;875;10069;7032;100131902;522;53820;9980;337963;337967;353323;7031;3588;6526;10215;7109;140578;386674;386675;23076;6573;3763;2114;353332;3141;4600;337971;54058;8204;386677;89765;30811;337974;337977;5651;337969;388813;57466;140290;54069;2551;757;10600;90625;23562;23308;26285;10694;386678;337975;337880;100288287;54102;6651;8888;8867;94104;64092;25966;54020;337966;9619;386684;388818;337978;386682;254950;54097;56911;873;29761;284827;81543;7226,212
1,1,21,15485038,48090352,32605314,54148;4599;5316;337882;106865373;1409;54101;9875;1826;9073;386679;874;51227;10950;337970;101928147;386681;56245;54943;643812;326;5121;1476;9946;116448;1292;64699;11077;1827;3150;63977;10281;149998;337973;8566;26046;7307;7113;54014;116159;56683;150094;85395;59271;386685;23515;337878;8624;29980;386683;337979;8568;100288323;54149;6450;4731;6493;539;104;54093;5822;6453;4047;54039;337985;7033;353333;23181;3454;25825;23275;2618;337976;2078;3455;1525;140258;56246;64968;49854;89766;754;3460;6647;54065;150051;58494;80781;7327;10785;337879;10841;54033;3753;337972;6782;150084;643803;728299;9992;386672;5211;861;11096;2897;56894;54084;6285;3689;8209;1859;29104;337960;7485;386676;571;386680;7267;53347;7074;5152;10311;150082;3772;3275;54059;8208;9510;10317;5116;84221;29947;337959;4685;6612;337968;755;1291;351;875;10069;7032;100131902;522;53820;9980;337963;337967;353323;7031;3588;6526;10215;7109;140578;386674;386675;23076;6573;3763;2114;353332;3141;4600;337971;54058;8204;386677;89765;30811;337974;337977;5651;337969;388813;57466;140290;54069;2551;757;10600;90625;23562;23308;26285;10694;386678;337975;337880;100288287;54102;6651;8888;8867;94104;64092;25966;54020;337966;9619;386684;388818;337978;386682;254950;54097;56911;873;29761;284827;81543;7226,212
1,1,21,15499847,44391157,28891310,54148;4599;337882;106865373;54101;9875;1826;9073;874;51227;10950;337970;101928147;56245;54943;643812;5121;9946;116448;64699;1827;3150;63977;10281;149998;337973;26046;7113;54014;116159;56683;59271;23515;337878;8624;29980;337979;100288323;54149;6450;4731;6493;539;54093;6453;337985;7033;3454;25825;2618;337976;2078;3455;1525;140258;56246;64968;49854;89766;3460;6647;54065;150051;58494;10785;337879;54033;3753;337972;6782;150084;643803;728299;9992;861;11096;2897;1859;29104;337960;7485;571;7267;53347;7074;5152;10311;150082;3772;8208;9510;10317;337959;4685;337968;351;10069;7032;100131902;522;53820;9980;337963;337967;7031;3588;6526;10215;140578;3763;2114;3141;4600;337971;8204;89765;30811;337974;337977;5651;337969;388813;57466;140290;54069;2551;757;10600;90625;23562;26285;10694;337975;337880;100288287;54102;6651;8867;94104;64092;25966;54020;337966;9619;388818;337978;254950;54097;56911;873;29761;284827,152
1,1,21,15499847,44391157,28891310,54148;4599;337882;106865373;54101;9875;1826;9073;874;51227;10950;337970;101928147;56245;54943;643812;5121;9946;116448;64699;1827;3150;63977;10281;149998;337973;26046;7113;54014;116159;56683;59271;23515;337878;8624;29980;337979;100288323;54149;6450;4731;6493;539;54093;6453;337985;7033;3454;25825;2618;337976;2078;3455;1525;140258;56246;64968;49854;89766;3460;6647;54065;150051;58494;10785;337879;54033;3753;337972;6782;150084;643803;728299;9992;861;11096;2897;1859;29104;337960;7485;571;7267;53347;7074;5152;10311;150082;3772;8208;9510;10317;337959;4685;337968;351;10069;7032;100131902;522;53820;9980;337963;337967;7031;3588;6526;10215;140578;3763;2114;3141;4600;337971;8204;89765;30811;337974;337977;5651;337969;388813;57466;140290;54069;2551;757;10600;90625;23562;26285;10694;337975;337880;100288287;54102;6651;8867;94104;64092;25966;54020;337966;9619;388818;337978;254950;54097;56911;873;29761;284827,152
1,1,21,15499847,48080911,32581064,54148;4599;5316;337882;106865373;1409;54101;9875;1826;9073;386679;874;51227;10950;337970;101928147;386681;56245;54943;643812;326;5121;1476;9946;116448;1292;64699;11077;1827;3150;63977;10281;149998;337973;8566;26046;7307;7113;54014;116159;56683;150094;85395;59271;386685;23515;337878;8624;29980;386683;337979;8568;100288323;54149;6450;4731;6493;539;104;54093;5822;6453;4047;54039;337985;7033;353333;23181;3454;25825;23275;2618;337976;2078;3455;1525;140258;56246;64968;49854;89766;754;3460;6647;54065;150051;58494;80781;7327;10785;337879;10841;54033;3753;337972;6782;150084;643803;728299;9992;386672;5211;861;11096;2897;56894;54084;6285;3689;8209;1859;29104;337960;7485;386676;571;386680;7267;53347;7074;5152;10311;150082;3772;3275;54059;8208;9510;10317;5116;84221;29947;337959;4685;6612;337968;755;1291;351;875;10069;7032;100131902;522;53820;9980;337963;337967;353323;7031;3588;6526;10215;7109;140578;386674;386675;23076;6573;3763;2114;353332;3141;4600;337971;54058;8204;386677;89765;30811;337974;337977;5651;337969;388813;57466;140290;54069;2551;757;10600;90625;23562;23308;26285;10694;386678;337975;337880;100288287;54102;6651;8888;8867;94104;64092;25966;54020;337966;9619;386684;388818;337978;386682;254950;54097;56911;873;29761;284827;81543;7226,212
1,1,21,15499847,48090317,32590470,54148;4599;5316;337882;106865373;1409;54101;9875;1826;9073;386679;874;51227;10950;337970;101928147;386681;56245;54943;643812;326;5121;1476;9946;116448;1292;64699;11077;1827;3150;63977;10281;149998;337973;8566;26046;7307;7113;54014;116159;56683;150094;85395;59271;386685;23515;337878;8624;29980;386683;337979;8568;100288323;54149;6450;4731;6493;539;104;54093;5822;6453;4047;54039;337985;7033;353333;23181;3454;25825;23275;2618;337976;2078;3455;1525;140258;56246;64968;49854;89766;754;3460;6647;54065;150051;58494;80781;7327;10785;337879;10841;54033;3753;337972;6782;150084;643803;728299;9992;386672;5211;861;11096;2897;56894;54084;6285;3689;8209;1859;29104;337960;7485;386676;571;386680;7267;53347;7074;5152;10311;150082;3772;3275;54059;8208;9510;10317;5116;84221;29947;337959;4685;6612;337968;755;1291;351;875;10069;7032;100131902;522;53820;9980;337963;337967;353323;7031;3588;6526;10215;7109;140578;386674;386675;23076;6573;3763;2114;353332;3141;4600;337971;54058;8204;386677;89765;30811;337974;337977;5651;337969;388813;57466;140290;54069;2551;757;10600;90625;23562;23308;26285;10694;386678;337975;337880;100288287;54102;6651;8888;8867;94104;64092;25966;54020;337966;9619;386684;388818;337978;386682;254950;54097;56911;873;29761;284827;81543;7226,212
1,1,21,15499847,48090317,32590470,54148;4599;5316;337882;106865373;1409;54101;9875;1826;9073;386679;874;51227;10950;337970;101928147;386681;56245;54943;643812;326;5121;1476;9946;116448;1292;64699;11077;1827;3150;63977;10281;149998;337973;8566;26046;7307;7113;54014;116159;56683;150094;85395;59271;386685;23515;337878;8624;29980;386683;337979;8568;100288323;54149;6450;4731;6493;539;104;54093;5822;6453;4047;54039;337985;7033;353333;23181;3454;25825;23275;2618;337976;2078;3455;1525;140258;56246;64968;49854;89766;754;3460;6647;54065;150051;58494;80781;7327;10785;337879;10841;54033;3753;337972;6782;150084;643803;728299;9992;386672;5211;861;11096;2897;56894;54084;6285;3689;8209;1859;29104;337960;7485;386676;571;386680;7267;53347;7074;5152;10311;150082;3772;3275;54059;8208;9510;10317;5116;84221;29947;337959;4685;6612;337968;755;1291;351;875;10069;7032;100131902;522;53820;9980;337963;337967;353323;7031;3588;6526;10215;7109;140578;386674;386675;23076;6573;3763;2114;353332;3141;4600;337971;54058;8204;386677;89765;30811;337974;337977;5651;337969;388813;57466;140290;54069;2551;757;10600;90625;23562;23308;26285;10694;386678;337975;337880;100288287;54102;6651;8888;8867;94104;64092;25966;54020;337966;9619;386684;388818;337978;386682;254950;54097;56911;873;29761;284827;81543;7226,212
1,1,21,15499847,48090317,32590470,54148;4599;5316;337882;106865373;1409;54101;9875;1826;9073;386679;874;51227;10950;337970;101928147;386681;56245;54943;643812;326;5121;1476;9946;116448;1292;64699;11077;1827;3150;63977;10281;149998;337973;8566;26046;7307;7113;54014;116159;56683;150094;85395;59271;386685;23515;337878;8624;29980;386683;337979;8568;100288323;54149;6450;4731;6493;539;104;54093;5822;6453;4047;54039;337985;7033;353333;23181;3454;25825;23275;2618;337976;2078;3455;1525;140258;56246;64968;49854;89766;754;3460;6647;54065;150051;58494;80781;7327;10785;337879;10841;54033;3753;337972;6782;150084;643803;728299;9992;386672;5211;861;11096;2897;56894;54084;6285;3689;8209;1859;29104;337960;7485;386676;571;386680;7267;53347;7074;5152;10311;150082;3772;3275;54059;8208;9510;10317;5116;84221;29947;337959;4685;6612;337968;755;1291;351;875;10069;7032;100131902;522;53820;9980;337963;337967;353323;7031;3588;6526;10215;7109;140578;386674;386675;23076;6573;3763;2114;353332;3141;4600;337971;54058;8204;386677;89765;30811;337974;337977;5651;337969;388813;57466;140290;54069;2551;757;10600;90625;23562;23308;26285;10694;386678;337975;337880;100288287;54102;6651;8888;8867;94104;64092;25966;54020;337966;9619;386684;388818;337978;386682;254950;54097;56911;873;29761;284827;81543;7226,212
1,1,21,15499847,48090317,32590470,54148;4599;5316;337882;106865373;1409;54101;9875;1826;9073;386679;874;51227;10950;337970;101928147;386681;56245;54943;643812;326;5121;1476;9946;116448;1292;64699;11077;1827;3150;63977;10281;149998;337973;8566;26046;7307;7113;54014;116159;56683;150094;85395;59271;386685;23515;337878;8624;29980;386683;337979;8568;100288323;54149;6450;4731;6493;539;104;54093;5822;6453;4047;54039;337985;7033;353333;23181;3454;25825;23275;2618;337976;2078;3455;1525;140258;56246;64968;49854;89766;754;3460;6647;54065;150051;58494;80781;7327;10785;337879;10841;54033;3753;337972;6782;150084;643803;728299;9992;386672;5211;861;11096;2897;56894;54084;6285;3689;8209;1859;29104;337960;7485;386676;571;386680;7267;53347;7074;5152;10311;150082;3772;3275;54059;8208;9510;10317;5116;84221;29947;337959;4685;6612;337968;755;1291;351;875;10069;7032;100131902;522;53820;9980;337963;337967;353323;7031;3588;6526;10215;7109;140578;386674;386675;23076;6573;3763;2114;353332;3141;4600;337971;54058;8204;386677;89765;30811;337974;337977;5651;337969;388813;57466;140290;54069;2551;757;10600;90625;23562;23308;26285;10694;386678;337975;337880;100288287;54102;6651;8888;8867;94104;64092;25966;54020;337966;9619;386684;388818;337978;386682;254950;54097;56911;873;29761;284827;81543;7226,212
1,1,21,15499847,48090317,32590470,54148;4599;5316;337882;106865373;1409;54101;9875;1826;9073;386679;874;51227;10950;337970;101928147;386681;56245;54943;643812;326;5121;1476;9946;116448;1292;64699;11077;1827;3150;63977;10281;149998;337973;8566;26046;7307;7113;54014;116159;56683;150094;85395;59271;386685;23515;337878;8624;29980;386683;337979;8568;100288323;54149;6450;4731;6493;539;104;54093;5822;6453;4047;54039;337985;7033;353333;23181;3454;25825;23275;2618;337976;2078;3455;1525;140258;56246;64968;49854;89766;754;3460;6647;54065;150051;58494;80781;7327;10785;337879;10841;54033;3753;337972;6782;150084;643803;728299;9992;386672;5211;861;11096;2897;56894;54084;6285;3689;8209;1859;29104;337960;7485;386676;571;386680;7267;53347;7074;5152;10311;150082;3772;3275;54059;8208;9510;10317;5116;84221;29947;337959;4685;6612;337968;755;1291;351;875;10069;7032;100131902;522;53820;9980;337963;337967;353323;7031;3588;6526;10215;7109;140578;386674;386675;23076;6573;3763;2114;353332;3141;4600;337971;54058;8204;386677;89765;30811;337974;337977;5651;337969;388813;57466;140290;54069;2551;757;10600;90625;23562;23308;26285;10694;386678;337975;337880;100288287;54102;6651;8888;8867;94104;64092;25966;54020;337966;9619;386684;388818;337978;386682;254950;54097;56911;873;29761;284827;81543;7226,212
1,1,21,15499847,48090317,32590470,54148;4599;5316;337882;106865373;1409;54101;9875;1826;9073;386679;874;51227;10950;337970;101928147;386681;56245;54943;643812;326;5121;1476;9946;116448;1292;64699;11077;1827;3150;63977;10281;149998;337973;8566;26046;7307;7113;54014;116159;56683;150094;85395;59271;386685;23515;337878;8624;29980;386683;337979;8568;100288323;54149;6450;4731;6493;539;104;54093;5822;6453;4047;54039;337985;7033;353333;23181;3454;25825;23275;2618;337976;2078;3455;1525;140258;56246;64968;49854;89766;754;3460;6647;54065;150051;58494;80781;7327;10785;337879;10841;54033;3753;337972;6782;150084;643803;728299;9992;386672;5211;861;11096;2897;56894;54084;6285;3689;8209;1859;29104;337960;7485;386676;571;386680;7267;53347;7074;5152;10311;150082;3772;3275;54059;8208;9510;10317;5116;84221;29947;337959;4685;6612;337968;755;1291;351;875;10069;7032;100131902;522;53820;9980;337963;337967;353323;7031;3588;6526;10215;7109;140578;386674;386675;23076;6573;3763;2114;353332;3141;4600;337971;54058;8204;386677;89765;30811;337974;337977;5651;337969;388813;57466;140290;54069;2551;757;10600;90625;23562;23308;26285;10694;386678;337975;337880;100288287;54102;6651;8888;8867;94104;64092;25966;54020;337966;9619;386684;388818;337978;386682;254950;54097;56911;873;29761;284827;81543;7226,212
1,1,21,15499847,48090317,32590470,54148;4599;5316;337882;106865373;1409;54101;9875;1826;9073;386679;874;51227;10950;337970;101928147;386681;56245;54943;643812;326;5121;1476;9946;116448;1292;64699;11077;1827;3150;63977;10281;149998;337973;8566;26046;7307;7113;54014;116159;56683;150094;85395;59271;386685;23515;337878;8624;29980;386683;337979;8568;100288323;54149;6450;4731;6493;539;104;54093;5822;6453;4047;54039;337985;7033;353333;23181;3454;25825;23275;2618;337976;2078;3455;1525;140258;56246;64968;49854;89766;754;3460;6647;54065;150051;58494;80781;7327;10785;337879;10841;54033;3753;337972;6782;150084;643803;728299;9992;386672;5211;861;11096;2897;56894;54084;6285;3689;8209;1859;29104;337960;7485;386676;571;386680;7267;53347;7074;5152;10311;150082;3772;3275;54059;8208;9510;10317;5116;84221;29947;337959;4685;6612;337968;755;1291;351;875;10069;7032;100131902;522;53820;9980;337963;337967;353323;7031;3588;6526;10215;7109;140578;386674;386675;23076;6573;3763;2114;353332;3141;4600;337971;54058;8204;386677;89765;30811;337974;337977;5651;337969;388813;57466;140290;54069;2551;757;10600;90625;23562;23308;26285;10694;386678;337975;337880;100288287;54102;6651;8888;8867;94104;64092;25966;54020;337966;9619;386684;388818;337978;386682;254950;54097;56911;873;29761;284827;81543;7226,212
1,1,21,15499847,48090317,32590470,54148;4599;5316;337882;106865373;1409;54101;9875;1826;9073;386679;874;51227;10950;337970;101928147;386681;56245;54943;643812;326;5121;1476;9946;116448;1292;64699;11077;1827;3150;63977;10281;149998;337973;8566;26046;7307;7113;54014;116159;56683;150094;85395;59271;386685;23515;337878;8624;29980;386683;337979;8568;100288323;54149;6450;4731;6493;539;104;54093;5822;6453;4047;54039;337985;7033;353333;23181;3454;25825;23275;2618;337976;2078;3455;1525;140258;56246;64968;49854;89766;754;3460;6647;54065;150051;58494;80781;7327;10785;337879;10841;54033;3753;337972;6782;150084;643803;728299;9992;386672;5211;861;11096;2897;56894;54084;6285;3689;8209;1859;29104;337960;7485;386676;571;386680;7267;53347;7074;5152;10311;150082;3772;3275;54059;8208;9510;10317;5116;84221;29947;337959;4685;6612;337968;755;1291;351;875;10069;7032;100131902;522;53820;9980;337963;337967;353323;7031;3588;6526;10215;7109;140578;386674;386675;23076;6573;3763;2114;353332;3141;4600;337971;54058;8204;386677;89765;30811;337974;337977;5651;337969;388813;57466;140290;54069;2551;757;10600;90625;23562;23308;26285;10694;386678;337975;337880;100288287;54102;6651;8888;8867;94104;64092;25966;54020;337966;9619;386684;388818;337978;386682;254950;54097;56911;873;29761;284827;81543;7226,212
1,1,21,15499847,48090317,32590470,54148;4599;5316;337882;106865373;1409;54101;9875;1826;9073;386679;874;51227;10950;337970;101928147;386681;56245;54943;643812;326;5121;1476;9946;116448;1292;64699;11077;1827;3150;63977;10281;149998;337973;8566;26046;7307;7113;54014;116159;56683;150094;85395;59271;386685;23515;337878;8624;29980;386683;337979;8568;100288323;54149;6450;4731;6493;539;104;54093;5822;6453;4047;54039;337985;7033;353333;23181;3454;25825;23275;2618;337976;2078;3455;1525;140258;56246;64968;49854;89766;754;3460;6647;54065;150051;58494;80781;7327;10785;337879;10841;54033;3753;337972;6782;150084;643803;728299;9992;386672;5211;861;11096;2897;56894;54084;6285;3689;8209;1859;29104;337960;7485;386676;571;386680;7267;53347;7074;5152;10311;150082;3772;3275;54059;8208;9510;10317;5116;84221;29947;337959;4685;6612;337968;755;1291;351;875;10069;7032;100131902;522;53820;9980;337963;337967;353323;7031;3588;6526;10215;7109;140578;386674;386675;23076;6573;3763;2114;353332;3141;4600;337971;54058;8204;386677;89765;30811;337974;337977;5651;337969;388813;57466;140290;54069;2551;757;10600;90625;23562;23308;26285;10694;386678;337975;337880;100288287;54102;6651;8888;8867;94104;64092;25966;54020;337966;9619;386684;388818;337978;386682;254950;54097;56911;873;29761;284827;81543;7226,212
1,1,21,15499847,48090317,32590470,54148;4599;5316;337882;106865373;1409;54101;9875;1826;9073;386679;874;51227;10950;337970;101928147;386681;56245;54943;643812;326;5121;1476;9946;116448;1292;64699;11077;1827;3150;63977;10281;149998;337973;8566;26046;7307;7113;54014;116159;56683;150094;85395;59271;386685;23515;337878;8624;29980;386683;337979;8568;100288323;54149;6450;4731;6493;539;104;54093;5822;6453;4047;54039;337985;7033;353333;23181;3454;25825;23275;2618;337976;2078;3455;1525;140258;56246;64968;49854;89766;754;3460;6647;54065;150051;58494;80781;7327;10785;337879;10841;54033;3753;337972;6782;150084;643803;728299;9992;386672;5211;861;11096;2897;56894;54084;6285;3689;8209;1859;29104;337960;7485;386676;571;386680;7267;53347;7074;5152;10311;150082;3772;3275;54059;8208;9510;10317;5116;84221;29947;337959;4685;6612;337968;755;1291;351;875;10069;7032;100131902;522;53820;9980;337963;337967;353323;7031;3588;6526;10215;7109;140578;386674;386675;23076;6573;3763;2114;353332;3141;4600;337971;54058;8204;386677;89765;30811;337974;337977;5651;337969;388813;57466;140290;54069;2551;757;10600;90625;23562;23308;26285;10694;386678;337975;337880;100288287;54102;6651;8888;8867;94104;64092;25966;54020;337966;9619;386684;388818;337978;386682;254950;54097;56911;873;29761;284827;81543;7226,212
1,1,21,15499847,48090317,32590470,54148;4599;5316;337882;106865373;1409;54101;9875;1826;9073;386679;874;51227;10950;337970;101928147;386681;56245;54943;643812;326;5121;1476;9946;116448;1292;64699;11077;1827;3150;63977;10281;149998;337973;8566;26046;7307;7113;54014;116159;56683;150094;85395;59271;386685;23515;337878;8624;29980;386683;337979;8568;100288323;54149;6450;4731;6493;539;104;54093;5822;6453;4047;54039;337985;7033;353333;23181;3454;25825;23275;2618;337976;2078;3455;1525;140258;56246;64968;49854;89766;754;3460;6647;54065;150051;58494;80781;7327;10785;337879;10841;54033;3753;337972;6782;150084;643803;728299;9992;386672;5211;861;11096;2897;56894;54084;6285;3689;8209;1859;29104;337960;7485;386676;571;386680;7267;53347;7074;5152;10311;150082;3772;3275;54059;8208;9510;10317;5116;84221;29947;337959;4685;6612;337968;755;1291;351;875;10069;7032;100131902;522;53820;9980;337963;337967;353323;7031;3588;6526;10215;7109;140578;386674;386675;23076;6573;3763;2114;353332;3141;4600;337971;54058;8204;386677;89765;30811;337974;337977;5651;337969;388813;57466;140290;54069;2551;757;10600;90625;23562;23308;26285;10694;386678;337975;337880;100288287;54102;6651;8888;8867;94104;64092;25966;54020;337966;9619;386684;388818;337978;386682;254950;54097;56911;873;29761;284827;81543;7226,212
1,1,21,15499847,48090317,32590470,54148;4599;5316;337882;106865373;1409;54101;9875;1826;9073;386679;874;51227;10950;337970;101928147;386681;56245;54943;643812;326;5121;1476;9946;116448;1292;64699;11077;1827;3150;63977;10281;149998;337973;8566;26046;7307;7113;54014;116159;56683;150094;85395;59271;386685;23515;337878;8624;29980;386683;337979;8568;100288323;54149;6450;4731;6493;539;104;54093;5822;6453;4047;54039;337985;7033;353333;23181;3454;25825;23275;2618;337976;2078;3455;1525;140258;56246;64968;49854;89766;754;3460;6647;54065;150051;58494;80781;7327;10785;337879;10841;54033;3753;337972;6782;150084;643803;728299;9992;386672;5211;861;11096;2897;56894;54084;6285;3689;8209;1859;29104;337960;7485;386676;571;386680;7267;53347;7074;5152;10311;150082;3772;3275;54059;8208;9510;10317;5116;84221;29947;337959;4685;6612;337968;755;1291;351;875;10069;7032;100131902;522;53820;9980;337963;337967;353323;7031;3588;6526;10215;7109;140578;386674;386675;23076;6573;3763;2114;353332;3141;4600;337971;54058;8204;386677;89765;30811;337974;337977;5651;337969;388813;57466;140290;54069;2551;757;10600;90625;23562;23308;26285;10694;386678;337975;337880;100288287;54102;6651;8888;8867;94104;64092;25966;54020;337966;9619;386684;388818;337978;386682;254950;54097;56911;873;29761;284827;81543;7226,212
1,1,21,15499847,48090317,32590470,54148;4599;5316;337882;106865373;1409;54101;9875;1826;9073;386679;874;51227;10950;337970;101928147;386681;56245;54943;643812;326;5121;1476;9946;116448;1292;64699;11077;1827;3150;63977;10281;149998;337973;8566;26046;7307;7113;54014;116159;56683;150094;85395;59271;386685;23515;337878;8624;29980;386683;337979;8568;100288323;54149;6450;4731;6493;539;104;54093;5822;6453;4047;54039;337985;7033;353333;23181;3454;25825;23275;2618;337976;2078;3455;1525;140258;56246;64968;49854;89766;754;3460;6647;54065;150051;58494;80781;7327;10785;337879;10841;54033;3753;337972;6782;150084;643803;728299;9992;386672;5211;861;11096;2897;56894;54084;6285;3689;8209;1859;29104;337960;7485;386676;571;386680;7267;53347;7074;5152;10311;150082;3772;3275;54059;8208;9510;10317;5116;84221;29947;337959;4685;6612;337968;755;1291;351;875;10069;7032;100131902;522;53820;9980;337963;337967;353323;7031;3588;6526;10215;7109;140578;386674;386675;23076;6573;3763;2114;353332;3141;4600;337971;54058;8204;386677;89765;30811;337974;337977;5651;337969;388813;57466;140290;54069;2551;757;10600;90625;23562;23308;26285;10694;386678;337975;337880;100288287;54102;6651;8888;8867;94104;64092;25966;54020;337966;9619;386684;388818;337978;386682;254950;54097;56911;873;29761;284827;81543;7226,212
1,1,21,15499847,48090317,32590470,54148;4599;5316;337882;106865373;1409;54101;9875;1826;9073;386679;874;51227;10950;337970;101928147;386681;56245;54943;643812;326;5121;1476;9946;116448;1292;64699;11077;1827;3150;63977;10281;149998;337973;8566;26046;7307;7113;54014;116159;56683;150094;85395;59271;386685;23515;337878;8624;29980;386683;337979;8568;100288323;54149;6450;4731;6493;539;104;54093;5822;6453;4047;54039;337985;7033;353333;23181;3454;25825;23275;2618;337976;2078;3455;1525;140258;56246;64968;49854;89766;754;3460;6647;54065;150051;58494;80781;7327;10785;337879;10841;54033;3753;337972;6782;150084;643803;728299;9992;386672;5211;861;11096;2897;56894;54084;6285;3689;8209;1859;29104;337960;7485;386676;571;386680;7267;53347;7074;5152;10311;150082;3772;3275;54059;8208;9510;10317;5116;84221;29947;337959;4685;6612;337968;755;1291;351;875;10069;7032;100131902;522;53820;9980;337963;337967;353323;7031;3588;6526;10215;7109;140578;386674;386675;23076;6573;3763;2114;353332;3141;4600;337971;54058;8204;386677;89765;30811;337974;337977;5651;337969;388813;57466;140290;54069;2551;757;10600;90625;23562;23308;26285;10694;386678;337975;337880;100288287;54102;6651;8888;8867;94104;64092;25966;54020;337966;9619;386684;388818;337978;386682;254950;54097;56911;873;29761;284827;81543;7226,212
1,1,21,15499847,48090317,32590470,54148;4599;5316;337882;106865373;1409;54101;9875;1826;9073;386679;874;51227;10950;337970;101928147;386681;56245;54943;643812;326;5121;1476;9946;116448;1292;64699;11077;1827;3150;63977;10281;149998;337973;8566;26046;7307;7113;54014;116159;56683;150094;85395;59271;386685;23515;337878;8624;29980;386683;337979;8568;100288323;54149;6450;4731;6493;539;104;54093;5822;6453;4047;54039;337985;7033;353333;23181;3454;25825;23275;2618;337976;2078;3455;1525;140258;56246;64968;49854;89766;754;3460;6647;54065;150051;58494;80781;7327;10785;337879;10841;54033;3753;337972;6782;150084;643803;728299;9992;386672;5211;861;11096;2897;56894;54084;6285;3689;8209;1859;29104;337960;7485;386676;571;386680;7267;53347;7074;5152;10311;150082;3772;3275;54059;8208;9510;10317;5116;84221;29947;337959;4685;6612;337968;755;1291;351;875;10069;7032;100131902;522;53820;9980;337963;337967;353323;7031;3588;6526;10215;7109;140578;386674;386675;23076;6573;3763;2114;353332;3141;4600;337971;54058;8204;386677;89765;30811;337974;337977;5651;337969;388813;57466;140290;54069;2551;757;10600;90625;23562;23308;26285;10694;386678;337975;337880;100288287;54102;6651;8888;8867;94104;64092;25966;54020;337966;9619;386684;388818;337978;386682;254950;54097;56911;873;29761;284827;81543;7226,212
1,1,21,15499847,48090317,32590470,54148;4599;5316;337882;106865373;1409;54101;9875;1826;9073;386679;874;51227;10950;337970;101928147;386681;56245;54943;643812;326;5121;1476;9946;116448;1292;64699;11077;1827;3150;63977;10281;149998;337973;8566;26046;7307;7113;54014;116159;56683;150094;85395;59271;386685;23515;337878;8624;29980;386683;337979;8568;100288323;54149;6450;4731;6493;539;104;54093;5822;6453;4047;54039;337985;7033;353333;23181;3454;25825;23275;2618;337976;2078;3455;1525;140258;56246;64968;49854;89766;754;3460;6647;54065;150051;58494;80781;7327;10785;337879;10841;54033;3753;337972;6782;150084;643803;728299;9992;386672;5211;861;11096;2897;56894;54084;6285;3689;8209;1859;29104;337960;7485;386676;571;386680;7267;53347;7074;5152;10311;150082;3772;3275;54059;8208;9510;10317;5116;84221;29947;337959;4685;6612;337968;755;1291;351;875;10069;7032;100131902;522;53820;9980;337963;337967;353323;7031;3588;6526;10215;7109;140578;386674;386675;23076;6573;3763;2114;353332;3141;4600;337971;54058;8204;386677;89765;30811;337974;337977;5651;337969;388813;57466;140290;54069;2551;757;10600;90625;23562;23308;26285;10694;386678;337975;337880;100288287;54102;6651;8888;8867;94104;64092;25966;54020;337966;9619;386684;388818;337978;386682;254950;54097;56911;873;29761;284827;81543;7226,212
1,1,21,15499847,48090317,32590470,54148;4599;5316;337882;106865373;1409;54101;9875;1826;9073;386679;874;51227;10950;337970;101928147;386681;56245;54943;643812;326;5121;1476;9946;116448;1292;64699;11077;1827;3150;63977;10281;149998;337973;8566;26046;7307;7113;54014;116159;56683;150094;85395;59271;386685;23515;337878;8624;29980;386683;337979;8568;100288323;54149;6450;4731;6493;539;104;54093;5822;6453;4047;54039;337985;7033;353333;23181;3454;25825;23275;2618;337976;2078;3455;1525;140258;56246;64968;49854;89766;754;3460;6647;54065;150051;58494;80781;7327;10785;337879;10841;54033;3753;337972;6782;150084;643803;728299;9992;386672;5211;861;11096;2897;56894;54084;6285;3689;8209;1859;29104;337960;7485;386676;571;386680;7267;53347;7074;5152;10311;150082;3772;3275;54059;8208;9510;10317;5116;84221;29947;337959;4685;6612;337968;755;1291;351;875;10069;7032;100131902;522;53820;9980;337963;337967;353323;7031;3588;6526;10215;7109;140578;386674;386675;23076;6573;3763;2114;353332;3141;4600;337971;54058;8204;386677;89765;30811;337974;337977;5651;337969;388813;57466;140290;54069;2551;757;10600;90625;23562;23308;26285;10694;386678;337975;337880;100288287;54102;6651;8888;8867;94104;64092;25966;54020;337966;9619;386684;388818;337978;386682;254950;54097;56911;873;29761;284827;81543;7226,212
1,1,21,15499847,48090317,32590470,54148;4599;5316;337882;106865373;1409;54101;9875;1826;9073;386679;874;51227;10950;337970;101928147;386681;56245;54943;643812;326;5121;1476;9946;116448;1292;64699;11077;1827;3150;63977;10281;149998;337973;8566;26046;7307;7113;54014;116159;56683;150094;85395;59271;386685;23515;337878;8624;29980;386683;337979;8568;100288323;54149;6450;4731;6493;539;104;54093;5822;6453;4047;54039;337985;7033;353333;23181;3454;25825;23275;2618;337976;2078;3455;1525;140258;56246;64968;49854;89766;754;3460;6647;54065;150051;58494;80781;7327;10785;337879;10841;54033;3753;337972;6782;150084;643803;728299;9992;386672;5211;861;11096;2897;56894;54084;6285;3689;8209;1859;29104;337960;7485;386676;571;386680;7267;53347;7074;5152;10311;150082;3772;3275;54059;8208;9510;10317;5116;84221;29947;337959;4685;6612;337968;755;1291;351;875;10069;7032;100131902;522;53820;9980;337963;337967;353323;7031;3588;6526;10215;7109;140578;386674;386675;23076;6573;3763;2114;353332;3141;4600;337971;54058;8204;386677;89765;30811;337974;337977;5651;337969;388813;57466;140290;54069;2551;757;10600;90625;23562;23308;26285;10694;386678;337975;337880;100288287;54102;6651;8888;8867;94104;64092;25966;54020;337966;9619;386684;388818;337978;386682;254950;54097;56911;873;29761;284827;81543;7226,212
1,1,21,15499847,48090317,32590470,54148;4599;5316;337882;106865373;1409;54101;9875;1826;9073;386679;874;51227;10950;337970;101928147;386681;56245;54943;643812;326;5121;1476;9946;116448;1292;64699;11077;1827;3150;63977;10281;149998;337973;8566;26046;7307;7113;54014;116159;56683;150094;85395;59271;386685;23515;337878;8624;29980;386683;337979;8568;100288323;54149;6450;4731;6493;539;104;54093;5822;6453;4047;54039;337985;7033;353333;23181;3454;25825;23275;2618;337976;2078;3455;1525;140258;56246;64968;49854;89766;754;3460;6647;54065;150051;58494;80781;7327;10785;337879;10841;54033;3753;337972;6782;150084;643803;728299;9992;386672;5211;861;11096;2897;56894;54084;6285;3689;8209;1859;29104;337960;7485;386676;571;386680;7267;53347;7074;5152;10311;150082;3772;3275;54059;8208;9510;10317;5116;84221;29947;337959;4685;6612;337968;755;1291;351;875;10069;7032;100131902;522;53820;9980;337963;337967;353323;7031;3588;6526;10215;7109;140578;386674;386675;23076;6573;3763;2114;353332;3141;4600;337971;54058;8204;386677;89765;30811;337974;337977;5651;337969;388813;57466;140290;54069;2551;757;10600;90625;23562;23308;26285;10694;386678;337975;337880;100288287;54102;6651;8888;8867;94104;64092;25966;54020;337966;9619;386684;388818;337978;386682;254950;54097;56911;873;29761;284827;81543;7226,212
1,1,21,15499847,48090317,32590470,54148;4599;5316;337882;106865373;1409;54101;9875;1826;9073;386679;874;51227;10950;337970;101928147;386681;56245;54943;643812;326;5121;1476;9946;116448;1292;64699;11077;1827;3150;63977;10281;149998;337973;8566;26046;7307;7113;54014;116159;56683;150094;85395;59271;386685;23515;337878;8624;29980;386683;337979;8568;100288323;54149;6450;4731;6493;539;104;54093;5822;6453;4047;54039;337985;7033;353333;23181;3454;25825;23275;2618;337976;2078;3455;1525;140258;56246;64968;49854;89766;754;3460;6647;54065;150051;58494;80781;7327;10785;337879;10841;54033;3753;337972;6782;150084;643803;728299;9992;386672;5211;861;11096;2897;56894;54084;6285;3689;8209;1859;29104;337960;7485;386676;571;386680;7267;53347;7074;5152;10311;150082;3772;3275;54059;8208;9510;10317;5116;84221;29947;337959;4685;6612;337968;755;1291;351;875;10069;7032;100131902;522;53820;9980;337963;337967;353323;7031;3588;6526;10215;7109;140578;386674;386675;23076;6573;3763;2114;353332;3141;4600;337971;54058;8204;386677;89765;30811;337974;337977;5651;337969;388813;57466;140290;54069;2551;757;10600;90625;23562;23308;26285;10694;386678;337975;337880;100288287;54102;6651;8888;8867;94104;64092;25966;54020;337966;9619;386684;388818;337978;386682;254950;54097;56911;873;29761;284827;81543;7226,212
1,1,21,15499847,48090317,32590470,54148;4599;5316;337882;106865373;1409;54101;9875;1826;9073;386679;874;51227;10950;337970;101928147;386681;56245;54943;643812;326;5121;1476;9946;116448;1292;64699;11077;1827;3150;63977;10281;149998;337973;8566;26046;7307;7113;54014;116159;56683;150094;85395;59271;386685;23515;337878;8624;29980;386683;337979;8568;100288323;54149;6450;4731;6493;539;104;54093;5822;6453;4047;54039;337985;7033;353333;23181;3454;25825;23275;2618;337976;2078;3455;1525;140258;56246;64968;49854;89766;754;3460;6647;54065;150051;58494;80781;7327;10785;337879;10841;54033;3753;337972;6782;150084;643803;728299;9992;386672;5211;861;11096;2897;56894;54084;6285;3689;8209;1859;29104;337960;7485;386676;571;386680;7267;53347;7074;5152;10311;150082;3772;3275;54059;8208;9510;10317;5116;84221;29947;337959;4685;6612;337968;755;1291;351;875;10069;7032;100131902;522;53820;9980;337963;337967;353323;7031;3588;6526;10215;7109;140578;386674;386675;23076;6573;3763;2114;353332;3141;4600;337971;54058;8204;386677;89765;30811;337974;337977;5651;337969;388813;57466;140290;54069;2551;757;10600;90625;23562;23308;26285;10694;386678;337975;337880;100288287;54102;6651;8888;8867;94104;64092;25966;54020;337966;9619;386684;388818;337978;386682;254950;54097;56911;873;29761;284827;81543;7226,212
1,1,21,15499847,48090317,32590470,54148;4599;5316;337882;106865373;1409;54101;9875;1826;9073;386679;874;51227;10950;337970;101928147;386681;56245;54943;643812;326;5121;1476;9946;116448;1292;64699;11077;1827;3150;63977;10281;149998;337973;8566;26046;7307;7113;54014;116159;56683;150094;85395;59271;386685;23515;337878;8624;29980;386683;337979;8568;100288323;54149;6450;4731;6493;539;104;54093;5822;6453;4047;54039;337985;7033;353333;23181;3454;25825;23275;2618;337976;2078;3455;1525;140258;56246;64968;49854;89766;754;3460;6647;54065;150051;58494;80781;7327;10785;337879;10841;54033;3753;337972;6782;150084;643803;728299;9992;386672;5211;861;11096;2897;56894;54084;6285;3689;8209;1859;29104;337960;7485;386676;571;386680;7267;53347;7074;5152;10311;150082;3772;3275;54059;8208;9510;10317;5116;84221;29947;337959;4685;6612;337968;755;1291;351;875;10069;7032;100131902;522;53820;9980;337963;337967;353323;7031;3588;6526;10215;7109;140578;386674;386675;23076;6573;3763;2114;353332;3141;4600;337971;54058;8204;386677;89765;30811;337974;337977;5651;337969;388813;57466;140290;54069;2551;757;10600;90625;23562;23308;26285;10694;386678;337975;337880;100288287;54102;6651;8888;8867;94104;64092;25966;54020;337966;9619;386684;388818;337978;386682;254950;54097;56911;873;29761;284827;81543;7226,212
1,1,21,15499847,48090317,32590470,54148;4599;5316;337882;106865373;1409;54101;9875;1826;9073;386679;874;51227;10950;337970;101928147;386681;56245;54943;643812;326;5121;1476;9946;116448;1292;64699;11077;1827;3150;63977;10281;149998;337973;8566;26046;7307;7113;54014;116159;56683;150094;85395;59271;386685;23515;337878;8624;29980;386683;337979;8568;100288323;54149;6450;4731;6493;539;104;54093;5822;6453;4047;54039;337985;7033;353333;23181;3454;25825;23275;2618;337976;2078;3455;1525;140258;56246;64968;49854;89766;754;3460;6647;54065;150051;58494;80781;7327;10785;337879;10841;54033;3753;337972;6782;150084;643803;728299;9992;386672;5211;861;11096;2897;56894;54084;6285;3689;8209;1859;29104;337960;7485;386676;571;386680;7267;53347;7074;5152;10311;150082;3772;3275;54059;8208;9510;10317;5116;84221;29947;337959;4685;6612;337968;755;1291;351;875;10069;7032;100131902;522;53820;9980;337963;337967;353323;7031;3588;6526;10215;7109;140578;386674;386675;23076;6573;3763;2114;353332;3141;4600;337971;54058;8204;386677;89765;30811;337974;337977;5651;337969;388813;57466;140290;54069;2551;757;10600;90625;23562;23308;26285;10694;386678;337975;337880;100288287;54102;6651;8888;8867;94104;64092;25966;54020;337966;9619;386684;388818;337978;386682;254950;54097;56911;873;29761;284827;81543;7226,212
1,1,21,15499847,48090317,32590470,54148;4599;5316;337882;106865373;1409;54101;9875;1826;9073;386679;874;51227;10950;337970;101928147;386681;56245;54943;643812;326;5121;1476;9946;116448;1292;64699;11077;1827;3150;63977;10281;149998;337973;8566;26046;7307;7113;54014;116159;56683;150094;85395;59271;386685;23515;337878;8624;29980;386683;337979;8568;100288323;54149;6450;4731;6493;539;104;54093;5822;6453;4047;54039;337985;7033;353333;23181;3454;25825;23275;2618;337976;2078;3455;1525;140258;56246;64968;49854;89766;754;3460;6647;54065;150051;58494;80781;7327;10785;337879;10841;54033;3753;337972;6782;150084;643803;728299;9992;386672;5211;861;11096;2897;56894;54084;6285;3689;8209;1859;29104;337960;7485;386676;571;386680;7267;53347;7074;5152;10311;150082;3772;3275;54059;8208;9510;10317;5116;84221;29947;337959;4685;6612;337968;755;1291;351;875;10069;7032;100131902;522;53820;9980;337963;337967;353323;7031;3588;6526;10215;7109;140578;386674;386675;23076;6573;3763;2114;353332;3141;4600;337971;54058;8204;386677;89765;30811;337974;337977;5651;337969;388813;57466;140290;54069;2551;757;10600;90625;23562;23308;26285;10694;386678;337975;337880;100288287;54102;6651;8888;8867;94104;64092;25966;54020;337966;9619;386684;388818;337978;386682;254950;54097;56911;873;29761;284827;81543;7226,212
1,1,21,15499847,48090317,32590470,54148;4599;5316;337882;106865373;1409;54101;9875;1826;9073;386679;874;51227;10950;337970;101928147;386681;56245;54943;643812;326;5121;1476;9946;116448;1292;64699;11077;1827;3150;63977;10281;149998;337973;8566;26046;7307;7113;54014;116159;56683;150094;85395;59271;386685;23515;337878;8624;29980;386683;337979;8568;100288323;54149;6450;4731;6493;539;104;54093;5822;6453;4047;54039;337985;7033;353333;23181;3454;25825;23275;2618;337976;2078;3455;1525;140258;56246;64968;49854;89766;754;3460;6647;54065;150051;58494;80781;7327;10785;337879;10841;54033;3753;337972;6782;150084;643803;728299;9992;386672;5211;861;11096;2897;56894;54084;6285;3689;8209;1859;29104;337960;7485;386676;571;386680;7267;53347;7074;5152;10311;150082;3772;3275;54059;8208;9510;10317;5116;84221;29947;337959;4685;6612;337968;755;1291;351;875;10069;7032;100131902;522;53820;9980;337963;337967;353323;7031;3588;6526;10215;7109;140578;386674;386675;23076;6573;3763;2114;353332;3141;4600;337971;54058;8204;386677;89765;30811;337974;337977;5651;337969;388813;57466;140290;54069;2551;757;10600;90625;23562;23308;26285;10694;386678;337975;337880;100288287;54102;6651;8888;8867;94104;64092;25966;54020;337966;9619;386684;388818;337978;386682;254950;54097;56911;873;29761;284827;81543;7226,212
1,1,21,15499847,48090317,32590470,54148;4599;5316;337882;106865373;1409;54101;9875;1826;9073;386679;874;51227;10950;337970;101928147;386681;56245;54943;643812;326;5121;1476;9946;116448;1292;64699;11077;1827;3150;63977;10281;149998;337973;8566;26046;7307;7113;54014;116159;56683;150094;85395;59271;386685;23515;337878;8624;29980;386683;337979;8568;100288323;54149;6450;4731;6493;539;104;54093;5822;6453;4047;54039;337985;7033;353333;23181;3454;25825;23275;2618;337976;2078;3455;1525;140258;56246;64968;49854;89766;754;3460;6647;54065;150051;58494;80781;7327;10785;337879;10841;54033;3753;337972;6782;150084;643803;728299;9992;386672;5211;861;11096;2897;56894;54084;6285;3689;8209;1859;29104;337960;7485;386676;571;386680;7267;53347;7074;5152;10311;150082;3772;3275;54059;8208;9510;10317;5116;84221;29947;337959;4685;6612;337968;755;1291;351;875;10069;7032;100131902;522;53820;9980;337963;337967;353323;7031;3588;6526;10215;7109;140578;386674;386675;23076;6573;3763;2114;353332;3141;4600;337971;54058;8204;386677;89765;30811;337974;337977;5651;337969;388813;57466;140290;54069;2551;757;10600;90625;23562;23308;26285;10694;386678;337975;337880;100288287;54102;6651;8888;8867;94104;64092;25966;54020;337966;9619;386684;388818;337978;386682;254950;54097;56911;873;29761;284827;81543;7226,212
1,1,21,15513244,48090352,32577108,54148;4599;5316;337882;106865373;1409;54101;9875;1826;9073;386679;874;51227;10950;337970;101928147;386681;56245;54943;643812;326;5121;1476;9946;116448;1292;64699;11077;1827;3150;63977;10281;149998;337973;8566;26046;7307;7113;54014;116159;56683;150094;85395;59271;386685;23515;337878;8624;29980;386683;337979;8568;100288323;54149;6450;4731;6493;539;104;54093;5822;6453;4047;54039;337985;7033;353333;23181;3454;25825;23275;2618;337976;2078;3455;1525;140258;56246;64968;49854;89766;754;3460;6647;54065;150051;58494;80781;7327;10785;337879;10841;54033;3753;337972;6782;150084;643803;728299;9992;386672;5211;861;11096;2897;56894;54084;6285;3689;8209;1859;29104;337960;7485;386676;571;386680;7267;53347;7074;5152;10311;150082;3772;3275;54059;8208;9510;10317;5116;84221;29947;337959;4685;6612;337968;755;1291;351;875;10069;7032;100131902;522;53820;9980;337963;337967;353323;7031;3588;6526;10215;7109;140578;386674;386675;23076;6573;3763;2114;353332;3141;4600;337971;54058;8204;386677;89765;30811;337974;337977;5651;337969;388813;57466;140290;54069;2551;757;10600;90625;23562;23308;26285;10694;386678;337975;337880;100288287;54102;6651;8888;8867;94104;64092;25966;54020;337966;9619;386684;388818;337978;386682;254950;54097;56911;873;29761;284827;81543;7226,212
1,1,21,15530370,48119895,32589525,54148;4599;5316;337882;106865373;1409;54101;9875;1826;9073;386679;874;51227;10950;337970;101928147;386681;56245;54943;643812;326;5121;1476;9946;116448;1292;64699;11077;1827;3150;63977;10281;149998;337973;8566;26046;7307;7113;54014;116159;56683;150094;85395;59271;386685;23515;337878;8624;29980;386683;337979;8568;100288323;54149;6450;4731;6493;539;104;54093;5822;6453;4047;54039;337985;7033;353333;23181;3454;25825;23275;2618;337976;2078;3455;1525;140258;56246;64968;49854;89766;754;3460;6647;54065;150051;58494;80781;7327;10785;337879;10841;54033;3753;337972;6782;150084;643803;728299;9992;386672;5211;861;11096;2897;56894;54084;6285;3689;8209;1859;29104;337960;7485;386676;571;386680;7267;53347;7074;5152;10311;150082;3772;3275;54059;8208;9510;10317;5116;84221;29947;337959;4685;6612;337968;755;1291;351;875;10069;7032;100131902;522;53820;9980;337963;337967;353323;7031;3588;6526;10215;7109;140578;386674;386675;23076;6573;3763;2114;353332;3141;4600;337971;54058;8204;386677;89765;30811;337974;337977;5651;337969;388813;57466;140290;54069;2551;757;10600;90625;23562;23308;26285;10694;386678;337975;337880;100288287;54102;6651;8888;8867;94104;64092;25966;54020;337966;9619;386684;388818;337978;386682;254950;54097;56911;873;29761;284827;81543;7226,212
1,1,21,15530429,48119895,32589466,54148;4599;5316;337882;106865373;1409;54101;9875;1826;9073;386679;874;51227;10950;337970;101928147;386681;56245;54943;643812;326;5121;1476;9946;116448;1292;64699;11077;1827;3150;63977;10281;149998;337973;8566;26046;7307;7113;54014;116159;56683;150094;85395;59271;386685;23515;337878;8624;29980;386683;337979;8568;100288323;54149;6450;4731;6493;539;104;54093;5822;6453;4047;54039;337985;7033;353333;23181;3454;25825;23275;2618;337976;2078;3455;1525;140258;56246;64968;49854;89766;754;3460;6647;54065;150051;58494;80781;7327;10785;337879;10841;54033;3753;337972;6782;150084;643803;728299;9992;386672;5211;861;11096;2897;56894;54084;6285;3689;8209;1859;29104;337960;7485;386676;571;386680;7267;53347;7074;5152;10311;150082;3772;3275;54059;8208;9510;10317;5116;84221;29947;337959;4685;6612;337968;755;1291;351;875;10069;7032;100131902;522;53820;9980;337963;337967;353323;7031;3588;6526;10215;7109;140578;386674;386675;23076;6573;3763;2114;353332;3141;4600;337971;54058;8204;386677;89765;30811;337974;337977;5651;337969;388813;57466;140290;54069;2551;757;10600;90625;23562;23308;26285;10694;386678;337975;337880;100288287;54102;6651;8888;8867;94104;64092;25966;54020;337966;9619;386684;388818;337978;386682;254950;54097;56911;873;29761;284827;81543;7226,212
-1,1,21,16714035,24198636,7484601,5651;140578;10950;54149;4685;29761;1525,7
1,-1,21,19412023,19602127,190104,140578,1
-1,1,21,20795486,33213462,12417976,337979;54148;100288323;11096;2897;337882;9073;29104;337960;337971;337985;571;337970;337974;337977;643812;337969;57466;337976;2551;10600;7074;140258;26285;10694;337975;337880;100288287;9510;6647;150051;58494;337959;337966;4685;388818;337968;337978;337973;254950;337879;56911;26046;351;284827;10069;116159;100131902;522;337972;337963;337967;643803;337878;728299,55
-1,-1,21,23727134,23833530,106396,,0
-1,-1,21,23727134,23991316,264182,,0
-1,-1,21,23782183,23927167,144984,,0
-1,-1,21,24526599,24622562,95963,,0
-1,-1,21,24526599,24622562,95963,,0
-1,-1,21,24526599,24622562,95963,,0
-1,1,21,25303376,25851449,548073,,0
1,1,21,29812033,39282854,9470821,9992;861;337882;2897;1859;9875;9073;337960;874;29104;51227;571;337970;101928147;56245;54943;643812;7267;7074;10311;9946;8208;116448;337959;1827;337968;337973;26046;10069;56683;100131902;53820;9980;59271;337963;337967;23515;337878;29980;3588;6526;10215;337979;100288323;6493;3763;539;54093;3141;6453;337971;337985;30811;3454;337974;337977;337969;57466;2618;337976;140290;757;54069;10600;3455;64968;140258;56246;23562;26285;10694;337975;337880;100288287;54102;3460;6651;6647;8867;54065;94104;150051;337966;388818;337978;337879;254950;56911;873;284827;3753;337972;643803;728299,94
-1,1,21,29880468,36062331,6181863,9992;337882;2897;9875;9073;337960;29104;571;337970;101928147;56245;54943;643812;7074;9946;116448;337959;1827;337968;337973;26046;10069;56683;100131902;59271;337963;337967;337878;29980;3588;6526;10215;337979;100288323;539;6453;337971;337985;30811;3454;337974;337977;337969;57466;2618;337976;140290;757;54069;10600;3455;64968;140258;56246;26285;10694;337975;337880;100288287;54102;3460;6651;6647;8867;54065;94104;150051;337966;388818;337978;337879;254950;56911;284827;3753;337972;643803;728299,78
1,-1,21,33037771,33038082,311,6647,1
1,1,21,34111831,48090258,13978427,4599;5316;106865373;1409;54101;1826;386679;874;51227;101928147;386681;56245;54943;326;5121;1476;9946;116448;1292;64699;11077;1827;3150;63977;10281;8566;7307;7113;54014;150094;85395;386685;23515;8624;29980;386683;8568;4731;6450;6493;539;104;54093;5822;6453;4047;54039;7033;353333;23181;3454;25825;23275;2618;2078;3455;64968;49854;754;89766;3460;54065;80781;7327;10785;10841;3753;150084;9992;386672;5211;861;54084;56894;6285;3689;8209;1859;7485;386676;386680;7267;53347;5152;10311;150082;3772;3275;54059;8208;10317;5116;84221;29947;6612;755;1291;875;7032;53820;9980;353323;7031;3588;6526;10215;7109;386674;386675;23076;6573;3763;2114;353332;3141;4600;54058;386677;89765;757;90625;23562;23308;386678;54102;6651;8888;94104;25966;54020;386684;9619;386682;54097;873;81543;7226,137
1,1,21,34997018,36118212,1121194,9992;6526;9946;54102;101928147;3753;54065;539;1827;6453;64968,11
1,1,21,35319225,48090972,12771747,9992;386672;5211;4599;5316;861;106865373;54084;56894;6285;3689;8209;1409;54101;1859;1826;386679;874;7485;386676;51227;386680;101928147;386681;7267;326;53347;5121;5152;10311;1476;150082;3772;3275;54059;8208;10317;1292;5116;84221;29947;64699;11077;1827;6612;3150;63977;10281;755;8566;1291;7307;7113;875;54014;7032;150094;53820;85395;9980;386685;23515;353323;8624;7031;6526;7109;386674;386683;386675;8568;4731;6450;23076;6493;6573;3763;2114;104;54093;353332;3141;5822;4047;4600;54039;54058;7033;386677;89765;353333;23181;25825;23275;2078;64968;49854;90625;754;89766;23562;23308;386678;54102;8888;54065;25966;54020;80781;386684;7327;9619;10785;386682;54097;10841;873;3753;81543;7226;150084,121
1,1,21,35319225,48090972,12771747,9992;386672;5211;4599;5316;861;106865373;54084;56894;6285;3689;8209;1409;54101;1859;1826;386679;874;7485;386676;51227;386680;101928147;386681;7267;326;53347;5121;5152;10311;1476;150082;3772;3275;54059;8208;10317;1292;5116;84221;29947;64699;11077;1827;6612;3150;63977;10281;755;8566;1291;7307;7113;875;54014;7032;150094;53820;85395;9980;386685;23515;353323;8624;7031;6526;7109;386674;386683;386675;8568;4731;6450;23076;6493;6573;3763;2114;104;54093;353332;3141;5822;4047;4600;54039;54058;7033;386677;89765;353333;23181;25825;23275;2078;64968;49854;90625;754;89766;23562;23308;386678;54102;8888;54065;25966;54020;80781;386684;7327;9619;10785;386682;54097;10841;873;3753;81543;7226;150084,121
-1,1,21,36162250,48056450,11894200,386672;5211;4599;861;5316;106865373;54084;56894;6285;3689;8209;1409;54101;1859;1826;386679;874;7485;386676;51227;386680;386681;7267;326;53347;5121;5152;10311;1476;150082;3772;3275;54059;8208;10317;1292;5116;84221;29947;64699;11077;6612;3150;63977;10281;755;8566;1291;7307;7113;875;54014;7032;150094;53820;85395;9980;386685;23515;353323;8624;7031;7109;386674;386675;386683;8568;4731;6450;23076;6493;6573;3763;2114;104;54093;353332;3141;5822;4047;4600;54039;54058;7033;386677;89765;353333;23181;25825;23275;2078;90625;49854;23562;754;89766;23308;386678;8888;25966;54020;80781;386684;7327;9619;10785;386682;54097;10841;873;81543;7226;150084,113
-1,1,21,36916169,41365265,4449096,8624;23562;10311;150082;3772;6450;8208;6493;106865373;3763;10317;2114;1859;54093;3141;3150;874;7485;10281;23515;51227;873;54014;7267;53820;9980;150084;2078;5121,29
-1,1,21,37144475,39930433,2785958,23562;10311;3772;8208;6493;3763;1859;54093;3141;874;10281;23515;51227;873;7267;53820;9980;2078,18
-1,1,21,37144475,39930433,2785958,23562;10311;3772;8208;6493;3763;1859;54093;3141;874;10281;23515;51227;873;7267;53820;9980;2078,18
1,1,21,37439289,48090972,10651683,386672;5211;4599;5316;54084;106865373;56894;6285;3689;8209;1409;54101;1859;1826;386679;874;7485;386676;51227;386680;386681;7267;326;53347;5121;5152;10311;1476;150082;3772;3275;54059;8208;10317;1292;5116;84221;29947;64699;11077;6612;3150;63977;10281;755;8566;1291;7307;7113;875;54014;7032;150094;53820;85395;9980;386685;23515;353323;8624;7031;7109;386674;386675;386683;8568;4731;6450;23076;6493;6573;3763;2114;104;353332;3141;5822;4047;4600;54039;54058;7033;386677;89765;353333;23181;25825;23275;2078;90625;49854;23562;754;89766;23308;386678;8888;25966;54020;80781;386684;7327;9619;10785;386682;54097;10841;873;81543;7226;150084,111
1,-1,21,37498151,37600266,102115,9980;874,2
1,-1,21,37498151,37600266,102115,9980;874,2
1,-1,21,37507345,37578365,71020,9980;874,2
1,1,21,37578365,48090317,10511952,386672;5211;4599;5316;54084;106865373;56894;6285;3689;8209;1409;54101;1859;1826;386679;7485;386676;51227;386680;386681;7267;326;53347;5121;5152;10311;1476;150082;3772;3275;54059;8208;10317;1292;5116;84221;29947;64699;11077;6612;3150;63977;10281;755;8566;1291;7307;7113;875;54014;7032;150094;53820;9980;85395;386685;23515;353323;8624;7031;7109;386674;386675;386683;8568;4731;6450;23076;6493;6573;3763;2114;104;353332;3141;5822;4047;4600;54039;54058;7033;386677;89765;353333;23181;25825;23275;2078;90625;49854;23562;754;89766;23308;386678;8888;25966;54020;80781;386684;7327;9619;10785;386682;54097;10841;81543;7226;150084,109
1,1,21,37891471,48090317,10198846,386672;5211;4599;5316;54084;106865373;56894;6285;3689;8209;1409;54101;1859;1826;386679;7485;386676;51227;386680;386681;7267;326;53347;5121;5152;10311;1476;150082;3772;3275;54059;10317;1292;5116;84221;29947;64699;11077;6612;3150;63977;10281;755;8566;1291;7307;7113;875;54014;7032;150094;53820;85395;386685;353323;8624;7031;7109;386674;386675;386683;8568;4731;6450;23076;6493;6573;3763;2114;104;353332;3141;5822;4047;4600;54039;54058;7033;386677;89765;353333;23181;25825;23275;2078;90625;23562;49854;754;89766;23308;386678;8888;25966;54020;80781;386684;7327;9619;10785;386682;54097;10841;81543;7226;150084,106
-1,1,21,37914123,48097372,10183249,386672;5211;4599;5316;54084;106865373;56894;6285;3689;8209;1409;54101;1859;1826;386679;7485;386676;51227;386680;386681;7267;326;53347;5121;5152;10311;1476;150082;3772;3275;54059;10317;1292;5116;84221;29947;64699;11077;6612;3150;63977;10281;755;8566;1291;7307;7113;875;54014;7032;150094;53820;85395;386685;353323;8624;7031;7109;386674;386675;386683;8568;4731;6450;23076;6493;6573;3763;2114;104;353332;3141;5822;4047;4600;54039;54058;7033;386677;89765;353333;23181;25825;23275;2078;90625;23562;49854;754;89766;23308;386678;8888;25966;54020;80781;386684;7327;9619;10785;386682;54097;10841;81543;7226;150084,106
-1,1,21,38176362,41901945,3725583,8624;10311;150082;3772;6450;106865373;3763;10317;2114;1859;3141;1826;3150;10281;7485;51227;54014;7267;53820;150084;2078;5121,22
-1,1,21,38699545,48097372,9397827,386672;5211;4599;5316;54084;106865373;56894;6285;3689;8209;1409;54101;1859;1826;386679;7485;386676;386680;386681;326;53347;5121;5152;1476;150082;3772;3275;54059;10317;1292;5116;84221;29947;64699;11077;6612;3150;63977;10281;755;8566;1291;7307;7113;875;54014;7032;150094;85395;386685;353323;8624;7031;7109;386674;386675;386683;8568;4731;6450;23076;6573;3763;2114;104;353332;5822;4047;4600;54039;54058;7033;386677;89765;353333;23181;25825;23275;2078;90625;49854;23308;754;89766;386678;8888;25966;54020;80781;386684;7327;9619;10785;386682;54097;10841;81543;7226;150084,99
-1,1,21,38790552,43619940,4829388,8624;49854;150082;3772;89766;4599;6450;106865373;3763;10317;2114;1859;54101;25966;9619;1826;4600;3150;63977;10281;7485;54097;7113;54014;25825;150084;2078;5121,28
-1,1,21,39041930,48090972,9049042,386672;5211;4599;5316;54084;106865373;56894;6285;3689;8209;1409;54101;1826;386679;7485;386676;386680;386681;326;53347;5121;5152;1476;150082;3772;3275;54059;10317;1292;5116;84221;29947;64699;11077;6612;3150;63977;10281;755;8566;1291;7307;7113;875;54014;7032;150094;85395;386685;353323;8624;7031;7109;386674;386675;386683;8568;4731;6450;23076;6573;3763;2114;104;353332;5822;4047;4600;54039;54058;7033;386677;89765;353333;23181;25825;23275;2078;90625;49854;23308;754;89766;386678;8888;25966;54020;80781;386684;7327;9619;10785;386682;54097;10841;81543;7226;150084,98
-1,1,21,40188323,48097372,7909049,386672;5211;4599;5316;54084;106865373;56894;6285;3689;8209;1409;54101;1826;386679;7485;386676;386680;386681;326;53347;5121;5152;1476;150082;3275;54059;10317;1292;5116;84221;29947;64699;11077;6612;63977;3150;755;8566;1291;7307;7113;875;54014;7032;150094;85395;386685;353323;8624;7031;7109;386674;386675;386683;8568;4731;6450;23076;6573;2114;104;353332;5822;4047;4600;54039;54058;7033;386677;89765;353333;23181;25825;23275;90625;49854;23308;754;89766;386678;8888;25966;54020;80781;386684;7327;9619;10785;386682;54097;10841;81543;7226;150084,94
-1,1,21,40747863,45666031,4918168,7031;7109;8568;4599;4731;6450;5316;23076;106865373;56894;8209;1409;54101;1826;4600;5822;7485;7033;89765;25825;53347;5121;49854;5152;150082;89766;90625;1476;23308;10317;25966;64699;54020;9619;11077;63977;10785;54097;8566;7307;7113;875;7032;150094;150084,45
-1,1,21,41254101,48097372,6843271,386672;5211;4599;5316;54084;56894;6285;3689;8209;1409;54101;1826;386679;386676;386680;386681;326;53347;5121;5152;1476;3275;54059;1292;5116;84221;29947;64699;11077;6612;63977;755;8566;1291;7307;7113;875;7032;150094;85395;386685;353323;7031;7109;386674;386675;386683;8568;4731;23076;6573;104;353332;5822;4047;4600;54039;54058;7033;386677;89765;353333;23181;25825;23275;90625;49854;23308;754;89766;386678;8888;25966;54020;80781;386684;7327;9619;10785;386682;54097;10841;81543;7226,84
-1,1,21,41628166,48119895,6491729,386672;5211;4599;5316;54084;56894;6285;3689;8209;1409;54101;1826;386679;386676;386680;386681;326;53347;5152;1476;3275;54059;1292;5116;84221;29947;64699;11077;6612;63977;755;8566;1291;7307;7113;875;7032;150094;85395;386685;353323;7031;7109;386674;386675;386683;8568;4731;23076;6573;104;353332;5822;4047;4600;54039;54058;7033;386677;89765;353333;23181;25825;23275;90625;49854;23308;754;89766;386678;8888;25966;54020;80781;386684;7327;9619;10785;386682;54097;10841;81543;7226,83
-1,1,21,41667952,48090352,6422400,386672;5211;4599;5316;54084;56894;6285;3689;8209;1409;54101;1826;386679;386676;386680;386681;326;53347;5152;1476;3275;54059;1292;5116;84221;29947;64699;11077;6612;63977;755;8566;1291;7307;7113;875;7032;150094;85395;386685;353323;7031;7109;386674;386675;386683;8568;4731;23076;6573;104;353332;5822;4047;4600;54039;54058;7033;386677;89765;353333;23181;25825;23275;90625;49854;23308;754;89766;386678;8888;25966;54020;80781;386684;7327;9619;10785;386682;54097;10841;81543;7226,83
-1,1,21,42410406,48097372,5686966,386672;5211;4599;5316;54084;56894;6285;3689;8209;1409;54101;386679;386676;386680;386681;326;53347;5152;1476;3275;54059;1292;5116;84221;29947;64699;11077;6612;63977;755;8566;1291;7307;7113;875;7032;150094;85395;386685;353323;7031;7109;386674;386675;386683;8568;4731;23076;6573;104;353332;5822;4047;4600;54039;54058;7033;386677;89765;353333;23181;25825;23275;90625;49854;23308;754;89766;386678;8888;25966;54020;80781;386684;7327;9619;10785;386682;54097;10841;81543;7226,82
-1,1,21,43153800,48090972,4937172,386672;5211;5316;54084;56894;6285;3689;8209;1409;54101;386679;386676;386680;386681;326;53347;5152;1476;3275;54059;1292;5116;84221;29947;64699;11077;6612;63977;755;8566;1291;7307;875;7032;150094;85395;386685;353323;7031;7109;386674;386675;386683;8568;4731;23076;6573;104;353332;5822;4047;54039;54058;7033;386677;89765;353333;23181;23275;90625;49854;23308;754;89766;386678;8888;25966;54020;80781;386684;7327;9619;10785;386682;10841;81543;7226,77
-1,1,21,43268694,48097372,4828678,386672;5211;5316;54084;56894;6285;3689;8209;1409;386679;386676;386680;386681;326;53347;5152;1476;3275;54059;1292;5116;84221;29947;64699;11077;6612;63977;755;8566;1291;7307;875;7032;150094;85395;386685;353323;7031;7109;386674;386675;386683;8568;4731;23076;6573;104;353332;5822;4047;54039;54058;7033;386677;89765;353333;23181;23275;90625;49854;23308;386678;89766;754;8888;54020;25966;386684;9619;7327;80781;10785;386682;10841;81543;7226,76
1,1,21,43407305,48119895,4712590,386672;5211;5316;54084;56894;6285;3689;8209;1409;386679;386676;386680;386681;326;53347;5152;1476;3275;54059;1292;5116;84221;29947;64699;11077;6612;755;8566;1291;7307;875;7032;150094;85395;386685;353323;7031;7109;386674;386675;386683;8568;4731;23076;6573;104;353332;5822;4047;54039;54058;7033;386677;89765;353333;23181;23275;90625;49854;23308;386678;89766;754;8888;54020;386684;9619;7327;80781;10785;386682;10841;81543;7226,74
-1,1,21,43498966,48097372,4598406,386672;5211;5316;54084;56894;6285;3689;8209;1409;386679;386676;386680;386681;326;53347;5152;1476;3275;54059;1292;5116;84221;29947;64699;11077;6612;755;8566;1291;7307;875;7032;150094;85395;386685;353323;7031;7109;386674;386675;386683;8568;4731;23076;6573;104;353332;5822;4047;54039;54058;7033;386677;89765;353333;23181;23275;90625;23308;386678;754;89766;8888;54020;386684;9619;7327;80781;10785;386682;10841;81543;7226,73
-1,1,21,43549809,48090972,4541163,386672;5211;5316;54084;56894;6285;3689;8209;1409;386679;386676;386680;386681;326;53347;5152;1476;3275;54059;1292;5116;84221;29947;64699;11077;6612;755;8566;1291;7307;875;7032;150094;85395;386685;353323;7031;7109;386674;386675;386683;8568;4731;23076;6573;104;353332;5822;4047;54039;54058;7033;386677;89765;353333;23181;23275;90625;23308;386678;754;89766;8888;54020;386684;9619;7327;80781;10785;386682;10841;81543;7226,73
-1,1,21,43598607,48097372,4498765,386672;5211;5316;54084;56894;6285;3689;8209;1409;386679;386676;386680;386681;326;53347;5152;1476;3275;54059;1292;5116;84221;29947;64699;11077;6612;755;8566;1291;7307;875;7032;150094;85395;386685;353323;7031;7109;386674;386675;386683;8568;4731;23076;6573;104;353332;5822;4047;54039;54058;7033;386677;89765;353333;23181;23275;90625;23308;386678;754;8888;54020;386684;9619;7327;80781;10785;386682;10841;81543;7226,72
-1,1,21,44333323,48090317,3756994,7109;386674;386675;386683;386672;8568;5211;5316;23076;56894;54084;6573;6285;3689;8209;1409;104;353332;5822;4047;386679;54039;54058;386676;386677;386680;353333;23181;386681;23275;326;23308;90625;386678;1476;754;3275;54059;8888;1292;5116;84221;29947;11077;386684;7327;6612;80781;755;386682;8566;10841;1291;7307;875;81543;7226;150094;85395;386685;353323,61
-1,1,21,44333323,48090317,3756994,7109;386674;386675;386683;386672;8568;5211;5316;23076;56894;54084;6573;6285;3689;8209;1409;104;353332;5822;4047;386679;54039;54058;386676;386677;386680;353333;23181;386681;23275;326;23308;90625;386678;1476;754;3275;54059;8888;1292;5116;84221;29947;11077;386684;7327;6612;80781;755;386682;8566;10841;1291;7307;875;81543;7226;150094;85395;386685;353323,61
-1,1,21,44491278,48090317,3599039,7109;386674;386675;386683;386672;8568;5211;23076;56894;54084;6573;6285;3689;8209;1409;104;353332;5822;4047;386679;54039;54058;386676;386677;386680;353333;23181;386681;23275;326;23308;386678;1476;754;3275;54059;8888;1292;5116;84221;29947;11077;386684;7327;6612;80781;755;386682;8566;10841;1291;7307;875;81543;7226;150094;85395;386685;353323,59
-1,1,21,44491278,48090317,3599039,7109;386674;386675;386683;386672;8568;5211;23076;56894;54084;6573;6285;3689;8209;1409;104;353332;5822;4047;386679;54039;54058;386676;386677;386680;353333;23181;386681;23275;326;23308;386678;1476;754;3275;54059;8888;1292;5116;84221;29947;11077;386684;7327;6612;80781;755;386682;8566;10841;1291;7307;875;81543;7226;150094;85395;386685;353323,59
1,-1,21,44592471,44662664,70193,1409,1
-1,1,21,44828064,48097372,3269308,7109;386674;386675;386683;386672;8568;5211;23076;56894;54084;6573;6285;3689;8209;104;353332;5822;4047;386679;54039;54058;386676;386677;386680;353333;23181;386681;23275;326;23308;386678;1476;754;3275;54059;8888;1292;5116;84221;29947;11077;386684;7327;6612;80781;755;386682;8566;10841;1291;81543;7226;150094;85395;386685;353323,56
-1,1,21,45265857,47057233,1791376,7109;386674;386675;386683;386672;5211;54084;56894;6573;3689;8209;104;353332;5822;386679;386676;386677;386680;353333;386681;23275;326;23308;386678;754;29947;386684;80781;7327;6612;755;386682;81543;7226;85395;386685;353323,37
-1,1,21,45773272,48097372,2324100,386674;386675;386683;386672;54084;6573;6285;3689;104;353332;4047;386679;54039;54058;386676;386677;386680;353333;23181;386681;23275;386678;754;3275;54059;8888;1292;5116;84221;386684;80781;7327;6612;386682;10841;1291;81543;7226;85395;386685;353323,41
-1,1,21,45814926,48090317,2275391,386674;386675;386683;386672;54084;6573;6285;3689;104;353332;4047;386679;54039;54058;386676;386677;386680;353333;23181;386681;23275;386678;754;3275;54059;8888;1292;5116;84221;386684;80781;7327;6612;386682;10841;1291;81543;7226;85395;386685;353323,41
-1,1,21,46798076,48090960,1292884,54039;54058;3275;10841;1291;54059;6573;6285;23181;8888;1292;5116;84221;80781;4047,15
1,-1,21,47987100,48022981,35881,23181;6285,2
-1,1,22,44166,11675280,11631114,,0
1,-1,22,16054691,17450189,1395498,23784;150165;81061;150160;128954,5
1,1,22,16054691,18661724,2607033,27440;51816;51807;23765;150160;27439;27443;55670;637;529;23784;11274;150165;23786;81061;83733;128954;101929372;57553,19
1,1,22,16054691,51220902,35166211,23481;200315;150383;3005;24144;129049;7533;91582;100423062;4733;2130;400916;7078;80831;55670;64976;6942;79174;6576;3985;83733;415116;6634;11144;29775;8218;23753;23542;158;57168;550631;23598;8542;84271;7621;83933;79924;91689;27351;5297;440822;2928;129080;140883;440829;150350;51512;1890;23654;25817;8318;57026;91289;728229;113828;5155;5905;26150;171568;4320;27440;85358;4627;23543;3957;80274;23764;51493;9681;150223;653689;4282;150368;11274;1120;440836;23539;5465;80830;23762;150372;9929;25793;50;27350;25829;63929;2781;162;253143;79087;84861;7353;51807;8398;638;8508;51733;11015;9993;85376;440804;4151;5816;5880;91319;7332;85379;284898;150274;9342;65078;80833;150275;1417;1312;6545;468;129025;23151;129138;83999;8459;8484;10766;1727;150379;56993;1375;1415;164668;105372977;5413;80764;22880;7441;102800317;7380;66035;150209;2547;128977;128989;113791;79734;150221;91179;3560;53947;83606;8664;23264;27254;56241;5008;10042;5988;57553;27037;4330;23466;2847;27341;51386;706;1454;5600;652968;254240;284904;7263;27127;26088;60489;84645;150356;645426;9889;414918;79680;23760;10454;9620;150165;81061;64781;9609;644186;11020;10634;23779;23209;400891;84700;9582;388849;51586;9127;23765;83874;348645;9814;55615;57591;135;6598;23551;10291;23786;25777;10126;1413;23616;613;391322;23541;114904;4357;91227;402055;6948;51537;115650;2033;55267;25813;25776;23784;27352;2687;10478;4668;164592;730005;200312;83642;6767;5594;646851;9978;23617;25807;3543;164684;6527;3976;2952;7122;1565;8563;4744;84844;4809;84247;6305;54584;2678;25830;6523;1652;9402;26286;23523;7008;6525;140606;79159;400935;23492;2192;6753;8897;10587;80832;1439;7290;54471;6721;150280;49;2812;150248;23759;9647;758;5625;55954;85377;10521;4700;23331;3053;150290;164656;4689;255349;8224;80020;1399;4174;29796;3956;253190;64098;3761;11200;55020;266747;7494;10738;85352;85359;164633;10369;10633;9215;55586;80115;23761;5902;11252;23544;9145;27128;85378;79879;51816;23780;8214;421;25771;79019;10739;23774;80305;4242;11158;157;150160;27439;7625;23119;529;29802;23464;79640;91464;55007;50487;55964;553158;23467;84164;114794;6300;11135;9463;83746;10343;10043;8940;23313;11078;23384;29781;27124;1414;388886;5372;101929372;89781;25775;54487;64800;410;4248;29801;9567;9701;56666;91445;23532;150297;6663;29799;91355;140564;6899;27156;25809;8911;27443;637;3162;9997;25770;100037417;150365;200316;267020;112885;339665;339669;29780;266629;23170;150353;7477;25814;80339;10762;8220;27349;56478;55687;25828;4771;84133;6122;8216;51233;113730;9514;128954;23112;5435;54456,427
1,1,22,16054691,51220902,35166211,23481;200315;150383;3005;24144;129049;7533;91582;100423062;4733;2130;400916;7078;80831;55670;64976;6942;79174;6576;3985;83733;415116;6634;11144;29775;8218;23753;23542;158;57168;550631;23598;8542;84271;7621;83933;79924;91689;27351;5297;440822;2928;129080;140883;440829;150350;51512;1890;23654;25817;8318;57026;91289;728229;113828;5155;5905;26150;171568;4320;27440;85358;4627;23543;3957;80274;23764;51493;9681;150223;653689;4282;150368;11274;1120;440836;23539;5465;80830;23762;150372;9929;25793;50;27350;25829;63929;2781;162;253143;79087;84861;7353;51807;8398;638;8508;51733;11015;9993;85376;440804;4151;5816;5880;91319;7332;85379;284898;150274;9342;65078;80833;150275;1417;1312;6545;468;129025;23151;129138;83999;8459;8484;10766;1727;150379;56993;1375;1415;164668;105372977;5413;80764;22880;7441;102800317;7380;66035;150209;2547;128977;128989;113791;79734;150221;91179;3560;53947;83606;8664;23264;27254;56241;5008;10042;5988;57553;27037;4330;23466;2847;27341;51386;706;1454;5600;652968;254240;284904;7263;27127;26088;60489;84645;150356;645426;9889;414918;79680;23760;10454;9620;150165;81061;64781;9609;644186;11020;10634;23779;23209;400891;84700;9582;388849;51586;9127;23765;83874;348645;9814;55615;57591;135;6598;23551;10291;23786;25777;10126;1413;23616;613;391322;23541;114904;4357;91227;402055;6948;51537;115650;2033;55267;25813;25776;23784;27352;2687;10478;4668;164592;730005;200312;83642;6767;5594;646851;9978;23617;25807;3543;164684;6527;3976;2952;7122;1565;8563;4744;84844;4809;84247;6305;54584;2678;25830;6523;1652;9402;26286;23523;7008;6525;140606;79159;400935;23492;2192;6753;8897;10587;80832;1439;7290;54471;6721;150280;49;2812;150248;23759;9647;758;5625;55954;85377;10521;4700;23331;3053;150290;164656;4689;255349;8224;80020;1399;4174;29796;3956;253190;64098;3761;11200;55020;266747;7494;10738;85352;85359;164633;10369;10633;9215;55586;80115;23761;5902;11252;23544;9145;27128;85378;79879;51816;23780;8214;421;25771;79019;10739;23774;80305;4242;11158;157;150160;27439;7625;23119;529;29802;23464;79640;91464;55007;50487;55964;553158;23467;84164;114794;6300;11135;9463;83746;10343;10043;8940;23313;11078;23384;29781;27124;1414;388886;5372;101929372;89781;25775;54487;64800;410;4248;29801;9567;9701;56666;91445;23532;150297;6663;29799;91355;140564;6899;27156;25809;8911;27443;637;3162;9997;25770;100037417;150365;200316;267020;112885;339665;339669;29780;266629;23170;150353;7477;25814;80339;10762;8220;27349;56478;55687;25828;4771;84133;6122;8216;51233;113730;9514;128954;23112;5435;54456,427
1,1,22,16054691,51237463,35182772,23481;200315;150383;3005;24144;129049;7533;91582;100423062;4733;2130;400916;7078;80831;55670;64976;6942;79174;6576;3985;83733;415116;6634;11144;29775;8218;23753;23542;158;57168;550631;23598;8542;84271;7621;83933;79924;91689;27351;5297;440822;2928;129080;140883;440829;150350;51512;1890;23654;25817;8318;57026;91289;728229;113828;5155;5905;26150;171568;4320;27440;85358;4627;23543;3957;80274;23764;51493;9681;150223;653689;4282;150368;11274;1120;440836;23539;5465;80830;23762;150372;9929;25793;50;27350;25829;63929;2781;162;253143;79087;84861;7353;51807;8398;638;8508;51733;11015;9993;85376;440804;4151;5816;5880;91319;7332;85379;284898;150274;9342;65078;80833;150275;1417;1312;6545;468;129025;23151;129138;83999;8459;8484;10766;1727;150379;56993;1375;1415;164668;105372977;5413;80764;22880;7441;102800317;7380;66035;150209;2547;128977;128989;113791;79734;150221;91179;3560;53947;83606;8664;23264;27254;56241;5008;10042;5988;57553;27037;4330;23466;2847;27341;51386;706;1454;5600;652968;254240;284904;7263;27127;26088;60489;84645;150356;645426;9889;414918;79680;23760;10454;9620;150165;81061;64781;9609;644186;11020;10634;23779;23209;400891;84700;9582;388849;51586;9127;23765;83874;348645;9814;55615;57591;135;6598;23551;10291;23786;25777;10126;1413;23616;613;391322;23541;114904;4357;91227;402055;6948;51537;115650;2033;55267;25813;25776;23784;27352;2687;10478;4668;164592;730005;200312;83642;6767;5594;646851;9978;23617;25807;3543;164684;6527;3976;2952;7122;1565;8563;4744;84844;4809;84247;6305;54584;2678;25830;6523;1652;9402;26286;23523;7008;6525;140606;79159;400935;23492;2192;6753;8897;10587;80832;1439;7290;54471;6721;150280;49;2812;150248;23759;9647;758;5625;55954;85377;10521;4700;23331;3053;150290;164656;4689;255349;8224;80020;1399;4174;29796;3956;253190;64098;3761;11200;55020;266747;7494;10738;85352;85359;164633;10369;10633;9215;55586;80115;23761;5902;11252;23544;9145;27128;85378;79879;51816;23780;8214;421;25771;79019;10739;23774;80305;4242;11158;157;150160;27439;7625;23119;529;29802;23464;79640;91464;55007;50487;55964;553158;23467;84164;114794;6300;11135;9463;83746;10343;10043;8940;23313;11078;23384;29781;27124;1414;388886;5372;101929372;89781;25775;54487;64800;410;4248;29801;9567;9701;56666;91445;23532;150297;6663;29799;91355;140564;6899;27156;25809;8911;27443;637;3162;9997;25770;100037417;150365;200316;267020;112885;339665;339669;29780;266629;23170;150353;7477;25814;80339;10762;8220;27349;56478;55687;25828;4771;84133;6122;8216;51233;113730;9514;128954;23112;5435;54456,427
1,-1,22,16087694,16417038,329344,23784,1
-1,-1,22,16087694,16431732,344038,23784,1
-1,-1,22,16087694,16431732,344038,23784,1
-1,-1,22,16087694,16431732,344038,23784,1
-1,-1,22,16087694,16431732,344038,23784,1
-1,-1,22,16087694,16431732,344038,23784,1
-1,-1,22,16087694,16431732,344038,23784,1
-1,-1,22,16087694,16431732,344038,23784,1
-1,-1,22,16087694,16431732,344038,23784,1
-1,-1,22,16087694,16431732,344038,23784,1
-1,-1,22,16087694,16431732,344038,23784,1
-1,-1,22,16087694,16431732,344038,23784,1
-1,-1,22,16087694,16431732,344038,23784,1
-1,-1,22,16087694,16431732,344038,23784,1
-1,-1,22,16087694,16431732,344038,23784,1
-1,-1,22,16087694,16431732,344038,23784,1
-1,-1,22,16087694,16431732,344038,23784,1
-1,-1,22,16087694,16431732,344038,23784,1
-1,-1,22,16087694,16431732,344038,23784,1
1,-1,22,16087694,16849852,762158,81061;23784,2
1,1,22,16087694,18641706,2554012,27440;51816;51807;23765;150160;27439;27443;55670;637;529;23784;11274;150165;23786;81061;83733;128954;101929372;57553,19
1,1,22,16087694,19010508,2922814,27440;51816;8214;51807;23765;150160;5625;27439;27443;55670;637;529;23784;11274;150165;23786;81061;83733;128954;101929372;57553,21
1,1,22,16087694,20311784,4224090,54487;27037;27440;29801;65078;10587;1312;51816;8214;7290;421;2812;6899;150160;5625;27439;27443;55670;637;64976;79680;529;23784;11274;150165;6576;81061;83733;8218;5413;23617;7122;8220;128977;388849;7353;2928;51807;128989;23765;9993;54584;85359;8318;23786;128954;101929372;57553;5902,49
1,1,22,16087694,20311784,4224090,54487;27037;27440;29801;65078;10587;1312;51816;8214;7290;421;2812;6899;150160;5625;27439;27443;55670;637;64976;79680;529;23784;11274;150165;6576;81061;83733;8218;5413;23617;7122;8220;128977;388849;7353;2928;51807;128989;23765;9993;54584;85359;8318;23786;128954;101929372;57553;5902,49
1,1,22,16087694,20311784,4224090,54487;27037;27440;29801;65078;10587;1312;51816;8214;7290;421;2812;6899;150160;5625;27439;27443;55670;637;64976;79680;529;23784;11274;150165;6576;81061;83733;8218;5413;23617;7122;8220;128977;388849;7353;2928;51807;128989;23765;9993;54584;85359;8318;23786;128954;101929372;57553;5902,49
1,1,22,16087694,20311784,4224090,54487;27037;27440;29801;65078;10587;1312;51816;8214;7290;421;2812;6899;150160;5625;27439;27443;55670;637;64976;79680;529;23784;11274;150165;6576;81061;83733;8218;5413;23617;7122;8220;128977;388849;7353;2928;51807;128989;23765;9993;54584;85359;8318;23786;128954;101929372;57553;5902,49
1,-1,22,16431732,17267283,835551,81061;150160;150165,3
1,1,22,16466033,18890162,2424129,27440;51816;51807;23765;150160;27439;27443;55670;637;529;11274;150165;23786;83733;128954;101929372;57553,17
1,1,22,16888899,18644773,1755874,27440;51816;51807;23765;150160;27439;27443;55670;637;529;11274;150165;23786;83733;128954;101929372;57553,17
1,1,22,16888899,18648856,1759957,27440;51816;51807;23765;150160;27439;27443;55670;637;529;11274;150165;23786;83733;128954;101929372;57553,17
1,1,22,16888899,18649190,1760291,27440;51816;51807;23765;150160;27439;27443;55670;637;529;11274;150165;23786;83733;128954;101929372;57553,17
1,1,22,16888899,18916828,2027929,27440;51816;8214;51807;23765;150160;5625;27439;27443;55670;637;529;11274;150165;23786;83733;128954;101929372;57553,19
1,1,22,16888899,18916828,2027929,27440;51816;8214;51807;23765;150160;5625;27439;27443;55670;637;529;11274;150165;23786;83733;128954;101929372;57553,19
-1,1,22,16888899,20000830,3111931,27440;10587;1312;51816;8214;7290;421;2812;6899;150160;5625;27439;27443;55670;637;64976;79680;529;11274;6576;150165;83733;8218;5413;23617;7122;8220;128977;7353;2928;51807;23765;9993;54584;8318;23786;128954;101929372;57553,39
1,1,22,16888899,20311858,3422959,54487;27037;27440;29801;65078;10587;1312;51816;8214;7290;421;2812;6899;150160;5625;27439;27443;55670;637;64976;79680;529;11274;6576;150165;83733;8218;5413;23617;7122;8220;128977;388849;7353;2928;51807;128989;23765;9993;54584;85359;8318;23786;128954;101929372;57553;5902,47
1,1,22,16888899,20311858,3422959,54487;27037;27440;29801;65078;10587;1312;51816;8214;7290;421;2812;6899;150160;5625;27439;27443;55670;637;64976;79680;529;11274;6576;150165;83733;8218;5413;23617;7122;8220;128977;388849;7353;2928;51807;128989;23765;9993;54584;85359;8318;23786;128954;101929372;57553;5902,47
-1,1,22,16888899,20716903,3828004,54487;27037;27440;29801;65078;10587;1312;51816;8214;7290;421;2812;6899;150160;5625;27439;27443;55670;637;64976;79680;529;11274;6576;150165;83733;8218;5413;23617;7122;8220;128977;388849;7353;2928;51807;128989;23765;9993;54584;85376;85359;8318;23786;728229;128954;101929372;57553;5902,49
1,1,22,16888899,23723805,6834906,7332;9342;65078;100423062;1312;613;51816;6545;8214;421;129025;91227;150160;7625;55670;27439;23119;64976;529;6576;83733;164592;8218;23753;5413;80764;5594;23617;7441;7122;150209;8940;128977;5297;2928;128989;140883;150221;54584;91179;8318;728229;101929372;57553;54487;27037;27440;29801;10587;7290;2812;23532;645426;29799;23759;150223;9647;6899;27156;5625;27443;79680;637;11274;150165;9609;3053;2781;1399;400891;8220;388849;84861;51586;7353;9127;51807;23765;9993;8216;85376;440804;85359;23786;128954;5902,86
1,1,22,16888900,18640300,1751400,27440;51816;51807;23765;150160;27439;27443;55670;637;529;11274;150165;23786;83733;128954;101929372;57553,17
-1,1,22,16888900,20026751,3137851,27440;10587;1312;51816;8214;7290;421;2812;6899;150160;5625;27439;27443;55670;637;64976;79680;529;11274;6576;150165;83733;8218;5413;23617;7122;8220;128977;7353;2928;51807;128989;23765;9993;54584;8318;23786;128954;101929372;57553,40
1,1,22,16888900,51197838,34308938,23481;200315;150383;3005;24144;129049;7533;91582;100423062;4733;2130;400916;7078;80831;55670;64976;6942;79174;6576;3985;83733;415116;6634;11144;29775;8218;23753;23542;158;57168;550631;23598;8542;84271;7621;83933;79924;91689;27351;5297;440822;2928;129080;140883;440829;150350;51512;1890;23654;25817;8318;57026;91289;728229;113828;5155;5905;26150;171568;4320;27440;85358;4627;23543;3957;80274;23764;51493;9681;150223;653689;4282;150368;11274;1120;440836;23539;5465;80830;23762;150372;9929;25793;50;27350;25829;63929;2781;162;253143;79087;84861;7353;51807;8398;638;8508;51733;11015;9993;85376;440804;4151;5816;5880;91319;7332;85379;284898;150274;9342;65078;80833;150275;1417;1312;6545;468;129025;23151;129138;83999;8459;8484;10766;1727;150379;56993;1375;1415;164668;105372977;5413;80764;22880;7441;102800317;7380;66035;150209;2547;128977;128989;113791;79734;150221;91179;3560;53947;83606;8664;23264;27254;56241;5008;10042;5988;57553;27037;4330;23466;2847;27341;51386;706;1454;5600;652968;254240;284904;7263;27127;26088;60489;84645;150356;645426;9889;414918;79680;23760;10454;9620;150165;64781;9609;644186;11020;10634;23779;23209;400891;84700;9582;388849;51586;9127;23765;83874;348645;9814;55615;57591;135;6598;23551;10291;23786;25777;10126;1413;23616;613;391322;23541;114904;4357;91227;402055;6948;51537;115650;2033;55267;25813;25776;27352;2687;10478;4668;164592;730005;200312;83642;6767;5594;646851;9978;23617;25807;3543;164684;6527;3976;2952;7122;1565;8563;4744;84844;4809;84247;6305;54584;2678;25830;6523;1652;9402;26286;23523;7008;6525;140606;79159;400935;23492;2192;6753;8897;10587;80832;1439;7290;54471;6721;150280;49;2812;150248;23759;9647;758;5625;55954;85377;10521;4700;23331;3053;150290;164656;4689;255349;8224;80020;1399;4174;29796;3956;253190;64098;3761;11200;55020;266747;7494;10738;85352;85359;164633;10369;10633;9215;55586;80115;23761;5902;11252;23544;9145;27128;85378;79879;51816;23780;8214;421;25771;79019;10739;23774;80305;4242;157;150160;27439;7625;23119;529;29802;23464;79640;91464;55007;50487;55964;553158;23467;84164;114794;6300;11135;9463;83746;10343;10043;8940;23313;11078;23384;29781;27124;1414;388886;5372;101929372;89781;25775;54487;64800;410;4248;29801;9567;9701;56666;91445;23532;150297;6663;29799;91355;140564;6899;27156;25809;8911;27443;637;3162;9997;25770;100037417;150365;200316;267020;112885;339665;339669;29780;266629;23170;150353;7477;25814;80339;10762;8220;27349;56478;55687;25828;4771;84133;6122;8216;51233;113730;9514;128954;23112;5435;54456,424
1,1,22,16888900,51197838,34308938,23481;200315;150383;3005;24144;129049;7533;91582;100423062;4733;2130;400916;7078;80831;55670;64976;6942;79174;6576;3985;83733;415116;6634;11144;29775;8218;23753;23542;158;57168;550631;23598;8542;84271;7621;83933;79924;91689;27351;5297;440822;2928;129080;140883;440829;150350;51512;1890;23654;25817;8318;57026;91289;728229;113828;5155;5905;26150;171568;4320;27440;85358;4627;23543;3957;80274;23764;51493;9681;150223;653689;4282;150368;11274;1120;440836;23539;5465;80830;23762;150372;9929;25793;50;27350;25829;63929;2781;162;253143;79087;84861;7353;51807;8398;638;8508;51733;11015;9993;85376;440804;4151;5816;5880;91319;7332;85379;284898;150274;9342;65078;80833;150275;1417;1312;6545;468;129025;23151;129138;83999;8459;8484;10766;1727;150379;56993;1375;1415;164668;105372977;5413;80764;22880;7441;102800317;7380;66035;150209;2547;128977;128989;113791;79734;150221;91179;3560;53947;83606;8664;23264;27254;56241;5008;10042;5988;57553;27037;4330;23466;2847;27341;51386;706;1454;5600;652968;254240;284904;7263;27127;26088;60489;84645;150356;645426;9889;414918;79680;23760;10454;9620;150165;64781;9609;644186;11020;10634;23779;23209;400891;84700;9582;388849;51586;9127;23765;83874;348645;9814;55615;57591;135;6598;23551;10291;23786;25777;10126;1413;23616;613;391322;23541;114904;4357;91227;402055;6948;51537;115650;2033;55267;25813;25776;27352;2687;10478;4668;164592;730005;200312;83642;6767;5594;646851;9978;23617;25807;3543;164684;6527;3976;2952;7122;1565;8563;4744;84844;4809;84247;6305;54584;2678;25830;6523;1652;9402;26286;23523;7008;6525;140606;79159;400935;23492;2192;6753;8897;10587;80832;1439;7290;54471;6721;150280;49;2812;150248;23759;9647;758;5625;55954;85377;10521;4700;23331;3053;150290;164656;4689;255349;8224;80020;1399;4174;29796;3956;253190;64098;3761;11200;55020;266747;7494;10738;85352;85359;164633;10369;10633;9215;55586;80115;23761;5902;11252;23544;9145;27128;85378;79879;51816;23780;8214;421;25771;79019;10739;23774;80305;4242;157;150160;27439;7625;23119;529;29802;23464;79640;91464;55007;50487;55964;553158;23467;84164;114794;6300;11135;9463;83746;10343;10043;8940;23313;11078;23384;29781;27124;1414;388886;5372;101929372;89781;25775;54487;64800;410;4248;29801;9567;9701;56666;91445;23532;150297;6663;29799;91355;140564;6899;27156;25809;8911;27443;637;3162;9997;25770;100037417;150365;200316;267020;112885;339665;339669;29780;266629;23170;150353;7477;25814;80339;10762;8220;27349;56478;55687;25828;4771;84133;6122;8216;51233;113730;9514;128954;23112;5435;54456,424
-1,1,22,17177911,19892632,2714721,27440;10587;51816;8214;7290;2812;6899;5625;27439;27443;55670;637;64976;79680;529;11274;6576;150165;83733;8218;5413;23617;7122;8220;128977;7353;2928;51807;23765;9993;54584;8318;23786;128954;101929372;57553,36
1,-1,22,17267393,17290275,22882,150165,1
1,-1,22,17267393,17290275,22882,150165,1
1,-1,22,17267393,17290275,22882,150165,1
1,-1,22,17267393,17290275,22882,150165,1
1,-1,22,17267393,17290275,22882,150165,1
1,1,22,17397498,18661773,1264275,51807;23765;27440;27439;27443;55670;637;529;11274;51816;23786;83733;128954;101929372;57553,15
1,1,22,17397498,18661773,1264275,51807;23765;27440;27439;27443;55670;637;529;11274;51816;23786;83733;128954;101929372;57553,15
1,1,22,17397498,18661773,1264275,51807;23765;27440;27439;27443;55670;637;529;11274;51816;23786;83733;128954;101929372;57553,15
1,1,22,17397498,18984519,1587021,27440;51816;8214;51807;23765;5625;27439;27443;55670;637;529;11274;23786;83733;128954;101929372;57553,17
1,1,22,17397498,20659606,3262108,54487;27037;27440;29801;65078;10587;1312;51816;8214;7290;421;2812;6899;5625;27439;27443;55670;637;64976;79680;529;11274;6576;83733;8218;5413;23617;7122;8220;128977;388849;7353;2928;51807;128989;23765;9993;54584;85376;85359;8318;23786;728229;128954;101929372;57553;5902,47
1,1,22,17397498,20659606,3262108,54487;27037;27440;29801;65078;10587;1312;51816;8214;7290;421;2812;6899;5625;27439;27443;55670;637;64976;79680;529;11274;6576;83733;8218;5413;23617;7122;8220;128977;388849;7353;2928;51807;128989;23765;9993;54584;85376;85359;8318;23786;728229;128954;101929372;57553;5902,47
1,1,22,17397498,20708934,3311436,54487;27037;27440;29801;65078;10587;1312;51816;8214;7290;421;2812;6899;5625;27439;27443;55670;637;64976;79680;529;11274;6576;83733;8218;5413;23617;7122;8220;128977;388849;7353;2928;51807;128989;23765;9993;54584;85376;85359;8318;23786;728229;128954;101929372;57553;5902,47
-1,1,22,17397498,20708934,3311436,54487;27037;27440;29801;65078;10587;1312;51816;8214;7290;421;2812;6899;5625;27439;27443;55670;637;64976;79680;529;11274;6576;83733;8218;5413;23617;7122;8220;128977;388849;7353;2928;51807;128989;23765;9993;54584;85376;85359;8318;23786;728229;128954;101929372;57553;5902,47
1,1,22,17397498,51178264,33780766,23481;200315;150383;3005;24144;129049;7533;91582;100423062;4733;2130;400916;7078;80831;55670;64976;6942;79174;6576;3985;83733;415116;6634;11144;29775;8218;23753;23542;158;57168;550631;23598;8542;84271;7621;83933;79924;91689;27351;5297;440822;2928;129080;140883;440829;150350;51512;1890;23654;25817;8318;57026;91289;728229;113828;5155;5905;26150;171568;4320;27440;85358;4627;23543;3957;80274;23764;51493;9681;150223;653689;4282;150368;11274;1120;440836;23539;5465;80830;23762;150372;9929;25793;50;27350;25829;63929;2781;162;253143;79087;84861;7353;51807;8398;638;8508;51733;11015;9993;85376;440804;4151;5816;5880;91319;7332;85379;284898;150274;9342;65078;80833;150275;1417;1312;6545;468;129025;23151;129138;83999;8459;8484;10766;1727;150379;56993;1375;1415;164668;105372977;5413;80764;22880;7441;102800317;7380;66035;150209;2547;128977;128989;113791;79734;150221;91179;3560;53947;83606;8664;23264;27254;56241;5008;10042;5988;57553;27037;4330;23466;2847;27341;51386;706;1454;5600;652968;254240;284904;7263;27127;26088;60489;84645;150356;645426;9889;414918;79680;23760;10454;9620;64781;9609;644186;11020;10634;23779;23209;400891;84700;9582;388849;51586;9127;23765;83874;348645;9814;55615;57591;135;6598;23551;10291;23786;25777;10126;1413;23616;613;391322;23541;114904;4357;91227;402055;6948;51537;115650;2033;55267;25813;25776;27352;2687;10478;4668;164592;730005;200312;83642;6767;5594;646851;9978;23617;25807;3543;164684;6527;3976;2952;7122;1565;8563;4744;84844;4809;84247;6305;54584;2678;25830;6523;1652;9402;26286;23523;7008;6525;140606;79159;400935;23492;2192;6753;8897;10587;80832;1439;7290;54471;6721;150280;49;2812;150248;23759;9647;758;5625;55954;85377;10521;4700;23331;3053;150290;164656;4689;255349;8224;80020;1399;4174;29796;3956;253190;64098;3761;11200;55020;266747;7494;10738;85352;85359;164633;10369;10633;9215;55586;80115;23761;5902;11252;23544;9145;27128;85378;79879;51816;23780;8214;421;25771;79019;10739;23774;80305;4242;157;27439;7625;23119;529;29802;23464;79640;91464;55007;50487;55964;553158;23467;84164;114794;6300;11135;9463;83746;10343;10043;8940;23313;11078;23384;29781;27124;1414;388886;5372;101929372;89781;25775;54487;64800;410;4248;29801;9567;9701;56666;91445;23532;150297;6663;29799;91355;140564;6899;27156;25809;8911;27443;637;3162;9997;25770;100037417;150365;200316;267020;112885;339665;339669;29780;266629;23170;150353;7477;25814;80339;10762;8220;27349;56478;55687;25828;4771;84133;6122;8216;51233;113730;9514;128954;23112;5435;54456,422
1,1,22,17397498,51178264,33780766,23481;200315;150383;3005;24144;129049;7533;91582;100423062;4733;2130;400916;7078;80831;55670;64976;6942;79174;6576;3985;83733;415116;6634;11144;29775;8218;23753;23542;158;57168;550631;23598;8542;84271;7621;83933;79924;91689;27351;5297;440822;2928;129080;140883;440829;150350;51512;1890;23654;25817;8318;57026;91289;728229;113828;5155;5905;26150;171568;4320;27440;85358;4627;23543;3957;80274;23764;51493;9681;150223;653689;4282;150368;11274;1120;440836;23539;5465;80830;23762;150372;9929;25793;50;27350;25829;63929;2781;162;253143;79087;84861;7353;51807;8398;638;8508;51733;11015;9993;85376;440804;4151;5816;5880;91319;7332;85379;284898;150274;9342;65078;80833;150275;1417;1312;6545;468;129025;23151;129138;83999;8459;8484;10766;1727;150379;56993;1375;1415;164668;105372977;5413;80764;22880;7441;102800317;7380;66035;150209;2547;128977;128989;113791;79734;150221;91179;3560;53947;83606;8664;23264;27254;56241;5008;10042;5988;57553;27037;4330;23466;2847;27341;51386;706;1454;5600;652968;254240;284904;7263;27127;26088;60489;84645;150356;645426;9889;414918;79680;23760;10454;9620;64781;9609;644186;11020;10634;23779;23209;400891;84700;9582;388849;51586;9127;23765;83874;348645;9814;55615;57591;135;6598;23551;10291;23786;25777;10126;1413;23616;613;391322;23541;114904;4357;91227;402055;6948;51537;115650;2033;55267;25813;25776;27352;2687;10478;4668;164592;730005;200312;83642;6767;5594;646851;9978;23617;25807;3543;164684;6527;3976;2952;7122;1565;8563;4744;84844;4809;84247;6305;54584;2678;25830;6523;1652;9402;26286;23523;7008;6525;140606;79159;400935;23492;2192;6753;8897;10587;80832;1439;7290;54471;6721;150280;49;2812;150248;23759;9647;758;5625;55954;85377;10521;4700;23331;3053;150290;164656;4689;255349;8224;80020;1399;4174;29796;3956;253190;64098;3761;11200;55020;266747;7494;10738;85352;85359;164633;10369;10633;9215;55586;80115;23761;5902;11252;23544;9145;27128;85378;79879;51816;23780;8214;421;25771;79019;10739;23774;80305;4242;157;27439;7625;23119;529;29802;23464;79640;91464;55007;50487;55964;553158;23467;84164;114794;6300;11135;9463;83746;10343;10043;8940;23313;11078;23384;29781;27124;1414;388886;5372;101929372;89781;25775;54487;64800;410;4248;29801;9567;9701;56666;91445;23532;150297;6663;29799;91355;140564;6899;27156;25809;8911;27443;637;3162;9997;25770;100037417;150365;200316;267020;112885;339665;339669;29780;266629;23170;150353;7477;25814;80339;10762;8220;27349;56478;55687;25828;4771;84133;6122;8216;51233;113730;9514;128954;23112;5435;54456,422
1,1,22,17397498,51178264,33780766,23481;200315;150383;3005;24144;129049;7533;91582;100423062;4733;2130;400916;7078;80831;55670;64976;6942;79174;6576;3985;83733;415116;6634;11144;29775;8218;23753;23542;158;57168;550631;23598;8542;84271;7621;83933;79924;91689;27351;5297;440822;2928;129080;140883;440829;150350;51512;1890;23654;25817;8318;57026;91289;728229;113828;5155;5905;26150;171568;4320;27440;85358;4627;23543;3957;80274;23764;51493;9681;150223;653689;4282;150368;11274;1120;440836;23539;5465;80830;23762;150372;9929;25793;50;27350;25829;63929;2781;162;253143;79087;84861;7353;51807;8398;638;8508;51733;11015;9993;85376;440804;4151;5816;5880;91319;7332;85379;284898;150274;9342;65078;80833;150275;1417;1312;6545;468;129025;23151;129138;83999;8459;8484;10766;1727;150379;56993;1375;1415;164668;105372977;5413;80764;22880;7441;102800317;7380;66035;150209;2547;128977;128989;113791;79734;150221;91179;3560;53947;83606;8664;23264;27254;56241;5008;10042;5988;57553;27037;4330;23466;2847;27341;51386;706;1454;5600;652968;254240;284904;7263;27127;26088;60489;84645;150356;645426;9889;414918;79680;23760;10454;9620;64781;9609;644186;11020;10634;23779;23209;400891;84700;9582;388849;51586;9127;23765;83874;348645;9814;55615;57591;135;6598;23551;10291;23786;25777;10126;1413;23616;613;391322;23541;114904;4357;91227;402055;6948;51537;115650;2033;55267;25813;25776;27352;2687;10478;4668;164592;730005;200312;83642;6767;5594;646851;9978;23617;25807;3543;164684;6527;3976;2952;7122;1565;8563;4744;84844;4809;84247;6305;54584;2678;25830;6523;1652;9402;26286;23523;7008;6525;140606;79159;400935;23492;2192;6753;8897;10587;80832;1439;7290;54471;6721;150280;49;2812;150248;23759;9647;758;5625;55954;85377;10521;4700;23331;3053;150290;164656;4689;255349;8224;80020;1399;4174;29796;3956;253190;64098;3761;11200;55020;266747;7494;10738;85352;85359;164633;10369;10633;9215;55586;80115;23761;5902;11252;23544;9145;27128;85378;79879;51816;23780;8214;421;25771;79019;10739;23774;80305;4242;157;27439;7625;23119;529;29802;23464;79640;91464;55007;50487;55964;553158;23467;84164;114794;6300;11135;9463;83746;10343;10043;8940;23313;11078;23384;29781;27124;1414;388886;5372;101929372;89781;25775;54487;64800;410;4248;29801;9567;9701;56666;91445;23532;150297;6663;29799;91355;140564;6899;27156;25809;8911;27443;637;3162;9997;25770;100037417;150365;200316;267020;112885;339665;339669;29780;266629;23170;150353;7477;25814;80339;10762;8220;27349;56478;55687;25828;4771;84133;6122;8216;51233;113730;9514;128954;23112;5435;54456,422
1,1,22,17397633,18628206,1230573,51807;23765;27440;27439;27443;55670;637;529;51816;23786;83733;128954;101929372;57553,14
1,1,22,17397633,18661758,1264125,51807;23765;27440;27439;27443;55670;637;529;11274;51816;23786;83733;128954;101929372;57553,15
1,1,22,17397633,18706059,1308426,51807;23765;27440;27439;27443;55670;637;529;11274;51816;23786;83733;128954;101929372;57553,15
1,1,22,17397633,19584890,2187257,27440;23617;51816;7122;8214;7290;8220;128977;7353;2928;51807;23765;9993;5625;27439;27443;55670;637;64976;529;11274;6576;8318;23786;83733;128954;101929372;57553;8218,29
1,1,22,17397633,51178213,33780580,23481;200315;150383;3005;24144;129049;7533;91582;100423062;4733;2130;400916;7078;80831;55670;64976;6942;79174;6576;3985;83733;415116;6634;11144;29775;8218;23753;23542;158;57168;550631;23598;8542;84271;7621;83933;79924;91689;27351;5297;440822;2928;129080;140883;440829;150350;51512;1890;23654;25817;8318;57026;91289;728229;113828;5155;5905;26150;171568;4320;27440;85358;4627;23543;3957;80274;23764;51493;9681;150223;653689;4282;150368;11274;1120;440836;23539;5465;80830;23762;150372;9929;25793;50;27350;25829;63929;2781;162;253143;79087;84861;7353;51807;8398;638;8508;51733;11015;9993;85376;440804;4151;5816;5880;91319;7332;85379;284898;150274;9342;65078;80833;150275;1417;1312;6545;468;129025;23151;129138;83999;8459;8484;10766;1727;150379;56993;1375;1415;164668;105372977;5413;80764;22880;7441;102800317;7380;66035;150209;2547;128977;128989;113791;79734;150221;91179;3560;53947;83606;8664;23264;27254;56241;5008;10042;5988;57553;27037;4330;23466;2847;27341;51386;706;1454;5600;652968;254240;284904;7263;27127;26088;60489;84645;150356;645426;9889;414918;79680;23760;10454;9620;64781;9609;644186;11020;10634;23779;23209;400891;84700;9582;388849;51586;9127;23765;83874;348645;9814;55615;57591;135;6598;23551;10291;23786;25777;10126;1413;23616;613;391322;23541;114904;4357;91227;402055;6948;51537;115650;2033;55267;25813;25776;27352;2687;10478;4668;164592;730005;200312;83642;6767;5594;646851;9978;23617;25807;3543;164684;6527;3976;2952;7122;1565;8563;4744;84844;4809;84247;6305;54584;2678;25830;6523;1652;9402;26286;23523;7008;6525;140606;79159;400935;23492;2192;6753;8897;10587;80832;1439;7290;54471;6721;150280;49;2812;150248;23759;9647;758;5625;55954;85377;10521;4700;23331;3053;150290;164656;4689;255349;8224;80020;1399;4174;29796;3956;253190;64098;3761;11200;55020;266747;7494;10738;85352;85359;164633;10369;10633;9215;55586;80115;23761;5902;11252;23544;9145;27128;85378;79879;51816;23780;8214;421;25771;79019;10739;23774;80305;4242;157;27439;7625;23119;529;29802;23464;79640;91464;55007;50487;55964;553158;23467;84164;114794;6300;11135;9463;83746;10343;10043;8940;23313;11078;23384;29781;27124;1414;388886;5372;101929372;89781;25775;54487;64800;410;4248;29801;9567;9701;56666;91445;23532;150297;6663;29799;91355;140564;6899;27156;25809;8911;27443;637;3162;9997;25770;100037417;150365;200316;267020;112885;339665;339669;29780;266629;23170;150353;7477;25814;80339;10762;8220;27349;56478;55687;25828;4771;84133;6122;8216;51233;113730;9514;128954;23112;5435;54456,422
1,-1,22,17541672,17550637,8965,,0
1,1,22,18570312,19184416,614104,2928;51807;9993;5625;23617;55670;11274;6576;8214;8220;8218,11
-1,-1,22,18628073,18848020,219947,11274,1
-1,-1,22,18628073,19010531,382458,11274;5625;8214,3
1,-1,22,18609960,18651614,41654,51807;11274,2
-1,1,22,18628019,21464119,2836100,54487;27037;9342;29801;65078;10587;1312;6545;8214;7290;421;2812;6899;5625;7625;79680;64976;11274;6576;3053;8218;5413;80764;23617;400891;1399;7122;150209;128977;8220;388849;84861;7353;51586;2928;128989;5297;9127;9993;54584;91179;85376;8216;85359;8318;728229;5902,47
-1,1,22,18628019,21505417,2877398,54487;27037;9342;29801;65078;10587;1312;6545;8214;7290;421;2812;6899;5625;7625;79680;64976;11274;6576;3053;8218;5413;80764;23617;400891;1399;7122;150209;128977;8220;388849;84861;7353;51586;2928;128989;5297;9127;9993;54584;91179;85376;8216;85359;8318;728229;5902,47
-1,1,22,18628019,21505417,2877398,54487;27037;9342;29801;65078;10587;1312;6545;8214;7290;421;2812;6899;5625;7625;79680;64976;11274;6576;3053;8218;5413;80764;23617;400891;1399;7122;150209;128977;8220;388849;84861;7353;51586;2928;128989;5297;9127;9993;54584;91179;85376;8216;85359;8318;728229;5902,47
-1,1,22,18628019,21505417,2877398,54487;27037;9342;29801;65078;10587;1312;6545;8214;7290;421;2812;6899;5625;7625;79680;64976;11274;6576;3053;8218;5413;80764;23617;400891;1399;7122;150209;128977;8220;388849;84861;7353;51586;2928;128989;5297;9127;9993;54584;91179;85376;8216;85359;8318;728229;5902,47
-1,-1,22,18641420,18848020,206600,11274,1
-1,-1,22,18641420,18848020,206600,11274,1
-1,-1,22,18641420,18848020,206600,11274,1
-1,-1,22,18641420,18848020,206600,11274,1
-1,-1,22,18641420,18848020,206600,11274,1
-1,1,22,18628132,21561468,2933336,54487;27037;9342;29801;65078;10587;1312;6545;8214;7290;421;2812;6899;5625;7625;79680;64976;11274;6576;3053;8218;5413;80764;23617;400891;1399;7122;150209;128977;8220;388849;84861;7353;51586;2928;128989;5297;9127;9993;54584;91179;85376;8216;85359;8318;728229;5902,47
-1,1,22,18628132,21561468,2933336,54487;27037;9342;29801;65078;10587;1312;6545;8214;7290;421;2812;6899;5625;7625;79680;64976;11274;6576;3053;8218;5413;80764;23617;400891;1399;7122;150209;128977;8220;388849;84861;7353;51586;2928;128989;5297;9127;9993;54584;91179;85376;8216;85359;8318;728229;5902,47
-1,1,22,18628132,21561468,2933336,54487;27037;9342;29801;65078;10587;1312;6545;8214;7290;421;2812;6899;5625;7625;79680;64976;11274;6576;3053;8218;5413;80764;23617;400891;1399;7122;150209;128977;8220;388849;84861;7353;51586;2928;128989;5297;9127;9993;54584;91179;85376;8216;85359;8318;728229;5902,47
-1,1,22,18628132,21561468,2933336,54487;27037;9342;29801;65078;10587;1312;6545;8214;7290;421;2812;6899;5625;7625;79680;64976;11274;6576;3053;8218;5413;80764;23617;400891;1399;7122;150209;128977;8220;388849;84861;7353;51586;2928;128989;5297;9127;9993;54584;91179;85376;8216;85359;8318;728229;5902,47
-1,1,22,18628132,21561468,2933336,54487;27037;9342;29801;65078;10587;1312;6545;8214;7290;421;2812;6899;5625;7625;79680;64976;11274;6576;3053;8218;5413;80764;23617;400891;1399;7122;150209;128977;8220;388849;84861;7353;51586;2928;128989;5297;9127;9993;54584;91179;85376;8216;85359;8318;728229;5902,47
-1,1,22,18628132,21561468,2933336,54487;27037;9342;29801;65078;10587;1312;6545;8214;7290;421;2812;6899;5625;7625;79680;64976;11274;6576;3053;8218;5413;80764;23617;400891;1399;7122;150209;128977;8220;388849;84861;7353;51586;2928;128989;5297;9127;9993;54584;91179;85376;8216;85359;8318;728229;5902,47
1,1,22,18628132,21712996,3084864,54487;27037;9342;29801;65078;10587;1312;6545;8214;7290;421;2812;6899;5625;7625;79680;64976;11274;6576;3053;8218;5413;80764;23617;400891;1399;7122;150209;128977;8220;388849;84861;7353;51586;2928;128989;5297;9127;9993;54584;91179;85376;8216;85359;8318;728229;5902,47
-1,1,22,18628132,21883879,3255747,54487;27037;9342;29801;65078;10587;1312;6545;8214;7290;421;2812;645426;6899;5625;7625;79680;23119;64976;11274;6576;3053;8218;5413;80764;23617;400891;1399;7122;150209;128977;8220;388849;84861;7353;51586;2928;128989;5297;9127;9993;54584;91179;85376;8216;440804;85359;8318;728229;5902,50
1,1,22,18628132,21900562,3272430,54487;27037;9342;29801;65078;10587;1312;6545;8214;7290;421;2812;645426;6899;5625;7625;79680;23119;64976;11274;6576;3053;8218;5413;80764;23617;400891;1399;7122;150209;128977;8220;388849;84861;7353;51586;2928;128989;5297;9127;150221;9993;54584;91179;85376;8216;440804;85359;8318;728229;5902,51
1,1,22,18628132,51203353,32575221,23481;200315;150383;3005;24144;129049;7533;91582;100423062;4733;2130;400916;7078;80831;64976;6942;79174;6576;3985;415116;6634;11144;29775;8218;23753;23542;158;57168;550631;23598;8542;84271;7621;83933;79924;91689;27351;5297;440822;2928;129080;140883;440829;150350;51512;1890;23654;25817;8318;57026;91289;728229;113828;5155;5905;26150;171568;4320;85358;4627;23543;3957;80274;23764;51493;9681;150223;653689;4282;150368;11274;1120;440836;23539;5465;80830;23762;150372;9929;25793;50;27350;25829;63929;2781;162;253143;79087;84861;7353;8398;638;8508;51733;11015;9993;85376;440804;4151;5816;5880;91319;7332;85379;284898;150274;9342;65078;80833;150275;1417;1312;6545;468;129025;23151;129138;83999;8459;8484;10766;1727;150379;56993;1375;1415;164668;105372977;5413;80764;22880;7441;102800317;7380;66035;150209;2547;128977;128989;113791;79734;150221;91179;3560;53947;83606;8664;23264;27254;56241;5008;10042;5988;27037;4330;23466;2847;27341;51386;706;1454;5600;652968;254240;284904;7263;27127;26088;60489;84645;150356;645426;9889;414918;79680;23760;10454;9620;64781;9609;644186;11020;10634;23779;23209;400891;84700;9582;388849;51586;9127;83874;348645;9814;55615;57591;135;6598;23551;10291;25777;10126;1413;23616;613;391322;23541;114904;4357;91227;402055;6948;51537;115650;2033;55267;25813;25776;27352;2687;10478;4668;164592;730005;200312;83642;6767;5594;646851;9978;23617;25807;3543;164684;6527;3976;2952;7122;1565;8563;4744;84844;4809;84247;6305;54584;2678;25830;6523;1652;9402;26286;23523;7008;6525;140606;79159;400935;23492;2192;6753;8897;10587;80832;1439;7290;54471;6721;150280;49;2812;150248;23759;9647;758;5625;55954;85377;10521;4700;23331;3053;150290;164656;4689;255349;8224;80020;1399;4174;29796;3956;253190;64098;3761;11200;55020;266747;7494;10738;85352;85359;164633;10369;10633;9215;55586;80115;23761;5902;11252;23544;9145;27128;85378;79879;23780;8214;421;25771;79019;10739;23774;80305;4242;157;7625;23119;29802;23464;79640;91464;55007;50487;55964;553158;23467;84164;114794;6300;11135;9463;83746;10343;10043;8940;23313;11078;23384;29781;27124;1414;388886;5372;89781;25775;54487;64800;410;4248;29801;9567;9701;56666;91445;23532;150297;6663;29799;91355;140564;6899;27156;25809;8911;3162;9997;25770;100037417;150365;200316;267020;112885;339665;339669;29780;266629;23170;150353;7477;25814;80339;10762;8220;27349;56478;55687;25828;4771;84133;6122;8216;51233;113730;9514;23112;5435;54456,408
-1,1,22,18628147,21440515,2812368,54487;27037;9342;29801;65078;10587;1312;6545;8214;7290;421;2812;6899;5625;7625;79680;64976;11274;6576;3053;8218;5413;80764;23617;400891;1399;7122;150209;128977;8220;388849;84861;7353;51586;2928;128989;5297;9127;9993;54584;91179;85376;8216;85359;8318;728229;5902,47
1,1,22,18631979,21465659,2833680,54487;27037;9342;29801;65078;10587;1312;6545;8214;7290;421;2812;6899;5625;7625;79680;64976;11274;6576;3053;8218;5413;80764;23617;400891;1399;7122;150209;128977;8220;388849;84861;7353;51586;2928;128989;5297;9127;9993;54584;91179;85376;8216;85359;8318;728229;5902,47
1,1,22,18636748,21465659,2828911,54487;27037;9342;29801;65078;10587;1312;6545;8214;7290;421;2812;6899;5625;7625;79680;64976;11274;6576;3053;8218;5413;80764;23617;400891;1399;7122;150209;128977;8220;388849;84861;7353;51586;2928;128989;5297;9127;9993;54584;91179;85376;8216;85359;8318;728229;5902,47
1,1,22,18640729,21465659,2824930,54487;27037;9342;29801;65078;10587;1312;6545;8214;7290;421;2812;6899;5625;7625;79680;64976;11274;6576;3053;8218;5413;80764;23617;400891;1399;7122;150209;128977;8220;388849;84861;7353;51586;2928;128989;5297;9127;9993;54584;91179;85376;8216;85359;8318;728229;5902,47
1,1,22,18640729,21465659,2824930,54487;27037;9342;29801;65078;10587;1312;6545;8214;7290;421;2812;6899;5625;7625;79680;64976;11274;6576;3053;8218;5413;80764;23617;400891;1399;7122;150209;128977;8220;388849;84861;7353;51586;2928;128989;5297;9127;9993;54584;91179;85376;8216;85359;8318;728229;5902,47
-1,-1,22,18661699,18953074,291375,5625;8214,2
-1,-1,22,18661699,19010531,348832,5625;8214,2
-1,1,22,18641479,21712996,3071517,54487;27037;9342;29801;65078;10587;1312;6545;8214;7290;421;2812;6899;5625;7625;79680;64976;11274;6576;3053;8218;5413;80764;23617;400891;1399;7122;150209;128977;8220;388849;84861;7353;51586;2928;128989;5297;9127;9993;54584;91179;85376;8216;85359;8318;728229;5902,47
-1,1,22,18641479,21722262,3080783,54487;27037;9342;29801;65078;10587;1312;6545;8214;7290;421;2812;6899;5625;7625;79680;64976;11274;6576;3053;8218;5413;80764;23617;400891;1399;7122;150209;128977;8220;388849;84861;7353;51586;2928;128989;5297;9127;9993;54584;91179;85376;8216;85359;8318;728229;5902,47
1,1,22,18641479,21917191,3275712,54487;27037;7332;9342;29801;65078;10587;1312;6545;8214;7290;421;2812;645426;6899;5625;7625;79680;23119;64976;11274;6576;3053;8218;5413;80764;23617;400891;1399;7122;150209;128977;8220;388849;84861;7353;51586;2928;128989;5297;9127;150221;9993;54584;91179;85376;8216;440804;85359;8318;728229;5902,52
-1,1,22,18644241,21465662,2821421,54487;27037;9342;29801;65078;10587;1312;6545;8214;7290;421;2812;6899;5625;7625;79680;64976;11274;6576;3053;8218;5413;80764;23617;400891;1399;7122;150209;128977;8220;388849;84861;7353;51586;2928;128989;5297;9127;9993;54584;91179;85376;8216;85359;8318;728229;5902,47
1,1,22,18644772,21041014,2396242,54487;27037;29801;65078;10587;1312;8214;7290;421;2812;6899;5625;7625;79680;64976;11274;6576;8218;5413;23617;7122;128977;8220;388849;84861;7353;51586;2928;128989;9993;54584;91179;85376;85359;8318;728229;5902,37
-1,1,22,18644790,21465659,2820869,54487;27037;9342;29801;65078;10587;1312;6545;8214;7290;421;2812;6899;5625;7625;79680;64976;11274;6576;3053;8218;5413;80764;23617;400891;1399;7122;150209;128977;8220;388849;84861;7353;51586;2928;128989;5297;9127;9993;54584;91179;85376;8216;85359;8318;728229;5902,47
-1,1,22,18644790,21465659,2820869,54487;27037;9342;29801;65078;10587;1312;6545;8214;7290;421;2812;6899;5625;7625;79680;64976;11274;6576;3053;8218;5413;80764;23617;400891;1399;7122;150209;128977;8220;388849;84861;7353;51586;2928;128989;5297;9127;9993;54584;91179;85376;8216;85359;8318;728229;5902,47
1,1,22,18644790,21465659,2820869,54487;27037;9342;29801;65078;10587;1312;6545;8214;7290;421;2812;6899;5625;7625;79680;64976;11274;6576;3053;8218;5413;80764;23617;400891;1399;7122;150209;128977;8220;388849;84861;7353;51586;2928;128989;5297;9127;9993;54584;91179;85376;8216;85359;8318;728229;5902,47
1,1,22,18644790,21465659,2820869,54487;27037;9342;29801;65078;10587;1312;6545;8214;7290;421;2812;6899;5625;7625;79680;64976;11274;6576;3053;8218;5413;80764;23617;400891;1399;7122;150209;128977;8220;388849;84861;7353;51586;2928;128989;5297;9127;9993;54584;91179;85376;8216;85359;8318;728229;5902,47
-1,1,22,18644790,21465659,2820869,54487;27037;9342;29801;65078;10587;1312;6545;8214;7290;421;2812;6899;5625;7625;79680;64976;11274;6576;3053;8218;5413;80764;23617;400891;1399;7122;150209;128977;8220;388849;84861;7353;51586;2928;128989;5297;9127;9993;54584;91179;85376;8216;85359;8318;728229;5902,47
1,1,22,18644790,21465659,2820869,54487;27037;9342;29801;65078;10587;1312;6545;8214;7290;421;2812;6899;5625;7625;79680;64976;11274;6576;3053;8218;5413;80764;23617;400891;1399;7122;150209;128977;8220;388849;84861;7353;51586;2928;128989;5297;9127;9993;54584;91179;85376;8216;85359;8318;728229;5902,47
1,1,22,18644790,21465659,2820869,54487;27037;9342;29801;65078;10587;1312;6545;8214;7290;421;2812;6899;5625;7625;79680;64976;11274;6576;3053;8218;5413;80764;23617;400891;1399;7122;150209;128977;8220;388849;84861;7353;51586;2928;128989;5297;9127;9993;54584;91179;85376;8216;85359;8318;728229;5902,47
-1,1,22,18644790,21465659,2820869,54487;27037;9342;29801;65078;10587;1312;6545;8214;7290;421;2812;6899;5625;7625;79680;64976;11274;6576;3053;8218;5413;80764;23617;400891;1399;7122;150209;128977;8220;388849;84861;7353;51586;2928;128989;5297;9127;9993;54584;91179;85376;8216;85359;8318;728229;5902,47
-1,1,22,18644790,21465659,2820869,54487;27037;9342;29801;65078;10587;1312;6545;8214;7290;421;2812;6899;5625;7625;79680;64976;11274;6576;3053;8218;5413;80764;23617;400891;1399;7122;150209;128977;8220;388849;84861;7353;51586;2928;128989;5297;9127;9993;54584;91179;85376;8216;85359;8318;728229;5902,47
-1,1,22,18644790,21465659,2820869,54487;27037;9342;29801;65078;10587;1312;6545;8214;7290;421;2812;6899;5625;7625;79680;64976;11274;6576;3053;8218;5413;80764;23617;400891;1399;7122;150209;128977;8220;388849;84861;7353;51586;2928;128989;5297;9127;9993;54584;91179;85376;8216;85359;8318;728229;5902,47
1,1,22,18644790,21465659,2820869,54487;27037;9342;29801;65078;10587;1312;6545;8214;7290;421;2812;6899;5625;7625;79680;64976;11274;6576;3053;8218;5413;80764;23617;400891;1399;7122;150209;128977;8220;388849;84861;7353;51586;2928;128989;5297;9127;9993;54584;91179;85376;8216;85359;8318;728229;5902,47
-1,1,22,18644790,21465659,2820869,54487;27037;9342;29801;65078;10587;1312;6545;8214;7290;421;2812;6899;5625;7625;79680;64976;11274;6576;3053;8218;5413;80764;23617;400891;1399;7122;150209;128977;8220;388849;84861;7353;51586;2928;128989;5297;9127;9993;54584;91179;85376;8216;85359;8318;728229;5902,47
-1,1,22,18644790,21798907,3154117,54487;27037;9342;29801;65078;10587;1312;6545;8214;7290;421;2812;6899;5625;7625;79680;23119;64976;11274;6576;3053;8218;5413;80764;23617;400891;1399;7122;150209;128977;8220;388849;84861;7353;51586;2928;128989;5297;9127;9993;54584;91179;85376;8216;440804;85359;8318;728229;5902,49
-1,1,22,18644790,21798907,3154117,54487;27037;9342;29801;65078;10587;1312;6545;8214;7290;421;2812;6899;5625;7625;79680;23119;64976;11274;6576;3053;8218;5413;80764;23617;400891;1399;7122;150209;128977;8220;388849;84861;7353;51586;2928;128989;5297;9127;9993;54584;91179;85376;8216;440804;85359;8318;728229;5902,49
-1,1,22,18644790,21798907,3154117,54487;27037;9342;29801;65078;10587;1312;6545;8214;7290;421;2812;6899;5625;7625;79680;23119;64976;11274;6576;3053;8218;5413;80764;23617;400891;1399;7122;150209;128977;8220;388849;84861;7353;51586;2928;128989;5297;9127;9993;54584;91179;85376;8216;440804;85359;8318;728229;5902,49
-1,1,22,18644790,21798907,3154117,54487;27037;9342;29801;65078;10587;1312;6545;8214;7290;421;2812;6899;5625;7625;79680;23119;64976;11274;6576;3053;8218;5413;80764;23617;400891;1399;7122;150209;128977;8220;388849;84861;7353;51586;2928;128989;5297;9127;9993;54584;91179;85376;8216;440804;85359;8318;728229;5902,49
-1,1,22,18644790,21798907,3154117,54487;27037;9342;29801;65078;10587;1312;6545;8214;7290;421;2812;6899;5625;7625;79680;23119;64976;11274;6576;3053;8218;5413;80764;23617;400891;1399;7122;150209;128977;8220;388849;84861;7353;51586;2928;128989;5297;9127;9993;54584;91179;85376;8216;440804;85359;8318;728229;5902,49
-1,1,22,18644790,21798907,3154117,54487;27037;9342;29801;65078;10587;1312;6545;8214;7290;421;2812;6899;5625;7625;79680;23119;64976;11274;6576;3053;8218;5413;80764;23617;400891;1399;7122;150209;128977;8220;388849;84861;7353;51586;2928;128989;5297;9127;9993;54584;91179;85376;8216;440804;85359;8318;728229;5902,49
-1,1,22,18644790,21798907,3154117,54487;27037;9342;29801;65078;10587;1312;6545;8214;7290;421;2812;6899;5625;7625;79680;23119;64976;11274;6576;3053;8218;5413;80764;23617;400891;1399;7122;150209;128977;8220;388849;84861;7353;51586;2928;128989;5297;9127;9993;54584;91179;85376;8216;440804;85359;8318;728229;5902,49
-1,1,22,18644790,21800471,3155681,54487;27037;9342;29801;65078;10587;1312;6545;8214;7290;421;2812;6899;5625;7625;79680;23119;64976;11274;6576;3053;8218;5413;80764;23617;400891;1399;7122;150209;128977;8220;388849;84861;7353;51586;2928;128989;5297;9127;9993;54584;91179;85376;8216;440804;85359;8318;728229;5902,49
-1,1,22,18644790,21915509,3270719,54487;27037;7332;9342;29801;65078;10587;1312;6545;8214;7290;421;2812;645426;6899;5625;7625;79680;23119;64976;11274;6576;3053;8218;5413;80764;23617;400891;1399;7122;150209;128977;8220;388849;84861;7353;51586;2928;128989;5297;9127;150221;9993;54584;91179;85376;8216;440804;85359;8318;728229;5902,52
-1,1,22,18645353,21465662,2820309,54487;27037;9342;29801;65078;10587;1312;6545;8214;7290;421;2812;6899;5625;7625;79680;64976;11274;6576;3053;8218;5413;80764;23617;400891;1399;7122;150209;128977;8220;388849;84861;7353;51586;2928;128989;5297;9127;9993;54584;91179;85376;8216;85359;8318;728229;5902,47
-1,1,22,18648856,21465662,2816806,54487;27037;9342;29801;65078;10587;1312;6545;8214;7290;421;2812;6899;5625;7625;79680;64976;11274;6576;3053;8218;5413;80764;23617;400891;1399;7122;150209;128977;8220;388849;84861;7353;51586;2928;128989;5297;9127;9993;54584;91179;85376;8216;85359;8318;728229;5902,47
1,1,22,18648866,21465659,2816793,54487;27037;9342;29801;65078;10587;1312;6545;8214;7290;421;2812;6899;5625;7625;79680;64976;11274;6576;3053;8218;5413;80764;23617;400891;1399;7122;150209;128977;8220;388849;84861;7353;51586;2928;128989;5297;9127;9993;54584;91179;85376;8216;85359;8318;728229;5902,47
-1,1,22,18648866,21465659,2816793,54487;27037;9342;29801;65078;10587;1312;6545;8214;7290;421;2812;6899;5625;7625;79680;64976;11274;6576;3053;8218;5413;80764;23617;400891;1399;7122;150209;128977;8220;388849;84861;7353;51586;2928;128989;5297;9127;9993;54584;91179;85376;8216;85359;8318;728229;5902,47
1,1,22,18648866,21465659,2816793,54487;27037;9342;29801;65078;10587;1312;6545;8214;7290;421;2812;6899;5625;7625;79680;64976;11274;6576;3053;8218;5413;80764;23617;400891;1399;7122;150209;128977;8220;388849;84861;7353;51586;2928;128989;5297;9127;9993;54584;91179;85376;8216;85359;8318;728229;5902,47
-1,1,22,18648866,21465662,2816796,54487;27037;9342;29801;65078;10587;1312;6545;8214;7290;421;2812;6899;5625;7625;79680;64976;11274;6576;3053;8218;5413;80764;23617;400891;1399;7122;150209;128977;8220;388849;84861;7353;51586;2928;128989;5297;9127;9993;54584;91179;85376;8216;85359;8318;728229;5902,47
-1,1,22,18648866,21798907,3150041,54487;27037;9342;29801;65078;10587;1312;6545;8214;7290;421;2812;6899;5625;7625;79680;23119;64976;11274;6576;3053;8218;5413;80764;23617;400891;1399;7122;150209;128977;8220;388849;84861;7353;51586;2928;128989;5297;9127;9993;54584;91179;85376;8216;440804;85359;8318;728229;5902,49
-1,1,22,18648866,21800797,3151931,54487;27037;9342;29801;65078;10587;1312;6545;8214;7290;421;2812;6899;5625;7625;79680;23119;64976;11274;6576;3053;8218;5413;80764;23617;400891;1399;7122;150209;128977;8220;388849;84861;7353;51586;2928;128989;5297;9127;9993;54584;91179;85376;8216;440804;85359;8318;728229;5902,49
1,1,22,18650664,21440455,2789791,54487;27037;9342;29801;65078;10587;1312;6545;8214;7290;421;2812;6899;5625;7625;79680;64976;11274;6576;3053;8218;5413;80764;23617;400891;1399;7122;150209;128977;8220;388849;84861;7353;51586;2928;128989;5297;9127;9993;54584;91179;85376;8216;85359;8318;728229;5902,47
-1,1,22,18650664,21440455,2789791,54487;27037;9342;29801;65078;10587;1312;6545;8214;7290;421;2812;6899;5625;7625;79680;64976;11274;6576;3053;8218;5413;80764;23617;400891;1399;7122;150209;128977;8220;388849;84861;7353;51586;2928;128989;5297;9127;9993;54584;91179;85376;8216;85359;8318;728229;5902,47
-1,1,22,18650664,21440455,2789791,54487;27037;9342;29801;65078;10587;1312;6545;8214;7290;421;2812;6899;5625;7625;79680;64976;11274;6576;3053;8218;5413;80764;23617;400891;1399;7122;150209;128977;8220;388849;84861;7353;51586;2928;128989;5297;9127;9993;54584;91179;85376;8216;85359;8318;728229;5902,47
-1,1,22,18650664,21440455,2789791,54487;27037;9342;29801;65078;10587;1312;6545;8214;7290;421;2812;6899;5625;7625;79680;64976;11274;6576;3053;8218;5413;80764;23617;400891;1399;7122;150209;128977;8220;388849;84861;7353;51586;2928;128989;5297;9127;9993;54584;91179;85376;8216;85359;8318;728229;5902,47
1,1,22,18650664,21440455,2789791,54487;27037;9342;29801;65078;10587;1312;6545;8214;7290;421;2812;6899;5625;7625;79680;64976;11274;6576;3053;8218;5413;80764;23617;400891;1399;7122;150209;128977;8220;388849;84861;7353;51586;2928;128989;5297;9127;9993;54584;91179;85376;8216;85359;8318;728229;5902,47
1,1,22,18651614,21440455,2788841,54487;27037;9342;29801;65078;10587;1312;6545;8214;7290;421;2812;6899;5625;7625;79680;64976;11274;6576;3053;8218;5413;80764;23617;400891;1399;7122;150209;128977;8220;388849;84861;7353;51586;2928;128989;5297;9127;9993;54584;91179;85376;8216;85359;8318;728229;5902,47
1,1,22,18661699,21505445,2843746,54487;27037;9342;29801;65078;10587;1312;6545;8214;7290;421;2812;6899;5625;7625;79680;64976;6576;3053;8218;5413;80764;23617;400891;1399;7122;150209;128977;8220;388849;84861;7353;51586;2928;128989;5297;9127;9993;54584;91179;85376;8216;85359;8318;728229;5902,46
-1,1,22,18661699,21505445,2843746,54487;27037;9342;29801;65078;10587;1312;6545;8214;7290;421;2812;6899;5625;7625;79680;64976;6576;3053;8218;5413;80764;23617;400891;1399;7122;150209;128977;8220;388849;84861;7353;51586;2928;128989;5297;9127;9993;54584;91179;85376;8216;85359;8318;728229;5902,46
1,1,22,18661699,22905025,4243326,54487;27037;7332;9342;29801;65078;10587;1312;6545;8214;7290;421;2812;23532;129025;645426;29799;23759;6899;150223;9647;5625;7625;79680;23119;64976;6576;3053;164592;8218;5413;80764;23753;5594;23617;7441;400891;1399;7122;150209;8940;128977;8220;388849;84861;7353;51586;2928;128989;5297;9127;150221;140883;9993;54584;91179;85376;8216;440804;85359;8318;728229;5902,63
-1,1,22,18661724,20659606,1997882,54487;27037;29801;65078;10587;1312;8214;7290;421;2812;6899;5625;79680;64976;6576;8218;5413;23617;7122;128977;8220;388849;7353;2928;128989;9993;54584;85376;85359;8318;728229;5902,32
-1,1,22,18661724,21440514,2778790,54487;27037;9342;29801;65078;10587;1312;6545;8214;7290;421;2812;6899;5625;7625;79680;64976;6576;3053;8218;5413;80764;23617;400891;1399;7122;150209;128977;8220;388849;84861;7353;51586;2928;128989;5297;9127;9993;54584;91179;85376;8216;85359;8318;728229;5902,46
-1,1,22,18661724,21440514,2778790,54487;27037;9342;29801;65078;10587;1312;6545;8214;7290;421;2812;6899;5625;7625;79680;64976;6576;3053;8218;5413;80764;23617;400891;1399;7122;150209;128977;8220;388849;84861;7353;51586;2928;128989;5297;9127;9993;54584;91179;85376;8216;85359;8318;728229;5902,46
-1,1,22,18661724,21440514,2778790,54487;27037;9342;29801;65078;10587;1312;6545;8214;7290;421;2812;6899;5625;7625;79680;64976;6576;3053;8218;5413;80764;23617;400891;1399;7122;150209;128977;8220;388849;84861;7353;51586;2928;128989;5297;9127;9993;54584;91179;85376;8216;85359;8318;728229;5902,46
-1,1,22,18661724,21440514,2778790,54487;27037;9342;29801;65078;10587;1312;6545;8214;7290;421;2812;6899;5625;7625;79680;64976;6576;3053;8218;5413;80764;23617;400891;1399;7122;150209;128977;8220;388849;84861;7353;51586;2928;128989;5297;9127;9993;54584;91179;85376;8216;85359;8318;728229;5902,46
1,1,22,18661724,21440514,2778790,54487;27037;9342;29801;65078;10587;1312;6545;8214;7290;421;2812;6899;5625;7625;79680;64976;6576;3053;8218;5413;80764;23617;400891;1399;7122;150209;128977;8220;388849;84861;7353;51586;2928;128989;5297;9127;9993;54584;91179;85376;8216;85359;8318;728229;5902,46
1,1,22,18661724,21461752,2800028,54487;27037;9342;29801;65078;10587;1312;6545;8214;7290;421;2812;6899;5625;7625;79680;64976;6576;3053;8218;5413;80764;23617;400891;1399;7122;150209;128977;8220;388849;84861;7353;51586;2928;128989;5297;9127;9993;54584;91179;85376;8216;85359;8318;728229;5902,46
-1,1,22,18661724,21461811,2800087,54487;27037;9342;29801;65078;10587;1312;6545;8214;7290;421;2812;6899;5625;7625;79680;64976;6576;3053;8218;5413;80764;23617;400891;1399;7122;150209;128977;8220;388849;84861;7353;51586;2928;128989;5297;9127;9993;54584;91179;85376;8216;85359;8318;728229;5902,46
-1,1,22,18661724,21464119,2802395,54487;27037;9342;29801;65078;10587;1312;6545;8214;7290;421;2812;6899;5625;7625;79680;64976;6576;3053;8218;5413;80764;23617;400891;1399;7122;150209;128977;8220;388849;84861;7353;51586;2928;128989;5297;9127;9993;54584;91179;85376;8216;85359;8318;728229;5902,46
-1,1,22,18661724,21464119,2802395,54487;27037;9342;29801;65078;10587;1312;6545;8214;7290;421;2812;6899;5625;7625;79680;64976;6576;3053;8218;5413;80764;23617;400891;1399;7122;150209;128977;8220;388849;84861;7353;51586;2928;128989;5297;9127;9993;54584;91179;85376;8216;85359;8318;728229;5902,46
-1,1,22,18661724,21464119,2802395,54487;27037;9342;29801;65078;10587;1312;6545;8214;7290;421;2812;6899;5625;7625;79680;64976;6576;3053;8218;5413;80764;23617;400891;1399;7122;150209;128977;8220;388849;84861;7353;51586;2928;128989;5297;9127;9993;54584;91179;85376;8216;85359;8318;728229;5902,46
-1,1,22,18661724,21464119,2802395,54487;27037;9342;29801;65078;10587;1312;6545;8214;7290;421;2812;6899;5625;7625;79680;64976;6576;3053;8218;5413;80764;23617;400891;1399;7122;150209;128977;8220;388849;84861;7353;51586;2928;128989;5297;9127;9993;54584;91179;85376;8216;85359;8318;728229;5902,46
-1,1,22,18661724,21505417,2843693,54487;27037;9342;29801;65078;10587;1312;6545;8214;7290;421;2812;6899;5625;7625;79680;64976;6576;3053;8218;5413;80764;23617;400891;1399;7122;150209;128977;8220;388849;84861;7353;51586;2928;128989;5297;9127;9993;54584;91179;85376;8216;85359;8318;728229;5902,46
-1,1,22,18661724,21505417,2843693,54487;27037;9342;29801;65078;10587;1312;6545;8214;7290;421;2812;6899;5625;7625;79680;64976;6576;3053;8218;5413;80764;23617;400891;1399;7122;150209;128977;8220;388849;84861;7353;51586;2928;128989;5297;9127;9993;54584;91179;85376;8216;85359;8318;728229;5902,46
-1,1,22,18661724,21505417,2843693,54487;27037;9342;29801;65078;10587;1312;6545;8214;7290;421;2812;6899;5625;7625;79680;64976;6576;3053;8218;5413;80764;23617;400891;1399;7122;150209;128977;8220;388849;84861;7353;51586;2928;128989;5297;9127;9993;54584;91179;85376;8216;85359;8318;728229;5902,46
-1,1,22,18661724,21505417,2843693,54487;27037;9342;29801;65078;10587;1312;6545;8214;7290;421;2812;6899;5625;7625;79680;64976;6576;3053;8218;5413;80764;23617;400891;1399;7122;150209;128977;8220;388849;84861;7353;51586;2928;128989;5297;9127;9993;54584;91179;85376;8216;85359;8318;728229;5902,46
-1,1,22,18661724,21505417,2843693,54487;27037;9342;29801;65078;10587;1312;6545;8214;7290;421;2812;6899;5625;7625;79680;64976;6576;3053;8218;5413;80764;23617;400891;1399;7122;150209;128977;8220;388849;84861;7353;51586;2928;128989;5297;9127;9993;54584;91179;85376;8216;85359;8318;728229;5902,46
-1,1,22,18661724,21505417,2843693,54487;27037;9342;29801;65078;10587;1312;6545;8214;7290;421;2812;6899;5625;7625;79680;64976;6576;3053;8218;5413;80764;23617;400891;1399;7122;150209;128977;8220;388849;84861;7353;51586;2928;128989;5297;9127;9993;54584;91179;85376;8216;85359;8318;728229;5902,46
-1,1,22,18661724,21505417,2843693,54487;27037;9342;29801;65078;10587;1312;6545;8214;7290;421;2812;6899;5625;7625;79680;64976;6576;3053;8218;5413;80764;23617;400891;1399;7122;150209;128977;8220;388849;84861;7353;51586;2928;128989;5297;9127;9993;54584;91179;85376;8216;85359;8318;728229;5902,46
1,1,22,18661724,21505417,2843693,54487;27037;9342;29801;65078;10587;1312;6545;8214;7290;421;2812;6899;5625;7625;79680;64976;6576;3053;8218;5413;80764;23617;400891;1399;7122;150209;128977;8220;388849;84861;7353;51586;2928;128989;5297;9127;9993;54584;91179;85376;8216;85359;8318;728229;5902,46
-1,1,22,18661724,21505417,2843693,54487;27037;9342;29801;65078;10587;1312;6545;8214;7290;421;2812;6899;5625;7625;79680;64976;6576;3053;8218;5413;80764;23617;400891;1399;7122;150209;128977;8220;388849;84861;7353;51586;2928;128989;5297;9127;9993;54584;91179;85376;8216;85359;8318;728229;5902,46
-1,1,22,18661724,21505417,2843693,54487;27037;9342;29801;65078;10587;1312;6545;8214;7290;421;2812;6899;5625;7625;79680;64976;6576;3053;8218;5413;80764;23617;400891;1399;7122;150209;128977;8220;388849;84861;7353;51586;2928;128989;5297;9127;9993;54584;91179;85376;8216;85359;8318;728229;5902,46
-1,1,22,18661724,21561514,2899790,54487;27037;9342;29801;65078;10587;1312;6545;8214;7290;421;2812;6899;5625;7625;79680;64976;6576;3053;8218;5413;80764;23617;400891;1399;7122;150209;128977;8220;388849;84861;7353;51586;2928;128989;5297;9127;9993;54584;91179;85376;8216;85359;8318;728229;5902,46
-1,1,22,18661724,21561514,2899790,54487;27037;9342;29801;65078;10587;1312;6545;8214;7290;421;2812;6899;5625;7625;79680;64976;6576;3053;8218;5413;80764;23617;400891;1399;7122;150209;128977;8220;388849;84861;7353;51586;2928;128989;5297;9127;9993;54584;91179;85376;8216;85359;8318;728229;5902,46
-1,1,22,18661724,21561514,2899790,54487;27037;9342;29801;65078;10587;1312;6545;8214;7290;421;2812;6899;5625;7625;79680;64976;6576;3053;8218;5413;80764;23617;400891;1399;7122;150209;128977;8220;388849;84861;7353;51586;2928;128989;5297;9127;9993;54584;91179;85376;8216;85359;8318;728229;5902,46
1,1,22,18661724,21661435,2999711,54487;27037;9342;29801;65078;10587;1312;6545;8214;7290;421;2812;6899;5625;7625;79680;64976;6576;3053;8218;5413;80764;23617;400891;1399;7122;150209;128977;8220;388849;84861;7353;51586;2928;128989;5297;9127;9993;54584;91179;85376;8216;85359;8318;728229;5902,46
-1,1,22,18661724,21809009,3147285,54487;27037;9342;29801;65078;10587;1312;6545;8214;7290;421;2812;6899;5625;7625;79680;23119;64976;6576;3053;8218;5413;80764;23617;400891;1399;7122;150209;128977;8220;388849;84861;7353;51586;2928;128989;5297;9127;9993;54584;91179;85376;8216;440804;85359;8318;728229;5902,48
-1,-1,22,18661748,18813961,152213,,0
-1,-1,22,18661748,18813961,152213,,0
-1,1,22,18706001,20311763,1605762,54487;27037;5413;29801;65078;23617;10587;1312;7122;8214;7290;421;128977;8220;2812;388849;7353;2928;128989;6899;9993;54584;5625;79680;85359;64976;8318;5902;6576;8218,30
-1,1,22,18706001,20659606,1953605,54487;27037;29801;65078;10587;1312;8214;7290;421;2812;6899;5625;79680;64976;6576;8218;5413;23617;7122;128977;8220;388849;7353;2928;128989;9993;54584;85376;85359;8318;728229;5902,32
-1,1,22,18706001,20659606,1953605,54487;27037;29801;65078;10587;1312;8214;7290;421;2812;6899;5625;79680;64976;6576;8218;5413;23617;7122;128977;8220;388849;7353;2928;128989;9993;54584;85376;85359;8318;728229;5902,32
-1,1,22,18706001,20659606,1953605,54487;27037;29801;65078;10587;1312;8214;7290;421;2812;6899;5625;79680;64976;6576;8218;5413;23617;7122;128977;8220;388849;7353;2928;128989;9993;54584;85376;85359;8318;728229;5902,32
-1,1,22,18706001,21025713,2319712,54487;27037;29801;65078;10587;1312;8214;7290;421;2812;6899;5625;7625;79680;64976;6576;8218;5413;23617;7122;128977;8220;388849;84861;7353;51586;2928;128989;9993;54584;91179;85376;85359;8318;728229;5902,36
-1,1,22,18706001,21025713,2319712,54487;27037;29801;65078;10587;1312;8214;7290;421;2812;6899;5625;7625;79680;64976;6576;8218;5413;23617;7122;128977;8220;388849;84861;7353;51586;2928;128989;9993;54584;91179;85376;85359;8318;728229;5902,36
-1,1,22,18706001,21440514,2734513,54487;27037;9342;29801;65078;10587;1312;6545;8214;7290;421;2812;6899;5625;7625;79680;64976;6576;3053;8218;5413;80764;23617;400891;1399;7122;150209;128977;8220;388849;84861;7353;51586;2928;128989;5297;9127;9993;54584;91179;85376;8216;85359;8318;728229;5902,46
-1,1,22,18706001,21440514,2734513,54487;27037;9342;29801;65078;10587;1312;6545;8214;7290;421;2812;6899;5625;7625;79680;64976;6576;3053;8218;5413;80764;23617;400891;1399;7122;150209;128977;8220;388849;84861;7353;51586;2928;128989;5297;9127;9993;54584;91179;85376;8216;85359;8318;728229;5902,46
-1,1,22,18706001,21440514,2734513,54487;27037;9342;29801;65078;10587;1312;6545;8214;7290;421;2812;6899;5625;7625;79680;64976;6576;3053;8218;5413;80764;23617;400891;1399;7122;150209;128977;8220;388849;84861;7353;51586;2928;128989;5297;9127;9993;54584;91179;85376;8216;85359;8318;728229;5902,46
-1,1,22,18706001,21440514,2734513,54487;27037;9342;29801;65078;10587;1312;6545;8214;7290;421;2812;6899;5625;7625;79680;64976;6576;3053;8218;5413;80764;23617;400891;1399;7122;150209;128977;8220;388849;84861;7353;51586;2928;128989;5297;9127;9993;54584;91179;85376;8216;85359;8318;728229;5902,46
-1,1,22,18706001,21464119,2758118,54487;27037;9342;29801;65078;10587;1312;6545;8214;7290;421;2812;6899;5625;7625;79680;64976;6576;3053;8218;5413;80764;23617;400891;1399;7122;150209;128977;8220;388849;84861;7353;51586;2928;128989;5297;9127;9993;54584;91179;85376;8216;85359;8318;728229;5902,46
-1,1,22,18706001,21464119,2758118,54487;27037;9342;29801;65078;10587;1312;6545;8214;7290;421;2812;6899;5625;7625;79680;64976;6576;3053;8218;5413;80764;23617;400891;1399;7122;150209;128977;8220;388849;84861;7353;51586;2928;128989;5297;9127;9993;54584;91179;85376;8216;85359;8318;728229;5902,46
-1,1,22,18706001,21464119,2758118,54487;27037;9342;29801;65078;10587;1312;6545;8214;7290;421;2812;6899;5625;7625;79680;64976;6576;3053;8218;5413;80764;23617;400891;1399;7122;150209;128977;8220;388849;84861;7353;51586;2928;128989;5297;9127;9993;54584;91179;85376;8216;85359;8318;728229;5902,46
-1,1,22,18706001,21464119,2758118,54487;27037;9342;29801;65078;10587;1312;6545;8214;7290;421;2812;6899;5625;7625;79680;64976;6576;3053;8218;5413;80764;23617;400891;1399;7122;150209;128977;8220;388849;84861;7353;51586;2928;128989;5297;9127;9993;54584;91179;85376;8216;85359;8318;728229;5902,46
-1,1,22,18706001,21464119,2758118,54487;27037;9342;29801;65078;10587;1312;6545;8214;7290;421;2812;6899;5625;7625;79680;64976;6576;3053;8218;5413;80764;23617;400891;1399;7122;150209;128977;8220;388849;84861;7353;51586;2928;128989;5297;9127;9993;54584;91179;85376;8216;85359;8318;728229;5902,46
-1,1,22,18706001,21464119,2758118,54487;27037;9342;29801;65078;10587;1312;6545;8214;7290;421;2812;6899;5625;7625;79680;64976;6576;3053;8218;5413;80764;23617;400891;1399;7122;150209;128977;8220;388849;84861;7353;51586;2928;128989;5297;9127;9993;54584;91179;85376;8216;85359;8318;728229;5902,46
-1,1,22,18706001,21464119,2758118,54487;27037;9342;29801;65078;10587;1312;6545;8214;7290;421;2812;6899;5625;7625;79680;64976;6576;3053;8218;5413;80764;23617;400891;1399;7122;150209;128977;8220;388849;84861;7353;51586;2928;128989;5297;9127;9993;54584;91179;85376;8216;85359;8318;728229;5902,46
-1,1,22,18706001,21464119,2758118,54487;27037;9342;29801;65078;10587;1312;6545;8214;7290;421;2812;6899;5625;7625;79680;64976;6576;3053;8218;5413;80764;23617;400891;1399;7122;150209;128977;8220;388849;84861;7353;51586;2928;128989;5297;9127;9993;54584;91179;85376;8216;85359;8318;728229;5902,46
-1,1,22,18706001,21464119,2758118,54487;27037;9342;29801;65078;10587;1312;6545;8214;7290;421;2812;6899;5625;7625;79680;64976;6576;3053;8218;5413;80764;23617;400891;1399;7122;150209;128977;8220;388849;84861;7353;51586;2928;128989;5297;9127;9993;54584;91179;85376;8216;85359;8318;728229;5902,46
-1,1,22,18706001,21464119,2758118,54487;27037;9342;29801;65078;10587;1312;6545;8214;7290;421;2812;6899;5625;7625;79680;64976;6576;3053;8218;5413;80764;23617;400891;1399;7122;150209;128977;8220;388849;84861;7353;51586;2928;128989;5297;9127;9993;54584;91179;85376;8216;85359;8318;728229;5902,46
-1,1,22,18706001,21464119,2758118,54487;27037;9342;29801;65078;10587;1312;6545;8214;7290;421;2812;6899;5625;7625;79680;64976;6576;3053;8218;5413;80764;23617;400891;1399;7122;150209;128977;8220;388849;84861;7353;51586;2928;128989;5297;9127;9993;54584;91179;85376;8216;85359;8318;728229;5902,46
-1,1,22,18706001,21464119,2758118,54487;27037;9342;29801;65078;10587;1312;6545;8214;7290;421;2812;6899;5625;7625;79680;64976;6576;3053;8218;5413;80764;23617;400891;1399;7122;150209;128977;8220;388849;84861;7353;51586;2928;128989;5297;9127;9993;54584;91179;85376;8216;85359;8318;728229;5902,46
-1,1,22,18706001,21464119,2758118,54487;27037;9342;29801;65078;10587;1312;6545;8214;7290;421;2812;6899;5625;7625;79680;64976;6576;3053;8218;5413;80764;23617;400891;1399;7122;150209;128977;8220;388849;84861;7353;51586;2928;128989;5297;9127;9993;54584;91179;85376;8216;85359;8318;728229;5902,46
-1,1,22,18706001,21505417,2799416,54487;27037;9342;29801;65078;10587;1312;6545;8214;7290;421;2812;6899;5625;7625;79680;64976;6576;3053;8218;5413;80764;23617;400891;1399;7122;150209;128977;8220;388849;84861;7353;51586;2928;128989;5297;9127;9993;54584;91179;85376;8216;85359;8318;728229;5902,46
-1,1,22,18706001,21505417,2799416,54487;27037;9342;29801;65078;10587;1312;6545;8214;7290;421;2812;6899;5625;7625;79680;64976;6576;3053;8218;5413;80764;23617;400891;1399;7122;150209;128977;8220;388849;84861;7353;51586;2928;128989;5297;9127;9993;54584;91179;85376;8216;85359;8318;728229;5902,46
-1,1,22,18706001,21505417,2799416,54487;27037;9342;29801;65078;10587;1312;6545;8214;7290;421;2812;6899;5625;7625;79680;64976;6576;3053;8218;5413;80764;23617;400891;1399;7122;150209;128977;8220;388849;84861;7353;51586;2928;128989;5297;9127;9993;54584;91179;85376;8216;85359;8318;728229;5902,46
-1,1,22,18706001,21505417,2799416,54487;27037;9342;29801;65078;10587;1312;6545;8214;7290;421;2812;6899;5625;7625;79680;64976;6576;3053;8218;5413;80764;23617;400891;1399;7122;150209;128977;8220;388849;84861;7353;51586;2928;128989;5297;9127;9993;54584;91179;85376;8216;85359;8318;728229;5902,46
-1,1,22,18706001,21505417,2799416,54487;27037;9342;29801;65078;10587;1312;6545;8214;7290;421;2812;6899;5625;7625;79680;64976;6576;3053;8218;5413;80764;23617;400891;1399;7122;150209;128977;8220;388849;84861;7353;51586;2928;128989;5297;9127;9993;54584;91179;85376;8216;85359;8318;728229;5902,46
-1,1,22,18706001,21505417,2799416,54487;27037;9342;29801;65078;10587;1312;6545;8214;7290;421;2812;6899;5625;7625;79680;64976;6576;3053;8218;5413;80764;23617;400891;1399;7122;150209;128977;8220;388849;84861;7353;51586;2928;128989;5297;9127;9993;54584;91179;85376;8216;85359;8318;728229;5902,46
-1,1,22,18706001,21505417,2799416,54487;27037;9342;29801;65078;10587;1312;6545;8214;7290;421;2812;6899;5625;7625;79680;64976;6576;3053;8218;5413;80764;23617;400891;1399;7122;150209;128977;8220;388849;84861;7353;51586;2928;128989;5297;9127;9993;54584;91179;85376;8216;85359;8318;728229;5902,46
-1,1,22,18706001,21505417,2799416,54487;27037;9342;29801;65078;10587;1312;6545;8214;7290;421;2812;6899;5625;7625;79680;64976;6576;3053;8218;5413;80764;23617;400891;1399;7122;150209;128977;8220;388849;84861;7353;51586;2928;128989;5297;9127;9993;54584;91179;85376;8216;85359;8318;728229;5902,46
-1,1,22,18706001,21505417,2799416,54487;27037;9342;29801;65078;10587;1312;6545;8214;7290;421;2812;6899;5625;7625;79680;64976;6576;3053;8218;5413;80764;23617;400891;1399;7122;150209;128977;8220;388849;84861;7353;51586;2928;128989;5297;9127;9993;54584;91179;85376;8216;85359;8318;728229;5902,46
-1,1,22,18706001,21505417,2799416,54487;27037;9342;29801;65078;10587;1312;6545;8214;7290;421;2812;6899;5625;7625;79680;64976;6576;3053;8218;5413;80764;23617;400891;1399;7122;150209;128977;8220;388849;84861;7353;51586;2928;128989;5297;9127;9993;54584;91179;85376;8216;85359;8318;728229;5902,46
-1,1,22,18706001,21505417,2799416,54487;27037;9342;29801;65078;10587;1312;6545;8214;7290;421;2812;6899;5625;7625;79680;64976;6576;3053;8218;5413;80764;23617;400891;1399;7122;150209;128977;8220;388849;84861;7353;51586;2928;128989;5297;9127;9993;54584;91179;85376;8216;85359;8318;728229;5902,46
-1,1,22,18706001,21505417,2799416,54487;27037;9342;29801;65078;10587;1312;6545;8214;7290;421;2812;6899;5625;7625;79680;64976;6576;3053;8218;5413;80764;23617;400891;1399;7122;150209;128977;8220;388849;84861;7353;51586;2928;128989;5297;9127;9993;54584;91179;85376;8216;85359;8318;728229;5902,46
-1,1,22,18706001,21505417,2799416,54487;27037;9342;29801;65078;10587;1312;6545;8214;7290;421;2812;6899;5625;7625;79680;64976;6576;3053;8218;5413;80764;23617;400891;1399;7122;150209;128977;8220;388849;84861;7353;51586;2928;128989;5297;9127;9993;54584;91179;85376;8216;85359;8318;728229;5902,46
-1,1,22,18706001,21505417,2799416,54487;27037;9342;29801;65078;10587;1312;6545;8214;7290;421;2812;6899;5625;7625;79680;64976;6576;3053;8218;5413;80764;23617;400891;1399;7122;150209;128977;8220;388849;84861;7353;51586;2928;128989;5297;9127;9993;54584;91179;85376;8216;85359;8318;728229;5902,46
-1,1,22,18706001,21505417,2799416,54487;27037;9342;29801;65078;10587;1312;6545;8214;7290;421;2812;6899;5625;7625;79680;64976;6576;3053;8218;5413;80764;23617;400891;1399;7122;150209;128977;8220;388849;84861;7353;51586;2928;128989;5297;9127;9993;54584;91179;85376;8216;85359;8318;728229;5902,46
-1,1,22,18706001,21505417,2799416,54487;27037;9342;29801;65078;10587;1312;6545;8214;7290;421;2812;6899;5625;7625;79680;64976;6576;3053;8218;5413;80764;23617;400891;1399;7122;150209;128977;8220;388849;84861;7353;51586;2928;128989;5297;9127;9993;54584;91179;85376;8216;85359;8318;728229;5902,46
-1,1,22,18706001,21505417,2799416,54487;27037;9342;29801;65078;10587;1312;6545;8214;7290;421;2812;6899;5625;7625;79680;64976;6576;3053;8218;5413;80764;23617;400891;1399;7122;150209;128977;8220;388849;84861;7353;51586;2928;128989;5297;9127;9993;54584;91179;85376;8216;85359;8318;728229;5902,46
-1,1,22,18706001,21505417,2799416,54487;27037;9342;29801;65078;10587;1312;6545;8214;7290;421;2812;6899;5625;7625;79680;64976;6576;3053;8218;5413;80764;23617;400891;1399;7122;150209;128977;8220;388849;84861;7353;51586;2928;128989;5297;9127;9993;54584;91179;85376;8216;85359;8318;728229;5902,46
-1,1,22,18706001,21505417,2799416,54487;27037;9342;29801;65078;10587;1312;6545;8214;7290;421;2812;6899;5625;7625;79680;64976;6576;3053;8218;5413;80764;23617;400891;1399;7122;150209;128977;8220;388849;84861;7353;51586;2928;128989;5297;9127;9993;54584;91179;85376;8216;85359;8318;728229;5902,46
-1,1,22,18706001,21505417,2799416,54487;27037;9342;29801;65078;10587;1312;6545;8214;7290;421;2812;6899;5625;7625;79680;64976;6576;3053;8218;5413;80764;23617;400891;1399;7122;150209;128977;8220;388849;84861;7353;51586;2928;128989;5297;9127;9993;54584;91179;85376;8216;85359;8318;728229;5902,46
-1,1,22,18706001,21505417,2799416,54487;27037;9342;29801;65078;10587;1312;6545;8214;7290;421;2812;6899;5625;7625;79680;64976;6576;3053;8218;5413;80764;23617;400891;1399;7122;150209;128977;8220;388849;84861;7353;51586;2928;128989;5297;9127;9993;54584;91179;85376;8216;85359;8318;728229;5902,46
-1,1,22,18706001,21505417,2799416,54487;27037;9342;29801;65078;10587;1312;6545;8214;7290;421;2812;6899;5625;7625;79680;64976;6576;3053;8218;5413;80764;23617;400891;1399;7122;150209;128977;8220;388849;84861;7353;51586;2928;128989;5297;9127;9993;54584;91179;85376;8216;85359;8318;728229;5902,46
-1,1,22,18706001,21505417,2799416,54487;27037;9342;29801;65078;10587;1312;6545;8214;7290;421;2812;6899;5625;7625;79680;64976;6576;3053;8218;5413;80764;23617;400891;1399;7122;150209;128977;8220;388849;84861;7353;51586;2928;128989;5297;9127;9993;54584;91179;85376;8216;85359;8318;728229;5902,46
-1,1,22,18706001,21505417,2799416,54487;27037;9342;29801;65078;10587;1312;6545;8214;7290;421;2812;6899;5625;7625;79680;64976;6576;3053;8218;5413;80764;23617;400891;1399;7122;150209;128977;8220;388849;84861;7353;51586;2928;128989;5297;9127;9993;54584;91179;85376;8216;85359;8318;728229;5902,46
-1,1,22,18706001,21505417,2799416,54487;27037;9342;29801;65078;10587;1312;6545;8214;7290;421;2812;6899;5625;7625;79680;64976;6576;3053;8218;5413;80764;23617;400891;1399;7122;150209;128977;8220;388849;84861;7353;51586;2928;128989;5297;9127;9993;54584;91179;85376;8216;85359;8318;728229;5902,46
-1,1,22,18706001,21505417,2799416,54487;27037;9342;29801;65078;10587;1312;6545;8214;7290;421;2812;6899;5625;7625;79680;64976;6576;3053;8218;5413;80764;23617;400891;1399;7122;150209;128977;8220;388849;84861;7353;51586;2928;128989;5297;9127;9993;54584;91179;85376;8216;85359;8318;728229;5902,46
-1,1,22,18706001,21505417,2799416,54487;27037;9342;29801;65078;10587;1312;6545;8214;7290;421;2812;6899;5625;7625;79680;64976;6576;3053;8218;5413;80764;23617;400891;1399;7122;150209;128977;8220;388849;84861;7353;51586;2928;128989;5297;9127;9993;54584;91179;85376;8216;85359;8318;728229;5902,46
1,1,22,18713491,20412989,1699498,54487;27037;5413;29801;65078;23617;10587;1312;7122;8214;7290;421;128977;8220;2812;388849;7353;2928;128989;6899;9993;54584;5625;79680;85359;64976;8318;5902;6576;728229;8218,31
1,1,22,18713491,21712996,2999505,54487;27037;9342;29801;65078;10587;1312;6545;8214;7290;421;2812;6899;5625;7625;79680;64976;6576;3053;8218;5413;80764;23617;400891;1399;7122;150209;128977;8220;388849;84861;7353;51586;2928;128989;5297;9127;9993;54584;91179;85376;8216;85359;8318;728229;5902,46
1,1,22,18713491,21917191,3203700,54487;27037;7332;9342;29801;65078;10587;1312;6545;8214;7290;421;2812;645426;6899;5625;7625;79680;23119;64976;6576;3053;8218;5413;80764;23617;400891;1399;7122;150209;128977;8220;388849;84861;7353;51586;2928;128989;5297;9127;150221;9993;54584;91179;85376;8216;440804;85359;8318;728229;5902,51
-1,1,22,18765085,21661435,2896350,54487;27037;9342;29801;65078;10587;1312;6545;8214;7290;421;2812;6899;5625;7625;79680;64976;6576;3053;8218;5413;80764;23617;400891;1399;7122;150209;128977;8220;388849;84861;7353;51586;2928;128989;5297;9127;9993;54584;91179;85376;8216;85359;8318;728229;5902,46
-1,1,22,18787999,21065894,2277895,54487;27037;29801;65078;10587;1312;8214;7290;421;2812;6899;5625;7625;79680;64976;6576;8218;5413;23617;7122;128977;8220;388849;84861;7353;51586;2928;128989;5297;9993;54584;91179;85376;85359;8318;728229;5902,37
-1,1,22,18787999,21468378,2680379,54487;27037;9342;29801;65078;10587;1312;6545;8214;7290;421;2812;6899;5625;7625;79680;64976;6576;3053;8218;5413;80764;23617;400891;1399;7122;150209;128977;8220;388849;84861;7353;51586;2928;128989;5297;9127;9993;54584;91179;85376;8216;85359;8318;728229;5902,46
-1,1,22,18787999,21684798,2896799,54487;27037;9342;29801;65078;10587;1312;6545;8214;7290;421;2812;6899;5625;7625;79680;64976;6576;3053;8218;5413;80764;23617;400891;1399;7122;150209;128977;8220;388849;84861;7353;51586;2928;128989;5297;9127;9993;54584;91179;85376;8216;85359;8318;728229;5902,46
-1,1,22,18848020,21468378,2620358,54487;27037;9342;29801;65078;10587;1312;6545;8214;7290;421;2812;6899;5625;7625;79680;64976;6576;3053;8218;5413;80764;23617;400891;1399;7122;150209;128977;8220;388849;84861;7353;51586;2928;128989;5297;9127;9993;54584;91179;85376;8216;85359;8318;728229;5902,46
-1,1,22,18848020,21468378,2620358,54487;27037;9342;29801;65078;10587;1312;6545;8214;7290;421;2812;6899;5625;7625;79680;64976;6576;3053;8218;5413;80764;23617;400891;1399;7122;150209;128977;8220;388849;84861;7353;51586;2928;128989;5297;9127;9993;54584;91179;85376;8216;85359;8318;728229;5902,46
1,1,22,18848020,21468378,2620358,54487;27037;9342;29801;65078;10587;1312;6545;8214;7290;421;2812;6899;5625;7625;79680;64976;6576;3053;8218;5413;80764;23617;400891;1399;7122;150209;128977;8220;388849;84861;7353;51586;2928;128989;5297;9127;9993;54584;91179;85376;8216;85359;8318;728229;5902,46
-1,1,22,18876630,21465659,2589029,54487;27037;9342;29801;65078;10587;1312;6545;8214;7290;421;2812;6899;5625;7625;79680;64976;6576;3053;8218;5413;80764;23617;400891;1399;7122;150209;128977;8220;388849;84861;7353;51586;2928;128989;5297;9127;9993;54584;91179;85376;8216;85359;8318;728229;5902,46
-1,1,22,18890042,21440455,2550413,54487;27037;9342;29801;65078;10587;1312;6545;8214;7290;421;2812;6899;5625;7625;79680;64976;6576;3053;8218;5413;80764;23617;400891;1399;7122;150209;128977;8220;388849;84861;7353;51586;2928;128989;5297;9127;9993;54584;91179;85376;8216;85359;8318;728229;5902,46
-1,1,22,18890162,21464056,2573894,54487;27037;9342;29801;65078;10587;1312;6545;8214;7290;421;2812;6899;5625;7625;79680;64976;6576;3053;8218;5413;80764;23617;400891;1399;7122;150209;128977;8220;388849;84861;7353;51586;2928;128989;5297;9127;9993;54584;91179;85376;8216;85359;8318;728229;5902,46
-1,1,22,18890162,21464056,2573894,54487;27037;9342;29801;65078;10587;1312;6545;8214;7290;421;2812;6899;5625;7625;79680;64976;6576;3053;8218;5413;80764;23617;400891;1399;7122;150209;128977;8220;388849;84861;7353;51586;2928;128989;5297;9127;9993;54584;91179;85376;8216;85359;8318;728229;5902,46
-1,1,22,18890221,21561468,2671247,54487;27037;9342;29801;65078;10587;1312;6545;8214;7290;421;2812;6899;5625;7625;79680;64976;6576;3053;8218;5413;80764;23617;400891;1399;7122;150209;128977;8220;388849;84861;7353;51586;2928;128989;5297;9127;9993;54584;91179;85376;8216;85359;8318;728229;5902,46
-1,1,22,18890221,21561468,2671247,54487;27037;9342;29801;65078;10587;1312;6545;8214;7290;421;2812;6899;5625;7625;79680;64976;6576;3053;8218;5413;80764;23617;400891;1399;7122;150209;128977;8220;388849;84861;7353;51586;2928;128989;5297;9127;9993;54584;91179;85376;8216;85359;8318;728229;5902,46
-1,1,22,18890221,21561468,2671247,54487;27037;9342;29801;65078;10587;1312;6545;8214;7290;421;2812;6899;5625;7625;79680;64976;6576;3053;8218;5413;80764;23617;400891;1399;7122;150209;128977;8220;388849;84861;7353;51586;2928;128989;5297;9127;9993;54584;91179;85376;8216;85359;8318;728229;5902,46
-1,1,22,18891526,21796215,2904689,54487;27037;9342;29801;65078;10587;1312;6545;8214;7290;421;2812;6899;5625;7625;79680;23119;64976;6576;3053;8218;5413;80764;23617;400891;1399;7122;150209;128977;8220;388849;84861;7353;51586;2928;128989;5297;9127;9993;54584;91179;85376;8216;440804;85359;8318;728229;5902,48
1,-1,22,18894339,19010683,116344,5625;8214,2
1,-1,22,18894339,19010683,116344,5625;8214,2
-1,1,22,18894339,20255110,1360771,54487;27037;5413;29801;65078;23617;10587;1312;7122;8214;7290;421;128977;8220;2812;388849;7353;2928;128989;6899;9993;54584;5625;79680;64976;8318;5902;6576;8218,29
-1,1,22,18894339,21440455,2546116,54487;27037;9342;29801;65078;10587;1312;6545;8214;7290;421;2812;6899;5625;7625;79680;64976;6576;3053;8218;5413;80764;23617;400891;1399;7122;150209;128977;8220;388849;84861;7353;51586;2928;128989;5297;9127;9993;54584;91179;85376;8216;85359;8318;728229;5902,46
-1,1,22,18894339,21440455,2546116,54487;27037;9342;29801;65078;10587;1312;6545;8214;7290;421;2812;6899;5625;7625;79680;64976;6576;3053;8218;5413;80764;23617;400891;1399;7122;150209;128977;8220;388849;84861;7353;51586;2928;128989;5297;9127;9993;54584;91179;85376;8216;85359;8318;728229;5902,46
1,1,22,18894339,21440455,2546116,54487;27037;9342;29801;65078;10587;1312;6545;8214;7290;421;2812;6899;5625;7625;79680;64976;6576;3053;8218;5413;80764;23617;400891;1399;7122;150209;128977;8220;388849;84861;7353;51586;2928;128989;5297;9127;9993;54584;91179;85376;8216;85359;8318;728229;5902,46
-1,1,22,18894339,21440455,2546116,54487;27037;9342;29801;65078;10587;1312;6545;8214;7290;421;2812;6899;5625;7625;79680;64976;6576;3053;8218;5413;80764;23617;400891;1399;7122;150209;128977;8220;388849;84861;7353;51586;2928;128989;5297;9127;9993;54584;91179;85376;8216;85359;8318;728229;5902,46
-1,1,22,18894339,21440455,2546116,54487;27037;9342;29801;65078;10587;1312;6545;8214;7290;421;2812;6899;5625;7625;79680;64976;6576;3053;8218;5413;80764;23617;400891;1399;7122;150209;128977;8220;388849;84861;7353;51586;2928;128989;5297;9127;9993;54584;91179;85376;8216;85359;8318;728229;5902,46
-1,1,22,18894339,21440455,2546116,54487;27037;9342;29801;65078;10587;1312;6545;8214;7290;421;2812;6899;5625;7625;79680;64976;6576;3053;8218;5413;80764;23617;400891;1399;7122;150209;128977;8220;388849;84861;7353;51586;2928;128989;5297;9127;9993;54584;91179;85376;8216;85359;8318;728229;5902,46
-1,1,22,18894339,21440455,2546116,54487;27037;9342;29801;65078;10587;1312;6545;8214;7290;421;2812;6899;5625;7625;79680;64976;6576;3053;8218;5413;80764;23617;400891;1399;7122;150209;128977;8220;388849;84861;7353;51586;2928;128989;5297;9127;9993;54584;91179;85376;8216;85359;8318;728229;5902,46
-1,1,22,18894339,21440455,2546116,54487;27037;9342;29801;65078;10587;1312;6545;8214;7290;421;2812;6899;5625;7625;79680;64976;6576;3053;8218;5413;80764;23617;400891;1399;7122;150209;128977;8220;388849;84861;7353;51586;2928;128989;5297;9127;9993;54584;91179;85376;8216;85359;8318;728229;5902,46
-1,1,22,18894820,21440515,2545695,54487;27037;9342;29801;65078;10587;1312;6545;8214;7290;421;2812;6899;5625;7625;79680;64976;6576;3053;8218;5413;80764;23617;400891;1399;7122;150209;128977;8220;388849;84861;7353;51586;2928;128989;5297;9127;9993;54584;91179;85376;8216;85359;8318;728229;5902,46
-1,1,22,18894820,21440515,2545695,54487;27037;9342;29801;65078;10587;1312;6545;8214;7290;421;2812;6899;5625;7625;79680;64976;6576;3053;8218;5413;80764;23617;400891;1399;7122;150209;128977;8220;388849;84861;7353;51586;2928;128989;5297;9127;9993;54584;91179;85376;8216;85359;8318;728229;5902,46
-1,1,22,18894820,21440515,2545695,54487;27037;9342;29801;65078;10587;1312;6545;8214;7290;421;2812;6899;5625;7625;79680;64976;6576;3053;8218;5413;80764;23617;400891;1399;7122;150209;128977;8220;388849;84861;7353;51586;2928;128989;5297;9127;9993;54584;91179;85376;8216;85359;8318;728229;5902,46
-1,1,22,18894820,21440515,2545695,54487;27037;9342;29801;65078;10587;1312;6545;8214;7290;421;2812;6899;5625;7625;79680;64976;6576;3053;8218;5413;80764;23617;400891;1399;7122;150209;128977;8220;388849;84861;7353;51586;2928;128989;5297;9127;9993;54584;91179;85376;8216;85359;8318;728229;5902,46
1,1,22,18894820,21440515,2545695,54487;27037;9342;29801;65078;10587;1312;6545;8214;7290;421;2812;6899;5625;7625;79680;64976;6576;3053;8218;5413;80764;23617;400891;1399;7122;150209;128977;8220;388849;84861;7353;51586;2928;128989;5297;9127;9993;54584;91179;85376;8216;85359;8318;728229;5902,46
-1,1,22,18894820,21440515,2545695,54487;27037;9342;29801;65078;10587;1312;6545;8214;7290;421;2812;6899;5625;7625;79680;64976;6576;3053;8218;5413;80764;23617;400891;1399;7122;150209;128977;8220;388849;84861;7353;51586;2928;128989;5297;9127;9993;54584;91179;85376;8216;85359;8318;728229;5902,46
-1,1,22,18894820,21440515,2545695,54487;27037;9342;29801;65078;10587;1312;6545;8214;7290;421;2812;6899;5625;7625;79680;64976;6576;3053;8218;5413;80764;23617;400891;1399;7122;150209;128977;8220;388849;84861;7353;51586;2928;128989;5297;9127;9993;54584;91179;85376;8216;85359;8318;728229;5902,46
-1,1,22,18894820,21440515,2545695,54487;27037;9342;29801;65078;10587;1312;6545;8214;7290;421;2812;6899;5625;7625;79680;64976;6576;3053;8218;5413;80764;23617;400891;1399;7122;150209;128977;8220;388849;84861;7353;51586;2928;128989;5297;9127;9993;54584;91179;85376;8216;85359;8318;728229;5902,46
-1,1,22,18894820,21440515,2545695,54487;27037;9342;29801;65078;10587;1312;6545;8214;7290;421;2812;6899;5625;7625;79680;64976;6576;3053;8218;5413;80764;23617;400891;1399;7122;150209;128977;8220;388849;84861;7353;51586;2928;128989;5297;9127;9993;54584;91179;85376;8216;85359;8318;728229;5902,46
-1,1,22,18894820,21440515,2545695,54487;27037;9342;29801;65078;10587;1312;6545;8214;7290;421;2812;6899;5625;7625;79680;64976;6576;3053;8218;5413;80764;23617;400891;1399;7122;150209;128977;8220;388849;84861;7353;51586;2928;128989;5297;9127;9993;54584;91179;85376;8216;85359;8318;728229;5902,46
-1,1,22,18894820,21440515,2545695,54487;27037;9342;29801;65078;10587;1312;6545;8214;7290;421;2812;6899;5625;7625;79680;64976;6576;3053;8218;5413;80764;23617;400891;1399;7122;150209;128977;8220;388849;84861;7353;51586;2928;128989;5297;9127;9993;54584;91179;85376;8216;85359;8318;728229;5902,46
1,1,22,18894820,21440515,2545695,54487;27037;9342;29801;65078;10587;1312;6545;8214;7290;421;2812;6899;5625;7625;79680;64976;6576;3053;8218;5413;80764;23617;400891;1399;7122;150209;128977;8220;388849;84861;7353;51586;2928;128989;5297;9127;9993;54584;91179;85376;8216;85359;8318;728229;5902,46
-1,1,22,18894820,21440515,2545695,54487;27037;9342;29801;65078;10587;1312;6545;8214;7290;421;2812;6899;5625;7625;79680;64976;6576;3053;8218;5413;80764;23617;400891;1399;7122;150209;128977;8220;388849;84861;7353;51586;2928;128989;5297;9127;9993;54584;91179;85376;8216;85359;8318;728229;5902,46
-1,1,22,18894820,21440515,2545695,54487;27037;9342;29801;65078;10587;1312;6545;8214;7290;421;2812;6899;5625;7625;79680;64976;6576;3053;8218;5413;80764;23617;400891;1399;7122;150209;128977;8220;388849;84861;7353;51586;2928;128989;5297;9127;9993;54584;91179;85376;8216;85359;8318;728229;5902,46
1,1,22,18894820,21505445,2610625,54487;27037;9342;29801;65078;10587;1312;6545;8214;7290;421;2812;6899;5625;7625;79680;64976;6576;3053;8218;5413;80764;23617;400891;1399;7122;150209;128977;8220;388849;84861;7353;51586;2928;128989;5297;9127;9993;54584;91179;85376;8216;85359;8318;728229;5902,46
-1,1,22,18894835,20238206,1343371,54487;27037;5413;29801;65078;23617;10587;1312;7122;8214;7290;421;128977;8220;2812;388849;7353;2928;128989;6899;9993;54584;5625;79680;64976;8318;5902;6576;8218,29
1,1,22,18894835,20311784,1416949,54487;27037;5413;29801;65078;23617;10587;1312;7122;8214;7290;421;128977;8220;2812;388849;7353;2928;128989;6899;9993;54584;5625;79680;85359;64976;8318;5902;6576;8218,30
-1,1,22,18894835,20659606,1764771,54487;27037;29801;65078;10587;1312;8214;7290;421;2812;6899;5625;79680;64976;6576;8218;5413;23617;7122;128977;8220;388849;7353;2928;128989;9993;54584;85376;85359;8318;728229;5902,32
-1,1,22,18894835,20659606,1764771,54487;27037;29801;65078;10587;1312;8214;7290;421;2812;6899;5625;79680;64976;6576;8218;5413;23617;7122;128977;8220;388849;7353;2928;128989;9993;54584;85376;85359;8318;728229;5902,32
-1,1,22,18894835,20659606,1764771,54487;27037;29801;65078;10587;1312;8214;7290;421;2812;6899;5625;79680;64976;6576;8218;5413;23617;7122;128977;8220;388849;7353;2928;128989;9993;54584;85376;85359;8318;728229;5902,32
-1,1,22,18894835,20659606,1764771,54487;27037;29801;65078;10587;1312;8214;7290;421;2812;6899;5625;79680;64976;6576;8218;5413;23617;7122;128977;8220;388849;7353;2928;128989;9993;54584;85376;85359;8318;728229;5902,32
-1,1,22,18894835,20659606,1764771,54487;27037;29801;65078;10587;1312;8214;7290;421;2812;6899;5625;79680;64976;6576;8218;5413;23617;7122;128977;8220;388849;7353;2928;128989;9993;54584;85376;85359;8318;728229;5902,32
-1,1,22,18894835,21461752,2566917,54487;27037;9342;29801;65078;10587;1312;6545;8214;7290;421;2812;6899;5625;7625;79680;64976;6576;3053;8218;5413;80764;23617;400891;1399;7122;150209;128977;8220;388849;84861;7353;51586;2928;128989;5297;9127;9993;54584;91179;85376;8216;85359;8318;728229;5902,46
1,1,22,18894835,21461752,2566917,54487;27037;9342;29801;65078;10587;1312;6545;8214;7290;421;2812;6899;5625;7625;79680;64976;6576;3053;8218;5413;80764;23617;400891;1399;7122;150209;128977;8220;388849;84861;7353;51586;2928;128989;5297;9127;9993;54584;91179;85376;8216;85359;8318;728229;5902,46
1,1,22,18894835,21461752,2566917,54487;27037;9342;29801;65078;10587;1312;6545;8214;7290;421;2812;6899;5625;7625;79680;64976;6576;3053;8218;5413;80764;23617;400891;1399;7122;150209;128977;8220;388849;84861;7353;51586;2928;128989;5297;9127;9993;54584;91179;85376;8216;85359;8318;728229;5902,46
-1,1,22,18894835,21461752,2566917,54487;27037;9342;29801;65078;10587;1312;6545;8214;7290;421;2812;6899;5625;7625;79680;64976;6576;3053;8218;5413;80764;23617;400891;1399;7122;150209;128977;8220;388849;84861;7353;51586;2928;128989;5297;9127;9993;54584;91179;85376;8216;85359;8318;728229;5902,46
-1,1,22,18894835,21461752,2566917,54487;27037;9342;29801;65078;10587;1312;6545;8214;7290;421;2812;6899;5625;7625;79680;64976;6576;3053;8218;5413;80764;23617;400891;1399;7122;150209;128977;8220;388849;84861;7353;51586;2928;128989;5297;9127;9993;54584;91179;85376;8216;85359;8318;728229;5902,46
-1,1,22,18894835,21461752,2566917,54487;27037;9342;29801;65078;10587;1312;6545;8214;7290;421;2812;6899;5625;7625;79680;64976;6576;3053;8218;5413;80764;23617;400891;1399;7122;150209;128977;8220;388849;84861;7353;51586;2928;128989;5297;9127;9993;54584;91179;85376;8216;85359;8318;728229;5902,46
-1,1,22,18894835,21461752,2566917,54487;27037;9342;29801;65078;10587;1312;6545;8214;7290;421;2812;6899;5625;7625;79680;64976;6576;3053;8218;5413;80764;23617;400891;1399;7122;150209;128977;8220;388849;84861;7353;51586;2928;128989;5297;9127;9993;54584;91179;85376;8216;85359;8318;728229;5902,46
-1,1,22,18894835,21461811,2566976,54487;27037;9342;29801;65078;10587;1312;6545;8214;7290;421;2812;6899;5625;7625;79680;64976;6576;3053;8218;5413;80764;23617;400891;1399;7122;150209;128977;8220;388849;84861;7353;51586;2928;128989;5297;9127;9993;54584;91179;85376;8216;85359;8318;728229;5902,46
-1,1,22,18894835,21464119,2569284,54487;27037;9342;29801;65078;10587;1312;6545;8214;7290;421;2812;6899;5625;7625;79680;64976;6576;3053;8218;5413;80764;23617;400891;1399;7122;150209;128977;8220;388849;84861;7353;51586;2928;128989;5297;9127;9993;54584;91179;85376;8216;85359;8318;728229;5902,46
-1,1,22,18894835,21505417,2610582,54487;27037;9342;29801;65078;10587;1312;6545;8214;7290;421;2812;6899;5625;7625;79680;64976;6576;3053;8218;5413;80764;23617;400891;1399;7122;150209;128977;8220;388849;84861;7353;51586;2928;128989;5297;9127;9993;54584;91179;85376;8216;85359;8318;728229;5902,46
1,1,22,18894835,21505417,2610582,54487;27037;9342;29801;65078;10587;1312;6545;8214;7290;421;2812;6899;5625;7625;79680;64976;6576;3053;8218;5413;80764;23617;400891;1399;7122;150209;128977;8220;388849;84861;7353;51586;2928;128989;5297;9127;9993;54584;91179;85376;8216;85359;8318;728229;5902,46
-1,1,22,18894835,21505417,2610582,54487;27037;9342;29801;65078;10587;1312;6545;8214;7290;421;2812;6899;5625;7625;79680;64976;6576;3053;8218;5413;80764;23617;400891;1399;7122;150209;128977;8220;388849;84861;7353;51586;2928;128989;5297;9127;9993;54584;91179;85376;8216;85359;8318;728229;5902,46
1,1,22,18894835,21505417,2610582,54487;27037;9342;29801;65078;10587;1312;6545;8214;7290;421;2812;6899;5625;7625;79680;64976;6576;3053;8218;5413;80764;23617;400891;1399;7122;150209;128977;8220;388849;84861;7353;51586;2928;128989;5297;9127;9993;54584;91179;85376;8216;85359;8318;728229;5902,46
1,1,22,18894835,21505417,2610582,54487;27037;9342;29801;65078;10587;1312;6545;8214;7290;421;2812;6899;5625;7625;79680;64976;6576;3053;8218;5413;80764;23617;400891;1399;7122;150209;128977;8220;388849;84861;7353;51586;2928;128989;5297;9127;9993;54584;91179;85376;8216;85359;8318;728229;5902,46
-1,1,22,18894835,21505417,2610582,54487;27037;9342;29801;65078;10587;1312;6545;8214;7290;421;2812;6899;5625;7625;79680;64976;6576;3053;8218;5413;80764;23617;400891;1399;7122;150209;128977;8220;388849;84861;7353;51586;2928;128989;5297;9127;9993;54584;91179;85376;8216;85359;8318;728229;5902,46
1,1,22,18894835,21505417,2610582,54487;27037;9342;29801;65078;10587;1312;6545;8214;7290;421;2812;6899;5625;7625;79680;64976;6576;3053;8218;5413;80764;23617;400891;1399;7122;150209;128977;8220;388849;84861;7353;51586;2928;128989;5297;9127;9993;54584;91179;85376;8216;85359;8318;728229;5902,46
-1,1,22,18894835,21505417,2610582,54487;27037;9342;29801;65078;10587;1312;6545;8214;7290;421;2812;6899;5625;7625;79680;64976;6576;3053;8218;5413;80764;23617;400891;1399;7122;150209;128977;8220;388849;84861;7353;51586;2928;128989;5297;9127;9993;54584;91179;85376;8216;85359;8318;728229;5902,46
1,1,22,18894835,21505417,2610582,54487;27037;9342;29801;65078;10587;1312;6545;8214;7290;421;2812;6899;5625;7625;79680;64976;6576;3053;8218;5413;80764;23617;400891;1399;7122;150209;128977;8220;388849;84861;7353;51586;2928;128989;5297;9127;9993;54584;91179;85376;8216;85359;8318;728229;5902,46
-1,1,22,18894835,21505417,2610582,54487;27037;9342;29801;65078;10587;1312;6545;8214;7290;421;2812;6899;5625;7625;79680;64976;6576;3053;8218;5413;80764;23617;400891;1399;7122;150209;128977;8220;388849;84861;7353;51586;2928;128989;5297;9127;9993;54584;91179;85376;8216;85359;8318;728229;5902,46
1,1,22,18894835,21505417,2610582,54487;27037;9342;29801;65078;10587;1312;6545;8214;7290;421;2812;6899;5625;7625;79680;64976;6576;3053;8218;5413;80764;23617;400891;1399;7122;150209;128977;8220;388849;84861;7353;51586;2928;128989;5297;9127;9993;54584;91179;85376;8216;85359;8318;728229;5902,46
1,1,22,18894835,21505417,2610582,54487;27037;9342;29801;65078;10587;1312;6545;8214;7290;421;2812;6899;5625;7625;79680;64976;6576;3053;8218;5413;80764;23617;400891;1399;7122;150209;128977;8220;388849;84861;7353;51586;2928;128989;5297;9127;9993;54584;91179;85376;8216;85359;8318;728229;5902,46
1,1,22,18894835,21505417,2610582,54487;27037;9342;29801;65078;10587;1312;6545;8214;7290;421;2812;6899;5625;7625;79680;64976;6576;3053;8218;5413;80764;23617;400891;1399;7122;150209;128977;8220;388849;84861;7353;51586;2928;128989;5297;9127;9993;54584;91179;85376;8216;85359;8318;728229;5902,46
-1,1,22,18894835,21505417,2610582,54487;27037;9342;29801;65078;10587;1312;6545;8214;7290;421;2812;6899;5625;7625;79680;64976;6576;3053;8218;5413;80764;23617;400891;1399;7122;150209;128977;8220;388849;84861;7353;51586;2928;128989;5297;9127;9993;54584;91179;85376;8216;85359;8318;728229;5902,46
1,1,22,18894835,21505417,2610582,54487;27037;9342;29801;65078;10587;1312;6545;8214;7290;421;2812;6899;5625;7625;79680;64976;6576;3053;8218;5413;80764;23617;400891;1399;7122;150209;128977;8220;388849;84861;7353;51586;2928;128989;5297;9127;9993;54584;91179;85376;8216;85359;8318;728229;5902,46
1,1,22,18894835,21505417,2610582,54487;27037;9342;29801;65078;10587;1312;6545;8214;7290;421;2812;6899;5625;7625;79680;64976;6576;3053;8218;5413;80764;23617;400891;1399;7122;150209;128977;8220;388849;84861;7353;51586;2928;128989;5297;9127;9993;54584;91179;85376;8216;85359;8318;728229;5902,46
1,1,22,18894835,21505417,2610582,54487;27037;9342;29801;65078;10587;1312;6545;8214;7290;421;2812;6899;5625;7625;79680;64976;6576;3053;8218;5413;80764;23617;400891;1399;7122;150209;128977;8220;388849;84861;7353;51586;2928;128989;5297;9127;9993;54584;91179;85376;8216;85359;8318;728229;5902,46
-1,1,22,18894835,21505417,2610582,54487;27037;9342;29801;65078;10587;1312;6545;8214;7290;421;2812;6899;5625;7625;79680;64976;6576;3053;8218;5413;80764;23617;400891;1399;7122;150209;128977;8220;388849;84861;7353;51586;2928;128989;5297;9127;9993;54584;91179;85376;8216;85359;8318;728229;5902,46
1,1,22,18894835,21505417,2610582,54487;27037;9342;29801;65078;10587;1312;6545;8214;7290;421;2812;6899;5625;7625;79680;64976;6576;3053;8218;5413;80764;23617;400891;1399;7122;150209;128977;8220;388849;84861;7353;51586;2928;128989;5297;9127;9993;54584;91179;85376;8216;85359;8318;728229;5902,46
1,1,22,18894835,21505417,2610582,54487;27037;9342;29801;65078;10587;1312;6545;8214;7290;421;2812;6899;5625;7625;79680;64976;6576;3053;8218;5413;80764;23617;400891;1399;7122;150209;128977;8220;388849;84861;7353;51586;2928;128989;5297;9127;9993;54584;91179;85376;8216;85359;8318;728229;5902,46
1,1,22,18894835,21505417,2610582,54487;27037;9342;29801;65078;10587;1312;6545;8214;7290;421;2812;6899;5625;7625;79680;64976;6576;3053;8218;5413;80764;23617;400891;1399;7122;150209;128977;8220;388849;84861;7353;51586;2928;128989;5297;9127;9993;54584;91179;85376;8216;85359;8318;728229;5902,46
1,1,22,18894835,21505417,2610582,54487;27037;9342;29801;65078;10587;1312;6545;8214;7290;421;2812;6899;5625;7625;79680;64976;6576;3053;8218;5413;80764;23617;400891;1399;7122;150209;128977;8220;388849;84861;7353;51586;2928;128989;5297;9127;9993;54584;91179;85376;8216;85359;8318;728229;5902,46
1,1,22,18894835,21505417,2610582,54487;27037;9342;29801;65078;10587;1312;6545;8214;7290;421;2812;6899;5625;7625;79680;64976;6576;3053;8218;5413;80764;23617;400891;1399;7122;150209;128977;8220;388849;84861;7353;51586;2928;128989;5297;9127;9993;54584;91179;85376;8216;85359;8318;728229;5902,46
-1,1,22,18894835,21505417,2610582,54487;27037;9342;29801;65078;10587;1312;6545;8214;7290;421;2812;6899;5625;7625;79680;64976;6576;3053;8218;5413;80764;23617;400891;1399;7122;150209;128977;8220;388849;84861;7353;51586;2928;128989;5297;9127;9993;54584;91179;85376;8216;85359;8318;728229;5902,46
-1,1,22,18894835,21505417,2610582,54487;27037;9342;29801;65078;10587;1312;6545;8214;7290;421;2812;6899;5625;7625;79680;64976;6576;3053;8218;5413;80764;23617;400891;1399;7122;150209;128977;8220;388849;84861;7353;51586;2928;128989;5297;9127;9993;54584;91179;85376;8216;85359;8318;728229;5902,46
1,1,22,18894835,21505417,2610582,54487;27037;9342;29801;65078;10587;1312;6545;8214;7290;421;2812;6899;5625;7625;79680;64976;6576;3053;8218;5413;80764;23617;400891;1399;7122;150209;128977;8220;388849;84861;7353;51586;2928;128989;5297;9127;9993;54584;91179;85376;8216;85359;8318;728229;5902,46
-1,1,22,18894835,21561514,2666679,54487;27037;9342;29801;65078;10587;1312;6545;8214;7290;421;2812;6899;5625;7625;79680;64976;6576;3053;8218;5413;80764;23617;400891;1399;7122;150209;128977;8220;388849;84861;7353;51586;2928;128989;5297;9127;9993;54584;91179;85376;8216;85359;8318;728229;5902,46
1,1,22,18894835,21561514,2666679,54487;27037;9342;29801;65078;10587;1312;6545;8214;7290;421;2812;6899;5625;7625;79680;64976;6576;3053;8218;5413;80764;23617;400891;1399;7122;150209;128977;8220;388849;84861;7353;51586;2928;128989;5297;9127;9993;54584;91179;85376;8216;85359;8318;728229;5902,46
1,1,22,18894835,21561514,2666679,54487;27037;9342;29801;65078;10587;1312;6545;8214;7290;421;2812;6899;5625;7625;79680;64976;6576;3053;8218;5413;80764;23617;400891;1399;7122;150209;128977;8220;388849;84861;7353;51586;2928;128989;5297;9127;9993;54584;91179;85376;8216;85359;8318;728229;5902,46
1,1,22,18894835,21561514,2666679,54487;27037;9342;29801;65078;10587;1312;6545;8214;7290;421;2812;6899;5625;7625;79680;64976;6576;3053;8218;5413;80764;23617;400891;1399;7122;150209;128977;8220;388849;84861;7353;51586;2928;128989;5297;9127;9993;54584;91179;85376;8216;85359;8318;728229;5902,46
1,1,22,18894835,21561514,2666679,54487;27037;9342;29801;65078;10587;1312;6545;8214;7290;421;2812;6899;5625;7625;79680;64976;6576;3053;8218;5413;80764;23617;400891;1399;7122;150209;128977;8220;388849;84861;7353;51586;2928;128989;5297;9127;9993;54584;91179;85376;8216;85359;8318;728229;5902,46
1,1,22,18894835,21561514,2666679,54487;27037;9342;29801;65078;10587;1312;6545;8214;7290;421;2812;6899;5625;7625;79680;64976;6576;3053;8218;5413;80764;23617;400891;1399;7122;150209;128977;8220;388849;84861;7353;51586;2928;128989;5297;9127;9993;54584;91179;85376;8216;85359;8318;728229;5902,46
1,1,22,18894835,21561514,2666679,54487;27037;9342;29801;65078;10587;1312;6545;8214;7290;421;2812;6899;5625;7625;79680;64976;6576;3053;8218;5413;80764;23617;400891;1399;7122;150209;128977;8220;388849;84861;7353;51586;2928;128989;5297;9127;9993;54584;91179;85376;8216;85359;8318;728229;5902,46
1,1,22,18894835,21561514,2666679,54487;27037;9342;29801;65078;10587;1312;6545;8214;7290;421;2812;6899;5625;7625;79680;64976;6576;3053;8218;5413;80764;23617;400891;1399;7122;150209;128977;8220;388849;84861;7353;51586;2928;128989;5297;9127;9993;54584;91179;85376;8216;85359;8318;728229;5902,46
1,1,22,18894835,21561514,2666679,54487;27037;9342;29801;65078;10587;1312;6545;8214;7290;421;2812;6899;5625;7625;79680;64976;6576;3053;8218;5413;80764;23617;400891;1399;7122;150209;128977;8220;388849;84861;7353;51586;2928;128989;5297;9127;9993;54584;91179;85376;8216;85359;8318;728229;5902,46
1,1,22,18894835,21809009,2914174,54487;27037;9342;29801;65078;10587;1312;6545;8214;7290;421;2812;6899;5625;7625;79680;23119;64976;6576;3053;8218;5413;80764;23617;400891;1399;7122;150209;128977;8220;388849;84861;7353;51586;2928;128989;5297;9127;9993;54584;91179;85376;8216;440804;85359;8318;728229;5902,48
1,1,22,18894835,21809009,2914174,54487;27037;9342;29801;65078;10587;1312;6545;8214;7290;421;2812;6899;5625;7625;79680;23119;64976;6576;3053;8218;5413;80764;23617;400891;1399;7122;150209;128977;8220;388849;84861;7353;51586;2928;128989;5297;9127;9993;54584;91179;85376;8216;440804;85359;8318;728229;5902,48
1,1,22,18894835,21809009,2914174,54487;27037;9342;29801;65078;10587;1312;6545;8214;7290;421;2812;6899;5625;7625;79680;23119;64976;6576;3053;8218;5413;80764;23617;400891;1399;7122;150209;128977;8220;388849;84861;7353;51586;2928;128989;5297;9127;9993;54584;91179;85376;8216;440804;85359;8318;728229;5902,48
1,1,22,18894835,21809009,2914174,54487;27037;9342;29801;65078;10587;1312;6545;8214;7290;421;2812;6899;5625;7625;79680;23119;64976;6576;3053;8218;5413;80764;23617;400891;1399;7122;150209;128977;8220;388849;84861;7353;51586;2928;128989;5297;9127;9993;54584;91179;85376;8216;440804;85359;8318;728229;5902,48
-1,1,22,18896972,20311763,1414791,54487;27037;5413;29801;65078;23617;10587;1312;7122;8214;7290;421;128977;8220;2812;388849;7353;2928;128989;6899;9993;54584;5625;79680;85359;64976;8318;5902;6576;8218,30
-1,1,22,18896972,21382953,2485981,54487;27037;9342;29801;65078;10587;1312;8214;7290;421;2812;6899;5625;7625;79680;64976;6576;3053;8218;5413;80764;23617;1399;7122;150209;128977;8220;388849;84861;7353;51586;2928;128989;5297;9127;9993;54584;91179;85376;8216;85359;8318;728229;5902,44
-1,1,22,18896972,21382953,2485981,54487;27037;9342;29801;65078;10587;1312;8214;7290;421;2812;6899;5625;7625;79680;64976;6576;3053;8218;5413;80764;23617;1399;7122;150209;128977;8220;388849;84861;7353;51586;2928;128989;5297;9127;9993;54584;91179;85376;8216;85359;8318;728229;5902,44
-1,1,22,18896972,21382953,2485981,54487;27037;9342;29801;65078;10587;1312;8214;7290;421;2812;6899;5625;7625;79680;64976;6576;3053;8218;5413;80764;23617;1399;7122;150209;128977;8220;388849;84861;7353;51586;2928;128989;5297;9127;9993;54584;91179;85376;8216;85359;8318;728229;5902,44
1,1,22,18908832,21358123,2449291,54487;27037;9342;29801;65078;10587;1312;7290;421;2812;6899;5625;7625;79680;64976;6576;3053;8218;5413;80764;23617;1399;7122;150209;128977;8220;388849;84861;7353;51586;2928;128989;5297;9993;54584;91179;85376;8216;85359;8318;728229;5902,42
-1,1,22,18916827,21465662,2548835,54487;27037;9342;29801;65078;10587;1312;6545;7290;421;2812;6899;5625;7625;79680;64976;6576;3053;8218;5413;80764;23617;400891;1399;7122;150209;128977;8220;388849;84861;7353;51586;2928;128989;5297;9127;9993;54584;91179;85376;8216;85359;8318;728229;5902,45
-1,1,22,18916827,21465662,2548835,54487;27037;9342;29801;65078;10587;1312;6545;7290;421;2812;6899;5625;7625;79680;64976;6576;3053;8218;5413;80764;23617;400891;1399;7122;150209;128977;8220;388849;84861;7353;51586;2928;128989;5297;9127;9993;54584;91179;85376;8216;85359;8318;728229;5902,45
-1,1,22,18916827,21465662,2548835,54487;27037;9342;29801;65078;10587;1312;6545;7290;421;2812;6899;5625;7625;79680;64976;6576;3053;8218;5413;80764;23617;400891;1399;7122;150209;128977;8220;388849;84861;7353;51586;2928;128989;5297;9127;9993;54584;91179;85376;8216;85359;8318;728229;5902,45
1,1,22,18916828,20312661,1395833,54487;27037;5413;29801;65078;23617;10587;1312;7122;7290;421;128977;8220;2812;388849;7353;2928;128989;6899;9993;54584;5625;79680;85359;64976;8318;5902;6576;8218,29
-1,1,22,18916828,20312661,1395833,54487;27037;5413;29801;65078;23617;10587;1312;7122;7290;421;128977;8220;2812;388849;7353;2928;128989;6899;9993;54584;5625;79680;85359;64976;8318;5902;6576;8218,29
-1,1,22,18916828,21041014,2124186,54487;27037;29801;65078;10587;1312;7290;421;2812;6899;5625;7625;79680;64976;6576;8218;5413;23617;7122;128977;8220;388849;84861;7353;51586;2928;128989;9993;54584;91179;85376;85359;8318;728229;5902,35
-1,1,22,18916828,21041014,2124186,54487;27037;29801;65078;10587;1312;7290;421;2812;6899;5625;7625;79680;64976;6576;8218;5413;23617;7122;128977;8220;388849;84861;7353;51586;2928;128989;9993;54584;91179;85376;85359;8318;728229;5902,35
-1,1,22,18916828,21049800,2132972,54487;27037;29801;65078;10587;1312;7290;421;2812;6899;5625;7625;79680;64976;6576;8218;5413;23617;7122;128977;8220;388849;84861;7353;51586;2928;128989;9993;54584;91179;85376;85359;8318;728229;5902,35
1,1,22,18916828,21465659,2548831,54487;27037;9342;29801;65078;10587;1312;6545;7290;421;2812;6899;5625;7625;79680;64976;6576;3053;8218;5413;80764;23617;400891;1399;7122;150209;128977;8220;388849;84861;7353;51586;2928;128989;5297;9127;9993;54584;91179;85376;8216;85359;8318;728229;5902,45
1,1,22,18916828,21465659,2548831,54487;27037;9342;29801;65078;10587;1312;6545;7290;421;2812;6899;5625;7625;79680;64976;6576;3053;8218;5413;80764;23617;400891;1399;7122;150209;128977;8220;388849;84861;7353;51586;2928;128989;5297;9127;9993;54584;91179;85376;8216;85359;8318;728229;5902,45
1,1,22,18916828,21465659,2548831,54487;27037;9342;29801;65078;10587;1312;6545;7290;421;2812;6899;5625;7625;79680;64976;6576;3053;8218;5413;80764;23617;400891;1399;7122;150209;128977;8220;388849;84861;7353;51586;2928;128989;5297;9127;9993;54584;91179;85376;8216;85359;8318;728229;5902,45
-1,1,22,18916828,21465659,2548831,54487;27037;9342;29801;65078;10587;1312;6545;7290;421;2812;6899;5625;7625;79680;64976;6576;3053;8218;5413;80764;23617;400891;1399;7122;150209;128977;8220;388849;84861;7353;51586;2928;128989;5297;9127;9993;54584;91179;85376;8216;85359;8318;728229;5902,45
1,1,22,18916828,21465659,2548831,54487;27037;9342;29801;65078;10587;1312;6545;7290;421;2812;6899;5625;7625;79680;64976;6576;3053;8218;5413;80764;23617;400891;1399;7122;150209;128977;8220;388849;84861;7353;51586;2928;128989;5297;9127;9993;54584;91179;85376;8216;85359;8318;728229;5902,45
1,1,22,18916828,21465659,2548831,54487;27037;9342;29801;65078;10587;1312;6545;7290;421;2812;6899;5625;7625;79680;64976;6576;3053;8218;5413;80764;23617;400891;1399;7122;150209;128977;8220;388849;84861;7353;51586;2928;128989;5297;9127;9993;54584;91179;85376;8216;85359;8318;728229;5902,45
1,1,22,18916828,21465659,2548831,54487;27037;9342;29801;65078;10587;1312;6545;7290;421;2812;6899;5625;7625;79680;64976;6576;3053;8218;5413;80764;23617;400891;1399;7122;150209;128977;8220;388849;84861;7353;51586;2928;128989;5297;9127;9993;54584;91179;85376;8216;85359;8318;728229;5902,45
-1,1,22,18916828,21465659,2548831,54487;27037;9342;29801;65078;10587;1312;6545;7290;421;2812;6899;5625;7625;79680;64976;6576;3053;8218;5413;80764;23617;400891;1399;7122;150209;128977;8220;388849;84861;7353;51586;2928;128989;5297;9127;9993;54584;91179;85376;8216;85359;8318;728229;5902,45
1,1,22,18916828,21465659,2548831,54487;27037;9342;29801;65078;10587;1312;6545;7290;421;2812;6899;5625;7625;79680;64976;6576;3053;8218;5413;80764;23617;400891;1399;7122;150209;128977;8220;388849;84861;7353;51586;2928;128989;5297;9127;9993;54584;91179;85376;8216;85359;8318;728229;5902,45
1,1,22,18916828,21465659,2548831,54487;27037;9342;29801;65078;10587;1312;6545;7290;421;2812;6899;5625;7625;79680;64976;6576;3053;8218;5413;80764;23617;400891;1399;7122;150209;128977;8220;388849;84861;7353;51586;2928;128989;5297;9127;9993;54584;91179;85376;8216;85359;8318;728229;5902,45
1,1,22,18916828,21465659,2548831,54487;27037;9342;29801;65078;10587;1312;6545;7290;421;2812;6899;5625;7625;79680;64976;6576;3053;8218;5413;80764;23617;400891;1399;7122;150209;128977;8220;388849;84861;7353;51586;2928;128989;5297;9127;9993;54584;91179;85376;8216;85359;8318;728229;5902,45
-1,1,22,18916828,21465662,2548834,54487;27037;9342;29801;65078;10587;1312;6545;7290;421;2812;6899;5625;7625;79680;64976;6576;3053;8218;5413;80764;23617;400891;1399;7122;150209;128977;8220;388849;84861;7353;51586;2928;128989;5297;9127;9993;54584;91179;85376;8216;85359;8318;728229;5902,45
-1,1,22,18916828,21465662,2548834,54487;27037;9342;29801;65078;10587;1312;6545;7290;421;2812;6899;5625;7625;79680;64976;6576;3053;8218;5413;80764;23617;400891;1399;7122;150209;128977;8220;388849;84861;7353;51586;2928;128989;5297;9127;9993;54584;91179;85376;8216;85359;8318;728229;5902,45
-1,1,22,18916828,21465662,2548834,54487;27037;9342;29801;65078;10587;1312;6545;7290;421;2812;6899;5625;7625;79680;64976;6576;3053;8218;5413;80764;23617;400891;1399;7122;150209;128977;8220;388849;84861;7353;51586;2928;128989;5297;9127;9993;54584;91179;85376;8216;85359;8318;728229;5902,45
-1,1,22,18916828,21465662,2548834,54487;27037;9342;29801;65078;10587;1312;6545;7290;421;2812;6899;5625;7625;79680;64976;6576;3053;8218;5413;80764;23617;400891;1399;7122;150209;128977;8220;388849;84861;7353;51586;2928;128989;5297;9127;9993;54584;91179;85376;8216;85359;8318;728229;5902,45
-1,1,22,18916828,21465662,2548834,54487;27037;9342;29801;65078;10587;1312;6545;7290;421;2812;6899;5625;7625;79680;64976;6576;3053;8218;5413;80764;23617;400891;1399;7122;150209;128977;8220;388849;84861;7353;51586;2928;128989;5297;9127;9993;54584;91179;85376;8216;85359;8318;728229;5902,45
-1,1,22,18916828,21465662,2548834,54487;27037;9342;29801;65078;10587;1312;6545;7290;421;2812;6899;5625;7625;79680;64976;6576;3053;8218;5413;80764;23617;400891;1399;7122;150209;128977;8220;388849;84861;7353;51586;2928;128989;5297;9127;9993;54584;91179;85376;8216;85359;8318;728229;5902,45
1,1,22,18916828,21465662,2548834,54487;27037;9342;29801;65078;10587;1312;6545;7290;421;2812;6899;5625;7625;79680;64976;6576;3053;8218;5413;80764;23617;400891;1399;7122;150209;128977;8220;388849;84861;7353;51586;2928;128989;5297;9127;9993;54584;91179;85376;8216;85359;8318;728229;5902,45
-1,1,22,18916828,21465662,2548834,54487;27037;9342;29801;65078;10587;1312;6545;7290;421;2812;6899;5625;7625;79680;64976;6576;3053;8218;5413;80764;23617;400891;1399;7122;150209;128977;8220;388849;84861;7353;51586;2928;128989;5297;9127;9993;54584;91179;85376;8216;85359;8318;728229;5902,45
-1,1,22,18916828,21465662,2548834,54487;27037;9342;29801;65078;10587;1312;6545;7290;421;2812;6899;5625;7625;79680;64976;6576;3053;8218;5413;80764;23617;400891;1399;7122;150209;128977;8220;388849;84861;7353;51586;2928;128989;5297;9127;9993;54584;91179;85376;8216;85359;8318;728229;5902,45
-1,1,22,18916828,21465662,2548834,54487;27037;9342;29801;65078;10587;1312;6545;7290;421;2812;6899;5625;7625;79680;64976;6576;3053;8218;5413;80764;23617;400891;1399;7122;150209;128977;8220;388849;84861;7353;51586;2928;128989;5297;9127;9993;54584;91179;85376;8216;85359;8318;728229;5902,45
-1,1,22,18916828,21465662,2548834,54487;27037;9342;29801;65078;10587;1312;6545;7290;421;2812;6899;5625;7625;79680;64976;6576;3053;8218;5413;80764;23617;400891;1399;7122;150209;128977;8220;388849;84861;7353;51586;2928;128989;5297;9127;9993;54584;91179;85376;8216;85359;8318;728229;5902,45
-1,1,22,18916828,21465662,2548834,54487;27037;9342;29801;65078;10587;1312;6545;7290;421;2812;6899;5625;7625;79680;64976;6576;3053;8218;5413;80764;23617;400891;1399;7122;150209;128977;8220;388849;84861;7353;51586;2928;128989;5297;9127;9993;54584;91179;85376;8216;85359;8318;728229;5902,45
-1,1,22,18916828,21465662,2548834,54487;27037;9342;29801;65078;10587;1312;6545;7290;421;2812;6899;5625;7625;79680;64976;6576;3053;8218;5413;80764;23617;400891;1399;7122;150209;128977;8220;388849;84861;7353;51586;2928;128989;5297;9127;9993;54584;91179;85376;8216;85359;8318;728229;5902,45
1,1,22,18916828,21465662,2548834,54487;27037;9342;29801;65078;10587;1312;6545;7290;421;2812;6899;5625;7625;79680;64976;6576;3053;8218;5413;80764;23617;400891;1399;7122;150209;128977;8220;388849;84861;7353;51586;2928;128989;5297;9127;9993;54584;91179;85376;8216;85359;8318;728229;5902,45
-1,1,22,18916828,21465662,2548834,54487;27037;9342;29801;65078;10587;1312;6545;7290;421;2812;6899;5625;7625;79680;64976;6576;3053;8218;5413;80764;23617;400891;1399;7122;150209;128977;8220;388849;84861;7353;51586;2928;128989;5297;9127;9993;54584;91179;85376;8216;85359;8318;728229;5902,45
-1,1,22,18916828,21465662,2548834,54487;27037;9342;29801;65078;10587;1312;6545;7290;421;2812;6899;5625;7625;79680;64976;6576;3053;8218;5413;80764;23617;400891;1399;7122;150209;128977;8220;388849;84861;7353;51586;2928;128989;5297;9127;9993;54584;91179;85376;8216;85359;8318;728229;5902,45
1,1,22,18916828,21465662,2548834,54487;27037;9342;29801;65078;10587;1312;6545;7290;421;2812;6899;5625;7625;79680;64976;6576;3053;8218;5413;80764;23617;400891;1399;7122;150209;128977;8220;388849;84861;7353;51586;2928;128989;5297;9127;9993;54584;91179;85376;8216;85359;8318;728229;5902,45
-1,1,22,18916828,21465662,2548834,54487;27037;9342;29801;65078;10587;1312;6545;7290;421;2812;6899;5625;7625;79680;64976;6576;3053;8218;5413;80764;23617;400891;1399;7122;150209;128977;8220;388849;84861;7353;51586;2928;128989;5297;9127;9993;54584;91179;85376;8216;85359;8318;728229;5902,45
-1,1,22,18916828,21465662,2548834,54487;27037;9342;29801;65078;10587;1312;6545;7290;421;2812;6899;5625;7625;79680;64976;6576;3053;8218;5413;80764;23617;400891;1399;7122;150209;128977;8220;388849;84861;7353;51586;2928;128989;5297;9127;9993;54584;91179;85376;8216;85359;8318;728229;5902,45
-1,1,22,18916828,21465662,2548834,54487;27037;9342;29801;65078;10587;1312;6545;7290;421;2812;6899;5625;7625;79680;64976;6576;3053;8218;5413;80764;23617;400891;1399;7122;150209;128977;8220;388849;84861;7353;51586;2928;128989;5297;9127;9993;54584;91179;85376;8216;85359;8318;728229;5902,45
-1,1,22,18916828,21465662,2548834,54487;27037;9342;29801;65078;10587;1312;6545;7290;421;2812;6899;5625;7625;79680;64976;6576;3053;8218;5413;80764;23617;400891;1399;7122;150209;128977;8220;388849;84861;7353;51586;2928;128989;5297;9127;9993;54584;91179;85376;8216;85359;8318;728229;5902,45
-1,1,22,18916828,21465662,2548834,54487;27037;9342;29801;65078;10587;1312;6545;7290;421;2812;6899;5625;7625;79680;64976;6576;3053;8218;5413;80764;23617;400891;1399;7122;150209;128977;8220;388849;84861;7353;51586;2928;128989;5297;9127;9993;54584;91179;85376;8216;85359;8318;728229;5902,45
-1,1,22,18916828,21465662,2548834,54487;27037;9342;29801;65078;10587;1312;6545;7290;421;2812;6899;5625;7625;79680;64976;6576;3053;8218;5413;80764;23617;400891;1399;7122;150209;128977;8220;388849;84861;7353;51586;2928;128989;5297;9127;9993;54584;91179;85376;8216;85359;8318;728229;5902,45
-1,1,22,18916828,21465662,2548834,54487;27037;9342;29801;65078;10587;1312;6545;7290;421;2812;6899;5625;7625;79680;64976;6576;3053;8218;5413;80764;23617;400891;1399;7122;150209;128977;8220;388849;84861;7353;51586;2928;128989;5297;9127;9993;54584;91179;85376;8216;85359;8318;728229;5902,45
1,1,22,18916828,21465662,2548834,54487;27037;9342;29801;65078;10587;1312;6545;7290;421;2812;6899;5625;7625;79680;64976;6576;3053;8218;5413;80764;23617;400891;1399;7122;150209;128977;8220;388849;84861;7353;51586;2928;128989;5297;9127;9993;54584;91179;85376;8216;85359;8318;728229;5902,45
1,1,22,18916828,21465662,2548834,54487;27037;9342;29801;65078;10587;1312;6545;7290;421;2812;6899;5625;7625;79680;64976;6576;3053;8218;5413;80764;23617;400891;1399;7122;150209;128977;8220;388849;84861;7353;51586;2928;128989;5297;9127;9993;54584;91179;85376;8216;85359;8318;728229;5902,45
-1,1,22,18916828,21465662,2548834,54487;27037;9342;29801;65078;10587;1312;6545;7290;421;2812;6899;5625;7625;79680;64976;6576;3053;8218;5413;80764;23617;400891;1399;7122;150209;128977;8220;388849;84861;7353;51586;2928;128989;5297;9127;9993;54584;91179;85376;8216;85359;8318;728229;5902,45
-1,1,22,18916828,21465662,2548834,54487;27037;9342;29801;65078;10587;1312;6545;7290;421;2812;6899;5625;7625;79680;64976;6576;3053;8218;5413;80764;23617;400891;1399;7122;150209;128977;8220;388849;84861;7353;51586;2928;128989;5297;9127;9993;54584;91179;85376;8216;85359;8318;728229;5902,45
1,1,22,18916828,21465662,2548834,54487;27037;9342;29801;65078;10587;1312;6545;7290;421;2812;6899;5625;7625;79680;64976;6576;3053;8218;5413;80764;23617;400891;1399;7122;150209;128977;8220;388849;84861;7353;51586;2928;128989;5297;9127;9993;54584;91179;85376;8216;85359;8318;728229;5902,45
-1,1,22,18916828,21465662,2548834,54487;27037;9342;29801;65078;10587;1312;6545;7290;421;2812;6899;5625;7625;79680;64976;6576;3053;8218;5413;80764;23617;400891;1399;7122;150209;128977;8220;388849;84861;7353;51586;2928;128989;5297;9127;9993;54584;91179;85376;8216;85359;8318;728229;5902,45
1,1,22,18916828,21465662,2548834,54487;27037;9342;29801;65078;10587;1312;6545;7290;421;2812;6899;5625;7625;79680;64976;6576;3053;8218;5413;80764;23617;400891;1399;7122;150209;128977;8220;388849;84861;7353;51586;2928;128989;5297;9127;9993;54584;91179;85376;8216;85359;8318;728229;5902,45
-1,1,22,18916828,21465662,2548834,54487;27037;9342;29801;65078;10587;1312;6545;7290;421;2812;6899;5625;7625;79680;64976;6576;3053;8218;5413;80764;23617;400891;1399;7122;150209;128977;8220;388849;84861;7353;51586;2928;128989;5297;9127;9993;54584;91179;85376;8216;85359;8318;728229;5902,45
-1,1,22,18916828,21465662,2548834,54487;27037;9342;29801;65078;10587;1312;6545;7290;421;2812;6899;5625;7625;79680;64976;6576;3053;8218;5413;80764;23617;400891;1399;7122;150209;128977;8220;388849;84861;7353;51586;2928;128989;5297;9127;9993;54584;91179;85376;8216;85359;8318;728229;5902,45
1,1,22,18916828,21465662,2548834,54487;27037;9342;29801;65078;10587;1312;6545;7290;421;2812;6899;5625;7625;79680;64976;6576;3053;8218;5413;80764;23617;400891;1399;7122;150209;128977;8220;388849;84861;7353;51586;2928;128989;5297;9127;9993;54584;91179;85376;8216;85359;8318;728229;5902,45
-1,1,22,18916842,19004772,87930,5625,1
-1,1,22,18916842,20311858,1395016,54487;27037;5413;29801;65078;23617;10587;1312;7122;7290;421;128977;8220;2812;388849;7353;2928;128989;6899;9993;54584;5625;79680;85359;64976;8318;5902;6576;8218,29
-1,1,22,18916842,20312661,1395819,54487;27037;5413;29801;65078;23617;10587;1312;7122;7290;421;128977;8220;2812;388849;7353;2928;128989;6899;9993;54584;5625;79680;85359;64976;8318;5902;6576;8218,29
1,1,22,18916842,20312661,1395819,54487;27037;5413;29801;65078;23617;10587;1312;7122;7290;421;128977;8220;2812;388849;7353;2928;128989;6899;9993;54584;5625;79680;85359;64976;8318;5902;6576;8218,29
1,1,22,18916842,20312661,1395819,54487;27037;5413;29801;65078;23617;10587;1312;7122;7290;421;128977;8220;2812;388849;7353;2928;128989;6899;9993;54584;5625;79680;85359;64976;8318;5902;6576;8218,29
-1,1,22,18916842,20312661,1395819,54487;27037;5413;29801;65078;23617;10587;1312;7122;7290;421;128977;8220;2812;388849;7353;2928;128989;6899;9993;54584;5625;79680;85359;64976;8318;5902;6576;8218,29
-1,1,22,18916842,20716903,1800061,54487;27037;5413;29801;65078;23617;10587;1312;7122;7290;421;128977;8220;2812;388849;7353;2928;128989;6899;9993;54584;5625;85376;79680;85359;64976;8318;5902;6576;728229;8218,31
1,1,22,18916842,20716903,1800061,54487;27037;5413;29801;65078;23617;10587;1312;7122;7290;421;128977;8220;2812;388849;7353;2928;128989;6899;9993;54584;5625;85376;79680;85359;64976;8318;5902;6576;728229;8218,31
1,1,22,18916842,21465659,2548817,54487;27037;9342;29801;65078;10587;1312;6545;7290;421;2812;6899;5625;7625;79680;64976;6576;3053;8218;5413;80764;23617;400891;1399;7122;150209;128977;8220;388849;84861;7353;51586;2928;128989;5297;9127;9993;54584;91179;85376;8216;85359;8318;728229;5902,45
1,1,22,18916842,21465659,2548817,54487;27037;9342;29801;65078;10587;1312;6545;7290;421;2812;6899;5625;7625;79680;64976;6576;3053;8218;5413;80764;23617;400891;1399;7122;150209;128977;8220;388849;84861;7353;51586;2928;128989;5297;9127;9993;54584;91179;85376;8216;85359;8318;728229;5902,45
1,1,22,18916842,21465659,2548817,54487;27037;9342;29801;65078;10587;1312;6545;7290;421;2812;6899;5625;7625;79680;64976;6576;3053;8218;5413;80764;23617;400891;1399;7122;150209;128977;8220;388849;84861;7353;51586;2928;128989;5297;9127;9993;54584;91179;85376;8216;85359;8318;728229;5902,45
1,1,22,18916842,21465659,2548817,54487;27037;9342;29801;65078;10587;1312;6545;7290;421;2812;6899;5625;7625;79680;64976;6576;3053;8218;5413;80764;23617;400891;1399;7122;150209;128977;8220;388849;84861;7353;51586;2928;128989;5297;9127;9993;54584;91179;85376;8216;85359;8318;728229;5902,45
1,1,22,18916842,21465659,2548817,54487;27037;9342;29801;65078;10587;1312;6545;7290;421;2812;6899;5625;7625;79680;64976;6576;3053;8218;5413;80764;23617;400891;1399;7122;150209;128977;8220;388849;84861;7353;51586;2928;128989;5297;9127;9993;54584;91179;85376;8216;85359;8318;728229;5902,45
1,1,22,18916842,21465659,2548817,54487;27037;9342;29801;65078;10587;1312;6545;7290;421;2812;6899;5625;7625;79680;64976;6576;3053;8218;5413;80764;23617;400891;1399;7122;150209;128977;8220;388849;84861;7353;51586;2928;128989;5297;9127;9993;54584;91179;85376;8216;85359;8318;728229;5902,45
1,1,22,18916842,21465659,2548817,54487;27037;9342;29801;65078;10587;1312;6545;7290;421;2812;6899;5625;7625;79680;64976;6576;3053;8218;5413;80764;23617;400891;1399;7122;150209;128977;8220;388849;84861;7353;51586;2928;128989;5297;9127;9993;54584;91179;85376;8216;85359;8318;728229;5902,45
1,1,22,18916842,21465659,2548817,54487;27037;9342;29801;65078;10587;1312;6545;7290;421;2812;6899;5625;7625;79680;64976;6576;3053;8218;5413;80764;23617;400891;1399;7122;150209;128977;8220;388849;84861;7353;51586;2928;128989;5297;9127;9993;54584;91179;85376;8216;85359;8318;728229;5902,45
1,1,22,18916842,21465659,2548817,54487;27037;9342;29801;65078;10587;1312;6545;7290;421;2812;6899;5625;7625;79680;64976;6576;3053;8218;5413;80764;23617;400891;1399;7122;150209;128977;8220;388849;84861;7353;51586;2928;128989;5297;9127;9993;54584;91179;85376;8216;85359;8318;728229;5902,45
1,1,22,18916842,21465659,2548817,54487;27037;9342;29801;65078;10587;1312;6545;7290;421;2812;6899;5625;7625;79680;64976;6576;3053;8218;5413;80764;23617;400891;1399;7122;150209;128977;8220;388849;84861;7353;51586;2928;128989;5297;9127;9993;54584;91179;85376;8216;85359;8318;728229;5902,45
-1,1,22,18916842,21465659,2548817,54487;27037;9342;29801;65078;10587;1312;6545;7290;421;2812;6899;5625;7625;79680;64976;6576;3053;8218;5413;80764;23617;400891;1399;7122;150209;128977;8220;388849;84861;7353;51586;2928;128989;5297;9127;9993;54584;91179;85376;8216;85359;8318;728229;5902,45
1,1,22,18916842,21465659,2548817,54487;27037;9342;29801;65078;10587;1312;6545;7290;421;2812;6899;5625;7625;79680;64976;6576;3053;8218;5413;80764;23617;400891;1399;7122;150209;128977;8220;388849;84861;7353;51586;2928;128989;5297;9127;9993;54584;91179;85376;8216;85359;8318;728229;5902,45
-1,1,22,18916842,21465659,2548817,54487;27037;9342;29801;65078;10587;1312;6545;7290;421;2812;6899;5625;7625;79680;64976;6576;3053;8218;5413;80764;23617;400891;1399;7122;150209;128977;8220;388849;84861;7353;51586;2928;128989;5297;9127;9993;54584;91179;85376;8216;85359;8318;728229;5902,45
-1,1,22,18916842,21465659,2548817,54487;27037;9342;29801;65078;10587;1312;6545;7290;421;2812;6899;5625;7625;79680;64976;6576;3053;8218;5413;80764;23617;400891;1399;7122;150209;128977;8220;388849;84861;7353;51586;2928;128989;5297;9127;9993;54584;91179;85376;8216;85359;8318;728229;5902,45
1,1,22,18916842,21465659,2548817,54487;27037;9342;29801;65078;10587;1312;6545;7290;421;2812;6899;5625;7625;79680;64976;6576;3053;8218;5413;80764;23617;400891;1399;7122;150209;128977;8220;388849;84861;7353;51586;2928;128989;5297;9127;9993;54584;91179;85376;8216;85359;8318;728229;5902,45
-1,1,22,18916842,21465659,2548817,54487;27037;9342;29801;65078;10587;1312;6545;7290;421;2812;6899;5625;7625;79680;64976;6576;3053;8218;5413;80764;23617;400891;1399;7122;150209;128977;8220;388849;84861;7353;51586;2928;128989;5297;9127;9993;54584;91179;85376;8216;85359;8318;728229;5902,45
-1,1,22,18916842,21465659,2548817,54487;27037;9342;29801;65078;10587;1312;6545;7290;421;2812;6899;5625;7625;79680;64976;6576;3053;8218;5413;80764;23617;400891;1399;7122;150209;128977;8220;388849;84861;7353;51586;2928;128989;5297;9127;9993;54584;91179;85376;8216;85359;8318;728229;5902,45
1,1,22,18916842,21465659,2548817,54487;27037;9342;29801;65078;10587;1312;6545;7290;421;2812;6899;5625;7625;79680;64976;6576;3053;8218;5413;80764;23617;400891;1399;7122;150209;128977;8220;388849;84861;7353;51586;2928;128989;5297;9127;9993;54584;91179;85376;8216;85359;8318;728229;5902,45
-1,1,22,18916842,21465659,2548817,54487;27037;9342;29801;65078;10587;1312;6545;7290;421;2812;6899;5625;7625;79680;64976;6576;3053;8218;5413;80764;23617;400891;1399;7122;150209;128977;8220;388849;84861;7353;51586;2928;128989;5297;9127;9993;54584;91179;85376;8216;85359;8318;728229;5902,45
-1,1,22,18916842,21465659,2548817,54487;27037;9342;29801;65078;10587;1312;6545;7290;421;2812;6899;5625;7625;79680;64976;6576;3053;8218;5413;80764;23617;400891;1399;7122;150209;128977;8220;388849;84861;7353;51586;2928;128989;5297;9127;9993;54584;91179;85376;8216;85359;8318;728229;5902,45
-1,1,22,18916842,21465659,2548817,54487;27037;9342;29801;65078;10587;1312;6545;7290;421;2812;6899;5625;7625;79680;64976;6576;3053;8218;5413;80764;23617;400891;1399;7122;150209;128977;8220;388849;84861;7353;51586;2928;128989;5297;9127;9993;54584;91179;85376;8216;85359;8318;728229;5902,45
-1,1,22,18916842,21465659,2548817,54487;27037;9342;29801;65078;10587;1312;6545;7290;421;2812;6899;5625;7625;79680;64976;6576;3053;8218;5413;80764;23617;400891;1399;7122;150209;128977;8220;388849;84861;7353;51586;2928;128989;5297;9127;9993;54584;91179;85376;8216;85359;8318;728229;5902,45
-1,1,22,18916842,21465659,2548817,54487;27037;9342;29801;65078;10587;1312;6545;7290;421;2812;6899;5625;7625;79680;64976;6576;3053;8218;5413;80764;23617;400891;1399;7122;150209;128977;8220;388849;84861;7353;51586;2928;128989;5297;9127;9993;54584;91179;85376;8216;85359;8318;728229;5902,45
-1,1,22,18916842,21465659,2548817,54487;27037;9342;29801;65078;10587;1312;6545;7290;421;2812;6899;5625;7625;79680;64976;6576;3053;8218;5413;80764;23617;400891;1399;7122;150209;128977;8220;388849;84861;7353;51586;2928;128989;5297;9127;9993;54584;91179;85376;8216;85359;8318;728229;5902,45
-1,1,22,18916842,21465659,2548817,54487;27037;9342;29801;65078;10587;1312;6545;7290;421;2812;6899;5625;7625;79680;64976;6576;3053;8218;5413;80764;23617;400891;1399;7122;150209;128977;8220;388849;84861;7353;51586;2928;128989;5297;9127;9993;54584;91179;85376;8216;85359;8318;728229;5902,45
1,1,22,18916842,21465659,2548817,54487;27037;9342;29801;65078;10587;1312;6545;7290;421;2812;6899;5625;7625;79680;64976;6576;3053;8218;5413;80764;23617;400891;1399;7122;150209;128977;8220;388849;84861;7353;51586;2928;128989;5297;9127;9993;54584;91179;85376;8216;85359;8318;728229;5902,45
1,1,22,18916842,21465659,2548817,54487;27037;9342;29801;65078;10587;1312;6545;7290;421;2812;6899;5625;7625;79680;64976;6576;3053;8218;5413;80764;23617;400891;1399;7122;150209;128977;8220;388849;84861;7353;51586;2928;128989;5297;9127;9993;54584;91179;85376;8216;85359;8318;728229;5902,45
-1,1,22,18916842,21465659,2548817,54487;27037;9342;29801;65078;10587;1312;6545;7290;421;2812;6899;5625;7625;79680;64976;6576;3053;8218;5413;80764;23617;400891;1399;7122;150209;128977;8220;388849;84861;7353;51586;2928;128989;5297;9127;9993;54584;91179;85376;8216;85359;8318;728229;5902,45
1,1,22,18916842,21465659,2548817,54487;27037;9342;29801;65078;10587;1312;6545;7290;421;2812;6899;5625;7625;79680;64976;6576;3053;8218;5413;80764;23617;400891;1399;7122;150209;128977;8220;388849;84861;7353;51586;2928;128989;5297;9127;9993;54584;91179;85376;8216;85359;8318;728229;5902,45
-1,1,22,18916842,21465659,2548817,54487;27037;9342;29801;65078;10587;1312;6545;7290;421;2812;6899;5625;7625;79680;64976;6576;3053;8218;5413;80764;23617;400891;1399;7122;150209;128977;8220;388849;84861;7353;51586;2928;128989;5297;9127;9993;54584;91179;85376;8216;85359;8318;728229;5902,45
-1,1,22,18916842,21465659,2548817,54487;27037;9342;29801;65078;10587;1312;6545;7290;421;2812;6899;5625;7625;79680;64976;6576;3053;8218;5413;80764;23617;400891;1399;7122;150209;128977;8220;388849;84861;7353;51586;2928;128989;5297;9127;9993;54584;91179;85376;8216;85359;8318;728229;5902,45
-1,1,22,18916842,21465659,2548817,54487;27037;9342;29801;65078;10587;1312;6545;7290;421;2812;6899;5625;7625;79680;64976;6576;3053;8218;5413;80764;23617;400891;1399;7122;150209;128977;8220;388849;84861;7353;51586;2928;128989;5297;9127;9993;54584;91179;85376;8216;85359;8318;728229;5902,45
-1,1,22,18916842,21465659,2548817,54487;27037;9342;29801;65078;10587;1312;6545;7290;421;2812;6899;5625;7625;79680;64976;6576;3053;8218;5413;80764;23617;400891;1399;7122;150209;128977;8220;388849;84861;7353;51586;2928;128989;5297;9127;9993;54584;91179;85376;8216;85359;8318;728229;5902,45
1,1,22,18916842,21465659,2548817,54487;27037;9342;29801;65078;10587;1312;6545;7290;421;2812;6899;5625;7625;79680;64976;6576;3053;8218;5413;80764;23617;400891;1399;7122;150209;128977;8220;388849;84861;7353;51586;2928;128989;5297;9127;9993;54584;91179;85376;8216;85359;8318;728229;5902,45
-1,1,22,18916842,21465659,2548817,54487;27037;9342;29801;65078;10587;1312;6545;7290;421;2812;6899;5625;7625;79680;64976;6576;3053;8218;5413;80764;23617;400891;1399;7122;150209;128977;8220;388849;84861;7353;51586;2928;128989;5297;9127;9993;54584;91179;85376;8216;85359;8318;728229;5902,45
1,1,22,18916842,21465659,2548817,54487;27037;9342;29801;65078;10587;1312;6545;7290;421;2812;6899;5625;7625;79680;64976;6576;3053;8218;5413;80764;23617;400891;1399;7122;150209;128977;8220;388849;84861;7353;51586;2928;128989;5297;9127;9993;54584;91179;85376;8216;85359;8318;728229;5902,45
1,1,22,18916842,21465659,2548817,54487;27037;9342;29801;65078;10587;1312;6545;7290;421;2812;6899;5625;7625;79680;64976;6576;3053;8218;5413;80764;23617;400891;1399;7122;150209;128977;8220;388849;84861;7353;51586;2928;128989;5297;9127;9993;54584;91179;85376;8216;85359;8318;728229;5902,45
-1,1,22,18916842,21465659,2548817,54487;27037;9342;29801;65078;10587;1312;6545;7290;421;2812;6899;5625;7625;79680;64976;6576;3053;8218;5413;80764;23617;400891;1399;7122;150209;128977;8220;388849;84861;7353;51586;2928;128989;5297;9127;9993;54584;91179;85376;8216;85359;8318;728229;5902,45
-1,1,22,18916842,21465659,2548817,54487;27037;9342;29801;65078;10587;1312;6545;7290;421;2812;6899;5625;7625;79680;64976;6576;3053;8218;5413;80764;23617;400891;1399;7122;150209;128977;8220;388849;84861;7353;51586;2928;128989;5297;9127;9993;54584;91179;85376;8216;85359;8318;728229;5902,45
-1,1,22,18916842,21465661,2548819,54487;27037;9342;29801;65078;10587;1312;6545;7290;421;2812;6899;5625;7625;79680;64976;6576;3053;8218;5413;80764;23617;400891;1399;7122;150209;128977;8220;388849;84861;7353;51586;2928;128989;5297;9127;9993;54584;91179;85376;8216;85359;8318;728229;5902,45
-1,1,22,18916842,21465662,2548820,54487;27037;9342;29801;65078;10587;1312;6545;7290;421;2812;6899;5625;7625;79680;64976;6576;3053;8218;5413;80764;23617;400891;1399;7122;150209;128977;8220;388849;84861;7353;51586;2928;128989;5297;9127;9993;54584;91179;85376;8216;85359;8318;728229;5902,45
-1,1,22,18916842,21465662,2548820,54487;27037;9342;29801;65078;10587;1312;6545;7290;421;2812;6899;5625;7625;79680;64976;6576;3053;8218;5413;80764;23617;400891;1399;7122;150209;128977;8220;388849;84861;7353;51586;2928;128989;5297;9127;9993;54584;91179;85376;8216;85359;8318;728229;5902,45
-1,1,22,18916842,21465662,2548820,54487;27037;9342;29801;65078;10587;1312;6545;7290;421;2812;6899;5625;7625;79680;64976;6576;3053;8218;5413;80764;23617;400891;1399;7122;150209;128977;8220;388849;84861;7353;51586;2928;128989;5297;9127;9993;54584;91179;85376;8216;85359;8318;728229;5902,45
-1,1,22,18916842,21465662,2548820,54487;27037;9342;29801;65078;10587;1312;6545;7290;421;2812;6899;5625;7625;79680;64976;6576;3053;8218;5413;80764;23617;400891;1399;7122;150209;128977;8220;388849;84861;7353;51586;2928;128989;5297;9127;9993;54584;91179;85376;8216;85359;8318;728229;5902,45
-1,1,22,18916842,21465662,2548820,54487;27037;9342;29801;65078;10587;1312;6545;7290;421;2812;6899;5625;7625;79680;64976;6576;3053;8218;5413;80764;23617;400891;1399;7122;150209;128977;8220;388849;84861;7353;51586;2928;128989;5297;9127;9993;54584;91179;85376;8216;85359;8318;728229;5902,45
-1,1,22,18916842,21465662,2548820,54487;27037;9342;29801;65078;10587;1312;6545;7290;421;2812;6899;5625;7625;79680;64976;6576;3053;8218;5413;80764;23617;400891;1399;7122;150209;128977;8220;388849;84861;7353;51586;2928;128989;5297;9127;9993;54584;91179;85376;8216;85359;8318;728229;5902,45
-1,1,22,18916842,21465662,2548820,54487;27037;9342;29801;65078;10587;1312;6545;7290;421;2812;6899;5625;7625;79680;64976;6576;3053;8218;5413;80764;23617;400891;1399;7122;150209;128977;8220;388849;84861;7353;51586;2928;128989;5297;9127;9993;54584;91179;85376;8216;85359;8318;728229;5902,45
-1,1,22,18916842,21465662,2548820,54487;27037;9342;29801;65078;10587;1312;6545;7290;421;2812;6899;5625;7625;79680;64976;6576;3053;8218;5413;80764;23617;400891;1399;7122;150209;128977;8220;388849;84861;7353;51586;2928;128989;5297;9127;9993;54584;91179;85376;8216;85359;8318;728229;5902,45
-1,1,22,18916842,21465662,2548820,54487;27037;9342;29801;65078;10587;1312;6545;7290;421;2812;6899;5625;7625;79680;64976;6576;3053;8218;5413;80764;23617;400891;1399;7122;150209;128977;8220;388849;84861;7353;51586;2928;128989;5297;9127;9993;54584;91179;85376;8216;85359;8318;728229;5902,45
-1,1,22,18916842,21465662,2548820,54487;27037;9342;29801;65078;10587;1312;6545;7290;421;2812;6899;5625;7625;79680;64976;6576;3053;8218;5413;80764;23617;400891;1399;7122;150209;128977;8220;388849;84861;7353;51586;2928;128989;5297;9127;9993;54584;91179;85376;8216;85359;8318;728229;5902,45
-1,1,22,18916842,21465662,2548820,54487;27037;9342;29801;65078;10587;1312;6545;7290;421;2812;6899;5625;7625;79680;64976;6576;3053;8218;5413;80764;23617;400891;1399;7122;150209;128977;8220;388849;84861;7353;51586;2928;128989;5297;9127;9993;54584;91179;85376;8216;85359;8318;728229;5902,45
-1,1,22,18916842,21465662,2548820,54487;27037;9342;29801;65078;10587;1312;6545;7290;421;2812;6899;5625;7625;79680;64976;6576;3053;8218;5413;80764;23617;400891;1399;7122;150209;128977;8220;388849;84861;7353;51586;2928;128989;5297;9127;9993;54584;91179;85376;8216;85359;8318;728229;5902,45
-1,1,22,18916842,21465662,2548820,54487;27037;9342;29801;65078;10587;1312;6545;7290;421;2812;6899;5625;7625;79680;64976;6576;3053;8218;5413;80764;23617;400891;1399;7122;150209;128977;8220;388849;84861;7353;51586;2928;128989;5297;9127;9993;54584;91179;85376;8216;85359;8318;728229;5902,45
-1,1,22,18916842,21465662,2548820,54487;27037;9342;29801;65078;10587;1312;6545;7290;421;2812;6899;5625;7625;79680;64976;6576;3053;8218;5413;80764;23617;400891;1399;7122;150209;128977;8220;388849;84861;7353;51586;2928;128989;5297;9127;9993;54584;91179;85376;8216;85359;8318;728229;5902,45
-1,1,22,18916842,21465662,2548820,54487;27037;9342;29801;65078;10587;1312;6545;7290;421;2812;6899;5625;7625;79680;64976;6576;3053;8218;5413;80764;23617;400891;1399;7122;150209;128977;8220;388849;84861;7353;51586;2928;128989;5297;9127;9993;54584;91179;85376;8216;85359;8318;728229;5902,45
-1,1,22,18916842,21465662,2548820,54487;27037;9342;29801;65078;10587;1312;6545;7290;421;2812;6899;5625;7625;79680;64976;6576;3053;8218;5413;80764;23617;400891;1399;7122;150209;128977;8220;388849;84861;7353;51586;2928;128989;5297;9127;9993;54584;91179;85376;8216;85359;8318;728229;5902,45
-1,1,22,18916842,21465662,2548820,54487;27037;9342;29801;65078;10587;1312;6545;7290;421;2812;6899;5625;7625;79680;64976;6576;3053;8218;5413;80764;23617;400891;1399;7122;150209;128977;8220;388849;84861;7353;51586;2928;128989;5297;9127;9993;54584;91179;85376;8216;85359;8318;728229;5902,45
-1,1,22,18916842,21465662,2548820,54487;27037;9342;29801;65078;10587;1312;6545;7290;421;2812;6899;5625;7625;79680;64976;6576;3053;8218;5413;80764;23617;400891;1399;7122;150209;128977;8220;388849;84861;7353;51586;2928;128989;5297;9127;9993;54584;91179;85376;8216;85359;8318;728229;5902,45
-1,1,22,18916842,21465662,2548820,54487;27037;9342;29801;65078;10587;1312;6545;7290;421;2812;6899;5625;7625;79680;64976;6576;3053;8218;5413;80764;23617;400891;1399;7122;150209;128977;8220;388849;84861;7353;51586;2928;128989;5297;9127;9993;54584;91179;85376;8216;85359;8318;728229;5902,45
-1,1,22,18916842,21465662,2548820,54487;27037;9342;29801;65078;10587;1312;6545;7290;421;2812;6899;5625;7625;79680;64976;6576;3053;8218;5413;80764;23617;400891;1399;7122;150209;128977;8220;388849;84861;7353;51586;2928;128989;5297;9127;9993;54584;91179;85376;8216;85359;8318;728229;5902,45
-1,1,22,18916842,21465662,2548820,54487;27037;9342;29801;65078;10587;1312;6545;7290;421;2812;6899;5625;7625;79680;64976;6576;3053;8218;5413;80764;23617;400891;1399;7122;150209;128977;8220;388849;84861;7353;51586;2928;128989;5297;9127;9993;54584;91179;85376;8216;85359;8318;728229;5902,45
-1,1,22,18916842,21465662,2548820,54487;27037;9342;29801;65078;10587;1312;6545;7290;421;2812;6899;5625;7625;79680;64976;6576;3053;8218;5413;80764;23617;400891;1399;7122;150209;128977;8220;388849;84861;7353;51586;2928;128989;5297;9127;9993;54584;91179;85376;8216;85359;8318;728229;5902,45
-1,1,22,18916842,21465662,2548820,54487;27037;9342;29801;65078;10587;1312;6545;7290;421;2812;6899;5625;7625;79680;64976;6576;3053;8218;5413;80764;23617;400891;1399;7122;150209;128977;8220;388849;84861;7353;51586;2928;128989;5297;9127;9993;54584;91179;85376;8216;85359;8318;728229;5902,45
-1,1,22,18916842,21465662,2548820,54487;27037;9342;29801;65078;10587;1312;6545;7290;421;2812;6899;5625;7625;79680;64976;6576;3053;8218;5413;80764;23617;400891;1399;7122;150209;128977;8220;388849;84861;7353;51586;2928;128989;5297;9127;9993;54584;91179;85376;8216;85359;8318;728229;5902,45
-1,1,22,18916842,21465662,2548820,54487;27037;9342;29801;65078;10587;1312;6545;7290;421;2812;6899;5625;7625;79680;64976;6576;3053;8218;5413;80764;23617;400891;1399;7122;150209;128977;8220;388849;84861;7353;51586;2928;128989;5297;9127;9993;54584;91179;85376;8216;85359;8318;728229;5902,45
-1,1,22,18916842,21465662,2548820,54487;27037;9342;29801;65078;10587;1312;6545;7290;421;2812;6899;5625;7625;79680;64976;6576;3053;8218;5413;80764;23617;400891;1399;7122;150209;128977;8220;388849;84861;7353;51586;2928;128989;5297;9127;9993;54584;91179;85376;8216;85359;8318;728229;5902,45
-1,1,22,18916842,21465662,2548820,54487;27037;9342;29801;65078;10587;1312;6545;7290;421;2812;6899;5625;7625;79680;64976;6576;3053;8218;5413;80764;23617;400891;1399;7122;150209;128977;8220;388849;84861;7353;51586;2928;128989;5297;9127;9993;54584;91179;85376;8216;85359;8318;728229;5902,45
-1,1,22,18916842,21465662,2548820,54487;27037;9342;29801;65078;10587;1312;6545;7290;421;2812;6899;5625;7625;79680;64976;6576;3053;8218;5413;80764;23617;400891;1399;7122;150209;128977;8220;388849;84861;7353;51586;2928;128989;5297;9127;9993;54584;91179;85376;8216;85359;8318;728229;5902,45
1,1,22,18916842,21465662,2548820,54487;27037;9342;29801;65078;10587;1312;6545;7290;421;2812;6899;5625;7625;79680;64976;6576;3053;8218;5413;80764;23617;400891;1399;7122;150209;128977;8220;388849;84861;7353;51586;2928;128989;5297;9127;9993;54584;91179;85376;8216;85359;8318;728229;5902,45
-1,1,22,18916842,21465662,2548820,54487;27037;9342;29801;65078;10587;1312;6545;7290;421;2812;6899;5625;7625;79680;64976;6576;3053;8218;5413;80764;23617;400891;1399;7122;150209;128977;8220;388849;84861;7353;51586;2928;128989;5297;9127;9993;54584;91179;85376;8216;85359;8318;728229;5902,45
-1,1,22,18916842,21465662,2548820,54487;27037;9342;29801;65078;10587;1312;6545;7290;421;2812;6899;5625;7625;79680;64976;6576;3053;8218;5413;80764;23617;400891;1399;7122;150209;128977;8220;388849;84861;7353;51586;2928;128989;5297;9127;9993;54584;91179;85376;8216;85359;8318;728229;5902,45
-1,1,22,18916842,21465662,2548820,54487;27037;9342;29801;65078;10587;1312;6545;7290;421;2812;6899;5625;7625;79680;64976;6576;3053;8218;5413;80764;23617;400891;1399;7122;150209;128977;8220;388849;84861;7353;51586;2928;128989;5297;9127;9993;54584;91179;85376;8216;85359;8318;728229;5902,45
-1,1,22,18916842,21465662,2548820,54487;27037;9342;29801;65078;10587;1312;6545;7290;421;2812;6899;5625;7625;79680;64976;6576;3053;8218;5413;80764;23617;400891;1399;7122;150209;128977;8220;388849;84861;7353;51586;2928;128989;5297;9127;9993;54584;91179;85376;8216;85359;8318;728229;5902,45
-1,1,22,18916842,21798907,2882065,54487;27037;9342;29801;65078;10587;1312;6545;7290;421;2812;6899;5625;7625;79680;23119;64976;6576;3053;8218;5413;80764;23617;400891;1399;7122;150209;128977;8220;388849;84861;7353;51586;2928;128989;5297;9127;9993;54584;91179;85376;8216;440804;85359;8318;728229;5902,47
-1,1,22,18916842,21798907,2882065,54487;27037;9342;29801;65078;10587;1312;6545;7290;421;2812;6899;5625;7625;79680;23119;64976;6576;3053;8218;5413;80764;23617;400891;1399;7122;150209;128977;8220;388849;84861;7353;51586;2928;128989;5297;9127;9993;54584;91179;85376;8216;440804;85359;8318;728229;5902,47
-1,1,22,18916842,21798907,2882065,54487;27037;9342;29801;65078;10587;1312;6545;7290;421;2812;6899;5625;7625;79680;23119;64976;6576;3053;8218;5413;80764;23617;400891;1399;7122;150209;128977;8220;388849;84861;7353;51586;2928;128989;5297;9127;9993;54584;91179;85376;8216;440804;85359;8318;728229;5902,47
-1,1,22,18916842,21798907,2882065,54487;27037;9342;29801;65078;10587;1312;6545;7290;421;2812;6899;5625;7625;79680;23119;64976;6576;3053;8218;5413;80764;23617;400891;1399;7122;150209;128977;8220;388849;84861;7353;51586;2928;128989;5297;9127;9993;54584;91179;85376;8216;440804;85359;8318;728229;5902,47
-1,1,22,18916842,21800471,2883629,54487;27037;9342;29801;65078;10587;1312;6545;7290;421;2812;6899;5625;7625;79680;23119;64976;6576;3053;8218;5413;80764;23617;400891;1399;7122;150209;128977;8220;388849;84861;7353;51586;2928;128989;5297;9127;9993;54584;91179;85376;8216;440804;85359;8318;728229;5902,47
-1,1,22,18916842,21800471,2883629,54487;27037;9342;29801;65078;10587;1312;6545;7290;421;2812;6899;5625;7625;79680;23119;64976;6576;3053;8218;5413;80764;23617;400891;1399;7122;150209;128977;8220;388849;84861;7353;51586;2928;128989;5297;9127;9993;54584;91179;85376;8216;440804;85359;8318;728229;5902,47
-1,1,22,18916842,21800797,2883955,54487;27037;9342;29801;65078;10587;1312;6545;7290;421;2812;6899;5625;7625;79680;23119;64976;6576;3053;8218;5413;80764;23617;400891;1399;7122;150209;128977;8220;388849;84861;7353;51586;2928;128989;5297;9127;9993;54584;91179;85376;8216;440804;85359;8318;728229;5902,47
-1,1,22,18916842,21804716,2887874,54487;27037;9342;29801;65078;10587;1312;6545;7290;421;2812;6899;5625;7625;79680;23119;64976;6576;3053;8218;5413;80764;23617;400891;1399;7122;150209;128977;8220;388849;84861;7353;51586;2928;128989;5297;9127;9993;54584;91179;85376;8216;440804;85359;8318;728229;5902,47
-1,1,22,18916842,21804886,2888044,54487;27037;9342;29801;65078;10587;1312;6545;7290;421;2812;6899;5625;7625;79680;23119;64976;6576;3053;8218;5413;80764;23617;400891;1399;7122;150209;128977;8220;388849;84861;7353;51586;2928;128989;5297;9127;9993;54584;91179;85376;8216;440804;85359;8318;728229;5902,47
-1,1,22,18916842,21915509,2998667,54487;27037;7332;9342;29801;65078;10587;1312;6545;7290;421;2812;645426;6899;5625;7625;79680;23119;64976;6576;3053;8218;5413;80764;23617;400891;1399;7122;150209;128977;8220;388849;84861;7353;51586;2928;128989;5297;9127;150221;9993;54584;91179;85376;8216;440804;85359;8318;728229;5902,50
-1,1,22,18916842,21915509,2998667,54487;27037;7332;9342;29801;65078;10587;1312;6545;7290;421;2812;645426;6899;5625;7625;79680;23119;64976;6576;3053;8218;5413;80764;23617;400891;1399;7122;150209;128977;8220;388849;84861;7353;51586;2928;128989;5297;9127;150221;9993;54584;91179;85376;8216;440804;85359;8318;728229;5902,50
-1,1,22,18917047,21465659,2548612,54487;27037;9342;29801;65078;10587;1312;6545;7290;421;2812;6899;5625;7625;79680;64976;6576;3053;8218;5413;80764;23617;400891;1399;7122;150209;128977;8220;388849;84861;7353;51586;2928;128989;5297;9127;9993;54584;91179;85376;8216;85359;8318;728229;5902,45
-1,1,22,18917047,21465659,2548612,54487;27037;9342;29801;65078;10587;1312;6545;7290;421;2812;6899;5625;7625;79680;64976;6576;3053;8218;5413;80764;23617;400891;1399;7122;150209;128977;8220;388849;84861;7353;51586;2928;128989;5297;9127;9993;54584;91179;85376;8216;85359;8318;728229;5902,45
-1,1,22,18917047,21465662,2548615,54487;27037;9342;29801;65078;10587;1312;6545;7290;421;2812;6899;5625;7625;79680;64976;6576;3053;8218;5413;80764;23617;400891;1399;7122;150209;128977;8220;388849;84861;7353;51586;2928;128989;5297;9127;9993;54584;91179;85376;8216;85359;8318;728229;5902,45
-1,1,22,18919942,20311763,1391821,54487;27037;5413;29801;65078;23617;10587;1312;7122;7290;421;128977;8220;2812;388849;7353;2928;128989;6899;9993;54584;5625;79680;85359;64976;8318;5902;6576;8218,29
1,1,22,18919942,20311763,1391821,54487;27037;5413;29801;65078;23617;10587;1312;7122;7290;421;128977;8220;2812;388849;7353;2928;128989;6899;9993;54584;5625;79680;85359;64976;8318;5902;6576;8218,29
1,1,22,18919942,20311763,1391821,54487;27037;5413;29801;65078;23617;10587;1312;7122;7290;421;128977;8220;2812;388849;7353;2928;128989;6899;9993;54584;5625;79680;85359;64976;8318;5902;6576;8218,29
-1,1,22,18919942,20311763,1391821,54487;27037;5413;29801;65078;23617;10587;1312;7122;7290;421;128977;8220;2812;388849;7353;2928;128989;6899;9993;54584;5625;79680;85359;64976;8318;5902;6576;8218,29
1,1,22,18919942,20311763,1391821,54487;27037;5413;29801;65078;23617;10587;1312;7122;7290;421;128977;8220;2812;388849;7353;2928;128989;6899;9993;54584;5625;79680;85359;64976;8318;5902;6576;8218,29
-1,1,22,18919942,20311763,1391821,54487;27037;5413;29801;65078;23617;10587;1312;7122;7290;421;128977;8220;2812;388849;7353;2928;128989;6899;9993;54584;5625;79680;85359;64976;8318;5902;6576;8218,29
1,1,22,18919942,20311763,1391821,54487;27037;5413;29801;65078;23617;10587;1312;7122;7290;421;128977;8220;2812;388849;7353;2928;128989;6899;9993;54584;5625;79680;85359;64976;8318;5902;6576;8218,29
-1,1,22,18919942,20659606,1739664,54487;27037;5413;29801;65078;23617;10587;1312;7122;7290;421;128977;8220;2812;388849;7353;2928;128989;6899;9993;54584;5625;85376;79680;85359;64976;8318;5902;6576;728229;8218,31
1,1,22,18919942,20708934,1788992,54487;27037;5413;29801;65078;23617;10587;1312;7122;7290;421;128977;8220;2812;388849;7353;2928;128989;6899;9993;54584;5625;85376;79680;85359;64976;8318;5902;6576;728229;8218,31
1,1,22,18919942,21440514,2520572,54487;27037;9342;29801;65078;10587;1312;6545;7290;421;2812;6899;5625;7625;79680;64976;6576;3053;8218;5413;80764;23617;400891;1399;7122;150209;128977;8220;388849;84861;7353;51586;2928;128989;5297;9127;9993;54584;91179;85376;8216;85359;8318;728229;5902,45
-1,1,22,18919942,21440514,2520572,54487;27037;9342;29801;65078;10587;1312;6545;7290;421;2812;6899;5625;7625;79680;64976;6576;3053;8218;5413;80764;23617;400891;1399;7122;150209;128977;8220;388849;84861;7353;51586;2928;128989;5297;9127;9993;54584;91179;85376;8216;85359;8318;728229;5902,45
-1,1,22,18919942,21440514,2520572,54487;27037;9342;29801;65078;10587;1312;6545;7290;421;2812;6899;5625;7625;79680;64976;6576;3053;8218;5413;80764;23617;400891;1399;7122;150209;128977;8220;388849;84861;7353;51586;2928;128989;5297;9127;9993;54584;91179;85376;8216;85359;8318;728229;5902,45
-1,1,22,18919942,21440514,2520572,54487;27037;9342;29801;65078;10587;1312;6545;7290;421;2812;6899;5625;7625;79680;64976;6576;3053;8218;5413;80764;23617;400891;1399;7122;150209;128977;8220;388849;84861;7353;51586;2928;128989;5297;9127;9993;54584;91179;85376;8216;85359;8318;728229;5902,45
-1,1,22,18919942,21440514,2520572,54487;27037;9342;29801;65078;10587;1312;6545;7290;421;2812;6899;5625;7625;79680;64976;6576;3053;8218;5413;80764;23617;400891;1399;7122;150209;128977;8220;388849;84861;7353;51586;2928;128989;5297;9127;9993;54584;91179;85376;8216;85359;8318;728229;5902,45
1,1,22,18919942,21440514,2520572,54487;27037;9342;29801;65078;10587;1312;6545;7290;421;2812;6899;5625;7625;79680;64976;6576;3053;8218;5413;80764;23617;400891;1399;7122;150209;128977;8220;388849;84861;7353;51586;2928;128989;5297;9127;9993;54584;91179;85376;8216;85359;8318;728229;5902,45
-1,1,22,18919942,21440514,2520572,54487;27037;9342;29801;65078;10587;1312;6545;7290;421;2812;6899;5625;7625;79680;64976;6576;3053;8218;5413;80764;23617;400891;1399;7122;150209;128977;8220;388849;84861;7353;51586;2928;128989;5297;9127;9993;54584;91179;85376;8216;85359;8318;728229;5902,45
-1,1,22,18919942,21505417,2585475,54487;27037;9342;29801;65078;10587;1312;6545;7290;421;2812;6899;5625;7625;79680;64976;6576;3053;8218;5413;80764;23617;400891;1399;7122;150209;128977;8220;388849;84861;7353;51586;2928;128989;5297;9127;9993;54584;91179;85376;8216;85359;8318;728229;5902,45
-1,1,22,18919942,21505417,2585475,54487;27037;9342;29801;65078;10587;1312;6545;7290;421;2812;6899;5625;7625;79680;64976;6576;3053;8218;5413;80764;23617;400891;1399;7122;150209;128977;8220;388849;84861;7353;51586;2928;128989;5297;9127;9993;54584;91179;85376;8216;85359;8318;728229;5902,45
-1,1,22,18919942,21505417,2585475,54487;27037;9342;29801;65078;10587;1312;6545;7290;421;2812;6899;5625;7625;79680;64976;6576;3053;8218;5413;80764;23617;400891;1399;7122;150209;128977;8220;388849;84861;7353;51586;2928;128989;5297;9127;9993;54584;91179;85376;8216;85359;8318;728229;5902,45
1,1,22,18919942,21505417,2585475,54487;27037;9342;29801;65078;10587;1312;6545;7290;421;2812;6899;5625;7625;79680;64976;6576;3053;8218;5413;80764;23617;400891;1399;7122;150209;128977;8220;388849;84861;7353;51586;2928;128989;5297;9127;9993;54584;91179;85376;8216;85359;8318;728229;5902,45
-1,1,22,18919942,21505417,2585475,54487;27037;9342;29801;65078;10587;1312;6545;7290;421;2812;6899;5625;7625;79680;64976;6576;3053;8218;5413;80764;23617;400891;1399;7122;150209;128977;8220;388849;84861;7353;51586;2928;128989;5297;9127;9993;54584;91179;85376;8216;85359;8318;728229;5902,45
-1,1,22,18919942,21505417,2585475,54487;27037;9342;29801;65078;10587;1312;6545;7290;421;2812;6899;5625;7625;79680;64976;6576;3053;8218;5413;80764;23617;400891;1399;7122;150209;128977;8220;388849;84861;7353;51586;2928;128989;5297;9127;9993;54584;91179;85376;8216;85359;8318;728229;5902,45
-1,1,22,18919942,21505417,2585475,54487;27037;9342;29801;65078;10587;1312;6545;7290;421;2812;6899;5625;7625;79680;64976;6576;3053;8218;5413;80764;23617;400891;1399;7122;150209;128977;8220;388849;84861;7353;51586;2928;128989;5297;9127;9993;54584;91179;85376;8216;85359;8318;728229;5902,45
1,1,22,18919942,21505417,2585475,54487;27037;9342;29801;65078;10587;1312;6545;7290;421;2812;6899;5625;7625;79680;64976;6576;3053;8218;5413;80764;23617;400891;1399;7122;150209;128977;8220;388849;84861;7353;51586;2928;128989;5297;9127;9993;54584;91179;85376;8216;85359;8318;728229;5902,45
1,1,22,18919942,21505417,2585475,54487;27037;9342;29801;65078;10587;1312;6545;7290;421;2812;6899;5625;7625;79680;64976;6576;3053;8218;5413;80764;23617;400891;1399;7122;150209;128977;8220;388849;84861;7353;51586;2928;128989;5297;9127;9993;54584;91179;85376;8216;85359;8318;728229;5902,45
-1,1,22,18919942,21505417,2585475,54487;27037;9342;29801;65078;10587;1312;6545;7290;421;2812;6899;5625;7625;79680;64976;6576;3053;8218;5413;80764;23617;400891;1399;7122;150209;128977;8220;388849;84861;7353;51586;2928;128989;5297;9127;9993;54584;91179;85376;8216;85359;8318;728229;5902,45
-1,1,22,18919942,21505417,2585475,54487;27037;9342;29801;65078;10587;1312;6545;7290;421;2812;6899;5625;7625;79680;64976;6576;3053;8218;5413;80764;23617;400891;1399;7122;150209;128977;8220;388849;84861;7353;51586;2928;128989;5297;9127;9993;54584;91179;85376;8216;85359;8318;728229;5902,45
-1,1,22,18919942,21505417,2585475,54487;27037;9342;29801;65078;10587;1312;6545;7290;421;2812;6899;5625;7625;79680;64976;6576;3053;8218;5413;80764;23617;400891;1399;7122;150209;128977;8220;388849;84861;7353;51586;2928;128989;5297;9127;9993;54584;91179;85376;8216;85359;8318;728229;5902,45
-1,1,22,18919942,21505417,2585475,54487;27037;9342;29801;65078;10587;1312;6545;7290;421;2812;6899;5625;7625;79680;64976;6576;3053;8218;5413;80764;23617;400891;1399;7122;150209;128977;8220;388849;84861;7353;51586;2928;128989;5297;9127;9993;54584;91179;85376;8216;85359;8318;728229;5902,45
-1,1,22,18919942,21505417,2585475,54487;27037;9342;29801;65078;10587;1312;6545;7290;421;2812;6899;5625;7625;79680;64976;6576;3053;8218;5413;80764;23617;400891;1399;7122;150209;128977;8220;388849;84861;7353;51586;2928;128989;5297;9127;9993;54584;91179;85376;8216;85359;8318;728229;5902,45
1,1,22,18919942,21505417,2585475,54487;27037;9342;29801;65078;10587;1312;6545;7290;421;2812;6899;5625;7625;79680;64976;6576;3053;8218;5413;80764;23617;400891;1399;7122;150209;128977;8220;388849;84861;7353;51586;2928;128989;5297;9127;9993;54584;91179;85376;8216;85359;8318;728229;5902,45
1,1,22,18919942,21505417,2585475,54487;27037;9342;29801;65078;10587;1312;6545;7290;421;2812;6899;5625;7625;79680;64976;6576;3053;8218;5413;80764;23617;400891;1399;7122;150209;128977;8220;388849;84861;7353;51586;2928;128989;5297;9127;9993;54584;91179;85376;8216;85359;8318;728229;5902,45
-1,1,22,18919942,21505417,2585475,54487;27037;9342;29801;65078;10587;1312;6545;7290;421;2812;6899;5625;7625;79680;64976;6576;3053;8218;5413;80764;23617;400891;1399;7122;150209;128977;8220;388849;84861;7353;51586;2928;128989;5297;9127;9993;54584;91179;85376;8216;85359;8318;728229;5902,45
-1,1,22,18919942,21505417,2585475,54487;27037;9342;29801;65078;10587;1312;6545;7290;421;2812;6899;5625;7625;79680;64976;6576;3053;8218;5413;80764;23617;400891;1399;7122;150209;128977;8220;388849;84861;7353;51586;2928;128989;5297;9127;9993;54584;91179;85376;8216;85359;8318;728229;5902,45
-1,1,22,18919942,21505417,2585475,54487;27037;9342;29801;65078;10587;1312;6545;7290;421;2812;6899;5625;7625;79680;64976;6576;3053;8218;5413;80764;23617;400891;1399;7122;150209;128977;8220;388849;84861;7353;51586;2928;128989;5297;9127;9993;54584;91179;85376;8216;85359;8318;728229;5902,45
-1,1,22,18919942,21505417,2585475,54487;27037;9342;29801;65078;10587;1312;6545;7290;421;2812;6899;5625;7625;79680;64976;6576;3053;8218;5413;80764;23617;400891;1399;7122;150209;128977;8220;388849;84861;7353;51586;2928;128989;5297;9127;9993;54584;91179;85376;8216;85359;8318;728229;5902,45
-1,1,22,18919942,21505417,2585475,54487;27037;9342;29801;65078;10587;1312;6545;7290;421;2812;6899;5625;7625;79680;64976;6576;3053;8218;5413;80764;23617;400891;1399;7122;150209;128977;8220;388849;84861;7353;51586;2928;128989;5297;9127;9993;54584;91179;85376;8216;85359;8318;728229;5902,45
-1,1,22,18919942,21505417,2585475,54487;27037;9342;29801;65078;10587;1312;6545;7290;421;2812;6899;5625;7625;79680;64976;6576;3053;8218;5413;80764;23617;400891;1399;7122;150209;128977;8220;388849;84861;7353;51586;2928;128989;5297;9127;9993;54584;91179;85376;8216;85359;8318;728229;5902,45
-1,1,22,18919942,21505417,2585475,54487;27037;9342;29801;65078;10587;1312;6545;7290;421;2812;6899;5625;7625;79680;64976;6576;3053;8218;5413;80764;23617;400891;1399;7122;150209;128977;8220;388849;84861;7353;51586;2928;128989;5297;9127;9993;54584;91179;85376;8216;85359;8318;728229;5902,45
-1,1,22,18919942,21505417,2585475,54487;27037;9342;29801;65078;10587;1312;6545;7290;421;2812;6899;5625;7625;79680;64976;6576;3053;8218;5413;80764;23617;400891;1399;7122;150209;128977;8220;388849;84861;7353;51586;2928;128989;5297;9127;9993;54584;91179;85376;8216;85359;8318;728229;5902,45
-1,1,22,18919942,21505417,2585475,54487;27037;9342;29801;65078;10587;1312;6545;7290;421;2812;6899;5625;7625;79680;64976;6576;3053;8218;5413;80764;23617;400891;1399;7122;150209;128977;8220;388849;84861;7353;51586;2928;128989;5297;9127;9993;54584;91179;85376;8216;85359;8318;728229;5902,45
-1,1,22,18919942,21505417,2585475,54487;27037;9342;29801;65078;10587;1312;6545;7290;421;2812;6899;5625;7625;79680;64976;6576;3053;8218;5413;80764;23617;400891;1399;7122;150209;128977;8220;388849;84861;7353;51586;2928;128989;5297;9127;9993;54584;91179;85376;8216;85359;8318;728229;5902,45
1,1,22,18919942,21561514,2641572,54487;27037;9342;29801;65078;10587;1312;6545;7290;421;2812;6899;5625;7625;79680;64976;6576;3053;8218;5413;80764;23617;400891;1399;7122;150209;128977;8220;388849;84861;7353;51586;2928;128989;5297;9127;9993;54584;91179;85376;8216;85359;8318;728229;5902,45
1,1,22,18919942,21561514,2641572,54487;27037;9342;29801;65078;10587;1312;6545;7290;421;2812;6899;5625;7625;79680;64976;6576;3053;8218;5413;80764;23617;400891;1399;7122;150209;128977;8220;388849;84861;7353;51586;2928;128989;5297;9127;9993;54584;91179;85376;8216;85359;8318;728229;5902,45
-1,1,22,18919942,21561514,2641572,54487;27037;9342;29801;65078;10587;1312;6545;7290;421;2812;6899;5625;7625;79680;64976;6576;3053;8218;5413;80764;23617;400891;1399;7122;150209;128977;8220;388849;84861;7353;51586;2928;128989;5297;9127;9993;54584;91179;85376;8216;85359;8318;728229;5902,45
-1,1,22,18919942,21561514,2641572,54487;27037;9342;29801;65078;10587;1312;6545;7290;421;2812;6899;5625;7625;79680;64976;6576;3053;8218;5413;80764;23617;400891;1399;7122;150209;128977;8220;388849;84861;7353;51586;2928;128989;5297;9127;9993;54584;91179;85376;8216;85359;8318;728229;5902,45
-1,1,22,18919942,21561514,2641572,54487;27037;9342;29801;65078;10587;1312;6545;7290;421;2812;6899;5625;7625;79680;64976;6576;3053;8218;5413;80764;23617;400891;1399;7122;150209;128977;8220;388849;84861;7353;51586;2928;128989;5297;9127;9993;54584;91179;85376;8216;85359;8318;728229;5902,45
-1,1,22,18919942,21561514,2641572,54487;27037;9342;29801;65078;10587;1312;6545;7290;421;2812;6899;5625;7625;79680;64976;6576;3053;8218;5413;80764;23617;400891;1399;7122;150209;128977;8220;388849;84861;7353;51586;2928;128989;5297;9127;9993;54584;91179;85376;8216;85359;8318;728229;5902,45
1,1,22,18919942,21561514,2641572,54487;27037;9342;29801;65078;10587;1312;6545;7290;421;2812;6899;5625;7625;79680;64976;6576;3053;8218;5413;80764;23617;400891;1399;7122;150209;128977;8220;388849;84861;7353;51586;2928;128989;5297;9127;9993;54584;91179;85376;8216;85359;8318;728229;5902,45
1,1,22,18919942,21801604,2881662,54487;27037;9342;29801;65078;10587;1312;6545;7290;421;2812;6899;5625;7625;79680;23119;64976;6576;3053;8218;5413;80764;23617;400891;1399;7122;150209;128977;8220;388849;84861;7353;51586;2928;128989;5297;9127;9993;54584;91179;85376;8216;440804;85359;8318;728229;5902,47
1,1,22,18919942,21809009,2889067,54487;27037;9342;29801;65078;10587;1312;6545;7290;421;2812;6899;5625;7625;79680;23119;64976;6576;3053;8218;5413;80764;23617;400891;1399;7122;150209;128977;8220;388849;84861;7353;51586;2928;128989;5297;9127;9993;54584;91179;85376;8216;440804;85359;8318;728229;5902,47
1,1,22,18919942,21809009,2889067,54487;27037;9342;29801;65078;10587;1312;6545;7290;421;2812;6899;5625;7625;79680;23119;64976;6576;3053;8218;5413;80764;23617;400891;1399;7122;150209;128977;8220;388849;84861;7353;51586;2928;128989;5297;9127;9993;54584;91179;85376;8216;440804;85359;8318;728229;5902,47
1,1,22,18919987,21561468,2641481,54487;27037;9342;29801;65078;10587;1312;6545;7290;421;2812;6899;5625;7625;79680;64976;6576;3053;8218;5413;80764;23617;400891;1399;7122;150209;128977;8220;388849;84861;7353;51586;2928;128989;5297;9127;9993;54584;91179;85376;8216;85359;8318;728229;5902,45
1,1,22,18937381,21465659,2528278,54487;27037;9342;29801;65078;10587;1312;6545;7290;421;2812;6899;7625;79680;64976;6576;3053;8218;5413;80764;23617;400891;1399;7122;150209;128977;8220;388849;84861;7353;51586;2928;128989;5297;9127;9993;54584;91179;85376;8216;85359;8318;728229;5902,44
1,1,22,18970561,21465659,2495098,54487;27037;9342;29801;65078;10587;1312;6545;7290;421;2812;6899;7625;79680;64976;6576;3053;8218;5413;80764;23617;400891;1399;7122;150209;128977;8220;388849;84861;7353;51586;2928;128989;5297;9127;9993;54584;91179;85376;8216;85359;8318;728229;5902,44
1,1,22,18970561,21465659,2495098,54487;27037;9342;29801;65078;10587;1312;6545;7290;421;2812;6899;7625;79680;64976;6576;3053;8218;5413;80764;23617;400891;1399;7122;150209;128977;8220;388849;84861;7353;51586;2928;128989;5297;9127;9993;54584;91179;85376;8216;85359;8318;728229;5902,44
-1,1,22,18970561,21465662,2495101,54487;27037;9342;29801;65078;10587;1312;6545;7290;421;2812;6899;7625;79680;64976;6576;3053;8218;5413;80764;23617;400891;1399;7122;150209;128977;8220;388849;84861;7353;51586;2928;128989;5297;9127;9993;54584;91179;85376;8216;85359;8318;728229;5902,44
-1,1,22,18999803,21455499,2455696,54487;27037;9342;29801;65078;10587;1312;6545;7290;421;2812;6899;7625;79680;64976;6576;3053;8218;5413;80764;23617;400891;1399;7122;150209;128977;8220;388849;84861;7353;51586;2928;128989;5297;9127;9993;54584;91179;85376;8216;85359;8318;728229;5902,44
1,-1,22,19006337,19010683,4346,,0
-1,1,22,19023801,21440455,2416654,54487;27037;9342;29801;65078;10587;1312;6545;421;7290;2812;6899;7625;79680;64976;6576;3053;8218;5413;80764;23617;400891;1399;7122;150209;128977;8220;388849;84861;7353;51586;2928;128989;5297;9127;9993;54584;91179;8216;85376;85359;8318;728229;5902,44
-1,1,22,19023801,21440455,2416654,54487;27037;9342;29801;65078;10587;1312;6545;421;7290;2812;6899;7625;79680;64976;6576;3053;8218;5413;80764;23617;400891;1399;7122;150209;128977;8220;388849;84861;7353;51586;2928;128989;5297;9127;9993;54584;91179;8216;85376;85359;8318;728229;5902,44
-1,1,22,19023801,21440455,2416654,54487;27037;9342;29801;65078;10587;1312;6545;421;7290;2812;6899;7625;79680;64976;6576;3053;8218;5413;80764;23617;400891;1399;7122;150209;128977;8220;388849;84861;7353;51586;2928;128989;5297;9127;9993;54584;91179;8216;85376;85359;8318;728229;5902,44
-1,1,22,19024656,21465659,2441003,54487;27037;9342;29801;65078;10587;1312;6545;421;7290;2812;6899;7625;79680;64976;6576;3053;8218;5413;80764;23617;400891;1399;7122;150209;128977;8220;388849;84861;7353;51586;2928;128989;5297;9127;9993;54584;91179;8216;85376;85359;8318;728229;5902,44
1,1,22,19024656,21465659,2441003,54487;27037;9342;29801;65078;10587;1312;6545;421;7290;2812;6899;7625;79680;64976;6576;3053;8218;5413;80764;23617;400891;1399;7122;150209;128977;8220;388849;84861;7353;51586;2928;128989;5297;9127;9993;54584;91179;8216;85376;85359;8318;728229;5902,44
-1,1,22,19024656,21798907,2774251,54487;27037;9342;29801;65078;10587;1312;6545;421;7290;2812;6899;7625;79680;23119;64976;6576;3053;8218;5413;80764;23617;400891;1399;7122;150209;128977;8220;388849;84861;7353;51586;2928;128989;5297;9127;9993;54584;91179;8216;85376;440804;85359;8318;728229;5902,46
-1,1,22,19024657,21465662,2441005,54487;27037;9342;29801;65078;10587;1312;6545;421;7290;2812;6899;7625;79680;64976;6576;3053;8218;5413;80764;23617;400891;1399;7122;150209;128977;8220;388849;84861;7353;51586;2928;128989;5297;9127;9993;54584;91179;8216;85376;85359;8318;728229;5902,44
1,1,22,19024792,21465659,2440867,54487;27037;9342;29801;65078;10587;1312;6545;421;7290;2812;6899;7625;79680;64976;6576;3053;8218;5413;80764;23617;400891;1399;7122;150209;128977;8220;388849;84861;7353;51586;2928;128989;5297;9127;9993;54584;91179;8216;85376;85359;8318;728229;5902,44
-1,1,22,19035323,21464119,2428796,54487;27037;9342;29801;65078;10587;1312;6545;421;7290;2812;6899;7625;79680;64976;6576;3053;8218;5413;80764;23617;400891;1399;7122;150209;128977;8220;388849;84861;7353;51586;2928;128989;5297;9127;9993;54584;91179;8216;85376;85359;8318;728229;5902,44
-1,1,22,19058829,21440514,2381685,54487;27037;9342;29801;65078;10587;1312;6545;421;7290;2812;6899;7625;79680;64976;6576;3053;8218;5413;80764;23617;400891;1399;7122;150209;128977;8220;388849;84861;7353;51586;2928;128989;5297;9127;9993;54584;91179;8216;85376;85359;8318;728229;5902,44
1,1,22,19058829,21561514,2502685,54487;27037;9342;29801;65078;10587;1312;6545;421;7290;2812;6899;7625;79680;64976;6576;3053;8218;5413;80764;23617;400891;1399;7122;150209;128977;8220;388849;84861;7353;51586;2928;128989;5297;9127;9993;54584;91179;8216;85376;85359;8318;728229;5902,44
1,-1,22,19139027,19147404,8377,,0
-1,1,22,19478208,20168230,690022,54487;5413;27037;29801;10587;1312;7122;421;388849;2812;128989;6899;54584;79680;8318;5902,16
1,-1,22,19694673,19712255,17582,5413;2812,2
1,-1,22,19711077,19712255,1178,2812,1
1,-1,22,19711077,19712255,1178,2812,1
1,-1,22,19711077,19712255,1178,2812,1
1,-1,22,19711077,19712255,1178,2812,1
1,-1,22,19711077,19712255,1178,2812,1
1,-1,22,19711077,19712255,1178,2812,1
1,-1,22,19711077,19712255,1178,2812,1
1,-1,22,19711077,19712255,1178,2812,1
1,-1,22,19711077,19712255,1178,2812,1
1,-1,22,19711077,19712255,1178,2812,1
1,-1,22,19746385,19750037,3652,6899,1
1,-1,22,19747933,19749476,1543,6899,1
1,-1,22,19747933,19749476,1543,6899,1
1,-1,22,19753293,19756992,3699,6899,1
1,-1,22,20127284,20144076,16792,388849;29801,2
1,-1,22,20127284,20144076,16792,388849;29801,2
1,-1,22,20127284,20144076,16792,388849;29801,2
1,-1,22,20127284,20144076,16792,388849;29801,2
1,-1,22,20127284,20144076,16792,388849;29801,2
1,-1,22,20127284,20144076,16792,388849;29801,2
1,-1,22,20127284,20144076,16792,388849;29801,2
1,-1,22,20127284,20144076,16792,388849;29801,2
1,-1,22,20127284,20144076,16792,388849;29801,2
1,-1,22,20130578,20133609,3031,29801,1
-1,1,22,20279766,23822986,3543220,7332;9342;100423062;6545;613;23532;129025;645426;29799;91227;23759;150223;9647;27156;7625;23119;9609;3053;164592;23753;80764;5594;7441;400891;1399;2781;150209;8940;51586;9127;84861;5297;140883;150221;91179;8216;85376;440804;85359;728229,40
-1,-1,22,20311613,20732528,420915,85376;728229,2
-1,-1,22,20321692,20708883,387191,85376;728229,2
-1,-1,22,20321692,20732528,410836,85376;728229,2
-1,-1,22,20321692,20732528,410836,85376;728229,2
1,1,22,20717654,21465659,748005,80764;9342;3053;91179;8216;7625;400891;1399;6545;150209;51586;9127;84861;5297,14
-1,1,22,20754407,21440515,686108,80764;9342;91179;8216;7625;400891;1399;84861;6545;150209;5297;51586;9127;3053,14
-1,1,22,20754422,21440514,686092,80764;9342;91179;8216;7625;400891;1399;84861;6545;150209;5297;51586;9127;3053,14
-1,1,22,20754422,21440514,686092,80764;9342;91179;8216;7625;400891;1399;84861;6545;150209;5297;51586;9127;3053,14
-1,1,22,20754422,21461752,707330,80764;9342;91179;8216;7625;400891;1399;84861;6545;150209;5297;51586;9127;3053,14
1,1,22,20895155,21374512,479357,80764;9342;8216;1399;5297;150209;51586;9127;3053,9
1,1,22,21025654,21505417,479763,80764;9342;3053;8216;400891;1399;6545;150209;9127;5297,10
1,1,22,21025654,22336268,1310614,7332;23753;80764;9342;5594;400891;1399;6545;150209;8940;9127;5297;645426;29799;150221;23759;150223;9647;8216;440804;23119;3053;164592,23
-1,1,22,21029655,22481498,1451843,7332;23753;80764;9342;5594;400891;1399;6545;150209;8940;9127;5297;645426;29799;150221;23759;150223;9647;8216;440804;23119;3053;164592,23
1,-1,22,21044196,21049198,5002,,0
1,-1,22,21044196,21049198,5002,,0
1,-1,22,21044196,21049198,5002,,0
1,-1,22,21044196,21049198,5002,,0
1,-1,22,21044196,21049198,5002,,0
1,-1,22,21044196,21049198,5002,,0
1,-1,22,21044196,21049198,5002,,0
1,-1,22,21044196,21049198,5002,,0
1,-1,22,21044196,21049198,5002,,0
1,-1,22,21044196,21049198,5002,,0
1,-1,22,21044196,21065882,21686,5297,1
1,-1,22,21044196,21065882,21686,5297,1
1,-1,22,21044196,21065882,21686,5297,1
1,-1,22,21044196,21065882,21686,5297,1
1,-1,22,21044196,21065882,21686,5297,1
1,-1,22,21044196,21065882,21686,5297,1
1,-1,22,21044196,21065882,21686,5297,1
1,-1,22,21044196,21065882,21686,5297,1
1,-1,22,21044196,21065882,21686,5297,1
1,1,22,21044196,21440455,396259,80764;9342;3053;8216;400891;1399;6545;150209;9127;5297,10
1,-1,22,21044808,21065882,21074,5297,1
1,-1,22,21045809,21065882,20073,5297,1
1,-1,22,21049198,21065882,16684,5297,1
1,-1,22,21049198,21065882,16684,5297,1
1,-1,22,21049198,21065882,16684,5297,1
1,-1,22,21055472,21065882,10410,5297,1
1,-1,22,21055472,21065882,10410,5297,1
1,-1,22,21055472,21065882,10410,5297,1
1,-1,22,21055472,21065882,10410,5297,1
1,-1,22,21055472,21065882,10410,5297,1
1,-1,22,21055472,21065882,10410,5297,1
1,-1,22,21055472,21065882,10410,5297,1
-1,1,22,21059669,21461606,401937,80764;9342;3053;8216;400891;1399;6545;150209;9127;5297,10
1,1,22,21065882,21440455,374573,80764;9342;3053;8216;400891;1399;6545;150209;9127;5297,10
-1,1,22,21065882,21937680,871798,7332;80764;9342;400891;1399;6545;150209;9127;5297;645426;150221;8216;440804;23119;3053,15
1,1,22,21081260,21440455,359195,80764;9342;3053;8216;400891;1399;6545;150209;9127;5297,10
-1,1,22,21081260,24593820,3512560,7332;4320;9342;100423062;6545;613;391322;400916;150248;23532;129025;645426;29799;91227;23759;150223;9647;27156;653689;4282;23119;29802;100037417;9609;3053;164592;23753;80764;5594;7441;3543;400891;1399;2781;7621;66035;150209;2952;8940;9127;5297;266747;140883;150221;8216;440804;51233;6598;1652;56241;23523;91319,52
1,1,22,21261514,37583387,16321873,23481;1413;24144;129049;7533;100423062;613;4733;391322;2130;400916;23541;114904;7078;4357;91227;402055;6948;80831;51537;2687;3985;164592;6634;730005;200312;23753;57168;5594;550631;23598;25807;3543;6527;7621;3976;2952;8563;4744;440822;129080;140883;2678;6523;1652;23523;6525;4320;140606;4627;23543;8897;80832;1439;51493;150280;150248;9681;23759;150223;9647;653689;4282;55954;23331;80830;23762;150290;164656;25793;4689;255349;8224;2781;1399;4174;162;29796;80020;253143;11200;266747;8508;51733;7494;10738;440804;4151;164633;10369;5816;10633;9215;23761;91319;7332;85379;23544;284898;150274;80833;1417;150275;6545;23780;129025;10739;8459;157;83999;23119;29802;91464;50487;1415;105372977;80764;22880;84164;7441;66035;150209;10043;8940;113791;79734;150221;3560;83606;8664;23384;56241;5008;27124;1414;388886;10042;89781;5988;25775;4330;652968;91445;254240;284904;7263;23532;150297;645426;29799;91355;27156;23760;3162;25770;100037417;9609;339665;339669;266629;11020;10634;400891;84700;9127;56478;25828;4771;84133;83874;8216;9814;135;51233;6598;10291;23551;9514;8542,179
1,-1,22,21368160,21377192,9032,9127,1
1,-1,22,21387900,21461752,73852,400891,1
1,-1,22,21400683,21461752,61069,400891,1
-1,-1,22,21468378,21684857,216479,,0
-1,-1,22,21468378,21684857,216479,,0
-1,-1,22,21468378,21684857,216479,,0
-1,-1,22,21468378,21684857,216479,,0
-1,-1,22,21468378,21684857,216479,,0
-1,-1,22,21468378,21684857,216479,,0
-1,-1,22,21468378,21684857,216479,,0
-1,-1,22,21468378,21684857,216479,,0
-1,-1,22,21468378,21684857,216479,,0
-1,-1,22,21468378,21684857,216479,,0
-1,-1,22,21468378,21684857,216479,,0
-1,-1,22,21468378,21684857,216479,,0
-1,-1,22,21468378,21684857,216479,,0
-1,-1,22,21468378,21684857,216479,,0
-1,1,22,21505358,22959664,1454306,7332;23753;5594;7441;8940;23532;129025;645426;29799;150221;140883;23759;150223;9647;440804;23119;164592,17
-1,1,22,21505386,22905025,1399639,7332;23753;5594;7441;8940;23532;129025;645426;29799;150221;140883;23759;150223;9647;440804;23119;164592,17
-1,1,22,21798705,22916612,1117907,7332;23753;5594;7441;8940;23532;129025;645426;29799;150221;140883;23759;150223;9647;23119;164592,16
-1,1,22,21798906,22997928,1199022,7332;23753;5594;7441;8940;23532;129025;645426;29799;150221;140883;23759;150223;9647;91227;23119;164592,17
-1,1,22,21798907,22962196,1163289,7332;23753;5594;7441;8940;23532;129025;645426;29799;150221;140883;23759;150223;9647;23119;164592,16
-1,1,22,21798907,22962196,1163289,7332;23753;5594;7441;8940;23532;129025;645426;29799;150221;140883;23759;150223;9647;23119;164592,16
-1,1,22,21798907,22962962,1164055,7332;23753;5594;7441;8940;23532;129025;645426;29799;150221;140883;23759;150223;9647;23119;164592,16
-1,1,22,21798907,23666232,1867325,7332;23753;5594;7441;2781;100423062;613;8940;23532;129025;645426;29799;91227;140883;23759;150223;9647;27156;150221;23119;9609;164592,22
-1,1,22,21801633,22998308,1196675,7332;23753;5594;7441;8940;23532;129025;645426;29799;150221;140883;23759;150223;9647;91227;23119;164592,17
1,1,22,21804562,24659578,2855016,7332;4320;100423062;613;391322;400916;150248;23532;129025;645426;29799;91227;23759;150223;9647;27156;653689;4282;23119;29802;100037417;2687;9609;164592;23753;5594;7441;3543;2781;7621;2952;66035;8940;266747;140883;150221;51233;6598;1652;56241;23523;91319,42
-1,1,22,21808938,22905025,1096087,129025;645426;7332;150221;23753;23759;150223;29799;5594;9647;140883;7441;23532;8940;164592,15
-1,1,22,21808950,22905068,1096118,129025;645426;7332;150221;23753;23759;150223;29799;5594;9647;140883;7441;23532;8940;164592,15
-1,1,22,21808950,22905068,1096118,129025;645426;7332;150221;23753;23759;150223;29799;5594;9647;140883;7441;23532;8940;164592,15
-1,1,22,21808950,23654222,1845272,7332;23753;5594;7441;2781;100423062;613;8940;23532;129025;645426;29799;91227;140883;23759;150223;9647;27156;150221;9609;164592,21
-1,1,22,21808950,23756873,1947923,7332;23753;5594;7441;2781;100423062;613;8940;23532;129025;645426;29799;91227;140883;23759;150223;9647;27156;150221;9609;164592,21
1,1,22,21808950,23756873,1947923,7332;23753;5594;7441;2781;100423062;613;8940;23532;129025;645426;29799;91227;140883;23759;150223;9647;27156;150221;9609;164592,21
-1,1,22,21808950,24643108,2834158,7332;4320;100423062;613;391322;400916;150248;23532;129025;645426;29799;91227;23759;150223;9647;27156;653689;4282;29802;100037417;2687;9609;164592;23753;5594;7441;3543;2781;7621;2952;66035;8940;266747;140883;150221;51233;6598;1652;56241;23523;91319,41
-1,1,22,21808950,24643108,2834158,7332;4320;100423062;613;391322;400916;150248;23532;129025;645426;29799;91227;23759;150223;9647;27156;653689;4282;29802;100037417;2687;9609;164592;23753;5594;7441;3543;2781;7621;2952;66035;8940;266747;140883;150221;51233;6598;1652;56241;23523;91319,41
-1,1,22,21917191,22959668,1042477,129025;7332;29799;23753;140883;23759;150223;9647;5594;164592;7441;8940;23532,13
1,1,22,21937680,22990230,1052550,129025;7332;91227;29799;23753;140883;23759;150223;9647;5594;164592;7441;8940;23532,14
-1,-1,22,22336262,22556709,220447,8940,1
-1,-1,22,22336262,22556709,220447,8940,1
-1,-1,22,22313381,22336268,22887,8940,1
1,-1,22,22313381,22336268,22887,8940,1
1,-1,22,22313381,22336268,22887,8940,1
1,-1,22,22313381,22336268,22887,8940,1
1,-1,22,22313381,22336268,22887,8940,1
1,-1,22,22313381,22336268,22887,8940,1
1,-1,22,22313381,22336268,22887,8940,1
1,-1,22,22323131,22574790,251659,8940,1
-1,-1,22,22336268,22556733,220465,8940,1
1,-1,22,22348942,22556704,207762,,0
-1,-1,22,22728411,23228810,500399,129025;91227;140883;23532,4
1,1,22,23012013,23643164,631151,2781;100423062;613;27156;9609,5
1,1,22,23012013,24959827,1947814,4320;3543;2781;7621;100423062;2952;613;66035;391322;400916;150248;266747;51733;27156;653689;4282;83606;23384;135;51233;6598;1652;29802;56241;100037417;2687;9609;23523;6634;91319,30
1,1,22,23012013,24959827,1947814,4320;3543;2781;7621;100423062;2952;613;66035;391322;400916;150248;266747;51733;27156;653689;4282;83606;23384;135;51233;6598;1652;29802;56241;100037417;2687;9609;23523;6634;91319,30
-1,1,22,23012069,23654237,642168,2781;100423062;613;27156;9609,5
1,1,22,23258229,25046758,1788529,4320;3543;2781;7621;2952;66035;613;388886;391322;400916;150248;266747;51733;27156;2678;653689;4282;83606;23384;135;51233;6598;1652;29802;56241;100037417;2687;9609;23523;6634;91319,31
1,1,22,23258938,25002659,1743721,4320;3543;2781;7621;2952;66035;613;388886;391322;400916;150248;266747;51733;27156;2678;653689;4282;83606;23384;135;51233;6598;1652;29802;56241;100037417;2687;9609;23523;6634;91319,31
1,1,22,23621418,36643415,13021997,23481;1413;24144;129049;7533;613;4733;391322;2130;400916;23541;7078;402055;6948;80831;51537;2687;3985;6634;730005;200312;57168;550631;23598;25807;3543;6527;7621;3976;2952;8563;4744;440822;129080;2678;6523;1652;23523;6525;4320;140606;23543;8897;80832;51493;150280;150248;9681;653689;4282;55954;23331;80830;23762;150290;25793;255349;8224;4174;162;29796;253143;11200;266747;8508;51733;7494;10738;4151;164633;10633;9215;23761;91319;23544;85379;284898;150274;80833;1417;150275;23780;10739;8459;157;83999;29802;91464;50487;1415;105372977;22880;84164;66035;10043;113791;83606;23384;56241;5008;27124;1414;388886;10042;89781;5988;25775;4330;652968;91445;254240;284904;150297;91355;23760;3162;25770;100037417;339665;266629;10634;84700;56478;4771;84133;83874;9814;135;51233;6598;10291;23551;9514,133
1,1,22,23637907,36614412,12976505,23481;1413;24144;129049;7533;613;4733;391322;2130;400916;23541;7078;402055;6948;80831;51537;2687;3985;6634;730005;200312;57168;550631;23598;25807;3543;6527;7621;3976;2952;8563;4744;440822;129080;2678;6523;1652;23523;6525;4320;140606;23543;8897;80832;51493;150280;150248;9681;653689;4282;55954;23331;80830;23762;150290;25793;255349;8224;4174;162;29796;253143;11200;266747;8508;51733;7494;10738;4151;164633;10633;9215;23761;91319;23544;85379;284898;150274;80833;1417;150275;10739;8459;157;83999;29802;91464;50487;1415;105372977;22880;84164;66035;10043;113791;83606;23384;56241;5008;27124;1414;388886;10042;89781;5988;25775;4330;652968;91445;254240;284904;150297;91355;23760;3162;25770;100037417;339665;266629;10634;84700;56478;4771;84133;83874;9814;135;51233;6598;10291;23551;9514,132
-1,1,22,23690387,24666092,975705,4320;3543;7621;2952;66035;391322;400916;150248;266747;653689;4282;51233;6598;1652;29802;56241;100037417;2687;23523;91319,20
1,1,22,23720171,24959827,1239656,4320;3543;7621;2952;66035;391322;400916;150248;266747;51733;653689;4282;83606;23384;135;51233;6598;1652;29802;56241;100037417;2687;23523;6634;91319,25
1,1,22,23739611,24544632,805021,4320;3543;7621;2952;66035;391322;400916;150248;266747;653689;4282;51233;6598;1652;29802;100037417;23523;91319,18
-1,-1,22,24328565,24385948,57383,2952;391322,2
-1,-1,22,24347988,24385948,37960,2952;391322,2
-1,-1,22,24347988,24385948,37960,2952;391322,2
-1,-1,22,24347988,24385948,37960,2952;391322,2
-1,-1,22,24347988,24385948,37960,2952;391322,2
-1,-1,22,24347988,24385948,37960,2952;391322,2
-1,-1,22,24347988,24385948,37960,2952;391322,2
-1,-1,22,24347988,24385948,37960,2952;391322,2
-1,-1,22,24347988,24385948,37960,2952;391322,2
-1,-1,22,24347988,24385948,37960,2952;391322,2
-1,-1,22,24347988,24385948,37960,2952;391322,2
-1,-1,22,24371005,24382415,11410,2952;391322,2
-1,-1,22,24371005,24382415,11410,2952;391322,2
-1,-1,22,24371005,24382415,11410,2952;391322,2
-1,-1,22,24371005,24382415,11410,2952;391322,2
-1,-1,22,24371005,24382415,11410,2952;391322,2
1,-1,22,24640758,24658565,17807,2687,1
1,-1,22,24640758,24658565,17807,2687,1
1,-1,22,24640758,24658565,17807,2687,1
1,-1,22,24640758,24658565,17807,2687,1
1,-1,22,24640758,24658565,17807,2687,1
1,-1,22,25010707,25053267,42560,2678,1
1,-1,22,25010707,25053267,42560,2678,1
-1,-1,22,25664650,25903747,239097,91355,1
-1,-1,22,25664650,25903747,239097,91355,1
-1,-1,22,25664650,25903747,239097,91355,1
-1,-1,22,25664650,25903747,239097,91355,1
-1,-1,22,25664650,25903747,239097,91355,1
-1,-1,22,25664650,25903747,239097,91355,1
-1,-1,22,25664650,25903747,239097,91355,1
-1,-1,22,25664650,25903747,239097,91355,1
-1,-1,22,25664650,25903747,239097,91355,1
-1,-1,22,25664650,25903747,239097,91355,1
-1,-1,22,25664650,25903747,239097,91355,1
-1,-1,22,25664650,25903747,239097,91355,1
-1,-1,22,25664650,25903747,239097,91355,1
-1,-1,22,25664650,25903747,239097,91355,1
-1,-1,22,25664650,25903747,239097,91355,1
-1,-1,22,25664650,25903747,239097,91355,1
-1,-1,22,25664650,25903747,239097,91355,1
-1,-1,22,25664650,25903747,239097,91355,1
-1,-1,22,25664650,25903747,239097,91355,1
-1,-1,22,25664650,25903747,239097,91355,1
-1,-1,22,25664650,25903747,239097,91355,1
-1,-1,22,25664650,25903747,239097,91355,1
-1,-1,22,25664650,25903747,239097,91355,1
-1,-1,22,25664650,25903747,239097,91355,1
-1,-1,22,25659172,25886807,227635,91355,1
1,-1,22,25664618,25892253,227635,91355,1
1,-1,22,25664618,25892253,227635,91355,1
-1,-1,22,25664646,25903514,238868,91355,1
1,-1,22,25695468,25903811,208343,91355,1
-1,-1,22,25695469,25903543,208074,91355,1
-1,-1,22,25695469,25903543,208074,91355,1
-1,-1,22,25695469,25903543,208074,91355,1
-1,-1,22,25695469,25903543,208074,91355,1
-1,-1,22,25695469,25903543,208074,91355,1
-1,-1,22,25695469,25903543,208074,91355,1
-1,-1,22,25695469,25903543,208074,91355,1
1,-1,22,25695469,25903543,208074,91355,1
1,-1,22,25695469,25903543,208074,91355,1
1,-1,22,25726380,25799552,73172,91355,1
1,-1,22,25970646,26108401,137755,157,1
-1,1,22,26847008,31847912,5000904,23481;284898;150274;1413;24144;150275;4733;2130;23541;402055;6948;8459;83999;51537;50487;3985;730005;105372977;200312;22880;84164;550631;23598;25807;3976;8563;4744;129080;113791;5008;27124;1414;89781;5988;6525;4330;140606;8897;652968;91445;284904;150280;55954;23760;25770;23331;23762;339665;150290;266629;10634;162;29796;11200;56478;4771;84133;8508;83874;7494;164633;10291;10633;9514,64
-1,1,22,28368472,29156338,787866,23331;150274;11200,3
-1,-1,22,28873373,28943898,70525,23331,1
-1,1,22,29998464,30035142,36678,4771,1
-1,1,22,36877226,38548989,1671763,51386;27128;79159;3005;6753;3957;23616;1439;7263;26088;114904;84645;4357;129138;6663;4242;8484;23464;85377;23539;29775;339669;164656;4689;11020;80020;114794;11135;9463;3956;25828;79734;8398;11078;3560;8664;10369;57026;5816;5880;80115;5435,42
-1,1,22,37843259,39499685,1656426,10126;23466;200315;51386;79159;3005;9567;3957;1454;23616;23764;26088;60489;84645;6663;129138;4242;8484;140564;25776;23464;85377;23539;10521;56993;200316;11144;29775;164668;9929;23467;646851;25829;27350;102800317;11135;9463;3956;3761;9582;8398;11078;11015;57026;80115;5435;25777,47
-1,1,22,37866631,39054815,1188184,51386;79159;3005;3957;1454;23616;23764;26088;84645;6663;129138;4242;8484;25776;23464;85377;23539;10521;11144;29775;646851;25829;102800317;11135;9463;3956;3761;8398;11078;11015;57026;80115;5435,33
1,1,22,39312492,51203353,11890861,200315;150383;91582;115650;2033;55267;25813;6942;79174;27352;10478;4668;415116;83642;158;6767;23542;9978;84271;164684;83933;91689;1565;79924;27351;84844;4809;84247;440829;6305;150350;51512;1890;25830;23654;25817;9402;91289;26286;113828;5905;5155;26150;171568;7008;85358;400935;23492;2192;80274;6721;54471;49;758;150368;1120;440836;4700;5465;150372;50;27350;63929;253190;64098;79087;55020;638;85352;55586;11252;9145;85378;79879;468;25771;79019;23151;23774;80305;10766;1727;79640;150379;55007;1375;55964;164668;553158;7380;6300;10343;83746;23313;2547;53947;23264;27254;29781;5372;2847;64800;27341;410;4248;706;9701;56666;5600;27127;60489;150356;9889;140564;414918;25809;8911;10454;9997;9620;267020;150365;200316;64781;112885;29780;644186;23170;150353;23779;23209;7477;25814;80339;10762;27349;55687;6122;348645;57591;55615;113730;9582;23112;54456,145
-1,-1,22,39323589,39380039,56450,9582;200315,2
-1,-1,22,39353666,39380039,26373,9582;200315,2
-1,-1,22,39353666,39380039,26373,9582;200315,2
-1,-1,22,39353666,39380039,26373,9582;200315,2
-1,-1,22,39353666,39380039,26373,9582;200315,2
-1,-1,22,39353666,39380039,26373,9582;200315,2
-1,-1,22,39353666,39380039,26373,9582;200315,2
-1,-1,22,39353666,39380039,26373,9582;200315,2
-1,-1,22,39353666,39380039,26373,9582;200315,2
-1,-1,22,39353666,39380039,26373,9582;200315,2
-1,-1,22,39353666,39380039,26373,9582;200315,2
-1,-1,22,39353666,39380039,26373,9582;200315,2
-1,-1,22,39353666,39407494,53828,9582;200315,2
-1,-1,22,39353666,39407494,53828,9582;200315,2
-1,-1,22,39353666,39407494,53828,9582;200315,2
-1,-1,22,39353666,39407494,53828,9582;200315,2
-1,-1,22,39353666,39407494,53828,9582;200315,2
-1,-1,22,39359112,39385485,26373,9582;200315,2
-1,-1,22,39359112,39385485,26373,9582;200315,2
-1,-1,22,39359112,39385485,26373,9582;200315,2
-1,-1,22,39359112,39385485,26373,9582;200315,2
-1,-1,22,39359112,39385485,26373,9582;200315,2
1,1,22,40598018,51174234,10576216,11252;150383;85378;79879;25771;79019;23151;23774;80305;10766;115650;2033;55267;25813;1727;6942;79174;27352;79640;150379;55007;1375;10478;4668;415116;55964;83642;158;6767;23542;553158;9978;84271;164684;7380;6300;10343;83933;83746;91689;1565;79924;23313;2547;27351;84844;4809;84247;440829;6305;51512;1890;53947;25830;23654;25817;23264;27254;29781;91289;5372;26286;5905;26150;7008;171568;2847;85358;64800;27341;410;400935;706;2192;9701;80274;56666;5600;27127;6721;150356;9889;414918;758;25809;150368;9997;9620;1120;440836;4700;267020;150365;5465;64781;112885;150372;29780;50;644186;63929;23170;150353;23779;23209;253190;7477;64098;25814;80339;79087;10762;55020;27349;55687;638;348645;85352;57591;55615;113730;55586;23112;54456,124
1,-1,22,41128510,41288860,160350,150353;63929;10478;6767,4
1,-1,22,41647929,41677294,29365,5905,1
1,1,22,41673826,42810963,1137137,150372;50;164684;79879;5372;91689;1565;6721;2547;27351;79019;84844;4809;171568;440829;10766;115650;4700;150368;55964;23264;6942;27254;79640;150365;5905;4668;7008,28
-1,1,22,42267147,51178264,8911117,11252;150383;85378;25771;79019;23151;23774;80305;115650;55267;25813;1727;6942;79174;150379;55007;1375;4668;415116;55964;83642;23542;553158;84271;164684;7380;6300;10343;83933;91689;1565;79924;23313;84247;440829;6305;51512;1890;53947;25830;23654;25817;29781;91289;26286;26150;85358;64800;27341;410;400935;706;2192;9701;80274;56666;5600;27127;6721;49;9889;414918;758;25809;150368;9997;9620;1120;440836;4700;267020;64781;5465;112885;150372;29780;644186;23170;23779;23209;253190;7477;64098;25814;80339;79087;10762;55020;27349;55687;638;348645;85352;55615;113730;55586;54456,97
-1,1,22,42441918,51197838,8755920,11252;150383;85378;25771;23151;23774;80305;55267;25813;1727;6942;79174;150379;55007;1375;4668;415116;83642;23542;553158;84271;7380;6300;10343;83933;91689;1565;79924;23313;84247;6305;51512;1890;53947;25830;23654;25817;29781;91289;26286;26150;85358;64800;27341;410;400935;706;2192;9701;80274;56666;5600;27127;49;9889;414918;758;25809;150368;9997;9620;1120;440836;4700;267020;64781;5465;112885;150372;29780;644186;23170;23779;23209;253190;7477;64098;25814;80339;79087;10762;55020;27349;55687;638;348645;85352;55615;113730;55586;54456,91
1,1,22,42476081,51178264,8702183,11252;150383;85378;25771;23151;23774;80305;55267;25813;1727;6942;79174;150379;55007;1375;415116;83642;23542;553158;84271;7380;6300;10343;83933;91689;79924;1565;23313;84247;6305;51512;1890;53947;25830;23654;25817;29781;91289;26286;26150;85358;64800;27341;410;400935;706;2192;9701;80274;56666;5600;27127;49;9889;414918;758;25809;9997;9620;1120;440836;4700;267020;64781;5465;112885;150372;29780;644186;23170;23779;23209;253190;7477;64098;25814;80339;79087;10762;55020;27349;55687;638;348645;85352;55615;113730;55586;54456,89
1,-1,22,42486662,42525705,39043,1565;4700,2
1,-1,22,42486662,42536651,49989,1565;4700,2
1,-1,22,42486662,42540449,53787,1565;4700,2
1,-1,22,42522607,42536651,14044,1565,1
-1,-1,22,42522607,42537387,14780,1565,1
-1,-1,22,42523991,42537387,13396,1565,1
-1,-1,22,42523991,42537387,13396,1565,1
-1,-1,22,42523991,42537387,13396,1565,1
-1,-1,22,42523991,42540449,16458,1565,1
1,-1,22,42523991,42540449,16458,1565,1
1,1,22,42776967,51197838,8420871,11252;150383;85378;25771;23151;23774;80305;55267;25813;1727;79174;150379;55007;1375;415116;83642;23542;553158;84271;7380;6300;10343;83933;79924;23313;84247;6305;51512;1890;53947;25830;23654;25817;29781;91289;26286;26150;85358;64800;27341;410;400935;706;2192;9701;80274;56666;5600;27127;49;9889;414918;758;25809;9997;9620;1120;440836;267020;64781;5465;112885;150372;29780;644186;23170;23779;23209;253190;7477;64098;25814;80339;79087;10762;55020;27349;55687;638;348645;85352;55615;113730;55586;54456,85
-1,1,22,42889451,50706908,7817457,11252;150383;85378;25771;23151;23774;80305;55267;25813;1727;79174;150379;55007;415116;83642;553158;84271;7380;6300;10343;83933;23313;84247;51512;53947;25830;25817;26286;26150;64800;27341;400935;706;2192;56666;80274;5600;27127;9889;25809;758;9620;267020;64781;5465;112885;29780;23170;23779;23209;253190;7477;64098;25814;80339;10762;79087;55020;27349;55687;638;348645;85352;55615;54456,65
-1,1,22,43050743,51197838,8147095,11252;150383;85378;25771;23151;23774;80305;55267;25813;79174;150379;55007;1375;415116;83642;23542;553158;7380;6300;10343;83933;79924;23313;84247;6305;51512;1890;53947;25830;23654;25817;29781;91289;26286;26150;85358;64800;410;400935;706;2192;9701;80274;56666;5600;27127;49;9889;414918;758;25809;9997;9620;1120;440836;64781;5465;112885;29780;644186;23170;23779;23209;7477;64098;25814;80339;79087;10762;55020;27349;55687;638;348645;85352;55615;113730;55586;54456,79
1,1,22,43106282,51178264,8071982,11252;150383;85378;25771;23151;23774;80305;55267;25813;79174;150379;55007;1375;415116;83642;23542;553158;7380;6300;10343;83933;79924;23313;84247;6305;51512;1890;53947;25830;23654;25817;29781;91289;26286;26150;85358;64800;410;400935;706;2192;9701;80274;56666;5600;27127;49;9889;414918;758;25809;9997;9620;1120;440836;64781;5465;112885;29780;644186;23170;23779;23209;7477;64098;25814;80339;79087;10762;55020;27349;55687;638;348645;85352;55615;113730;55586;54456,79
-1,1,22,43233100,51174234,7941134,11252;150383;85378;25771;23151;23774;80305;55267;25813;79174;150379;55007;1375;415116;83642;23542;553158;7380;6300;10343;83933;79924;23313;84247;6305;51512;1890;25830;23654;25817;29781;91289;26286;26150;85358;64800;410;400935;706;2192;56666;80274;5600;9701;27127;9889;414918;25809;758;9997;9620;1120;440836;64781;5465;112885;29780;644186;23170;23779;23209;7477;64098;25814;80339;10762;79087;55020;27349;55687;638;348645;85352;55615;113730;55586;54456,77
-1,1,22,43381459,51197838,7816379,11252;150383;85378;25771;23151;23774;80305;55267;25813;79174;150379;55007;1375;415116;83642;23542;553158;7380;6300;10343;83933;79924;23313;84247;6305;51512;1890;25830;23654;25817;29781;91289;26150;85358;64800;410;400935;706;2192;56666;80274;5600;9701;27127;49;9889;414918;25809;758;9997;9620;1120;440836;64781;5465;112885;29780;644186;23170;23779;23209;7477;64098;25814;80339;10762;79087;55020;27349;55687;638;348645;85352;55615;113730;55586;54456,77
-1,1,22,43583986,51183872,7599886,150383;85378;25771;23151;23774;80305;55267;25813;79174;150379;55007;1375;415116;83642;23542;553158;7380;6300;10343;83933;79924;23313;84247;6305;51512;1890;25830;23654;25817;29781;91289;26150;85358;64800;410;400935;2192;56666;80274;5600;9701;27127;49;9889;414918;758;9997;9620;1120;440836;64781;5465;112885;29780;644186;23779;23209;7477;64098;25814;80339;10762;79087;55020;55687;348645;85352;55615;113730;55586;54456,71
-1,1,22,43875989,51197838,7321849,150383;85378;25771;23151;23774;80305;55267;25813;79174;150379;55007;1375;415116;83642;23542;553158;7380;6300;10343;83933;79924;23313;84247;6305;51512;1890;25830;23654;25817;29781;91289;26150;85358;64800;410;400935;2192;56666;5600;9701;27127;49;9889;414918;758;9997;9620;1120;440836;64781;5465;112885;29780;644186;23779;23209;7477;64098;25814;80339;10762;79087;55020;55687;348645;85352;55615;113730;55586;54456,70
-1,1,22,44298441,51178264,6879823,150383;85378;25771;23151;23774;80305;55267;25813;79174;55007;1375;415116;83642;23542;553158;7380;6300;10343;83933;79924;23313;84247;6305;51512;1890;23654;25817;29781;91289;26150;85358;410;400935;2192;56666;5600;9701;27127;49;9889;414918;9997;9620;1120;440836;64781;5465;112885;29780;644186;23779;23209;7477;25814;64098;80339;10762;79087;55020;55687;348645;85352;55615;113730;55586;54456,66
1,-1,22,44388759,51121542,6732783,150383;85378;25771;23151;23774;80305;55267;25813;79174;55007;1375;415116;83642;23542;553158;7380;6300;10343;83933;79924;23313;84247;6305;51512;1890;23654;25817;29781;91289;26150;85358;410;400935;2192;56666;5600;9701;27127;9889;414918;9997;9620;1120;440836;64781;5465;112885;29780;644186;23779;23209;7477;25814;64098;10762;79087;55020;55687;348645;55615;85352;113730;55586;54456,64
-1,1,22,45002243,51178264,6176021,85358;150383;410;400935;85378;2192;56666;5600;9701;27127;49;25771;23151;23774;9889;80305;414918;55267;79174;9997;9620;1120;440836;55007;64781;5465;1375;112885;415116;83642;23542;553158;644186;7380;23779;23209;6300;10343;83933;79924;7477;25814;23313;10762;79087;55020;55687;6305;51512;1890;348645;55615;23654;25817;113730;29781;55586;91289;54456;26150,60
-1,1,22,45160169,51178264,6018095,85358;150383;410;400935;85378;2192;56666;5600;9701;27127;49;25771;23151;23774;9889;80305;414918;55267;79174;9997;9620;1120;440836;55007;64781;5465;1375;112885;415116;83642;23542;553158;644186;7380;23779;23209;6300;10343;83933;79924;7477;23313;25814;10762;79087;55020;55687;6305;51512;1890;348645;23654;25817;113730;29781;55586;91289;54456;26150,59
1,1,22,45193119,51178264,5985145,85358;150383;410;400935;85378;2192;56666;5600;9701;27127;49;25771;23151;23774;9889;80305;414918;55267;79174;9997;9620;1120;440836;55007;64781;5465;1375;112885;415116;83642;23542;553158;644186;7380;23779;23209;6300;10343;83933;79924;7477;23313;25814;10762;79087;55020;55687;6305;51512;1890;348645;23654;25817;113730;29781;55586;91289;54456;26150,59
-1,1,22,45261208,51197838,5936630,85358;150383;410;400935;85378;2192;56666;5600;9701;27127;49;25771;23151;23774;9889;80305;414918;55267;79174;9997;9620;1120;440836;55007;64781;5465;1375;112885;415116;83642;23542;644186;7380;23209;6300;10343;83933;79924;7477;23313;25814;10762;79087;55020;55687;6305;51512;1890;348645;23654;25817;113730;29781;55586;91289;54456;26150,57
-1,1,22,46543160,51197838,4654678,85358;150383;410;400935;85378;9701;56666;5600;49;25771;23151;23774;9889;80305;414918;79174;9997;9620;1120;440836;64781;5465;1375;415116;83642;23542;644186;23209;6300;10343;83933;79924;79087;55020;55687;6305;51512;1890;348645;23654;25817;113730;29781;55586;91289;54456,46
-1,1,22,46757062,51197727,4440665,85358;410;400935;85378;9701;56666;5600;49;25771;23151;23774;9889;80305;414918;79174;9997;9620;1120;440836;64781;1375;415116;83642;23542;644186;23209;6300;83933;79924;79087;6305;1890;348645;23654;25817;113730;29781;55586;91289;54456,40
-1,1,22,46866460,51197838,4331378,85358;410;400935;85378;9701;56666;5600;49;25771;23151;23774;9889;80305;414918;79174;9997;9620;1120;440836;64781;1375;415116;83642;23542;644186;23209;6300;83933;79924;79087;6305;1890;348645;23654;25817;113730;29781;55586;91289;54456,40
-1,1,22,47128342,51218950,4090608,85358;410;400935;85378;9701;56666;5600;49;25771;9889;23774;80305;11158;414918;79174;9997;1120;440836;64781;1375;415116;83642;23542;644186;23209;6300;83933;79924;79087;6305;1890;348645;23654;25817;113730;29781;55586;91289;54456,39
-1,1,22,47187586,51237463,4049877,85358;410;400935;85378;9701;56666;5600;49;25771;9889;23774;80305;11158;414918;79174;9997;1120;440836;1375;415116;83642;23542;644186;23209;6300;83933;79924;79087;6305;1890;348645;23654;25817;113730;29781;55586;91289;54456,38
-1,1,22,47247169,51176099,3928930,85358;410;400935;85378;9701;56666;5600;25771;9889;23774;80305;414918;79174;9997;1120;440836;1375;415116;83642;23542;644186;23209;6300;83933;79924;79087;6305;1890;348645;23654;25817;113730;29781;55586;91289;54456,36
-1,1,22,47315714,51178264,3862550,85358;410;400935;85378;9701;56666;5600;49;25771;9889;23774;80305;414918;79174;9997;1120;440836;1375;415116;83642;23542;644186;23209;6300;83933;79924;79087;6305;1890;348645;23654;25817;113730;29781;55586;91289;54456,37
-1,1,22,48457263,51203353,2746090,85358;410;400935;85378;9701;56666;5600;49;9889;23774;80305;414918;79174;9997;1120;440836;1375;415116;83642;23542;644186;23209;6300;83933;79924;79087;6305;1890;348645;23654;25817;113730;29781;55586;91289;54456,36
-1,1,22,48556939,51197838,2640899,85358;410;400935;85378;9701;56666;5600;49;9889;23774;80305;414918;79174;9997;1120;440836;1375;415116;83642;23542;644186;23209;6300;83933;79924;79087;6305;1890;348645;23654;25817;113730;29781;55586;91289;54456,36
-1,1,22,48637187,51178264,2541077,85358;410;400935;85378;9701;56666;5600;49;9889;23774;80305;414918;79174;9997;1120;440836;1375;415116;83642;23542;644186;23209;6300;83933;79924;79087;6305;1890;348645;23654;25817;113730;29781;55586;91289;54456,36
-1,1,22,48896156,51203353,2307197,85358;410;400935;85378;9701;56666;5600;49;9889;23774;80305;414918;79174;9997;1120;440836;1375;415116;83642;23542;644186;23209;6300;83933;79924;79087;6305;1890;348645;23654;25817;113730;29781;55586;91289;54456,36
-1,1,22,48896208,51203353,2307145,85358;410;400935;85378;9701;56666;5600;49;9889;23774;80305;414918;79174;9997;1120;440836;1375;415116;83642;23542;644186;23209;6300;83933;79924;79087;6305;1890;348645;23654;25817;113730;29781;55586;91289;54456,36
-1,1,22,49010148,51178264,2168116,85358;410;400935;85378;9701;56666;5600;49;9889;23774;80305;414918;79174;9997;1120;440836;1375;415116;83642;23542;644186;23209;6300;83933;79924;79087;6305;1890;348645;23654;25817;113730;29781;55586;91289;54456,36
-1,1,22,49146203,51203353,2057150,85358;410;400935;85378;9701;56666;5600;49;9889;23774;80305;414918;79174;9997;1120;440836;1375;415116;83642;23542;644186;23209;6300;83933;79924;79087;6305;1890;348645;23654;25817;113730;29781;55586;91289;54456,36
-1,1,22,49305443,51197838,1892395,85358;410;400935;85378;9701;56666;5600;49;9889;23774;80305;414918;79174;9997;1120;440836;1375;415116;83642;23542;644186;23209;6300;83933;79924;79087;6305;1890;348645;23654;113730;29781;55586;91289;54456,35
1,-1,22,49371757,49499379,127622,,0
1,-1,22,49399646,49995123,595477,,0
1,1,22,49595767,50181440,585673,348645;23774,2
-1,1,22,49628164,51197838,1569674,85358;410;400935;85378;9701;56666;5600;49;9889;23774;80305;414918;79174;9997;1120;440836;1375;415116;83642;23542;644186;23209;6300;83933;79924;79087;6305;1890;348645;23654;113730;29781;55586;91289;54456,35
-1,1,22,49711443,51178264,1466821,85358;410;400935;85378;9701;56666;5600;49;9889;23774;80305;414918;79174;9997;1120;440836;1375;415116;83642;23542;644186;23209;6300;83933;79924;79087;6305;1890;348645;23654;113730;29781;55586;91289;54456,35
-1,1,22,49711443,51178264,1466821,85358;410;400935;85378;9701;56666;5600;49;9889;23774;80305;414918;79174;9997;1120;440836;1375;415116;83642;23542;644186;23209;6300;83933;79924;79087;6305;1890;348645;23654;113730;29781;55586;91289;54456,35
-1,1,22,49774048,51178264,1404216,85358;410;400935;85378;9701;56666;5600;49;9889;23774;80305;414918;79174;9997;1120;440836;1375;415116;83642;23542;644186;23209;6300;83933;79924;79087;6305;1890;348645;23654;113730;29781;55586;91289;54456,35
-1,-1,22,49843984,49898417,54433,,0
-1,-1,22,49843984,49898417,54433,,0
-1,1,22,49898417,51203353,1304936,85358;410;400935;85378;9701;56666;5600;49;9889;23774;80305;414918;79174;9997;1120;440836;1375;415116;83642;23542;644186;23209;6300;83933;79924;79087;6305;1890;348645;23654;113730;29781;55586;91289;54456,35
-1,1,22,49923409,51197838,1274429,85358;410;400935;85378;9701;56666;5600;49;9889;23774;80305;414918;79174;9997;1120;440836;1375;415116;83642;23542;644186;23209;6300;83933;79924;79087;6305;1890;348645;23654;113730;29781;55586;91289;54456,35
-1,1,22,49928762,51203353,1274591,85358;410;400935;85378;9701;56666;5600;49;9889;23774;80305;414918;79174;9997;1120;440836;1375;415116;83642;23542;644186;23209;6300;83933;79924;79087;6305;1890;348645;23654;113730;29781;55586;91289;54456,35
-1,1,22,50145416,51197838,1052422,85358;410;400935;85378;9701;56666;5600;49;9889;23774;80305;414918;79174;9997;1120;440836;1375;415116;83642;23542;644186;23209;6300;83933;79924;79087;6305;1890;23654;113730;29781;55586;91289;54456,34
-1,1,22,50587992,51218950,630958,83642;23542;85358;644186;410;85378;9701;56666;5600;6300;83933;79924;49;80305;6305;11158;414918;1890;23654;113730;9997;29781;1120;440836;55586;91289;1375;54456,28
1,-1,22,50713396,51178264,464868,23542;85358;644186;410;9701;79924;49;6305;414918;1890;23654;113730;9997;29781;1120;440836;55586;91289;1375,19
-1,1,22,50857155,51203353,346198,23542;85358;644186;410;9701;79924;49;6305;1890;113730;9997;29781;55586;91289;440836;1120;1375,17
-1,1,22,50857138,51178264,321126,23542;85358;644186;410;9701;79924;49;6305;1890;113730;9997;29781;55586;91289;440836;1120;1375,17
-1,1,22,50923886,51197838,273952,23542;85358;644186;1890;410;1375;113730;9997;29781;79924;55586;91289;440836;1120;49,15
-1,1,22,51123497,51203353,79856,49;85358,2
-1,1,22,51121360,51183840,62480,49;85358,2
-1,1,22,51121362,51197838,76476,49;85358,2
-1,1,22,51121452,51183872,62420,49;85358,2
-1,1,22,51123491,51178264,54773,49;85358,2
-1,1,22,51123491,51178264,54773,49;85358,2
-1,1,22,51123491,51178264,54773,49;85358,2
-1,1,22,51123491,51178264,54773,49;85358,2
-1,1,22,51123491,51178264,54773,49;85358,2
-1,1,22,51123491,51203353,79862,49;85358,2
-1,1,22,51123491,51203353,79862,49;85358,2
-1,1,22,51123491,51203353,79862,49;85358,2
-1,1,22,51123491,51203353,79862,49;85358,2
-1,1,22,51123491,51203353,79862,49;85358,2
-1,1,22,51123491,51237463,113972,49;11158;85358,3
-1,1,22,51127896,51197838,69942,49;85358,2
-1,1,22,51127896,51197838,69942,49;85358,2
-1,1,22,51127896,51197838,69942,49;85358,2
-1,1,22,51127897,51176099,48202,85358,1
-1,1,22,51127897,51183872,55975,49;85358,2
-1,1,22,51127898,51197838,69940,49;85358,2
-1,1,22,51132803,51203353,70550,49;85358,2
-1,1,22,51137326,51165677,28351,85358,1
-1,1,22,51147983,51183871,35888,49;85358,2
1,-1,22,51182469,51220902,38433,49;11158,2
-1,1,X,17642,6454929,6437287,414;28227;51481;286530;57502;8225;1438;3563;5613;25878;347527;415;416;207063;4267;293;7499;9189;438;64109;6473;8227;55344;8623;8908,25
-1,1,X,60001,155260560,155200559,23096;64061;392509;10214;170685;23157;727837;55998;23439;729431;10916;158586;55859;331;3423;54830;4168;6901;5358;92002;27344;729447;54328;266740;9075;102723737;7552;729422;54954;84460;389874;56000;340562;644538;92552;254158;79649;56850;8225;2824;100272147;51186;3149;26576;100130361;1730;347541;139425;3547;728695;729408;79921;57826;59272;203413;2986;7512;9737;8544;55634;2857;3421;537;11013;340554;5716;6658;4101;54457;1438;91966;441519;4100;5931;27316;7403;4534;6839;51480;728096;27112;92129;101928917;140462;8241;6567;827;203569;27301;84548;645037;54413;100133053;7355;254065;79836;10084;347442;60343;51765;55593;139818;56180;6303;8269;142684;7626;10046;8409;203447;63932;2710;4515;8406;51248;56001;51616;2925;100130613;2564;1193;100132994;5354;11043;340533;22;3476;84631;26748;11238;203562;102723631;170261;58526;441525;4983;29944;6907;1536;2539;1478;9468;23597;2187;1287;81887;6611;3561;9767;9282;54857;347365;10800;139341;54539;11219;728062;169966;51209;23630;26548;1121;2000;645188;51438;2846;280658;1852;347344;23229;10857;56157;286430;101059915;438;5277;9758;1069;4674;154796;56548;51309;1184;645073;80712;1774;10245;2258;728343;9823;441531;11141;643311;90121;256643;23676;4114;6758;4107;286499;5009;1654;1831;51284;94121;170302;11230;79135;286410;9210;2491;441490;84187;633;6191;64743;4110;3598;389856;7789;55787;9452;50814;2157;139422;170062;57187;139067;4104;203427;4693;5456;10013;1964;55190;100996648;293;9016;100528062;30011;90316;93953;10178;6322;28952;24137;2332;4105;6845;94122;84968;64663;1538;9142;286530;2245;5634;9506;79576;3266;139212;5207;6535;8227;393;389852;170626;91851;27334;158866;550643;159013;407;7224;55796;10761;100132963;168400;4281;158835;24140;8471;90167;7737;7319;10149;11279;6134;64109;1678;139322;5063;55906;116442;84443;27197;8233;548313;6872;27018;100129239;139105;7102;10549;26071;2664;59353;8573;28985;79184;728049;728090;158521;3581;139886;282808;8263;9130;728082;778;90843;1756;5422;7317;5935;347454;29071;207063;4112;412;158506;340602;30848;5127;22866;93380;159091;10159;212;139285;9338;85417;8266;100132399;158584;494118;190;7569;89801;2892;1968;5230;57232;55559;57529;8277;63035;80231;286436;25975;51311;8905;55086;139735;395;83692;171484;10251;169981;1349;63904;139716;257397;142689;80258;27035;1641;55613;7105;100329135;84295;9459;4810;404281;4109;367;474384;6748;139760;347487;92745;158830;53344;4103;9203;139378;186;474343;2719;3597;140456;9248;402415;203430;9185;90161;728042;4129;65267;56849;8228;8226;728036;7114;6399;4952;83740;84889;8481;6757;347468;347475;414;6759;9500;51132;8823;541578;2158;55609;2556;494119;6756;9502;158880;8517;8242;474383;57595;51442;389895;100132304;9754;80311;6102;27328;695;56159;51213;90737;60506;10943;100873985;57526;728269;170082;474382;102723680;728656;3358;8273;83844;114824;389840;170067;81557;80823;8862;2002;7216;79979;158763;23641;55217;8270;57477;7592;2833;425054;340526;727866;139599;139804;54470;8450;959;139562;645864;10075;117154;57631;2010;54521;79589;51634;3750;653282;728072;7076;392490;9363;8623;3920;347411;7454;100506164;265;90293;645051;100529097;55511;158724;6197;203547;139135;5355;347516;203522;139081;6451;27336;158787;728458;7499;4841;347517;51360;340578;139596;1896;441509;54466;660;158798;4108;171482;79868;728075;158833;79366;1821;56156;392465;1260;5160;56062;5303;3054;51260;139628;653220;340596;554;28986;23133;57393;2623;28227;4113;57692;50945;3730;7739;100131755;57481;8260;139170;64219;4204;389860;2574;3563;65991;10325;6170;10813;79710;8712;26280;2316;256714;10742;6173;9104;494197;29057;139324;442444;6103;54880;90736;55558;2742;1736;369;255313;3654;170627;645974;3897;79983;727940;541466;347527;8243;4007;139741;29978;2182;7504;60401;84707;53336;1485;159090;94056;57502;55285;653067;1046;11152;641339;1947;8852;7712;23708;203523;4267;54967;340542;89885;2277;83550;644353;55916;340595;6594;139189;63947;9643;9843;4935;139728;100288814;10479;50943;53940;55026;100507170;5638;4478;8239;4068;51114;139411;246100;9968;84679;115201;100533997;1741;416;64840;10682;11326;25763;27330;171483;8908;27286;1038;7543;158800;90060;1288;84061;215;6247;292;55879;401612;1183;340527;55344;29935;158983;357;10009;2747;2652;286514;340543;54885;100129407;10495;6792;79742;140886;2239;2334;4128;441518;139604;4303;55869;25878;4115;11040;8473;6855;84636;55922;728712;5956;2705;55841;54821;729396;441521;8933;10735;729442;9949;4694;84528;51481;492;3028;100129520;795;10389;83604;7411;9947;9367;100463488;10134;79057;54552;6906;340547;30014;415;5255;680;158809;6990;4435;5475;340529;65109;64860;7030;729428;8776;4675;5030;51566;729201;56271;4943;79917;85012;114928;5256;26609;54960;538;6853;5365;4354;286451;29934;10838;139221;9189;347404;6473;3251;286464;158931;139793;100008586;2717;3052;5973;139065;5199;546;5613;51270;139231;9131;7547;474381;257240;11254;27238;64102;2543;158747;2273;56474;5165;64648;54440;140597;5631;728239;3188;100130086;5251;8237;286527;100130302,815
-1,1,X,60679,2695400,2634721,28227;286530;8225;1438;3563;207063;4267;293;7499;9189;438;64109;6473;8227;55344;8623,16
-1,1,X,60679,3676181,3615502,414;28227;286530;8225;1438;3563;5613;25878;347527;415;416;207063;4267;293;7499;9189;438;64109;6473;8227;55344;8623;8908,23
-1,1,X,60679,8448318,8387639,414;28227;51481;286530;57502;8226;8228;425054;8225;1438;3563;26609;5613;25878;347527;415;416;207063;4267;293;412;7499;9189;438;64109;51480;6473;8227;55344;8623;8908,31
-1,1,X,60679,9427683,9367004,414;51481;171482;425054;1438;5613;347527;415;207063;293;412;438;64109;51480;55344;8623;28227;286530;57502;8226;8228;3730;8225;3563;26609;25878;416;4267;7499;9189;6473;8227;171483;8908,34
-1,1,X,60679,16205542,16144863,414;660;2925;51481;171482;9367;4935;100288814;11238;415;207063;293;412;57393;6907;28227;286530;3730;92552;8225;10943;5634;2824;2187;3563;26609;54960;170082;416;25975;51311;8905;9189;395;6473;171484;8227;59272;171483;8908;2742;8544;3052;425054;4281;1438;5613;347527;645864;438;64109;51480;1183;140456;5277;9758;140462;55344;8623;357;8233;265;57502;8228;8226;158747;7114;25878;6399;4267;7499;51284;2277;55841;8481,75
-1,1,X,60679,36202463,36141784,414;55787;139422;170062;4935;100288814;1964;293;53940;30011;6322;80311;139411;286530;92552;254158;8225;10943;5634;2824;170082;416;347541;139425;8227;59272;389840;170067;171483;8908;8544;7543;425054;168400;4281;1438;6247;645864;5931;10149;64109;51480;1183;140462;55344;8623;357;8233;265;286514;6792;158724;6197;139105;347442;139604;10549;25878;6303;7499;4115;55841;51360;2710;660;2925;51481;171482;795;10389;5160;1756;83604;5422;9367;11238;415;207063;4112;412;158506;158809;22866;5475;57393;6907;28227;4113;190;3730;1968;9468;23597;2187;5256;3563;26609;54960;6611;80231;25975;51311;8905;9189;395;6473;171484;256714;286464;10742;257397;2742;3052;4810;404281;5613;347527;438;140456;5277;9758;257240;9185;94056;57502;8228;8226;158747;11141;56474;5165;7114;256643;23676;4114;6399;4267;51284;2277;170302;79135;5251;8481;100130302,144
-1,1,X,60679,49016667,48955988,414;64743;6759;10214;55787;139422;170062;6756;4935;4693;100288814;10013;1964;293;53940;30011;27344;6322;5638;8239;94122;80311;6102;139411;286530;92552;254158;60506;56850;8225;10943;5634;2824;100873985;84679;170082;416;347541;139425;64840;10682;3266;25763;8227;59272;389840;170067;171483;389852;8908;2002;159013;8544;7543;2857;55634;7592;90060;425054;168400;4281;1438;24140;6247;645864;5931;10149;7403;6839;64109;51480;1183;3750;7076;140462;8241;55344;8623;347411;27197;357;7454;8233;265;286514;548313;6792;79742;158724;7355;6197;4128;139105;10084;347442;139604;7102;55593;10549;25878;6303;7499;4115;11040;8573;8409;55841;51360;2710;8406;660;2925;51481;171482;392465;795;10389;5160;1756;83604;5422;9367;7317;5935;11238;415;207063;4112;412;158506;58526;158809;6990;5127;22866;5475;10159;57393;7030;2623;6907;28227;4113;1536;190;7569;729201;3730;1968;9468;23597;57232;4943;2187;5256;3563;26609;54960;6611;6853;9767;80231;9282;25975;51311;8905;9189;395;347404;139341;54539;6473;171484;256714;286464;10742;9104;442444;6103;54880;257397;63904;2742;80258;369;3052;4810;404281;5199;347344;92745;5613;347527;438;140456;7504;5277;9758;56548;257240;9185;27238;94056;4129;10245;57502;8228;8226;158747;11141;56474;5165;11152;7114;641339;256643;23676;4114;6758;7712;6399;5009;1654;4267;51284;2277;170302;79135;11230;5251;8481;441490;8237;100130302,234
-1,1,X,60679,49824045,49763366,414;6759;10214;729431;6756;27344;729447;729422;80311;6102;92552;254158;60506;56850;8225;10943;2824;100873985;170082;347541;139425;729408;59272;389840;170067;2002;8544;55634;2857;7592;425054;1438;645864;5931;7403;6839;51480;3750;7076;140462;8241;8623;347411;7454;265;645037;645051;158724;7355;6197;10084;347442;5355;55593;6303;7499;8409;51360;2710;8406;660;2925;171482;392465;5160;26748;11238;58526;57393;2623;6907;28227;4113;1536;3730;9468;23597;2187;6611;3563;2574;9767;9282;8712;139341;54539;256714;10742;9104;442444;6103;54880;2742;369;347344;347527;4007;438;7504;5277;9758;56548;1184;645073;94056;10245;57502;11141;11152;641339;256643;23676;4114;6758;7712;5009;1654;4267;51284;2277;170302;79135;11230;441490;64743;389856;55787;139422;170062;4935;4693;100288814;10013;1964;293;50943;53940;30011;6322;5638;28952;8239;94122;139411;286530;5634;84679;9506;416;64840;10682;3266;25763;8227;389852;171483;8908;159013;7543;90060;168400;4281;24140;6247;10149;64109;1183;55344;27197;357;8233;286514;548313;6792;79742;4128;139105;139604;7102;10549;25878;4115;11040;6855;8573;55841;729396;729442;51481;795;10389;83604;1756;778;5422;9367;7317;5935;415;207063;4112;412;158506;158809;6990;5127;22866;5475;10159;100132399;7030;729428;190;7569;729201;89801;1968;57232;4943;79917;5256;26609;54960;6853;80231;25975;51311;8905;9189;395;347404;6473;171484;286464;63904;257397;80258;100008586;3052;4810;404281;5199;92745;5613;140456;257240;9185;27238;4129;2543;8228;158747;8226;56474;5165;7114;6399;5251;8481;8237;100130302,261
-1,1,X,60679,49824045,49763366,414;6759;10214;729431;6756;27344;729447;729422;80311;6102;92552;254158;60506;56850;8225;10943;2824;100873985;170082;347541;139425;729408;59272;389840;170067;2002;8544;55634;2857;7592;425054;1438;645864;5931;7403;6839;51480;3750;7076;140462;8241;8623;347411;7454;265;645037;645051;158724;7355;6197;10084;347442;5355;55593;6303;7499;8409;51360;2710;8406;660;2925;171482;392465;5160;26748;11238;58526;57393;2623;6907;28227;4113;1536;3730;9468;23597;2187;6611;3563;2574;9767;9282;8712;139341;54539;256714;10742;9104;442444;6103;54880;2742;369;347344;347527;4007;438;7504;5277;9758;56548;1184;645073;94056;10245;57502;11141;11152;641339;256643;23676;4114;6758;7712;5009;1654;4267;51284;2277;170302;79135;11230;441490;64743;389856;55787;139422;170062;4935;4693;100288814;10013;1964;293;50943;53940;30011;6322;5638;28952;8239;94122;139411;286530;5634;84679;9506;416;64840;10682;3266;25763;8227;389852;171483;8908;159013;7543;90060;168400;4281;24140;6247;10149;64109;1183;55344;27197;357;8233;286514;548313;6792;79742;4128;139105;139604;7102;10549;25878;4115;11040;6855;8573;55841;729396;729442;51481;795;10389;83604;1756;778;5422;9367;7317;5935;415;207063;4112;412;158506;158809;6990;5127;22866;5475;10159;100132399;7030;729428;190;7569;729201;89801;1968;57232;4943;79917;5256;26609;54960;6853;80231;25975;51311;8905;9189;395;347404;6473;171484;286464;63904;257397;80258;100008586;3052;4810;404281;5199;92745;5613;140456;257240;9185;27238;4129;2543;8228;158747;8226;56474;5165;7114;6399;5251;8481;8237;100130302,261
-1,1,X,60679,51948998,51888319,414;6759;9500;10214;170685;729431;6756;27344;729447;729422;80311;6102;92552;254158;60506;56850;8225;10943;2824;100873985;170082;347541;139425;729408;59272;389840;170067;81557;2002;8544;55634;2857;7592;57477;425054;1438;645864;5931;7403;6839;51480;3750;7076;140462;8241;8623;347411;7454;265;645037;645051;158724;7355;6197;10084;347442;5355;55593;6303;7499;8409;51360;2710;8406;660;2925;171482;392465;5160;26748;11238;58526;57393;2623;6907;28227;4113;1536;3730;9468;23597;2187;6611;3563;2574;9767;9282;8712;139341;54539;256714;10742;9104;442444;6103;54880;2742;369;347344;347527;4007;438;7504;5277;9758;56548;1184;645073;94056;10245;57502;11141;11152;641339;256643;23676;4114;6758;8852;7712;23708;5009;1654;4267;51284;2277;170302;79135;11230;9210;441490;64743;389856;55787;139189;139422;170062;4935;4693;100288814;10013;1964;55190;293;50943;53940;30011;6322;5638;28952;8239;94122;139411;286530;5634;84679;9506;416;64840;10682;3266;25763;8227;389852;171483;8908;159013;7543;90060;168400;4281;24140;6247;10149;64109;1183;55344;27197;357;8233;286514;548313;6792;79742;4128;139105;139604;7102;10549;25878;4115;11040;6855;8573;55841;729396;729442;51481;795;10389;83604;1756;778;5422;9367;7317;5935;415;207063;4112;412;158506;340602;158809;6990;5127;22866;5475;10159;85417;100132399;7030;729428;190;7569;729201;89801;1968;57232;4943;79917;5256;26609;54960;6853;80231;25975;51311;8905;9189;395;347404;6473;171484;286464;63904;257397;80258;100008586;3052;4810;404281;5199;92745;5613;140456;257240;9185;27238;4129;2543;8228;158747;8226;56474;5165;7114;6399;728239;5251;8481;8237;100130302,273
1,1,X,60679,52886834,52826155,414;6759;9500;10214;170685;727837;729431;6756;9502;27344;729447;729422;80311;6102;92552;254158;60506;56850;8225;10943;2824;100873985;170082;347541;139425;729408;59272;389840;170067;81557;2002;8544;55634;2857;7592;57477;425054;1438;645864;5931;7403;6839;51480;3750;7076;140462;8241;8623;347411;7454;265;645037;645051;158724;7355;6197;10084;347442;5355;55593;6303;7499;8409;51360;2710;8406;660;2925;171482;392465;5160;26748;11238;653220;58526;57393;2623;6907;28227;4113;1536;3730;9468;23597;2187;6611;3563;2574;9767;9282;8712;139341;54539;256714;10742;9104;494197;442444;6103;54880;2742;369;280658;170627;347344;347527;4007;438;7504;5277;9758;56548;1184;645073;94056;10245;57502;11141;653067;11152;641339;256643;23676;4114;6758;8852;7712;23708;5009;1654;4267;51284;2277;170302;79135;11230;9210;441490;64743;389856;55787;139189;139422;170062;4935;4693;100288814;10013;1964;55190;293;50943;53940;30011;6322;5638;28952;8239;94122;139411;286530;5634;84679;9506;416;64840;10682;3266;25763;8227;389852;171483;8908;159013;7543;90060;168400;4281;24140;6247;10149;64109;1183;55344;27197;357;8233;286514;548313;6792;79742;4128;139105;139604;7102;10549;25878;4115;11040;6855;8573;55841;729396;729442;51481;795;10389;83604;1756;778;5422;9367;7317;5935;415;207063;4112;412;158506;340602;158809;6990;5127;22866;5475;10159;85417;100132399;7030;729428;190;7569;729201;89801;1968;57232;4943;79917;5256;26609;54960;6853;80231;25975;51311;8905;9189;395;347404;6473;171484;286464;63904;257397;80258;100008586;3052;4810;404281;5199;92745;5613;140456;257240;9185;27238;4129;2543;8228;158747;8226;56474;5165;7114;6399;728239;5251;8481;8237;6757;100130302,281
1,1,X,60679,75640898,75580219,23096;414;64061;6759;9500;10214;51132;170685;727837;729431;10916;158586;6756;9502;158880;8242;27344;729447;54328;100132304;729422;9754;80311;6102;54954;56159;389874;90737;92552;254158;60506;56850;8225;2824;10943;100873985;170082;100130361;347541;139425;728656;729408;59272;389840;170067;81557;2002;7216;8544;55634;2857;57477;7592;2833;340554;425054;340526;727866;139599;1438;139562;645864;5931;10075;7403;6839;51480;3750;27112;7076;140462;8241;6567;392490;8623;347411;203569;7454;27301;265;645037;645051;54413;7355;158724;6197;10084;347442;5355;347516;55593;158787;6303;7499;4841;8409;347517;51360;139596;1896;2710;54466;8406;51248;660;2925;171482;100132994;158833;340533;392465;22;5160;5303;3476;26748;51260;11238;139628;653220;58526;28986;23133;4983;57393;2623;6907;28227;4113;1536;9468;3730;23597;2187;81887;64219;389860;6611;2574;3563;3561;9767;10325;9282;54857;347365;8712;139341;54539;256714;10742;26548;9104;494197;29057;442444;6103;54880;90736;2742;369;280658;170627;645974;347344;23229;347527;8243;4007;286430;101059915;29978;438;7504;60401;5277;9758;4674;56548;1184;645073;10245;94056;57502;11141;653067;1046;11152;90121;641339;256643;23676;4114;6758;1947;8852;7712;23708;5009;1654;4267;51284;170302;11230;79135;2277;9210;441490;6191;64743;389856;7789;55787;139189;63947;139422;170062;9843;4935;4693;10013;100288814;1964;55190;293;50943;53940;30011;93953;6322;28952;24137;5638;4478;8239;94122;139411;286530;2245;9968;5634;84679;1741;9506;416;3266;64840;10682;11326;5207;25763;8227;389852;170626;171483;8908;158866;550643;159013;407;7543;90060;168400;4281;158835;24140;6247;10149;11279;64109;1183;340527;55906;55344;27197;357;8233;286514;100129407;548313;6872;6792;79742;4128;139105;7102;139604;4303;10549;55869;25878;4115;11040;8473;6855;8573;2705;55841;54821;729396;729442;139886;51481;3028;778;795;10389;1756;83604;5422;7317;5935;9367;100463488;54552;415;207063;4112;412;158506;340602;5255;158809;5127;6990;22866;4435;5475;10159;212;139285;340529;85417;100132399;158584;7030;729428;5030;190;7569;89801;729201;1968;57232;4943;79917;5256;26609;54960;6853;80231;286451;29934;25975;51311;8905;9189;395;347404;171484;6473;286464;169981;63904;257397;142689;80258;139793;55613;100008586;3052;4810;404281;5199;367;92745;5613;158830;53344;9203;474343;140456;257240;9185;27238;4129;2543;65267;8228;158747;8226;56474;5165;7114;6399;728239;84889;5251;8481;8237;6757;100130302,402
1,1,X,60679,155251871,155191192,23096;64061;392509;10214;170685;23157;727837;55998;23439;729431;10916;158586;55859;331;3423;54830;4168;6901;5358;92002;27344;729447;54328;266740;9075;102723737;7552;729422;54954;84460;389874;56000;340562;644538;92552;254158;79649;56850;8225;2824;100272147;51186;3149;26576;100130361;1730;347541;139425;3547;728695;729408;79921;57826;59272;203413;2986;7512;9737;8544;55634;2857;3421;537;11013;340554;5716;6658;4101;54457;1438;91966;441519;4100;5931;27316;7403;4534;6839;51480;728096;27112;92129;101928917;140462;8241;6567;827;203569;27301;84548;645037;54413;100133053;7355;254065;79836;10084;347442;60343;51765;55593;139818;56180;6303;8269;142684;7626;10046;8409;203447;63932;2710;4515;8406;51248;56001;51616;2925;100130613;2564;1193;100132994;5354;11043;340533;22;3476;84631;26748;11238;203562;102723631;170261;58526;441525;4983;29944;6907;1536;2539;1478;9468;23597;2187;1287;81887;6611;3561;9767;9282;54857;347365;10800;139341;54539;11219;728062;169966;51209;23630;26548;1121;2000;645188;51438;2846;280658;1852;347344;23229;10857;56157;286430;101059915;438;5277;9758;1069;4674;154796;56548;51309;1184;645073;80712;1774;10245;2258;728343;9823;441531;11141;643311;90121;256643;23676;4114;6758;4107;286499;5009;1654;1831;51284;94121;170302;11230;79135;286410;9210;2491;441490;84187;633;6191;64743;4110;3598;389856;7789;55787;9452;50814;2157;139422;170062;57187;139067;4104;203427;4693;5456;10013;1964;55190;100996648;293;9016;100528062;30011;90316;93953;10178;6322;28952;24137;2332;4105;6845;94122;84968;64663;1538;9142;286530;2245;5634;9506;79576;3266;139212;5207;6535;8227;393;389852;170626;91851;27334;158866;550643;159013;407;7224;55796;10761;100132963;168400;4281;158835;24140;8471;90167;7737;7319;10149;11279;6134;64109;1678;139322;5063;55906;116442;84443;27197;8233;548313;6872;27018;100129239;139105;7102;10549;26071;2664;59353;8573;28985;79184;728049;728090;158521;3581;139886;282808;8263;9130;728082;778;90843;1756;5422;7317;5935;347454;29071;207063;4112;412;158506;340602;30848;5127;22866;93380;159091;10159;212;139285;9338;85417;8266;100132399;158584;494118;190;7569;89801;2892;1968;5230;57232;55559;57529;8277;63035;80231;286436;25975;51311;8905;55086;139735;395;83692;171484;10251;169981;1349;63904;139716;257397;142689;80258;27035;1641;55613;7105;100329135;84295;9459;4810;404281;4109;367;474384;6748;139760;347487;92745;158830;53344;4103;9203;139378;186;474343;2719;3597;140456;9248;402415;203430;9185;90161;728042;4129;65267;56849;8228;8226;728036;7114;6399;4952;83740;84889;8481;6757;347468;347475;414;6759;9500;51132;8823;541578;2158;55609;2556;494119;6756;9502;158880;8517;8242;474383;57595;51442;389895;100132304;9754;80311;6102;27328;695;56159;51213;90737;60506;10943;100873985;57526;728269;170082;474382;102723680;728656;3358;8273;83844;114824;389840;170067;81557;80823;8862;2002;7216;79979;158763;23641;55217;8270;57477;7592;2833;425054;340526;727866;139599;139804;54470;8450;959;139562;645864;10075;117154;57631;2010;54521;79589;51634;3750;653282;728072;7076;392490;9363;8623;3920;347411;7454;100506164;265;90293;645051;100529097;55511;158724;6197;203547;139135;5355;347516;203522;139081;6451;27336;158787;728458;7499;4841;347517;51360;340578;139596;1896;441509;54466;660;158798;4108;171482;79868;728075;158833;79366;1821;56156;392465;1260;5160;56062;5303;3054;51260;139628;653220;340596;554;28986;23133;57393;2623;28227;4113;57692;50945;3730;7739;100131755;57481;8260;139170;64219;4204;389860;2574;3563;65991;10325;6170;10813;79710;8712;26280;2316;256714;10742;6173;9104;494197;29057;139324;442444;6103;54880;90736;55558;2742;1736;369;255313;3654;170627;645974;3897;79983;727940;541466;347527;8243;4007;139741;29978;2182;7504;60401;84707;53336;1485;159090;94056;57502;55285;653067;1046;11152;641339;1947;8852;7712;23708;203523;4267;54967;340542;89885;2277;83550;644353;55916;340595;6594;139189;63947;9643;9843;4935;139728;100288814;10479;50943;53940;55026;100507170;5638;4478;8239;4068;51114;139411;246100;9968;84679;115201;100533997;1741;416;64840;10682;11326;25763;27330;171483;8908;27286;1038;7543;158800;90060;1288;84061;215;6247;292;55879;401612;1183;340527;55344;29935;158983;357;10009;2747;2652;286514;340543;54885;100129407;10495;6792;79742;140886;2239;2334;4128;441518;139604;4303;55869;25878;4115;11040;8473;6855;84636;55922;728712;5956;2705;55841;54821;729396;441521;8933;10735;729442;9949;4694;84528;51481;492;3028;100129520;795;10389;83604;7411;9947;9367;100463488;10134;79057;54552;6906;340547;30014;415;5255;680;158809;6990;4435;5475;340529;65109;64860;7030;729428;8776;4675;5030;51566;729201;56271;4943;79917;85012;114928;5256;26609;54960;538;6853;5365;4354;286451;29934;10838;139221;9189;347404;6473;3251;286464;158931;139793;100008586;2717;3052;5973;139065;5199;546;5613;51270;139231;9131;7547;474381;257240;11254;27238;64102;2543;158747;2273;56474;5165;64648;54440;140597;5631;728239;3188;100130086;5251;8237;286527;100130302,815
1,1,X,60679,155251871,155191192,23096;64061;392509;10214;170685;23157;727837;55998;23439;729431;10916;158586;55859;331;3423;54830;4168;6901;5358;92002;27344;729447;54328;266740;9075;102723737;7552;729422;54954;84460;389874;56000;340562;644538;92552;254158;79649;56850;8225;2824;100272147;51186;3149;26576;100130361;1730;347541;139425;3547;728695;729408;79921;57826;59272;203413;2986;7512;9737;8544;55634;2857;3421;537;11013;340554;5716;6658;4101;54457;1438;91966;441519;4100;5931;27316;7403;4534;6839;51480;728096;27112;92129;101928917;140462;8241;6567;827;203569;27301;84548;645037;54413;100133053;7355;254065;79836;10084;347442;60343;51765;55593;139818;56180;6303;8269;142684;7626;10046;8409;203447;63932;2710;4515;8406;51248;56001;51616;2925;100130613;2564;1193;100132994;5354;11043;340533;22;3476;84631;26748;11238;203562;102723631;170261;58526;441525;4983;29944;6907;1536;2539;1478;9468;23597;2187;1287;81887;6611;3561;9767;9282;54857;347365;10800;139341;54539;11219;728062;169966;51209;23630;26548;1121;2000;645188;51438;2846;280658;1852;347344;23229;10857;56157;286430;101059915;438;5277;9758;1069;4674;154796;56548;51309;1184;645073;80712;1774;10245;2258;728343;9823;441531;11141;643311;90121;256643;23676;4114;6758;4107;286499;5009;1654;1831;51284;94121;170302;11230;79135;286410;9210;2491;441490;84187;633;6191;64743;4110;3598;389856;7789;55787;9452;50814;2157;139422;170062;57187;139067;4104;203427;4693;5456;10013;1964;55190;100996648;293;9016;100528062;30011;90316;93953;10178;6322;28952;24137;2332;4105;6845;94122;84968;64663;1538;9142;286530;2245;5634;9506;79576;3266;139212;5207;6535;8227;393;389852;170626;91851;27334;158866;550643;159013;407;7224;55796;10761;100132963;168400;4281;158835;24140;8471;90167;7737;7319;10149;11279;6134;64109;1678;139322;5063;55906;116442;84443;27197;8233;548313;6872;27018;100129239;139105;7102;10549;26071;2664;59353;8573;28985;79184;728049;728090;158521;3581;139886;282808;8263;9130;728082;778;90843;1756;5422;7317;5935;347454;29071;207063;4112;412;158506;340602;30848;5127;22866;93380;159091;10159;212;139285;9338;85417;8266;100132399;158584;494118;190;7569;89801;2892;1968;5230;57232;55559;57529;8277;63035;80231;286436;25975;51311;8905;55086;139735;395;83692;171484;10251;169981;1349;63904;139716;257397;142689;80258;27035;1641;55613;7105;100329135;84295;9459;4810;404281;4109;367;474384;6748;139760;347487;92745;158830;53344;4103;9203;139378;186;474343;2719;3597;140456;9248;402415;203430;9185;90161;728042;4129;65267;56849;8228;8226;728036;7114;6399;4952;83740;84889;8481;6757;347468;347475;414;6759;9500;51132;8823;541578;2158;55609;2556;494119;6756;9502;158880;8517;8242;474383;57595;51442;389895;100132304;9754;80311;6102;27328;695;56159;51213;90737;60506;10943;100873985;57526;728269;170082;474382;102723680;728656;3358;8273;83844;114824;389840;170067;81557;80823;8862;2002;7216;79979;158763;23641;55217;8270;57477;7592;2833;425054;340526;727866;139599;139804;54470;8450;959;139562;645864;10075;117154;57631;2010;54521;79589;51634;3750;653282;728072;7076;392490;9363;8623;3920;347411;7454;100506164;265;90293;645051;100529097;55511;158724;6197;203547;139135;5355;347516;203522;139081;6451;27336;158787;728458;7499;4841;347517;51360;340578;139596;1896;441509;54466;660;158798;4108;171482;79868;728075;158833;79366;1821;56156;392465;1260;5160;56062;5303;3054;51260;139628;653220;340596;554;28986;23133;57393;2623;28227;4113;57692;50945;3730;7739;100131755;57481;8260;139170;64219;4204;389860;2574;3563;65991;10325;6170;10813;79710;8712;26280;2316;256714;10742;6173;9104;494197;29057;139324;442444;6103;54880;90736;55558;2742;1736;369;255313;3654;170627;645974;3897;79983;727940;541466;347527;8243;4007;139741;29978;2182;7504;60401;84707;53336;1485;159090;94056;57502;55285;653067;1046;11152;641339;1947;8852;7712;23708;203523;4267;54967;340542;89885;2277;83550;644353;55916;340595;6594;139189;63947;9643;9843;4935;139728;100288814;10479;50943;53940;55026;100507170;5638;4478;8239;4068;51114;139411;246100;9968;84679;115201;100533997;1741;416;64840;10682;11326;25763;27330;171483;8908;27286;1038;7543;158800;90060;1288;84061;215;6247;292;55879;401612;1183;340527;55344;29935;158983;357;10009;2747;2652;286514;340543;54885;100129407;10495;6792;79742;140886;2239;2334;4128;441518;139604;4303;55869;25878;4115;11040;8473;6855;84636;55922;728712;5956;2705;55841;54821;729396;441521;8933;10735;729442;9949;4694;84528;51481;492;3028;100129520;795;10389;83604;7411;9947;9367;100463488;10134;79057;54552;6906;340547;30014;415;5255;680;158809;6990;4435;5475;340529;65109;64860;7030;729428;8776;4675;5030;51566;729201;56271;4943;79917;85012;114928;5256;26609;54960;538;6853;5365;4354;286451;29934;10838;139221;9189;347404;6473;3251;286464;158931;139793;100008586;2717;3052;5973;139065;5199;546;5613;51270;139231;9131;7547;474381;257240;11254;27238;64102;2543;158747;2273;56474;5165;64648;54440;140597;5631;728239;3188;100130086;5251;8237;286527;100130302,815
-1,1,X,60679,155251871,155191192,23096;64061;392509;10214;170685;23157;727837;55998;23439;729431;10916;158586;55859;331;3423;54830;4168;6901;5358;92002;27344;729447;54328;266740;9075;102723737;7552;729422;54954;84460;389874;56000;340562;644538;92552;254158;79649;56850;8225;2824;100272147;51186;3149;26576;100130361;1730;347541;139425;3547;728695;729408;79921;57826;59272;203413;2986;7512;9737;8544;55634;2857;3421;537;11013;340554;5716;6658;4101;54457;1438;91966;441519;4100;5931;27316;7403;4534;6839;51480;728096;27112;92129;101928917;140462;8241;6567;827;203569;27301;84548;645037;54413;100133053;7355;254065;79836;10084;347442;60343;51765;55593;139818;56180;6303;8269;142684;7626;10046;8409;203447;63932;2710;4515;8406;51248;56001;51616;2925;100130613;2564;1193;100132994;5354;11043;340533;22;3476;84631;26748;11238;203562;102723631;170261;58526;441525;4983;29944;6907;1536;2539;1478;9468;23597;2187;1287;81887;6611;3561;9767;9282;54857;347365;10800;139341;54539;11219;728062;169966;51209;23630;26548;1121;2000;645188;51438;2846;280658;1852;347344;23229;10857;56157;286430;101059915;438;5277;9758;1069;4674;154796;56548;51309;1184;645073;80712;1774;10245;2258;728343;9823;441531;11141;643311;90121;256643;23676;4114;6758;4107;286499;5009;1654;1831;51284;94121;170302;11230;79135;286410;9210;2491;441490;84187;633;6191;64743;4110;3598;389856;7789;55787;9452;50814;2157;139422;170062;57187;139067;4104;203427;4693;5456;10013;1964;55190;100996648;293;9016;100528062;30011;90316;93953;10178;6322;28952;24137;2332;4105;6845;94122;84968;64663;1538;9142;286530;2245;5634;9506;79576;3266;139212;5207;6535;8227;393;389852;170626;91851;27334;158866;550643;159013;407;7224;55796;10761;100132963;168400;4281;158835;24140;8471;90167;7737;7319;10149;11279;6134;64109;1678;139322;5063;55906;116442;84443;27197;8233;548313;6872;27018;100129239;139105;7102;10549;26071;2664;59353;8573;28985;79184;728049;728090;158521;3581;139886;282808;8263;9130;728082;778;90843;1756;5422;7317;5935;347454;29071;207063;4112;412;158506;340602;30848;5127;22866;93380;159091;10159;212;139285;9338;85417;8266;100132399;158584;494118;190;7569;89801;2892;1968;5230;57232;55559;57529;8277;63035;80231;286436;25975;51311;8905;55086;139735;395;83692;171484;10251;169981;1349;63904;139716;257397;142689;80258;27035;1641;55613;7105;100329135;84295;9459;4810;404281;4109;367;474384;6748;139760;347487;92745;158830;53344;4103;9203;139378;186;474343;2719;3597;140456;9248;402415;203430;9185;90161;728042;4129;65267;56849;8228;8226;728036;7114;6399;4952;83740;84889;8481;6757;347468;347475;414;6759;9500;51132;8823;541578;2158;55609;2556;494119;6756;9502;158880;8517;8242;474383;57595;51442;389895;100132304;9754;80311;6102;27328;695;56159;51213;90737;60506;10943;100873985;57526;728269;170082;474382;102723680;728656;3358;8273;83844;114824;389840;170067;81557;80823;8862;2002;7216;79979;158763;23641;55217;8270;57477;7592;2833;425054;340526;727866;139599;139804;54470;8450;959;139562;645864;10075;117154;57631;2010;54521;79589;51634;3750;653282;728072;7076;392490;9363;8623;3920;347411;7454;100506164;265;90293;645051;100529097;55511;158724;6197;203547;139135;5355;347516;203522;139081;6451;27336;158787;728458;7499;4841;347517;51360;340578;139596;1896;441509;54466;660;158798;4108;171482;79868;728075;158833;79366;1821;56156;392465;1260;5160;56062;5303;3054;51260;139628;653220;340596;554;28986;23133;57393;2623;28227;4113;57692;50945;3730;7739;100131755;57481;8260;139170;64219;4204;389860;2574;3563;65991;10325;6170;10813;79710;8712;26280;2316;256714;10742;6173;9104;494197;29057;139324;442444;6103;54880;90736;55558;2742;1736;369;255313;3654;170627;645974;3897;79983;727940;541466;347527;8243;4007;139741;29978;2182;7504;60401;84707;53336;1485;159090;94056;57502;55285;653067;1046;11152;641339;1947;8852;7712;23708;203523;4267;54967;340542;89885;2277;83550;644353;55916;340595;6594;139189;63947;9643;9843;4935;139728;100288814;10479;50943;53940;55026;100507170;5638;4478;8239;4068;51114;139411;246100;9968;84679;115201;100533997;1741;416;64840;10682;11326;25763;27330;171483;8908;27286;1038;7543;158800;90060;1288;84061;215;6247;292;55879;401612;1183;340527;55344;29935;158983;357;10009;2747;2652;286514;340543;54885;100129407;10495;6792;79742;140886;2239;2334;4128;441518;139604;4303;55869;25878;4115;11040;8473;6855;84636;55922;728712;5956;2705;55841;54821;729396;441521;8933;10735;729442;9949;4694;84528;51481;492;3028;100129520;795;10389;83604;7411;9947;9367;100463488;10134;79057;54552;6906;340547;30014;415;5255;680;158809;6990;4435;5475;340529;65109;64860;7030;729428;8776;4675;5030;51566;729201;56271;4943;79917;85012;114928;5256;26609;54960;538;6853;5365;4354;286451;29934;10838;139221;9189;347404;6473;3251;286464;158931;139793;100008586;2717;3052;5973;139065;5199;546;5613;51270;139231;9131;7547;474381;257240;11254;27238;64102;2543;158747;2273;56474;5165;64648;54440;140597;5631;728239;3188;100130086;5251;8237;286527;100130302,815
-1,1,X,60679,155251871,155191192,23096;64061;392509;10214;170685;23157;727837;55998;23439;729431;10916;158586;55859;331;3423;54830;4168;6901;5358;92002;27344;729447;54328;266740;9075;102723737;7552;729422;54954;84460;389874;56000;340562;644538;92552;254158;79649;56850;8225;2824;100272147;51186;3149;26576;100130361;1730;347541;139425;3547;728695;729408;79921;57826;59272;203413;2986;7512;9737;8544;55634;2857;3421;537;11013;340554;5716;6658;4101;54457;1438;91966;441519;4100;5931;27316;7403;4534;6839;51480;728096;27112;92129;101928917;140462;8241;6567;827;203569;27301;84548;645037;54413;100133053;7355;254065;79836;10084;347442;60343;51765;55593;139818;56180;6303;8269;142684;7626;10046;8409;203447;63932;2710;4515;8406;51248;56001;51616;2925;100130613;2564;1193;100132994;5354;11043;340533;22;3476;84631;26748;11238;203562;102723631;170261;58526;441525;4983;29944;6907;1536;2539;1478;9468;23597;2187;1287;81887;6611;3561;9767;9282;54857;347365;10800;139341;54539;11219;728062;169966;51209;23630;26548;1121;2000;645188;51438;2846;280658;1852;347344;23229;10857;56157;286430;101059915;438;5277;9758;1069;4674;154796;56548;51309;1184;645073;80712;1774;10245;2258;728343;9823;441531;11141;643311;90121;256643;23676;4114;6758;4107;286499;5009;1654;1831;51284;94121;170302;11230;79135;286410;9210;2491;441490;84187;633;6191;64743;4110;3598;389856;7789;55787;9452;50814;2157;139422;170062;57187;139067;4104;203427;4693;5456;10013;1964;55190;100996648;293;9016;100528062;30011;90316;93953;10178;6322;28952;24137;2332;4105;6845;94122;84968;64663;1538;9142;286530;2245;5634;9506;79576;3266;139212;5207;6535;8227;393;389852;170626;91851;27334;158866;550643;159013;407;7224;55796;10761;100132963;168400;4281;158835;24140;8471;90167;7737;7319;10149;11279;6134;64109;1678;139322;5063;55906;116442;84443;27197;8233;548313;6872;27018;100129239;139105;7102;10549;26071;2664;59353;8573;28985;79184;728049;728090;158521;3581;139886;282808;8263;9130;728082;778;90843;1756;5422;7317;5935;347454;29071;207063;4112;412;158506;340602;30848;5127;22866;93380;159091;10159;212;139285;9338;85417;8266;100132399;158584;494118;190;7569;89801;2892;1968;5230;57232;55559;57529;8277;63035;80231;286436;25975;51311;8905;55086;139735;395;83692;171484;10251;169981;1349;63904;139716;257397;142689;80258;27035;1641;55613;7105;100329135;84295;9459;4810;404281;4109;367;474384;6748;139760;347487;92745;158830;53344;4103;9203;139378;186;474343;2719;3597;140456;9248;402415;203430;9185;90161;728042;4129;65267;56849;8228;8226;728036;7114;6399;4952;83740;84889;8481;6757;347468;347475;414;6759;9500;51132;8823;541578;2158;55609;2556;494119;6756;9502;158880;8517;8242;474383;57595;51442;389895;100132304;9754;80311;6102;27328;695;56159;51213;90737;60506;10943;100873985;57526;728269;170082;474382;102723680;728656;3358;8273;83844;114824;389840;170067;81557;80823;8862;2002;7216;79979;158763;23641;55217;8270;57477;7592;2833;425054;340526;727866;139599;139804;54470;8450;959;139562;645864;10075;117154;57631;2010;54521;79589;51634;3750;653282;728072;7076;392490;9363;8623;3920;347411;7454;100506164;265;90293;645051;100529097;55511;158724;6197;203547;139135;5355;347516;203522;139081;6451;27336;158787;728458;7499;4841;347517;51360;340578;139596;1896;441509;54466;660;158798;4108;171482;79868;728075;158833;79366;1821;56156;392465;1260;5160;56062;5303;3054;51260;139628;653220;340596;554;28986;23133;57393;2623;28227;4113;57692;50945;3730;7739;100131755;57481;8260;139170;64219;4204;389860;2574;3563;65991;10325;6170;10813;79710;8712;26280;2316;256714;10742;6173;9104;494197;29057;139324;442444;6103;54880;90736;55558;2742;1736;369;255313;3654;170627;645974;3897;79983;727940;541466;347527;8243;4007;139741;29978;2182;7504;60401;84707;53336;1485;159090;94056;57502;55285;653067;1046;11152;641339;1947;8852;7712;23708;203523;4267;54967;340542;89885;2277;83550;644353;55916;340595;6594;139189;63947;9643;9843;4935;139728;100288814;10479;50943;53940;55026;100507170;5638;4478;8239;4068;51114;139411;246100;9968;84679;115201;100533997;1741;416;64840;10682;11326;25763;27330;171483;8908;27286;1038;7543;158800;90060;1288;84061;215;6247;292;55879;401612;1183;340527;55344;29935;158983;357;10009;2747;2652;286514;340543;54885;100129407;10495;6792;79742;140886;2239;2334;4128;441518;139604;4303;55869;25878;4115;11040;8473;6855;84636;55922;728712;5956;2705;55841;54821;729396;441521;8933;10735;729442;9949;4694;84528;51481;492;3028;100129520;795;10389;83604;7411;9947;9367;100463488;10134;79057;54552;6906;340547;30014;415;5255;680;158809;6990;4435;5475;340529;65109;64860;7030;729428;8776;4675;5030;51566;729201;56271;4943;79917;85012;114928;5256;26609;54960;538;6853;5365;4354;286451;29934;10838;139221;9189;347404;6473;3251;286464;158931;139793;100008586;2717;3052;5973;139065;5199;546;5613;51270;139231;9131;7547;474381;257240;11254;27238;64102;2543;158747;2273;56474;5165;64648;54440;140597;5631;728239;3188;100130086;5251;8237;286527;100130302,815
1,1,X,60679,155251871,155191192,23096;64061;392509;10214;170685;23157;727837;55998;23439;729431;10916;158586;55859;331;3423;54830;4168;6901;5358;92002;27344;729447;54328;266740;9075;102723737;7552;729422;54954;84460;389874;56000;340562;644538;92552;254158;79649;56850;8225;2824;100272147;51186;3149;26576;100130361;1730;347541;139425;3547;728695;729408;79921;57826;59272;203413;2986;7512;9737;8544;55634;2857;3421;537;11013;340554;5716;6658;4101;54457;1438;91966;441519;4100;5931;27316;7403;4534;6839;51480;728096;27112;92129;101928917;140462;8241;6567;827;203569;27301;84548;645037;54413;100133053;7355;254065;79836;10084;347442;60343;51765;55593;139818;56180;6303;8269;142684;7626;10046;8409;203447;63932;2710;4515;8406;51248;56001;51616;2925;100130613;2564;1193;100132994;5354;11043;340533;22;3476;84631;26748;11238;203562;102723631;170261;58526;441525;4983;29944;6907;1536;2539;1478;9468;23597;2187;1287;81887;6611;3561;9767;9282;54857;347365;10800;139341;54539;11219;728062;169966;51209;23630;26548;1121;2000;645188;51438;2846;280658;1852;347344;23229;10857;56157;286430;101059915;438;5277;9758;1069;4674;154796;56548;51309;1184;645073;80712;1774;10245;2258;728343;9823;441531;11141;643311;90121;256643;23676;4114;6758;4107;286499;5009;1654;1831;51284;94121;170302;11230;79135;286410;9210;2491;441490;84187;633;6191;64743;4110;3598;389856;7789;55787;9452;50814;2157;139422;170062;57187;139067;4104;203427;4693;5456;10013;1964;55190;100996648;293;9016;100528062;30011;90316;93953;10178;6322;28952;24137;2332;4105;6845;94122;84968;64663;1538;9142;286530;2245;5634;9506;79576;3266;139212;5207;6535;8227;393;389852;170626;91851;27334;158866;550643;159013;407;7224;55796;10761;100132963;168400;4281;158835;24140;8471;90167;7737;7319;10149;11279;6134;64109;1678;139322;5063;55906;116442;84443;27197;8233;548313;6872;27018;100129239;139105;7102;10549;26071;2664;59353;8573;28985;79184;728049;728090;158521;3581;139886;282808;8263;9130;728082;778;90843;1756;5422;7317;5935;347454;29071;207063;4112;412;158506;340602;30848;5127;22866;93380;159091;10159;212;139285;9338;85417;8266;100132399;158584;494118;190;7569;89801;2892;1968;5230;57232;55559;57529;8277;63035;80231;286436;25975;51311;8905;55086;139735;395;83692;171484;10251;169981;1349;63904;139716;257397;142689;80258;27035;1641;55613;7105;100329135;84295;9459;4810;404281;4109;367;474384;6748;139760;347487;92745;158830;53344;4103;9203;139378;186;474343;2719;3597;140456;9248;402415;203430;9185;90161;728042;4129;65267;56849;8228;8226;728036;7114;6399;4952;83740;84889;8481;6757;347468;347475;414;6759;9500;51132;8823;541578;2158;55609;2556;494119;6756;9502;158880;8517;8242;474383;57595;51442;389895;100132304;9754;80311;6102;27328;695;56159;51213;90737;60506;10943;100873985;57526;728269;170082;474382;102723680;728656;3358;8273;83844;114824;389840;170067;81557;80823;8862;2002;7216;79979;158763;23641;55217;8270;57477;7592;2833;425054;340526;727866;139599;139804;54470;8450;959;139562;645864;10075;117154;57631;2010;54521;79589;51634;3750;653282;728072;7076;392490;9363;8623;3920;347411;7454;100506164;265;90293;645051;100529097;55511;158724;6197;203547;139135;5355;347516;203522;139081;6451;27336;158787;728458;7499;4841;347517;51360;340578;139596;1896;441509;54466;660;158798;4108;171482;79868;728075;158833;79366;1821;56156;392465;1260;5160;56062;5303;3054;51260;139628;653220;340596;554;28986;23133;57393;2623;28227;4113;57692;50945;3730;7739;100131755;57481;8260;139170;64219;4204;389860;2574;3563;65991;10325;6170;10813;79710;8712;26280;2316;256714;10742;6173;9104;494197;29057;139324;442444;6103;54880;90736;55558;2742;1736;369;255313;3654;170627;645974;3897;79983;727940;541466;347527;8243;4007;139741;29978;2182;7504;60401;84707;53336;1485;159090;94056;57502;55285;653067;1046;11152;641339;1947;8852;7712;23708;203523;4267;54967;340542;89885;2277;83550;644353;55916;340595;6594;139189;63947;9643;9843;4935;139728;100288814;10479;50943;53940;55026;100507170;5638;4478;8239;4068;51114;139411;246100;9968;84679;115201;100533997;1741;416;64840;10682;11326;25763;27330;171483;8908;27286;1038;7543;158800;90060;1288;84061;215;6247;292;55879;401612;1183;340527;55344;29935;158983;357;10009;2747;2652;286514;340543;54885;100129407;10495;6792;79742;140886;2239;2334;4128;441518;139604;4303;55869;25878;4115;11040;8473;6855;84636;55922;728712;5956;2705;55841;54821;729396;441521;8933;10735;729442;9949;4694;84528;51481;492;3028;100129520;795;10389;83604;7411;9947;9367;100463488;10134;79057;54552;6906;340547;30014;415;5255;680;158809;6990;4435;5475;340529;65109;64860;7030;729428;8776;4675;5030;51566;729201;56271;4943;79917;85012;114928;5256;26609;54960;538;6853;5365;4354;286451;29934;10838;139221;9189;347404;6473;3251;286464;158931;139793;100008586;2717;3052;5973;139065;5199;546;5613;51270;139231;9131;7547;474381;257240;11254;27238;64102;2543;158747;2273;56474;5165;64648;54440;140597;5631;728239;3188;100130086;5251;8237;286527;100130302,815
1,1,X,60679,155251871,155191192,23096;64061;392509;10214;170685;23157;727837;55998;23439;729431;10916;158586;55859;331;3423;54830;4168;6901;5358;92002;27344;729447;54328;266740;9075;102723737;7552;729422;54954;84460;389874;56000;340562;644538;92552;254158;79649;56850;8225;2824;100272147;51186;3149;26576;100130361;1730;347541;139425;3547;728695;729408;79921;57826;59272;203413;2986;7512;9737;8544;55634;2857;3421;537;11013;340554;5716;6658;4101;54457;1438;91966;441519;4100;5931;27316;7403;4534;6839;51480;728096;27112;92129;101928917;140462;8241;6567;827;203569;27301;84548;645037;54413;100133053;7355;254065;79836;10084;347442;60343;51765;55593;139818;56180;6303;8269;142684;7626;10046;8409;203447;63932;2710;4515;8406;51248;56001;51616;2925;100130613;2564;1193;100132994;5354;11043;340533;22;3476;84631;26748;11238;203562;102723631;170261;58526;441525;4983;29944;6907;1536;2539;1478;9468;23597;2187;1287;81887;6611;3561;9767;9282;54857;347365;10800;139341;54539;11219;728062;169966;51209;23630;26548;1121;2000;645188;51438;2846;280658;1852;347344;23229;10857;56157;286430;101059915;438;5277;9758;1069;4674;154796;56548;51309;1184;645073;80712;1774;10245;2258;728343;9823;441531;11141;643311;90121;256643;23676;4114;6758;4107;286499;5009;1654;1831;51284;94121;170302;11230;79135;286410;9210;2491;441490;84187;633;6191;64743;4110;3598;389856;7789;55787;9452;50814;2157;139422;170062;57187;139067;4104;203427;4693;5456;10013;1964;55190;100996648;293;9016;100528062;30011;90316;93953;10178;6322;28952;24137;2332;4105;6845;94122;84968;64663;1538;9142;286530;2245;5634;9506;79576;3266;139212;5207;6535;8227;393;389852;170626;91851;27334;158866;550643;159013;407;7224;55796;10761;100132963;168400;4281;158835;24140;8471;90167;7737;7319;10149;11279;6134;64109;1678;139322;5063;55906;116442;84443;27197;8233;548313;6872;27018;100129239;139105;7102;10549;26071;2664;59353;8573;28985;79184;728049;728090;158521;3581;139886;282808;8263;9130;728082;778;90843;1756;5422;7317;5935;347454;29071;207063;4112;412;158506;340602;30848;5127;22866;93380;159091;10159;212;139285;9338;85417;8266;100132399;158584;494118;190;7569;89801;2892;1968;5230;57232;55559;57529;8277;63035;80231;286436;25975;51311;8905;55086;139735;395;83692;171484;10251;169981;1349;63904;139716;257397;142689;80258;27035;1641;55613;7105;100329135;84295;9459;4810;404281;4109;367;474384;6748;139760;347487;92745;158830;53344;4103;9203;139378;186;474343;2719;3597;140456;9248;402415;203430;9185;90161;728042;4129;65267;56849;8228;8226;728036;7114;6399;4952;83740;84889;8481;6757;347468;347475;414;6759;9500;51132;8823;541578;2158;55609;2556;494119;6756;9502;158880;8517;8242;474383;57595;51442;389895;100132304;9754;80311;6102;27328;695;56159;51213;90737;60506;10943;100873985;57526;728269;170082;474382;102723680;728656;3358;8273;83844;114824;389840;170067;81557;80823;8862;2002;7216;79979;158763;23641;55217;8270;57477;7592;2833;425054;340526;727866;139599;139804;54470;8450;959;139562;645864;10075;117154;57631;2010;54521;79589;51634;3750;653282;728072;7076;392490;9363;8623;3920;347411;7454;100506164;265;90293;645051;100529097;55511;158724;6197;203547;139135;5355;347516;203522;139081;6451;27336;158787;728458;7499;4841;347517;51360;340578;139596;1896;441509;54466;660;158798;4108;171482;79868;728075;158833;79366;1821;56156;392465;1260;5160;56062;5303;3054;51260;139628;653220;340596;554;28986;23133;57393;2623;28227;4113;57692;50945;3730;7739;100131755;57481;8260;139170;64219;4204;389860;2574;3563;65991;10325;6170;10813;79710;8712;26280;2316;256714;10742;6173;9104;494197;29057;139324;442444;6103;54880;90736;55558;2742;1736;369;255313;3654;170627;645974;3897;79983;727940;541466;347527;8243;4007;139741;29978;2182;7504;60401;84707;53336;1485;159090;94056;57502;55285;653067;1046;11152;641339;1947;8852;7712;23708;203523;4267;54967;340542;89885;2277;83550;644353;55916;340595;6594;139189;63947;9643;9843;4935;139728;100288814;10479;50943;53940;55026;100507170;5638;4478;8239;4068;51114;139411;246100;9968;84679;115201;100533997;1741;416;64840;10682;11326;25763;27330;171483;8908;27286;1038;7543;158800;90060;1288;84061;215;6247;292;55879;401612;1183;340527;55344;29935;158983;357;10009;2747;2652;286514;340543;54885;100129407;10495;6792;79742;140886;2239;2334;4128;441518;139604;4303;55869;25878;4115;11040;8473;6855;84636;55922;728712;5956;2705;55841;54821;729396;441521;8933;10735;729442;9949;4694;84528;51481;492;3028;100129520;795;10389;83604;7411;9947;9367;100463488;10134;79057;54552;6906;340547;30014;415;5255;680;158809;6990;4435;5475;340529;65109;64860;7030;729428;8776;4675;5030;51566;729201;56271;4943;79917;85012;114928;5256;26609;54960;538;6853;5365;4354;286451;29934;10838;139221;9189;347404;6473;3251;286464;158931;139793;100008586;2717;3052;5973;139065;5199;546;5613;51270;139231;9131;7547;474381;257240;11254;27238;64102;2543;158747;2273;56474;5165;64648;54440;140597;5631;728239;3188;100130086;5251;8237;286527;100130302,815
-1,1,X,60679,155251871,155191192,23096;64061;392509;10214;170685;23157;727837;55998;23439;729431;10916;158586;55859;331;3423;54830;4168;6901;5358;92002;27344;729447;54328;266740;9075;102723737;7552;729422;54954;84460;389874;56000;340562;644538;92552;254158;79649;56850;8225;2824;100272147;51186;3149;26576;100130361;1730;347541;139425;3547;728695;729408;79921;57826;59272;203413;2986;7512;9737;8544;55634;2857;3421;537;11013;340554;5716;6658;4101;54457;1438;91966;441519;4100;5931;27316;7403;4534;6839;51480;728096;27112;92129;101928917;140462;8241;6567;827;203569;27301;84548;645037;54413;100133053;7355;254065;79836;10084;347442;60343;51765;55593;139818;56180;6303;8269;142684;7626;10046;8409;203447;63932;2710;4515;8406;51248;56001;51616;2925;100130613;2564;1193;100132994;5354;11043;340533;22;3476;84631;26748;11238;203562;102723631;170261;58526;441525;4983;29944;6907;1536;2539;1478;9468;23597;2187;1287;81887;6611;3561;9767;9282;54857;347365;10800;139341;54539;11219;728062;169966;51209;23630;26548;1121;2000;645188;51438;2846;280658;1852;347344;23229;10857;56157;286430;101059915;438;5277;9758;1069;4674;154796;56548;51309;1184;645073;80712;1774;10245;2258;728343;9823;441531;11141;643311;90121;256643;23676;4114;6758;4107;286499;5009;1654;1831;51284;94121;170302;11230;79135;286410;9210;2491;441490;84187;633;6191;64743;4110;3598;389856;7789;55787;9452;50814;2157;139422;170062;57187;139067;4104;203427;4693;5456;10013;1964;55190;100996648;293;9016;100528062;30011;90316;93953;10178;6322;28952;24137;2332;4105;6845;94122;84968;64663;1538;9142;286530;2245;5634;9506;79576;3266;139212;5207;6535;8227;393;389852;170626;91851;27334;158866;550643;159013;407;7224;55796;10761;100132963;168400;4281;158835;24140;8471;90167;7737;7319;10149;11279;6134;64109;1678;139322;5063;55906;116442;84443;27197;8233;548313;6872;27018;100129239;139105;7102;10549;26071;2664;59353;8573;28985;79184;728049;728090;158521;3581;139886;282808;8263;9130;728082;778;90843;1756;5422;7317;5935;347454;29071;207063;4112;412;158506;340602;30848;5127;22866;93380;159091;10159;212;139285;9338;85417;8266;100132399;158584;494118;190;7569;89801;2892;1968;5230;57232;55559;57529;8277;63035;80231;286436;25975;51311;8905;55086;139735;395;83692;171484;10251;169981;1349;63904;139716;257397;142689;80258;27035;1641;55613;7105;100329135;84295;9459;4810;404281;4109;367;474384;6748;139760;347487;92745;158830;53344;4103;9203;139378;186;474343;2719;3597;140456;9248;402415;203430;9185;90161;728042;4129;65267;56849;8228;8226;728036;7114;6399;4952;83740;84889;8481;6757;347468;347475;414;6759;9500;51132;8823;541578;2158;55609;2556;494119;6756;9502;158880;8517;8242;474383;57595;51442;389895;100132304;9754;80311;6102;27328;695;56159;51213;90737;60506;10943;100873985;57526;728269;170082;474382;102723680;728656;3358;8273;83844;114824;389840;170067;81557;80823;8862;2002;7216;79979;158763;23641;55217;8270;57477;7592;2833;425054;340526;727866;139599;139804;54470;8450;959;139562;645864;10075;117154;57631;2010;54521;79589;51634;3750;653282;728072;7076;392490;9363;8623;3920;347411;7454;100506164;265;90293;645051;100529097;55511;158724;6197;203547;139135;5355;347516;203522;139081;6451;27336;158787;728458;7499;4841;347517;51360;340578;139596;1896;441509;54466;660;158798;4108;171482;79868;728075;158833;79366;1821;56156;392465;1260;5160;56062;5303;3054;51260;139628;653220;340596;554;28986;23133;57393;2623;28227;4113;57692;50945;3730;7739;100131755;57481;8260;139170;64219;4204;389860;2574;3563;65991;10325;6170;10813;79710;8712;26280;2316;256714;10742;6173;9104;494197;29057;139324;442444;6103;54880;90736;55558;2742;1736;369;255313;3654;170627;645974;3897;79983;727940;541466;347527;8243;4007;139741;29978;2182;7504;60401;84707;53336;1485;159090;94056;57502;55285;653067;1046;11152;641339;1947;8852;7712;23708;203523;4267;54967;340542;89885;2277;83550;644353;55916;340595;6594;139189;63947;9643;9843;4935;139728;100288814;10479;50943;53940;55026;100507170;5638;4478;8239;4068;51114;139411;246100;9968;84679;115201;100533997;1741;416;64840;10682;11326;25763;27330;171483;8908;27286;1038;7543;158800;90060;1288;84061;215;6247;292;55879;401612;1183;340527;55344;29935;158983;357;10009;2747;2652;286514;340543;54885;100129407;10495;6792;79742;140886;2239;2334;4128;441518;139604;4303;55869;25878;4115;11040;8473;6855;84636;55922;728712;5956;2705;55841;54821;729396;441521;8933;10735;729442;9949;4694;84528;51481;492;3028;100129520;795;10389;83604;7411;9947;9367;100463488;10134;79057;54552;6906;340547;30014;415;5255;680;158809;6990;4435;5475;340529;65109;64860;7030;729428;8776;4675;5030;51566;729201;56271;4943;79917;85012;114928;5256;26609;54960;538;6853;5365;4354;286451;29934;10838;139221;9189;347404;6473;3251;286464;158931;139793;100008586;2717;3052;5973;139065;5199;546;5613;51270;139231;9131;7547;474381;257240;11254;27238;64102;2543;158747;2273;56474;5165;64648;54440;140597;5631;728239;3188;100130086;5251;8237;286527;100130302,815
-1,1,X,60679,155251871,155191192,23096;64061;392509;10214;170685;23157;727837;55998;23439;729431;10916;158586;55859;331;3423;54830;4168;6901;5358;92002;27344;729447;54328;266740;9075;102723737;7552;729422;54954;84460;389874;56000;340562;644538;92552;254158;79649;56850;8225;2824;100272147;51186;3149;26576;100130361;1730;347541;139425;3547;728695;729408;79921;57826;59272;203413;2986;7512;9737;8544;55634;2857;3421;537;11013;340554;5716;6658;4101;54457;1438;91966;441519;4100;5931;27316;7403;4534;6839;51480;728096;27112;92129;101928917;140462;8241;6567;827;203569;27301;84548;645037;54413;100133053;7355;254065;79836;10084;347442;60343;51765;55593;139818;56180;6303;8269;142684;7626;10046;8409;203447;63932;2710;4515;8406;51248;56001;51616;2925;100130613;2564;1193;100132994;5354;11043;340533;22;3476;84631;26748;11238;203562;102723631;170261;58526;441525;4983;29944;6907;1536;2539;1478;9468;23597;2187;1287;81887;6611;3561;9767;9282;54857;347365;10800;139341;54539;11219;728062;169966;51209;23630;26548;1121;2000;645188;51438;2846;280658;1852;347344;23229;10857;56157;286430;101059915;438;5277;9758;1069;4674;154796;56548;51309;1184;645073;80712;1774;10245;2258;728343;9823;441531;11141;643311;90121;256643;23676;4114;6758;4107;286499;5009;1654;1831;51284;94121;170302;11230;79135;286410;9210;2491;441490;84187;633;6191;64743;4110;3598;389856;7789;55787;9452;50814;2157;139422;170062;57187;139067;4104;203427;4693;5456;10013;1964;55190;100996648;293;9016;100528062;30011;90316;93953;10178;6322;28952;24137;2332;4105;6845;94122;84968;64663;1538;9142;286530;2245;5634;9506;79576;3266;139212;5207;6535;8227;393;389852;170626;91851;27334;158866;550643;159013;407;7224;55796;10761;100132963;168400;4281;158835;24140;8471;90167;7737;7319;10149;11279;6134;64109;1678;139322;5063;55906;116442;84443;27197;8233;548313;6872;27018;100129239;139105;7102;10549;26071;2664;59353;8573;28985;79184;728049;728090;158521;3581;139886;282808;8263;9130;728082;778;90843;1756;5422;7317;5935;347454;29071;207063;4112;412;158506;340602;30848;5127;22866;93380;159091;10159;212;139285;9338;85417;8266;100132399;158584;494118;190;7569;89801;2892;1968;5230;57232;55559;57529;8277;63035;80231;286436;25975;51311;8905;55086;139735;395;83692;171484;10251;169981;1349;63904;139716;257397;142689;80258;27035;1641;55613;7105;100329135;84295;9459;4810;404281;4109;367;474384;6748;139760;347487;92745;158830;53344;4103;9203;139378;186;474343;2719;3597;140456;9248;402415;203430;9185;90161;728042;4129;65267;56849;8228;8226;728036;7114;6399;4952;83740;84889;8481;6757;347468;347475;414;6759;9500;51132;8823;541578;2158;55609;2556;494119;6756;9502;158880;8517;8242;474383;57595;51442;389895;100132304;9754;80311;6102;27328;695;56159;51213;90737;60506;10943;100873985;57526;728269;170082;474382;102723680;728656;3358;8273;83844;114824;389840;170067;81557;80823;8862;2002;7216;79979;158763;23641;55217;8270;57477;7592;2833;425054;340526;727866;139599;139804;54470;8450;959;139562;645864;10075;117154;57631;2010;54521;79589;51634;3750;653282;728072;7076;392490;9363;8623;3920;347411;7454;100506164;265;90293;645051;100529097;55511;158724;6197;203547;139135;5355;347516;203522;139081;6451;27336;158787;728458;7499;4841;347517;51360;340578;139596;1896;441509;54466;660;158798;4108;171482;79868;728075;158833;79366;1821;56156;392465;1260;5160;56062;5303;3054;51260;139628;653220;340596;554;28986;23133;57393;2623;28227;4113;57692;50945;3730;7739;100131755;57481;8260;139170;64219;4204;389860;2574;3563;65991;10325;6170;10813;79710;8712;26280;2316;256714;10742;6173;9104;494197;29057;139324;442444;6103;54880;90736;55558;2742;1736;369;255313;3654;170627;645974;3897;79983;727940;541466;347527;8243;4007;139741;29978;2182;7504;60401;84707;53336;1485;159090;94056;57502;55285;653067;1046;11152;641339;1947;8852;7712;23708;203523;4267;54967;340542;89885;2277;83550;644353;55916;340595;6594;139189;63947;9643;9843;4935;139728;100288814;10479;50943;53940;55026;100507170;5638;4478;8239;4068;51114;139411;246100;9968;84679;115201;100533997;1741;416;64840;10682;11326;25763;27330;171483;8908;27286;1038;7543;158800;90060;1288;84061;215;6247;292;55879;401612;1183;340527;55344;29935;158983;357;10009;2747;2652;286514;340543;54885;100129407;10495;6792;79742;140886;2239;2334;4128;441518;139604;4303;55869;25878;4115;11040;8473;6855;84636;55922;728712;5956;2705;55841;54821;729396;441521;8933;10735;729442;9949;4694;84528;51481;492;3028;100129520;795;10389;83604;7411;9947;9367;100463488;10134;79057;54552;6906;340547;30014;415;5255;680;158809;6990;4435;5475;340529;65109;64860;7030;729428;8776;4675;5030;51566;729201;56271;4943;79917;85012;114928;5256;26609;54960;538;6853;5365;4354;286451;29934;10838;139221;9189;347404;6473;3251;286464;158931;139793;100008586;2717;3052;5973;139065;5199;546;5613;51270;139231;9131;7547;474381;257240;11254;27238;64102;2543;158747;2273;56474;5165;64648;54440;140597;5631;728239;3188;100130086;5251;8237;286527;100130302,815
-1,1,X,60679,155251871,155191192,23096;64061;392509;10214;170685;23157;727837;55998;23439;729431;10916;158586;55859;331;3423;54830;4168;6901;5358;92002;27344;729447;54328;266740;9075;102723737;7552;729422;54954;84460;389874;56000;340562;644538;92552;254158;79649;56850;8225;2824;100272147;51186;3149;26576;100130361;1730;347541;139425;3547;728695;729408;79921;57826;59272;203413;2986;7512;9737;8544;55634;2857;3421;537;11013;340554;5716;6658;4101;54457;1438;91966;441519;4100;5931;27316;7403;4534;6839;51480;728096;27112;92129;101928917;140462;8241;6567;827;203569;27301;84548;645037;54413;100133053;7355;254065;79836;10084;347442;60343;51765;55593;139818;56180;6303;8269;142684;7626;10046;8409;203447;63932;2710;4515;8406;51248;56001;51616;2925;100130613;2564;1193;100132994;5354;11043;340533;22;3476;84631;26748;11238;203562;102723631;170261;58526;441525;4983;29944;6907;1536;2539;1478;9468;23597;2187;1287;81887;6611;3561;9767;9282;54857;347365;10800;139341;54539;11219;728062;169966;51209;23630;26548;1121;2000;645188;51438;2846;280658;1852;347344;23229;10857;56157;286430;101059915;438;5277;9758;1069;4674;154796;56548;51309;1184;645073;80712;1774;10245;2258;728343;9823;441531;11141;643311;90121;256643;23676;4114;6758;4107;286499;5009;1654;1831;51284;94121;170302;11230;79135;286410;9210;2491;441490;84187;633;6191;64743;4110;3598;389856;7789;55787;9452;50814;2157;139422;170062;57187;139067;4104;203427;4693;5456;10013;1964;55190;100996648;293;9016;100528062;30011;90316;93953;10178;6322;28952;24137;2332;4105;6845;94122;84968;64663;1538;9142;286530;2245;5634;9506;79576;3266;139212;5207;6535;8227;393;389852;170626;91851;27334;158866;550643;159013;407;7224;55796;10761;100132963;168400;4281;158835;24140;8471;90167;7737;7319;10149;11279;6134;64109;1678;139322;5063;55906;116442;84443;27197;8233;548313;6872;27018;100129239;139105;7102;10549;26071;2664;59353;8573;28985;79184;728049;728090;158521;3581;139886;282808;8263;9130;728082;778;90843;1756;5422;7317;5935;347454;29071;207063;4112;412;158506;340602;30848;5127;22866;93380;159091;10159;212;139285;9338;85417;8266;100132399;158584;494118;190;7569;89801;2892;1968;5230;57232;55559;57529;8277;63035;80231;286436;25975;51311;8905;55086;139735;395;83692;171484;10251;169981;1349;63904;139716;257397;142689;80258;27035;1641;55613;7105;100329135;84295;9459;4810;404281;4109;367;474384;6748;139760;347487;92745;158830;53344;4103;9203;139378;186;474343;2719;3597;140456;9248;402415;203430;9185;90161;728042;4129;65267;56849;8228;8226;728036;7114;6399;4952;83740;84889;8481;6757;347468;347475;414;6759;9500;51132;8823;541578;2158;55609;2556;494119;6756;9502;158880;8517;8242;474383;57595;51442;389895;100132304;9754;80311;6102;27328;695;56159;51213;90737;60506;10943;100873985;57526;728269;170082;474382;102723680;728656;3358;8273;83844;114824;389840;170067;81557;80823;8862;2002;7216;79979;158763;23641;55217;8270;57477;7592;2833;425054;340526;727866;139599;139804;54470;8450;959;139562;645864;10075;117154;57631;2010;54521;79589;51634;3750;653282;728072;7076;392490;9363;8623;3920;347411;7454;100506164;265;90293;645051;100529097;55511;158724;6197;203547;139135;5355;347516;203522;139081;6451;27336;158787;728458;7499;4841;347517;51360;340578;139596;1896;441509;54466;660;158798;4108;171482;79868;728075;158833;79366;1821;56156;392465;1260;5160;56062;5303;3054;51260;139628;653220;340596;554;28986;23133;57393;2623;28227;4113;57692;50945;3730;7739;100131755;57481;8260;139170;64219;4204;389860;2574;3563;65991;10325;6170;10813;79710;8712;26280;2316;256714;10742;6173;9104;494197;29057;139324;442444;6103;54880;90736;55558;2742;1736;369;255313;3654;170627;645974;3897;79983;727940;541466;347527;8243;4007;139741;29978;2182;7504;60401;84707;53336;1485;159090;94056;57502;55285;653067;1046;11152;641339;1947;8852;7712;23708;203523;4267;54967;340542;89885;2277;83550;644353;55916;340595;6594;139189;63947;9643;9843;4935;139728;100288814;10479;50943;53940;55026;100507170;5638;4478;8239;4068;51114;139411;246100;9968;84679;115201;100533997;1741;416;64840;10682;11326;25763;27330;171483;8908;27286;1038;7543;158800;90060;1288;84061;215;6247;292;55879;401612;1183;340527;55344;29935;158983;357;10009;2747;2652;286514;340543;54885;100129407;10495;6792;79742;140886;2239;2334;4128;441518;139604;4303;55869;25878;4115;11040;8473;6855;84636;55922;728712;5956;2705;55841;54821;729396;441521;8933;10735;729442;9949;4694;84528;51481;492;3028;100129520;795;10389;83604;7411;9947;9367;100463488;10134;79057;54552;6906;340547;30014;415;5255;680;158809;6990;4435;5475;340529;65109;64860;7030;729428;8776;4675;5030;51566;729201;56271;4943;79917;85012;114928;5256;26609;54960;538;6853;5365;4354;286451;29934;10838;139221;9189;347404;6473;3251;286464;158931;139793;100008586;2717;3052;5973;139065;5199;546;5613;51270;139231;9131;7547;474381;257240;11254;27238;64102;2543;158747;2273;56474;5165;64648;54440;140597;5631;728239;3188;100130086;5251;8237;286527;100130302,815
1,1,X,60679,155251871,155191192,23096;64061;392509;10214;170685;23157;727837;55998;23439;729431;10916;158586;55859;331;3423;54830;4168;6901;5358;92002;27344;729447;54328;266740;9075;102723737;7552;729422;54954;84460;389874;56000;340562;644538;92552;254158;79649;56850;8225;2824;100272147;51186;3149;26576;100130361;1730;347541;139425;3547;728695;729408;79921;57826;59272;203413;2986;7512;9737;8544;55634;2857;3421;537;11013;340554;5716;6658;4101;54457;1438;91966;441519;4100;5931;27316;7403;4534;6839;51480;728096;27112;92129;101928917;140462;8241;6567;827;203569;27301;84548;645037;54413;100133053;7355;254065;79836;10084;347442;60343;51765;55593;139818;56180;6303;8269;142684;7626;10046;8409;203447;63932;2710;4515;8406;51248;56001;51616;2925;100130613;2564;1193;100132994;5354;11043;340533;22;3476;84631;26748;11238;203562;102723631;170261;58526;441525;4983;29944;6907;1536;2539;1478;9468;23597;2187;1287;81887;6611;3561;9767;9282;54857;347365;10800;139341;54539;11219;728062;169966;51209;23630;26548;1121;2000;645188;51438;2846;280658;1852;347344;23229;10857;56157;286430;101059915;438;5277;9758;1069;4674;154796;56548;51309;1184;645073;80712;1774;10245;2258;728343;9823;441531;11141;643311;90121;256643;23676;4114;6758;4107;286499;5009;1654;1831;51284;94121;170302;11230;79135;286410;9210;2491;441490;84187;633;6191;64743;4110;3598;389856;7789;55787;9452;50814;2157;139422;170062;57187;139067;4104;203427;4693;5456;10013;1964;55190;100996648;293;9016;100528062;30011;90316;93953;10178;6322;28952;24137;2332;4105;6845;94122;84968;64663;1538;9142;286530;2245;5634;9506;79576;3266;139212;5207;6535;8227;393;389852;170626;91851;27334;158866;550643;159013;407;7224;55796;10761;100132963;168400;4281;158835;24140;8471;90167;7737;7319;10149;11279;6134;64109;1678;139322;5063;55906;116442;84443;27197;8233;548313;6872;27018;100129239;139105;7102;10549;26071;2664;59353;8573;28985;79184;728049;728090;158521;3581;139886;282808;8263;9130;728082;778;90843;1756;5422;7317;5935;347454;29071;207063;4112;412;158506;340602;30848;5127;22866;93380;159091;10159;212;139285;9338;85417;8266;100132399;158584;494118;190;7569;89801;2892;1968;5230;57232;55559;57529;8277;63035;80231;286436;25975;51311;8905;55086;139735;395;83692;171484;10251;169981;1349;63904;139716;257397;142689;80258;27035;1641;55613;7105;100329135;84295;9459;4810;404281;4109;367;474384;6748;139760;347487;92745;158830;53344;4103;9203;139378;186;474343;2719;3597;140456;9248;402415;203430;9185;90161;728042;4129;65267;56849;8228;8226;728036;7114;6399;4952;83740;84889;8481;6757;347468;347475;414;6759;9500;51132;8823;541578;2158;55609;2556;494119;6756;9502;158880;8517;8242;474383;57595;51442;389895;100132304;9754;80311;6102;27328;695;56159;51213;90737;60506;10943;100873985;57526;728269;170082;474382;102723680;728656;3358;8273;83844;114824;389840;170067;81557;80823;8862;2002;7216;79979;158763;23641;55217;8270;57477;7592;2833;425054;340526;727866;139599;139804;54470;8450;959;139562;645864;10075;117154;57631;2010;54521;79589;51634;3750;653282;728072;7076;392490;9363;8623;3920;347411;7454;100506164;265;90293;645051;100529097;55511;158724;6197;203547;139135;5355;347516;203522;139081;6451;27336;158787;728458;7499;4841;347517;51360;340578;139596;1896;441509;54466;660;158798;4108;171482;79868;728075;158833;79366;1821;56156;392465;1260;5160;56062;5303;3054;51260;139628;653220;340596;554;28986;23133;57393;2623;28227;4113;57692;50945;3730;7739;100131755;57481;8260;139170;64219;4204;389860;2574;3563;65991;10325;6170;10813;79710;8712;26280;2316;256714;10742;6173;9104;494197;29057;139324;442444;6103;54880;90736;55558;2742;1736;369;255313;3654;170627;645974;3897;79983;727940;541466;347527;8243;4007;139741;29978;2182;7504;60401;84707;53336;1485;159090;94056;57502;55285;653067;1046;11152;641339;1947;8852;7712;23708;203523;4267;54967;340542;89885;2277;83550;644353;55916;340595;6594;139189;63947;9643;9843;4935;139728;100288814;10479;50943;53940;55026;100507170;5638;4478;8239;4068;51114;139411;246100;9968;84679;115201;100533997;1741;416;64840;10682;11326;25763;27330;171483;8908;27286;1038;7543;158800;90060;1288;84061;215;6247;292;55879;401612;1183;340527;55344;29935;158983;357;10009;2747;2652;286514;340543;54885;100129407;10495;6792;79742;140886;2239;2334;4128;441518;139604;4303;55869;25878;4115;11040;8473;6855;84636;55922;728712;5956;2705;55841;54821;729396;441521;8933;10735;729442;9949;4694;84528;51481;492;3028;100129520;795;10389;83604;7411;9947;9367;100463488;10134;79057;54552;6906;340547;30014;415;5255;680;158809;6990;4435;5475;340529;65109;64860;7030;729428;8776;4675;5030;51566;729201;56271;4943;79917;85012;114928;5256;26609;54960;538;6853;5365;4354;286451;29934;10838;139221;9189;347404;6473;3251;286464;158931;139793;100008586;2717;3052;5973;139065;5199;546;5613;51270;139231;9131;7547;474381;257240;11254;27238;64102;2543;158747;2273;56474;5165;64648;54440;140597;5631;728239;3188;100130086;5251;8237;286527;100130302,815
1,1,X,60679,155251871,155191192,23096;64061;392509;10214;170685;23157;727837;55998;23439;729431;10916;158586;55859;331;3423;54830;4168;6901;5358;92002;27344;729447;54328;266740;9075;102723737;7552;729422;54954;84460;389874;56000;340562;644538;92552;254158;79649;56850;8225;2824;100272147;51186;3149;26576;100130361;1730;347541;139425;3547;728695;729408;79921;57826;59272;203413;2986;7512;9737;8544;55634;2857;3421;537;11013;340554;5716;6658;4101;54457;1438;91966;441519;4100;5931;27316;7403;4534;6839;51480;728096;27112;92129;101928917;140462;8241;6567;827;203569;27301;84548;645037;54413;100133053;7355;254065;79836;10084;347442;60343;51765;55593;139818;56180;6303;8269;142684;7626;10046;8409;203447;63932;2710;4515;8406;51248;56001;51616;2925;100130613;2564;1193;100132994;5354;11043;340533;22;3476;84631;26748;11238;203562;102723631;170261;58526;441525;4983;29944;6907;1536;2539;1478;9468;23597;2187;1287;81887;6611;3561;9767;9282;54857;347365;10800;139341;54539;11219;728062;169966;51209;23630;26548;1121;2000;645188;51438;2846;280658;1852;347344;23229;10857;56157;286430;101059915;438;5277;9758;1069;4674;154796;56548;51309;1184;645073;80712;1774;10245;2258;728343;9823;441531;11141;643311;90121;256643;23676;4114;6758;4107;286499;5009;1654;1831;51284;94121;170302;11230;79135;286410;9210;2491;441490;84187;633;6191;64743;4110;3598;389856;7789;55787;9452;50814;2157;139422;170062;57187;139067;4104;203427;4693;5456;10013;1964;55190;100996648;293;9016;100528062;30011;90316;93953;10178;6322;28952;24137;2332;4105;6845;94122;84968;64663;1538;9142;286530;2245;5634;9506;79576;3266;139212;5207;6535;8227;393;389852;170626;91851;27334;158866;550643;159013;407;7224;55796;10761;100132963;168400;4281;158835;24140;8471;90167;7737;7319;10149;11279;6134;64109;1678;139322;5063;55906;116442;84443;27197;8233;548313;6872;27018;100129239;139105;7102;10549;26071;2664;59353;8573;28985;79184;728049;728090;158521;3581;139886;282808;8263;9130;728082;778;90843;1756;5422;7317;5935;347454;29071;207063;4112;412;158506;340602;30848;5127;22866;93380;159091;10159;212;139285;9338;85417;8266;100132399;158584;494118;190;7569;89801;2892;1968;5230;57232;55559;57529;8277;63035;80231;286436;25975;51311;8905;55086;139735;395;83692;171484;10251;169981;1349;63904;139716;257397;142689;80258;27035;1641;55613;7105;100329135;84295;9459;4810;404281;4109;367;474384;6748;139760;347487;92745;158830;53344;4103;9203;139378;186;474343;2719;3597;140456;9248;402415;203430;9185;90161;728042;4129;65267;56849;8228;8226;728036;7114;6399;4952;83740;84889;8481;6757;347468;347475;414;6759;9500;51132;8823;541578;2158;55609;2556;494119;6756;9502;158880;8517;8242;474383;57595;51442;389895;100132304;9754;80311;6102;27328;695;56159;51213;90737;60506;10943;100873985;57526;728269;170082;474382;102723680;728656;3358;8273;83844;114824;389840;170067;81557;80823;8862;2002;7216;79979;158763;23641;55217;8270;57477;7592;2833;425054;340526;727866;139599;139804;54470;8450;959;139562;645864;10075;117154;57631;2010;54521;79589;51634;3750;653282;728072;7076;392490;9363;8623;3920;347411;7454;100506164;265;90293;645051;100529097;55511;158724;6197;203547;139135;5355;347516;203522;139081;6451;27336;158787;728458;7499;4841;347517;51360;340578;139596;1896;441509;54466;660;158798;4108;171482;79868;728075;158833;79366;1821;56156;392465;1260;5160;56062;5303;3054;51260;139628;653220;340596;554;28986;23133;57393;2623;28227;4113;57692;50945;3730;7739;100131755;57481;8260;139170;64219;4204;389860;2574;3563;65991;10325;6170;10813;79710;8712;26280;2316;256714;10742;6173;9104;494197;29057;139324;442444;6103;54880;90736;55558;2742;1736;369;255313;3654;170627;645974;3897;79983;727940;541466;347527;8243;4007;139741;29978;2182;7504;60401;84707;53336;1485;159090;94056;57502;55285;653067;1046;11152;641339;1947;8852;7712;23708;203523;4267;54967;340542;89885;2277;83550;644353;55916;340595;6594;139189;63947;9643;9843;4935;139728;100288814;10479;50943;53940;55026;100507170;5638;4478;8239;4068;51114;139411;246100;9968;84679;115201;100533997;1741;416;64840;10682;11326;25763;27330;171483;8908;27286;1038;7543;158800;90060;1288;84061;215;6247;292;55879;401612;1183;340527;55344;29935;158983;357;10009;2747;2652;286514;340543;54885;100129407;10495;6792;79742;140886;2239;2334;4128;441518;139604;4303;55869;25878;4115;11040;8473;6855;84636;55922;728712;5956;2705;55841;54821;729396;441521;8933;10735;729442;9949;4694;84528;51481;492;3028;100129520;795;10389;83604;7411;9947;9367;100463488;10134;79057;54552;6906;340547;30014;415;5255;680;158809;6990;4435;5475;340529;65109;64860;7030;729428;8776;4675;5030;51566;729201;56271;4943;79917;85012;114928;5256;26609;54960;538;6853;5365;4354;286451;29934;10838;139221;9189;347404;6473;3251;286464;158931;139793;100008586;2717;3052;5973;139065;5199;546;5613;51270;139231;9131;7547;474381;257240;11254;27238;64102;2543;158747;2273;56474;5165;64648;54440;140597;5631;728239;3188;100130086;5251;8237;286527;100130302,815
1,1,X,60679,155251871,155191192,23096;64061;392509;10214;170685;23157;727837;55998;23439;729431;10916;158586;55859;331;3423;54830;4168;6901;5358;92002;27344;729447;54328;266740;9075;102723737;7552;729422;54954;84460;389874;56000;340562;644538;92552;254158;79649;56850;8225;2824;100272147;51186;3149;26576;100130361;1730;347541;139425;3547;728695;729408;79921;57826;59272;203413;2986;7512;9737;8544;55634;2857;3421;537;11013;340554;5716;6658;4101;54457;1438;91966;441519;4100;5931;27316;7403;4534;6839;51480;728096;27112;92129;101928917;140462;8241;6567;827;203569;27301;84548;645037;54413;100133053;7355;254065;79836;10084;347442;60343;51765;55593;139818;56180;6303;8269;142684;7626;10046;8409;203447;63932;2710;4515;8406;51248;56001;51616;2925;100130613;2564;1193;100132994;5354;11043;340533;22;3476;84631;26748;11238;203562;102723631;170261;58526;441525;4983;29944;6907;1536;2539;1478;9468;23597;2187;1287;81887;6611;3561;9767;9282;54857;347365;10800;139341;54539;11219;728062;169966;51209;23630;26548;1121;2000;645188;51438;2846;280658;1852;347344;23229;10857;56157;286430;101059915;438;5277;9758;1069;4674;154796;56548;51309;1184;645073;80712;1774;10245;2258;728343;9823;441531;11141;643311;90121;256643;23676;4114;6758;4107;286499;5009;1654;1831;51284;94121;170302;11230;79135;286410;9210;2491;441490;84187;633;6191;64743;4110;3598;389856;7789;55787;9452;50814;2157;139422;170062;57187;139067;4104;203427;4693;5456;10013;1964;55190;100996648;293;9016;100528062;30011;90316;93953;10178;6322;28952;24137;2332;4105;6845;94122;84968;64663;1538;9142;286530;2245;5634;9506;79576;3266;139212;5207;6535;8227;393;389852;170626;91851;27334;158866;550643;159013;407;7224;55796;10761;100132963;168400;4281;158835;24140;8471;90167;7737;7319;10149;11279;6134;64109;1678;139322;5063;55906;116442;84443;27197;8233;548313;6872;27018;100129239;139105;7102;10549;26071;2664;59353;8573;28985;79184;728049;728090;158521;3581;139886;282808;8263;9130;728082;778;90843;1756;5422;7317;5935;347454;29071;207063;4112;412;158506;340602;30848;5127;22866;93380;159091;10159;212;139285;9338;85417;8266;100132399;158584;494118;190;7569;89801;2892;1968;5230;57232;55559;57529;8277;63035;80231;286436;25975;51311;8905;55086;139735;395;83692;171484;10251;169981;1349;63904;139716;257397;142689;80258;27035;1641;55613;7105;100329135;84295;9459;4810;404281;4109;367;474384;6748;139760;347487;92745;158830;53344;4103;9203;139378;186;474343;2719;3597;140456;9248;402415;203430;9185;90161;728042;4129;65267;56849;8228;8226;728036;7114;6399;4952;83740;84889;8481;6757;347468;347475;414;6759;9500;51132;8823;541578;2158;55609;2556;494119;6756;9502;158880;8517;8242;474383;57595;51442;389895;100132304;9754;80311;6102;27328;695;56159;51213;90737;60506;10943;100873985;57526;728269;170082;474382;102723680;728656;3358;8273;83844;114824;389840;170067;81557;80823;8862;2002;7216;79979;158763;23641;55217;8270;57477;7592;2833;425054;340526;727866;139599;139804;54470;8450;959;139562;645864;10075;117154;57631;2010;54521;79589;51634;3750;653282;728072;7076;392490;9363;8623;3920;347411;7454;100506164;265;90293;645051;100529097;55511;158724;6197;203547;139135;5355;347516;203522;139081;6451;27336;158787;728458;7499;4841;347517;51360;340578;139596;1896;441509;54466;660;158798;4108;171482;79868;728075;158833;79366;1821;56156;392465;1260;5160;56062;5303;3054;51260;139628;653220;340596;554;28986;23133;57393;2623;28227;4113;57692;50945;3730;7739;100131755;57481;8260;139170;64219;4204;389860;2574;3563;65991;10325;6170;10813;79710;8712;26280;2316;256714;10742;6173;9104;494197;29057;139324;442444;6103;54880;90736;55558;2742;1736;369;255313;3654;170627;645974;3897;79983;727940;541466;347527;8243;4007;139741;29978;2182;7504;60401;84707;53336;1485;159090;94056;57502;55285;653067;1046;11152;641339;1947;8852;7712;23708;203523;4267;54967;340542;89885;2277;83550;644353;55916;340595;6594;139189;63947;9643;9843;4935;139728;100288814;10479;50943;53940;55026;100507170;5638;4478;8239;4068;51114;139411;246100;9968;84679;115201;100533997;1741;416;64840;10682;11326;25763;27330;171483;8908;27286;1038;7543;158800;90060;1288;84061;215;6247;292;55879;401612;1183;340527;55344;29935;158983;357;10009;2747;2652;286514;340543;54885;100129407;10495;6792;79742;140886;2239;2334;4128;441518;139604;4303;55869;25878;4115;11040;8473;6855;84636;55922;728712;5956;2705;55841;54821;729396;441521;8933;10735;729442;9949;4694;84528;51481;492;3028;100129520;795;10389;83604;7411;9947;9367;100463488;10134;79057;54552;6906;340547;30014;415;5255;680;158809;6990;4435;5475;340529;65109;64860;7030;729428;8776;4675;5030;51566;729201;56271;4943;79917;85012;114928;5256;26609;54960;538;6853;5365;4354;286451;29934;10838;139221;9189;347404;6473;3251;286464;158931;139793;100008586;2717;3052;5973;139065;5199;546;5613;51270;139231;9131;7547;474381;257240;11254;27238;64102;2543;158747;2273;56474;5165;64648;54440;140597;5631;728239;3188;100130086;5251;8237;286527;100130302,815
1,1,X,60679,155251871,155191192,23096;64061;392509;10214;170685;23157;727837;55998;23439;729431;10916;158586;55859;331;3423;54830;4168;6901;5358;92002;27344;729447;54328;266740;9075;102723737;7552;729422;54954;84460;389874;56000;340562;644538;92552;254158;79649;56850;8225;2824;100272147;51186;3149;26576;100130361;1730;347541;139425;3547;728695;729408;79921;57826;59272;203413;2986;7512;9737;8544;55634;2857;3421;537;11013;340554;5716;6658;4101;54457;1438;91966;441519;4100;5931;27316;7403;4534;6839;51480;728096;27112;92129;101928917;140462;8241;6567;827;203569;27301;84548;645037;54413;100133053;7355;254065;79836;10084;347442;60343;51765;55593;139818;56180;6303;8269;142684;7626;10046;8409;203447;63932;2710;4515;8406;51248;56001;51616;2925;100130613;2564;1193;100132994;5354;11043;340533;22;3476;84631;26748;11238;203562;102723631;170261;58526;441525;4983;29944;6907;1536;2539;1478;9468;23597;2187;1287;81887;6611;3561;9767;9282;54857;347365;10800;139341;54539;11219;728062;169966;51209;23630;26548;1121;2000;645188;51438;2846;280658;1852;347344;23229;10857;56157;286430;101059915;438;5277;9758;1069;4674;154796;56548;51309;1184;645073;80712;1774;10245;2258;728343;9823;441531;11141;643311;90121;256643;23676;4114;6758;4107;286499;5009;1654;1831;51284;94121;170302;11230;79135;286410;9210;2491;441490;84187;633;6191;64743;4110;3598;389856;7789;55787;9452;50814;2157;139422;170062;57187;139067;4104;203427;4693;5456;10013;1964;55190;100996648;293;9016;100528062;30011;90316;93953;10178;6322;28952;24137;2332;4105;6845;94122;84968;64663;1538;9142;286530;2245;5634;9506;79576;3266;139212;5207;6535;8227;393;389852;170626;91851;27334;158866;550643;159013;407;7224;55796;10761;100132963;168400;4281;158835;24140;8471;90167;7737;7319;10149;11279;6134;64109;1678;139322;5063;55906;116442;84443;27197;8233;548313;6872;27018;100129239;139105;7102;10549;26071;2664;59353;8573;28985;79184;728049;728090;158521;3581;139886;282808;8263;9130;728082;778;90843;1756;5422;7317;5935;347454;29071;207063;4112;412;158506;340602;30848;5127;22866;93380;159091;10159;212;139285;9338;85417;8266;100132399;158584;494118;190;7569;89801;2892;1968;5230;57232;55559;57529;8277;63035;80231;286436;25975;51311;8905;55086;139735;395;83692;171484;10251;169981;1349;63904;139716;257397;142689;80258;27035;1641;55613;7105;100329135;84295;9459;4810;404281;4109;367;474384;6748;139760;347487;92745;158830;53344;4103;9203;139378;186;474343;2719;3597;140456;9248;402415;203430;9185;90161;728042;4129;65267;56849;8228;8226;728036;7114;6399;4952;83740;84889;8481;6757;347468;347475;414;6759;9500;51132;8823;541578;2158;55609;2556;494119;6756;9502;158880;8517;8242;474383;57595;51442;389895;100132304;9754;80311;6102;27328;695;56159;51213;90737;60506;10943;100873985;57526;728269;170082;474382;102723680;728656;3358;8273;83844;114824;389840;170067;81557;80823;8862;2002;7216;79979;158763;23641;55217;8270;57477;7592;2833;425054;340526;727866;139599;139804;54470;8450;959;139562;645864;10075;117154;57631;2010;54521;79589;51634;3750;653282;728072;7076;392490;9363;8623;3920;347411;7454;100506164;265;90293;645051;100529097;55511;158724;6197;203547;139135;5355;347516;203522;139081;6451;27336;158787;728458;7499;4841;347517;51360;340578;139596;1896;441509;54466;660;158798;4108;171482;79868;728075;158833;79366;1821;56156;392465;1260;5160;56062;5303;3054;51260;139628;653220;340596;554;28986;23133;57393;2623;28227;4113;57692;50945;3730;7739;100131755;57481;8260;139170;64219;4204;389860;2574;3563;65991;10325;6170;10813;79710;8712;26280;2316;256714;10742;6173;9104;494197;29057;139324;442444;6103;54880;90736;55558;2742;1736;369;255313;3654;170627;645974;3897;79983;727940;541466;347527;8243;4007;139741;29978;2182;7504;60401;84707;53336;1485;159090;94056;57502;55285;653067;1046;11152;641339;1947;8852;7712;23708;203523;4267;54967;340542;89885;2277;83550;644353;55916;340595;6594;139189;63947;9643;9843;4935;139728;100288814;10479;50943;53940;55026;100507170;5638;4478;8239;4068;51114;139411;246100;9968;84679;115201;100533997;1741;416;64840;10682;11326;25763;27330;171483;8908;27286;1038;7543;158800;90060;1288;84061;215;6247;292;55879;401612;1183;340527;55344;29935;158983;357;10009;2747;2652;286514;340543;54885;100129407;10495;6792;79742;140886;2239;2334;4128;441518;139604;4303;55869;25878;4115;11040;8473;6855;84636;55922;728712;5956;2705;55841;54821;729396;441521;8933;10735;729442;9949;4694;84528;51481;492;3028;100129520;795;10389;83604;7411;9947;9367;100463488;10134;79057;54552;6906;340547;30014;415;5255;680;158809;6990;4435;5475;340529;65109;64860;7030;729428;8776;4675;5030;51566;729201;56271;4943;79917;85012;114928;5256;26609;54960;538;6853;5365;4354;286451;29934;10838;139221;9189;347404;6473;3251;286464;158931;139793;100008586;2717;3052;5973;139065;5199;546;5613;51270;139231;9131;7547;474381;257240;11254;27238;64102;2543;158747;2273;56474;5165;64648;54440;140597;5631;728239;3188;100130086;5251;8237;286527;100130302,815
1,1,X,60679,155251871,155191192,23096;64061;392509;10214;170685;23157;727837;55998;23439;729431;10916;158586;55859;331;3423;54830;4168;6901;5358;92002;27344;729447;54328;266740;9075;102723737;7552;729422;54954;84460;389874;56000;340562;644538;92552;254158;79649;56850;8225;2824;100272147;51186;3149;26576;100130361;1730;347541;139425;3547;728695;729408;79921;57826;59272;203413;2986;7512;9737;8544;55634;2857;3421;537;11013;340554;5716;6658;4101;54457;1438;91966;441519;4100;5931;27316;7403;4534;6839;51480;728096;27112;92129;101928917;140462;8241;6567;827;203569;27301;84548;645037;54413;100133053;7355;254065;79836;10084;347442;60343;51765;55593;139818;56180;6303;8269;142684;7626;10046;8409;203447;63932;2710;4515;8406;51248;56001;51616;2925;100130613;2564;1193;100132994;5354;11043;340533;22;3476;84631;26748;11238;203562;102723631;170261;58526;441525;4983;29944;6907;1536;2539;1478;9468;23597;2187;1287;81887;6611;3561;9767;9282;54857;347365;10800;139341;54539;11219;728062;169966;51209;23630;26548;1121;2000;645188;51438;2846;280658;1852;347344;23229;10857;56157;286430;101059915;438;5277;9758;1069;4674;154796;56548;51309;1184;645073;80712;1774;10245;2258;728343;9823;441531;11141;643311;90121;256643;23676;4114;6758;4107;286499;5009;1654;1831;51284;94121;170302;11230;79135;286410;9210;2491;441490;84187;633;6191;64743;4110;3598;389856;7789;55787;9452;50814;2157;139422;170062;57187;139067;4104;203427;4693;5456;10013;1964;55190;100996648;293;9016;100528062;30011;90316;93953;10178;6322;28952;24137;2332;4105;6845;94122;84968;64663;1538;9142;286530;2245;5634;9506;79576;3266;139212;5207;6535;8227;393;389852;170626;91851;27334;158866;550643;159013;407;7224;55796;10761;100132963;168400;4281;158835;24140;8471;90167;7737;7319;10149;11279;6134;64109;1678;139322;5063;55906;116442;84443;27197;8233;548313;6872;27018;100129239;139105;7102;10549;26071;2664;59353;8573;28985;79184;728049;728090;158521;3581;139886;282808;8263;9130;728082;778;90843;1756;5422;7317;5935;347454;29071;207063;4112;412;158506;340602;30848;5127;22866;93380;159091;10159;212;139285;9338;85417;8266;100132399;158584;494118;190;7569;89801;2892;1968;5230;57232;55559;57529;8277;63035;80231;286436;25975;51311;8905;55086;139735;395;83692;171484;10251;169981;1349;63904;139716;257397;142689;80258;27035;1641;55613;7105;100329135;84295;9459;4810;404281;4109;367;474384;6748;139760;347487;92745;158830;53344;4103;9203;139378;186;474343;2719;3597;140456;9248;402415;203430;9185;90161;728042;4129;65267;56849;8228;8226;728036;7114;6399;4952;83740;84889;8481;6757;347468;347475;414;6759;9500;51132;8823;541578;2158;55609;2556;494119;6756;9502;158880;8517;8242;474383;57595;51442;389895;100132304;9754;80311;6102;27328;695;56159;51213;90737;60506;10943;100873985;57526;728269;170082;474382;102723680;728656;3358;8273;83844;114824;389840;170067;81557;80823;8862;2002;7216;79979;158763;23641;55217;8270;57477;7592;2833;425054;340526;727866;139599;139804;54470;8450;959;139562;645864;10075;117154;57631;2010;54521;79589;51634;3750;653282;728072;7076;392490;9363;8623;3920;347411;7454;100506164;265;90293;645051;100529097;55511;158724;6197;203547;139135;5355;347516;203522;139081;6451;27336;158787;728458;7499;4841;347517;51360;340578;139596;1896;441509;54466;660;158798;4108;171482;79868;728075;158833;79366;1821;56156;392465;1260;5160;56062;5303;3054;51260;139628;653220;340596;554;28986;23133;57393;2623;28227;4113;57692;50945;3730;7739;100131755;57481;8260;139170;64219;4204;389860;2574;3563;65991;10325;6170;10813;79710;8712;26280;2316;256714;10742;6173;9104;494197;29057;139324;442444;6103;54880;90736;55558;2742;1736;369;255313;3654;170627;645974;3897;79983;727940;541466;347527;8243;4007;139741;29978;2182;7504;60401;84707;53336;1485;159090;94056;57502;55285;653067;1046;11152;641339;1947;8852;7712;23708;203523;4267;54967;340542;89885;2277;83550;644353;55916;340595;6594;139189;63947;9643;9843;4935;139728;100288814;10479;50943;53940;55026;100507170;5638;4478;8239;4068;51114;139411;246100;9968;84679;115201;100533997;1741;416;64840;10682;11326;25763;27330;171483;8908;27286;1038;7543;158800;90060;1288;84061;215;6247;292;55879;401612;1183;340527;55344;29935;158983;357;10009;2747;2652;286514;340543;54885;100129407;10495;6792;79742;140886;2239;2334;4128;441518;139604;4303;55869;25878;4115;11040;8473;6855;84636;55922;728712;5956;2705;55841;54821;729396;441521;8933;10735;729442;9949;4694;84528;51481;492;3028;100129520;795;10389;83604;7411;9947;9367;100463488;10134;79057;54552;6906;340547;30014;415;5255;680;158809;6990;4435;5475;340529;65109;64860;7030;729428;8776;4675;5030;51566;729201;56271;4943;79917;85012;114928;5256;26609;54960;538;6853;5365;4354;286451;29934;10838;139221;9189;347404;6473;3251;286464;158931;139793;100008586;2717;3052;5973;139065;5199;546;5613;51270;139231;9131;7547;474381;257240;11254;27238;64102;2543;158747;2273;56474;5165;64648;54440;140597;5631;728239;3188;100130086;5251;8237;286527;100130302,815
-1,1,X,60679,155251871,155191192,23096;64061;392509;10214;170685;23157;727837;55998;23439;729431;10916;158586;55859;331;3423;54830;4168;6901;5358;92002;27344;729447;54328;266740;9075;102723737;7552;729422;54954;84460;389874;56000;340562;644538;92552;254158;79649;56850;8225;2824;100272147;51186;3149;26576;100130361;1730;347541;139425;3547;728695;729408;79921;57826;59272;203413;2986;7512;9737;8544;55634;2857;3421;537;11013;340554;5716;6658;4101;54457;1438;91966;441519;4100;5931;27316;7403;4534;6839;51480;728096;27112;92129;101928917;140462;8241;6567;827;203569;27301;84548;645037;54413;100133053;7355;254065;79836;10084;347442;60343;51765;55593;139818;56180;6303;8269;142684;7626;10046;8409;203447;63932;2710;4515;8406;51248;56001;51616;2925;100130613;2564;1193;100132994;5354;11043;340533;22;3476;84631;26748;11238;203562;102723631;170261;58526;441525;4983;29944;6907;1536;2539;1478;9468;23597;2187;1287;81887;6611;3561;9767;9282;54857;347365;10800;139341;54539;11219;728062;169966;51209;23630;26548;1121;2000;645188;51438;2846;280658;1852;347344;23229;10857;56157;286430;101059915;438;5277;9758;1069;4674;154796;56548;51309;1184;645073;80712;1774;10245;2258;728343;9823;441531;11141;643311;90121;256643;23676;4114;6758;4107;286499;5009;1654;1831;51284;94121;170302;11230;79135;286410;9210;2491;441490;84187;633;6191;64743;4110;3598;389856;7789;55787;9452;50814;2157;139422;170062;57187;139067;4104;203427;4693;5456;10013;1964;55190;100996648;293;9016;100528062;30011;90316;93953;10178;6322;28952;24137;2332;4105;6845;94122;84968;64663;1538;9142;286530;2245;5634;9506;79576;3266;139212;5207;6535;8227;393;389852;170626;91851;27334;158866;550643;159013;407;7224;55796;10761;100132963;168400;4281;158835;24140;8471;90167;7737;7319;10149;11279;6134;64109;1678;139322;5063;55906;116442;84443;27197;8233;548313;6872;27018;100129239;139105;7102;10549;26071;2664;59353;8573;28985;79184;728049;728090;158521;3581;139886;282808;8263;9130;728082;778;90843;1756;5422;7317;5935;347454;29071;207063;4112;412;158506;340602;30848;5127;22866;93380;159091;10159;212;139285;9338;85417;8266;100132399;158584;494118;190;7569;89801;2892;1968;5230;57232;55559;57529;8277;63035;80231;286436;25975;51311;8905;55086;139735;395;83692;171484;10251;169981;1349;63904;139716;257397;142689;80258;27035;1641;55613;7105;100329135;84295;9459;4810;404281;4109;367;474384;6748;139760;347487;92745;158830;53344;4103;9203;139378;186;474343;2719;3597;140456;9248;402415;203430;9185;90161;728042;4129;65267;56849;8228;8226;728036;7114;6399;4952;83740;84889;8481;6757;347468;347475;414;6759;9500;51132;8823;541578;2158;55609;2556;494119;6756;9502;158880;8517;8242;474383;57595;51442;389895;100132304;9754;80311;6102;27328;695;56159;51213;90737;60506;10943;100873985;57526;728269;170082;474382;102723680;728656;3358;8273;83844;114824;389840;170067;81557;80823;8862;2002;7216;79979;158763;23641;55217;8270;57477;7592;2833;425054;340526;727866;139599;139804;54470;8450;959;139562;645864;10075;117154;57631;2010;54521;79589;51634;3750;653282;728072;7076;392490;9363;8623;3920;347411;7454;100506164;265;90293;645051;100529097;55511;158724;6197;203547;139135;5355;347516;203522;139081;6451;27336;158787;728458;7499;4841;347517;51360;340578;139596;1896;441509;54466;660;158798;4108;171482;79868;728075;158833;79366;1821;56156;392465;1260;5160;56062;5303;3054;51260;139628;653220;340596;554;28986;23133;57393;2623;28227;4113;57692;50945;3730;7739;100131755;57481;8260;139170;64219;4204;389860;2574;3563;65991;10325;6170;10813;79710;8712;26280;2316;256714;10742;6173;9104;494197;29057;139324;442444;6103;54880;90736;55558;2742;1736;369;255313;3654;170627;645974;3897;79983;727940;541466;347527;8243;4007;139741;29978;2182;7504;60401;84707;53336;1485;159090;94056;57502;55285;653067;1046;11152;641339;1947;8852;7712;23708;203523;4267;54967;340542;89885;2277;83550;644353;55916;340595;6594;139189;63947;9643;9843;4935;139728;100288814;10479;50943;53940;55026;100507170;5638;4478;8239;4068;51114;139411;246100;9968;84679;115201;100533997;1741;416;64840;10682;11326;25763;27330;171483;8908;27286;1038;7543;158800;90060;1288;84061;215;6247;292;55879;401612;1183;340527;55344;29935;158983;357;10009;2747;2652;286514;340543;54885;100129407;10495;6792;79742;140886;2239;2334;4128;441518;139604;4303;55869;25878;4115;11040;8473;6855;84636;55922;728712;5956;2705;55841;54821;729396;441521;8933;10735;729442;9949;4694;84528;51481;492;3028;100129520;795;10389;83604;7411;9947;9367;100463488;10134;79057;54552;6906;340547;30014;415;5255;680;158809;6990;4435;5475;340529;65109;64860;7030;729428;8776;4675;5030;51566;729201;56271;4943;79917;85012;114928;5256;26609;54960;538;6853;5365;4354;286451;29934;10838;139221;9189;347404;6473;3251;286464;158931;139793;100008586;2717;3052;5973;139065;5199;546;5613;51270;139231;9131;7547;474381;257240;11254;27238;64102;2543;158747;2273;56474;5165;64648;54440;140597;5631;728239;3188;100130086;5251;8237;286527;100130302,815
1,1,X,60679,155251871,155191192,23096;64061;392509;10214;170685;23157;727837;55998;23439;729431;10916;158586;55859;331;3423;54830;4168;6901;5358;92002;27344;729447;54328;266740;9075;102723737;7552;729422;54954;84460;389874;56000;340562;644538;92552;254158;79649;56850;8225;2824;100272147;51186;3149;26576;100130361;1730;347541;139425;3547;728695;729408;79921;57826;59272;203413;2986;7512;9737;8544;55634;2857;3421;537;11013;340554;5716;6658;4101;54457;1438;91966;441519;4100;5931;27316;7403;4534;6839;51480;728096;27112;92129;101928917;140462;8241;6567;827;203569;27301;84548;645037;54413;100133053;7355;254065;79836;10084;347442;60343;51765;55593;139818;56180;6303;8269;142684;7626;10046;8409;203447;63932;2710;4515;8406;51248;56001;51616;2925;100130613;2564;1193;100132994;5354;11043;340533;22;3476;84631;26748;11238;203562;102723631;170261;58526;441525;4983;29944;6907;1536;2539;1478;9468;23597;2187;1287;81887;6611;3561;9767;9282;54857;347365;10800;139341;54539;11219;728062;169966;51209;23630;26548;1121;2000;645188;51438;2846;280658;1852;347344;23229;10857;56157;286430;101059915;438;5277;9758;1069;4674;154796;56548;51309;1184;645073;80712;1774;10245;2258;728343;9823;441531;11141;643311;90121;256643;23676;4114;6758;4107;286499;5009;1654;1831;51284;94121;170302;11230;79135;286410;9210;2491;441490;84187;633;6191;64743;4110;3598;389856;7789;55787;9452;50814;2157;139422;170062;57187;139067;4104;203427;4693;5456;10013;1964;55190;100996648;293;9016;100528062;30011;90316;93953;10178;6322;28952;24137;2332;4105;6845;94122;84968;64663;1538;9142;286530;2245;5634;9506;79576;3266;139212;5207;6535;8227;393;389852;170626;91851;27334;158866;550643;159013;407;7224;55796;10761;100132963;168400;4281;158835;24140;8471;90167;7737;7319;10149;11279;6134;64109;1678;139322;5063;55906;116442;84443;27197;8233;548313;6872;27018;100129239;139105;7102;10549;26071;2664;59353;8573;28985;79184;728049;728090;158521;3581;139886;282808;8263;9130;728082;778;90843;1756;5422;7317;5935;347454;29071;207063;4112;412;158506;340602;30848;5127;22866;93380;159091;10159;212;139285;9338;85417;8266;100132399;158584;494118;190;7569;89801;2892;1968;5230;57232;55559;57529;8277;63035;80231;286436;25975;51311;8905;55086;139735;395;83692;171484;10251;169981;1349;63904;139716;257397;142689;80258;27035;1641;55613;7105;100329135;84295;9459;4810;404281;4109;367;474384;6748;139760;347487;92745;158830;53344;4103;9203;139378;186;474343;2719;3597;140456;9248;402415;203430;9185;90161;728042;4129;65267;56849;8228;8226;728036;7114;6399;4952;83740;84889;8481;6757;347468;347475;414;6759;9500;51132;8823;541578;2158;55609;2556;494119;6756;9502;158880;8517;8242;474383;57595;51442;389895;100132304;9754;80311;6102;27328;695;56159;51213;90737;60506;10943;100873985;57526;728269;170082;474382;102723680;728656;3358;8273;83844;114824;389840;170067;81557;80823;8862;2002;7216;79979;158763;23641;55217;8270;57477;7592;2833;425054;340526;727866;139599;139804;54470;8450;959;139562;645864;10075;117154;57631;2010;54521;79589;51634;3750;653282;728072;7076;392490;9363;8623;3920;347411;7454;100506164;265;90293;645051;100529097;55511;158724;6197;203547;139135;5355;347516;203522;139081;6451;27336;158787;728458;7499;4841;347517;51360;340578;139596;1896;441509;54466;660;158798;4108;171482;79868;728075;158833;79366;1821;56156;392465;1260;5160;56062;5303;3054;51260;139628;653220;340596;554;28986;23133;57393;2623;28227;4113;57692;50945;3730;7739;100131755;57481;8260;139170;64219;4204;389860;2574;3563;65991;10325;6170;10813;79710;8712;26280;2316;256714;10742;6173;9104;494197;29057;139324;442444;6103;54880;90736;55558;2742;1736;369;255313;3654;170627;645974;3897;79983;727940;541466;347527;8243;4007;139741;29978;2182;7504;60401;84707;53336;1485;159090;94056;57502;55285;653067;1046;11152;641339;1947;8852;7712;23708;203523;4267;54967;340542;89885;2277;83550;644353;55916;340595;6594;139189;63947;9643;9843;4935;139728;100288814;10479;50943;53940;55026;100507170;5638;4478;8239;4068;51114;139411;246100;9968;84679;115201;100533997;1741;416;64840;10682;11326;25763;27330;171483;8908;27286;1038;7543;158800;90060;1288;84061;215;6247;292;55879;401612;1183;340527;55344;29935;158983;357;10009;2747;2652;286514;340543;54885;100129407;10495;6792;79742;140886;2239;2334;4128;441518;139604;4303;55869;25878;4115;11040;8473;6855;84636;55922;728712;5956;2705;55841;54821;729396;441521;8933;10735;729442;9949;4694;84528;51481;492;3028;100129520;795;10389;83604;7411;9947;9367;100463488;10134;79057;54552;6906;340547;30014;415;5255;680;158809;6990;4435;5475;340529;65109;64860;7030;729428;8776;4675;5030;51566;729201;56271;4943;79917;85012;114928;5256;26609;54960;538;6853;5365;4354;286451;29934;10838;139221;9189;347404;6473;3251;286464;158931;139793;100008586;2717;3052;5973;139065;5199;546;5613;51270;139231;9131;7547;474381;257240;11254;27238;64102;2543;158747;2273;56474;5165;64648;54440;140597;5631;728239;3188;100130086;5251;8237;286527;100130302,815
1,1,X,60679,155251871,155191192,23096;64061;392509;10214;170685;23157;727837;55998;23439;729431;10916;158586;55859;331;3423;54830;4168;6901;5358;92002;27344;729447;54328;266740;9075;102723737;7552;729422;54954;84460;389874;56000;340562;644538;92552;254158;79649;56850;8225;2824;100272147;51186;3149;26576;100130361;1730;347541;139425;3547;728695;729408;79921;57826;59272;203413;2986;7512;9737;8544;55634;2857;3421;537;11013;340554;5716;6658;4101;54457;1438;91966;441519;4100;5931;27316;7403;4534;6839;51480;728096;27112;92129;101928917;140462;8241;6567;827;203569;27301;84548;645037;54413;100133053;7355;254065;79836;10084;347442;60343;51765;55593;139818;56180;6303;8269;142684;7626;10046;8409;203447;63932;2710;4515;8406;51248;56001;51616;2925;100130613;2564;1193;100132994;5354;11043;340533;22;3476;84631;26748;11238;203562;102723631;170261;58526;441525;4983;29944;6907;1536;2539;1478;9468;23597;2187;1287;81887;6611;3561;9767;9282;54857;347365;10800;139341;54539;11219;728062;169966;51209;23630;26548;1121;2000;645188;51438;2846;280658;1852;347344;23229;10857;56157;286430;101059915;438;5277;9758;1069;4674;154796;56548;51309;1184;645073;80712;1774;10245;2258;728343;9823;441531;11141;643311;90121;256643;23676;4114;6758;4107;286499;5009;1654;1831;51284;94121;170302;11230;79135;286410;9210;2491;441490;84187;633;6191;64743;4110;3598;389856;7789;55787;9452;50814;2157;139422;170062;57187;139067;4104;203427;4693;5456;10013;1964;55190;100996648;293;9016;100528062;30011;90316;93953;10178;6322;28952;24137;2332;4105;6845;94122;84968;64663;1538;9142;286530;2245;5634;9506;79576;3266;139212;5207;6535;8227;393;389852;170626;91851;27334;158866;550643;159013;407;7224;55796;10761;100132963;168400;4281;158835;24140;8471;90167;7737;7319;10149;11279;6134;64109;1678;139322;5063;55906;116442;84443;27197;8233;548313;6872;27018;100129239;139105;7102;10549;26071;2664;59353;8573;28985;79184;728049;728090;158521;3581;139886;282808;8263;9130;728082;778;90843;1756;5422;7317;5935;347454;29071;207063;4112;412;158506;340602;30848;5127;22866;93380;159091;10159;212;139285;9338;85417;8266;100132399;158584;494118;190;7569;89801;2892;1968;5230;57232;55559;57529;8277;63035;80231;286436;25975;51311;8905;55086;139735;395;83692;171484;10251;169981;1349;63904;139716;257397;142689;80258;27035;1641;55613;7105;100329135;84295;9459;4810;404281;4109;367;474384;6748;139760;347487;92745;158830;53344;4103;9203;139378;186;474343;2719;3597;140456;9248;402415;203430;9185;90161;728042;4129;65267;56849;8228;8226;728036;7114;6399;4952;83740;84889;8481;6757;347468;347475;414;6759;9500;51132;8823;541578;2158;55609;2556;494119;6756;9502;158880;8517;8242;474383;57595;51442;389895;100132304;9754;80311;6102;27328;695;56159;51213;90737;60506;10943;100873985;57526;728269;170082;474382;102723680;728656;3358;8273;83844;114824;389840;170067;81557;80823;8862;2002;7216;79979;158763;23641;55217;8270;57477;7592;2833;425054;340526;727866;139599;139804;54470;8450;959;139562;645864;10075;117154;57631;2010;54521;79589;51634;3750;653282;728072;7076;392490;9363;8623;3920;347411;7454;100506164;265;90293;645051;100529097;55511;158724;6197;203547;139135;5355;347516;203522;139081;6451;27336;158787;728458;7499;4841;347517;51360;340578;139596;1896;441509;54466;660;158798;4108;171482;79868;728075;158833;79366;1821;56156;392465;1260;5160;56062;5303;3054;51260;139628;653220;340596;554;28986;23133;57393;2623;28227;4113;57692;50945;3730;7739;100131755;57481;8260;139170;64219;4204;389860;2574;3563;65991;10325;6170;10813;79710;8712;26280;2316;256714;10742;6173;9104;494197;29057;139324;442444;6103;54880;90736;55558;2742;1736;369;255313;3654;170627;645974;3897;79983;727940;541466;347527;8243;4007;139741;29978;2182;7504;60401;84707;53336;1485;159090;94056;57502;55285;653067;1046;11152;641339;1947;8852;7712;23708;203523;4267;54967;340542;89885;2277;83550;644353;55916;340595;6594;139189;63947;9643;9843;4935;139728;100288814;10479;50943;53940;55026;100507170;5638;4478;8239;4068;51114;139411;246100;9968;84679;115201;100533997;1741;416;64840;10682;11326;25763;27330;171483;8908;27286;1038;7543;158800;90060;1288;84061;215;6247;292;55879;401612;1183;340527;55344;29935;158983;357;10009;2747;2652;286514;340543;54885;100129407;10495;6792;79742;140886;2239;2334;4128;441518;139604;4303;55869;25878;4115;11040;8473;6855;84636;55922;728712;5956;2705;55841;54821;729396;441521;8933;10735;729442;9949;4694;84528;51481;492;3028;100129520;795;10389;83604;7411;9947;9367;100463488;10134;79057;54552;6906;340547;30014;415;5255;680;158809;6990;4435;5475;340529;65109;64860;7030;729428;8776;4675;5030;51566;729201;56271;4943;79917;85012;114928;5256;26609;54960;538;6853;5365;4354;286451;29934;10838;139221;9189;347404;6473;3251;286464;158931;139793;100008586;2717;3052;5973;139065;5199;546;5613;51270;139231;9131;7547;474381;257240;11254;27238;64102;2543;158747;2273;56474;5165;64648;54440;140597;5631;728239;3188;100130086;5251;8237;286527;100130302,815
1,1,X,60679,155251871,155191192,23096;64061;392509;10214;170685;23157;727837;55998;23439;729431;10916;158586;55859;331;3423;54830;4168;6901;5358;92002;27344;729447;54328;266740;9075;102723737;7552;729422;54954;84460;389874;56000;340562;644538;92552;254158;79649;56850;8225;2824;100272147;51186;3149;26576;100130361;1730;347541;139425;3547;728695;729408;79921;57826;59272;203413;2986;7512;9737;8544;55634;2857;3421;537;11013;340554;5716;6658;4101;54457;1438;91966;441519;4100;5931;27316;7403;4534;6839;51480;728096;27112;92129;101928917;140462;8241;6567;827;203569;27301;84548;645037;54413;100133053;7355;254065;79836;10084;347442;60343;51765;55593;139818;56180;6303;8269;142684;7626;10046;8409;203447;63932;2710;4515;8406;51248;56001;51616;2925;100130613;2564;1193;100132994;5354;11043;340533;22;3476;84631;26748;11238;203562;102723631;170261;58526;441525;4983;29944;6907;1536;2539;1478;9468;23597;2187;1287;81887;6611;3561;9767;9282;54857;347365;10800;139341;54539;11219;728062;169966;51209;23630;26548;1121;2000;645188;51438;2846;280658;1852;347344;23229;10857;56157;286430;101059915;438;5277;9758;1069;4674;154796;56548;51309;1184;645073;80712;1774;10245;2258;728343;9823;441531;11141;643311;90121;256643;23676;4114;6758;4107;286499;5009;1654;1831;51284;94121;170302;11230;79135;286410;9210;2491;441490;84187;633;6191;64743;4110;3598;389856;7789;55787;9452;50814;2157;139422;170062;57187;139067;4104;203427;4693;5456;10013;1964;55190;100996648;293;9016;100528062;30011;90316;93953;10178;6322;28952;24137;2332;4105;6845;94122;84968;64663;1538;9142;286530;2245;5634;9506;79576;3266;139212;5207;6535;8227;393;389852;170626;91851;27334;158866;550643;159013;407;7224;55796;10761;100132963;168400;4281;158835;24140;8471;90167;7737;7319;10149;11279;6134;64109;1678;139322;5063;55906;116442;84443;27197;8233;548313;6872;27018;100129239;139105;7102;10549;26071;2664;59353;8573;28985;79184;728049;728090;158521;3581;139886;282808;8263;9130;728082;778;90843;1756;5422;7317;5935;347454;29071;207063;4112;412;158506;340602;30848;5127;22866;93380;159091;10159;212;139285;9338;85417;8266;100132399;158584;494118;190;7569;89801;2892;1968;5230;57232;55559;57529;8277;63035;80231;286436;25975;51311;8905;55086;139735;395;83692;171484;10251;169981;1349;63904;139716;257397;142689;80258;27035;1641;55613;7105;100329135;84295;9459;4810;404281;4109;367;474384;6748;139760;347487;92745;158830;53344;4103;9203;139378;186;474343;2719;3597;140456;9248;402415;203430;9185;90161;728042;4129;65267;56849;8228;8226;728036;7114;6399;4952;83740;84889;8481;6757;347468;347475;414;6759;9500;51132;8823;541578;2158;55609;2556;494119;6756;9502;158880;8517;8242;474383;57595;51442;389895;100132304;9754;80311;6102;27328;695;56159;51213;90737;60506;10943;100873985;57526;728269;170082;474382;102723680;728656;3358;8273;83844;114824;389840;170067;81557;80823;8862;2002;7216;79979;158763;23641;55217;8270;57477;7592;2833;425054;340526;727866;139599;139804;54470;8450;959;139562;645864;10075;117154;57631;2010;54521;79589;51634;3750;653282;728072;7076;392490;9363;8623;3920;347411;7454;100506164;265;90293;645051;100529097;55511;158724;6197;203547;139135;5355;347516;203522;139081;6451;27336;158787;728458;7499;4841;347517;51360;340578;139596;1896;441509;54466;660;158798;4108;171482;79868;728075;158833;79366;1821;56156;392465;1260;5160;56062;5303;3054;51260;139628;653220;340596;554;28986;23133;57393;2623;28227;4113;57692;50945;3730;7739;100131755;57481;8260;139170;64219;4204;389860;2574;3563;65991;10325;6170;10813;79710;8712;26280;2316;256714;10742;6173;9104;494197;29057;139324;442444;6103;54880;90736;55558;2742;1736;369;255313;3654;170627;645974;3897;79983;727940;541466;347527;8243;4007;139741;29978;2182;7504;60401;84707;53336;1485;159090;94056;57502;55285;653067;1046;11152;641339;1947;8852;7712;23708;203523;4267;54967;340542;89885;2277;83550;644353;55916;340595;6594;139189;63947;9643;9843;4935;139728;100288814;10479;50943;53940;55026;100507170;5638;4478;8239;4068;51114;139411;246100;9968;84679;115201;100533997;1741;416;64840;10682;11326;25763;27330;171483;8908;27286;1038;7543;158800;90060;1288;84061;215;6247;292;55879;401612;1183;340527;55344;29935;158983;357;10009;2747;2652;286514;340543;54885;100129407;10495;6792;79742;140886;2239;2334;4128;441518;139604;4303;55869;25878;4115;11040;8473;6855;84636;55922;728712;5956;2705;55841;54821;729396;441521;8933;10735;729442;9949;4694;84528;51481;492;3028;100129520;795;10389;83604;7411;9947;9367;100463488;10134;79057;54552;6906;340547;30014;415;5255;680;158809;6990;4435;5475;340529;65109;64860;7030;729428;8776;4675;5030;51566;729201;56271;4943;79917;85012;114928;5256;26609;54960;538;6853;5365;4354;286451;29934;10838;139221;9189;347404;6473;3251;286464;158931;139793;100008586;2717;3052;5973;139065;5199;546;5613;51270;139231;9131;7547;474381;257240;11254;27238;64102;2543;158747;2273;56474;5165;64648;54440;140597;5631;728239;3188;100130086;5251;8237;286527;100130302,815
1,1,X,60679,155251871,155191192,23096;64061;392509;10214;170685;23157;727837;55998;23439;729431;10916;158586;55859;331;3423;54830;4168;6901;5358;92002;27344;729447;54328;266740;9075;102723737;7552;729422;54954;84460;389874;56000;340562;644538;92552;254158;79649;56850;8225;2824;100272147;51186;3149;26576;100130361;1730;347541;139425;3547;728695;729408;79921;57826;59272;203413;2986;7512;9737;8544;55634;2857;3421;537;11013;340554;5716;6658;4101;54457;1438;91966;441519;4100;5931;27316;7403;4534;6839;51480;728096;27112;92129;101928917;140462;8241;6567;827;203569;27301;84548;645037;54413;100133053;7355;254065;79836;10084;347442;60343;51765;55593;139818;56180;6303;8269;142684;7626;10046;8409;203447;63932;2710;4515;8406;51248;56001;51616;2925;100130613;2564;1193;100132994;5354;11043;340533;22;3476;84631;26748;11238;203562;102723631;170261;58526;441525;4983;29944;6907;1536;2539;1478;9468;23597;2187;1287;81887;6611;3561;9767;9282;54857;347365;10800;139341;54539;11219;728062;169966;51209;23630;26548;1121;2000;645188;51438;2846;280658;1852;347344;23229;10857;56157;286430;101059915;438;5277;9758;1069;4674;154796;56548;51309;1184;645073;80712;1774;10245;2258;728343;9823;441531;11141;643311;90121;256643;23676;4114;6758;4107;286499;5009;1654;1831;51284;94121;170302;11230;79135;286410;9210;2491;441490;84187;633;6191;64743;4110;3598;389856;7789;55787;9452;50814;2157;139422;170062;57187;139067;4104;203427;4693;5456;10013;1964;55190;100996648;293;9016;100528062;30011;90316;93953;10178;6322;28952;24137;2332;4105;6845;94122;84968;64663;1538;9142;286530;2245;5634;9506;79576;3266;139212;5207;6535;8227;393;389852;170626;91851;27334;158866;550643;159013;407;7224;55796;10761;100132963;168400;4281;158835;24140;8471;90167;7737;7319;10149;11279;6134;64109;1678;139322;5063;55906;116442;84443;27197;8233;548313;6872;27018;100129239;139105;7102;10549;26071;2664;59353;8573;28985;79184;728049;728090;158521;3581;139886;282808;8263;9130;728082;778;90843;1756;5422;7317;5935;347454;29071;207063;4112;412;158506;340602;30848;5127;22866;93380;159091;10159;212;139285;9338;85417;8266;100132399;158584;494118;190;7569;89801;2892;1968;5230;57232;55559;57529;8277;63035;80231;286436;25975;51311;8905;55086;139735;395;83692;171484;10251;169981;1349;63904;139716;257397;142689;80258;27035;1641;55613;7105;100329135;84295;9459;4810;404281;4109;367;474384;6748;139760;347487;92745;158830;53344;4103;9203;139378;186;474343;2719;3597;140456;9248;402415;203430;9185;90161;728042;4129;65267;56849;8228;8226;728036;7114;6399;4952;83740;84889;8481;6757;347468;347475;414;6759;9500;51132;8823;541578;2158;55609;2556;494119;6756;9502;158880;8517;8242;474383;57595;51442;389895;100132304;9754;80311;6102;27328;695;56159;51213;90737;60506;10943;100873985;57526;728269;170082;474382;102723680;728656;3358;8273;83844;114824;389840;170067;81557;80823;8862;2002;7216;79979;158763;23641;55217;8270;57477;7592;2833;425054;340526;727866;139599;139804;54470;8450;959;139562;645864;10075;117154;57631;2010;54521;79589;51634;3750;653282;728072;7076;392490;9363;8623;3920;347411;7454;100506164;265;90293;645051;100529097;55511;158724;6197;203547;139135;5355;347516;203522;139081;6451;27336;158787;728458;7499;4841;347517;51360;340578;139596;1896;441509;54466;660;158798;4108;171482;79868;728075;158833;79366;1821;56156;392465;1260;5160;56062;5303;3054;51260;139628;653220;340596;554;28986;23133;57393;2623;28227;4113;57692;50945;3730;7739;100131755;57481;8260;139170;64219;4204;389860;2574;3563;65991;10325;6170;10813;79710;8712;26280;2316;256714;10742;6173;9104;494197;29057;139324;442444;6103;54880;90736;55558;2742;1736;369;255313;3654;170627;645974;3897;79983;727940;541466;347527;8243;4007;139741;29978;2182;7504;60401;84707;53336;1485;159090;94056;57502;55285;653067;1046;11152;641339;1947;8852;7712;23708;203523;4267;54967;340542;89885;2277;83550;644353;55916;340595;6594;139189;63947;9643;9843;4935;139728;100288814;10479;50943;53940;55026;100507170;5638;4478;8239;4068;51114;139411;246100;9968;84679;115201;100533997;1741;416;64840;10682;11326;25763;27330;171483;8908;27286;1038;7543;158800;90060;1288;84061;215;6247;292;55879;401612;1183;340527;55344;29935;158983;357;10009;2747;2652;286514;340543;54885;100129407;10495;6792;79742;140886;2239;2334;4128;441518;139604;4303;55869;25878;4115;11040;8473;6855;84636;55922;728712;5956;2705;55841;54821;729396;441521;8933;10735;729442;9949;4694;84528;51481;492;3028;100129520;795;10389;83604;7411;9947;9367;100463488;10134;79057;54552;6906;340547;30014;415;5255;680;158809;6990;4435;5475;340529;65109;64860;7030;729428;8776;4675;5030;51566;729201;56271;4943;79917;85012;114928;5256;26609;54960;538;6853;5365;4354;286451;29934;10838;139221;9189;347404;6473;3251;286464;158931;139793;100008586;2717;3052;5973;139065;5199;546;5613;51270;139231;9131;7547;474381;257240;11254;27238;64102;2543;158747;2273;56474;5165;64648;54440;140597;5631;728239;3188;100130086;5251;8237;286527;100130302,815
-1,1,X,60679,155251871,155191192,23096;64061;392509;10214;170685;23157;727837;55998;23439;729431;10916;158586;55859;331;3423;54830;4168;6901;5358;92002;27344;729447;54328;266740;9075;102723737;7552;729422;54954;84460;389874;56000;340562;644538;92552;254158;79649;56850;8225;2824;100272147;51186;3149;26576;100130361;1730;347541;139425;3547;728695;729408;79921;57826;59272;203413;2986;7512;9737;8544;55634;2857;3421;537;11013;340554;5716;6658;4101;54457;1438;91966;441519;4100;5931;27316;7403;4534;6839;51480;728096;27112;92129;101928917;140462;8241;6567;827;203569;27301;84548;645037;54413;100133053;7355;254065;79836;10084;347442;60343;51765;55593;139818;56180;6303;8269;142684;7626;10046;8409;203447;63932;2710;4515;8406;51248;56001;51616;2925;100130613;2564;1193;100132994;5354;11043;340533;22;3476;84631;26748;11238;203562;102723631;170261;58526;441525;4983;29944;6907;1536;2539;1478;9468;23597;2187;1287;81887;6611;3561;9767;9282;54857;347365;10800;139341;54539;11219;728062;169966;51209;23630;26548;1121;2000;645188;51438;2846;280658;1852;347344;23229;10857;56157;286430;101059915;438;5277;9758;1069;4674;154796;56548;51309;1184;645073;80712;1774;10245;2258;728343;9823;441531;11141;643311;90121;256643;23676;4114;6758;4107;286499;5009;1654;1831;51284;94121;170302;11230;79135;286410;9210;2491;441490;84187;633;6191;64743;4110;3598;389856;7789;55787;9452;50814;2157;139422;170062;57187;139067;4104;203427;4693;5456;10013;1964;55190;100996648;293;9016;100528062;30011;90316;93953;10178;6322;28952;24137;2332;4105;6845;94122;84968;64663;1538;9142;286530;2245;5634;9506;79576;3266;139212;5207;6535;8227;393;389852;170626;91851;27334;158866;550643;159013;407;7224;55796;10761;100132963;168400;4281;158835;24140;8471;90167;7737;7319;10149;11279;6134;64109;1678;139322;5063;55906;116442;84443;27197;8233;548313;6872;27018;100129239;139105;7102;10549;26071;2664;59353;8573;28985;79184;728049;728090;158521;3581;139886;282808;8263;9130;728082;778;90843;1756;5422;7317;5935;347454;29071;207063;4112;412;158506;340602;30848;5127;22866;93380;159091;10159;212;139285;9338;85417;8266;100132399;158584;494118;190;7569;89801;2892;1968;5230;57232;55559;57529;8277;63035;80231;286436;25975;51311;8905;55086;139735;395;83692;171484;10251;169981;1349;63904;139716;257397;142689;80258;27035;1641;55613;7105;100329135;84295;9459;4810;404281;4109;367;474384;6748;139760;347487;92745;158830;53344;4103;9203;139378;186;474343;2719;3597;140456;9248;402415;203430;9185;90161;728042;4129;65267;56849;8228;8226;728036;7114;6399;4952;83740;84889;8481;6757;347468;347475;414;6759;9500;51132;8823;541578;2158;55609;2556;494119;6756;9502;158880;8517;8242;474383;57595;51442;389895;100132304;9754;80311;6102;27328;695;56159;51213;90737;60506;10943;100873985;57526;728269;170082;474382;102723680;728656;3358;8273;83844;114824;389840;170067;81557;80823;8862;2002;7216;79979;158763;23641;55217;8270;57477;7592;2833;425054;340526;727866;139599;139804;54470;8450;959;139562;645864;10075;117154;57631;2010;54521;79589;51634;3750;653282;728072;7076;392490;9363;8623;3920;347411;7454;100506164;265;90293;645051;100529097;55511;158724;6197;203547;139135;5355;347516;203522;139081;6451;27336;158787;728458;7499;4841;347517;51360;340578;139596;1896;441509;54466;660;158798;4108;171482;79868;728075;158833;79366;1821;56156;392465;1260;5160;56062;5303;3054;51260;139628;653220;340596;554;28986;23133;57393;2623;28227;4113;57692;50945;3730;7739;100131755;57481;8260;139170;64219;4204;389860;2574;3563;65991;10325;6170;10813;79710;8712;26280;2316;256714;10742;6173;9104;494197;29057;139324;442444;6103;54880;90736;55558;2742;1736;369;255313;3654;170627;645974;3897;79983;727940;541466;347527;8243;4007;139741;29978;2182;7504;60401;84707;53336;1485;159090;94056;57502;55285;653067;1046;11152;641339;1947;8852;7712;23708;203523;4267;54967;340542;89885;2277;83550;644353;55916;340595;6594;139189;63947;9643;9843;4935;139728;100288814;10479;50943;53940;55026;100507170;5638;4478;8239;4068;51114;139411;246100;9968;84679;115201;100533997;1741;416;64840;10682;11326;25763;27330;171483;8908;27286;1038;7543;158800;90060;1288;84061;215;6247;292;55879;401612;1183;340527;55344;29935;158983;357;10009;2747;2652;286514;340543;54885;100129407;10495;6792;79742;140886;2239;2334;4128;441518;139604;4303;55869;25878;4115;11040;8473;6855;84636;55922;728712;5956;2705;55841;54821;729396;441521;8933;10735;729442;9949;4694;84528;51481;492;3028;100129520;795;10389;83604;7411;9947;9367;100463488;10134;79057;54552;6906;340547;30014;415;5255;680;158809;6990;4435;5475;340529;65109;64860;7030;729428;8776;4675;5030;51566;729201;56271;4943;79917;85012;114928;5256;26609;54960;538;6853;5365;4354;286451;29934;10838;139221;9189;347404;6473;3251;286464;158931;139793;100008586;2717;3052;5973;139065;5199;546;5613;51270;139231;9131;7547;474381;257240;11254;27238;64102;2543;158747;2273;56474;5165;64648;54440;140597;5631;728239;3188;100130086;5251;8237;286527;100130302,815
1,1,X,60679,155251871,155191192,23096;64061;392509;10214;170685;23157;727837;55998;23439;729431;10916;158586;55859;331;3423;54830;4168;6901;5358;92002;27344;729447;54328;266740;9075;102723737;7552;729422;54954;84460;389874;56000;340562;644538;92552;254158;79649;56850;8225;2824;100272147;51186;3149;26576;100130361;1730;347541;139425;3547;728695;729408;79921;57826;59272;203413;2986;7512;9737;8544;55634;2857;3421;537;11013;340554;5716;6658;4101;54457;1438;91966;441519;4100;5931;27316;7403;4534;6839;51480;728096;27112;92129;101928917;140462;8241;6567;827;203569;27301;84548;645037;54413;100133053;7355;254065;79836;10084;347442;60343;51765;55593;139818;56180;6303;8269;142684;7626;10046;8409;203447;63932;2710;4515;8406;51248;56001;51616;2925;100130613;2564;1193;100132994;5354;11043;340533;22;3476;84631;26748;11238;203562;102723631;170261;58526;441525;4983;29944;6907;1536;2539;1478;9468;23597;2187;1287;81887;6611;3561;9767;9282;54857;347365;10800;139341;54539;11219;728062;169966;51209;23630;26548;1121;2000;645188;51438;2846;280658;1852;347344;23229;10857;56157;286430;101059915;438;5277;9758;1069;4674;154796;56548;51309;1184;645073;80712;1774;10245;2258;728343;9823;441531;11141;643311;90121;256643;23676;4114;6758;4107;286499;5009;1654;1831;51284;94121;170302;11230;79135;286410;9210;2491;441490;84187;633;6191;64743;4110;3598;389856;7789;55787;9452;50814;2157;139422;170062;57187;139067;4104;203427;4693;5456;10013;1964;55190;100996648;293;9016;100528062;30011;90316;93953;10178;6322;28952;24137;2332;4105;6845;94122;84968;64663;1538;9142;286530;2245;5634;9506;79576;3266;139212;5207;6535;8227;393;389852;170626;91851;27334;158866;550643;159013;407;7224;55796;10761;100132963;168400;4281;158835;24140;8471;90167;7737;7319;10149;11279;6134;64109;1678;139322;5063;55906;116442;84443;27197;8233;548313;6872;27018;100129239;139105;7102;10549;26071;2664;59353;8573;28985;79184;728049;728090;158521;3581;139886;282808;8263;9130;728082;778;90843;1756;5422;7317;5935;347454;29071;207063;4112;412;158506;340602;30848;5127;22866;93380;159091;10159;212;139285;9338;85417;8266;100132399;158584;494118;190;7569;89801;2892;1968;5230;57232;55559;57529;8277;63035;80231;286436;25975;51311;8905;55086;139735;395;83692;171484;10251;169981;1349;63904;139716;257397;142689;80258;27035;1641;55613;7105;100329135;84295;9459;4810;404281;4109;367;474384;6748;139760;347487;92745;158830;53344;4103;9203;139378;186;474343;2719;3597;140456;9248;402415;203430;9185;90161;728042;4129;65267;56849;8228;8226;728036;7114;6399;4952;83740;84889;8481;6757;347468;347475;414;6759;9500;51132;8823;541578;2158;55609;2556;494119;6756;9502;158880;8517;8242;474383;57595;51442;389895;100132304;9754;80311;6102;27328;695;56159;51213;90737;60506;10943;100873985;57526;728269;170082;474382;102723680;728656;3358;8273;83844;114824;389840;170067;81557;80823;8862;2002;7216;79979;158763;23641;55217;8270;57477;7592;2833;425054;340526;727866;139599;139804;54470;8450;959;139562;645864;10075;117154;57631;2010;54521;79589;51634;3750;653282;728072;7076;392490;9363;8623;3920;347411;7454;100506164;265;90293;645051;100529097;55511;158724;6197;203547;139135;5355;347516;203522;139081;6451;27336;158787;728458;7499;4841;347517;51360;340578;139596;1896;441509;54466;660;158798;4108;171482;79868;728075;158833;79366;1821;56156;392465;1260;5160;56062;5303;3054;51260;139628;653220;340596;554;28986;23133;57393;2623;28227;4113;57692;50945;3730;7739;100131755;57481;8260;139170;64219;4204;389860;2574;3563;65991;10325;6170;10813;79710;8712;26280;2316;256714;10742;6173;9104;494197;29057;139324;442444;6103;54880;90736;55558;2742;1736;369;255313;3654;170627;645974;3897;79983;727940;541466;347527;8243;4007;139741;29978;2182;7504;60401;84707;53336;1485;159090;94056;57502;55285;653067;1046;11152;641339;1947;8852;7712;23708;203523;4267;54967;340542;89885;2277;83550;644353;55916;340595;6594;139189;63947;9643;9843;4935;139728;100288814;10479;50943;53940;55026;100507170;5638;4478;8239;4068;51114;139411;246100;9968;84679;115201;100533997;1741;416;64840;10682;11326;25763;27330;171483;8908;27286;1038;7543;158800;90060;1288;84061;215;6247;292;55879;401612;1183;340527;55344;29935;158983;357;10009;2747;2652;286514;340543;54885;100129407;10495;6792;79742;140886;2239;2334;4128;441518;139604;4303;55869;25878;4115;11040;8473;6855;84636;55922;728712;5956;2705;55841;54821;729396;441521;8933;10735;729442;9949;4694;84528;51481;492;3028;100129520;795;10389;83604;7411;9947;9367;100463488;10134;79057;54552;6906;340547;30014;415;5255;680;158809;6990;4435;5475;340529;65109;64860;7030;729428;8776;4675;5030;51566;729201;56271;4943;79917;85012;114928;5256;26609;54960;538;6853;5365;4354;286451;29934;10838;139221;9189;347404;6473;3251;286464;158931;139793;100008586;2717;3052;5973;139065;5199;546;5613;51270;139231;9131;7547;474381;257240;11254;27238;64102;2543;158747;2273;56474;5165;64648;54440;140597;5631;728239;3188;100130086;5251;8237;286527;100130302,815
1,1,X,60679,155251871,155191192,23096;64061;392509;10214;170685;23157;727837;55998;23439;729431;10916;158586;55859;331;3423;54830;4168;6901;5358;92002;27344;729447;54328;266740;9075;102723737;7552;729422;54954;84460;389874;56000;340562;644538;92552;254158;79649;56850;8225;2824;100272147;51186;3149;26576;100130361;1730;347541;139425;3547;728695;729408;79921;57826;59272;203413;2986;7512;9737;8544;55634;2857;3421;537;11013;340554;5716;6658;4101;54457;1438;91966;441519;4100;5931;27316;7403;4534;6839;51480;728096;27112;92129;101928917;140462;8241;6567;827;203569;27301;84548;645037;54413;100133053;7355;254065;79836;10084;347442;60343;51765;55593;139818;56180;6303;8269;142684;7626;10046;8409;203447;63932;2710;4515;8406;51248;56001;51616;2925;100130613;2564;1193;100132994;5354;11043;340533;22;3476;84631;26748;11238;203562;102723631;170261;58526;441525;4983;29944;6907;1536;2539;1478;9468;23597;2187;1287;81887;6611;3561;9767;9282;54857;347365;10800;139341;54539;11219;728062;169966;51209;23630;26548;1121;2000;645188;51438;2846;280658;1852;347344;23229;10857;56157;286430;101059915;438;5277;9758;1069;4674;154796;56548;51309;1184;645073;80712;1774;10245;2258;728343;9823;441531;11141;643311;90121;256643;23676;4114;6758;4107;286499;5009;1654;1831;51284;94121;170302;11230;79135;286410;9210;2491;441490;84187;633;6191;64743;4110;3598;389856;7789;55787;9452;50814;2157;139422;170062;57187;139067;4104;203427;4693;5456;10013;1964;55190;100996648;293;9016;100528062;30011;90316;93953;10178;6322;28952;24137;2332;4105;6845;94122;84968;64663;1538;9142;286530;2245;5634;9506;79576;3266;139212;5207;6535;8227;393;389852;170626;91851;27334;158866;550643;159013;407;7224;55796;10761;100132963;168400;4281;158835;24140;8471;90167;7737;7319;10149;11279;6134;64109;1678;139322;5063;55906;116442;84443;27197;8233;548313;6872;27018;100129239;139105;7102;10549;26071;2664;59353;8573;28985;79184;728049;728090;158521;3581;139886;282808;8263;9130;728082;778;90843;1756;5422;7317;5935;347454;29071;207063;4112;412;158506;340602;30848;5127;22866;93380;159091;10159;212;139285;9338;85417;8266;100132399;158584;494118;190;7569;89801;2892;1968;5230;57232;55559;57529;8277;63035;80231;286436;25975;51311;8905;55086;139735;395;83692;171484;10251;169981;1349;63904;139716;257397;142689;80258;27035;1641;55613;7105;100329135;84295;9459;4810;404281;4109;367;474384;6748;139760;347487;92745;158830;53344;4103;9203;139378;186;474343;2719;3597;140456;9248;402415;203430;9185;90161;728042;4129;65267;56849;8228;8226;728036;7114;6399;4952;83740;84889;8481;6757;347468;347475;414;6759;9500;51132;8823;541578;2158;55609;2556;494119;6756;9502;158880;8517;8242;474383;57595;51442;389895;100132304;9754;80311;6102;27328;695;56159;51213;90737;60506;10943;100873985;57526;728269;170082;474382;102723680;728656;3358;8273;83844;114824;389840;170067;81557;80823;8862;2002;7216;79979;158763;23641;55217;8270;57477;7592;2833;425054;340526;727866;139599;139804;54470;8450;959;139562;645864;10075;117154;57631;2010;54521;79589;51634;3750;653282;728072;7076;392490;9363;8623;3920;347411;7454;100506164;265;90293;645051;100529097;55511;158724;6197;203547;139135;5355;347516;203522;139081;6451;27336;158787;728458;7499;4841;347517;51360;340578;139596;1896;441509;54466;660;158798;4108;171482;79868;728075;158833;79366;1821;56156;392465;1260;5160;56062;5303;3054;51260;139628;653220;340596;554;28986;23133;57393;2623;28227;4113;57692;50945;3730;7739;100131755;57481;8260;139170;64219;4204;389860;2574;3563;65991;10325;6170;10813;79710;8712;26280;2316;256714;10742;6173;9104;494197;29057;139324;442444;6103;54880;90736;55558;2742;1736;369;255313;3654;170627;645974;3897;79983;727940;541466;347527;8243;4007;139741;29978;2182;7504;60401;84707;53336;1485;159090;94056;57502;55285;653067;1046;11152;641339;1947;8852;7712;23708;203523;4267;54967;340542;89885;2277;83550;644353;55916;340595;6594;139189;63947;9643;9843;4935;139728;100288814;10479;50943;53940;55026;100507170;5638;4478;8239;4068;51114;139411;246100;9968;84679;115201;100533997;1741;416;64840;10682;11326;25763;27330;171483;8908;27286;1038;7543;158800;90060;1288;84061;215;6247;292;55879;401612;1183;340527;55344;29935;158983;357;10009;2747;2652;286514;340543;54885;100129407;10495;6792;79742;140886;2239;2334;4128;441518;139604;4303;55869;25878;4115;11040;8473;6855;84636;55922;728712;5956;2705;55841;54821;729396;441521;8933;10735;729442;9949;4694;84528;51481;492;3028;100129520;795;10389;83604;7411;9947;9367;100463488;10134;79057;54552;6906;340547;30014;415;5255;680;158809;6990;4435;5475;340529;65109;64860;7030;729428;8776;4675;5030;51566;729201;56271;4943;79917;85012;114928;5256;26609;54960;538;6853;5365;4354;286451;29934;10838;139221;9189;347404;6473;3251;286464;158931;139793;100008586;2717;3052;5973;139065;5199;546;5613;51270;139231;9131;7547;474381;257240;11254;27238;64102;2543;158747;2273;56474;5165;64648;54440;140597;5631;728239;3188;100130086;5251;8237;286527;100130302,815
1,1,X,60679,155252491,155191812,23096;64061;392509;10214;170685;23157;727837;55998;23439;729431;10916;158586;55859;331;3423;54830;4168;6901;5358;92002;27344;729447;54328;266740;9075;102723737;7552;729422;54954;84460;389874;56000;340562;644538;92552;254158;79649;56850;8225;2824;100272147;51186;3149;26576;100130361;1730;347541;139425;3547;728695;729408;79921;57826;59272;203413;2986;7512;9737;8544;55634;2857;3421;537;11013;340554;5716;6658;4101;54457;1438;91966;441519;4100;5931;27316;7403;4534;6839;51480;728096;27112;92129;101928917;140462;8241;6567;827;203569;27301;84548;645037;54413;100133053;7355;254065;79836;10084;347442;60343;51765;55593;139818;56180;6303;8269;142684;7626;10046;8409;203447;63932;2710;4515;8406;51248;56001;51616;2925;100130613;2564;1193;100132994;5354;11043;340533;22;3476;84631;26748;11238;203562;102723631;170261;58526;441525;4983;29944;6907;1536;2539;1478;9468;23597;2187;1287;81887;6611;3561;9767;9282;54857;347365;10800;139341;54539;11219;728062;169966;51209;23630;26548;1121;2000;645188;51438;2846;280658;1852;347344;23229;10857;56157;286430;101059915;438;5277;9758;1069;4674;154796;56548;51309;1184;645073;80712;1774;10245;2258;728343;9823;441531;11141;643311;90121;256643;23676;4114;6758;4107;286499;5009;1654;1831;51284;94121;170302;11230;79135;286410;9210;2491;441490;84187;633;6191;64743;4110;3598;389856;7789;55787;9452;50814;2157;139422;170062;57187;139067;4104;203427;4693;5456;10013;1964;55190;100996648;293;9016;100528062;30011;90316;93953;10178;6322;28952;24137;2332;4105;6845;94122;84968;64663;1538;9142;286530;2245;5634;9506;79576;3266;139212;5207;6535;8227;393;389852;170626;91851;27334;158866;550643;159013;407;7224;55796;10761;100132963;168400;4281;158835;24140;8471;90167;7737;7319;10149;11279;6134;64109;1678;139322;5063;55906;116442;84443;27197;8233;548313;6872;27018;100129239;139105;7102;10549;26071;2664;59353;8573;28985;79184;728049;728090;158521;3581;139886;282808;8263;9130;728082;778;90843;1756;5422;7317;5935;347454;29071;207063;4112;412;158506;340602;30848;5127;22866;93380;159091;10159;212;139285;9338;85417;8266;100132399;158584;494118;190;7569;89801;2892;1968;5230;57232;55559;57529;8277;63035;80231;286436;25975;51311;8905;55086;139735;395;83692;171484;10251;169981;1349;63904;139716;257397;142689;80258;27035;1641;55613;7105;100329135;84295;9459;4810;404281;4109;367;474384;6748;139760;347487;92745;158830;53344;4103;9203;139378;186;474343;2719;3597;140456;9248;402415;203430;9185;90161;728042;4129;65267;56849;8228;8226;728036;7114;6399;4952;83740;84889;8481;6757;347468;347475;414;6759;9500;51132;8823;541578;2158;55609;2556;494119;6756;9502;158880;8517;8242;474383;57595;51442;389895;100132304;9754;80311;6102;27328;695;56159;51213;90737;60506;10943;100873985;57526;728269;170082;474382;102723680;728656;3358;8273;83844;114824;389840;170067;81557;80823;8862;2002;7216;79979;158763;23641;55217;8270;57477;7592;2833;425054;340526;727866;139599;139804;54470;8450;959;139562;645864;10075;117154;57631;2010;54521;79589;51634;3750;653282;728072;7076;392490;9363;8623;3920;347411;7454;100506164;265;90293;645051;100529097;55511;158724;6197;203547;139135;5355;347516;203522;139081;6451;27336;158787;728458;7499;4841;347517;51360;340578;139596;1896;441509;54466;660;158798;4108;171482;79868;728075;158833;79366;1821;56156;392465;1260;5160;56062;5303;3054;51260;139628;653220;340596;554;28986;23133;57393;2623;28227;4113;57692;50945;3730;7739;100131755;57481;8260;139170;64219;4204;389860;2574;3563;65991;10325;6170;10813;79710;8712;26280;2316;256714;10742;6173;9104;494197;29057;139324;442444;6103;54880;90736;55558;2742;1736;369;255313;3654;170627;645974;3897;79983;727940;541466;347527;8243;4007;139741;29978;2182;7504;60401;84707;53336;1485;159090;94056;57502;55285;653067;1046;11152;641339;1947;8852;7712;23708;203523;4267;54967;340542;89885;2277;83550;644353;55916;340595;6594;139189;63947;9643;9843;4935;139728;100288814;10479;50943;53940;55026;100507170;5638;4478;8239;4068;51114;139411;246100;9968;84679;115201;100533997;1741;416;64840;10682;11326;25763;27330;171483;8908;27286;1038;7543;158800;90060;1288;84061;215;6247;292;55879;401612;1183;340527;55344;29935;158983;357;10009;2747;2652;286514;340543;54885;100129407;10495;6792;79742;140886;2239;2334;4128;441518;139604;4303;55869;25878;4115;11040;8473;6855;84636;55922;728712;5956;2705;55841;54821;729396;441521;8933;10735;729442;9949;4694;84528;51481;492;3028;100129520;795;10389;83604;7411;9947;9367;100463488;10134;79057;54552;6906;340547;30014;415;5255;680;158809;6990;4435;5475;340529;65109;64860;7030;729428;8776;4675;5030;51566;729201;56271;4943;79917;85012;114928;5256;26609;54960;538;6853;5365;4354;286451;29934;10838;139221;9189;347404;6473;3251;286464;158931;139793;100008586;2717;3052;5973;139065;5199;546;5613;51270;139231;9131;7547;474381;257240;11254;27238;64102;2543;158747;2273;56474;5165;64648;54440;140597;5631;728239;3188;100130086;5251;8237;286527;100130302,815
1,1,X,60679,155252491,155191812,23096;64061;392509;10214;170685;23157;727837;55998;23439;729431;10916;158586;55859;331;3423;54830;4168;6901;5358;92002;27344;729447;54328;266740;9075;102723737;7552;729422;54954;84460;389874;56000;340562;644538;92552;254158;79649;56850;8225;2824;100272147;51186;3149;26576;100130361;1730;347541;139425;3547;728695;729408;79921;57826;59272;203413;2986;7512;9737;8544;55634;2857;3421;537;11013;340554;5716;6658;4101;54457;1438;91966;441519;4100;5931;27316;7403;4534;6839;51480;728096;27112;92129;101928917;140462;8241;6567;827;203569;27301;84548;645037;54413;100133053;7355;254065;79836;10084;347442;60343;51765;55593;139818;56180;6303;8269;142684;7626;10046;8409;203447;63932;2710;4515;8406;51248;56001;51616;2925;100130613;2564;1193;100132994;5354;11043;340533;22;3476;84631;26748;11238;203562;102723631;170261;58526;441525;4983;29944;6907;1536;2539;1478;9468;23597;2187;1287;81887;6611;3561;9767;9282;54857;347365;10800;139341;54539;11219;728062;169966;51209;23630;26548;1121;2000;645188;51438;2846;280658;1852;347344;23229;10857;56157;286430;101059915;438;5277;9758;1069;4674;154796;56548;51309;1184;645073;80712;1774;10245;2258;728343;9823;441531;11141;643311;90121;256643;23676;4114;6758;4107;286499;5009;1654;1831;51284;94121;170302;11230;79135;286410;9210;2491;441490;84187;633;6191;64743;4110;3598;389856;7789;55787;9452;50814;2157;139422;170062;57187;139067;4104;203427;4693;5456;10013;1964;55190;100996648;293;9016;100528062;30011;90316;93953;10178;6322;28952;24137;2332;4105;6845;94122;84968;64663;1538;9142;286530;2245;5634;9506;79576;3266;139212;5207;6535;8227;393;389852;170626;91851;27334;158866;550643;159013;407;7224;55796;10761;100132963;168400;4281;158835;24140;8471;90167;7737;7319;10149;11279;6134;64109;1678;139322;5063;55906;116442;84443;27197;8233;548313;6872;27018;100129239;139105;7102;10549;26071;2664;59353;8573;28985;79184;728049;728090;158521;3581;139886;282808;8263;9130;728082;778;90843;1756;5422;7317;5935;347454;29071;207063;4112;412;158506;340602;30848;5127;22866;93380;159091;10159;212;139285;9338;85417;8266;100132399;158584;494118;190;7569;89801;2892;1968;5230;57232;55559;57529;8277;63035;80231;286436;25975;51311;8905;55086;139735;395;83692;171484;10251;169981;1349;63904;139716;257397;142689;80258;27035;1641;55613;7105;100329135;84295;9459;4810;404281;4109;367;474384;6748;139760;347487;92745;158830;53344;4103;9203;139378;186;474343;2719;3597;140456;9248;402415;203430;9185;90161;728042;4129;65267;56849;8228;8226;728036;7114;6399;4952;83740;84889;8481;6757;347468;347475;414;6759;9500;51132;8823;541578;2158;55609;2556;494119;6756;9502;158880;8517;8242;474383;57595;51442;389895;100132304;9754;80311;6102;27328;695;56159;51213;90737;60506;10943;100873985;57526;728269;170082;474382;102723680;728656;3358;8273;83844;114824;389840;170067;81557;80823;8862;2002;7216;79979;158763;23641;55217;8270;57477;7592;2833;425054;340526;727866;139599;139804;54470;8450;959;139562;645864;10075;117154;57631;2010;54521;79589;51634;3750;653282;728072;7076;392490;9363;8623;3920;347411;7454;100506164;265;90293;645051;100529097;55511;158724;6197;203547;139135;5355;347516;203522;139081;6451;27336;158787;728458;7499;4841;347517;51360;340578;139596;1896;441509;54466;660;158798;4108;171482;79868;728075;158833;79366;1821;56156;392465;1260;5160;56062;5303;3054;51260;139628;653220;340596;554;28986;23133;57393;2623;28227;4113;57692;50945;3730;7739;100131755;57481;8260;139170;64219;4204;389860;2574;3563;65991;10325;6170;10813;79710;8712;26280;2316;256714;10742;6173;9104;494197;29057;139324;442444;6103;54880;90736;55558;2742;1736;369;255313;3654;170627;645974;3897;79983;727940;541466;347527;8243;4007;139741;29978;2182;7504;60401;84707;53336;1485;159090;94056;57502;55285;653067;1046;11152;641339;1947;8852;7712;23708;203523;4267;54967;340542;89885;2277;83550;644353;55916;340595;6594;139189;63947;9643;9843;4935;139728;100288814;10479;50943;53940;55026;100507170;5638;4478;8239;4068;51114;139411;246100;9968;84679;115201;100533997;1741;416;64840;10682;11326;25763;27330;171483;8908;27286;1038;7543;158800;90060;1288;84061;215;6247;292;55879;401612;1183;340527;55344;29935;158983;357;10009;2747;2652;286514;340543;54885;100129407;10495;6792;79742;140886;2239;2334;4128;441518;139604;4303;55869;25878;4115;11040;8473;6855;84636;55922;728712;5956;2705;55841;54821;729396;441521;8933;10735;729442;9949;4694;84528;51481;492;3028;100129520;795;10389;83604;7411;9947;9367;100463488;10134;79057;54552;6906;340547;30014;415;5255;680;158809;6990;4435;5475;340529;65109;64860;7030;729428;8776;4675;5030;51566;729201;56271;4943;79917;85012;114928;5256;26609;54960;538;6853;5365;4354;286451;29934;10838;139221;9189;347404;6473;3251;286464;158931;139793;100008586;2717;3052;5973;139065;5199;546;5613;51270;139231;9131;7547;474381;257240;11254;27238;64102;2543;158747;2273;56474;5165;64648;54440;140597;5631;728239;3188;100130086;5251;8237;286527;100130302,815
1,1,X,60701,2854384,2793683,414;28227;286530;8225;1438;3563;415;207063;4267;293;7499;9189;438;64109;6473;8227;55344;8623;8908,19
1,1,X,60701,8097511,8036810,414;28227;51481;286530;57502;8226;8228;8225;1438;3563;26609;5613;25878;347527;415;416;207063;4267;293;412;7499;9189;438;64109;6473;8227;55344;8623;8908,29
-1,1,X,60701,8115153,8054452,414;28227;51481;286530;57502;8226;8228;8225;1438;3563;26609;5613;25878;347527;415;416;207063;4267;293;412;7499;9189;438;64109;6473;8227;55344;8623;8908,29
-1,1,X,60701,8392011,8331310,414;28227;51481;286530;57502;8226;8228;8225;1438;3563;26609;5613;25878;347527;415;416;207063;4267;293;412;7499;9189;438;64109;51480;6473;8227;55344;8623;8908,30
-1,1,X,60701,8434426,8373725,414;28227;51481;286530;57502;8226;8228;425054;8225;1438;3563;26609;5613;25878;347527;415;416;207063;4267;293;412;7499;9189;438;64109;51480;6473;8227;55344;8623;8908,31
-1,1,X,60701,8536442,8475741,414;51481;425054;1438;5613;347527;415;207063;293;412;438;64109;51480;55344;8623;28227;286530;57502;8226;8228;3730;8225;3563;26609;25878;416;4267;7499;9189;6473;8227;8908,32
-1,1,X,60701,8536442,8475741,414;51481;425054;1438;5613;347527;415;207063;293;412;438;64109;51480;55344;8623;28227;286530;57502;8226;8228;3730;8225;3563;26609;25878;416;4267;7499;9189;6473;8227;8908,32
1,1,X,60701,21884360,21823659,414;660;2925;51481;171482;55787;795;10389;5160;9367;4935;100288814;11238;1964;415;207063;293;412;30011;22866;5475;6322;57393;6907;28227;286530;3730;92552;8225;10943;5634;2824;2187;5256;3563;26609;54960;170082;416;25975;51311;8905;9189;395;6473;171484;8227;256714;59272;389840;10742;171483;8908;2742;8544;3052;4810;425054;404281;4281;1438;6247;5613;645864;5931;347527;10149;438;64109;51480;1183;140456;5277;9758;140462;55344;8623;257240;9185;357;8233;265;94056;57502;8228;8226;158747;6792;56474;6197;7114;139105;256643;23676;25878;6399;7499;4267;51284;2277;55841;51360;8481,103
-1,1,X,60701,37318587,37257886,414;55787;139422;170062;4935;100288814;1964;293;53940;30011;6322;5638;80311;139411;286530;92552;254158;8225;10943;5634;2824;170082;416;347541;139425;8227;59272;389840;170067;171483;8908;8544;7543;425054;168400;4281;1438;6247;645864;5931;10149;64109;51480;1183;140462;55344;8623;357;8233;265;286514;6792;158724;6197;139105;347442;139604;10549;25878;6303;7499;4115;55841;51360;2710;660;2925;51481;171482;795;10389;5160;1756;83604;5422;9367;11238;415;207063;4112;412;158506;158809;22866;5475;57393;6907;28227;4113;190;3730;1968;9468;23597;2187;5256;3563;26609;54960;6611;80231;25975;51311;8905;9189;395;6473;171484;256714;286464;10742;442444;257397;2742;3052;4810;404281;5613;347527;438;140456;5277;9758;257240;9185;94056;57502;8228;8226;158747;11141;56474;5165;7114;256643;23676;4114;6399;4267;51284;2277;170302;79135;5251;8481;441490;100130302,147
-1,1,X,60701,48928877,48868176,414;64743;6759;10214;55787;139422;170062;6756;4935;4693;100288814;10013;1964;293;53940;30011;27344;6322;5638;8239;94122;80311;6102;139411;286530;92552;254158;60506;56850;8225;10943;5634;2824;100873985;84679;170082;416;347541;139425;64840;10682;3266;25763;8227;59272;389840;170067;171483;389852;8908;2002;159013;8544;7543;2857;55634;7592;90060;425054;168400;4281;1438;24140;6247;645864;5931;10149;7403;6839;64109;51480;1183;3750;7076;140462;8241;55344;8623;347411;27197;357;7454;8233;265;286514;548313;6792;79742;158724;7355;6197;4128;139105;10084;347442;139604;7102;55593;10549;25878;6303;7499;4115;11040;8573;8409;55841;51360;2710;8406;660;2925;51481;171482;392465;795;10389;5160;1756;83604;5422;9367;7317;5935;11238;415;207063;4112;412;158506;58526;158809;6990;5127;22866;5475;10159;57393;7030;2623;6907;28227;4113;1536;190;7569;729201;3730;1968;9468;23597;57232;4943;2187;5256;3563;26609;54960;6611;6853;9767;80231;9282;25975;51311;8905;9189;395;347404;139341;54539;6473;171484;256714;286464;10742;9104;442444;6103;54880;257397;63904;2742;80258;369;3052;4810;404281;5199;347344;92745;5613;347527;438;140456;7504;5277;9758;56548;257240;9185;94056;4129;10245;57502;8228;8226;158747;11141;56474;5165;7114;641339;256643;23676;4114;6758;7712;6399;5009;1654;4267;51284;2277;170302;79135;11230;5251;8481;441490;8237;100130302,232
-1,1,X,60701,51776830,51716129,414;6759;9500;10214;170685;729431;6756;27344;729447;729422;80311;6102;92552;254158;60506;56850;8225;10943;2824;100873985;170082;347541;139425;729408;59272;389840;170067;2002;8544;55634;2857;7592;57477;425054;1438;645864;5931;7403;6839;51480;3750;7076;140462;8241;8623;347411;7454;265;645037;645051;158724;7355;6197;10084;347442;5355;55593;6303;7499;8409;51360;2710;8406;660;2925;171482;392465;5160;26748;11238;58526;57393;2623;6907;28227;4113;1536;3730;9468;23597;2187;6611;3563;2574;9767;9282;8712;139341;54539;256714;10742;9104;442444;6103;54880;2742;369;347344;347527;4007;438;7504;5277;9758;56548;1184;645073;94056;10245;57502;11141;11152;641339;256643;23676;4114;6758;8852;7712;23708;5009;1654;4267;51284;2277;170302;79135;11230;9210;441490;64743;389856;55787;139189;139422;170062;4935;4693;100288814;10013;1964;55190;293;50943;53940;30011;6322;5638;28952;8239;94122;139411;286530;5634;84679;9506;416;64840;10682;3266;25763;8227;389852;171483;8908;159013;7543;90060;168400;4281;24140;6247;10149;64109;1183;55344;27197;357;8233;286514;548313;6792;79742;4128;139105;139604;7102;10549;25878;4115;11040;6855;8573;55841;729396;729442;51481;795;10389;83604;1756;778;5422;9367;7317;5935;415;207063;4112;412;158506;340602;158809;6990;5127;22866;5475;10159;85417;100132399;7030;729428;190;7569;729201;89801;1968;57232;4943;79917;5256;26609;54960;6853;80231;25975;51311;8905;9189;395;347404;6473;171484;286464;63904;257397;80258;100008586;3052;4810;404281;5199;92745;5613;140456;257240;9185;27238;4129;2543;8228;158747;8226;56474;5165;7114;6399;5251;8481;8237;100130302,271
-1,1,X,60701,52886834,52826133,414;6759;9500;10214;170685;727837;729431;6756;9502;27344;729447;729422;80311;6102;92552;254158;60506;56850;8225;10943;2824;100873985;170082;347541;139425;729408;59272;389840;170067;81557;2002;8544;55634;2857;7592;57477;425054;1438;645864;5931;7403;6839;51480;3750;7076;140462;8241;8623;347411;7454;265;645037;645051;158724;7355;6197;10084;347442;5355;55593;6303;7499;8409;51360;2710;8406;660;2925;171482;392465;5160;26748;11238;653220;58526;57393;2623;6907;28227;4113;1536;3730;9468;23597;2187;6611;3563;2574;9767;9282;8712;139341;54539;256714;10742;9104;494197;442444;6103;54880;2742;369;280658;170627;347344;347527;4007;438;7504;5277;9758;56548;1184;645073;94056;10245;57502;11141;653067;11152;641339;256643;23676;4114;6758;8852;7712;23708;5009;1654;4267;51284;2277;170302;79135;11230;9210;441490;64743;389856;55787;139189;139422;170062;4935;4693;100288814;10013;1964;55190;293;50943;53940;30011;6322;5638;28952;8239;94122;139411;286530;5634;84679;9506;416;64840;10682;3266;25763;8227;389852;171483;8908;159013;7543;90060;168400;4281;24140;6247;10149;64109;1183;55344;27197;357;8233;286514;548313;6792;79742;4128;139105;139604;7102;10549;25878;4115;11040;6855;8573;55841;729396;729442;51481;795;10389;83604;1756;778;5422;9367;7317;5935;415;207063;4112;412;158506;340602;158809;6990;5127;22866;5475;10159;85417;100132399;7030;729428;190;7569;729201;89801;1968;57232;4943;79917;5256;26609;54960;6853;80231;25975;51311;8905;9189;395;347404;6473;171484;286464;63904;257397;80258;100008586;3052;4810;404281;5199;92745;5613;140456;257240;9185;27238;4129;2543;8228;158747;8226;56474;5165;7114;6399;728239;5251;8481;8237;6757;100130302,281
-1,1,X,60701,53047381,52986680,414;6759;9500;10214;170685;727837;729431;6756;9502;27344;729447;729422;80311;6102;92552;254158;60506;56850;8225;10943;2824;100873985;170082;347541;139425;729408;59272;389840;170067;81557;2002;8544;55634;2857;7592;57477;425054;727866;1438;645864;5931;7403;6839;51480;3750;7076;140462;8241;8623;347411;7454;265;645037;645051;158724;7355;6197;10084;347442;5355;55593;6303;7499;8409;51360;2710;8406;660;2925;171482;392465;5160;26748;11238;653220;58526;57393;2623;6907;28227;4113;1536;3730;9468;23597;2187;6611;3563;2574;9767;9282;8712;139341;54539;256714;10742;9104;494197;29057;442444;6103;54880;2742;369;280658;170627;347344;347527;4007;438;7504;5277;9758;56548;1184;645073;94056;10245;57502;11141;653067;11152;641339;256643;23676;4114;6758;8852;7712;23708;5009;1654;4267;51284;2277;170302;79135;11230;9210;441490;64743;389856;55787;139189;139422;170062;4935;4693;100288814;10013;1964;55190;293;50943;53940;30011;6322;5638;28952;8239;94122;139411;286530;5634;84679;9506;416;64840;10682;3266;25763;8227;389852;170626;171483;8908;159013;7543;90060;168400;4281;24140;6247;10149;64109;1183;55344;27197;357;8233;286514;548313;6792;79742;4128;139105;139604;7102;10549;25878;4115;11040;6855;8573;55841;729396;729442;51481;795;10389;83604;1756;778;5422;9367;7317;5935;415;207063;4112;412;158506;340602;158809;6990;5127;22866;5475;10159;85417;100132399;7030;729428;190;7569;729201;89801;1968;57232;4943;79917;5256;26609;54960;6853;80231;25975;51311;8905;9189;395;347404;6473;171484;286464;63904;257397;80258;100008586;3052;4810;404281;5199;92745;5613;140456;257240;9185;27238;4129;2543;8228;158747;8226;56474;5165;7114;6399;728239;5251;8481;8237;6757;100130302,284
-1,1,X,60701,53776922,53716221,23096;414;64061;6759;9500;10214;170685;727837;729431;6756;9502;8242;27344;729447;54328;729422;80311;6102;92552;254158;60506;56850;8225;10943;2824;100873985;170082;347541;139425;729408;59272;389840;170067;81557;2002;8544;55634;2857;7592;57477;425054;727866;1438;645864;5931;10075;7403;6839;51480;3750;7076;140462;8241;8623;347411;7454;265;645037;645051;158724;7355;6197;10084;347442;5355;55593;158787;6303;7499;8409;51360;2710;8406;660;2925;171482;392465;5160;26748;11238;653220;58526;57393;2623;6907;28227;4113;1536;3730;9468;23597;2187;6611;3563;2574;9767;9282;8712;139341;54539;256714;10742;9104;494197;29057;442444;6103;54880;2742;369;280658;170627;347344;347527;8243;4007;438;7504;5277;9758;56548;1184;645073;94056;10245;57502;11141;653067;11152;641339;256643;23676;4114;6758;8852;7712;23708;5009;1654;4267;51284;2277;170302;79135;11230;9210;441490;64743;389856;55787;139189;139422;170062;4935;4693;100288814;10013;1964;55190;293;50943;53940;30011;6322;5638;28952;8239;94122;139411;286530;5634;84679;9506;416;64840;10682;3266;25763;8227;389852;170626;171483;8908;159013;7543;90060;168400;4281;24140;6247;10149;64109;1183;55344;27197;357;8233;286514;548313;6792;79742;4128;139105;139604;7102;10549;25878;4115;11040;6855;8573;55841;729396;729442;51481;3028;795;10389;83604;1756;778;5422;9367;7317;5935;415;207063;4112;412;158506;340602;158809;6990;5127;22866;5475;10159;85417;100132399;7030;729428;190;7569;729201;89801;1968;57232;4943;79917;5256;26609;54960;6853;80231;25975;51311;8905;9189;395;347404;6473;171484;286464;63904;257397;80258;100008586;3052;4810;404281;5199;92745;5613;140456;257240;9185;27238;4129;2543;8228;158747;8226;56474;5165;7114;6399;728239;5251;8481;8237;6757;100130302,292
-1,1,X,60701,58081470,58020769,23096;414;64061;6759;9500;10214;170685;727837;729431;10916;158586;6756;9502;158880;8242;27344;729447;54328;729422;80311;6102;54954;90737;92552;254158;60506;56850;8225;2824;10943;100873985;170082;347541;139425;729408;59272;389840;170067;81557;2002;7216;8544;55634;2857;57477;7592;425054;727866;1438;645864;5931;10075;7403;6839;51480;3750;7076;140462;8241;8623;347411;203569;7454;27301;265;645037;645051;7355;158724;6197;10084;347442;5355;55593;158787;6303;7499;8409;51360;2710;54466;8406;660;2925;171482;392465;5160;26748;11238;139628;653220;58526;28986;23133;57393;2623;6907;28227;4113;1536;9468;3730;23597;2187;389860;6611;2574;3563;9767;10325;9282;347365;8712;139341;54539;256714;10742;9104;494197;29057;442444;6103;54880;90736;2742;369;280658;170627;347344;347527;8243;4007;286430;29978;438;7504;5277;9758;56548;1184;645073;10245;94056;57502;11141;653067;11152;90121;641339;256643;23676;4114;6758;8852;7712;23708;5009;1654;4267;51284;170302;11230;79135;2277;9210;441490;64743;389856;7789;55787;139189;139422;170062;4935;4693;10013;100288814;1964;55190;293;50943;53940;30011;6322;28952;5638;8239;94122;139411;286530;2245;5634;84679;9506;416;3266;64840;10682;5207;25763;8227;389852;170626;171483;8908;550643;159013;7543;90060;168400;4281;24140;6247;10149;11279;64109;1183;55344;27197;357;8233;286514;548313;6792;79742;4128;139105;7102;139604;10549;25878;4115;11040;6855;8573;55841;729396;729442;51481;3028;778;795;10389;1756;83604;5422;7317;5935;9367;100463488;54552;415;207063;4112;412;158506;340602;158809;5127;6990;22866;5475;10159;212;85417;100132399;158584;7030;729428;190;7569;89801;729201;1968;57232;4943;79917;5256;26609;54960;6853;80231;25975;51311;8905;9189;395;347404;171484;6473;286464;169981;63904;257397;80258;139793;100008586;3052;4810;404281;5199;92745;5613;474343;140456;257240;9185;27238;4129;2543;65267;8228;158747;8226;56474;5165;7114;6399;728239;5251;8481;8237;6757;100130302,324
-1,1,X,60701,58081487,58020786,23096;414;64061;6759;9500;10214;170685;727837;729431;10916;158586;6756;9502;158880;8242;27344;729447;54328;729422;80311;6102;54954;90737;92552;254158;60506;56850;8225;2824;10943;100873985;170082;347541;139425;729408;59272;389840;170067;81557;2002;7216;8544;55634;2857;57477;7592;425054;727866;1438;645864;5931;10075;7403;6839;51480;3750;7076;140462;8241;8623;347411;203569;7454;27301;265;645037;645051;7355;158724;6197;10084;347442;5355;55593;158787;6303;7499;8409;51360;2710;54466;8406;660;2925;171482;392465;5160;26748;11238;139628;653220;58526;28986;23133;57393;2623;6907;28227;4113;1536;9468;3730;23597;2187;389860;6611;2574;3563;9767;10325;9282;347365;8712;139341;54539;256714;10742;9104;494197;29057;442444;6103;54880;90736;2742;369;280658;170627;347344;347527;8243;4007;286430;29978;438;7504;5277;9758;56548;1184;645073;10245;94056;57502;11141;653067;11152;90121;641339;256643;23676;4114;6758;8852;7712;23708;5009;1654;4267;51284;170302;11230;79135;2277;9210;441490;64743;389856;7789;55787;139189;139422;170062;4935;4693;10013;100288814;1964;55190;293;50943;53940;30011;6322;28952;5638;8239;94122;139411;286530;2245;5634;84679;9506;416;3266;64840;10682;5207;25763;8227;389852;170626;171483;8908;550643;159013;7543;90060;168400;4281;24140;6247;10149;11279;64109;1183;55344;27197;357;8233;286514;548313;6792;79742;4128;139105;7102;139604;10549;25878;4115;11040;6855;8573;55841;729396;729442;51481;3028;778;795;10389;1756;83604;5422;7317;5935;9367;100463488;54552;415;207063;4112;412;158506;340602;158809;5127;6990;22866;5475;10159;212;85417;100132399;158584;7030;729428;190;7569;89801;729201;1968;57232;4943;79917;5256;26609;54960;6853;80231;25975;51311;8905;9189;395;347404;171484;6473;286464;169981;63904;257397;80258;139793;100008586;3052;4810;404281;5199;92745;5613;474343;140456;257240;9185;27238;4129;2543;65267;8228;158747;8226;56474;5165;7114;6399;728239;5251;8481;8237;6757;100130302,324
-1,1,X,60701,58081487,58020786,23096;414;64061;6759;9500;10214;170685;727837;729431;10916;158586;6756;9502;158880;8242;27344;729447;54328;729422;80311;6102;54954;90737;92552;254158;60506;56850;8225;2824;10943;100873985;170082;347541;139425;729408;59272;389840;170067;81557;2002;7216;8544;55634;2857;57477;7592;425054;727866;1438;645864;5931;10075;7403;6839;51480;3750;7076;140462;8241;8623;347411;203569;7454;27301;265;645037;645051;7355;158724;6197;10084;347442;5355;55593;158787;6303;7499;8409;51360;2710;54466;8406;660;2925;171482;392465;5160;26748;11238;139628;653220;58526;28986;23133;57393;2623;6907;28227;4113;1536;9468;3730;23597;2187;389860;6611;2574;3563;9767;10325;9282;347365;8712;139341;54539;256714;10742;9104;494197;29057;442444;6103;54880;90736;2742;369;280658;170627;347344;347527;8243;4007;286430;29978;438;7504;5277;9758;56548;1184;645073;10245;94056;57502;11141;653067;11152;90121;641339;256643;23676;4114;6758;8852;7712;23708;5009;1654;4267;51284;170302;11230;79135;2277;9210;441490;64743;389856;7789;55787;139189;139422;170062;4935;4693;10013;100288814;1964;55190;293;50943;53940;30011;6322;28952;5638;8239;94122;139411;286530;2245;5634;84679;9506;416;3266;64840;10682;5207;25763;8227;389852;170626;171483;8908;550643;159013;7543;90060;168400;4281;24140;6247;10149;11279;64109;1183;55344;27197;357;8233;286514;548313;6792;79742;4128;139105;7102;139604;10549;25878;4115;11040;6855;8573;55841;729396;729442;51481;3028;778;795;10389;1756;83604;5422;7317;5935;9367;100463488;54552;415;207063;4112;412;158506;340602;158809;5127;6990;22866;5475;10159;212;85417;100132399;158584;7030;729428;190;7569;89801;729201;1968;57232;4943;79917;5256;26609;54960;6853;80231;25975;51311;8905;9189;395;347404;171484;6473;286464;169981;63904;257397;80258;139793;100008586;3052;4810;404281;5199;92745;5613;474343;140456;257240;9185;27238;4129;2543;65267;8228;158747;8226;56474;5165;7114;6399;728239;5251;8481;8237;6757;100130302,324
-1,1,X,60701,58081487,58020786,23096;414;64061;6759;9500;10214;170685;727837;729431;10916;158586;6756;9502;158880;8242;27344;729447;54328;729422;80311;6102;54954;90737;92552;254158;60506;56850;8225;2824;10943;100873985;170082;347541;139425;729408;59272;389840;170067;81557;2002;7216;8544;55634;2857;57477;7592;425054;727866;1438;645864;5931;10075;7403;6839;51480;3750;7076;140462;8241;8623;347411;203569;7454;27301;265;645037;645051;7355;158724;6197;10084;347442;5355;55593;158787;6303;7499;8409;51360;2710;54466;8406;660;2925;171482;392465;5160;26748;11238;139628;653220;58526;28986;23133;57393;2623;6907;28227;4113;1536;9468;3730;23597;2187;389860;6611;2574;3563;9767;10325;9282;347365;8712;139341;54539;256714;10742;9104;494197;29057;442444;6103;54880;90736;2742;369;280658;170627;347344;347527;8243;4007;286430;29978;438;7504;5277;9758;56548;1184;645073;10245;94056;57502;11141;653067;11152;90121;641339;256643;23676;4114;6758;8852;7712;23708;5009;1654;4267;51284;170302;11230;79135;2277;9210;441490;64743;389856;7789;55787;139189;139422;170062;4935;4693;10013;100288814;1964;55190;293;50943;53940;30011;6322;28952;5638;8239;94122;139411;286530;2245;5634;84679;9506;416;3266;64840;10682;5207;25763;8227;389852;170626;171483;8908;550643;159013;7543;90060;168400;4281;24140;6247;10149;11279;64109;1183;55344;27197;357;8233;286514;548313;6792;79742;4128;139105;7102;139604;10549;25878;4115;11040;6855;8573;55841;729396;729442;51481;3028;778;795;10389;1756;83604;5422;7317;5935;9367;100463488;54552;415;207063;4112;412;158506;340602;158809;5127;6990;22866;5475;10159;212;85417;100132399;158584;7030;729428;190;7569;89801;729201;1968;57232;4943;79917;5256;26609;54960;6853;80231;25975;51311;8905;9189;395;347404;171484;6473;286464;169981;63904;257397;80258;139793;100008586;3052;4810;404281;5199;92745;5613;474343;140456;257240;9185;27238;4129;2543;65267;8228;158747;8226;56474;5165;7114;6399;728239;5251;8481;8237;6757;100130302,324
-1,1,X,60701,58544094,58483393,23096;414;64061;6759;9500;10214;170685;727837;729431;10916;158586;6756;9502;158880;8242;27344;729447;54328;729422;80311;6102;54954;90737;92552;254158;60506;56850;8225;2824;10943;100873985;170082;347541;139425;729408;59272;389840;170067;81557;2002;7216;8544;55634;2857;57477;7592;425054;727866;1438;645864;5931;10075;7403;6839;51480;3750;7076;140462;8241;8623;347411;203569;7454;27301;265;645037;645051;7355;158724;6197;10084;347442;5355;55593;158787;6303;7499;8409;51360;2710;54466;8406;660;2925;171482;392465;5160;26748;11238;139628;653220;58526;28986;23133;57393;2623;6907;28227;4113;1536;9468;3730;23597;2187;389860;6611;2574;3563;9767;10325;9282;347365;8712;139341;54539;256714;10742;9104;494197;29057;442444;6103;54880;90736;2742;369;280658;170627;347344;347527;8243;4007;286430;29978;438;7504;5277;9758;56548;1184;645073;10245;94056;57502;11141;653067;11152;90121;641339;256643;23676;4114;6758;8852;7712;23708;5009;1654;4267;51284;170302;11230;79135;2277;9210;441490;64743;389856;7789;55787;139189;139422;170062;4935;4693;10013;100288814;1964;55190;293;50943;53940;30011;6322;28952;5638;8239;94122;139411;286530;2245;5634;84679;9506;416;3266;64840;10682;5207;25763;8227;389852;170626;171483;8908;550643;159013;7543;90060;168400;4281;24140;6247;10149;11279;64109;1183;55344;27197;357;8233;286514;548313;6792;79742;4128;139105;7102;139604;10549;25878;4115;11040;6855;8573;55841;729396;729442;51481;3028;778;795;10389;1756;83604;5422;7317;5935;9367;100463488;54552;415;207063;4112;412;158506;340602;158809;5127;6990;22866;5475;10159;212;85417;100132399;158584;7030;729428;190;7569;89801;729201;1968;57232;4943;79917;5256;26609;54960;6853;80231;25975;51311;8905;9189;395;347404;171484;6473;286464;169981;63904;257397;80258;139793;100008586;3052;4810;404281;5199;92745;5613;474343;140456;257240;9185;27238;4129;2543;65267;8228;158747;8226;56474;5165;7114;6399;728239;5251;8481;8237;6757;100130302,324
-1,1,X,60701,61931689,61870988,23096;414;64061;6759;9500;10214;170685;727837;729431;10916;158586;6756;9502;158880;8242;27344;729447;54328;729422;80311;6102;54954;90737;92552;254158;60506;56850;8225;2824;10943;100873985;170082;347541;139425;729408;59272;389840;170067;81557;2002;7216;8544;55634;2857;57477;7592;425054;727866;1438;645864;5931;10075;7403;6839;51480;3750;7076;140462;8241;8623;347411;203569;7454;27301;265;645037;645051;7355;158724;6197;10084;347442;5355;55593;158787;6303;7499;8409;51360;2710;54466;8406;660;2925;171482;392465;5160;26748;11238;139628;653220;58526;28986;23133;57393;2623;6907;28227;4113;1536;9468;3730;23597;2187;389860;6611;2574;3563;9767;10325;9282;347365;8712;139341;54539;256714;10742;9104;494197;29057;442444;6103;54880;90736;2742;369;280658;170627;347344;347527;8243;4007;286430;29978;438;7504;5277;9758;56548;1184;645073;10245;94056;57502;11141;653067;11152;90121;641339;256643;23676;4114;6758;8852;7712;23708;5009;1654;4267;51284;170302;11230;79135;2277;9210;441490;64743;389856;7789;55787;139189;139422;170062;4935;4693;10013;100288814;1964;55190;293;50943;53940;30011;6322;28952;5638;8239;94122;139411;286530;2245;5634;84679;9506;416;3266;64840;10682;5207;25763;8227;389852;170626;171483;8908;550643;159013;7543;90060;168400;4281;24140;6247;10149;11279;64109;1183;55344;27197;357;8233;286514;548313;6792;79742;4128;139105;7102;139604;10549;25878;4115;11040;6855;8573;55841;729396;729442;51481;3028;778;795;10389;1756;83604;5422;7317;5935;9367;100463488;54552;415;207063;4112;412;158506;340602;158809;5127;6990;22866;5475;10159;212;85417;100132399;158584;7030;729428;190;7569;89801;729201;1968;57232;4943;79917;5256;26609;54960;6853;80231;25975;51311;8905;9189;395;347404;171484;6473;286464;169981;63904;257397;80258;139793;100008586;3052;4810;404281;5199;92745;5613;474343;140456;257240;9185;27238;4129;2543;65267;8228;158747;8226;56474;5165;7114;6399;728239;5251;8481;8237;6757;100130302,324
-1,1,X,60701,87573652,87512951,23096;414;64061;6759;9500;10214;51132;8823;170685;727837;729431;10916;158586;6756;9502;158880;8242;27344;729447;54328;7552;729422;100132304;9754;80311;6102;54954;56159;389874;340562;90737;92552;254158;60506;56850;8225;2824;10943;100873985;170082;100130361;347541;139425;728656;729408;59272;389840;170067;81557;2002;7216;8544;55634;2857;57477;7592;2833;340554;425054;340526;727866;139599;1438;139562;645864;5931;10075;117154;7403;6839;51480;3750;27112;7076;140462;8241;6567;392490;8623;347411;203569;7454;27301;265;645037;645051;54413;7355;158724;6197;254065;10084;347442;5355;347516;55593;6451;158787;6303;7499;4841;8409;347517;51360;139596;1896;2710;54466;8406;51248;660;51616;2925;171482;100132994;158833;79366;340533;392465;22;5160;56062;5303;3476;26748;51260;11238;139628;653220;58526;28986;23133;4983;57393;2623;6907;28227;4113;1536;57692;50945;9468;3730;23597;2187;81887;64219;389860;6611;2574;3563;3561;9767;10325;9282;54857;347365;10800;8712;139341;54539;256714;169966;10742;26548;9104;494197;1121;29057;139324;442444;6103;54880;90736;2742;369;2846;280658;170627;645974;347344;23229;79983;347527;8243;4007;286430;101059915;29978;438;7504;60401;5277;9758;4674;56548;1184;645073;10245;94056;57502;441531;11141;653067;1046;11152;90121;641339;256643;23676;4114;6758;1947;8852;7712;23708;5009;1654;4267;51284;170302;11230;79135;2277;9210;441490;6191;64743;389856;7789;55787;9452;139189;63947;139422;170062;9843;4935;4693;5456;10013;100288814;1964;55190;293;50943;53940;30011;93953;6322;28952;24137;5638;4478;8239;94122;139411;1538;286530;2245;9968;5634;84679;1741;9506;416;3266;64840;10682;11326;5207;25763;8227;27330;389852;170626;171483;8908;27334;158866;550643;159013;407;7543;90060;84061;168400;4281;158835;24140;6247;10149;11279;64109;1183;340527;139322;55906;55344;27197;357;8233;286514;100129407;548313;6872;6792;79742;4128;139105;7102;139604;4303;10549;55869;25878;4115;11040;8473;6855;84636;8573;2705;55841;54821;729396;729442;139886;51481;3028;778;795;10389;1756;83604;5422;7317;5935;9367;100463488;54552;415;207063;4112;412;158506;340602;5255;158809;5127;6990;22866;4435;5475;10159;212;139285;340529;85417;100132399;158584;7030;729428;5030;190;7569;89801;729201;1968;5230;57232;4943;79917;5256;26609;54960;538;6853;80231;286451;29934;25975;51311;8905;9189;395;347404;171484;6473;286464;169981;1349;63904;257397;142689;80258;139793;55613;100008586;3052;4810;404281;5199;367;546;92745;5613;158830;53344;9203;474343;140456;203430;257240;9185;27238;4129;2543;65267;8228;158747;8226;56474;5165;7114;6399;728239;84889;5251;8481;8237;6757;100130302,433
-1,1,X,60701,105357395,105296694,23096;414;64061;392509;6759;10214;9500;51132;8823;170685;727837;55998;729431;10916;158586;6756;9502;158880;55859;8242;27344;729447;54328;7552;729422;100132304;9754;80311;6102;27328;54954;84460;695;389874;56000;340562;56159;92552;254158;90737;60506;56850;8225;2824;10943;100873985;57526;51186;170082;100130361;1730;347541;139425;728656;729408;79921;59272;389840;170067;81557;80823;2002;7216;79979;9737;8544;55634;2857;57477;7592;11013;340554;2833;425054;340526;727866;139599;54457;1438;54470;139562;645864;5931;10075;117154;7403;6839;51480;3750;27112;7076;140462;8241;6567;392490;8623;347411;203569;7454;27301;265;645037;645051;54413;100529097;7355;158724;6197;254065;10084;347442;5355;347516;55593;6451;158787;6303;142684;7499;4841;8409;347517;51360;203447;139596;1896;441509;2710;54466;8406;51248;56001;51616;2925;660;171482;100132994;5354;158833;340533;79366;1821;392465;22;5160;56062;5303;3476;26748;51260;11238;139628;203562;653220;58526;28986;23133;4983;57393;2623;6907;28227;4113;1536;57692;1478;50945;9468;3730;100131755;23597;2187;81887;64219;389860;6611;2574;3563;3561;9767;10325;9282;54857;347365;10800;8712;26280;139341;54539;256714;169966;10742;51209;6173;26548;9104;494197;1121;29057;139324;442444;6103;54880;90736;2742;369;2846;280658;170627;645974;347344;23229;79983;347527;8243;56157;286430;4007;101059915;29978;438;7504;60401;5277;84707;9758;4674;53336;56548;51309;1184;645073;80712;10245;94056;728343;57502;9823;441531;11141;653067;1046;11152;90121;641339;256643;23676;4114;6758;1947;8852;286499;7712;5009;23708;1654;4267;51284;340542;94121;170302;11230;79135;2277;9210;2491;441490;6191;64743;644353;389856;7789;55787;9452;139189;63947;139422;170062;9643;9843;4935;4693;5456;10013;100288814;1964;55190;100996648;293;50943;53940;100528062;30011;90316;93953;6322;28952;24137;5638;4478;8239;94122;139411;1538;286530;2245;9968;5634;84679;1741;9506;416;3266;64840;10682;11326;5207;25763;8227;27330;389852;170626;171483;8908;27334;158866;27286;550643;159013;407;7543;90060;84061;168400;4281;158835;24140;6247;10149;11279;401612;64109;1678;1183;340527;139322;55906;55344;29935;27197;158983;357;8233;286514;340543;100129407;548313;6872;27018;6792;79742;140886;4128;139105;7102;139604;4303;10549;55869;25878;4115;11040;8473;59353;6855;84636;8573;2705;55841;54821;729396;729442;139886;282808;51481;3028;778;90843;795;1756;10389;5422;7317;5935;83604;9367;100463488;54552;6906;415;207063;4112;412;158506;340602;5255;158809;5127;6990;22866;4435;5475;10159;212;139285;9338;85417;340529;100132399;158584;64860;7030;729428;4675;5030;51566;190;7569;89801;729201;56271;1968;5230;57232;4943;79917;85012;114928;5256;26609;54960;538;6853;286527;80231;286451;286436;25975;51311;8905;29934;9189;395;347404;171484;6473;286464;169981;1349;63904;158931;257397;142689;80258;27035;139793;55613;7105;100008586;2717;3052;4810;404281;5199;367;546;92745;5613;158830;53344;9203;139231;474343;140456;402415;203430;257240;9185;27238;64102;4129;2543;65267;56849;8228;158747;8226;56474;5165;7114;140597;6399;728239;84889;3188;5251;8481;8237;6757;100130302,510
-1,1,X,60701,127527686,127466985,23096;64061;392509;10214;170685;23157;727837;55998;23439;729431;10916;158586;55859;331;54830;5358;27344;729447;54328;9075;7552;729422;54954;84460;389874;56000;340562;92552;254158;56850;8225;2824;51186;100130361;1730;347541;139425;729408;79921;59272;203413;2986;9737;8544;55634;2857;11013;340554;5716;54457;1438;5931;7403;6839;51480;728096;27112;92129;140462;8241;6567;827;203569;27301;645037;54413;7355;254065;79836;10084;347442;55593;139818;6303;142684;8409;203447;63932;2710;8406;51248;56001;51616;2925;100130613;100132994;5354;11043;340533;22;3476;26748;11238;203562;170261;58526;4983;6907;1536;1478;9468;23597;2187;1287;81887;6611;3561;9767;9282;54857;347365;10800;139341;54539;728062;169966;51209;23630;26548;1121;2846;280658;347344;23229;10857;56157;286430;101059915;438;5277;9758;4674;154796;56548;51309;1184;645073;80712;10245;728343;9823;441531;11141;643311;90121;256643;23676;4114;6758;286499;5009;1654;1831;51284;94121;170302;11230;79135;9210;2491;441490;84187;6191;64743;3598;389856;7789;55787;9452;139422;170062;57187;203427;4693;5456;10013;1964;55190;100996648;293;100528062;30011;90316;93953;10178;6322;28952;24137;94122;1538;286530;2245;5634;9506;79576;3266;139212;5207;8227;389852;170626;91851;27334;158866;550643;159013;407;7224;168400;4281;158835;24140;8471;7737;7319;10149;11279;64109;1678;139322;5063;55906;84443;27197;8233;548313;6872;27018;139105;7102;10549;59353;8573;28985;728049;728090;139886;282808;728082;778;90843;1756;5422;7317;5935;347454;29071;207063;4112;412;158506;340602;5127;22866;10159;212;139285;9338;85417;100132399;158584;190;7569;89801;2892;1968;5230;57232;57529;80231;286436;25975;51311;8905;55086;395;171484;169981;1349;63904;257397;142689;80258;27035;1641;55613;7105;100329135;4810;404281;367;92745;158830;53344;9203;186;474343;3597;140456;402415;203430;9185;728042;4129;65267;56849;8228;8226;728036;7114;6399;84889;8481;6757;414;6759;9500;51132;8823;6756;9502;158880;8242;100132304;9754;80311;6102;27328;695;56159;51213;90737;60506;10943;100873985;57526;170082;728656;3358;389840;170067;81557;80823;2002;7216;79979;57477;7592;2833;425054;340526;727866;139599;139804;54470;8450;139562;645864;10075;117154;57631;54521;79589;3750;653282;728072;7076;392490;8623;3920;347411;7454;265;90293;645051;100529097;158724;6197;5355;347516;6451;158787;7499;4841;347517;51360;340578;139596;1896;441509;54466;660;158798;171482;79868;728075;158833;79366;1821;56156;392465;5160;56062;5303;51260;139628;653220;340596;28986;23133;57393;2623;28227;4113;57692;50945;3730;100131755;57481;139170;64219;389860;2574;3563;10325;6170;79710;8712;26280;256714;10742;6173;9104;494197;29057;139324;442444;6103;54880;90736;2742;369;255313;170627;645974;79983;727940;347527;8243;4007;139741;29978;2182;7504;60401;84707;53336;94056;57502;55285;653067;1046;11152;641339;1947;8852;7712;23708;4267;340542;2277;644353;55916;340595;139189;63947;9643;9843;4935;100288814;50943;53940;55026;100507170;5638;4478;8239;4068;139411;9968;84679;115201;1741;416;64840;10682;11326;25763;27330;171483;8908;27286;7543;158800;90060;1288;84061;6247;292;401612;1183;340527;55344;29935;158983;357;10009;2747;286514;340543;54885;100129407;6792;79742;140886;4128;139604;4303;55869;25878;4115;11040;8473;6855;84636;55922;2705;55841;54821;729396;10735;729442;9949;4694;84528;51481;3028;100129520;795;10389;83604;9367;100463488;54552;6906;340547;415;5255;158809;6990;4435;5475;340529;65109;64860;7030;729428;4675;5030;51566;729201;56271;4943;79917;85012;114928;5256;26609;54960;538;6853;286451;29934;139221;9189;347404;6473;286464;158931;139793;100008586;2717;3052;5199;546;5613;139231;257240;11254;27238;64102;2543;158747;56474;5165;140597;5631;728239;3188;5251;8237;286527;100130302,613
-1,1,X,60701,155208354,155147653,23096;64061;392509;10214;170685;23157;727837;55998;23439;729431;10916;158586;55859;331;3423;54830;4168;6901;5358;92002;27344;729447;54328;266740;9075;102723737;7552;729422;54954;84460;389874;56000;340562;644538;92552;254158;79649;56850;8225;2824;100272147;51186;3149;26576;100130361;1730;347541;139425;3547;728695;729408;79921;57826;59272;203413;2986;7512;9737;8544;55634;2857;3421;537;11013;340554;5716;6658;4101;54457;1438;91966;441519;4100;5931;27316;7403;4534;6839;51480;728096;27112;92129;101928917;140462;8241;6567;827;203569;27301;84548;645037;54413;100133053;7355;254065;79836;10084;347442;60343;51765;55593;139818;56180;6303;8269;142684;7626;10046;8409;203447;63932;2710;4515;8406;51248;56001;51616;2925;100130613;2564;1193;100132994;5354;11043;340533;22;3476;84631;26748;11238;203562;102723631;170261;58526;441525;4983;29944;6907;1536;2539;1478;9468;23597;2187;1287;81887;6611;3561;9767;9282;54857;347365;10800;139341;54539;11219;728062;169966;51209;23630;26548;1121;2000;645188;51438;2846;280658;1852;347344;23229;10857;56157;286430;101059915;438;5277;9758;1069;4674;154796;56548;51309;1184;645073;80712;1774;10245;2258;728343;9823;441531;11141;643311;90121;256643;23676;4114;6758;4107;286499;5009;1654;1831;51284;94121;170302;11230;79135;286410;9210;2491;441490;84187;633;6191;64743;4110;3598;389856;7789;55787;9452;50814;2157;139422;170062;57187;139067;4104;203427;4693;5456;10013;1964;55190;100996648;293;9016;100528062;30011;90316;93953;10178;6322;28952;24137;2332;4105;6845;94122;84968;64663;1538;9142;286530;2245;5634;9506;79576;3266;139212;5207;6535;8227;393;389852;170626;91851;27334;158866;550643;159013;407;7224;55796;10761;100132963;168400;4281;158835;24140;8471;90167;7737;7319;10149;11279;6134;64109;1678;139322;5063;55906;116442;84443;27197;8233;548313;6872;27018;100129239;139105;7102;10549;26071;2664;59353;8573;28985;79184;728049;728090;158521;139886;282808;8263;9130;728082;778;90843;1756;5422;7317;5935;347454;29071;207063;4112;412;158506;340602;30848;5127;22866;93380;159091;10159;212;139285;9338;85417;8266;100132399;158584;494118;190;7569;89801;2892;1968;5230;57232;55559;57529;8277;63035;80231;286436;25975;51311;8905;55086;139735;395;83692;171484;10251;169981;1349;63904;139716;257397;142689;80258;27035;1641;55613;7105;100329135;84295;9459;4810;404281;4109;367;474384;6748;139760;347487;92745;158830;53344;4103;9203;139378;186;474343;2719;3597;140456;9248;402415;203430;9185;90161;728042;4129;65267;56849;8228;8226;728036;7114;6399;4952;83740;84889;8481;6757;347468;347475;414;6759;9500;51132;8823;541578;2158;55609;2556;494119;6756;9502;158880;8517;8242;474383;57595;51442;389895;100132304;9754;80311;6102;27328;695;56159;51213;90737;60506;10943;100873985;57526;728269;170082;474382;102723680;728656;3358;8273;83844;114824;389840;170067;81557;80823;8862;2002;7216;79979;158763;23641;55217;8270;57477;7592;2833;425054;340526;727866;139599;139804;54470;8450;959;139562;645864;10075;117154;57631;2010;54521;79589;51634;3750;653282;728072;7076;392490;9363;8623;3920;347411;7454;100506164;265;90293;645051;100529097;55511;158724;6197;203547;139135;5355;347516;203522;139081;6451;27336;158787;728458;7499;4841;347517;51360;340578;139596;1896;441509;54466;660;158798;4108;171482;79868;728075;158833;79366;1821;56156;392465;1260;5160;56062;5303;3054;51260;139628;653220;340596;554;28986;23133;57393;2623;28227;4113;57692;50945;3730;7739;100131755;57481;8260;139170;64219;4204;389860;2574;3563;65991;10325;6170;10813;79710;8712;26280;2316;256714;10742;6173;9104;494197;29057;139324;442444;6103;54880;90736;55558;2742;1736;369;255313;3654;170627;645974;3897;79983;727940;541466;347527;8243;4007;139741;29978;2182;7504;60401;84707;53336;1485;159090;94056;57502;55285;653067;1046;11152;641339;1947;8852;7712;23708;203523;4267;54967;340542;89885;2277;83550;644353;55916;340595;6594;139189;63947;9643;9843;4935;139728;100288814;10479;50943;53940;55026;100507170;5638;4478;8239;4068;51114;139411;246100;9968;84679;115201;100533997;1741;416;64840;10682;11326;25763;27330;171483;8908;27286;1038;7543;158800;90060;1288;84061;215;6247;292;55879;401612;1183;340527;55344;29935;158983;357;10009;2747;2652;286514;340543;54885;100129407;10495;6792;79742;140886;2239;2334;4128;441518;139604;4303;55869;25878;4115;11040;8473;6855;84636;55922;728712;5956;2705;55841;54821;729396;441521;8933;10735;729442;9949;4694;84528;51481;492;3028;100129520;795;10389;83604;7411;9947;9367;100463488;10134;79057;54552;6906;340547;30014;415;5255;680;158809;6990;4435;5475;340529;65109;64860;7030;729428;8776;4675;5030;51566;729201;56271;4943;79917;85012;114928;5256;26609;54960;538;6853;5365;4354;286451;29934;10838;139221;9189;347404;6473;3251;286464;158931;139793;100008586;2717;3052;5973;139065;5199;546;5613;51270;139231;9131;7547;474381;257240;11254;27238;64102;2543;158747;2273;56474;5165;64648;54440;140597;5631;728239;3188;100130086;5251;8237;286527;100130302,814
-1,1,X,60701,155208354,155147653,23096;64061;392509;10214;170685;23157;727837;55998;23439;729431;10916;158586;55859;331;3423;54830;4168;6901;5358;92002;27344;729447;54328;266740;9075;102723737;7552;729422;54954;84460;389874;56000;340562;644538;92552;254158;79649;56850;8225;2824;100272147;51186;3149;26576;100130361;1730;347541;139425;3547;728695;729408;79921;57826;59272;203413;2986;7512;9737;8544;55634;2857;3421;537;11013;340554;5716;6658;4101;54457;1438;91966;441519;4100;5931;27316;7403;4534;6839;51480;728096;27112;92129;101928917;140462;8241;6567;827;203569;27301;84548;645037;54413;100133053;7355;254065;79836;10084;347442;60343;51765;55593;139818;56180;6303;8269;142684;7626;10046;8409;203447;63932;2710;4515;8406;51248;56001;51616;2925;100130613;2564;1193;100132994;5354;11043;340533;22;3476;84631;26748;11238;203562;102723631;170261;58526;441525;4983;29944;6907;1536;2539;1478;9468;23597;2187;1287;81887;6611;3561;9767;9282;54857;347365;10800;139341;54539;11219;728062;169966;51209;23630;26548;1121;2000;645188;51438;2846;280658;1852;347344;23229;10857;56157;286430;101059915;438;5277;9758;1069;4674;154796;56548;51309;1184;645073;80712;1774;10245;2258;728343;9823;441531;11141;643311;90121;256643;23676;4114;6758;4107;286499;5009;1654;1831;51284;94121;170302;11230;79135;286410;9210;2491;441490;84187;633;6191;64743;4110;3598;389856;7789;55787;9452;50814;2157;139422;170062;57187;139067;4104;203427;4693;5456;10013;1964;55190;100996648;293;9016;100528062;30011;90316;93953;10178;6322;28952;24137;2332;4105;6845;94122;84968;64663;1538;9142;286530;2245;5634;9506;79576;3266;139212;5207;6535;8227;393;389852;170626;91851;27334;158866;550643;159013;407;7224;55796;10761;100132963;168400;4281;158835;24140;8471;90167;7737;7319;10149;11279;6134;64109;1678;139322;5063;55906;116442;84443;27197;8233;548313;6872;27018;100129239;139105;7102;10549;26071;2664;59353;8573;28985;79184;728049;728090;158521;139886;282808;8263;9130;728082;778;90843;1756;5422;7317;5935;347454;29071;207063;4112;412;158506;340602;30848;5127;22866;93380;159091;10159;212;139285;9338;85417;8266;100132399;158584;494118;190;7569;89801;2892;1968;5230;57232;55559;57529;8277;63035;80231;286436;25975;51311;8905;55086;139735;395;83692;171484;10251;169981;1349;63904;139716;257397;142689;80258;27035;1641;55613;7105;100329135;84295;9459;4810;404281;4109;367;474384;6748;139760;347487;92745;158830;53344;4103;9203;139378;186;474343;2719;3597;140456;9248;402415;203430;9185;90161;728042;4129;65267;56849;8228;8226;728036;7114;6399;4952;83740;84889;8481;6757;347468;347475;414;6759;9500;51132;8823;541578;2158;55609;2556;494119;6756;9502;158880;8517;8242;474383;57595;51442;389895;100132304;9754;80311;6102;27328;695;56159;51213;90737;60506;10943;100873985;57526;728269;170082;474382;102723680;728656;3358;8273;83844;114824;389840;170067;81557;80823;8862;2002;7216;79979;158763;23641;55217;8270;57477;7592;2833;425054;340526;727866;139599;139804;54470;8450;959;139562;645864;10075;117154;57631;2010;54521;79589;51634;3750;653282;728072;7076;392490;9363;8623;3920;347411;7454;100506164;265;90293;645051;100529097;55511;158724;6197;203547;139135;5355;347516;203522;139081;6451;27336;158787;728458;7499;4841;347517;51360;340578;139596;1896;441509;54466;660;158798;4108;171482;79868;728075;158833;79366;1821;56156;392465;1260;5160;56062;5303;3054;51260;139628;653220;340596;554;28986;23133;57393;2623;28227;4113;57692;50945;3730;7739;100131755;57481;8260;139170;64219;4204;389860;2574;3563;65991;10325;6170;10813;79710;8712;26280;2316;256714;10742;6173;9104;494197;29057;139324;442444;6103;54880;90736;55558;2742;1736;369;255313;3654;170627;645974;3897;79983;727940;541466;347527;8243;4007;139741;29978;2182;7504;60401;84707;53336;1485;159090;94056;57502;55285;653067;1046;11152;641339;1947;8852;7712;23708;203523;4267;54967;340542;89885;2277;83550;644353;55916;340595;6594;139189;63947;9643;9843;4935;139728;100288814;10479;50943;53940;55026;100507170;5638;4478;8239;4068;51114;139411;246100;9968;84679;115201;100533997;1741;416;64840;10682;11326;25763;27330;171483;8908;27286;1038;7543;158800;90060;1288;84061;215;6247;292;55879;401612;1183;340527;55344;29935;158983;357;10009;2747;2652;286514;340543;54885;100129407;10495;6792;79742;140886;2239;2334;4128;441518;139604;4303;55869;25878;4115;11040;8473;6855;84636;55922;728712;5956;2705;55841;54821;729396;441521;8933;10735;729442;9949;4694;84528;51481;492;3028;100129520;795;10389;83604;7411;9947;9367;100463488;10134;79057;54552;6906;340547;30014;415;5255;680;158809;6990;4435;5475;340529;65109;64860;7030;729428;8776;4675;5030;51566;729201;56271;4943;79917;85012;114928;5256;26609;54960;538;6853;5365;4354;286451;29934;10838;139221;9189;347404;6473;3251;286464;158931;139793;100008586;2717;3052;5973;139065;5199;546;5613;51270;139231;9131;7547;474381;257240;11254;27238;64102;2543;158747;2273;56474;5165;64648;54440;140597;5631;728239;3188;100130086;5251;8237;286527;100130302,814
-1,1,X,60701,155208354,155147653,23096;64061;392509;10214;170685;23157;727837;55998;23439;729431;10916;158586;55859;331;3423;54830;4168;6901;5358;92002;27344;729447;54328;266740;9075;102723737;7552;729422;54954;84460;389874;56000;340562;644538;92552;254158;79649;56850;8225;2824;100272147;51186;3149;26576;100130361;1730;347541;139425;3547;728695;729408;79921;57826;59272;203413;2986;7512;9737;8544;55634;2857;3421;537;11013;340554;5716;6658;4101;54457;1438;91966;441519;4100;5931;27316;7403;4534;6839;51480;728096;27112;92129;101928917;140462;8241;6567;827;203569;27301;84548;645037;54413;100133053;7355;254065;79836;10084;347442;60343;51765;55593;139818;56180;6303;8269;142684;7626;10046;8409;203447;63932;2710;4515;8406;51248;56001;51616;2925;100130613;2564;1193;100132994;5354;11043;340533;22;3476;84631;26748;11238;203562;102723631;170261;58526;441525;4983;29944;6907;1536;2539;1478;9468;23597;2187;1287;81887;6611;3561;9767;9282;54857;347365;10800;139341;54539;11219;728062;169966;51209;23630;26548;1121;2000;645188;51438;2846;280658;1852;347344;23229;10857;56157;286430;101059915;438;5277;9758;1069;4674;154796;56548;51309;1184;645073;80712;1774;10245;2258;728343;9823;441531;11141;643311;90121;256643;23676;4114;6758;4107;286499;5009;1654;1831;51284;94121;170302;11230;79135;286410;9210;2491;441490;84187;633;6191;64743;4110;3598;389856;7789;55787;9452;50814;2157;139422;170062;57187;139067;4104;203427;4693;5456;10013;1964;55190;100996648;293;9016;100528062;30011;90316;93953;10178;6322;28952;24137;2332;4105;6845;94122;84968;64663;1538;9142;286530;2245;5634;9506;79576;3266;139212;5207;6535;8227;393;389852;170626;91851;27334;158866;550643;159013;407;7224;55796;10761;100132963;168400;4281;158835;24140;8471;90167;7737;7319;10149;11279;6134;64109;1678;139322;5063;55906;116442;84443;27197;8233;548313;6872;27018;100129239;139105;7102;10549;26071;2664;59353;8573;28985;79184;728049;728090;158521;139886;282808;8263;9130;728082;778;90843;1756;5422;7317;5935;347454;29071;207063;4112;412;158506;340602;30848;5127;22866;93380;159091;10159;212;139285;9338;85417;8266;100132399;158584;494118;190;7569;89801;2892;1968;5230;57232;55559;57529;8277;63035;80231;286436;25975;51311;8905;55086;139735;395;83692;171484;10251;169981;1349;63904;139716;257397;142689;80258;27035;1641;55613;7105;100329135;84295;9459;4810;404281;4109;367;474384;6748;139760;347487;92745;158830;53344;4103;9203;139378;186;474343;2719;3597;140456;9248;402415;203430;9185;90161;728042;4129;65267;56849;8228;8226;728036;7114;6399;4952;83740;84889;8481;6757;347468;347475;414;6759;9500;51132;8823;541578;2158;55609;2556;494119;6756;9502;158880;8517;8242;474383;57595;51442;389895;100132304;9754;80311;6102;27328;695;56159;51213;90737;60506;10943;100873985;57526;728269;170082;474382;102723680;728656;3358;8273;83844;114824;389840;170067;81557;80823;8862;2002;7216;79979;158763;23641;55217;8270;57477;7592;2833;425054;340526;727866;139599;139804;54470;8450;959;139562;645864;10075;117154;57631;2010;54521;79589;51634;3750;653282;728072;7076;392490;9363;8623;3920;347411;7454;100506164;265;90293;645051;100529097;55511;158724;6197;203547;139135;5355;347516;203522;139081;6451;27336;158787;728458;7499;4841;347517;51360;340578;139596;1896;441509;54466;660;158798;4108;171482;79868;728075;158833;79366;1821;56156;392465;1260;5160;56062;5303;3054;51260;139628;653220;340596;554;28986;23133;57393;2623;28227;4113;57692;50945;3730;7739;100131755;57481;8260;139170;64219;4204;389860;2574;3563;65991;10325;6170;10813;79710;8712;26280;2316;256714;10742;6173;9104;494197;29057;139324;442444;6103;54880;90736;55558;2742;1736;369;255313;3654;170627;645974;3897;79983;727940;541466;347527;8243;4007;139741;29978;2182;7504;60401;84707;53336;1485;159090;94056;57502;55285;653067;1046;11152;641339;1947;8852;7712;23708;203523;4267;54967;340542;89885;2277;83550;644353;55916;340595;6594;139189;63947;9643;9843;4935;139728;100288814;10479;50943;53940;55026;100507170;5638;4478;8239;4068;51114;139411;246100;9968;84679;115201;100533997;1741;416;64840;10682;11326;25763;27330;171483;8908;27286;1038;7543;158800;90060;1288;84061;215;6247;292;55879;401612;1183;340527;55344;29935;158983;357;10009;2747;2652;286514;340543;54885;100129407;10495;6792;79742;140886;2239;2334;4128;441518;139604;4303;55869;25878;4115;11040;8473;6855;84636;55922;728712;5956;2705;55841;54821;729396;441521;8933;10735;729442;9949;4694;84528;51481;492;3028;100129520;795;10389;83604;7411;9947;9367;100463488;10134;79057;54552;6906;340547;30014;415;5255;680;158809;6990;4435;5475;340529;65109;64860;7030;729428;8776;4675;5030;51566;729201;56271;4943;79917;85012;114928;5256;26609;54960;538;6853;5365;4354;286451;29934;10838;139221;9189;347404;6473;3251;286464;158931;139793;100008586;2717;3052;5973;139065;5199;546;5613;51270;139231;9131;7547;474381;257240;11254;27238;64102;2543;158747;2273;56474;5165;64648;54440;140597;5631;728239;3188;100130086;5251;8237;286527;100130302,814
-1,1,X,60701,155208354,155147653,23096;64061;392509;10214;170685;23157;727837;55998;23439;729431;10916;158586;55859;331;3423;54830;4168;6901;5358;92002;27344;729447;54328;266740;9075;102723737;7552;729422;54954;84460;389874;56000;340562;644538;92552;254158;79649;56850;8225;2824;100272147;51186;3149;26576;100130361;1730;347541;139425;3547;728695;729408;79921;57826;59272;203413;2986;7512;9737;8544;55634;2857;3421;537;11013;340554;5716;6658;4101;54457;1438;91966;441519;4100;5931;27316;7403;4534;6839;51480;728096;27112;92129;101928917;140462;8241;6567;827;203569;27301;84548;645037;54413;100133053;7355;254065;79836;10084;347442;60343;51765;55593;139818;56180;6303;8269;142684;7626;10046;8409;203447;63932;2710;4515;8406;51248;56001;51616;2925;100130613;2564;1193;100132994;5354;11043;340533;22;3476;84631;26748;11238;203562;102723631;170261;58526;441525;4983;29944;6907;1536;2539;1478;9468;23597;2187;1287;81887;6611;3561;9767;9282;54857;347365;10800;139341;54539;11219;728062;169966;51209;23630;26548;1121;2000;645188;51438;2846;280658;1852;347344;23229;10857;56157;286430;101059915;438;5277;9758;1069;4674;154796;56548;51309;1184;645073;80712;1774;10245;2258;728343;9823;441531;11141;643311;90121;256643;23676;4114;6758;4107;286499;5009;1654;1831;51284;94121;170302;11230;79135;286410;9210;2491;441490;84187;633;6191;64743;4110;3598;389856;7789;55787;9452;50814;2157;139422;170062;57187;139067;4104;203427;4693;5456;10013;1964;55190;100996648;293;9016;100528062;30011;90316;93953;10178;6322;28952;24137;2332;4105;6845;94122;84968;64663;1538;9142;286530;2245;5634;9506;79576;3266;139212;5207;6535;8227;393;389852;170626;91851;27334;158866;550643;159013;407;7224;55796;10761;100132963;168400;4281;158835;24140;8471;90167;7737;7319;10149;11279;6134;64109;1678;139322;5063;55906;116442;84443;27197;8233;548313;6872;27018;100129239;139105;7102;10549;26071;2664;59353;8573;28985;79184;728049;728090;158521;139886;282808;8263;9130;728082;778;90843;1756;5422;7317;5935;347454;29071;207063;4112;412;158506;340602;30848;5127;22866;93380;159091;10159;212;139285;9338;85417;8266;100132399;158584;494118;190;7569;89801;2892;1968;5230;57232;55559;57529;8277;63035;80231;286436;25975;51311;8905;55086;139735;395;83692;171484;10251;169981;1349;63904;139716;257397;142689;80258;27035;1641;55613;7105;100329135;84295;9459;4810;404281;4109;367;474384;6748;139760;347487;92745;158830;53344;4103;9203;139378;186;474343;2719;3597;140456;9248;402415;203430;9185;90161;728042;4129;65267;56849;8228;8226;728036;7114;6399;4952;83740;84889;8481;6757;347468;347475;414;6759;9500;51132;8823;541578;2158;55609;2556;494119;6756;9502;158880;8517;8242;474383;57595;51442;389895;100132304;9754;80311;6102;27328;695;56159;51213;90737;60506;10943;100873985;57526;728269;170082;474382;102723680;728656;3358;8273;83844;114824;389840;170067;81557;80823;8862;2002;7216;79979;158763;23641;55217;8270;57477;7592;2833;425054;340526;727866;139599;139804;54470;8450;959;139562;645864;10075;117154;57631;2010;54521;79589;51634;3750;653282;728072;7076;392490;9363;8623;3920;347411;7454;100506164;265;90293;645051;100529097;55511;158724;6197;203547;139135;5355;347516;203522;139081;6451;27336;158787;728458;7499;4841;347517;51360;340578;139596;1896;441509;54466;660;158798;4108;171482;79868;728075;158833;79366;1821;56156;392465;1260;5160;56062;5303;3054;51260;139628;653220;340596;554;28986;23133;57393;2623;28227;4113;57692;50945;3730;7739;100131755;57481;8260;139170;64219;4204;389860;2574;3563;65991;10325;6170;10813;79710;8712;26280;2316;256714;10742;6173;9104;494197;29057;139324;442444;6103;54880;90736;55558;2742;1736;369;255313;3654;170627;645974;3897;79983;727940;541466;347527;8243;4007;139741;29978;2182;7504;60401;84707;53336;1485;159090;94056;57502;55285;653067;1046;11152;641339;1947;8852;7712;23708;203523;4267;54967;340542;89885;2277;83550;644353;55916;340595;6594;139189;63947;9643;9843;4935;139728;100288814;10479;50943;53940;55026;100507170;5638;4478;8239;4068;51114;139411;246100;9968;84679;115201;100533997;1741;416;64840;10682;11326;25763;27330;171483;8908;27286;1038;7543;158800;90060;1288;84061;215;6247;292;55879;401612;1183;340527;55344;29935;158983;357;10009;2747;2652;286514;340543;54885;100129407;10495;6792;79742;140886;2239;2334;4128;441518;139604;4303;55869;25878;4115;11040;8473;6855;84636;55922;728712;5956;2705;55841;54821;729396;441521;8933;10735;729442;9949;4694;84528;51481;492;3028;100129520;795;10389;83604;7411;9947;9367;100463488;10134;79057;54552;6906;340547;30014;415;5255;680;158809;6990;4435;5475;340529;65109;64860;7030;729428;8776;4675;5030;51566;729201;56271;4943;79917;85012;114928;5256;26609;54960;538;6853;5365;4354;286451;29934;10838;139221;9189;347404;6473;3251;286464;158931;139793;100008586;2717;3052;5973;139065;5199;546;5613;51270;139231;9131;7547;474381;257240;11254;27238;64102;2543;158747;2273;56474;5165;64648;54440;140597;5631;728239;3188;100130086;5251;8237;286527;100130302,814
1,1,X,60701,155209024,155148323,23096;64061;392509;10214;170685;23157;727837;55998;23439;729431;10916;158586;55859;331;3423;54830;4168;6901;5358;92002;27344;729447;54328;266740;9075;102723737;7552;729422;54954;84460;389874;56000;340562;644538;92552;254158;79649;56850;8225;2824;100272147;51186;3149;26576;100130361;1730;347541;139425;3547;728695;729408;79921;57826;59272;203413;2986;7512;9737;8544;55634;2857;3421;537;11013;340554;5716;6658;4101;54457;1438;91966;441519;4100;5931;27316;7403;4534;6839;51480;728096;27112;92129;101928917;140462;8241;6567;827;203569;27301;84548;645037;54413;100133053;7355;254065;79836;10084;347442;60343;51765;55593;139818;56180;6303;8269;142684;7626;10046;8409;203447;63932;2710;4515;8406;51248;56001;51616;2925;100130613;2564;1193;100132994;5354;11043;340533;22;3476;84631;26748;11238;203562;102723631;170261;58526;441525;4983;29944;6907;1536;2539;1478;9468;23597;2187;1287;81887;6611;3561;9767;9282;54857;347365;10800;139341;54539;11219;728062;169966;51209;23630;26548;1121;2000;645188;51438;2846;280658;1852;347344;23229;10857;56157;286430;101059915;438;5277;9758;1069;4674;154796;56548;51309;1184;645073;80712;1774;10245;2258;728343;9823;441531;11141;643311;90121;256643;23676;4114;6758;4107;286499;5009;1654;1831;51284;94121;170302;11230;79135;286410;9210;2491;441490;84187;633;6191;64743;4110;3598;389856;7789;55787;9452;50814;2157;139422;170062;57187;139067;4104;203427;4693;5456;10013;1964;55190;100996648;293;9016;100528062;30011;90316;93953;10178;6322;28952;24137;2332;4105;6845;94122;84968;64663;1538;9142;286530;2245;5634;9506;79576;3266;139212;5207;6535;8227;393;389852;170626;91851;27334;158866;550643;159013;407;7224;55796;10761;100132963;168400;4281;158835;24140;8471;90167;7737;7319;10149;11279;6134;64109;1678;139322;5063;55906;116442;84443;27197;8233;548313;6872;27018;100129239;139105;7102;10549;26071;2664;59353;8573;28985;79184;728049;728090;158521;139886;282808;8263;9130;728082;778;90843;1756;5422;7317;5935;347454;29071;207063;4112;412;158506;340602;30848;5127;22866;93380;159091;10159;212;139285;9338;85417;8266;100132399;158584;494118;190;7569;89801;2892;1968;5230;57232;55559;57529;8277;63035;80231;286436;25975;51311;8905;55086;139735;395;83692;171484;10251;169981;1349;63904;139716;257397;142689;80258;27035;1641;55613;7105;100329135;84295;9459;4810;404281;4109;367;474384;6748;139760;347487;92745;158830;53344;4103;9203;139378;186;474343;2719;3597;140456;9248;402415;203430;9185;90161;728042;4129;65267;56849;8228;8226;728036;7114;6399;4952;83740;84889;8481;6757;347468;347475;414;6759;9500;51132;8823;541578;2158;55609;2556;494119;6756;9502;158880;8517;8242;474383;57595;51442;389895;100132304;9754;80311;6102;27328;695;56159;51213;90737;60506;10943;100873985;57526;728269;170082;474382;102723680;728656;3358;8273;83844;114824;389840;170067;81557;80823;8862;2002;7216;79979;158763;23641;55217;8270;57477;7592;2833;425054;340526;727866;139599;139804;54470;8450;959;139562;645864;10075;117154;57631;2010;54521;79589;51634;3750;653282;728072;7076;392490;9363;8623;3920;347411;7454;100506164;265;90293;645051;100529097;55511;158724;6197;203547;139135;5355;347516;203522;139081;6451;27336;158787;728458;7499;4841;347517;51360;340578;139596;1896;441509;54466;660;158798;4108;171482;79868;728075;158833;79366;1821;56156;392465;1260;5160;56062;5303;3054;51260;139628;653220;340596;554;28986;23133;57393;2623;28227;4113;57692;50945;3730;7739;100131755;57481;8260;139170;64219;4204;389860;2574;3563;65991;10325;6170;10813;79710;8712;26280;2316;256714;10742;6173;9104;494197;29057;139324;442444;6103;54880;90736;55558;2742;1736;369;255313;3654;170627;645974;3897;79983;727940;541466;347527;8243;4007;139741;29978;2182;7504;60401;84707;53336;1485;159090;94056;57502;55285;653067;1046;11152;641339;1947;8852;7712;23708;203523;4267;54967;340542;89885;2277;83550;644353;55916;340595;6594;139189;63947;9643;9843;4935;139728;100288814;10479;50943;53940;55026;100507170;5638;4478;8239;4068;51114;139411;246100;9968;84679;115201;100533997;1741;416;64840;10682;11326;25763;27330;171483;8908;27286;1038;7543;158800;90060;1288;84061;215;6247;292;55879;401612;1183;340527;55344;29935;158983;357;10009;2747;2652;286514;340543;54885;100129407;10495;6792;79742;140886;2239;2334;4128;441518;139604;4303;55869;25878;4115;11040;8473;6855;84636;55922;728712;5956;2705;55841;54821;729396;441521;8933;10735;729442;9949;4694;84528;51481;492;3028;100129520;795;10389;83604;7411;9947;9367;100463488;10134;79057;54552;6906;340547;30014;415;5255;680;158809;6990;4435;5475;340529;65109;64860;7030;729428;8776;4675;5030;51566;729201;56271;4943;79917;85012;114928;5256;26609;54960;538;6853;5365;4354;286451;29934;10838;139221;9189;347404;6473;3251;286464;158931;139793;100008586;2717;3052;5973;139065;5199;546;5613;51270;139231;9131;7547;474381;257240;11254;27238;64102;2543;158747;2273;56474;5165;64648;54440;140597;5631;728239;3188;100130086;5251;8237;286527;100130302,814
1,1,X,60701,155226891,155166190,23096;64061;392509;10214;170685;23157;727837;55998;23439;729431;10916;158586;55859;331;3423;54830;4168;6901;5358;92002;27344;729447;54328;266740;9075;102723737;7552;729422;54954;84460;389874;56000;340562;644538;92552;254158;79649;56850;8225;2824;100272147;51186;3149;26576;100130361;1730;347541;139425;3547;728695;729408;79921;57826;59272;203413;2986;7512;9737;8544;55634;2857;3421;537;11013;340554;5716;6658;4101;54457;1438;91966;441519;4100;5931;27316;7403;4534;6839;51480;728096;27112;92129;101928917;140462;8241;6567;827;203569;27301;84548;645037;54413;100133053;7355;254065;79836;10084;347442;60343;51765;55593;139818;56180;6303;8269;142684;7626;10046;8409;203447;63932;2710;4515;8406;51248;56001;51616;2925;100130613;2564;1193;100132994;5354;11043;340533;22;3476;84631;26748;11238;203562;102723631;170261;58526;441525;4983;29944;6907;1536;2539;1478;9468;23597;2187;1287;81887;6611;3561;9767;9282;54857;347365;10800;139341;54539;11219;728062;169966;51209;23630;26548;1121;2000;645188;51438;2846;280658;1852;347344;23229;10857;56157;286430;101059915;438;5277;9758;1069;4674;154796;56548;51309;1184;645073;80712;1774;10245;2258;728343;9823;441531;11141;643311;90121;256643;23676;4114;6758;4107;286499;5009;1654;1831;51284;94121;170302;11230;79135;286410;9210;2491;441490;84187;633;6191;64743;4110;3598;389856;7789;55787;9452;50814;2157;139422;170062;57187;139067;4104;203427;4693;5456;10013;1964;55190;100996648;293;9016;100528062;30011;90316;93953;10178;6322;28952;24137;2332;4105;6845;94122;84968;64663;1538;9142;286530;2245;5634;9506;79576;3266;139212;5207;6535;8227;393;389852;170626;91851;27334;158866;550643;159013;407;7224;55796;10761;100132963;168400;4281;158835;24140;8471;90167;7737;7319;10149;11279;6134;64109;1678;139322;5063;55906;116442;84443;27197;8233;548313;6872;27018;100129239;139105;7102;10549;26071;2664;59353;8573;28985;79184;728049;728090;158521;139886;282808;8263;9130;728082;778;90843;1756;5422;7317;5935;347454;29071;207063;4112;412;158506;340602;30848;5127;22866;93380;159091;10159;212;139285;9338;85417;8266;100132399;158584;494118;190;7569;89801;2892;1968;5230;57232;55559;57529;8277;63035;80231;286436;25975;51311;8905;55086;139735;395;83692;171484;10251;169981;1349;63904;139716;257397;142689;80258;27035;1641;55613;7105;100329135;84295;9459;4810;404281;4109;367;474384;6748;139760;347487;92745;158830;53344;4103;9203;139378;186;474343;2719;3597;140456;9248;402415;203430;9185;90161;728042;4129;65267;56849;8228;8226;728036;7114;6399;4952;83740;84889;8481;6757;347468;347475;414;6759;9500;51132;8823;541578;2158;55609;2556;494119;6756;9502;158880;8517;8242;474383;57595;51442;389895;100132304;9754;80311;6102;27328;695;56159;51213;90737;60506;10943;100873985;57526;728269;170082;474382;102723680;728656;3358;8273;83844;114824;389840;170067;81557;80823;8862;2002;7216;79979;158763;23641;55217;8270;57477;7592;2833;425054;340526;727866;139599;139804;54470;8450;959;139562;645864;10075;117154;57631;2010;54521;79589;51634;3750;653282;728072;7076;392490;9363;8623;3920;347411;7454;100506164;265;90293;645051;100529097;55511;158724;6197;203547;139135;5355;347516;203522;139081;6451;27336;158787;728458;7499;4841;347517;51360;340578;139596;1896;441509;54466;660;158798;4108;171482;79868;728075;158833;79366;1821;56156;392465;1260;5160;56062;5303;3054;51260;139628;653220;340596;554;28986;23133;57393;2623;28227;4113;57692;50945;3730;7739;100131755;57481;8260;139170;64219;4204;389860;2574;3563;65991;10325;6170;10813;79710;8712;26280;2316;256714;10742;6173;9104;494197;29057;139324;442444;6103;54880;90736;55558;2742;1736;369;255313;3654;170627;645974;3897;79983;727940;541466;347527;8243;4007;139741;29978;2182;7504;60401;84707;53336;1485;159090;94056;57502;55285;653067;1046;11152;641339;1947;8852;7712;23708;203523;4267;54967;340542;89885;2277;83550;644353;55916;340595;6594;139189;63947;9643;9843;4935;139728;100288814;10479;50943;53940;55026;100507170;5638;4478;8239;4068;51114;139411;246100;9968;84679;115201;100533997;1741;416;64840;10682;11326;25763;27330;171483;8908;27286;1038;7543;158800;90060;1288;84061;215;6247;292;55879;401612;1183;340527;55344;29935;158983;357;10009;2747;2652;286514;340543;54885;100129407;10495;6792;79742;140886;2239;2334;4128;441518;139604;4303;55869;25878;4115;11040;8473;6855;84636;55922;728712;5956;2705;55841;54821;729396;441521;8933;10735;729442;9949;4694;84528;51481;492;3028;100129520;795;10389;83604;7411;9947;9367;100463488;10134;79057;54552;6906;340547;30014;415;5255;680;158809;6990;4435;5475;340529;65109;64860;7030;729428;8776;4675;5030;51566;729201;56271;4943;79917;85012;114928;5256;26609;54960;538;6853;5365;4354;286451;29934;10838;139221;9189;347404;6473;3251;286464;158931;139793;100008586;2717;3052;5973;139065;5199;546;5613;51270;139231;9131;7547;474381;257240;11254;27238;64102;2543;158747;2273;56474;5165;64648;54440;140597;5631;728239;3188;100130086;5251;8237;286527;100130302,814
1,1,X,60701,155232894,155172193,23096;64061;392509;10214;170685;23157;727837;55998;23439;729431;10916;158586;55859;331;3423;54830;4168;6901;5358;92002;27344;729447;54328;266740;9075;102723737;7552;729422;54954;84460;389874;56000;340562;644538;92552;254158;79649;56850;8225;2824;100272147;51186;3149;26576;100130361;1730;347541;139425;3547;728695;729408;79921;57826;59272;203413;2986;7512;9737;8544;55634;2857;3421;537;11013;340554;5716;6658;4101;54457;1438;91966;441519;4100;5931;27316;7403;4534;6839;51480;728096;27112;92129;101928917;140462;8241;6567;827;203569;27301;84548;645037;54413;100133053;7355;254065;79836;10084;347442;60343;51765;55593;139818;56180;6303;8269;142684;7626;10046;8409;203447;63932;2710;4515;8406;51248;56001;51616;2925;100130613;2564;1193;100132994;5354;11043;340533;22;3476;84631;26748;11238;203562;102723631;170261;58526;441525;4983;29944;6907;1536;2539;1478;9468;23597;2187;1287;81887;6611;3561;9767;9282;54857;347365;10800;139341;54539;11219;728062;169966;51209;23630;26548;1121;2000;645188;51438;2846;280658;1852;347344;23229;10857;56157;286430;101059915;438;5277;9758;1069;4674;154796;56548;51309;1184;645073;80712;1774;10245;2258;728343;9823;441531;11141;643311;90121;256643;23676;4114;6758;4107;286499;5009;1654;1831;51284;94121;170302;11230;79135;286410;9210;2491;441490;84187;633;6191;64743;4110;3598;389856;7789;55787;9452;50814;2157;139422;170062;57187;139067;4104;203427;4693;5456;10013;1964;55190;100996648;293;9016;100528062;30011;90316;93953;10178;6322;28952;24137;2332;4105;6845;94122;84968;64663;1538;9142;286530;2245;5634;9506;79576;3266;139212;5207;6535;8227;393;389852;170626;91851;27334;158866;550643;159013;407;7224;55796;10761;100132963;168400;4281;158835;24140;8471;90167;7737;7319;10149;11279;6134;64109;1678;139322;5063;55906;116442;84443;27197;8233;548313;6872;27018;100129239;139105;7102;10549;26071;2664;59353;8573;28985;79184;728049;728090;158521;3581;139886;282808;8263;9130;728082;778;90843;1756;5422;7317;5935;347454;29071;207063;4112;412;158506;340602;30848;5127;22866;93380;159091;10159;212;139285;9338;85417;8266;100132399;158584;494118;190;7569;89801;2892;1968;5230;57232;55559;57529;8277;63035;80231;286436;25975;51311;8905;55086;139735;395;83692;171484;10251;169981;1349;63904;139716;257397;142689;80258;27035;1641;55613;7105;100329135;84295;9459;4810;404281;4109;367;474384;6748;139760;347487;92745;158830;53344;4103;9203;139378;186;474343;2719;3597;140456;9248;402415;203430;9185;90161;728042;4129;65267;56849;8228;8226;728036;7114;6399;4952;83740;84889;8481;6757;347468;347475;414;6759;9500;51132;8823;541578;2158;55609;2556;494119;6756;9502;158880;8517;8242;474383;57595;51442;389895;100132304;9754;80311;6102;27328;695;56159;51213;90737;60506;10943;100873985;57526;728269;170082;474382;102723680;728656;3358;8273;83844;114824;389840;170067;81557;80823;8862;2002;7216;79979;158763;23641;55217;8270;57477;7592;2833;425054;340526;727866;139599;139804;54470;8450;959;139562;645864;10075;117154;57631;2010;54521;79589;51634;3750;653282;728072;7076;392490;9363;8623;3920;347411;7454;100506164;265;90293;645051;100529097;55511;158724;6197;203547;139135;5355;347516;203522;139081;6451;27336;158787;728458;7499;4841;347517;51360;340578;139596;1896;441509;54466;660;158798;4108;171482;79868;728075;158833;79366;1821;56156;392465;1260;5160;56062;5303;3054;51260;139628;653220;340596;554;28986;23133;57393;2623;28227;4113;57692;50945;3730;7739;100131755;57481;8260;139170;64219;4204;389860;2574;3563;65991;10325;6170;10813;79710;8712;26280;2316;256714;10742;6173;9104;494197;29057;139324;442444;6103;54880;90736;55558;2742;1736;369;255313;3654;170627;645974;3897;79983;727940;541466;347527;8243;4007;139741;29978;2182;7504;60401;84707;53336;1485;159090;94056;57502;55285;653067;1046;11152;641339;1947;8852;7712;23708;203523;4267;54967;340542;89885;2277;83550;644353;55916;340595;6594;139189;63947;9643;9843;4935;139728;100288814;10479;50943;53940;55026;100507170;5638;4478;8239;4068;51114;139411;246100;9968;84679;115201;100533997;1741;416;64840;10682;11326;25763;27330;171483;8908;27286;1038;7543;158800;90060;1288;84061;215;6247;292;55879;401612;1183;340527;55344;29935;158983;357;10009;2747;2652;286514;340543;54885;100129407;10495;6792;79742;140886;2239;2334;4128;441518;139604;4303;55869;25878;4115;11040;8473;6855;84636;55922;728712;5956;2705;55841;54821;729396;441521;8933;10735;729442;9949;4694;84528;51481;492;3028;100129520;795;10389;83604;7411;9947;9367;100463488;10134;79057;54552;6906;340547;30014;415;5255;680;158809;6990;4435;5475;340529;65109;64860;7030;729428;8776;4675;5030;51566;729201;56271;4943;79917;85012;114928;5256;26609;54960;538;6853;5365;4354;286451;29934;10838;139221;9189;347404;6473;3251;286464;158931;139793;100008586;2717;3052;5973;139065;5199;546;5613;51270;139231;9131;7547;474381;257240;11254;27238;64102;2543;158747;2273;56474;5165;64648;54440;140597;5631;728239;3188;100130086;5251;8237;286527;100130302,815
1,1,X,60701,155232894,155172193,23096;64061;392509;10214;170685;23157;727837;55998;23439;729431;10916;158586;55859;331;3423;54830;4168;6901;5358;92002;27344;729447;54328;266740;9075;102723737;7552;729422;54954;84460;389874;56000;340562;644538;92552;254158;79649;56850;8225;2824;100272147;51186;3149;26576;100130361;1730;347541;139425;3547;728695;729408;79921;57826;59272;203413;2986;7512;9737;8544;55634;2857;3421;537;11013;340554;5716;6658;4101;54457;1438;91966;441519;4100;5931;27316;7403;4534;6839;51480;728096;27112;92129;101928917;140462;8241;6567;827;203569;27301;84548;645037;54413;100133053;7355;254065;79836;10084;347442;60343;51765;55593;139818;56180;6303;8269;142684;7626;10046;8409;203447;63932;2710;4515;8406;51248;56001;51616;2925;100130613;2564;1193;100132994;5354;11043;340533;22;3476;84631;26748;11238;203562;102723631;170261;58526;441525;4983;29944;6907;1536;2539;1478;9468;23597;2187;1287;81887;6611;3561;9767;9282;54857;347365;10800;139341;54539;11219;728062;169966;51209;23630;26548;1121;2000;645188;51438;2846;280658;1852;347344;23229;10857;56157;286430;101059915;438;5277;9758;1069;4674;154796;56548;51309;1184;645073;80712;1774;10245;2258;728343;9823;441531;11141;643311;90121;256643;23676;4114;6758;4107;286499;5009;1654;1831;51284;94121;170302;11230;79135;286410;9210;2491;441490;84187;633;6191;64743;4110;3598;389856;7789;55787;9452;50814;2157;139422;170062;57187;139067;4104;203427;4693;5456;10013;1964;55190;100996648;293;9016;100528062;30011;90316;93953;10178;6322;28952;24137;2332;4105;6845;94122;84968;64663;1538;9142;286530;2245;5634;9506;79576;3266;139212;5207;6535;8227;393;389852;170626;91851;27334;158866;550643;159013;407;7224;55796;10761;100132963;168400;4281;158835;24140;8471;90167;7737;7319;10149;11279;6134;64109;1678;139322;5063;55906;116442;84443;27197;8233;548313;6872;27018;100129239;139105;7102;10549;26071;2664;59353;8573;28985;79184;728049;728090;158521;3581;139886;282808;8263;9130;728082;778;90843;1756;5422;7317;5935;347454;29071;207063;4112;412;158506;340602;30848;5127;22866;93380;159091;10159;212;139285;9338;85417;8266;100132399;158584;494118;190;7569;89801;2892;1968;5230;57232;55559;57529;8277;63035;80231;286436;25975;51311;8905;55086;139735;395;83692;171484;10251;169981;1349;63904;139716;257397;142689;80258;27035;1641;55613;7105;100329135;84295;9459;4810;404281;4109;367;474384;6748;139760;347487;92745;158830;53344;4103;9203;139378;186;474343;2719;3597;140456;9248;402415;203430;9185;90161;728042;4129;65267;56849;8228;8226;728036;7114;6399;4952;83740;84889;8481;6757;347468;347475;414;6759;9500;51132;8823;541578;2158;55609;2556;494119;6756;9502;158880;8517;8242;474383;57595;51442;389895;100132304;9754;80311;6102;27328;695;56159;51213;90737;60506;10943;100873985;57526;728269;170082;474382;102723680;728656;3358;8273;83844;114824;389840;170067;81557;80823;8862;2002;7216;79979;158763;23641;55217;8270;57477;7592;2833;425054;340526;727866;139599;139804;54470;8450;959;139562;645864;10075;117154;57631;2010;54521;79589;51634;3750;653282;728072;7076;392490;9363;8623;3920;347411;7454;100506164;265;90293;645051;100529097;55511;158724;6197;203547;139135;5355;347516;203522;139081;6451;27336;158787;728458;7499;4841;347517;51360;340578;139596;1896;441509;54466;660;158798;4108;171482;79868;728075;158833;79366;1821;56156;392465;1260;5160;56062;5303;3054;51260;139628;653220;340596;554;28986;23133;57393;2623;28227;4113;57692;50945;3730;7739;100131755;57481;8260;139170;64219;4204;389860;2574;3563;65991;10325;6170;10813;79710;8712;26280;2316;256714;10742;6173;9104;494197;29057;139324;442444;6103;54880;90736;55558;2742;1736;369;255313;3654;170627;645974;3897;79983;727940;541466;347527;8243;4007;139741;29978;2182;7504;60401;84707;53336;1485;159090;94056;57502;55285;653067;1046;11152;641339;1947;8852;7712;23708;203523;4267;54967;340542;89885;2277;83550;644353;55916;340595;6594;139189;63947;9643;9843;4935;139728;100288814;10479;50943;53940;55026;100507170;5638;4478;8239;4068;51114;139411;246100;9968;84679;115201;100533997;1741;416;64840;10682;11326;25763;27330;171483;8908;27286;1038;7543;158800;90060;1288;84061;215;6247;292;55879;401612;1183;340527;55344;29935;158983;357;10009;2747;2652;286514;340543;54885;100129407;10495;6792;79742;140886;2239;2334;4128;441518;139604;4303;55869;25878;4115;11040;8473;6855;84636;55922;728712;5956;2705;55841;54821;729396;441521;8933;10735;729442;9949;4694;84528;51481;492;3028;100129520;795;10389;83604;7411;9947;9367;100463488;10134;79057;54552;6906;340547;30014;415;5255;680;158809;6990;4435;5475;340529;65109;64860;7030;729428;8776;4675;5030;51566;729201;56271;4943;79917;85012;114928;5256;26609;54960;538;6853;5365;4354;286451;29934;10838;139221;9189;347404;6473;3251;286464;158931;139793;100008586;2717;3052;5973;139065;5199;546;5613;51270;139231;9131;7547;474381;257240;11254;27238;64102;2543;158747;2273;56474;5165;64648;54440;140597;5631;728239;3188;100130086;5251;8237;286527;100130302,815
-1,1,X,60701,155232894,155172193,23096;64061;392509;10214;170685;23157;727837;55998;23439;729431;10916;158586;55859;331;3423;54830;4168;6901;5358;92002;27344;729447;54328;266740;9075;102723737;7552;729422;54954;84460;389874;56000;340562;644538;92552;254158;79649;56850;8225;2824;100272147;51186;3149;26576;100130361;1730;347541;139425;3547;728695;729408;79921;57826;59272;203413;2986;7512;9737;8544;55634;2857;3421;537;11013;340554;5716;6658;4101;54457;1438;91966;441519;4100;5931;27316;7403;4534;6839;51480;728096;27112;92129;101928917;140462;8241;6567;827;203569;27301;84548;645037;54413;100133053;7355;254065;79836;10084;347442;60343;51765;55593;139818;56180;6303;8269;142684;7626;10046;8409;203447;63932;2710;4515;8406;51248;56001;51616;2925;100130613;2564;1193;100132994;5354;11043;340533;22;3476;84631;26748;11238;203562;102723631;170261;58526;441525;4983;29944;6907;1536;2539;1478;9468;23597;2187;1287;81887;6611;3561;9767;9282;54857;347365;10800;139341;54539;11219;728062;169966;51209;23630;26548;1121;2000;645188;51438;2846;280658;1852;347344;23229;10857;56157;286430;101059915;438;5277;9758;1069;4674;154796;56548;51309;1184;645073;80712;1774;10245;2258;728343;9823;441531;11141;643311;90121;256643;23676;4114;6758;4107;286499;5009;1654;1831;51284;94121;170302;11230;79135;286410;9210;2491;441490;84187;633;6191;64743;4110;3598;389856;7789;55787;9452;50814;2157;139422;170062;57187;139067;4104;203427;4693;5456;10013;1964;55190;100996648;293;9016;100528062;30011;90316;93953;10178;6322;28952;24137;2332;4105;6845;94122;84968;64663;1538;9142;286530;2245;5634;9506;79576;3266;139212;5207;6535;8227;393;389852;170626;91851;27334;158866;550643;159013;407;7224;55796;10761;100132963;168400;4281;158835;24140;8471;90167;7737;7319;10149;11279;6134;64109;1678;139322;5063;55906;116442;84443;27197;8233;548313;6872;27018;100129239;139105;7102;10549;26071;2664;59353;8573;28985;79184;728049;728090;158521;3581;139886;282808;8263;9130;728082;778;90843;1756;5422;7317;5935;347454;29071;207063;4112;412;158506;340602;30848;5127;22866;93380;159091;10159;212;139285;9338;85417;8266;100132399;158584;494118;190;7569;89801;2892;1968;5230;57232;55559;57529;8277;63035;80231;286436;25975;51311;8905;55086;139735;395;83692;171484;10251;169981;1349;63904;139716;257397;142689;80258;27035;1641;55613;7105;100329135;84295;9459;4810;404281;4109;367;474384;6748;139760;347487;92745;158830;53344;4103;9203;139378;186;474343;2719;3597;140456;9248;402415;203430;9185;90161;728042;4129;65267;56849;8228;8226;728036;7114;6399;4952;83740;84889;8481;6757;347468;347475;414;6759;9500;51132;8823;541578;2158;55609;2556;494119;6756;9502;158880;8517;8242;474383;57595;51442;389895;100132304;9754;80311;6102;27328;695;56159;51213;90737;60506;10943;100873985;57526;728269;170082;474382;102723680;728656;3358;8273;83844;114824;389840;170067;81557;80823;8862;2002;7216;79979;158763;23641;55217;8270;57477;7592;2833;425054;340526;727866;139599;139804;54470;8450;959;139562;645864;10075;117154;57631;2010;54521;79589;51634;3750;653282;728072;7076;392490;9363;8623;3920;347411;7454;100506164;265;90293;645051;100529097;55511;158724;6197;203547;139135;5355;347516;203522;139081;6451;27336;158787;728458;7499;4841;347517;51360;340578;139596;1896;441509;54466;660;158798;4108;171482;79868;728075;158833;79366;1821;56156;392465;1260;5160;56062;5303;3054;51260;139628;653220;340596;554;28986;23133;57393;2623;28227;4113;57692;50945;3730;7739;100131755;57481;8260;139170;64219;4204;389860;2574;3563;65991;10325;6170;10813;79710;8712;26280;2316;256714;10742;6173;9104;494197;29057;139324;442444;6103;54880;90736;55558;2742;1736;369;255313;3654;170627;645974;3897;79983;727940;541466;347527;8243;4007;139741;29978;2182;7504;60401;84707;53336;1485;159090;94056;57502;55285;653067;1046;11152;641339;1947;8852;7712;23708;203523;4267;54967;340542;89885;2277;83550;644353;55916;340595;6594;139189;63947;9643;9843;4935;139728;100288814;10479;50943;53940;55026;100507170;5638;4478;8239;4068;51114;139411;246100;9968;84679;115201;100533997;1741;416;64840;10682;11326;25763;27330;171483;8908;27286;1038;7543;158800;90060;1288;84061;215;6247;292;55879;401612;1183;340527;55344;29935;158983;357;10009;2747;2652;286514;340543;54885;100129407;10495;6792;79742;140886;2239;2334;4128;441518;139604;4303;55869;25878;4115;11040;8473;6855;84636;55922;728712;5956;2705;55841;54821;729396;441521;8933;10735;729442;9949;4694;84528;51481;492;3028;100129520;795;10389;83604;7411;9947;9367;100463488;10134;79057;54552;6906;340547;30014;415;5255;680;158809;6990;4435;5475;340529;65109;64860;7030;729428;8776;4675;5030;51566;729201;56271;4943;79917;85012;114928;5256;26609;54960;538;6853;5365;4354;286451;29934;10838;139221;9189;347404;6473;3251;286464;158931;139793;100008586;2717;3052;5973;139065;5199;546;5613;51270;139231;9131;7547;474381;257240;11254;27238;64102;2543;158747;2273;56474;5165;64648;54440;140597;5631;728239;3188;100130086;5251;8237;286527;100130302,815
-1,1,X,60701,155232894,155172193,23096;64061;392509;10214;170685;23157;727837;55998;23439;729431;10916;158586;55859;331;3423;54830;4168;6901;5358;92002;27344;729447;54328;266740;9075;102723737;7552;729422;54954;84460;389874;56000;340562;644538;92552;254158;79649;56850;8225;2824;100272147;51186;3149;26576;100130361;1730;347541;139425;3547;728695;729408;79921;57826;59272;203413;2986;7512;9737;8544;55634;2857;3421;537;11013;340554;5716;6658;4101;54457;1438;91966;441519;4100;5931;27316;7403;4534;6839;51480;728096;27112;92129;101928917;140462;8241;6567;827;203569;27301;84548;645037;54413;100133053;7355;254065;79836;10084;347442;60343;51765;55593;139818;56180;6303;8269;142684;7626;10046;8409;203447;63932;2710;4515;8406;51248;56001;51616;2925;100130613;2564;1193;100132994;5354;11043;340533;22;3476;84631;26748;11238;203562;102723631;170261;58526;441525;4983;29944;6907;1536;2539;1478;9468;23597;2187;1287;81887;6611;3561;9767;9282;54857;347365;10800;139341;54539;11219;728062;169966;51209;23630;26548;1121;2000;645188;51438;2846;280658;1852;347344;23229;10857;56157;286430;101059915;438;5277;9758;1069;4674;154796;56548;51309;1184;645073;80712;1774;10245;2258;728343;9823;441531;11141;643311;90121;256643;23676;4114;6758;4107;286499;5009;1654;1831;51284;94121;170302;11230;79135;286410;9210;2491;441490;84187;633;6191;64743;4110;3598;389856;7789;55787;9452;50814;2157;139422;170062;57187;139067;4104;203427;4693;5456;10013;1964;55190;100996648;293;9016;100528062;30011;90316;93953;10178;6322;28952;24137;2332;4105;6845;94122;84968;64663;1538;9142;286530;2245;5634;9506;79576;3266;139212;5207;6535;8227;393;389852;170626;91851;27334;158866;550643;159013;407;7224;55796;10761;100132963;168400;4281;158835;24140;8471;90167;7737;7319;10149;11279;6134;64109;1678;139322;5063;55906;116442;84443;27197;8233;548313;6872;27018;100129239;139105;7102;10549;26071;2664;59353;8573;28985;79184;728049;728090;158521;3581;139886;282808;8263;9130;728082;778;90843;1756;5422;7317;5935;347454;29071;207063;4112;412;158506;340602;30848;5127;22866;93380;159091;10159;212;139285;9338;85417;8266;100132399;158584;494118;190;7569;89801;2892;1968;5230;57232;55559;57529;8277;63035;80231;286436;25975;51311;8905;55086;139735;395;83692;171484;10251;169981;1349;63904;139716;257397;142689;80258;27035;1641;55613;7105;100329135;84295;9459;4810;404281;4109;367;474384;6748;139760;347487;92745;158830;53344;4103;9203;139378;186;474343;2719;3597;140456;9248;402415;203430;9185;90161;728042;4129;65267;56849;8228;8226;728036;7114;6399;4952;83740;84889;8481;6757;347468;347475;414;6759;9500;51132;8823;541578;2158;55609;2556;494119;6756;9502;158880;8517;8242;474383;57595;51442;389895;100132304;9754;80311;6102;27328;695;56159;51213;90737;60506;10943;100873985;57526;728269;170082;474382;102723680;728656;3358;8273;83844;114824;389840;170067;81557;80823;8862;2002;7216;79979;158763;23641;55217;8270;57477;7592;2833;425054;340526;727866;139599;139804;54470;8450;959;139562;645864;10075;117154;57631;2010;54521;79589;51634;3750;653282;728072;7076;392490;9363;8623;3920;347411;7454;100506164;265;90293;645051;100529097;55511;158724;6197;203547;139135;5355;347516;203522;139081;6451;27336;158787;728458;7499;4841;347517;51360;340578;139596;1896;441509;54466;660;158798;4108;171482;79868;728075;158833;79366;1821;56156;392465;1260;5160;56062;5303;3054;51260;139628;653220;340596;554;28986;23133;57393;2623;28227;4113;57692;50945;3730;7739;100131755;57481;8260;139170;64219;4204;389860;2574;3563;65991;10325;6170;10813;79710;8712;26280;2316;256714;10742;6173;9104;494197;29057;139324;442444;6103;54880;90736;55558;2742;1736;369;255313;3654;170627;645974;3897;79983;727940;541466;347527;8243;4007;139741;29978;2182;7504;60401;84707;53336;1485;159090;94056;57502;55285;653067;1046;11152;641339;1947;8852;7712;23708;203523;4267;54967;340542;89885;2277;83550;644353;55916;340595;6594;139189;63947;9643;9843;4935;139728;100288814;10479;50943;53940;55026;100507170;5638;4478;8239;4068;51114;139411;246100;9968;84679;115201;100533997;1741;416;64840;10682;11326;25763;27330;171483;8908;27286;1038;7543;158800;90060;1288;84061;215;6247;292;55879;401612;1183;340527;55344;29935;158983;357;10009;2747;2652;286514;340543;54885;100129407;10495;6792;79742;140886;2239;2334;4128;441518;139604;4303;55869;25878;4115;11040;8473;6855;84636;55922;728712;5956;2705;55841;54821;729396;441521;8933;10735;729442;9949;4694;84528;51481;492;3028;100129520;795;10389;83604;7411;9947;9367;100463488;10134;79057;54552;6906;340547;30014;415;5255;680;158809;6990;4435;5475;340529;65109;64860;7030;729428;8776;4675;5030;51566;729201;56271;4943;79917;85012;114928;5256;26609;54960;538;6853;5365;4354;286451;29934;10838;139221;9189;347404;6473;3251;286464;158931;139793;100008586;2717;3052;5973;139065;5199;546;5613;51270;139231;9131;7547;474381;257240;11254;27238;64102;2543;158747;2273;56474;5165;64648;54440;140597;5631;728239;3188;100130086;5251;8237;286527;100130302,815
-1,1,X,60701,155232894,155172193,23096;64061;392509;10214;170685;23157;727837;55998;23439;729431;10916;158586;55859;331;3423;54830;4168;6901;5358;92002;27344;729447;54328;266740;9075;102723737;7552;729422;54954;84460;389874;56000;340562;644538;92552;254158;79649;56850;8225;2824;100272147;51186;3149;26576;100130361;1730;347541;139425;3547;728695;729408;79921;57826;59272;203413;2986;7512;9737;8544;55634;2857;3421;537;11013;340554;5716;6658;4101;54457;1438;91966;441519;4100;5931;27316;7403;4534;6839;51480;728096;27112;92129;101928917;140462;8241;6567;827;203569;27301;84548;645037;54413;100133053;7355;254065;79836;10084;347442;60343;51765;55593;139818;56180;6303;8269;142684;7626;10046;8409;203447;63932;2710;4515;8406;51248;56001;51616;2925;100130613;2564;1193;100132994;5354;11043;340533;22;3476;84631;26748;11238;203562;102723631;170261;58526;441525;4983;29944;6907;1536;2539;1478;9468;23597;2187;1287;81887;6611;3561;9767;9282;54857;347365;10800;139341;54539;11219;728062;169966;51209;23630;26548;1121;2000;645188;51438;2846;280658;1852;347344;23229;10857;56157;286430;101059915;438;5277;9758;1069;4674;154796;56548;51309;1184;645073;80712;1774;10245;2258;728343;9823;441531;11141;643311;90121;256643;23676;4114;6758;4107;286499;5009;1654;1831;51284;94121;170302;11230;79135;286410;9210;2491;441490;84187;633;6191;64743;4110;3598;389856;7789;55787;9452;50814;2157;139422;170062;57187;139067;4104;203427;4693;5456;10013;1964;55190;100996648;293;9016;100528062;30011;90316;93953;10178;6322;28952;24137;2332;4105;6845;94122;84968;64663;1538;9142;286530;2245;5634;9506;79576;3266;139212;5207;6535;8227;393;389852;170626;91851;27334;158866;550643;159013;407;7224;55796;10761;100132963;168400;4281;158835;24140;8471;90167;7737;7319;10149;11279;6134;64109;1678;139322;5063;55906;116442;84443;27197;8233;548313;6872;27018;100129239;139105;7102;10549;26071;2664;59353;8573;28985;79184;728049;728090;158521;3581;139886;282808;8263;9130;728082;778;90843;1756;5422;7317;5935;347454;29071;207063;4112;412;158506;340602;30848;5127;22866;93380;159091;10159;212;139285;9338;85417;8266;100132399;158584;494118;190;7569;89801;2892;1968;5230;57232;55559;57529;8277;63035;80231;286436;25975;51311;8905;55086;139735;395;83692;171484;10251;169981;1349;63904;139716;257397;142689;80258;27035;1641;55613;7105;100329135;84295;9459;4810;404281;4109;367;474384;6748;139760;347487;92745;158830;53344;4103;9203;139378;186;474343;2719;3597;140456;9248;402415;203430;9185;90161;728042;4129;65267;56849;8228;8226;728036;7114;6399;4952;83740;84889;8481;6757;347468;347475;414;6759;9500;51132;8823;541578;2158;55609;2556;494119;6756;9502;158880;8517;8242;474383;57595;51442;389895;100132304;9754;80311;6102;27328;695;56159;51213;90737;60506;10943;100873985;57526;728269;170082;474382;102723680;728656;3358;8273;83844;114824;389840;170067;81557;80823;8862;2002;7216;79979;158763;23641;55217;8270;57477;7592;2833;425054;340526;727866;139599;139804;54470;8450;959;139562;645864;10075;117154;57631;2010;54521;79589;51634;3750;653282;728072;7076;392490;9363;8623;3920;347411;7454;100506164;265;90293;645051;100529097;55511;158724;6197;203547;139135;5355;347516;203522;139081;6451;27336;158787;728458;7499;4841;347517;51360;340578;139596;1896;441509;54466;660;158798;4108;171482;79868;728075;158833;79366;1821;56156;392465;1260;5160;56062;5303;3054;51260;139628;653220;340596;554;28986;23133;57393;2623;28227;4113;57692;50945;3730;7739;100131755;57481;8260;139170;64219;4204;389860;2574;3563;65991;10325;6170;10813;79710;8712;26280;2316;256714;10742;6173;9104;494197;29057;139324;442444;6103;54880;90736;55558;2742;1736;369;255313;3654;170627;645974;3897;79983;727940;541466;347527;8243;4007;139741;29978;2182;7504;60401;84707;53336;1485;159090;94056;57502;55285;653067;1046;11152;641339;1947;8852;7712;23708;203523;4267;54967;340542;89885;2277;83550;644353;55916;340595;6594;139189;63947;9643;9843;4935;139728;100288814;10479;50943;53940;55026;100507170;5638;4478;8239;4068;51114;139411;246100;9968;84679;115201;100533997;1741;416;64840;10682;11326;25763;27330;171483;8908;27286;1038;7543;158800;90060;1288;84061;215;6247;292;55879;401612;1183;340527;55344;29935;158983;357;10009;2747;2652;286514;340543;54885;100129407;10495;6792;79742;140886;2239;2334;4128;441518;139604;4303;55869;25878;4115;11040;8473;6855;84636;55922;728712;5956;2705;55841;54821;729396;441521;8933;10735;729442;9949;4694;84528;51481;492;3028;100129520;795;10389;83604;7411;9947;9367;100463488;10134;79057;54552;6906;340547;30014;415;5255;680;158809;6990;4435;5475;340529;65109;64860;7030;729428;8776;4675;5030;51566;729201;56271;4943;79917;85012;114928;5256;26609;54960;538;6853;5365;4354;286451;29934;10838;139221;9189;347404;6473;3251;286464;158931;139793;100008586;2717;3052;5973;139065;5199;546;5613;51270;139231;9131;7547;474381;257240;11254;27238;64102;2543;158747;2273;56474;5165;64648;54440;140597;5631;728239;3188;100130086;5251;8237;286527;100130302,815
-1,1,X,60701,155232907,155172206,23096;64061;392509;10214;170685;23157;727837;55998;23439;729431;10916;158586;55859;331;3423;54830;4168;6901;5358;92002;27344;729447;54328;266740;9075;102723737;7552;729422;54954;84460;389874;56000;340562;644538;92552;254158;79649;56850;8225;2824;100272147;51186;3149;26576;100130361;1730;347541;139425;3547;728695;729408;79921;57826;59272;203413;2986;7512;9737;8544;55634;2857;3421;537;11013;340554;5716;6658;4101;54457;1438;91966;441519;4100;5931;27316;7403;4534;6839;51480;728096;27112;92129;101928917;140462;8241;6567;827;203569;27301;84548;645037;54413;100133053;7355;254065;79836;10084;347442;60343;51765;55593;139818;56180;6303;8269;142684;7626;10046;8409;203447;63932;2710;4515;8406;51248;56001;51616;2925;100130613;2564;1193;100132994;5354;11043;340533;22;3476;84631;26748;11238;203562;102723631;170261;58526;441525;4983;29944;6907;1536;2539;1478;9468;23597;2187;1287;81887;6611;3561;9767;9282;54857;347365;10800;139341;54539;11219;728062;169966;51209;23630;26548;1121;2000;645188;51438;2846;280658;1852;347344;23229;10857;56157;286430;101059915;438;5277;9758;1069;4674;154796;56548;51309;1184;645073;80712;1774;10245;2258;728343;9823;441531;11141;643311;90121;256643;23676;4114;6758;4107;286499;5009;1654;1831;51284;94121;170302;11230;79135;286410;9210;2491;441490;84187;633;6191;64743;4110;3598;389856;7789;55787;9452;50814;2157;139422;170062;57187;139067;4104;203427;4693;5456;10013;1964;55190;100996648;293;9016;100528062;30011;90316;93953;10178;6322;28952;24137;2332;4105;6845;94122;84968;64663;1538;9142;286530;2245;5634;9506;79576;3266;139212;5207;6535;8227;393;389852;170626;91851;27334;158866;550643;159013;407;7224;55796;10761;100132963;168400;4281;158835;24140;8471;90167;7737;7319;10149;11279;6134;64109;1678;139322;5063;55906;116442;84443;27197;8233;548313;6872;27018;100129239;139105;7102;10549;26071;2664;59353;8573;28985;79184;728049;728090;158521;3581;139886;282808;8263;9130;728082;778;90843;1756;5422;7317;5935;347454;29071;207063;4112;412;158506;340602;30848;5127;22866;93380;159091;10159;212;139285;9338;85417;8266;100132399;158584;494118;190;7569;89801;2892;1968;5230;57232;55559;57529;8277;63035;80231;286436;25975;51311;8905;55086;139735;395;83692;171484;10251;169981;1349;63904;139716;257397;142689;80258;27035;1641;55613;7105;100329135;84295;9459;4810;404281;4109;367;474384;6748;139760;347487;92745;158830;53344;4103;9203;139378;186;474343;2719;3597;140456;9248;402415;203430;9185;90161;728042;4129;65267;56849;8228;8226;728036;7114;6399;4952;83740;84889;8481;6757;347468;347475;414;6759;9500;51132;8823;541578;2158;55609;2556;494119;6756;9502;158880;8517;8242;474383;57595;51442;389895;100132304;9754;80311;6102;27328;695;56159;51213;90737;60506;10943;100873985;57526;728269;170082;474382;102723680;728656;3358;8273;83844;114824;389840;170067;81557;80823;8862;2002;7216;79979;158763;23641;55217;8270;57477;7592;2833;425054;340526;727866;139599;139804;54470;8450;959;139562;645864;10075;117154;57631;2010;54521;79589;51634;3750;653282;728072;7076;392490;9363;8623;3920;347411;7454;100506164;265;90293;645051;100529097;55511;158724;6197;203547;139135;5355;347516;203522;139081;6451;27336;158787;728458;7499;4841;347517;51360;340578;139596;1896;441509;54466;660;158798;4108;171482;79868;728075;158833;79366;1821;56156;392465;1260;5160;56062;5303;3054;51260;139628;653220;340596;554;28986;23133;57393;2623;28227;4113;57692;50945;3730;7739;100131755;57481;8260;139170;64219;4204;389860;2574;3563;65991;10325;6170;10813;79710;8712;26280;2316;256714;10742;6173;9104;494197;29057;139324;442444;6103;54880;90736;55558;2742;1736;369;255313;3654;170627;645974;3897;79983;727940;541466;347527;8243;4007;139741;29978;2182;7504;60401;84707;53336;1485;159090;94056;57502;55285;653067;1046;11152;641339;1947;8852;7712;23708;203523;4267;54967;340542;89885;2277;83550;644353;55916;340595;6594;139189;63947;9643;9843;4935;139728;100288814;10479;50943;53940;55026;100507170;5638;4478;8239;4068;51114;139411;246100;9968;84679;115201;100533997;1741;416;64840;10682;11326;25763;27330;171483;8908;27286;1038;7543;158800;90060;1288;84061;215;6247;292;55879;401612;1183;340527;55344;29935;158983;357;10009;2747;2652;286514;340543;54885;100129407;10495;6792;79742;140886;2239;2334;4128;441518;139604;4303;55869;25878;4115;11040;8473;6855;84636;55922;728712;5956;2705;55841;54821;729396;441521;8933;10735;729442;9949;4694;84528;51481;492;3028;100129520;795;10389;83604;7411;9947;9367;100463488;10134;79057;54552;6906;340547;30014;415;5255;680;158809;6990;4435;5475;340529;65109;64860;7030;729428;8776;4675;5030;51566;729201;56271;4943;79917;85012;114928;5256;26609;54960;538;6853;5365;4354;286451;29934;10838;139221;9189;347404;6473;3251;286464;158931;139793;100008586;2717;3052;5973;139065;5199;546;5613;51270;139231;9131;7547;474381;257240;11254;27238;64102;2543;158747;2273;56474;5165;64648;54440;140597;5631;728239;3188;100130086;5251;8237;286527;100130302,815
-1,1,X,60701,155232907,155172206,23096;64061;392509;10214;170685;23157;727837;55998;23439;729431;10916;158586;55859;331;3423;54830;4168;6901;5358;92002;27344;729447;54328;266740;9075;102723737;7552;729422;54954;84460;389874;56000;340562;644538;92552;254158;79649;56850;8225;2824;100272147;51186;3149;26576;100130361;1730;347541;139425;3547;728695;729408;79921;57826;59272;203413;2986;7512;9737;8544;55634;2857;3421;537;11013;340554;5716;6658;4101;54457;1438;91966;441519;4100;5931;27316;7403;4534;6839;51480;728096;27112;92129;101928917;140462;8241;6567;827;203569;27301;84548;645037;54413;100133053;7355;254065;79836;10084;347442;60343;51765;55593;139818;56180;6303;8269;142684;7626;10046;8409;203447;63932;2710;4515;8406;51248;56001;51616;2925;100130613;2564;1193;100132994;5354;11043;340533;22;3476;84631;26748;11238;203562;102723631;170261;58526;441525;4983;29944;6907;1536;2539;1478;9468;23597;2187;1287;81887;6611;3561;9767;9282;54857;347365;10800;139341;54539;11219;728062;169966;51209;23630;26548;1121;2000;645188;51438;2846;280658;1852;347344;23229;10857;56157;286430;101059915;438;5277;9758;1069;4674;154796;56548;51309;1184;645073;80712;1774;10245;2258;728343;9823;441531;11141;643311;90121;256643;23676;4114;6758;4107;286499;5009;1654;1831;51284;94121;170302;11230;79135;286410;9210;2491;441490;84187;633;6191;64743;4110;3598;389856;7789;55787;9452;50814;2157;139422;170062;57187;139067;4104;203427;4693;5456;10013;1964;55190;100996648;293;9016;100528062;30011;90316;93953;10178;6322;28952;24137;2332;4105;6845;94122;84968;64663;1538;9142;286530;2245;5634;9506;79576;3266;139212;5207;6535;8227;393;389852;170626;91851;27334;158866;550643;159013;407;7224;55796;10761;100132963;168400;4281;158835;24140;8471;90167;7737;7319;10149;11279;6134;64109;1678;139322;5063;55906;116442;84443;27197;8233;548313;6872;27018;100129239;139105;7102;10549;26071;2664;59353;8573;28985;79184;728049;728090;158521;3581;139886;282808;8263;9130;728082;778;90843;1756;5422;7317;5935;347454;29071;207063;4112;412;158506;340602;30848;5127;22866;93380;159091;10159;212;139285;9338;85417;8266;100132399;158584;494118;190;7569;89801;2892;1968;5230;57232;55559;57529;8277;63035;80231;286436;25975;51311;8905;55086;139735;395;83692;171484;10251;169981;1349;63904;139716;257397;142689;80258;27035;1641;55613;7105;100329135;84295;9459;4810;404281;4109;367;474384;6748;139760;347487;92745;158830;53344;4103;9203;139378;186;474343;2719;3597;140456;9248;402415;203430;9185;90161;728042;4129;65267;56849;8228;8226;728036;7114;6399;4952;83740;84889;8481;6757;347468;347475;414;6759;9500;51132;8823;541578;2158;55609;2556;494119;6756;9502;158880;8517;8242;474383;57595;51442;389895;100132304;9754;80311;6102;27328;695;56159;51213;90737;60506;10943;100873985;57526;728269;170082;474382;102723680;728656;3358;8273;83844;114824;389840;170067;81557;80823;8862;2002;7216;79979;158763;23641;55217;8270;57477;7592;2833;425054;340526;727866;139599;139804;54470;8450;959;139562;645864;10075;117154;57631;2010;54521;79589;51634;3750;653282;728072;7076;392490;9363;8623;3920;347411;7454;100506164;265;90293;645051;100529097;55511;158724;6197;203547;139135;5355;347516;203522;139081;6451;27336;158787;728458;7499;4841;347517;51360;340578;139596;1896;441509;54466;660;158798;4108;171482;79868;728075;158833;79366;1821;56156;392465;1260;5160;56062;5303;3054;51260;139628;653220;340596;554;28986;23133;57393;2623;28227;4113;57692;50945;3730;7739;100131755;57481;8260;139170;64219;4204;389860;2574;3563;65991;10325;6170;10813;79710;8712;26280;2316;256714;10742;6173;9104;494197;29057;139324;442444;6103;54880;90736;55558;2742;1736;369;255313;3654;170627;645974;3897;79983;727940;541466;347527;8243;4007;139741;29978;2182;7504;60401;84707;53336;1485;159090;94056;57502;55285;653067;1046;11152;641339;1947;8852;7712;23708;203523;4267;54967;340542;89885;2277;83550;644353;55916;340595;6594;139189;63947;9643;9843;4935;139728;100288814;10479;50943;53940;55026;100507170;5638;4478;8239;4068;51114;139411;246100;9968;84679;115201;100533997;1741;416;64840;10682;11326;25763;27330;171483;8908;27286;1038;7543;158800;90060;1288;84061;215;6247;292;55879;401612;1183;340527;55344;29935;158983;357;10009;2747;2652;286514;340543;54885;100129407;10495;6792;79742;140886;2239;2334;4128;441518;139604;4303;55869;25878;4115;11040;8473;6855;84636;55922;728712;5956;2705;55841;54821;729396;441521;8933;10735;729442;9949;4694;84528;51481;492;3028;100129520;795;10389;83604;7411;9947;9367;100463488;10134;79057;54552;6906;340547;30014;415;5255;680;158809;6990;4435;5475;340529;65109;64860;7030;729428;8776;4675;5030;51566;729201;56271;4943;79917;85012;114928;5256;26609;54960;538;6853;5365;4354;286451;29934;10838;139221;9189;347404;6473;3251;286464;158931;139793;100008586;2717;3052;5973;139065;5199;546;5613;51270;139231;9131;7547;474381;257240;11254;27238;64102;2543;158747;2273;56474;5165;64648;54440;140597;5631;728239;3188;100130086;5251;8237;286527;100130302,815
-1,1,X,60701,155232907,155172206,23096;64061;392509;10214;170685;23157;727837;55998;23439;729431;10916;158586;55859;331;3423;54830;4168;6901;5358;92002;27344;729447;54328;266740;9075;102723737;7552;729422;54954;84460;389874;56000;340562;644538;92552;254158;79649;56850;8225;2824;100272147;51186;3149;26576;100130361;1730;347541;139425;3547;728695;729408;79921;57826;59272;203413;2986;7512;9737;8544;55634;2857;3421;537;11013;340554;5716;6658;4101;54457;1438;91966;441519;4100;5931;27316;7403;4534;6839;51480;728096;27112;92129;101928917;140462;8241;6567;827;203569;27301;84548;645037;54413;100133053;7355;254065;79836;10084;347442;60343;51765;55593;139818;56180;6303;8269;142684;7626;10046;8409;203447;63932;2710;4515;8406;51248;56001;51616;2925;100130613;2564;1193;100132994;5354;11043;340533;22;3476;84631;26748;11238;203562;102723631;170261;58526;441525;4983;29944;6907;1536;2539;1478;9468;23597;2187;1287;81887;6611;3561;9767;9282;54857;347365;10800;139341;54539;11219;728062;169966;51209;23630;26548;1121;2000;645188;51438;2846;280658;1852;347344;23229;10857;56157;286430;101059915;438;5277;9758;1069;4674;154796;56548;51309;1184;645073;80712;1774;10245;2258;728343;9823;441531;11141;643311;90121;256643;23676;4114;6758;4107;286499;5009;1654;1831;51284;94121;170302;11230;79135;286410;9210;2491;441490;84187;633;6191;64743;4110;3598;389856;7789;55787;9452;50814;2157;139422;170062;57187;139067;4104;203427;4693;5456;10013;1964;55190;100996648;293;9016;100528062;30011;90316;93953;10178;6322;28952;24137;2332;4105;6845;94122;84968;64663;1538;9142;286530;2245;5634;9506;79576;3266;139212;5207;6535;8227;393;389852;170626;91851;27334;158866;550643;159013;407;7224;55796;10761;100132963;168400;4281;158835;24140;8471;90167;7737;7319;10149;11279;6134;64109;1678;139322;5063;55906;116442;84443;27197;8233;548313;6872;27018;100129239;139105;7102;10549;26071;2664;59353;8573;28985;79184;728049;728090;158521;3581;139886;282808;8263;9130;728082;778;90843;1756;5422;7317;5935;347454;29071;207063;4112;412;158506;340602;30848;5127;22866;93380;159091;10159;212;139285;9338;85417;8266;100132399;158584;494118;190;7569;89801;2892;1968;5230;57232;55559;57529;8277;63035;80231;286436;25975;51311;8905;55086;139735;395;83692;171484;10251;169981;1349;63904;139716;257397;142689;80258;27035;1641;55613;7105;100329135;84295;9459;4810;404281;4109;367;474384;6748;139760;347487;92745;158830;53344;4103;9203;139378;186;474343;2719;3597;140456;9248;402415;203430;9185;90161;728042;4129;65267;56849;8228;8226;728036;7114;6399;4952;83740;84889;8481;6757;347468;347475;414;6759;9500;51132;8823;541578;2158;55609;2556;494119;6756;9502;158880;8517;8242;474383;57595;51442;389895;100132304;9754;80311;6102;27328;695;56159;51213;90737;60506;10943;100873985;57526;728269;170082;474382;102723680;728656;3358;8273;83844;114824;389840;170067;81557;80823;8862;2002;7216;79979;158763;23641;55217;8270;57477;7592;2833;425054;340526;727866;139599;139804;54470;8450;959;139562;645864;10075;117154;57631;2010;54521;79589;51634;3750;653282;728072;7076;392490;9363;8623;3920;347411;7454;100506164;265;90293;645051;100529097;55511;158724;6197;203547;139135;5355;347516;203522;139081;6451;27336;158787;728458;7499;4841;347517;51360;340578;139596;1896;441509;54466;660;158798;4108;171482;79868;728075;158833;79366;1821;56156;392465;1260;5160;56062;5303;3054;51260;139628;653220;340596;554;28986;23133;57393;2623;28227;4113;57692;50945;3730;7739;100131755;57481;8260;139170;64219;4204;389860;2574;3563;65991;10325;6170;10813;79710;8712;26280;2316;256714;10742;6173;9104;494197;29057;139324;442444;6103;54880;90736;55558;2742;1736;369;255313;3654;170627;645974;3897;79983;727940;541466;347527;8243;4007;139741;29978;2182;7504;60401;84707;53336;1485;159090;94056;57502;55285;653067;1046;11152;641339;1947;8852;7712;23708;203523;4267;54967;340542;89885;2277;83550;644353;55916;340595;6594;139189;63947;9643;9843;4935;139728;100288814;10479;50943;53940;55026;100507170;5638;4478;8239;4068;51114;139411;246100;9968;84679;115201;100533997;1741;416;64840;10682;11326;25763;27330;171483;8908;27286;1038;7543;158800;90060;1288;84061;215;6247;292;55879;401612;1183;340527;55344;29935;158983;357;10009;2747;2652;286514;340543;54885;100129407;10495;6792;79742;140886;2239;2334;4128;441518;139604;4303;55869;25878;4115;11040;8473;6855;84636;55922;728712;5956;2705;55841;54821;729396;441521;8933;10735;729442;9949;4694;84528;51481;492;3028;100129520;795;10389;83604;7411;9947;9367;100463488;10134;79057;54552;6906;340547;30014;415;5255;680;158809;6990;4435;5475;340529;65109;64860;7030;729428;8776;4675;5030;51566;729201;56271;4943;79917;85012;114928;5256;26609;54960;538;6853;5365;4354;286451;29934;10838;139221;9189;347404;6473;3251;286464;158931;139793;100008586;2717;3052;5973;139065;5199;546;5613;51270;139231;9131;7547;474381;257240;11254;27238;64102;2543;158747;2273;56474;5165;64648;54440;140597;5631;728239;3188;100130086;5251;8237;286527;100130302,815
1,1,X,60701,155232907,155172206,23096;64061;392509;10214;170685;23157;727837;55998;23439;729431;10916;158586;55859;331;3423;54830;4168;6901;5358;92002;27344;729447;54328;266740;9075;102723737;7552;729422;54954;84460;389874;56000;340562;644538;92552;254158;79649;56850;8225;2824;100272147;51186;3149;26576;100130361;1730;347541;139425;3547;728695;729408;79921;57826;59272;203413;2986;7512;9737;8544;55634;2857;3421;537;11013;340554;5716;6658;4101;54457;1438;91966;441519;4100;5931;27316;7403;4534;6839;51480;728096;27112;92129;101928917;140462;8241;6567;827;203569;27301;84548;645037;54413;100133053;7355;254065;79836;10084;347442;60343;51765;55593;139818;56180;6303;8269;142684;7626;10046;8409;203447;63932;2710;4515;8406;51248;56001;51616;2925;100130613;2564;1193;100132994;5354;11043;340533;22;3476;84631;26748;11238;203562;102723631;170261;58526;441525;4983;29944;6907;1536;2539;1478;9468;23597;2187;1287;81887;6611;3561;9767;9282;54857;347365;10800;139341;54539;11219;728062;169966;51209;23630;26548;1121;2000;645188;51438;2846;280658;1852;347344;23229;10857;56157;286430;101059915;438;5277;9758;1069;4674;154796;56548;51309;1184;645073;80712;1774;10245;2258;728343;9823;441531;11141;643311;90121;256643;23676;4114;6758;4107;286499;5009;1654;1831;51284;94121;170302;11230;79135;286410;9210;2491;441490;84187;633;6191;64743;4110;3598;389856;7789;55787;9452;50814;2157;139422;170062;57187;139067;4104;203427;4693;5456;10013;1964;55190;100996648;293;9016;100528062;30011;90316;93953;10178;6322;28952;24137;2332;4105;6845;94122;84968;64663;1538;9142;286530;2245;5634;9506;79576;3266;139212;5207;6535;8227;393;389852;170626;91851;27334;158866;550643;159013;407;7224;55796;10761;100132963;168400;4281;158835;24140;8471;90167;7737;7319;10149;11279;6134;64109;1678;139322;5063;55906;116442;84443;27197;8233;548313;6872;27018;100129239;139105;7102;10549;26071;2664;59353;8573;28985;79184;728049;728090;158521;3581;139886;282808;8263;9130;728082;778;90843;1756;5422;7317;5935;347454;29071;207063;4112;412;158506;340602;30848;5127;22866;93380;159091;10159;212;139285;9338;85417;8266;100132399;158584;494118;190;7569;89801;2892;1968;5230;57232;55559;57529;8277;63035;80231;286436;25975;51311;8905;55086;139735;395;83692;171484;10251;169981;1349;63904;139716;257397;142689;80258;27035;1641;55613;7105;100329135;84295;9459;4810;404281;4109;367;474384;6748;139760;347487;92745;158830;53344;4103;9203;139378;186;474343;2719;3597;140456;9248;402415;203430;9185;90161;728042;4129;65267;56849;8228;8226;728036;7114;6399;4952;83740;84889;8481;6757;347468;347475;414;6759;9500;51132;8823;541578;2158;55609;2556;494119;6756;9502;158880;8517;8242;474383;57595;51442;389895;100132304;9754;80311;6102;27328;695;56159;51213;90737;60506;10943;100873985;57526;728269;170082;474382;102723680;728656;3358;8273;83844;114824;389840;170067;81557;80823;8862;2002;7216;79979;158763;23641;55217;8270;57477;7592;2833;425054;340526;727866;139599;139804;54470;8450;959;139562;645864;10075;117154;57631;2010;54521;79589;51634;3750;653282;728072;7076;392490;9363;8623;3920;347411;7454;100506164;265;90293;645051;100529097;55511;158724;6197;203547;139135;5355;347516;203522;139081;6451;27336;158787;728458;7499;4841;347517;51360;340578;139596;1896;441509;54466;660;158798;4108;171482;79868;728075;158833;79366;1821;56156;392465;1260;5160;56062;5303;3054;51260;139628;653220;340596;554;28986;23133;57393;2623;28227;4113;57692;50945;3730;7739;100131755;57481;8260;139170;64219;4204;389860;2574;3563;65991;10325;6170;10813;79710;8712;26280;2316;256714;10742;6173;9104;494197;29057;139324;442444;6103;54880;90736;55558;2742;1736;369;255313;3654;170627;645974;3897;79983;727940;541466;347527;8243;4007;139741;29978;2182;7504;60401;84707;53336;1485;159090;94056;57502;55285;653067;1046;11152;641339;1947;8852;7712;23708;203523;4267;54967;340542;89885;2277;83550;644353;55916;340595;6594;139189;63947;9643;9843;4935;139728;100288814;10479;50943;53940;55026;100507170;5638;4478;8239;4068;51114;139411;246100;9968;84679;115201;100533997;1741;416;64840;10682;11326;25763;27330;171483;8908;27286;1038;7543;158800;90060;1288;84061;215;6247;292;55879;401612;1183;340527;55344;29935;158983;357;10009;2747;2652;286514;340543;54885;100129407;10495;6792;79742;140886;2239;2334;4128;441518;139604;4303;55869;25878;4115;11040;8473;6855;84636;55922;728712;5956;2705;55841;54821;729396;441521;8933;10735;729442;9949;4694;84528;51481;492;3028;100129520;795;10389;83604;7411;9947;9367;100463488;10134;79057;54552;6906;340547;30014;415;5255;680;158809;6990;4435;5475;340529;65109;64860;7030;729428;8776;4675;5030;51566;729201;56271;4943;79917;85012;114928;5256;26609;54960;538;6853;5365;4354;286451;29934;10838;139221;9189;347404;6473;3251;286464;158931;139793;100008586;2717;3052;5973;139065;5199;546;5613;51270;139231;9131;7547;474381;257240;11254;27238;64102;2543;158747;2273;56474;5165;64648;54440;140597;5631;728239;3188;100130086;5251;8237;286527;100130302,815
-1,1,X,60701,155232907,155172206,23096;64061;392509;10214;170685;23157;727837;55998;23439;729431;10916;158586;55859;331;3423;54830;4168;6901;5358;92002;27344;729447;54328;266740;9075;102723737;7552;729422;54954;84460;389874;56000;340562;644538;92552;254158;79649;56850;8225;2824;100272147;51186;3149;26576;100130361;1730;347541;139425;3547;728695;729408;79921;57826;59272;203413;2986;7512;9737;8544;55634;2857;3421;537;11013;340554;5716;6658;4101;54457;1438;91966;441519;4100;5931;27316;7403;4534;6839;51480;728096;27112;92129;101928917;140462;8241;6567;827;203569;27301;84548;645037;54413;100133053;7355;254065;79836;10084;347442;60343;51765;55593;139818;56180;6303;8269;142684;7626;10046;8409;203447;63932;2710;4515;8406;51248;56001;51616;2925;100130613;2564;1193;100132994;5354;11043;340533;22;3476;84631;26748;11238;203562;102723631;170261;58526;441525;4983;29944;6907;1536;2539;1478;9468;23597;2187;1287;81887;6611;3561;9767;9282;54857;347365;10800;139341;54539;11219;728062;169966;51209;23630;26548;1121;2000;645188;51438;2846;280658;1852;347344;23229;10857;56157;286430;101059915;438;5277;9758;1069;4674;154796;56548;51309;1184;645073;80712;1774;10245;2258;728343;9823;441531;11141;643311;90121;256643;23676;4114;6758;4107;286499;5009;1654;1831;51284;94121;170302;11230;79135;286410;9210;2491;441490;84187;633;6191;64743;4110;3598;389856;7789;55787;9452;50814;2157;139422;170062;57187;139067;4104;203427;4693;5456;10013;1964;55190;100996648;293;9016;100528062;30011;90316;93953;10178;6322;28952;24137;2332;4105;6845;94122;84968;64663;1538;9142;286530;2245;5634;9506;79576;3266;139212;5207;6535;8227;393;389852;170626;91851;27334;158866;550643;159013;407;7224;55796;10761;100132963;168400;4281;158835;24140;8471;90167;7737;7319;10149;11279;6134;64109;1678;139322;5063;55906;116442;84443;27197;8233;548313;6872;27018;100129239;139105;7102;10549;26071;2664;59353;8573;28985;79184;728049;728090;158521;3581;139886;282808;8263;9130;728082;778;90843;1756;5422;7317;5935;347454;29071;207063;4112;412;158506;340602;30848;5127;22866;93380;159091;10159;212;139285;9338;85417;8266;100132399;158584;494118;190;7569;89801;2892;1968;5230;57232;55559;57529;8277;63035;80231;286436;25975;51311;8905;55086;139735;395;83692;171484;10251;169981;1349;63904;139716;257397;142689;80258;27035;1641;55613;7105;100329135;84295;9459;4810;404281;4109;367;474384;6748;139760;347487;92745;158830;53344;4103;9203;139378;186;474343;2719;3597;140456;9248;402415;203430;9185;90161;728042;4129;65267;56849;8228;8226;728036;7114;6399;4952;83740;84889;8481;6757;347468;347475;414;6759;9500;51132;8823;541578;2158;55609;2556;494119;6756;9502;158880;8517;8242;474383;57595;51442;389895;100132304;9754;80311;6102;27328;695;56159;51213;90737;60506;10943;100873985;57526;728269;170082;474382;102723680;728656;3358;8273;83844;114824;389840;170067;81557;80823;8862;2002;7216;79979;158763;23641;55217;8270;57477;7592;2833;425054;340526;727866;139599;139804;54470;8450;959;139562;645864;10075;117154;57631;2010;54521;79589;51634;3750;653282;728072;7076;392490;9363;8623;3920;347411;7454;100506164;265;90293;645051;100529097;55511;158724;6197;203547;139135;5355;347516;203522;139081;6451;27336;158787;728458;7499;4841;347517;51360;340578;139596;1896;441509;54466;660;158798;4108;171482;79868;728075;158833;79366;1821;56156;392465;1260;5160;56062;5303;3054;51260;139628;653220;340596;554;28986;23133;57393;2623;28227;4113;57692;50945;3730;7739;100131755;57481;8260;139170;64219;4204;389860;2574;3563;65991;10325;6170;10813;79710;8712;26280;2316;256714;10742;6173;9104;494197;29057;139324;442444;6103;54880;90736;55558;2742;1736;369;255313;3654;170627;645974;3897;79983;727940;541466;347527;8243;4007;139741;29978;2182;7504;60401;84707;53336;1485;159090;94056;57502;55285;653067;1046;11152;641339;1947;8852;7712;23708;203523;4267;54967;340542;89885;2277;83550;644353;55916;340595;6594;139189;63947;9643;9843;4935;139728;100288814;10479;50943;53940;55026;100507170;5638;4478;8239;4068;51114;139411;246100;9968;84679;115201;100533997;1741;416;64840;10682;11326;25763;27330;171483;8908;27286;1038;7543;158800;90060;1288;84061;215;6247;292;55879;401612;1183;340527;55344;29935;158983;357;10009;2747;2652;286514;340543;54885;100129407;10495;6792;79742;140886;2239;2334;4128;441518;139604;4303;55869;25878;4115;11040;8473;6855;84636;55922;728712;5956;2705;55841;54821;729396;441521;8933;10735;729442;9949;4694;84528;51481;492;3028;100129520;795;10389;83604;7411;9947;9367;100463488;10134;79057;54552;6906;340547;30014;415;5255;680;158809;6990;4435;5475;340529;65109;64860;7030;729428;8776;4675;5030;51566;729201;56271;4943;79917;85012;114928;5256;26609;54960;538;6853;5365;4354;286451;29934;10838;139221;9189;347404;6473;3251;286464;158931;139793;100008586;2717;3052;5973;139065;5199;546;5613;51270;139231;9131;7547;474381;257240;11254;27238;64102;2543;158747;2273;56474;5165;64648;54440;140597;5631;728239;3188;100130086;5251;8237;286527;100130302,815
-1,1,X,60701,155232907,155172206,23096;64061;392509;10214;170685;23157;727837;55998;23439;729431;10916;158586;55859;331;3423;54830;4168;6901;5358;92002;27344;729447;54328;266740;9075;102723737;7552;729422;54954;84460;389874;56000;340562;644538;92552;254158;79649;56850;8225;2824;100272147;51186;3149;26576;100130361;1730;347541;139425;3547;728695;729408;79921;57826;59272;203413;2986;7512;9737;8544;55634;2857;3421;537;11013;340554;5716;6658;4101;54457;1438;91966;441519;4100;5931;27316;7403;4534;6839;51480;728096;27112;92129;101928917;140462;8241;6567;827;203569;27301;84548;645037;54413;100133053;7355;254065;79836;10084;347442;60343;51765;55593;139818;56180;6303;8269;142684;7626;10046;8409;203447;63932;2710;4515;8406;51248;56001;51616;2925;100130613;2564;1193;100132994;5354;11043;340533;22;3476;84631;26748;11238;203562;102723631;170261;58526;441525;4983;29944;6907;1536;2539;1478;9468;23597;2187;1287;81887;6611;3561;9767;9282;54857;347365;10800;139341;54539;11219;728062;169966;51209;23630;26548;1121;2000;645188;51438;2846;280658;1852;347344;23229;10857;56157;286430;101059915;438;5277;9758;1069;4674;154796;56548;51309;1184;645073;80712;1774;10245;2258;728343;9823;441531;11141;643311;90121;256643;23676;4114;6758;4107;286499;5009;1654;1831;51284;94121;170302;11230;79135;286410;9210;2491;441490;84187;633;6191;64743;4110;3598;389856;7789;55787;9452;50814;2157;139422;170062;57187;139067;4104;203427;4693;5456;10013;1964;55190;100996648;293;9016;100528062;30011;90316;93953;10178;6322;28952;24137;2332;4105;6845;94122;84968;64663;1538;9142;286530;2245;5634;9506;79576;3266;139212;5207;6535;8227;393;389852;170626;91851;27334;158866;550643;159013;407;7224;55796;10761;100132963;168400;4281;158835;24140;8471;90167;7737;7319;10149;11279;6134;64109;1678;139322;5063;55906;116442;84443;27197;8233;548313;6872;27018;100129239;139105;7102;10549;26071;2664;59353;8573;28985;79184;728049;728090;158521;3581;139886;282808;8263;9130;728082;778;90843;1756;5422;7317;5935;347454;29071;207063;4112;412;158506;340602;30848;5127;22866;93380;159091;10159;212;139285;9338;85417;8266;100132399;158584;494118;190;7569;89801;2892;1968;5230;57232;55559;57529;8277;63035;80231;286436;25975;51311;8905;55086;139735;395;83692;171484;10251;169981;1349;63904;139716;257397;142689;80258;27035;1641;55613;7105;100329135;84295;9459;4810;404281;4109;367;474384;6748;139760;347487;92745;158830;53344;4103;9203;139378;186;474343;2719;3597;140456;9248;402415;203430;9185;90161;728042;4129;65267;56849;8228;8226;728036;7114;6399;4952;83740;84889;8481;6757;347468;347475;414;6759;9500;51132;8823;541578;2158;55609;2556;494119;6756;9502;158880;8517;8242;474383;57595;51442;389895;100132304;9754;80311;6102;27328;695;56159;51213;90737;60506;10943;100873985;57526;728269;170082;474382;102723680;728656;3358;8273;83844;114824;389840;170067;81557;80823;8862;2002;7216;79979;158763;23641;55217;8270;57477;7592;2833;425054;340526;727866;139599;139804;54470;8450;959;139562;645864;10075;117154;57631;2010;54521;79589;51634;3750;653282;728072;7076;392490;9363;8623;3920;347411;7454;100506164;265;90293;645051;100529097;55511;158724;6197;203547;139135;5355;347516;203522;139081;6451;27336;158787;728458;7499;4841;347517;51360;340578;139596;1896;441509;54466;660;158798;4108;171482;79868;728075;158833;79366;1821;56156;392465;1260;5160;56062;5303;3054;51260;139628;653220;340596;554;28986;23133;57393;2623;28227;4113;57692;50945;3730;7739;100131755;57481;8260;139170;64219;4204;389860;2574;3563;65991;10325;6170;10813;79710;8712;26280;2316;256714;10742;6173;9104;494197;29057;139324;442444;6103;54880;90736;55558;2742;1736;369;255313;3654;170627;645974;3897;79983;727940;541466;347527;8243;4007;139741;29978;2182;7504;60401;84707;53336;1485;159090;94056;57502;55285;653067;1046;11152;641339;1947;8852;7712;23708;203523;4267;54967;340542;89885;2277;83550;644353;55916;340595;6594;139189;63947;9643;9843;4935;139728;100288814;10479;50943;53940;55026;100507170;5638;4478;8239;4068;51114;139411;246100;9968;84679;115201;100533997;1741;416;64840;10682;11326;25763;27330;171483;8908;27286;1038;7543;158800;90060;1288;84061;215;6247;292;55879;401612;1183;340527;55344;29935;158983;357;10009;2747;2652;286514;340543;54885;100129407;10495;6792;79742;140886;2239;2334;4128;441518;139604;4303;55869;25878;4115;11040;8473;6855;84636;55922;728712;5956;2705;55841;54821;729396;441521;8933;10735;729442;9949;4694;84528;51481;492;3028;100129520;795;10389;83604;7411;9947;9367;100463488;10134;79057;54552;6906;340547;30014;415;5255;680;158809;6990;4435;5475;340529;65109;64860;7030;729428;8776;4675;5030;51566;729201;56271;4943;79917;85012;114928;5256;26609;54960;538;6853;5365;4354;286451;29934;10838;139221;9189;347404;6473;3251;286464;158931;139793;100008586;2717;3052;5973;139065;5199;546;5613;51270;139231;9131;7547;474381;257240;11254;27238;64102;2543;158747;2273;56474;5165;64648;54440;140597;5631;728239;3188;100130086;5251;8237;286527;100130302,815
-1,1,X,60701,155232907,155172206,23096;64061;392509;10214;170685;23157;727837;55998;23439;729431;10916;158586;55859;331;3423;54830;4168;6901;5358;92002;27344;729447;54328;266740;9075;102723737;7552;729422;54954;84460;389874;56000;340562;644538;92552;254158;79649;56850;8225;2824;100272147;51186;3149;26576;100130361;1730;347541;139425;3547;728695;729408;79921;57826;59272;203413;2986;7512;9737;8544;55634;2857;3421;537;11013;340554;5716;6658;4101;54457;1438;91966;441519;4100;5931;27316;7403;4534;6839;51480;728096;27112;92129;101928917;140462;8241;6567;827;203569;27301;84548;645037;54413;100133053;7355;254065;79836;10084;347442;60343;51765;55593;139818;56180;6303;8269;142684;7626;10046;8409;203447;63932;2710;4515;8406;51248;56001;51616;2925;100130613;2564;1193;100132994;5354;11043;340533;22;3476;84631;26748;11238;203562;102723631;170261;58526;441525;4983;29944;6907;1536;2539;1478;9468;23597;2187;1287;81887;6611;3561;9767;9282;54857;347365;10800;139341;54539;11219;728062;169966;51209;23630;26548;1121;2000;645188;51438;2846;280658;1852;347344;23229;10857;56157;286430;101059915;438;5277;9758;1069;4674;154796;56548;51309;1184;645073;80712;1774;10245;2258;728343;9823;441531;11141;643311;90121;256643;23676;4114;6758;4107;286499;5009;1654;1831;51284;94121;170302;11230;79135;286410;9210;2491;441490;84187;633;6191;64743;4110;3598;389856;7789;55787;9452;50814;2157;139422;170062;57187;139067;4104;203427;4693;5456;10013;1964;55190;100996648;293;9016;100528062;30011;90316;93953;10178;6322;28952;24137;2332;4105;6845;94122;84968;64663;1538;9142;286530;2245;5634;9506;79576;3266;139212;5207;6535;8227;393;389852;170626;91851;27334;158866;550643;159013;407;7224;55796;10761;100132963;168400;4281;158835;24140;8471;90167;7737;7319;10149;11279;6134;64109;1678;139322;5063;55906;116442;84443;27197;8233;548313;6872;27018;100129239;139105;7102;10549;26071;2664;59353;8573;28985;79184;728049;728090;158521;3581;139886;282808;8263;9130;728082;778;90843;1756;5422;7317;5935;347454;29071;207063;4112;412;158506;340602;30848;5127;22866;93380;159091;10159;212;139285;9338;85417;8266;100132399;158584;494118;190;7569;89801;2892;1968;5230;57232;55559;57529;8277;63035;80231;286436;25975;51311;8905;55086;139735;395;83692;171484;10251;169981;1349;63904;139716;257397;142689;80258;27035;1641;55613;7105;100329135;84295;9459;4810;404281;4109;367;474384;6748;139760;347487;92745;158830;53344;4103;9203;139378;186;474343;2719;3597;140456;9248;402415;203430;9185;90161;728042;4129;65267;56849;8228;8226;728036;7114;6399;4952;83740;84889;8481;6757;347468;347475;414;6759;9500;51132;8823;541578;2158;55609;2556;494119;6756;9502;158880;8517;8242;474383;57595;51442;389895;100132304;9754;80311;6102;27328;695;56159;51213;90737;60506;10943;100873985;57526;728269;170082;474382;102723680;728656;3358;8273;83844;114824;389840;170067;81557;80823;8862;2002;7216;79979;158763;23641;55217;8270;57477;7592;2833;425054;340526;727866;139599;139804;54470;8450;959;139562;645864;10075;117154;57631;2010;54521;79589;51634;3750;653282;728072;7076;392490;9363;8623;3920;347411;7454;100506164;265;90293;645051;100529097;55511;158724;6197;203547;139135;5355;347516;203522;139081;6451;27336;158787;728458;7499;4841;347517;51360;340578;139596;1896;441509;54466;660;158798;4108;171482;79868;728075;158833;79366;1821;56156;392465;1260;5160;56062;5303;3054;51260;139628;653220;340596;554;28986;23133;57393;2623;28227;4113;57692;50945;3730;7739;100131755;57481;8260;139170;64219;4204;389860;2574;3563;65991;10325;6170;10813;79710;8712;26280;2316;256714;10742;6173;9104;494197;29057;139324;442444;6103;54880;90736;55558;2742;1736;369;255313;3654;170627;645974;3897;79983;727940;541466;347527;8243;4007;139741;29978;2182;7504;60401;84707;53336;1485;159090;94056;57502;55285;653067;1046;11152;641339;1947;8852;7712;23708;203523;4267;54967;340542;89885;2277;83550;644353;55916;340595;6594;139189;63947;9643;9843;4935;139728;100288814;10479;50943;53940;55026;100507170;5638;4478;8239;4068;51114;139411;246100;9968;84679;115201;100533997;1741;416;64840;10682;11326;25763;27330;171483;8908;27286;1038;7543;158800;90060;1288;84061;215;6247;292;55879;401612;1183;340527;55344;29935;158983;357;10009;2747;2652;286514;340543;54885;100129407;10495;6792;79742;140886;2239;2334;4128;441518;139604;4303;55869;25878;4115;11040;8473;6855;84636;55922;728712;5956;2705;55841;54821;729396;441521;8933;10735;729442;9949;4694;84528;51481;492;3028;100129520;795;10389;83604;7411;9947;9367;100463488;10134;79057;54552;6906;340547;30014;415;5255;680;158809;6990;4435;5475;340529;65109;64860;7030;729428;8776;4675;5030;51566;729201;56271;4943;79917;85012;114928;5256;26609;54960;538;6853;5365;4354;286451;29934;10838;139221;9189;347404;6473;3251;286464;158931;139793;100008586;2717;3052;5973;139065;5199;546;5613;51270;139231;9131;7547;474381;257240;11254;27238;64102;2543;158747;2273;56474;5165;64648;54440;140597;5631;728239;3188;100130086;5251;8237;286527;100130302,815
1,1,X,60701,155232907,155172206,23096;64061;392509;10214;170685;23157;727837;55998;23439;729431;10916;158586;55859;331;3423;54830;4168;6901;5358;92002;27344;729447;54328;266740;9075;102723737;7552;729422;54954;84460;389874;56000;340562;644538;92552;254158;79649;56850;8225;2824;100272147;51186;3149;26576;100130361;1730;347541;139425;3547;728695;729408;79921;57826;59272;203413;2986;7512;9737;8544;55634;2857;3421;537;11013;340554;5716;6658;4101;54457;1438;91966;441519;4100;5931;27316;7403;4534;6839;51480;728096;27112;92129;101928917;140462;8241;6567;827;203569;27301;84548;645037;54413;100133053;7355;254065;79836;10084;347442;60343;51765;55593;139818;56180;6303;8269;142684;7626;10046;8409;203447;63932;2710;4515;8406;51248;56001;51616;2925;100130613;2564;1193;100132994;5354;11043;340533;22;3476;84631;26748;11238;203562;102723631;170261;58526;441525;4983;29944;6907;1536;2539;1478;9468;23597;2187;1287;81887;6611;3561;9767;9282;54857;347365;10800;139341;54539;11219;728062;169966;51209;23630;26548;1121;2000;645188;51438;2846;280658;1852;347344;23229;10857;56157;286430;101059915;438;5277;9758;1069;4674;154796;56548;51309;1184;645073;80712;1774;10245;2258;728343;9823;441531;11141;643311;90121;256643;23676;4114;6758;4107;286499;5009;1654;1831;51284;94121;170302;11230;79135;286410;9210;2491;441490;84187;633;6191;64743;4110;3598;389856;7789;55787;9452;50814;2157;139422;170062;57187;139067;4104;203427;4693;5456;10013;1964;55190;100996648;293;9016;100528062;30011;90316;93953;10178;6322;28952;24137;2332;4105;6845;94122;84968;64663;1538;9142;286530;2245;5634;9506;79576;3266;139212;5207;6535;8227;393;389852;170626;91851;27334;158866;550643;159013;407;7224;55796;10761;100132963;168400;4281;158835;24140;8471;90167;7737;7319;10149;11279;6134;64109;1678;139322;5063;55906;116442;84443;27197;8233;548313;6872;27018;100129239;139105;7102;10549;26071;2664;59353;8573;28985;79184;728049;728090;158521;3581;139886;282808;8263;9130;728082;778;90843;1756;5422;7317;5935;347454;29071;207063;4112;412;158506;340602;30848;5127;22866;93380;159091;10159;212;139285;9338;85417;8266;100132399;158584;494118;190;7569;89801;2892;1968;5230;57232;55559;57529;8277;63035;80231;286436;25975;51311;8905;55086;139735;395;83692;171484;10251;169981;1349;63904;139716;257397;142689;80258;27035;1641;55613;7105;100329135;84295;9459;4810;404281;4109;367;474384;6748;139760;347487;92745;158830;53344;4103;9203;139378;186;474343;2719;3597;140456;9248;402415;203430;9185;90161;728042;4129;65267;56849;8228;8226;728036;7114;6399;4952;83740;84889;8481;6757;347468;347475;414;6759;9500;51132;8823;541578;2158;55609;2556;494119;6756;9502;158880;8517;8242;474383;57595;51442;389895;100132304;9754;80311;6102;27328;695;56159;51213;90737;60506;10943;100873985;57526;728269;170082;474382;102723680;728656;3358;8273;83844;114824;389840;170067;81557;80823;8862;2002;7216;79979;158763;23641;55217;8270;57477;7592;2833;425054;340526;727866;139599;139804;54470;8450;959;139562;645864;10075;117154;57631;2010;54521;79589;51634;3750;653282;728072;7076;392490;9363;8623;3920;347411;7454;100506164;265;90293;645051;100529097;55511;158724;6197;203547;139135;5355;347516;203522;139081;6451;27336;158787;728458;7499;4841;347517;51360;340578;139596;1896;441509;54466;660;158798;4108;171482;79868;728075;158833;79366;1821;56156;392465;1260;5160;56062;5303;3054;51260;139628;653220;340596;554;28986;23133;57393;2623;28227;4113;57692;50945;3730;7739;100131755;57481;8260;139170;64219;4204;389860;2574;3563;65991;10325;6170;10813;79710;8712;26280;2316;256714;10742;6173;9104;494197;29057;139324;442444;6103;54880;90736;55558;2742;1736;369;255313;3654;170627;645974;3897;79983;727940;541466;347527;8243;4007;139741;29978;2182;7504;60401;84707;53336;1485;159090;94056;57502;55285;653067;1046;11152;641339;1947;8852;7712;23708;203523;4267;54967;340542;89885;2277;83550;644353;55916;340595;6594;139189;63947;9643;9843;4935;139728;100288814;10479;50943;53940;55026;100507170;5638;4478;8239;4068;51114;139411;246100;9968;84679;115201;100533997;1741;416;64840;10682;11326;25763;27330;171483;8908;27286;1038;7543;158800;90060;1288;84061;215;6247;292;55879;401612;1183;340527;55344;29935;158983;357;10009;2747;2652;286514;340543;54885;100129407;10495;6792;79742;140886;2239;2334;4128;441518;139604;4303;55869;25878;4115;11040;8473;6855;84636;55922;728712;5956;2705;55841;54821;729396;441521;8933;10735;729442;9949;4694;84528;51481;492;3028;100129520;795;10389;83604;7411;9947;9367;100463488;10134;79057;54552;6906;340547;30014;415;5255;680;158809;6990;4435;5475;340529;65109;64860;7030;729428;8776;4675;5030;51566;729201;56271;4943;79917;85012;114928;5256;26609;54960;538;6853;5365;4354;286451;29934;10838;139221;9189;347404;6473;3251;286464;158931;139793;100008586;2717;3052;5973;139065;5199;546;5613;51270;139231;9131;7547;474381;257240;11254;27238;64102;2543;158747;2273;56474;5165;64648;54440;140597;5631;728239;3188;100130086;5251;8237;286527;100130302,815
1,1,X,60701,155232907,155172206,23096;64061;392509;10214;170685;23157;727837;55998;23439;729431;10916;158586;55859;331;3423;54830;4168;6901;5358;92002;27344;729447;54328;266740;9075;102723737;7552;729422;54954;84460;389874;56000;340562;644538;92552;254158;79649;56850;8225;2824;100272147;51186;3149;26576;100130361;1730;347541;139425;3547;728695;729408;79921;57826;59272;203413;2986;7512;9737;8544;55634;2857;3421;537;11013;340554;5716;6658;4101;54457;1438;91966;441519;4100;5931;27316;7403;4534;6839;51480;728096;27112;92129;101928917;140462;8241;6567;827;203569;27301;84548;645037;54413;100133053;7355;254065;79836;10084;347442;60343;51765;55593;139818;56180;6303;8269;142684;7626;10046;8409;203447;63932;2710;4515;8406;51248;56001;51616;2925;100130613;2564;1193;100132994;5354;11043;340533;22;3476;84631;26748;11238;203562;102723631;170261;58526;441525;4983;29944;6907;1536;2539;1478;9468;23597;2187;1287;81887;6611;3561;9767;9282;54857;347365;10800;139341;54539;11219;728062;169966;51209;23630;26548;1121;2000;645188;51438;2846;280658;1852;347344;23229;10857;56157;286430;101059915;438;5277;9758;1069;4674;154796;56548;51309;1184;645073;80712;1774;10245;2258;728343;9823;441531;11141;643311;90121;256643;23676;4114;6758;4107;286499;5009;1654;1831;51284;94121;170302;11230;79135;286410;9210;2491;441490;84187;633;6191;64743;4110;3598;389856;7789;55787;9452;50814;2157;139422;170062;57187;139067;4104;203427;4693;5456;10013;1964;55190;100996648;293;9016;100528062;30011;90316;93953;10178;6322;28952;24137;2332;4105;6845;94122;84968;64663;1538;9142;286530;2245;5634;9506;79576;3266;139212;5207;6535;8227;393;389852;170626;91851;27334;158866;550643;159013;407;7224;55796;10761;100132963;168400;4281;158835;24140;8471;90167;7737;7319;10149;11279;6134;64109;1678;139322;5063;55906;116442;84443;27197;8233;548313;6872;27018;100129239;139105;7102;10549;26071;2664;59353;8573;28985;79184;728049;728090;158521;3581;139886;282808;8263;9130;728082;778;90843;1756;5422;7317;5935;347454;29071;207063;4112;412;158506;340602;30848;5127;22866;93380;159091;10159;212;139285;9338;85417;8266;100132399;158584;494118;190;7569;89801;2892;1968;5230;57232;55559;57529;8277;63035;80231;286436;25975;51311;8905;55086;139735;395;83692;171484;10251;169981;1349;63904;139716;257397;142689;80258;27035;1641;55613;7105;100329135;84295;9459;4810;404281;4109;367;474384;6748;139760;347487;92745;158830;53344;4103;9203;139378;186;474343;2719;3597;140456;9248;402415;203430;9185;90161;728042;4129;65267;56849;8228;8226;728036;7114;6399;4952;83740;84889;8481;6757;347468;347475;414;6759;9500;51132;8823;541578;2158;55609;2556;494119;6756;9502;158880;8517;8242;474383;57595;51442;389895;100132304;9754;80311;6102;27328;695;56159;51213;90737;60506;10943;100873985;57526;728269;170082;474382;102723680;728656;3358;8273;83844;114824;389840;170067;81557;80823;8862;2002;7216;79979;158763;23641;55217;8270;57477;7592;2833;425054;340526;727866;139599;139804;54470;8450;959;139562;645864;10075;117154;57631;2010;54521;79589;51634;3750;653282;728072;7076;392490;9363;8623;3920;347411;7454;100506164;265;90293;645051;100529097;55511;158724;6197;203547;139135;5355;347516;203522;139081;6451;27336;158787;728458;7499;4841;347517;51360;340578;139596;1896;441509;54466;660;158798;4108;171482;79868;728075;158833;79366;1821;56156;392465;1260;5160;56062;5303;3054;51260;139628;653220;340596;554;28986;23133;57393;2623;28227;4113;57692;50945;3730;7739;100131755;57481;8260;139170;64219;4204;389860;2574;3563;65991;10325;6170;10813;79710;8712;26280;2316;256714;10742;6173;9104;494197;29057;139324;442444;6103;54880;90736;55558;2742;1736;369;255313;3654;170627;645974;3897;79983;727940;541466;347527;8243;4007;139741;29978;2182;7504;60401;84707;53336;1485;159090;94056;57502;55285;653067;1046;11152;641339;1947;8852;7712;23708;203523;4267;54967;340542;89885;2277;83550;644353;55916;340595;6594;139189;63947;9643;9843;4935;139728;100288814;10479;50943;53940;55026;100507170;5638;4478;8239;4068;51114;139411;246100;9968;84679;115201;100533997;1741;416;64840;10682;11326;25763;27330;171483;8908;27286;1038;7543;158800;90060;1288;84061;215;6247;292;55879;401612;1183;340527;55344;29935;158983;357;10009;2747;2652;286514;340543;54885;100129407;10495;6792;79742;140886;2239;2334;4128;441518;139604;4303;55869;25878;4115;11040;8473;6855;84636;55922;728712;5956;2705;55841;54821;729396;441521;8933;10735;729442;9949;4694;84528;51481;492;3028;100129520;795;10389;83604;7411;9947;9367;100463488;10134;79057;54552;6906;340547;30014;415;5255;680;158809;6990;4435;5475;340529;65109;64860;7030;729428;8776;4675;5030;51566;729201;56271;4943;79917;85012;114928;5256;26609;54960;538;6853;5365;4354;286451;29934;10838;139221;9189;347404;6473;3251;286464;158931;139793;100008586;2717;3052;5973;139065;5199;546;5613;51270;139231;9131;7547;474381;257240;11254;27238;64102;2543;158747;2273;56474;5165;64648;54440;140597;5631;728239;3188;100130086;5251;8237;286527;100130302,815
-1,1,X,60701,155232907,155172206,23096;64061;392509;10214;170685;23157;727837;55998;23439;729431;10916;158586;55859;331;3423;54830;4168;6901;5358;92002;27344;729447;54328;266740;9075;102723737;7552;729422;54954;84460;389874;56000;340562;644538;92552;254158;79649;56850;8225;2824;100272147;51186;3149;26576;100130361;1730;347541;139425;3547;728695;729408;79921;57826;59272;203413;2986;7512;9737;8544;55634;2857;3421;537;11013;340554;5716;6658;4101;54457;1438;91966;441519;4100;5931;27316;7403;4534;6839;51480;728096;27112;92129;101928917;140462;8241;6567;827;203569;27301;84548;645037;54413;100133053;7355;254065;79836;10084;347442;60343;51765;55593;139818;56180;6303;8269;142684;7626;10046;8409;203447;63932;2710;4515;8406;51248;56001;51616;2925;100130613;2564;1193;100132994;5354;11043;340533;22;3476;84631;26748;11238;203562;102723631;170261;58526;441525;4983;29944;6907;1536;2539;1478;9468;23597;2187;1287;81887;6611;3561;9767;9282;54857;347365;10800;139341;54539;11219;728062;169966;51209;23630;26548;1121;2000;645188;51438;2846;280658;1852;347344;23229;10857;56157;286430;101059915;438;5277;9758;1069;4674;154796;56548;51309;1184;645073;80712;1774;10245;2258;728343;9823;441531;11141;643311;90121;256643;23676;4114;6758;4107;286499;5009;1654;1831;51284;94121;170302;11230;79135;286410;9210;2491;441490;84187;633;6191;64743;4110;3598;389856;7789;55787;9452;50814;2157;139422;170062;57187;139067;4104;203427;4693;5456;10013;1964;55190;100996648;293;9016;100528062;30011;90316;93953;10178;6322;28952;24137;2332;4105;6845;94122;84968;64663;1538;9142;286530;2245;5634;9506;79576;3266;139212;5207;6535;8227;393;389852;170626;91851;27334;158866;550643;159013;407;7224;55796;10761;100132963;168400;4281;158835;24140;8471;90167;7737;7319;10149;11279;6134;64109;1678;139322;5063;55906;116442;84443;27197;8233;548313;6872;27018;100129239;139105;7102;10549;26071;2664;59353;8573;28985;79184;728049;728090;158521;3581;139886;282808;8263;9130;728082;778;90843;1756;5422;7317;5935;347454;29071;207063;4112;412;158506;340602;30848;5127;22866;93380;159091;10159;212;139285;9338;85417;8266;100132399;158584;494118;190;7569;89801;2892;1968;5230;57232;55559;57529;8277;63035;80231;286436;25975;51311;8905;55086;139735;395;83692;171484;10251;169981;1349;63904;139716;257397;142689;80258;27035;1641;55613;7105;100329135;84295;9459;4810;404281;4109;367;474384;6748;139760;347487;92745;158830;53344;4103;9203;139378;186;474343;2719;3597;140456;9248;402415;203430;9185;90161;728042;4129;65267;56849;8228;8226;728036;7114;6399;4952;83740;84889;8481;6757;347468;347475;414;6759;9500;51132;8823;541578;2158;55609;2556;494119;6756;9502;158880;8517;8242;474383;57595;51442;389895;100132304;9754;80311;6102;27328;695;56159;51213;90737;60506;10943;100873985;57526;728269;170082;474382;102723680;728656;3358;8273;83844;114824;389840;170067;81557;80823;8862;2002;7216;79979;158763;23641;55217;8270;57477;7592;2833;425054;340526;727866;139599;139804;54470;8450;959;139562;645864;10075;117154;57631;2010;54521;79589;51634;3750;653282;728072;7076;392490;9363;8623;3920;347411;7454;100506164;265;90293;645051;100529097;55511;158724;6197;203547;139135;5355;347516;203522;139081;6451;27336;158787;728458;7499;4841;347517;51360;340578;139596;1896;441509;54466;660;158798;4108;171482;79868;728075;158833;79366;1821;56156;392465;1260;5160;56062;5303;3054;51260;139628;653220;340596;554;28986;23133;57393;2623;28227;4113;57692;50945;3730;7739;100131755;57481;8260;139170;64219;4204;389860;2574;3563;65991;10325;6170;10813;79710;8712;26280;2316;256714;10742;6173;9104;494197;29057;139324;442444;6103;54880;90736;55558;2742;1736;369;255313;3654;170627;645974;3897;79983;727940;541466;347527;8243;4007;139741;29978;2182;7504;60401;84707;53336;1485;159090;94056;57502;55285;653067;1046;11152;641339;1947;8852;7712;23708;203523;4267;54967;340542;89885;2277;83550;644353;55916;340595;6594;139189;63947;9643;9843;4935;139728;100288814;10479;50943;53940;55026;100507170;5638;4478;8239;4068;51114;139411;246100;9968;84679;115201;100533997;1741;416;64840;10682;11326;25763;27330;171483;8908;27286;1038;7543;158800;90060;1288;84061;215;6247;292;55879;401612;1183;340527;55344;29935;158983;357;10009;2747;2652;286514;340543;54885;100129407;10495;6792;79742;140886;2239;2334;4128;441518;139604;4303;55869;25878;4115;11040;8473;6855;84636;55922;728712;5956;2705;55841;54821;729396;441521;8933;10735;729442;9949;4694;84528;51481;492;3028;100129520;795;10389;83604;7411;9947;9367;100463488;10134;79057;54552;6906;340547;30014;415;5255;680;158809;6990;4435;5475;340529;65109;64860;7030;729428;8776;4675;5030;51566;729201;56271;4943;79917;85012;114928;5256;26609;54960;538;6853;5365;4354;286451;29934;10838;139221;9189;347404;6473;3251;286464;158931;139793;100008586;2717;3052;5973;139065;5199;546;5613;51270;139231;9131;7547;474381;257240;11254;27238;64102;2543;158747;2273;56474;5165;64648;54440;140597;5631;728239;3188;100130086;5251;8237;286527;100130302,815
1,1,X,60701,155232907,155172206,23096;64061;392509;10214;170685;23157;727837;55998;23439;729431;10916;158586;55859;331;3423;54830;4168;6901;5358;92002;27344;729447;54328;266740;9075;102723737;7552;729422;54954;84460;389874;56000;340562;644538;92552;254158;79649;56850;8225;2824;100272147;51186;3149;26576;100130361;1730;347541;139425;3547;728695;729408;79921;57826;59272;203413;2986;7512;9737;8544;55634;2857;3421;537;11013;340554;5716;6658;4101;54457;1438;91966;441519;4100;5931;27316;7403;4534;6839;51480;728096;27112;92129;101928917;140462;8241;6567;827;203569;27301;84548;645037;54413;100133053;7355;254065;79836;10084;347442;60343;51765;55593;139818;56180;6303;8269;142684;7626;10046;8409;203447;63932;2710;4515;8406;51248;56001;51616;2925;100130613;2564;1193;100132994;5354;11043;340533;22;3476;84631;26748;11238;203562;102723631;170261;58526;441525;4983;29944;6907;1536;2539;1478;9468;23597;2187;1287;81887;6611;3561;9767;9282;54857;347365;10800;139341;54539;11219;728062;169966;51209;23630;26548;1121;2000;645188;51438;2846;280658;1852;347344;23229;10857;56157;286430;101059915;438;5277;9758;1069;4674;154796;56548;51309;1184;645073;80712;1774;10245;2258;728343;9823;441531;11141;643311;90121;256643;23676;4114;6758;4107;286499;5009;1654;1831;51284;94121;170302;11230;79135;286410;9210;2491;441490;84187;633;6191;64743;4110;3598;389856;7789;55787;9452;50814;2157;139422;170062;57187;139067;4104;203427;4693;5456;10013;1964;55190;100996648;293;9016;100528062;30011;90316;93953;10178;6322;28952;24137;2332;4105;6845;94122;84968;64663;1538;9142;286530;2245;5634;9506;79576;3266;139212;5207;6535;8227;393;389852;170626;91851;27334;158866;550643;159013;407;7224;55796;10761;100132963;168400;4281;158835;24140;8471;90167;7737;7319;10149;11279;6134;64109;1678;139322;5063;55906;116442;84443;27197;8233;548313;6872;27018;100129239;139105;7102;10549;26071;2664;59353;8573;28985;79184;728049;728090;158521;3581;139886;282808;8263;9130;728082;778;90843;1756;5422;7317;5935;347454;29071;207063;4112;412;158506;340602;30848;5127;22866;93380;159091;10159;212;139285;9338;85417;8266;100132399;158584;494118;190;7569;89801;2892;1968;5230;57232;55559;57529;8277;63035;80231;286436;25975;51311;8905;55086;139735;395;83692;171484;10251;169981;1349;63904;139716;257397;142689;80258;27035;1641;55613;7105;100329135;84295;9459;4810;404281;4109;367;474384;6748;139760;347487;92745;158830;53344;4103;9203;139378;186;474343;2719;3597;140456;9248;402415;203430;9185;90161;728042;4129;65267;56849;8228;8226;728036;7114;6399;4952;83740;84889;8481;6757;347468;347475;414;6759;9500;51132;8823;541578;2158;55609;2556;494119;6756;9502;158880;8517;8242;474383;57595;51442;389895;100132304;9754;80311;6102;27328;695;56159;51213;90737;60506;10943;100873985;57526;728269;170082;474382;102723680;728656;3358;8273;83844;114824;389840;170067;81557;80823;8862;2002;7216;79979;158763;23641;55217;8270;57477;7592;2833;425054;340526;727866;139599;139804;54470;8450;959;139562;645864;10075;117154;57631;2010;54521;79589;51634;3750;653282;728072;7076;392490;9363;8623;3920;347411;7454;100506164;265;90293;645051;100529097;55511;158724;6197;203547;139135;5355;347516;203522;139081;6451;27336;158787;728458;7499;4841;347517;51360;340578;139596;1896;441509;54466;660;158798;4108;171482;79868;728075;158833;79366;1821;56156;392465;1260;5160;56062;5303;3054;51260;139628;653220;340596;554;28986;23133;57393;2623;28227;4113;57692;50945;3730;7739;100131755;57481;8260;139170;64219;4204;389860;2574;3563;65991;10325;6170;10813;79710;8712;26280;2316;256714;10742;6173;9104;494197;29057;139324;442444;6103;54880;90736;55558;2742;1736;369;255313;3654;170627;645974;3897;79983;727940;541466;347527;8243;4007;139741;29978;2182;7504;60401;84707;53336;1485;159090;94056;57502;55285;653067;1046;11152;641339;1947;8852;7712;23708;203523;4267;54967;340542;89885;2277;83550;644353;55916;340595;6594;139189;63947;9643;9843;4935;139728;100288814;10479;50943;53940;55026;100507170;5638;4478;8239;4068;51114;139411;246100;9968;84679;115201;100533997;1741;416;64840;10682;11326;25763;27330;171483;8908;27286;1038;7543;158800;90060;1288;84061;215;6247;292;55879;401612;1183;340527;55344;29935;158983;357;10009;2747;2652;286514;340543;54885;100129407;10495;6792;79742;140886;2239;2334;4128;441518;139604;4303;55869;25878;4115;11040;8473;6855;84636;55922;728712;5956;2705;55841;54821;729396;441521;8933;10735;729442;9949;4694;84528;51481;492;3028;100129520;795;10389;83604;7411;9947;9367;100463488;10134;79057;54552;6906;340547;30014;415;5255;680;158809;6990;4435;5475;340529;65109;64860;7030;729428;8776;4675;5030;51566;729201;56271;4943;79917;85012;114928;5256;26609;54960;538;6853;5365;4354;286451;29934;10838;139221;9189;347404;6473;3251;286464;158931;139793;100008586;2717;3052;5973;139065;5199;546;5613;51270;139231;9131;7547;474381;257240;11254;27238;64102;2543;158747;2273;56474;5165;64648;54440;140597;5631;728239;3188;100130086;5251;8237;286527;100130302,815
-1,1,X,60701,155232907,155172206,23096;64061;392509;10214;170685;23157;727837;55998;23439;729431;10916;158586;55859;331;3423;54830;4168;6901;5358;92002;27344;729447;54328;266740;9075;102723737;7552;729422;54954;84460;389874;56000;340562;644538;92552;254158;79649;56850;8225;2824;100272147;51186;3149;26576;100130361;1730;347541;139425;3547;728695;729408;79921;57826;59272;203413;2986;7512;9737;8544;55634;2857;3421;537;11013;340554;5716;6658;4101;54457;1438;91966;441519;4100;5931;27316;7403;4534;6839;51480;728096;27112;92129;101928917;140462;8241;6567;827;203569;27301;84548;645037;54413;100133053;7355;254065;79836;10084;347442;60343;51765;55593;139818;56180;6303;8269;142684;7626;10046;8409;203447;63932;2710;4515;8406;51248;56001;51616;2925;100130613;2564;1193;100132994;5354;11043;340533;22;3476;84631;26748;11238;203562;102723631;170261;58526;441525;4983;29944;6907;1536;2539;1478;9468;23597;2187;1287;81887;6611;3561;9767;9282;54857;347365;10800;139341;54539;11219;728062;169966;51209;23630;26548;1121;2000;645188;51438;2846;280658;1852;347344;23229;10857;56157;286430;101059915;438;5277;9758;1069;4674;154796;56548;51309;1184;645073;80712;1774;10245;2258;728343;9823;441531;11141;643311;90121;256643;23676;4114;6758;4107;286499;5009;1654;1831;51284;94121;170302;11230;79135;286410;9210;2491;441490;84187;633;6191;64743;4110;3598;389856;7789;55787;9452;50814;2157;139422;170062;57187;139067;4104;203427;4693;5456;10013;1964;55190;100996648;293;9016;100528062;30011;90316;93953;10178;6322;28952;24137;2332;4105;6845;94122;84968;64663;1538;9142;286530;2245;5634;9506;79576;3266;139212;5207;6535;8227;393;389852;170626;91851;27334;158866;550643;159013;407;7224;55796;10761;100132963;168400;4281;158835;24140;8471;90167;7737;7319;10149;11279;6134;64109;1678;139322;5063;55906;116442;84443;27197;8233;548313;6872;27018;100129239;139105;7102;10549;26071;2664;59353;8573;28985;79184;728049;728090;158521;3581;139886;282808;8263;9130;728082;778;90843;1756;5422;7317;5935;347454;29071;207063;4112;412;158506;340602;30848;5127;22866;93380;159091;10159;212;139285;9338;85417;8266;100132399;158584;494118;190;7569;89801;2892;1968;5230;57232;55559;57529;8277;63035;80231;286436;25975;51311;8905;55086;139735;395;83692;171484;10251;169981;1349;63904;139716;257397;142689;80258;27035;1641;55613;7105;100329135;84295;9459;4810;404281;4109;367;474384;6748;139760;347487;92745;158830;53344;4103;9203;139378;186;474343;2719;3597;140456;9248;402415;203430;9185;90161;728042;4129;65267;56849;8228;8226;728036;7114;6399;4952;83740;84889;8481;6757;347468;347475;414;6759;9500;51132;8823;541578;2158;55609;2556;494119;6756;9502;158880;8517;8242;474383;57595;51442;389895;100132304;9754;80311;6102;27328;695;56159;51213;90737;60506;10943;100873985;57526;728269;170082;474382;102723680;728656;3358;8273;83844;114824;389840;170067;81557;80823;8862;2002;7216;79979;158763;23641;55217;8270;57477;7592;2833;425054;340526;727866;139599;139804;54470;8450;959;139562;645864;10075;117154;57631;2010;54521;79589;51634;3750;653282;728072;7076;392490;9363;8623;3920;347411;7454;100506164;265;90293;645051;100529097;55511;158724;6197;203547;139135;5355;347516;203522;139081;6451;27336;158787;728458;7499;4841;347517;51360;340578;139596;1896;441509;54466;660;158798;4108;171482;79868;728075;158833;79366;1821;56156;392465;1260;5160;56062;5303;3054;51260;139628;653220;340596;554;28986;23133;57393;2623;28227;4113;57692;50945;3730;7739;100131755;57481;8260;139170;64219;4204;389860;2574;3563;65991;10325;6170;10813;79710;8712;26280;2316;256714;10742;6173;9104;494197;29057;139324;442444;6103;54880;90736;55558;2742;1736;369;255313;3654;170627;645974;3897;79983;727940;541466;347527;8243;4007;139741;29978;2182;7504;60401;84707;53336;1485;159090;94056;57502;55285;653067;1046;11152;641339;1947;8852;7712;23708;203523;4267;54967;340542;89885;2277;83550;644353;55916;340595;6594;139189;63947;9643;9843;4935;139728;100288814;10479;50943;53940;55026;100507170;5638;4478;8239;4068;51114;139411;246100;9968;84679;115201;100533997;1741;416;64840;10682;11326;25763;27330;171483;8908;27286;1038;7543;158800;90060;1288;84061;215;6247;292;55879;401612;1183;340527;55344;29935;158983;357;10009;2747;2652;286514;340543;54885;100129407;10495;6792;79742;140886;2239;2334;4128;441518;139604;4303;55869;25878;4115;11040;8473;6855;84636;55922;728712;5956;2705;55841;54821;729396;441521;8933;10735;729442;9949;4694;84528;51481;492;3028;100129520;795;10389;83604;7411;9947;9367;100463488;10134;79057;54552;6906;340547;30014;415;5255;680;158809;6990;4435;5475;340529;65109;64860;7030;729428;8776;4675;5030;51566;729201;56271;4943;79917;85012;114928;5256;26609;54960;538;6853;5365;4354;286451;29934;10838;139221;9189;347404;6473;3251;286464;158931;139793;100008586;2717;3052;5973;139065;5199;546;5613;51270;139231;9131;7547;474381;257240;11254;27238;64102;2543;158747;2273;56474;5165;64648;54440;140597;5631;728239;3188;100130086;5251;8237;286527;100130302,815
1,1,X,60701,155232907,155172206,23096;64061;392509;10214;170685;23157;727837;55998;23439;729431;10916;158586;55859;331;3423;54830;4168;6901;5358;92002;27344;729447;54328;266740;9075;102723737;7552;729422;54954;84460;389874;56000;340562;644538;92552;254158;79649;56850;8225;2824;100272147;51186;3149;26576;100130361;1730;347541;139425;3547;728695;729408;79921;57826;59272;203413;2986;7512;9737;8544;55634;2857;3421;537;11013;340554;5716;6658;4101;54457;1438;91966;441519;4100;5931;27316;7403;4534;6839;51480;728096;27112;92129;101928917;140462;8241;6567;827;203569;27301;84548;645037;54413;100133053;7355;254065;79836;10084;347442;60343;51765;55593;139818;56180;6303;8269;142684;7626;10046;8409;203447;63932;2710;4515;8406;51248;56001;51616;2925;100130613;2564;1193;100132994;5354;11043;340533;22;3476;84631;26748;11238;203562;102723631;170261;58526;441525;4983;29944;6907;1536;2539;1478;9468;23597;2187;1287;81887;6611;3561;9767;9282;54857;347365;10800;139341;54539;11219;728062;169966;51209;23630;26548;1121;2000;645188;51438;2846;280658;1852;347344;23229;10857;56157;286430;101059915;438;5277;9758;1069;4674;154796;56548;51309;1184;645073;80712;1774;10245;2258;728343;9823;441531;11141;643311;90121;256643;23676;4114;6758;4107;286499;5009;1654;1831;51284;94121;170302;11230;79135;286410;9210;2491;441490;84187;633;6191;64743;4110;3598;389856;7789;55787;9452;50814;2157;139422;170062;57187;139067;4104;203427;4693;5456;10013;1964;55190;100996648;293;9016;100528062;30011;90316;93953;10178;6322;28952;24137;2332;4105;6845;94122;84968;64663;1538;9142;286530;2245;5634;9506;79576;3266;139212;5207;6535;8227;393;389852;170626;91851;27334;158866;550643;159013;407;7224;55796;10761;100132963;168400;4281;158835;24140;8471;90167;7737;7319;10149;11279;6134;64109;1678;139322;5063;55906;116442;84443;27197;8233;548313;6872;27018;100129239;139105;7102;10549;26071;2664;59353;8573;28985;79184;728049;728090;158521;3581;139886;282808;8263;9130;728082;778;90843;1756;5422;7317;5935;347454;29071;207063;4112;412;158506;340602;30848;5127;22866;93380;159091;10159;212;139285;9338;85417;8266;100132399;158584;494118;190;7569;89801;2892;1968;5230;57232;55559;57529;8277;63035;80231;286436;25975;51311;8905;55086;139735;395;83692;171484;10251;169981;1349;63904;139716;257397;142689;80258;27035;1641;55613;7105;100329135;84295;9459;4810;404281;4109;367;474384;6748;139760;347487;92745;158830;53344;4103;9203;139378;186;474343;2719;3597;140456;9248;402415;203430;9185;90161;728042;4129;65267;56849;8228;8226;728036;7114;6399;4952;83740;84889;8481;6757;347468;347475;414;6759;9500;51132;8823;541578;2158;55609;2556;494119;6756;9502;158880;8517;8242;474383;57595;51442;389895;100132304;9754;80311;6102;27328;695;56159;51213;90737;60506;10943;100873985;57526;728269;170082;474382;102723680;728656;3358;8273;83844;114824;389840;170067;81557;80823;8862;2002;7216;79979;158763;23641;55217;8270;57477;7592;2833;425054;340526;727866;139599;139804;54470;8450;959;139562;645864;10075;117154;57631;2010;54521;79589;51634;3750;653282;728072;7076;392490;9363;8623;3920;347411;7454;100506164;265;90293;645051;100529097;55511;158724;6197;203547;139135;5355;347516;203522;139081;6451;27336;158787;728458;7499;4841;347517;51360;340578;139596;1896;441509;54466;660;158798;4108;171482;79868;728075;158833;79366;1821;56156;392465;1260;5160;56062;5303;3054;51260;139628;653220;340596;554;28986;23133;57393;2623;28227;4113;57692;50945;3730;7739;100131755;57481;8260;139170;64219;4204;389860;2574;3563;65991;10325;6170;10813;79710;8712;26280;2316;256714;10742;6173;9104;494197;29057;139324;442444;6103;54880;90736;55558;2742;1736;369;255313;3654;170627;645974;3897;79983;727940;541466;347527;8243;4007;139741;29978;2182;7504;60401;84707;53336;1485;159090;94056;57502;55285;653067;1046;11152;641339;1947;8852;7712;23708;203523;4267;54967;340542;89885;2277;83550;644353;55916;340595;6594;139189;63947;9643;9843;4935;139728;100288814;10479;50943;53940;55026;100507170;5638;4478;8239;4068;51114;139411;246100;9968;84679;115201;100533997;1741;416;64840;10682;11326;25763;27330;171483;8908;27286;1038;7543;158800;90060;1288;84061;215;6247;292;55879;401612;1183;340527;55344;29935;158983;357;10009;2747;2652;286514;340543;54885;100129407;10495;6792;79742;140886;2239;2334;4128;441518;139604;4303;55869;25878;4115;11040;8473;6855;84636;55922;728712;5956;2705;55841;54821;729396;441521;8933;10735;729442;9949;4694;84528;51481;492;3028;100129520;795;10389;83604;7411;9947;9367;100463488;10134;79057;54552;6906;340547;30014;415;5255;680;158809;6990;4435;5475;340529;65109;64860;7030;729428;8776;4675;5030;51566;729201;56271;4943;79917;85012;114928;5256;26609;54960;538;6853;5365;4354;286451;29934;10838;139221;9189;347404;6473;3251;286464;158931;139793;100008586;2717;3052;5973;139065;5199;546;5613;51270;139231;9131;7547;474381;257240;11254;27238;64102;2543;158747;2273;56474;5165;64648;54440;140597;5631;728239;3188;100130086;5251;8237;286527;100130302,815
-1,1,X,60701,155232907,155172206,23096;64061;392509;10214;170685;23157;727837;55998;23439;729431;10916;158586;55859;331;3423;54830;4168;6901;5358;92002;27344;729447;54328;266740;9075;102723737;7552;729422;54954;84460;389874;56000;340562;644538;92552;254158;79649;56850;8225;2824;100272147;51186;3149;26576;100130361;1730;347541;139425;3547;728695;729408;79921;57826;59272;203413;2986;7512;9737;8544;55634;2857;3421;537;11013;340554;5716;6658;4101;54457;1438;91966;441519;4100;5931;27316;7403;4534;6839;51480;728096;27112;92129;101928917;140462;8241;6567;827;203569;27301;84548;645037;54413;100133053;7355;254065;79836;10084;347442;60343;51765;55593;139818;56180;6303;8269;142684;7626;10046;8409;203447;63932;2710;4515;8406;51248;56001;51616;2925;100130613;2564;1193;100132994;5354;11043;340533;22;3476;84631;26748;11238;203562;102723631;170261;58526;441525;4983;29944;6907;1536;2539;1478;9468;23597;2187;1287;81887;6611;3561;9767;9282;54857;347365;10800;139341;54539;11219;728062;169966;51209;23630;26548;1121;2000;645188;51438;2846;280658;1852;347344;23229;10857;56157;286430;101059915;438;5277;9758;1069;4674;154796;56548;51309;1184;645073;80712;1774;10245;2258;728343;9823;441531;11141;643311;90121;256643;23676;4114;6758;4107;286499;5009;1654;1831;51284;94121;170302;11230;79135;286410;9210;2491;441490;84187;633;6191;64743;4110;3598;389856;7789;55787;9452;50814;2157;139422;170062;57187;139067;4104;203427;4693;5456;10013;1964;55190;100996648;293;9016;100528062;30011;90316;93953;10178;6322;28952;24137;2332;4105;6845;94122;84968;64663;1538;9142;286530;2245;5634;9506;79576;3266;139212;5207;6535;8227;393;389852;170626;91851;27334;158866;550643;159013;407;7224;55796;10761;100132963;168400;4281;158835;24140;8471;90167;7737;7319;10149;11279;6134;64109;1678;139322;5063;55906;116442;84443;27197;8233;548313;6872;27018;100129239;139105;7102;10549;26071;2664;59353;8573;28985;79184;728049;728090;158521;3581;139886;282808;8263;9130;728082;778;90843;1756;5422;7317;5935;347454;29071;207063;4112;412;158506;340602;30848;5127;22866;93380;159091;10159;212;139285;9338;85417;8266;100132399;158584;494118;190;7569;89801;2892;1968;5230;57232;55559;57529;8277;63035;80231;286436;25975;51311;8905;55086;139735;395;83692;171484;10251;169981;1349;63904;139716;257397;142689;80258;27035;1641;55613;7105;100329135;84295;9459;4810;404281;4109;367;474384;6748;139760;347487;92745;158830;53344;4103;9203;139378;186;474343;2719;3597;140456;9248;402415;203430;9185;90161;728042;4129;65267;56849;8228;8226;728036;7114;6399;4952;83740;84889;8481;6757;347468;347475;414;6759;9500;51132;8823;541578;2158;55609;2556;494119;6756;9502;158880;8517;8242;474383;57595;51442;389895;100132304;9754;80311;6102;27328;695;56159;51213;90737;60506;10943;100873985;57526;728269;170082;474382;102723680;728656;3358;8273;83844;114824;389840;170067;81557;80823;8862;2002;7216;79979;158763;23641;55217;8270;57477;7592;2833;425054;340526;727866;139599;139804;54470;8450;959;139562;645864;10075;117154;57631;2010;54521;79589;51634;3750;653282;728072;7076;392490;9363;8623;3920;347411;7454;100506164;265;90293;645051;100529097;55511;158724;6197;203547;139135;5355;347516;203522;139081;6451;27336;158787;728458;7499;4841;347517;51360;340578;139596;1896;441509;54466;660;158798;4108;171482;79868;728075;158833;79366;1821;56156;392465;1260;5160;56062;5303;3054;51260;139628;653220;340596;554;28986;23133;57393;2623;28227;4113;57692;50945;3730;7739;100131755;57481;8260;139170;64219;4204;389860;2574;3563;65991;10325;6170;10813;79710;8712;26280;2316;256714;10742;6173;9104;494197;29057;139324;442444;6103;54880;90736;55558;2742;1736;369;255313;3654;170627;645974;3897;79983;727940;541466;347527;8243;4007;139741;29978;2182;7504;60401;84707;53336;1485;159090;94056;57502;55285;653067;1046;11152;641339;1947;8852;7712;23708;203523;4267;54967;340542;89885;2277;83550;644353;55916;340595;6594;139189;63947;9643;9843;4935;139728;100288814;10479;50943;53940;55026;100507170;5638;4478;8239;4068;51114;139411;246100;9968;84679;115201;100533997;1741;416;64840;10682;11326;25763;27330;171483;8908;27286;1038;7543;158800;90060;1288;84061;215;6247;292;55879;401612;1183;340527;55344;29935;158983;357;10009;2747;2652;286514;340543;54885;100129407;10495;6792;79742;140886;2239;2334;4128;441518;139604;4303;55869;25878;4115;11040;8473;6855;84636;55922;728712;5956;2705;55841;54821;729396;441521;8933;10735;729442;9949;4694;84528;51481;492;3028;100129520;795;10389;83604;7411;9947;9367;100463488;10134;79057;54552;6906;340547;30014;415;5255;680;158809;6990;4435;5475;340529;65109;64860;7030;729428;8776;4675;5030;51566;729201;56271;4943;79917;85012;114928;5256;26609;54960;538;6853;5365;4354;286451;29934;10838;139221;9189;347404;6473;3251;286464;158931;139793;100008586;2717;3052;5973;139065;5199;546;5613;51270;139231;9131;7547;474381;257240;11254;27238;64102;2543;158747;2273;56474;5165;64648;54440;140597;5631;728239;3188;100130086;5251;8237;286527;100130302,815
-1,1,X,60701,155232907,155172206,23096;64061;392509;10214;170685;23157;727837;55998;23439;729431;10916;158586;55859;331;3423;54830;4168;6901;5358;92002;27344;729447;54328;266740;9075;102723737;7552;729422;54954;84460;389874;56000;340562;644538;92552;254158;79649;56850;8225;2824;100272147;51186;3149;26576;100130361;1730;347541;139425;3547;728695;729408;79921;57826;59272;203413;2986;7512;9737;8544;55634;2857;3421;537;11013;340554;5716;6658;4101;54457;1438;91966;441519;4100;5931;27316;7403;4534;6839;51480;728096;27112;92129;101928917;140462;8241;6567;827;203569;27301;84548;645037;54413;100133053;7355;254065;79836;10084;347442;60343;51765;55593;139818;56180;6303;8269;142684;7626;10046;8409;203447;63932;2710;4515;8406;51248;56001;51616;2925;100130613;2564;1193;100132994;5354;11043;340533;22;3476;84631;26748;11238;203562;102723631;170261;58526;441525;4983;29944;6907;1536;2539;1478;9468;23597;2187;1287;81887;6611;3561;9767;9282;54857;347365;10800;139341;54539;11219;728062;169966;51209;23630;26548;1121;2000;645188;51438;2846;280658;1852;347344;23229;10857;56157;286430;101059915;438;5277;9758;1069;4674;154796;56548;51309;1184;645073;80712;1774;10245;2258;728343;9823;441531;11141;643311;90121;256643;23676;4114;6758;4107;286499;5009;1654;1831;51284;94121;170302;11230;79135;286410;9210;2491;441490;84187;633;6191;64743;4110;3598;389856;7789;55787;9452;50814;2157;139422;170062;57187;139067;4104;203427;4693;5456;10013;1964;55190;100996648;293;9016;100528062;30011;90316;93953;10178;6322;28952;24137;2332;4105;6845;94122;84968;64663;1538;9142;286530;2245;5634;9506;79576;3266;139212;5207;6535;8227;393;389852;170626;91851;27334;158866;550643;159013;407;7224;55796;10761;100132963;168400;4281;158835;24140;8471;90167;7737;7319;10149;11279;6134;64109;1678;139322;5063;55906;116442;84443;27197;8233;548313;6872;27018;100129239;139105;7102;10549;26071;2664;59353;8573;28985;79184;728049;728090;158521;3581;139886;282808;8263;9130;728082;778;90843;1756;5422;7317;5935;347454;29071;207063;4112;412;158506;340602;30848;5127;22866;93380;159091;10159;212;139285;9338;85417;8266;100132399;158584;494118;190;7569;89801;2892;1968;5230;57232;55559;57529;8277;63035;80231;286436;25975;51311;8905;55086;139735;395;83692;171484;10251;169981;1349;63904;139716;257397;142689;80258;27035;1641;55613;7105;100329135;84295;9459;4810;404281;4109;367;474384;6748;139760;347487;92745;158830;53344;4103;9203;139378;186;474343;2719;3597;140456;9248;402415;203430;9185;90161;728042;4129;65267;56849;8228;8226;728036;7114;6399;4952;83740;84889;8481;6757;347468;347475;414;6759;9500;51132;8823;541578;2158;55609;2556;494119;6756;9502;158880;8517;8242;474383;57595;51442;389895;100132304;9754;80311;6102;27328;695;56159;51213;90737;60506;10943;100873985;57526;728269;170082;474382;102723680;728656;3358;8273;83844;114824;389840;170067;81557;80823;8862;2002;7216;79979;158763;23641;55217;8270;57477;7592;2833;425054;340526;727866;139599;139804;54470;8450;959;139562;645864;10075;117154;57631;2010;54521;79589;51634;3750;653282;728072;7076;392490;9363;8623;3920;347411;7454;100506164;265;90293;645051;100529097;55511;158724;6197;203547;139135;5355;347516;203522;139081;6451;27336;158787;728458;7499;4841;347517;51360;340578;139596;1896;441509;54466;660;158798;4108;171482;79868;728075;158833;79366;1821;56156;392465;1260;5160;56062;5303;3054;51260;139628;653220;340596;554;28986;23133;57393;2623;28227;4113;57692;50945;3730;7739;100131755;57481;8260;139170;64219;4204;389860;2574;3563;65991;10325;6170;10813;79710;8712;26280;2316;256714;10742;6173;9104;494197;29057;139324;442444;6103;54880;90736;55558;2742;1736;369;255313;3654;170627;645974;3897;79983;727940;541466;347527;8243;4007;139741;29978;2182;7504;60401;84707;53336;1485;159090;94056;57502;55285;653067;1046;11152;641339;1947;8852;7712;23708;203523;4267;54967;340542;89885;2277;83550;644353;55916;340595;6594;139189;63947;9643;9843;4935;139728;100288814;10479;50943;53940;55026;100507170;5638;4478;8239;4068;51114;139411;246100;9968;84679;115201;100533997;1741;416;64840;10682;11326;25763;27330;171483;8908;27286;1038;7543;158800;90060;1288;84061;215;6247;292;55879;401612;1183;340527;55344;29935;158983;357;10009;2747;2652;286514;340543;54885;100129407;10495;6792;79742;140886;2239;2334;4128;441518;139604;4303;55869;25878;4115;11040;8473;6855;84636;55922;728712;5956;2705;55841;54821;729396;441521;8933;10735;729442;9949;4694;84528;51481;492;3028;100129520;795;10389;83604;7411;9947;9367;100463488;10134;79057;54552;6906;340547;30014;415;5255;680;158809;6990;4435;5475;340529;65109;64860;7030;729428;8776;4675;5030;51566;729201;56271;4943;79917;85012;114928;5256;26609;54960;538;6853;5365;4354;286451;29934;10838;139221;9189;347404;6473;3251;286464;158931;139793;100008586;2717;3052;5973;139065;5199;546;5613;51270;139231;9131;7547;474381;257240;11254;27238;64102;2543;158747;2273;56474;5165;64648;54440;140597;5631;728239;3188;100130086;5251;8237;286527;100130302,815
-1,1,X,60701,155232907,155172206,23096;64061;392509;10214;170685;23157;727837;55998;23439;729431;10916;158586;55859;331;3423;54830;4168;6901;5358;92002;27344;729447;54328;266740;9075;102723737;7552;729422;54954;84460;389874;56000;340562;644538;92552;254158;79649;56850;8225;2824;100272147;51186;3149;26576;100130361;1730;347541;139425;3547;728695;729408;79921;57826;59272;203413;2986;7512;9737;8544;55634;2857;3421;537;11013;340554;5716;6658;4101;54457;1438;91966;441519;4100;5931;27316;7403;4534;6839;51480;728096;27112;92129;101928917;140462;8241;6567;827;203569;27301;84548;645037;54413;100133053;7355;254065;79836;10084;347442;60343;51765;55593;139818;56180;6303;8269;142684;7626;10046;8409;203447;63932;2710;4515;8406;51248;56001;51616;2925;100130613;2564;1193;100132994;5354;11043;340533;22;3476;84631;26748;11238;203562;102723631;170261;58526;441525;4983;29944;6907;1536;2539;1478;9468;23597;2187;1287;81887;6611;3561;9767;9282;54857;347365;10800;139341;54539;11219;728062;169966;51209;23630;26548;1121;2000;645188;51438;2846;280658;1852;347344;23229;10857;56157;286430;101059915;438;5277;9758;1069;4674;154796;56548;51309;1184;645073;80712;1774;10245;2258;728343;9823;441531;11141;643311;90121;256643;23676;4114;6758;4107;286499;5009;1654;1831;51284;94121;170302;11230;79135;286410;9210;2491;441490;84187;633;6191;64743;4110;3598;389856;7789;55787;9452;50814;2157;139422;170062;57187;139067;4104;203427;4693;5456;10013;1964;55190;100996648;293;9016;100528062;30011;90316;93953;10178;6322;28952;24137;2332;4105;6845;94122;84968;64663;1538;9142;286530;2245;5634;9506;79576;3266;139212;5207;6535;8227;393;389852;170626;91851;27334;158866;550643;159013;407;7224;55796;10761;100132963;168400;4281;158835;24140;8471;90167;7737;7319;10149;11279;6134;64109;1678;139322;5063;55906;116442;84443;27197;8233;548313;6872;27018;100129239;139105;7102;10549;26071;2664;59353;8573;28985;79184;728049;728090;158521;3581;139886;282808;8263;9130;728082;778;90843;1756;5422;7317;5935;347454;29071;207063;4112;412;158506;340602;30848;5127;22866;93380;159091;10159;212;139285;9338;85417;8266;100132399;158584;494118;190;7569;89801;2892;1968;5230;57232;55559;57529;8277;63035;80231;286436;25975;51311;8905;55086;139735;395;83692;171484;10251;169981;1349;63904;139716;257397;142689;80258;27035;1641;55613;7105;100329135;84295;9459;4810;404281;4109;367;474384;6748;139760;347487;92745;158830;53344;4103;9203;139378;186;474343;2719;3597;140456;9248;402415;203430;9185;90161;728042;4129;65267;56849;8228;8226;728036;7114;6399;4952;83740;84889;8481;6757;347468;347475;414;6759;9500;51132;8823;541578;2158;55609;2556;494119;6756;9502;158880;8517;8242;474383;57595;51442;389895;100132304;9754;80311;6102;27328;695;56159;51213;90737;60506;10943;100873985;57526;728269;170082;474382;102723680;728656;3358;8273;83844;114824;389840;170067;81557;80823;8862;2002;7216;79979;158763;23641;55217;8270;57477;7592;2833;425054;340526;727866;139599;139804;54470;8450;959;139562;645864;10075;117154;57631;2010;54521;79589;51634;3750;653282;728072;7076;392490;9363;8623;3920;347411;7454;100506164;265;90293;645051;100529097;55511;158724;6197;203547;139135;5355;347516;203522;139081;6451;27336;158787;728458;7499;4841;347517;51360;340578;139596;1896;441509;54466;660;158798;4108;171482;79868;728075;158833;79366;1821;56156;392465;1260;5160;56062;5303;3054;51260;139628;653220;340596;554;28986;23133;57393;2623;28227;4113;57692;50945;3730;7739;100131755;57481;8260;139170;64219;4204;389860;2574;3563;65991;10325;6170;10813;79710;8712;26280;2316;256714;10742;6173;9104;494197;29057;139324;442444;6103;54880;90736;55558;2742;1736;369;255313;3654;170627;645974;3897;79983;727940;541466;347527;8243;4007;139741;29978;2182;7504;60401;84707;53336;1485;159090;94056;57502;55285;653067;1046;11152;641339;1947;8852;7712;23708;203523;4267;54967;340542;89885;2277;83550;644353;55916;340595;6594;139189;63947;9643;9843;4935;139728;100288814;10479;50943;53940;55026;100507170;5638;4478;8239;4068;51114;139411;246100;9968;84679;115201;100533997;1741;416;64840;10682;11326;25763;27330;171483;8908;27286;1038;7543;158800;90060;1288;84061;215;6247;292;55879;401612;1183;340527;55344;29935;158983;357;10009;2747;2652;286514;340543;54885;100129407;10495;6792;79742;140886;2239;2334;4128;441518;139604;4303;55869;25878;4115;11040;8473;6855;84636;55922;728712;5956;2705;55841;54821;729396;441521;8933;10735;729442;9949;4694;84528;51481;492;3028;100129520;795;10389;83604;7411;9947;9367;100463488;10134;79057;54552;6906;340547;30014;415;5255;680;158809;6990;4435;5475;340529;65109;64860;7030;729428;8776;4675;5030;51566;729201;56271;4943;79917;85012;114928;5256;26609;54960;538;6853;5365;4354;286451;29934;10838;139221;9189;347404;6473;3251;286464;158931;139793;100008586;2717;3052;5973;139065;5199;546;5613;51270;139231;9131;7547;474381;257240;11254;27238;64102;2543;158747;2273;56474;5165;64648;54440;140597;5631;728239;3188;100130086;5251;8237;286527;100130302,815
-1,1,X,60701,155232907,155172206,23096;64061;392509;10214;170685;23157;727837;55998;23439;729431;10916;158586;55859;331;3423;54830;4168;6901;5358;92002;27344;729447;54328;266740;9075;102723737;7552;729422;54954;84460;389874;56000;340562;644538;92552;254158;79649;56850;8225;2824;100272147;51186;3149;26576;100130361;1730;347541;139425;3547;728695;729408;79921;57826;59272;203413;2986;7512;9737;8544;55634;2857;3421;537;11013;340554;5716;6658;4101;54457;1438;91966;441519;4100;5931;27316;7403;4534;6839;51480;728096;27112;92129;101928917;140462;8241;6567;827;203569;27301;84548;645037;54413;100133053;7355;254065;79836;10084;347442;60343;51765;55593;139818;56180;6303;8269;142684;7626;10046;8409;203447;63932;2710;4515;8406;51248;56001;51616;2925;100130613;2564;1193;100132994;5354;11043;340533;22;3476;84631;26748;11238;203562;102723631;170261;58526;441525;4983;29944;6907;1536;2539;1478;9468;23597;2187;1287;81887;6611;3561;9767;9282;54857;347365;10800;139341;54539;11219;728062;169966;51209;23630;26548;1121;2000;645188;51438;2846;280658;1852;347344;23229;10857;56157;286430;101059915;438;5277;9758;1069;4674;154796;56548;51309;1184;645073;80712;1774;10245;2258;728343;9823;441531;11141;643311;90121;256643;23676;4114;6758;4107;286499;5009;1654;1831;51284;94121;170302;11230;79135;286410;9210;2491;441490;84187;633;6191;64743;4110;3598;389856;7789;55787;9452;50814;2157;139422;170062;57187;139067;4104;203427;4693;5456;10013;1964;55190;100996648;293;9016;100528062;30011;90316;93953;10178;6322;28952;24137;2332;4105;6845;94122;84968;64663;1538;9142;286530;2245;5634;9506;79576;3266;139212;5207;6535;8227;393;389852;170626;91851;27334;158866;550643;159013;407;7224;55796;10761;100132963;168400;4281;158835;24140;8471;90167;7737;7319;10149;11279;6134;64109;1678;139322;5063;55906;116442;84443;27197;8233;548313;6872;27018;100129239;139105;7102;10549;26071;2664;59353;8573;28985;79184;728049;728090;158521;3581;139886;282808;8263;9130;728082;778;90843;1756;5422;7317;5935;347454;29071;207063;4112;412;158506;340602;30848;5127;22866;93380;159091;10159;212;139285;9338;85417;8266;100132399;158584;494118;190;7569;89801;2892;1968;5230;57232;55559;57529;8277;63035;80231;286436;25975;51311;8905;55086;139735;395;83692;171484;10251;169981;1349;63904;139716;257397;142689;80258;27035;1641;55613;7105;100329135;84295;9459;4810;404281;4109;367;474384;6748;139760;347487;92745;158830;53344;4103;9203;139378;186;474343;2719;3597;140456;9248;402415;203430;9185;90161;728042;4129;65267;56849;8228;8226;728036;7114;6399;4952;83740;84889;8481;6757;347468;347475;414;6759;9500;51132;8823;541578;2158;55609;2556;494119;6756;9502;158880;8517;8242;474383;57595;51442;389895;100132304;9754;80311;6102;27328;695;56159;51213;90737;60506;10943;100873985;57526;728269;170082;474382;102723680;728656;3358;8273;83844;114824;389840;170067;81557;80823;8862;2002;7216;79979;158763;23641;55217;8270;57477;7592;2833;425054;340526;727866;139599;139804;54470;8450;959;139562;645864;10075;117154;57631;2010;54521;79589;51634;3750;653282;728072;7076;392490;9363;8623;3920;347411;7454;100506164;265;90293;645051;100529097;55511;158724;6197;203547;139135;5355;347516;203522;139081;6451;27336;158787;728458;7499;4841;347517;51360;340578;139596;1896;441509;54466;660;158798;4108;171482;79868;728075;158833;79366;1821;56156;392465;1260;5160;56062;5303;3054;51260;139628;653220;340596;554;28986;23133;57393;2623;28227;4113;57692;50945;3730;7739;100131755;57481;8260;139170;64219;4204;389860;2574;3563;65991;10325;6170;10813;79710;8712;26280;2316;256714;10742;6173;9104;494197;29057;139324;442444;6103;54880;90736;55558;2742;1736;369;255313;3654;170627;645974;3897;79983;727940;541466;347527;8243;4007;139741;29978;2182;7504;60401;84707;53336;1485;159090;94056;57502;55285;653067;1046;11152;641339;1947;8852;7712;23708;203523;4267;54967;340542;89885;2277;83550;644353;55916;340595;6594;139189;63947;9643;9843;4935;139728;100288814;10479;50943;53940;55026;100507170;5638;4478;8239;4068;51114;139411;246100;9968;84679;115201;100533997;1741;416;64840;10682;11326;25763;27330;171483;8908;27286;1038;7543;158800;90060;1288;84061;215;6247;292;55879;401612;1183;340527;55344;29935;158983;357;10009;2747;2652;286514;340543;54885;100129407;10495;6792;79742;140886;2239;2334;4128;441518;139604;4303;55869;25878;4115;11040;8473;6855;84636;55922;728712;5956;2705;55841;54821;729396;441521;8933;10735;729442;9949;4694;84528;51481;492;3028;100129520;795;10389;83604;7411;9947;9367;100463488;10134;79057;54552;6906;340547;30014;415;5255;680;158809;6990;4435;5475;340529;65109;64860;7030;729428;8776;4675;5030;51566;729201;56271;4943;79917;85012;114928;5256;26609;54960;538;6853;5365;4354;286451;29934;10838;139221;9189;347404;6473;3251;286464;158931;139793;100008586;2717;3052;5973;139065;5199;546;5613;51270;139231;9131;7547;474381;257240;11254;27238;64102;2543;158747;2273;56474;5165;64648;54440;140597;5631;728239;3188;100130086;5251;8237;286527;100130302,815
1,1,X,60701,155232907,155172206,23096;64061;392509;10214;170685;23157;727837;55998;23439;729431;10916;158586;55859;331;3423;54830;4168;6901;5358;92002;27344;729447;54328;266740;9075;102723737;7552;729422;54954;84460;389874;56000;340562;644538;92552;254158;79649;56850;8225;2824;100272147;51186;3149;26576;100130361;1730;347541;139425;3547;728695;729408;79921;57826;59272;203413;2986;7512;9737;8544;55634;2857;3421;537;11013;340554;5716;6658;4101;54457;1438;91966;441519;4100;5931;27316;7403;4534;6839;51480;728096;27112;92129;101928917;140462;8241;6567;827;203569;27301;84548;645037;54413;100133053;7355;254065;79836;10084;347442;60343;51765;55593;139818;56180;6303;8269;142684;7626;10046;8409;203447;63932;2710;4515;8406;51248;56001;51616;2925;100130613;2564;1193;100132994;5354;11043;340533;22;3476;84631;26748;11238;203562;102723631;170261;58526;441525;4983;29944;6907;1536;2539;1478;9468;23597;2187;1287;81887;6611;3561;9767;9282;54857;347365;10800;139341;54539;11219;728062;169966;51209;23630;26548;1121;2000;645188;51438;2846;280658;1852;347344;23229;10857;56157;286430;101059915;438;5277;9758;1069;4674;154796;56548;51309;1184;645073;80712;1774;10245;2258;728343;9823;441531;11141;643311;90121;256643;23676;4114;6758;4107;286499;5009;1654;1831;51284;94121;170302;11230;79135;286410;9210;2491;441490;84187;633;6191;64743;4110;3598;389856;7789;55787;9452;50814;2157;139422;170062;57187;139067;4104;203427;4693;5456;10013;1964;55190;100996648;293;9016;100528062;30011;90316;93953;10178;6322;28952;24137;2332;4105;6845;94122;84968;64663;1538;9142;286530;2245;5634;9506;79576;3266;139212;5207;6535;8227;393;389852;170626;91851;27334;158866;550643;159013;407;7224;55796;10761;100132963;168400;4281;158835;24140;8471;90167;7737;7319;10149;11279;6134;64109;1678;139322;5063;55906;116442;84443;27197;8233;548313;6872;27018;100129239;139105;7102;10549;26071;2664;59353;8573;28985;79184;728049;728090;158521;3581;139886;282808;8263;9130;728082;778;90843;1756;5422;7317;5935;347454;29071;207063;4112;412;158506;340602;30848;5127;22866;93380;159091;10159;212;139285;9338;85417;8266;100132399;158584;494118;190;7569;89801;2892;1968;5230;57232;55559;57529;8277;63035;80231;286436;25975;51311;8905;55086;139735;395;83692;171484;10251;169981;1349;63904;139716;257397;142689;80258;27035;1641;55613;7105;100329135;84295;9459;4810;404281;4109;367;474384;6748;139760;347487;92745;158830;53344;4103;9203;139378;186;474343;2719;3597;140456;9248;402415;203430;9185;90161;728042;4129;65267;56849;8228;8226;728036;7114;6399;4952;83740;84889;8481;6757;347468;347475;414;6759;9500;51132;8823;541578;2158;55609;2556;494119;6756;9502;158880;8517;8242;474383;57595;51442;389895;100132304;9754;80311;6102;27328;695;56159;51213;90737;60506;10943;100873985;57526;728269;170082;474382;102723680;728656;3358;8273;83844;114824;389840;170067;81557;80823;8862;2002;7216;79979;158763;23641;55217;8270;57477;7592;2833;425054;340526;727866;139599;139804;54470;8450;959;139562;645864;10075;117154;57631;2010;54521;79589;51634;3750;653282;728072;7076;392490;9363;8623;3920;347411;7454;100506164;265;90293;645051;100529097;55511;158724;6197;203547;139135;5355;347516;203522;139081;6451;27336;158787;728458;7499;4841;347517;51360;340578;139596;1896;441509;54466;660;158798;4108;171482;79868;728075;158833;79366;1821;56156;392465;1260;5160;56062;5303;3054;51260;139628;653220;340596;554;28986;23133;57393;2623;28227;4113;57692;50945;3730;7739;100131755;57481;8260;139170;64219;4204;389860;2574;3563;65991;10325;6170;10813;79710;8712;26280;2316;256714;10742;6173;9104;494197;29057;139324;442444;6103;54880;90736;55558;2742;1736;369;255313;3654;170627;645974;3897;79983;727940;541466;347527;8243;4007;139741;29978;2182;7504;60401;84707;53336;1485;159090;94056;57502;55285;653067;1046;11152;641339;1947;8852;7712;23708;203523;4267;54967;340542;89885;2277;83550;644353;55916;340595;6594;139189;63947;9643;9843;4935;139728;100288814;10479;50943;53940;55026;100507170;5638;4478;8239;4068;51114;139411;246100;9968;84679;115201;100533997;1741;416;64840;10682;11326;25763;27330;171483;8908;27286;1038;7543;158800;90060;1288;84061;215;6247;292;55879;401612;1183;340527;55344;29935;158983;357;10009;2747;2652;286514;340543;54885;100129407;10495;6792;79742;140886;2239;2334;4128;441518;139604;4303;55869;25878;4115;11040;8473;6855;84636;55922;728712;5956;2705;55841;54821;729396;441521;8933;10735;729442;9949;4694;84528;51481;492;3028;100129520;795;10389;83604;7411;9947;9367;100463488;10134;79057;54552;6906;340547;30014;415;5255;680;158809;6990;4435;5475;340529;65109;64860;7030;729428;8776;4675;5030;51566;729201;56271;4943;79917;85012;114928;5256;26609;54960;538;6853;5365;4354;286451;29934;10838;139221;9189;347404;6473;3251;286464;158931;139793;100008586;2717;3052;5973;139065;5199;546;5613;51270;139231;9131;7547;474381;257240;11254;27238;64102;2543;158747;2273;56474;5165;64648;54440;140597;5631;728239;3188;100130086;5251;8237;286527;100130302,815
-1,1,X,60701,155232907,155172206,23096;64061;392509;10214;170685;23157;727837;55998;23439;729431;10916;158586;55859;331;3423;54830;4168;6901;5358;92002;27344;729447;54328;266740;9075;102723737;7552;729422;54954;84460;389874;56000;340562;644538;92552;254158;79649;56850;8225;2824;100272147;51186;3149;26576;100130361;1730;347541;139425;3547;728695;729408;79921;57826;59272;203413;2986;7512;9737;8544;55634;2857;3421;537;11013;340554;5716;6658;4101;54457;1438;91966;441519;4100;5931;27316;7403;4534;6839;51480;728096;27112;92129;101928917;140462;8241;6567;827;203569;27301;84548;645037;54413;100133053;7355;254065;79836;10084;347442;60343;51765;55593;139818;56180;6303;8269;142684;7626;10046;8409;203447;63932;2710;4515;8406;51248;56001;51616;2925;100130613;2564;1193;100132994;5354;11043;340533;22;3476;84631;26748;11238;203562;102723631;170261;58526;441525;4983;29944;6907;1536;2539;1478;9468;23597;2187;1287;81887;6611;3561;9767;9282;54857;347365;10800;139341;54539;11219;728062;169966;51209;23630;26548;1121;2000;645188;51438;2846;280658;1852;347344;23229;10857;56157;286430;101059915;438;5277;9758;1069;4674;154796;56548;51309;1184;645073;80712;1774;10245;2258;728343;9823;441531;11141;643311;90121;256643;23676;4114;6758;4107;286499;5009;1654;1831;51284;94121;170302;11230;79135;286410;9210;2491;441490;84187;633;6191;64743;4110;3598;389856;7789;55787;9452;50814;2157;139422;170062;57187;139067;4104;203427;4693;5456;10013;1964;55190;100996648;293;9016;100528062;30011;90316;93953;10178;6322;28952;24137;2332;4105;6845;94122;84968;64663;1538;9142;286530;2245;5634;9506;79576;3266;139212;5207;6535;8227;393;389852;170626;91851;27334;158866;550643;159013;407;7224;55796;10761;100132963;168400;4281;158835;24140;8471;90167;7737;7319;10149;11279;6134;64109;1678;139322;5063;55906;116442;84443;27197;8233;548313;6872;27018;100129239;139105;7102;10549;26071;2664;59353;8573;28985;79184;728049;728090;158521;3581;139886;282808;8263;9130;728082;778;90843;1756;5422;7317;5935;347454;29071;207063;4112;412;158506;340602;30848;5127;22866;93380;159091;10159;212;139285;9338;85417;8266;100132399;158584;494118;190;7569;89801;2892;1968;5230;57232;55559;57529;8277;63035;80231;286436;25975;51311;8905;55086;139735;395;83692;171484;10251;169981;1349;63904;139716;257397;142689;80258;27035;1641;55613;7105;100329135;84295;9459;4810;404281;4109;367;474384;6748;139760;347487;92745;158830;53344;4103;9203;139378;186;474343;2719;3597;140456;9248;402415;203430;9185;90161;728042;4129;65267;56849;8228;8226;728036;7114;6399;4952;83740;84889;8481;6757;347468;347475;414;6759;9500;51132;8823;541578;2158;55609;2556;494119;6756;9502;158880;8517;8242;474383;57595;51442;389895;100132304;9754;80311;6102;27328;695;56159;51213;90737;60506;10943;100873985;57526;728269;170082;474382;102723680;728656;3358;8273;83844;114824;389840;170067;81557;80823;8862;2002;7216;79979;158763;23641;55217;8270;57477;7592;2833;425054;340526;727866;139599;139804;54470;8450;959;139562;645864;10075;117154;57631;2010;54521;79589;51634;3750;653282;728072;7076;392490;9363;8623;3920;347411;7454;100506164;265;90293;645051;100529097;55511;158724;6197;203547;139135;5355;347516;203522;139081;6451;27336;158787;728458;7499;4841;347517;51360;340578;139596;1896;441509;54466;660;158798;4108;171482;79868;728075;158833;79366;1821;56156;392465;1260;5160;56062;5303;3054;51260;139628;653220;340596;554;28986;23133;57393;2623;28227;4113;57692;50945;3730;7739;100131755;57481;8260;139170;64219;4204;389860;2574;3563;65991;10325;6170;10813;79710;8712;26280;2316;256714;10742;6173;9104;494197;29057;139324;442444;6103;54880;90736;55558;2742;1736;369;255313;3654;170627;645974;3897;79983;727940;541466;347527;8243;4007;139741;29978;2182;7504;60401;84707;53336;1485;159090;94056;57502;55285;653067;1046;11152;641339;1947;8852;7712;23708;203523;4267;54967;340542;89885;2277;83550;644353;55916;340595;6594;139189;63947;9643;9843;4935;139728;100288814;10479;50943;53940;55026;100507170;5638;4478;8239;4068;51114;139411;246100;9968;84679;115201;100533997;1741;416;64840;10682;11326;25763;27330;171483;8908;27286;1038;7543;158800;90060;1288;84061;215;6247;292;55879;401612;1183;340527;55344;29935;158983;357;10009;2747;2652;286514;340543;54885;100129407;10495;6792;79742;140886;2239;2334;4128;441518;139604;4303;55869;25878;4115;11040;8473;6855;84636;55922;728712;5956;2705;55841;54821;729396;441521;8933;10735;729442;9949;4694;84528;51481;492;3028;100129520;795;10389;83604;7411;9947;9367;100463488;10134;79057;54552;6906;340547;30014;415;5255;680;158809;6990;4435;5475;340529;65109;64860;7030;729428;8776;4675;5030;51566;729201;56271;4943;79917;85012;114928;5256;26609;54960;538;6853;5365;4354;286451;29934;10838;139221;9189;347404;6473;3251;286464;158931;139793;100008586;2717;3052;5973;139065;5199;546;5613;51270;139231;9131;7547;474381;257240;11254;27238;64102;2543;158747;2273;56474;5165;64648;54440;140597;5631;728239;3188;100130086;5251;8237;286527;100130302,815
1,1,X,60701,155232907,155172206,23096;64061;392509;10214;170685;23157;727837;55998;23439;729431;10916;158586;55859;331;3423;54830;4168;6901;5358;92002;27344;729447;54328;266740;9075;102723737;7552;729422;54954;84460;389874;56000;340562;644538;92552;254158;79649;56850;8225;2824;100272147;51186;3149;26576;100130361;1730;347541;139425;3547;728695;729408;79921;57826;59272;203413;2986;7512;9737;8544;55634;2857;3421;537;11013;340554;5716;6658;4101;54457;1438;91966;441519;4100;5931;27316;7403;4534;6839;51480;728096;27112;92129;101928917;140462;8241;6567;827;203569;27301;84548;645037;54413;100133053;7355;254065;79836;10084;347442;60343;51765;55593;139818;56180;6303;8269;142684;7626;10046;8409;203447;63932;2710;4515;8406;51248;56001;51616;2925;100130613;2564;1193;100132994;5354;11043;340533;22;3476;84631;26748;11238;203562;102723631;170261;58526;441525;4983;29944;6907;1536;2539;1478;9468;23597;2187;1287;81887;6611;3561;9767;9282;54857;347365;10800;139341;54539;11219;728062;169966;51209;23630;26548;1121;2000;645188;51438;2846;280658;1852;347344;23229;10857;56157;286430;101059915;438;5277;9758;1069;4674;154796;56548;51309;1184;645073;80712;1774;10245;2258;728343;9823;441531;11141;643311;90121;256643;23676;4114;6758;4107;286499;5009;1654;1831;51284;94121;170302;11230;79135;286410;9210;2491;441490;84187;633;6191;64743;4110;3598;389856;7789;55787;9452;50814;2157;139422;170062;57187;139067;4104;203427;4693;5456;10013;1964;55190;100996648;293;9016;100528062;30011;90316;93953;10178;6322;28952;24137;2332;4105;6845;94122;84968;64663;1538;9142;286530;2245;5634;9506;79576;3266;139212;5207;6535;8227;393;389852;170626;91851;27334;158866;550643;159013;407;7224;55796;10761;100132963;168400;4281;158835;24140;8471;90167;7737;7319;10149;11279;6134;64109;1678;139322;5063;55906;116442;84443;27197;8233;548313;6872;27018;100129239;139105;7102;10549;26071;2664;59353;8573;28985;79184;728049;728090;158521;3581;139886;282808;8263;9130;728082;778;90843;1756;5422;7317;5935;347454;29071;207063;4112;412;158506;340602;30848;5127;22866;93380;159091;10159;212;139285;9338;85417;8266;100132399;158584;494118;190;7569;89801;2892;1968;5230;57232;55559;57529;8277;63035;80231;286436;25975;51311;8905;55086;139735;395;83692;171484;10251;169981;1349;63904;139716;257397;142689;80258;27035;1641;55613;7105;100329135;84295;9459;4810;404281;4109;367;474384;6748;139760;347487;92745;158830;53344;4103;9203;139378;186;474343;2719;3597;140456;9248;402415;203430;9185;90161;728042;4129;65267;56849;8228;8226;728036;7114;6399;4952;83740;84889;8481;6757;347468;347475;414;6759;9500;51132;8823;541578;2158;55609;2556;494119;6756;9502;158880;8517;8242;474383;57595;51442;389895;100132304;9754;80311;6102;27328;695;56159;51213;90737;60506;10943;100873985;57526;728269;170082;474382;102723680;728656;3358;8273;83844;114824;389840;170067;81557;80823;8862;2002;7216;79979;158763;23641;55217;8270;57477;7592;2833;425054;340526;727866;139599;139804;54470;8450;959;139562;645864;10075;117154;57631;2010;54521;79589;51634;3750;653282;728072;7076;392490;9363;8623;3920;347411;7454;100506164;265;90293;645051;100529097;55511;158724;6197;203547;139135;5355;347516;203522;139081;6451;27336;158787;728458;7499;4841;347517;51360;340578;139596;1896;441509;54466;660;158798;4108;171482;79868;728075;158833;79366;1821;56156;392465;1260;5160;56062;5303;3054;51260;139628;653220;340596;554;28986;23133;57393;2623;28227;4113;57692;50945;3730;7739;100131755;57481;8260;139170;64219;4204;389860;2574;3563;65991;10325;6170;10813;79710;8712;26280;2316;256714;10742;6173;9104;494197;29057;139324;442444;6103;54880;90736;55558;2742;1736;369;255313;3654;170627;645974;3897;79983;727940;541466;347527;8243;4007;139741;29978;2182;7504;60401;84707;53336;1485;159090;94056;57502;55285;653067;1046;11152;641339;1947;8852;7712;23708;203523;4267;54967;340542;89885;2277;83550;644353;55916;340595;6594;139189;63947;9643;9843;4935;139728;100288814;10479;50943;53940;55026;100507170;5638;4478;8239;4068;51114;139411;246100;9968;84679;115201;100533997;1741;416;64840;10682;11326;25763;27330;171483;8908;27286;1038;7543;158800;90060;1288;84061;215;6247;292;55879;401612;1183;340527;55344;29935;158983;357;10009;2747;2652;286514;340543;54885;100129407;10495;6792;79742;140886;2239;2334;4128;441518;139604;4303;55869;25878;4115;11040;8473;6855;84636;55922;728712;5956;2705;55841;54821;729396;441521;8933;10735;729442;9949;4694;84528;51481;492;3028;100129520;795;10389;83604;7411;9947;9367;100463488;10134;79057;54552;6906;340547;30014;415;5255;680;158809;6990;4435;5475;340529;65109;64860;7030;729428;8776;4675;5030;51566;729201;56271;4943;79917;85012;114928;5256;26609;54960;538;6853;5365;4354;286451;29934;10838;139221;9189;347404;6473;3251;286464;158931;139793;100008586;2717;3052;5973;139065;5199;546;5613;51270;139231;9131;7547;474381;257240;11254;27238;64102;2543;158747;2273;56474;5165;64648;54440;140597;5631;728239;3188;100130086;5251;8237;286527;100130302,815
1,1,X,60701,155232907,155172206,23096;64061;392509;10214;170685;23157;727837;55998;23439;729431;10916;158586;55859;331;3423;54830;4168;6901;5358;92002;27344;729447;54328;266740;9075;102723737;7552;729422;54954;84460;389874;56000;340562;644538;92552;254158;79649;56850;8225;2824;100272147;51186;3149;26576;100130361;1730;347541;139425;3547;728695;729408;79921;57826;59272;203413;2986;7512;9737;8544;55634;2857;3421;537;11013;340554;5716;6658;4101;54457;1438;91966;441519;4100;5931;27316;7403;4534;6839;51480;728096;27112;92129;101928917;140462;8241;6567;827;203569;27301;84548;645037;54413;100133053;7355;254065;79836;10084;347442;60343;51765;55593;139818;56180;6303;8269;142684;7626;10046;8409;203447;63932;2710;4515;8406;51248;56001;51616;2925;100130613;2564;1193;100132994;5354;11043;340533;22;3476;84631;26748;11238;203562;102723631;170261;58526;441525;4983;29944;6907;1536;2539;1478;9468;23597;2187;1287;81887;6611;3561;9767;9282;54857;347365;10800;139341;54539;11219;728062;169966;51209;23630;26548;1121;2000;645188;51438;2846;280658;1852;347344;23229;10857;56157;286430;101059915;438;5277;9758;1069;4674;154796;56548;51309;1184;645073;80712;1774;10245;2258;728343;9823;441531;11141;643311;90121;256643;23676;4114;6758;4107;286499;5009;1654;1831;51284;94121;170302;11230;79135;286410;9210;2491;441490;84187;633;6191;64743;4110;3598;389856;7789;55787;9452;50814;2157;139422;170062;57187;139067;4104;203427;4693;5456;10013;1964;55190;100996648;293;9016;100528062;30011;90316;93953;10178;6322;28952;24137;2332;4105;6845;94122;84968;64663;1538;9142;286530;2245;5634;9506;79576;3266;139212;5207;6535;8227;393;389852;170626;91851;27334;158866;550643;159013;407;7224;55796;10761;100132963;168400;4281;158835;24140;8471;90167;7737;7319;10149;11279;6134;64109;1678;139322;5063;55906;116442;84443;27197;8233;548313;6872;27018;100129239;139105;7102;10549;26071;2664;59353;8573;28985;79184;728049;728090;158521;3581;139886;282808;8263;9130;728082;778;90843;1756;5422;7317;5935;347454;29071;207063;4112;412;158506;340602;30848;5127;22866;93380;159091;10159;212;139285;9338;85417;8266;100132399;158584;494118;190;7569;89801;2892;1968;5230;57232;55559;57529;8277;63035;80231;286436;25975;51311;8905;55086;139735;395;83692;171484;10251;169981;1349;63904;139716;257397;142689;80258;27035;1641;55613;7105;100329135;84295;9459;4810;404281;4109;367;474384;6748;139760;347487;92745;158830;53344;4103;9203;139378;186;474343;2719;3597;140456;9248;402415;203430;9185;90161;728042;4129;65267;56849;8228;8226;728036;7114;6399;4952;83740;84889;8481;6757;347468;347475;414;6759;9500;51132;8823;541578;2158;55609;2556;494119;6756;9502;158880;8517;8242;474383;57595;51442;389895;100132304;9754;80311;6102;27328;695;56159;51213;90737;60506;10943;100873985;57526;728269;170082;474382;102723680;728656;3358;8273;83844;114824;389840;170067;81557;80823;8862;2002;7216;79979;158763;23641;55217;8270;57477;7592;2833;425054;340526;727866;139599;139804;54470;8450;959;139562;645864;10075;117154;57631;2010;54521;79589;51634;3750;653282;728072;7076;392490;9363;8623;3920;347411;7454;100506164;265;90293;645051;100529097;55511;158724;6197;203547;139135;5355;347516;203522;139081;6451;27336;158787;728458;7499;4841;347517;51360;340578;139596;1896;441509;54466;660;158798;4108;171482;79868;728075;158833;79366;1821;56156;392465;1260;5160;56062;5303;3054;51260;139628;653220;340596;554;28986;23133;57393;2623;28227;4113;57692;50945;3730;7739;100131755;57481;8260;139170;64219;4204;389860;2574;3563;65991;10325;6170;10813;79710;8712;26280;2316;256714;10742;6173;9104;494197;29057;139324;442444;6103;54880;90736;55558;2742;1736;369;255313;3654;170627;645974;3897;79983;727940;541466;347527;8243;4007;139741;29978;2182;7504;60401;84707;53336;1485;159090;94056;57502;55285;653067;1046;11152;641339;1947;8852;7712;23708;203523;4267;54967;340542;89885;2277;83550;644353;55916;340595;6594;139189;63947;9643;9843;4935;139728;100288814;10479;50943;53940;55026;100507170;5638;4478;8239;4068;51114;139411;246100;9968;84679;115201;100533997;1741;416;64840;10682;11326;25763;27330;171483;8908;27286;1038;7543;158800;90060;1288;84061;215;6247;292;55879;401612;1183;340527;55344;29935;158983;357;10009;2747;2652;286514;340543;54885;100129407;10495;6792;79742;140886;2239;2334;4128;441518;139604;4303;55869;25878;4115;11040;8473;6855;84636;55922;728712;5956;2705;55841;54821;729396;441521;8933;10735;729442;9949;4694;84528;51481;492;3028;100129520;795;10389;83604;7411;9947;9367;100463488;10134;79057;54552;6906;340547;30014;415;5255;680;158809;6990;4435;5475;340529;65109;64860;7030;729428;8776;4675;5030;51566;729201;56271;4943;79917;85012;114928;5256;26609;54960;538;6853;5365;4354;286451;29934;10838;139221;9189;347404;6473;3251;286464;158931;139793;100008586;2717;3052;5973;139065;5199;546;5613;51270;139231;9131;7547;474381;257240;11254;27238;64102;2543;158747;2273;56474;5165;64648;54440;140597;5631;728239;3188;100130086;5251;8237;286527;100130302,815
1,1,X,60701,155232907,155172206,23096;64061;392509;10214;170685;23157;727837;55998;23439;729431;10916;158586;55859;331;3423;54830;4168;6901;5358;92002;27344;729447;54328;266740;9075;102723737;7552;729422;54954;84460;389874;56000;340562;644538;92552;254158;79649;56850;8225;2824;100272147;51186;3149;26576;100130361;1730;347541;139425;3547;728695;729408;79921;57826;59272;203413;2986;7512;9737;8544;55634;2857;3421;537;11013;340554;5716;6658;4101;54457;1438;91966;441519;4100;5931;27316;7403;4534;6839;51480;728096;27112;92129;101928917;140462;8241;6567;827;203569;27301;84548;645037;54413;100133053;7355;254065;79836;10084;347442;60343;51765;55593;139818;56180;6303;8269;142684;7626;10046;8409;203447;63932;2710;4515;8406;51248;56001;51616;2925;100130613;2564;1193;100132994;5354;11043;340533;22;3476;84631;26748;11238;203562;102723631;170261;58526;441525;4983;29944;6907;1536;2539;1478;9468;23597;2187;1287;81887;6611;3561;9767;9282;54857;347365;10800;139341;54539;11219;728062;169966;51209;23630;26548;1121;2000;645188;51438;2846;280658;1852;347344;23229;10857;56157;286430;101059915;438;5277;9758;1069;4674;154796;56548;51309;1184;645073;80712;1774;10245;2258;728343;9823;441531;11141;643311;90121;256643;23676;4114;6758;4107;286499;5009;1654;1831;51284;94121;170302;11230;79135;286410;9210;2491;441490;84187;633;6191;64743;4110;3598;389856;7789;55787;9452;50814;2157;139422;170062;57187;139067;4104;203427;4693;5456;10013;1964;55190;100996648;293;9016;100528062;30011;90316;93953;10178;6322;28952;24137;2332;4105;6845;94122;84968;64663;1538;9142;286530;2245;5634;9506;79576;3266;139212;5207;6535;8227;393;389852;170626;91851;27334;158866;550643;159013;407;7224;55796;10761;100132963;168400;4281;158835;24140;8471;90167;7737;7319;10149;11279;6134;64109;1678;139322;5063;55906;116442;84443;27197;8233;548313;6872;27018;100129239;139105;7102;10549;26071;2664;59353;8573;28985;79184;728049;728090;158521;3581;139886;282808;8263;9130;728082;778;90843;1756;5422;7317;5935;347454;29071;207063;4112;412;158506;340602;30848;5127;22866;93380;159091;10159;212;139285;9338;85417;8266;100132399;158584;494118;190;7569;89801;2892;1968;5230;57232;55559;57529;8277;63035;80231;286436;25975;51311;8905;55086;139735;395;83692;171484;10251;169981;1349;63904;139716;257397;142689;80258;27035;1641;55613;7105;100329135;84295;9459;4810;404281;4109;367;474384;6748;139760;347487;92745;158830;53344;4103;9203;139378;186;474343;2719;3597;140456;9248;402415;203430;9185;90161;728042;4129;65267;56849;8228;8226;728036;7114;6399;4952;83740;84889;8481;6757;347468;347475;414;6759;9500;51132;8823;541578;2158;55609;2556;494119;6756;9502;158880;8517;8242;474383;57595;51442;389895;100132304;9754;80311;6102;27328;695;56159;51213;90737;60506;10943;100873985;57526;728269;170082;474382;102723680;728656;3358;8273;83844;114824;389840;170067;81557;80823;8862;2002;7216;79979;158763;23641;55217;8270;57477;7592;2833;425054;340526;727866;139599;139804;54470;8450;959;139562;645864;10075;117154;57631;2010;54521;79589;51634;3750;653282;728072;7076;392490;9363;8623;3920;347411;7454;100506164;265;90293;645051;100529097;55511;158724;6197;203547;139135;5355;347516;203522;139081;6451;27336;158787;728458;7499;4841;347517;51360;340578;139596;1896;441509;54466;660;158798;4108;171482;79868;728075;158833;79366;1821;56156;392465;1260;5160;56062;5303;3054;51260;139628;653220;340596;554;28986;23133;57393;2623;28227;4113;57692;50945;3730;7739;100131755;57481;8260;139170;64219;4204;389860;2574;3563;65991;10325;6170;10813;79710;8712;26280;2316;256714;10742;6173;9104;494197;29057;139324;442444;6103;54880;90736;55558;2742;1736;369;255313;3654;170627;645974;3897;79983;727940;541466;347527;8243;4007;139741;29978;2182;7504;60401;84707;53336;1485;159090;94056;57502;55285;653067;1046;11152;641339;1947;8852;7712;23708;203523;4267;54967;340542;89885;2277;83550;644353;55916;340595;6594;139189;63947;9643;9843;4935;139728;100288814;10479;50943;53940;55026;100507170;5638;4478;8239;4068;51114;139411;246100;9968;84679;115201;100533997;1741;416;64840;10682;11326;25763;27330;171483;8908;27286;1038;7543;158800;90060;1288;84061;215;6247;292;55879;401612;1183;340527;55344;29935;158983;357;10009;2747;2652;286514;340543;54885;100129407;10495;6792;79742;140886;2239;2334;4128;441518;139604;4303;55869;25878;4115;11040;8473;6855;84636;55922;728712;5956;2705;55841;54821;729396;441521;8933;10735;729442;9949;4694;84528;51481;492;3028;100129520;795;10389;83604;7411;9947;9367;100463488;10134;79057;54552;6906;340547;30014;415;5255;680;158809;6990;4435;5475;340529;65109;64860;7030;729428;8776;4675;5030;51566;729201;56271;4943;79917;85012;114928;5256;26609;54960;538;6853;5365;4354;286451;29934;10838;139221;9189;347404;6473;3251;286464;158931;139793;100008586;2717;3052;5973;139065;5199;546;5613;51270;139231;9131;7547;474381;257240;11254;27238;64102;2543;158747;2273;56474;5165;64648;54440;140597;5631;728239;3188;100130086;5251;8237;286527;100130302,815
1,1,X,60701,155232907,155172206,23096;64061;392509;10214;170685;23157;727837;55998;23439;729431;10916;158586;55859;331;3423;54830;4168;6901;5358;92002;27344;729447;54328;266740;9075;102723737;7552;729422;54954;84460;389874;56000;340562;644538;92552;254158;79649;56850;8225;2824;100272147;51186;3149;26576;100130361;1730;347541;139425;3547;728695;729408;79921;57826;59272;203413;2986;7512;9737;8544;55634;2857;3421;537;11013;340554;5716;6658;4101;54457;1438;91966;441519;4100;5931;27316;7403;4534;6839;51480;728096;27112;92129;101928917;140462;8241;6567;827;203569;27301;84548;645037;54413;100133053;7355;254065;79836;10084;347442;60343;51765;55593;139818;56180;6303;8269;142684;7626;10046;8409;203447;63932;2710;4515;8406;51248;56001;51616;2925;100130613;2564;1193;100132994;5354;11043;340533;22;3476;84631;26748;11238;203562;102723631;170261;58526;441525;4983;29944;6907;1536;2539;1478;9468;23597;2187;1287;81887;6611;3561;9767;9282;54857;347365;10800;139341;54539;11219;728062;169966;51209;23630;26548;1121;2000;645188;51438;2846;280658;1852;347344;23229;10857;56157;286430;101059915;438;5277;9758;1069;4674;154796;56548;51309;1184;645073;80712;1774;10245;2258;728343;9823;441531;11141;643311;90121;256643;23676;4114;6758;4107;286499;5009;1654;1831;51284;94121;170302;11230;79135;286410;9210;2491;441490;84187;633;6191;64743;4110;3598;389856;7789;55787;9452;50814;2157;139422;170062;57187;139067;4104;203427;4693;5456;10013;1964;55190;100996648;293;9016;100528062;30011;90316;93953;10178;6322;28952;24137;2332;4105;6845;94122;84968;64663;1538;9142;286530;2245;5634;9506;79576;3266;139212;5207;6535;8227;393;389852;170626;91851;27334;158866;550643;159013;407;7224;55796;10761;100132963;168400;4281;158835;24140;8471;90167;7737;7319;10149;11279;6134;64109;1678;139322;5063;55906;116442;84443;27197;8233;548313;6872;27018;100129239;139105;7102;10549;26071;2664;59353;8573;28985;79184;728049;728090;158521;3581;139886;282808;8263;9130;728082;778;90843;1756;5422;7317;5935;347454;29071;207063;4112;412;158506;340602;30848;5127;22866;93380;159091;10159;212;139285;9338;85417;8266;100132399;158584;494118;190;7569;89801;2892;1968;5230;57232;55559;57529;8277;63035;80231;286436;25975;51311;8905;55086;139735;395;83692;171484;10251;169981;1349;63904;139716;257397;142689;80258;27035;1641;55613;7105;100329135;84295;9459;4810;404281;4109;367;474384;6748;139760;347487;92745;158830;53344;4103;9203;139378;186;474343;2719;3597;140456;9248;402415;203430;9185;90161;728042;4129;65267;56849;8228;8226;728036;7114;6399;4952;83740;84889;8481;6757;347468;347475;414;6759;9500;51132;8823;541578;2158;55609;2556;494119;6756;9502;158880;8517;8242;474383;57595;51442;389895;100132304;9754;80311;6102;27328;695;56159;51213;90737;60506;10943;100873985;57526;728269;170082;474382;102723680;728656;3358;8273;83844;114824;389840;170067;81557;80823;8862;2002;7216;79979;158763;23641;55217;8270;57477;7592;2833;425054;340526;727866;139599;139804;54470;8450;959;139562;645864;10075;117154;57631;2010;54521;79589;51634;3750;653282;728072;7076;392490;9363;8623;3920;347411;7454;100506164;265;90293;645051;100529097;55511;158724;6197;203547;139135;5355;347516;203522;139081;6451;27336;158787;728458;7499;4841;347517;51360;340578;139596;1896;441509;54466;660;158798;4108;171482;79868;728075;158833;79366;1821;56156;392465;1260;5160;56062;5303;3054;51260;139628;653220;340596;554;28986;23133;57393;2623;28227;4113;57692;50945;3730;7739;100131755;57481;8260;139170;64219;4204;389860;2574;3563;65991;10325;6170;10813;79710;8712;26280;2316;256714;10742;6173;9104;494197;29057;139324;442444;6103;54880;90736;55558;2742;1736;369;255313;3654;170627;645974;3897;79983;727940;541466;347527;8243;4007;139741;29978;2182;7504;60401;84707;53336;1485;159090;94056;57502;55285;653067;1046;11152;641339;1947;8852;7712;23708;203523;4267;54967;340542;89885;2277;83550;644353;55916;340595;6594;139189;63947;9643;9843;4935;139728;100288814;10479;50943;53940;55026;100507170;5638;4478;8239;4068;51114;139411;246100;9968;84679;115201;100533997;1741;416;64840;10682;11326;25763;27330;171483;8908;27286;1038;7543;158800;90060;1288;84061;215;6247;292;55879;401612;1183;340527;55344;29935;158983;357;10009;2747;2652;286514;340543;54885;100129407;10495;6792;79742;140886;2239;2334;4128;441518;139604;4303;55869;25878;4115;11040;8473;6855;84636;55922;728712;5956;2705;55841;54821;729396;441521;8933;10735;729442;9949;4694;84528;51481;492;3028;100129520;795;10389;83604;7411;9947;9367;100463488;10134;79057;54552;6906;340547;30014;415;5255;680;158809;6990;4435;5475;340529;65109;64860;7030;729428;8776;4675;5030;51566;729201;56271;4943;79917;85012;114928;5256;26609;54960;538;6853;5365;4354;286451;29934;10838;139221;9189;347404;6473;3251;286464;158931;139793;100008586;2717;3052;5973;139065;5199;546;5613;51270;139231;9131;7547;474381;257240;11254;27238;64102;2543;158747;2273;56474;5165;64648;54440;140597;5631;728239;3188;100130086;5251;8237;286527;100130302,815
1,1,X,60701,155246225,155185524,23096;64061;392509;10214;170685;23157;727837;55998;23439;729431;10916;158586;55859;331;3423;54830;4168;6901;5358;92002;27344;729447;54328;266740;9075;102723737;7552;729422;54954;84460;389874;56000;340562;644538;92552;254158;79649;56850;8225;2824;100272147;51186;3149;26576;100130361;1730;347541;139425;3547;728695;729408;79921;57826;59272;203413;2986;7512;9737;8544;55634;2857;3421;537;11013;340554;5716;6658;4101;54457;1438;91966;441519;4100;5931;27316;7403;4534;6839;51480;728096;27112;92129;101928917;140462;8241;6567;827;203569;27301;84548;645037;54413;100133053;7355;254065;79836;10084;347442;60343;51765;55593;139818;56180;6303;8269;142684;7626;10046;8409;203447;63932;2710;4515;8406;51248;56001;51616;2925;100130613;2564;1193;100132994;5354;11043;340533;22;3476;84631;26748;11238;203562;102723631;170261;58526;441525;4983;29944;6907;1536;2539;1478;9468;23597;2187;1287;81887;6611;3561;9767;9282;54857;347365;10800;139341;54539;11219;728062;169966;51209;23630;26548;1121;2000;645188;51438;2846;280658;1852;347344;23229;10857;56157;286430;101059915;438;5277;9758;1069;4674;154796;56548;51309;1184;645073;80712;1774;10245;2258;728343;9823;441531;11141;643311;90121;256643;23676;4114;6758;4107;286499;5009;1654;1831;51284;94121;170302;11230;79135;286410;9210;2491;441490;84187;633;6191;64743;4110;3598;389856;7789;55787;9452;50814;2157;139422;170062;57187;139067;4104;203427;4693;5456;10013;1964;55190;100996648;293;9016;100528062;30011;90316;93953;10178;6322;28952;24137;2332;4105;6845;94122;84968;64663;1538;9142;286530;2245;5634;9506;79576;3266;139212;5207;6535;8227;393;389852;170626;91851;27334;158866;550643;159013;407;7224;55796;10761;100132963;168400;4281;158835;24140;8471;90167;7737;7319;10149;11279;6134;64109;1678;139322;5063;55906;116442;84443;27197;8233;548313;6872;27018;100129239;139105;7102;10549;26071;2664;59353;8573;28985;79184;728049;728090;158521;3581;139886;282808;8263;9130;728082;778;90843;1756;5422;7317;5935;347454;29071;207063;4112;412;158506;340602;30848;5127;22866;93380;159091;10159;212;139285;9338;85417;8266;100132399;158584;494118;190;7569;89801;2892;1968;5230;57232;55559;57529;8277;63035;80231;286436;25975;51311;8905;55086;139735;395;83692;171484;10251;169981;1349;63904;139716;257397;142689;80258;27035;1641;55613;7105;100329135;84295;9459;4810;404281;4109;367;474384;6748;139760;347487;92745;158830;53344;4103;9203;139378;186;474343;2719;3597;140456;9248;402415;203430;9185;90161;728042;4129;65267;56849;8228;8226;728036;7114;6399;4952;83740;84889;8481;6757;347468;347475;414;6759;9500;51132;8823;541578;2158;55609;2556;494119;6756;9502;158880;8517;8242;474383;57595;51442;389895;100132304;9754;80311;6102;27328;695;56159;51213;90737;60506;10943;100873985;57526;728269;170082;474382;102723680;728656;3358;8273;83844;114824;389840;170067;81557;80823;8862;2002;7216;79979;158763;23641;55217;8270;57477;7592;2833;425054;340526;727866;139599;139804;54470;8450;959;139562;645864;10075;117154;57631;2010;54521;79589;51634;3750;653282;728072;7076;392490;9363;8623;3920;347411;7454;100506164;265;90293;645051;100529097;55511;158724;6197;203547;139135;5355;347516;203522;139081;6451;27336;158787;728458;7499;4841;347517;51360;340578;139596;1896;441509;54466;660;158798;4108;171482;79868;728075;158833;79366;1821;56156;392465;1260;5160;56062;5303;3054;51260;139628;653220;340596;554;28986;23133;57393;2623;28227;4113;57692;50945;3730;7739;100131755;57481;8260;139170;64219;4204;389860;2574;3563;65991;10325;6170;10813;79710;8712;26280;2316;256714;10742;6173;9104;494197;29057;139324;442444;6103;54880;90736;55558;2742;1736;369;255313;3654;170627;645974;3897;79983;727940;541466;347527;8243;4007;139741;29978;2182;7504;60401;84707;53336;1485;159090;94056;57502;55285;653067;1046;11152;641339;1947;8852;7712;23708;203523;4267;54967;340542;89885;2277;83550;644353;55916;340595;6594;139189;63947;9643;9843;4935;139728;100288814;10479;50943;53940;55026;100507170;5638;4478;8239;4068;51114;139411;246100;9968;84679;115201;100533997;1741;416;64840;10682;11326;25763;27330;171483;8908;27286;1038;7543;158800;90060;1288;84061;215;6247;292;55879;401612;1183;340527;55344;29935;158983;357;10009;2747;2652;286514;340543;54885;100129407;10495;6792;79742;140886;2239;2334;4128;441518;139604;4303;55869;25878;4115;11040;8473;6855;84636;55922;728712;5956;2705;55841;54821;729396;441521;8933;10735;729442;9949;4694;84528;51481;492;3028;100129520;795;10389;83604;7411;9947;9367;100463488;10134;79057;54552;6906;340547;30014;415;5255;680;158809;6990;4435;5475;340529;65109;64860;7030;729428;8776;4675;5030;51566;729201;56271;4943;79917;85012;114928;5256;26609;54960;538;6853;5365;4354;286451;29934;10838;139221;9189;347404;6473;3251;286464;158931;139793;100008586;2717;3052;5973;139065;5199;546;5613;51270;139231;9131;7547;474381;257240;11254;27238;64102;2543;158747;2273;56474;5165;64648;54440;140597;5631;728239;3188;100130086;5251;8237;286527;100130302,815
1,1,X,60701,155260560,155199859,23096;64061;392509;10214;170685;23157;727837;55998;23439;729431;10916;158586;55859;331;3423;54830;4168;6901;5358;92002;27344;729447;54328;266740;9075;102723737;7552;729422;54954;84460;389874;56000;340562;644538;92552;254158;79649;56850;8225;2824;100272147;51186;3149;26576;100130361;1730;347541;139425;3547;728695;729408;79921;57826;59272;203413;2986;7512;9737;8544;55634;2857;3421;537;11013;340554;5716;6658;4101;54457;1438;91966;441519;4100;5931;27316;7403;4534;6839;51480;728096;27112;92129;101928917;140462;8241;6567;827;203569;27301;84548;645037;54413;100133053;7355;254065;79836;10084;347442;60343;51765;55593;139818;56180;6303;8269;142684;7626;10046;8409;203447;63932;2710;4515;8406;51248;56001;51616;2925;100130613;2564;1193;100132994;5354;11043;340533;22;3476;84631;26748;11238;203562;102723631;170261;58526;441525;4983;29944;6907;1536;2539;1478;9468;23597;2187;1287;81887;6611;3561;9767;9282;54857;347365;10800;139341;54539;11219;728062;169966;51209;23630;26548;1121;2000;645188;51438;2846;280658;1852;347344;23229;10857;56157;286430;101059915;438;5277;9758;1069;4674;154796;56548;51309;1184;645073;80712;1774;10245;2258;728343;9823;441531;11141;643311;90121;256643;23676;4114;6758;4107;286499;5009;1654;1831;51284;94121;170302;11230;79135;286410;9210;2491;441490;84187;633;6191;64743;4110;3598;389856;7789;55787;9452;50814;2157;139422;170062;57187;139067;4104;203427;4693;5456;10013;1964;55190;100996648;293;9016;100528062;30011;90316;93953;10178;6322;28952;24137;2332;4105;6845;94122;84968;64663;1538;9142;286530;2245;5634;9506;79576;3266;139212;5207;6535;8227;393;389852;170626;91851;27334;158866;550643;159013;407;7224;55796;10761;100132963;168400;4281;158835;24140;8471;90167;7737;7319;10149;11279;6134;64109;1678;139322;5063;55906;116442;84443;27197;8233;548313;6872;27018;100129239;139105;7102;10549;26071;2664;59353;8573;28985;79184;728049;728090;158521;3581;139886;282808;8263;9130;728082;778;90843;1756;5422;7317;5935;347454;29071;207063;4112;412;158506;340602;30848;5127;22866;93380;159091;10159;212;139285;9338;85417;8266;100132399;158584;494118;190;7569;89801;2892;1968;5230;57232;55559;57529;8277;63035;80231;286436;25975;51311;8905;55086;139735;395;83692;171484;10251;169981;1349;63904;139716;257397;142689;80258;27035;1641;55613;7105;100329135;84295;9459;4810;404281;4109;367;474384;6748;139760;347487;92745;158830;53344;4103;9203;139378;186;474343;2719;3597;140456;9248;402415;203430;9185;90161;728042;4129;65267;56849;8228;8226;728036;7114;6399;4952;83740;84889;8481;6757;347468;347475;414;6759;9500;51132;8823;541578;2158;55609;2556;494119;6756;9502;158880;8517;8242;474383;57595;51442;389895;100132304;9754;80311;6102;27328;695;56159;51213;90737;60506;10943;100873985;57526;728269;170082;474382;102723680;728656;3358;8273;83844;114824;389840;170067;81557;80823;8862;2002;7216;79979;158763;23641;55217;8270;57477;7592;2833;425054;340526;727866;139599;139804;54470;8450;959;139562;645864;10075;117154;57631;2010;54521;79589;51634;3750;653282;728072;7076;392490;9363;8623;3920;347411;7454;100506164;265;90293;645051;100529097;55511;158724;6197;203547;139135;5355;347516;203522;139081;6451;27336;158787;728458;7499;4841;347517;51360;340578;139596;1896;441509;54466;660;158798;4108;171482;79868;728075;158833;79366;1821;56156;392465;1260;5160;56062;5303;3054;51260;139628;653220;340596;554;28986;23133;57393;2623;28227;4113;57692;50945;3730;7739;100131755;57481;8260;139170;64219;4204;389860;2574;3563;65991;10325;6170;10813;79710;8712;26280;2316;256714;10742;6173;9104;494197;29057;139324;442444;6103;54880;90736;55558;2742;1736;369;255313;3654;170627;645974;3897;79983;727940;541466;347527;8243;4007;139741;29978;2182;7504;60401;84707;53336;1485;159090;94056;57502;55285;653067;1046;11152;641339;1947;8852;7712;23708;203523;4267;54967;340542;89885;2277;83550;644353;55916;340595;6594;139189;63947;9643;9843;4935;139728;100288814;10479;50943;53940;55026;100507170;5638;4478;8239;4068;51114;139411;246100;9968;84679;115201;100533997;1741;416;64840;10682;11326;25763;27330;171483;8908;27286;1038;7543;158800;90060;1288;84061;215;6247;292;55879;401612;1183;340527;55344;29935;158983;357;10009;2747;2652;286514;340543;54885;100129407;10495;6792;79742;140886;2239;2334;4128;441518;139604;4303;55869;25878;4115;11040;8473;6855;84636;55922;728712;5956;2705;55841;54821;729396;441521;8933;10735;729442;9949;4694;84528;51481;492;3028;100129520;795;10389;83604;7411;9947;9367;100463488;10134;79057;54552;6906;340547;30014;415;5255;680;158809;6990;4435;5475;340529;65109;64860;7030;729428;8776;4675;5030;51566;729201;56271;4943;79917;85012;114928;5256;26609;54960;538;6853;5365;4354;286451;29934;10838;139221;9189;347404;6473;3251;286464;158931;139793;100008586;2717;3052;5973;139065;5199;546;5613;51270;139231;9131;7547;474381;257240;11254;27238;64102;2543;158747;2273;56474;5165;64648;54440;140597;5631;728239;3188;100130086;5251;8237;286527;100130302,815
1,1,X,60701,155260560,155199859,23096;64061;392509;10214;170685;23157;727837;55998;23439;729431;10916;158586;55859;331;3423;54830;4168;6901;5358;92002;27344;729447;54328;266740;9075;102723737;7552;729422;54954;84460;389874;56000;340562;644538;92552;254158;79649;56850;8225;2824;100272147;51186;3149;26576;100130361;1730;347541;139425;3547;728695;729408;79921;57826;59272;203413;2986;7512;9737;8544;55634;2857;3421;537;11013;340554;5716;6658;4101;54457;1438;91966;441519;4100;5931;27316;7403;4534;6839;51480;728096;27112;92129;101928917;140462;8241;6567;827;203569;27301;84548;645037;54413;100133053;7355;254065;79836;10084;347442;60343;51765;55593;139818;56180;6303;8269;142684;7626;10046;8409;203447;63932;2710;4515;8406;51248;56001;51616;2925;100130613;2564;1193;100132994;5354;11043;340533;22;3476;84631;26748;11238;203562;102723631;170261;58526;441525;4983;29944;6907;1536;2539;1478;9468;23597;2187;1287;81887;6611;3561;9767;9282;54857;347365;10800;139341;54539;11219;728062;169966;51209;23630;26548;1121;2000;645188;51438;2846;280658;1852;347344;23229;10857;56157;286430;101059915;438;5277;9758;1069;4674;154796;56548;51309;1184;645073;80712;1774;10245;2258;728343;9823;441531;11141;643311;90121;256643;23676;4114;6758;4107;286499;5009;1654;1831;51284;94121;170302;11230;79135;286410;9210;2491;441490;84187;633;6191;64743;4110;3598;389856;7789;55787;9452;50814;2157;139422;170062;57187;139067;4104;203427;4693;5456;10013;1964;55190;100996648;293;9016;100528062;30011;90316;93953;10178;6322;28952;24137;2332;4105;6845;94122;84968;64663;1538;9142;286530;2245;5634;9506;79576;3266;139212;5207;6535;8227;393;389852;170626;91851;27334;158866;550643;159013;407;7224;55796;10761;100132963;168400;4281;158835;24140;8471;90167;7737;7319;10149;11279;6134;64109;1678;139322;5063;55906;116442;84443;27197;8233;548313;6872;27018;100129239;139105;7102;10549;26071;2664;59353;8573;28985;79184;728049;728090;158521;3581;139886;282808;8263;9130;728082;778;90843;1756;5422;7317;5935;347454;29071;207063;4112;412;158506;340602;30848;5127;22866;93380;159091;10159;212;139285;9338;85417;8266;100132399;158584;494118;190;7569;89801;2892;1968;5230;57232;55559;57529;8277;63035;80231;286436;25975;51311;8905;55086;139735;395;83692;171484;10251;169981;1349;63904;139716;257397;142689;80258;27035;1641;55613;7105;100329135;84295;9459;4810;404281;4109;367;474384;6748;139760;347487;92745;158830;53344;4103;9203;139378;186;474343;2719;3597;140456;9248;402415;203430;9185;90161;728042;4129;65267;56849;8228;8226;728036;7114;6399;4952;83740;84889;8481;6757;347468;347475;414;6759;9500;51132;8823;541578;2158;55609;2556;494119;6756;9502;158880;8517;8242;474383;57595;51442;389895;100132304;9754;80311;6102;27328;695;56159;51213;90737;60506;10943;100873985;57526;728269;170082;474382;102723680;728656;3358;8273;83844;114824;389840;170067;81557;80823;8862;2002;7216;79979;158763;23641;55217;8270;57477;7592;2833;425054;340526;727866;139599;139804;54470;8450;959;139562;645864;10075;117154;57631;2010;54521;79589;51634;3750;653282;728072;7076;392490;9363;8623;3920;347411;7454;100506164;265;90293;645051;100529097;55511;158724;6197;203547;139135;5355;347516;203522;139081;6451;27336;158787;728458;7499;4841;347517;51360;340578;139596;1896;441509;54466;660;158798;4108;171482;79868;728075;158833;79366;1821;56156;392465;1260;5160;56062;5303;3054;51260;139628;653220;340596;554;28986;23133;57393;2623;28227;4113;57692;50945;3730;7739;100131755;57481;8260;139170;64219;4204;389860;2574;3563;65991;10325;6170;10813;79710;8712;26280;2316;256714;10742;6173;9104;494197;29057;139324;442444;6103;54880;90736;55558;2742;1736;369;255313;3654;170627;645974;3897;79983;727940;541466;347527;8243;4007;139741;29978;2182;7504;60401;84707;53336;1485;159090;94056;57502;55285;653067;1046;11152;641339;1947;8852;7712;23708;203523;4267;54967;340542;89885;2277;83550;644353;55916;340595;6594;139189;63947;9643;9843;4935;139728;100288814;10479;50943;53940;55026;100507170;5638;4478;8239;4068;51114;139411;246100;9968;84679;115201;100533997;1741;416;64840;10682;11326;25763;27330;171483;8908;27286;1038;7543;158800;90060;1288;84061;215;6247;292;55879;401612;1183;340527;55344;29935;158983;357;10009;2747;2652;286514;340543;54885;100129407;10495;6792;79742;140886;2239;2334;4128;441518;139604;4303;55869;25878;4115;11040;8473;6855;84636;55922;728712;5956;2705;55841;54821;729396;441521;8933;10735;729442;9949;4694;84528;51481;492;3028;100129520;795;10389;83604;7411;9947;9367;100463488;10134;79057;54552;6906;340547;30014;415;5255;680;158809;6990;4435;5475;340529;65109;64860;7030;729428;8776;4675;5030;51566;729201;56271;4943;79917;85012;114928;5256;26609;54960;538;6853;5365;4354;286451;29934;10838;139221;9189;347404;6473;3251;286464;158931;139793;100008586;2717;3052;5973;139065;5199;546;5613;51270;139231;9131;7547;474381;257240;11254;27238;64102;2543;158747;2273;56474;5165;64648;54440;140597;5631;728239;3188;100130086;5251;8237;286527;100130302,815
1,1,X,60701,155260560,155199859,23096;64061;392509;10214;170685;23157;727837;55998;23439;729431;10916;158586;55859;331;3423;54830;4168;6901;5358;92002;27344;729447;54328;266740;9075;102723737;7552;729422;54954;84460;389874;56000;340562;644538;92552;254158;79649;56850;8225;2824;100272147;51186;3149;26576;100130361;1730;347541;139425;3547;728695;729408;79921;57826;59272;203413;2986;7512;9737;8544;55634;2857;3421;537;11013;340554;5716;6658;4101;54457;1438;91966;441519;4100;5931;27316;7403;4534;6839;51480;728096;27112;92129;101928917;140462;8241;6567;827;203569;27301;84548;645037;54413;100133053;7355;254065;79836;10084;347442;60343;51765;55593;139818;56180;6303;8269;142684;7626;10046;8409;203447;63932;2710;4515;8406;51248;56001;51616;2925;100130613;2564;1193;100132994;5354;11043;340533;22;3476;84631;26748;11238;203562;102723631;170261;58526;441525;4983;29944;6907;1536;2539;1478;9468;23597;2187;1287;81887;6611;3561;9767;9282;54857;347365;10800;139341;54539;11219;728062;169966;51209;23630;26548;1121;2000;645188;51438;2846;280658;1852;347344;23229;10857;56157;286430;101059915;438;5277;9758;1069;4674;154796;56548;51309;1184;645073;80712;1774;10245;2258;728343;9823;441531;11141;643311;90121;256643;23676;4114;6758;4107;286499;5009;1654;1831;51284;94121;170302;11230;79135;286410;9210;2491;441490;84187;633;6191;64743;4110;3598;389856;7789;55787;9452;50814;2157;139422;170062;57187;139067;4104;203427;4693;5456;10013;1964;55190;100996648;293;9016;100528062;30011;90316;93953;10178;6322;28952;24137;2332;4105;6845;94122;84968;64663;1538;9142;286530;2245;5634;9506;79576;3266;139212;5207;6535;8227;393;389852;170626;91851;27334;158866;550643;159013;407;7224;55796;10761;100132963;168400;4281;158835;24140;8471;90167;7737;7319;10149;11279;6134;64109;1678;139322;5063;55906;116442;84443;27197;8233;548313;6872;27018;100129239;139105;7102;10549;26071;2664;59353;8573;28985;79184;728049;728090;158521;3581;139886;282808;8263;9130;728082;778;90843;1756;5422;7317;5935;347454;29071;207063;4112;412;158506;340602;30848;5127;22866;93380;159091;10159;212;139285;9338;85417;8266;100132399;158584;494118;190;7569;89801;2892;1968;5230;57232;55559;57529;8277;63035;80231;286436;25975;51311;8905;55086;139735;395;83692;171484;10251;169981;1349;63904;139716;257397;142689;80258;27035;1641;55613;7105;100329135;84295;9459;4810;404281;4109;367;474384;6748;139760;347487;92745;158830;53344;4103;9203;139378;186;474343;2719;3597;140456;9248;402415;203430;9185;90161;728042;4129;65267;56849;8228;8226;728036;7114;6399;4952;83740;84889;8481;6757;347468;347475;414;6759;9500;51132;8823;541578;2158;55609;2556;494119;6756;9502;158880;8517;8242;474383;57595;51442;389895;100132304;9754;80311;6102;27328;695;56159;51213;90737;60506;10943;100873985;57526;728269;170082;474382;102723680;728656;3358;8273;83844;114824;389840;170067;81557;80823;8862;2002;7216;79979;158763;23641;55217;8270;57477;7592;2833;425054;340526;727866;139599;139804;54470;8450;959;139562;645864;10075;117154;57631;2010;54521;79589;51634;3750;653282;728072;7076;392490;9363;8623;3920;347411;7454;100506164;265;90293;645051;100529097;55511;158724;6197;203547;139135;5355;347516;203522;139081;6451;27336;158787;728458;7499;4841;347517;51360;340578;139596;1896;441509;54466;660;158798;4108;171482;79868;728075;158833;79366;1821;56156;392465;1260;5160;56062;5303;3054;51260;139628;653220;340596;554;28986;23133;57393;2623;28227;4113;57692;50945;3730;7739;100131755;57481;8260;139170;64219;4204;389860;2574;3563;65991;10325;6170;10813;79710;8712;26280;2316;256714;10742;6173;9104;494197;29057;139324;442444;6103;54880;90736;55558;2742;1736;369;255313;3654;170627;645974;3897;79983;727940;541466;347527;8243;4007;139741;29978;2182;7504;60401;84707;53336;1485;159090;94056;57502;55285;653067;1046;11152;641339;1947;8852;7712;23708;203523;4267;54967;340542;89885;2277;83550;644353;55916;340595;6594;139189;63947;9643;9843;4935;139728;100288814;10479;50943;53940;55026;100507170;5638;4478;8239;4068;51114;139411;246100;9968;84679;115201;100533997;1741;416;64840;10682;11326;25763;27330;171483;8908;27286;1038;7543;158800;90060;1288;84061;215;6247;292;55879;401612;1183;340527;55344;29935;158983;357;10009;2747;2652;286514;340543;54885;100129407;10495;6792;79742;140886;2239;2334;4128;441518;139604;4303;55869;25878;4115;11040;8473;6855;84636;55922;728712;5956;2705;55841;54821;729396;441521;8933;10735;729442;9949;4694;84528;51481;492;3028;100129520;795;10389;83604;7411;9947;9367;100463488;10134;79057;54552;6906;340547;30014;415;5255;680;158809;6990;4435;5475;340529;65109;64860;7030;729428;8776;4675;5030;51566;729201;56271;4943;79917;85012;114928;5256;26609;54960;538;6853;5365;4354;286451;29934;10838;139221;9189;347404;6473;3251;286464;158931;139793;100008586;2717;3052;5973;139065;5199;546;5613;51270;139231;9131;7547;474381;257240;11254;27238;64102;2543;158747;2273;56474;5165;64648;54440;140597;5631;728239;3188;100130086;5251;8237;286527;100130302,815
1,1,X,60701,155260560,155199859,23096;64061;392509;10214;170685;23157;727837;55998;23439;729431;10916;158586;55859;331;3423;54830;4168;6901;5358;92002;27344;729447;54328;266740;9075;102723737;7552;729422;54954;84460;389874;56000;340562;644538;92552;254158;79649;56850;8225;2824;100272147;51186;3149;26576;100130361;1730;347541;139425;3547;728695;729408;79921;57826;59272;203413;2986;7512;9737;8544;55634;2857;3421;537;11013;340554;5716;6658;4101;54457;1438;91966;441519;4100;5931;27316;7403;4534;6839;51480;728096;27112;92129;101928917;140462;8241;6567;827;203569;27301;84548;645037;54413;100133053;7355;254065;79836;10084;347442;60343;51765;55593;139818;56180;6303;8269;142684;7626;10046;8409;203447;63932;2710;4515;8406;51248;56001;51616;2925;100130613;2564;1193;100132994;5354;11043;340533;22;3476;84631;26748;11238;203562;102723631;170261;58526;441525;4983;29944;6907;1536;2539;1478;9468;23597;2187;1287;81887;6611;3561;9767;9282;54857;347365;10800;139341;54539;11219;728062;169966;51209;23630;26548;1121;2000;645188;51438;2846;280658;1852;347344;23229;10857;56157;286430;101059915;438;5277;9758;1069;4674;154796;56548;51309;1184;645073;80712;1774;10245;2258;728343;9823;441531;11141;643311;90121;256643;23676;4114;6758;4107;286499;5009;1654;1831;51284;94121;170302;11230;79135;286410;9210;2491;441490;84187;633;6191;64743;4110;3598;389856;7789;55787;9452;50814;2157;139422;170062;57187;139067;4104;203427;4693;5456;10013;1964;55190;100996648;293;9016;100528062;30011;90316;93953;10178;6322;28952;24137;2332;4105;6845;94122;84968;64663;1538;9142;286530;2245;5634;9506;79576;3266;139212;5207;6535;8227;393;389852;170626;91851;27334;158866;550643;159013;407;7224;55796;10761;100132963;168400;4281;158835;24140;8471;90167;7737;7319;10149;11279;6134;64109;1678;139322;5063;55906;116442;84443;27197;8233;548313;6872;27018;100129239;139105;7102;10549;26071;2664;59353;8573;28985;79184;728049;728090;158521;3581;139886;282808;8263;9130;728082;778;90843;1756;5422;7317;5935;347454;29071;207063;4112;412;158506;340602;30848;5127;22866;93380;159091;10159;212;139285;9338;85417;8266;100132399;158584;494118;190;7569;89801;2892;1968;5230;57232;55559;57529;8277;63035;80231;286436;25975;51311;8905;55086;139735;395;83692;171484;10251;169981;1349;63904;139716;257397;142689;80258;27035;1641;55613;7105;100329135;84295;9459;4810;404281;4109;367;474384;6748;139760;347487;92745;158830;53344;4103;9203;139378;186;474343;2719;3597;140456;9248;402415;203430;9185;90161;728042;4129;65267;56849;8228;8226;728036;7114;6399;4952;83740;84889;8481;6757;347468;347475;414;6759;9500;51132;8823;541578;2158;55609;2556;494119;6756;9502;158880;8517;8242;474383;57595;51442;389895;100132304;9754;80311;6102;27328;695;56159;51213;90737;60506;10943;100873985;57526;728269;170082;474382;102723680;728656;3358;8273;83844;114824;389840;170067;81557;80823;8862;2002;7216;79979;158763;23641;55217;8270;57477;7592;2833;425054;340526;727866;139599;139804;54470;8450;959;139562;645864;10075;117154;57631;2010;54521;79589;51634;3750;653282;728072;7076;392490;9363;8623;3920;347411;7454;100506164;265;90293;645051;100529097;55511;158724;6197;203547;139135;5355;347516;203522;139081;6451;27336;158787;728458;7499;4841;347517;51360;340578;139596;1896;441509;54466;660;158798;4108;171482;79868;728075;158833;79366;1821;56156;392465;1260;5160;56062;5303;3054;51260;139628;653220;340596;554;28986;23133;57393;2623;28227;4113;57692;50945;3730;7739;100131755;57481;8260;139170;64219;4204;389860;2574;3563;65991;10325;6170;10813;79710;8712;26280;2316;256714;10742;6173;9104;494197;29057;139324;442444;6103;54880;90736;55558;2742;1736;369;255313;3654;170627;645974;3897;79983;727940;541466;347527;8243;4007;139741;29978;2182;7504;60401;84707;53336;1485;159090;94056;57502;55285;653067;1046;11152;641339;1947;8852;7712;23708;203523;4267;54967;340542;89885;2277;83550;644353;55916;340595;6594;139189;63947;9643;9843;4935;139728;100288814;10479;50943;53940;55026;100507170;5638;4478;8239;4068;51114;139411;246100;9968;84679;115201;100533997;1741;416;64840;10682;11326;25763;27330;171483;8908;27286;1038;7543;158800;90060;1288;84061;215;6247;292;55879;401612;1183;340527;55344;29935;158983;357;10009;2747;2652;286514;340543;54885;100129407;10495;6792;79742;140886;2239;2334;4128;441518;139604;4303;55869;25878;4115;11040;8473;6855;84636;55922;728712;5956;2705;55841;54821;729396;441521;8933;10735;729442;9949;4694;84528;51481;492;3028;100129520;795;10389;83604;7411;9947;9367;100463488;10134;79057;54552;6906;340547;30014;415;5255;680;158809;6990;4435;5475;340529;65109;64860;7030;729428;8776;4675;5030;51566;729201;56271;4943;79917;85012;114928;5256;26609;54960;538;6853;5365;4354;286451;29934;10838;139221;9189;347404;6473;3251;286464;158931;139793;100008586;2717;3052;5973;139065;5199;546;5613;51270;139231;9131;7547;474381;257240;11254;27238;64102;2543;158747;2273;56474;5165;64648;54440;140597;5631;728239;3188;100130086;5251;8237;286527;100130302,815
-1,1,X,60701,155260560,155199859,23096;64061;392509;10214;170685;23157;727837;55998;23439;729431;10916;158586;55859;331;3423;54830;4168;6901;5358;92002;27344;729447;54328;266740;9075;102723737;7552;729422;54954;84460;389874;56000;340562;644538;92552;254158;79649;56850;8225;2824;100272147;51186;3149;26576;100130361;1730;347541;139425;3547;728695;729408;79921;57826;59272;203413;2986;7512;9737;8544;55634;2857;3421;537;11013;340554;5716;6658;4101;54457;1438;91966;441519;4100;5931;27316;7403;4534;6839;51480;728096;27112;92129;101928917;140462;8241;6567;827;203569;27301;84548;645037;54413;100133053;7355;254065;79836;10084;347442;60343;51765;55593;139818;56180;6303;8269;142684;7626;10046;8409;203447;63932;2710;4515;8406;51248;56001;51616;2925;100130613;2564;1193;100132994;5354;11043;340533;22;3476;84631;26748;11238;203562;102723631;170261;58526;441525;4983;29944;6907;1536;2539;1478;9468;23597;2187;1287;81887;6611;3561;9767;9282;54857;347365;10800;139341;54539;11219;728062;169966;51209;23630;26548;1121;2000;645188;51438;2846;280658;1852;347344;23229;10857;56157;286430;101059915;438;5277;9758;1069;4674;154796;56548;51309;1184;645073;80712;1774;10245;2258;728343;9823;441531;11141;643311;90121;256643;23676;4114;6758;4107;286499;5009;1654;1831;51284;94121;170302;11230;79135;286410;9210;2491;441490;84187;633;6191;64743;4110;3598;389856;7789;55787;9452;50814;2157;139422;170062;57187;139067;4104;203427;4693;5456;10013;1964;55190;100996648;293;9016;100528062;30011;90316;93953;10178;6322;28952;24137;2332;4105;6845;94122;84968;64663;1538;9142;286530;2245;5634;9506;79576;3266;139212;5207;6535;8227;393;389852;170626;91851;27334;158866;550643;159013;407;7224;55796;10761;100132963;168400;4281;158835;24140;8471;90167;7737;7319;10149;11279;6134;64109;1678;139322;5063;55906;116442;84443;27197;8233;548313;6872;27018;100129239;139105;7102;10549;26071;2664;59353;8573;28985;79184;728049;728090;158521;3581;139886;282808;8263;9130;728082;778;90843;1756;5422;7317;5935;347454;29071;207063;4112;412;158506;340602;30848;5127;22866;93380;159091;10159;212;139285;9338;85417;8266;100132399;158584;494118;190;7569;89801;2892;1968;5230;57232;55559;57529;8277;63035;80231;286436;25975;51311;8905;55086;139735;395;83692;171484;10251;169981;1349;63904;139716;257397;142689;80258;27035;1641;55613;7105;100329135;84295;9459;4810;404281;4109;367;474384;6748;139760;347487;92745;158830;53344;4103;9203;139378;186;474343;2719;3597;140456;9248;402415;203430;9185;90161;728042;4129;65267;56849;8228;8226;728036;7114;6399;4952;83740;84889;8481;6757;347468;347475;414;6759;9500;51132;8823;541578;2158;55609;2556;494119;6756;9502;158880;8517;8242;474383;57595;51442;389895;100132304;9754;80311;6102;27328;695;56159;51213;90737;60506;10943;100873985;57526;728269;170082;474382;102723680;728656;3358;8273;83844;114824;389840;170067;81557;80823;8862;2002;7216;79979;158763;23641;55217;8270;57477;7592;2833;425054;340526;727866;139599;139804;54470;8450;959;139562;645864;10075;117154;57631;2010;54521;79589;51634;3750;653282;728072;7076;392490;9363;8623;3920;347411;7454;100506164;265;90293;645051;100529097;55511;158724;6197;203547;139135;5355;347516;203522;139081;6451;27336;158787;728458;7499;4841;347517;51360;340578;139596;1896;441509;54466;660;158798;4108;171482;79868;728075;158833;79366;1821;56156;392465;1260;5160;56062;5303;3054;51260;139628;653220;340596;554;28986;23133;57393;2623;28227;4113;57692;50945;3730;7739;100131755;57481;8260;139170;64219;4204;389860;2574;3563;65991;10325;6170;10813;79710;8712;26280;2316;256714;10742;6173;9104;494197;29057;139324;442444;6103;54880;90736;55558;2742;1736;369;255313;3654;170627;645974;3897;79983;727940;541466;347527;8243;4007;139741;29978;2182;7504;60401;84707;53336;1485;159090;94056;57502;55285;653067;1046;11152;641339;1947;8852;7712;23708;203523;4267;54967;340542;89885;2277;83550;644353;55916;340595;6594;139189;63947;9643;9843;4935;139728;100288814;10479;50943;53940;55026;100507170;5638;4478;8239;4068;51114;139411;246100;9968;84679;115201;100533997;1741;416;64840;10682;11326;25763;27330;171483;8908;27286;1038;7543;158800;90060;1288;84061;215;6247;292;55879;401612;1183;340527;55344;29935;158983;357;10009;2747;2652;286514;340543;54885;100129407;10495;6792;79742;140886;2239;2334;4128;441518;139604;4303;55869;25878;4115;11040;8473;6855;84636;55922;728712;5956;2705;55841;54821;729396;441521;8933;10735;729442;9949;4694;84528;51481;492;3028;100129520;795;10389;83604;7411;9947;9367;100463488;10134;79057;54552;6906;340547;30014;415;5255;680;158809;6990;4435;5475;340529;65109;64860;7030;729428;8776;4675;5030;51566;729201;56271;4943;79917;85012;114928;5256;26609;54960;538;6853;5365;4354;286451;29934;10838;139221;9189;347404;6473;3251;286464;158931;139793;100008586;2717;3052;5973;139065;5199;546;5613;51270;139231;9131;7547;474381;257240;11254;27238;64102;2543;158747;2273;56474;5165;64648;54440;140597;5631;728239;3188;100130086;5251;8237;286527;100130302,815
1,1,X,60701,155260560,155199859,23096;64061;392509;10214;170685;23157;727837;55998;23439;729431;10916;158586;55859;331;3423;54830;4168;6901;5358;92002;27344;729447;54328;266740;9075;102723737;7552;729422;54954;84460;389874;56000;340562;644538;92552;254158;79649;56850;8225;2824;100272147;51186;3149;26576;100130361;1730;347541;139425;3547;728695;729408;79921;57826;59272;203413;2986;7512;9737;8544;55634;2857;3421;537;11013;340554;5716;6658;4101;54457;1438;91966;441519;4100;5931;27316;7403;4534;6839;51480;728096;27112;92129;101928917;140462;8241;6567;827;203569;27301;84548;645037;54413;100133053;7355;254065;79836;10084;347442;60343;51765;55593;139818;56180;6303;8269;142684;7626;10046;8409;203447;63932;2710;4515;8406;51248;56001;51616;2925;100130613;2564;1193;100132994;5354;11043;340533;22;3476;84631;26748;11238;203562;102723631;170261;58526;441525;4983;29944;6907;1536;2539;1478;9468;23597;2187;1287;81887;6611;3561;9767;9282;54857;347365;10800;139341;54539;11219;728062;169966;51209;23630;26548;1121;2000;645188;51438;2846;280658;1852;347344;23229;10857;56157;286430;101059915;438;5277;9758;1069;4674;154796;56548;51309;1184;645073;80712;1774;10245;2258;728343;9823;441531;11141;643311;90121;256643;23676;4114;6758;4107;286499;5009;1654;1831;51284;94121;170302;11230;79135;286410;9210;2491;441490;84187;633;6191;64743;4110;3598;389856;7789;55787;9452;50814;2157;139422;170062;57187;139067;4104;203427;4693;5456;10013;1964;55190;100996648;293;9016;100528062;30011;90316;93953;10178;6322;28952;24137;2332;4105;6845;94122;84968;64663;1538;9142;286530;2245;5634;9506;79576;3266;139212;5207;6535;8227;393;389852;170626;91851;27334;158866;550643;159013;407;7224;55796;10761;100132963;168400;4281;158835;24140;8471;90167;7737;7319;10149;11279;6134;64109;1678;139322;5063;55906;116442;84443;27197;8233;548313;6872;27018;100129239;139105;7102;10549;26071;2664;59353;8573;28985;79184;728049;728090;158521;3581;139886;282808;8263;9130;728082;778;90843;1756;5422;7317;5935;347454;29071;207063;4112;412;158506;340602;30848;5127;22866;93380;159091;10159;212;139285;9338;85417;8266;100132399;158584;494118;190;7569;89801;2892;1968;5230;57232;55559;57529;8277;63035;80231;286436;25975;51311;8905;55086;139735;395;83692;171484;10251;169981;1349;63904;139716;257397;142689;80258;27035;1641;55613;7105;100329135;84295;9459;4810;404281;4109;367;474384;6748;139760;347487;92745;158830;53344;4103;9203;139378;186;474343;2719;3597;140456;9248;402415;203430;9185;90161;728042;4129;65267;56849;8228;8226;728036;7114;6399;4952;83740;84889;8481;6757;347468;347475;414;6759;9500;51132;8823;541578;2158;55609;2556;494119;6756;9502;158880;8517;8242;474383;57595;51442;389895;100132304;9754;80311;6102;27328;695;56159;51213;90737;60506;10943;100873985;57526;728269;170082;474382;102723680;728656;3358;8273;83844;114824;389840;170067;81557;80823;8862;2002;7216;79979;158763;23641;55217;8270;57477;7592;2833;425054;340526;727866;139599;139804;54470;8450;959;139562;645864;10075;117154;57631;2010;54521;79589;51634;3750;653282;728072;7076;392490;9363;8623;3920;347411;7454;100506164;265;90293;645051;100529097;55511;158724;6197;203547;139135;5355;347516;203522;139081;6451;27336;158787;728458;7499;4841;347517;51360;340578;139596;1896;441509;54466;660;158798;4108;171482;79868;728075;158833;79366;1821;56156;392465;1260;5160;56062;5303;3054;51260;139628;653220;340596;554;28986;23133;57393;2623;28227;4113;57692;50945;3730;7739;100131755;57481;8260;139170;64219;4204;389860;2574;3563;65991;10325;6170;10813;79710;8712;26280;2316;256714;10742;6173;9104;494197;29057;139324;442444;6103;54880;90736;55558;2742;1736;369;255313;3654;170627;645974;3897;79983;727940;541466;347527;8243;4007;139741;29978;2182;7504;60401;84707;53336;1485;159090;94056;57502;55285;653067;1046;11152;641339;1947;8852;7712;23708;203523;4267;54967;340542;89885;2277;83550;644353;55916;340595;6594;139189;63947;9643;9843;4935;139728;100288814;10479;50943;53940;55026;100507170;5638;4478;8239;4068;51114;139411;246100;9968;84679;115201;100533997;1741;416;64840;10682;11326;25763;27330;171483;8908;27286;1038;7543;158800;90060;1288;84061;215;6247;292;55879;401612;1183;340527;55344;29935;158983;357;10009;2747;2652;286514;340543;54885;100129407;10495;6792;79742;140886;2239;2334;4128;441518;139604;4303;55869;25878;4115;11040;8473;6855;84636;55922;728712;5956;2705;55841;54821;729396;441521;8933;10735;729442;9949;4694;84528;51481;492;3028;100129520;795;10389;83604;7411;9947;9367;100463488;10134;79057;54552;6906;340547;30014;415;5255;680;158809;6990;4435;5475;340529;65109;64860;7030;729428;8776;4675;5030;51566;729201;56271;4943;79917;85012;114928;5256;26609;54960;538;6853;5365;4354;286451;29934;10838;139221;9189;347404;6473;3251;286464;158931;139793;100008586;2717;3052;5973;139065;5199;546;5613;51270;139231;9131;7547;474381;257240;11254;27238;64102;2543;158747;2273;56474;5165;64648;54440;140597;5631;728239;3188;100130086;5251;8237;286527;100130302,815
1,1,X,60701,155260560,155199859,23096;64061;392509;10214;170685;23157;727837;55998;23439;729431;10916;158586;55859;331;3423;54830;4168;6901;5358;92002;27344;729447;54328;266740;9075;102723737;7552;729422;54954;84460;389874;56000;340562;644538;92552;254158;79649;56850;8225;2824;100272147;51186;3149;26576;100130361;1730;347541;139425;3547;728695;729408;79921;57826;59272;203413;2986;7512;9737;8544;55634;2857;3421;537;11013;340554;5716;6658;4101;54457;1438;91966;441519;4100;5931;27316;7403;4534;6839;51480;728096;27112;92129;101928917;140462;8241;6567;827;203569;27301;84548;645037;54413;100133053;7355;254065;79836;10084;347442;60343;51765;55593;139818;56180;6303;8269;142684;7626;10046;8409;203447;63932;2710;4515;8406;51248;56001;51616;2925;100130613;2564;1193;100132994;5354;11043;340533;22;3476;84631;26748;11238;203562;102723631;170261;58526;441525;4983;29944;6907;1536;2539;1478;9468;23597;2187;1287;81887;6611;3561;9767;9282;54857;347365;10800;139341;54539;11219;728062;169966;51209;23630;26548;1121;2000;645188;51438;2846;280658;1852;347344;23229;10857;56157;286430;101059915;438;5277;9758;1069;4674;154796;56548;51309;1184;645073;80712;1774;10245;2258;728343;9823;441531;11141;643311;90121;256643;23676;4114;6758;4107;286499;5009;1654;1831;51284;94121;170302;11230;79135;286410;9210;2491;441490;84187;633;6191;64743;4110;3598;389856;7789;55787;9452;50814;2157;139422;170062;57187;139067;4104;203427;4693;5456;10013;1964;55190;100996648;293;9016;100528062;30011;90316;93953;10178;6322;28952;24137;2332;4105;6845;94122;84968;64663;1538;9142;286530;2245;5634;9506;79576;3266;139212;5207;6535;8227;393;389852;170626;91851;27334;158866;550643;159013;407;7224;55796;10761;100132963;168400;4281;158835;24140;8471;90167;7737;7319;10149;11279;6134;64109;1678;139322;5063;55906;116442;84443;27197;8233;548313;6872;27018;100129239;139105;7102;10549;26071;2664;59353;8573;28985;79184;728049;728090;158521;3581;139886;282808;8263;9130;728082;778;90843;1756;5422;7317;5935;347454;29071;207063;4112;412;158506;340602;30848;5127;22866;93380;159091;10159;212;139285;9338;85417;8266;100132399;158584;494118;190;7569;89801;2892;1968;5230;57232;55559;57529;8277;63035;80231;286436;25975;51311;8905;55086;139735;395;83692;171484;10251;169981;1349;63904;139716;257397;142689;80258;27035;1641;55613;7105;100329135;84295;9459;4810;404281;4109;367;474384;6748;139760;347487;92745;158830;53344;4103;9203;139378;186;474343;2719;3597;140456;9248;402415;203430;9185;90161;728042;4129;65267;56849;8228;8226;728036;7114;6399;4952;83740;84889;8481;6757;347468;347475;414;6759;9500;51132;8823;541578;2158;55609;2556;494119;6756;9502;158880;8517;8242;474383;57595;51442;389895;100132304;9754;80311;6102;27328;695;56159;51213;90737;60506;10943;100873985;57526;728269;170082;474382;102723680;728656;3358;8273;83844;114824;389840;170067;81557;80823;8862;2002;7216;79979;158763;23641;55217;8270;57477;7592;2833;425054;340526;727866;139599;139804;54470;8450;959;139562;645864;10075;117154;57631;2010;54521;79589;51634;3750;653282;728072;7076;392490;9363;8623;3920;347411;7454;100506164;265;90293;645051;100529097;55511;158724;6197;203547;139135;5355;347516;203522;139081;6451;27336;158787;728458;7499;4841;347517;51360;340578;139596;1896;441509;54466;660;158798;4108;171482;79868;728075;158833;79366;1821;56156;392465;1260;5160;56062;5303;3054;51260;139628;653220;340596;554;28986;23133;57393;2623;28227;4113;57692;50945;3730;7739;100131755;57481;8260;139170;64219;4204;389860;2574;3563;65991;10325;6170;10813;79710;8712;26280;2316;256714;10742;6173;9104;494197;29057;139324;442444;6103;54880;90736;55558;2742;1736;369;255313;3654;170627;645974;3897;79983;727940;541466;347527;8243;4007;139741;29978;2182;7504;60401;84707;53336;1485;159090;94056;57502;55285;653067;1046;11152;641339;1947;8852;7712;23708;203523;4267;54967;340542;89885;2277;83550;644353;55916;340595;6594;139189;63947;9643;9843;4935;139728;100288814;10479;50943;53940;55026;100507170;5638;4478;8239;4068;51114;139411;246100;9968;84679;115201;100533997;1741;416;64840;10682;11326;25763;27330;171483;8908;27286;1038;7543;158800;90060;1288;84061;215;6247;292;55879;401612;1183;340527;55344;29935;158983;357;10009;2747;2652;286514;340543;54885;100129407;10495;6792;79742;140886;2239;2334;4128;441518;139604;4303;55869;25878;4115;11040;8473;6855;84636;55922;728712;5956;2705;55841;54821;729396;441521;8933;10735;729442;9949;4694;84528;51481;492;3028;100129520;795;10389;83604;7411;9947;9367;100463488;10134;79057;54552;6906;340547;30014;415;5255;680;158809;6990;4435;5475;340529;65109;64860;7030;729428;8776;4675;5030;51566;729201;56271;4943;79917;85012;114928;5256;26609;54960;538;6853;5365;4354;286451;29934;10838;139221;9189;347404;6473;3251;286464;158931;139793;100008586;2717;3052;5973;139065;5199;546;5613;51270;139231;9131;7547;474381;257240;11254;27238;64102;2543;158747;2273;56474;5165;64648;54440;140597;5631;728239;3188;100130086;5251;8237;286527;100130302,815
1,1,X,60701,155260560,155199859,23096;64061;392509;10214;170685;23157;727837;55998;23439;729431;10916;158586;55859;331;3423;54830;4168;6901;5358;92002;27344;729447;54328;266740;9075;102723737;7552;729422;54954;84460;389874;56000;340562;644538;92552;254158;79649;56850;8225;2824;100272147;51186;3149;26576;100130361;1730;347541;139425;3547;728695;729408;79921;57826;59272;203413;2986;7512;9737;8544;55634;2857;3421;537;11013;340554;5716;6658;4101;54457;1438;91966;441519;4100;5931;27316;7403;4534;6839;51480;728096;27112;92129;101928917;140462;8241;6567;827;203569;27301;84548;645037;54413;100133053;7355;254065;79836;10084;347442;60343;51765;55593;139818;56180;6303;8269;142684;7626;10046;8409;203447;63932;2710;4515;8406;51248;56001;51616;2925;100130613;2564;1193;100132994;5354;11043;340533;22;3476;84631;26748;11238;203562;102723631;170261;58526;441525;4983;29944;6907;1536;2539;1478;9468;23597;2187;1287;81887;6611;3561;9767;9282;54857;347365;10800;139341;54539;11219;728062;169966;51209;23630;26548;1121;2000;645188;51438;2846;280658;1852;347344;23229;10857;56157;286430;101059915;438;5277;9758;1069;4674;154796;56548;51309;1184;645073;80712;1774;10245;2258;728343;9823;441531;11141;643311;90121;256643;23676;4114;6758;4107;286499;5009;1654;1831;51284;94121;170302;11230;79135;286410;9210;2491;441490;84187;633;6191;64743;4110;3598;389856;7789;55787;9452;50814;2157;139422;170062;57187;139067;4104;203427;4693;5456;10013;1964;55190;100996648;293;9016;100528062;30011;90316;93953;10178;6322;28952;24137;2332;4105;6845;94122;84968;64663;1538;9142;286530;2245;5634;9506;79576;3266;139212;5207;6535;8227;393;389852;170626;91851;27334;158866;550643;159013;407;7224;55796;10761;100132963;168400;4281;158835;24140;8471;90167;7737;7319;10149;11279;6134;64109;1678;139322;5063;55906;116442;84443;27197;8233;548313;6872;27018;100129239;139105;7102;10549;26071;2664;59353;8573;28985;79184;728049;728090;158521;3581;139886;282808;8263;9130;728082;778;90843;1756;5422;7317;5935;347454;29071;207063;4112;412;158506;340602;30848;5127;22866;93380;159091;10159;212;139285;9338;85417;8266;100132399;158584;494118;190;7569;89801;2892;1968;5230;57232;55559;57529;8277;63035;80231;286436;25975;51311;8905;55086;139735;395;83692;171484;10251;169981;1349;63904;139716;257397;142689;80258;27035;1641;55613;7105;100329135;84295;9459;4810;404281;4109;367;474384;6748;139760;347487;92745;158830;53344;4103;9203;139378;186;474343;2719;3597;140456;9248;402415;203430;9185;90161;728042;4129;65267;56849;8228;8226;728036;7114;6399;4952;83740;84889;8481;6757;347468;347475;414;6759;9500;51132;8823;541578;2158;55609;2556;494119;6756;9502;158880;8517;8242;474383;57595;51442;389895;100132304;9754;80311;6102;27328;695;56159;51213;90737;60506;10943;100873985;57526;728269;170082;474382;102723680;728656;3358;8273;83844;114824;389840;170067;81557;80823;8862;2002;7216;79979;158763;23641;55217;8270;57477;7592;2833;425054;340526;727866;139599;139804;54470;8450;959;139562;645864;10075;117154;57631;2010;54521;79589;51634;3750;653282;728072;7076;392490;9363;8623;3920;347411;7454;100506164;265;90293;645051;100529097;55511;158724;6197;203547;139135;5355;347516;203522;139081;6451;27336;158787;728458;7499;4841;347517;51360;340578;139596;1896;441509;54466;660;158798;4108;171482;79868;728075;158833;79366;1821;56156;392465;1260;5160;56062;5303;3054;51260;139628;653220;340596;554;28986;23133;57393;2623;28227;4113;57692;50945;3730;7739;100131755;57481;8260;139170;64219;4204;389860;2574;3563;65991;10325;6170;10813;79710;8712;26280;2316;256714;10742;6173;9104;494197;29057;139324;442444;6103;54880;90736;55558;2742;1736;369;255313;3654;170627;645974;3897;79983;727940;541466;347527;8243;4007;139741;29978;2182;7504;60401;84707;53336;1485;159090;94056;57502;55285;653067;1046;11152;641339;1947;8852;7712;23708;203523;4267;54967;340542;89885;2277;83550;644353;55916;340595;6594;139189;63947;9643;9843;4935;139728;100288814;10479;50943;53940;55026;100507170;5638;4478;8239;4068;51114;139411;246100;9968;84679;115201;100533997;1741;416;64840;10682;11326;25763;27330;171483;8908;27286;1038;7543;158800;90060;1288;84061;215;6247;292;55879;401612;1183;340527;55344;29935;158983;357;10009;2747;2652;286514;340543;54885;100129407;10495;6792;79742;140886;2239;2334;4128;441518;139604;4303;55869;25878;4115;11040;8473;6855;84636;55922;728712;5956;2705;55841;54821;729396;441521;8933;10735;729442;9949;4694;84528;51481;492;3028;100129520;795;10389;83604;7411;9947;9367;100463488;10134;79057;54552;6906;340547;30014;415;5255;680;158809;6990;4435;5475;340529;65109;64860;7030;729428;8776;4675;5030;51566;729201;56271;4943;79917;85012;114928;5256;26609;54960;538;6853;5365;4354;286451;29934;10838;139221;9189;347404;6473;3251;286464;158931;139793;100008586;2717;3052;5973;139065;5199;546;5613;51270;139231;9131;7547;474381;257240;11254;27238;64102;2543;158747;2273;56474;5165;64648;54440;140597;5631;728239;3188;100130086;5251;8237;286527;100130302,815
1,1,X,60701,155260560,155199859,23096;64061;392509;10214;170685;23157;727837;55998;23439;729431;10916;158586;55859;331;3423;54830;4168;6901;5358;92002;27344;729447;54328;266740;9075;102723737;7552;729422;54954;84460;389874;56000;340562;644538;92552;254158;79649;56850;8225;2824;100272147;51186;3149;26576;100130361;1730;347541;139425;3547;728695;729408;79921;57826;59272;203413;2986;7512;9737;8544;55634;2857;3421;537;11013;340554;5716;6658;4101;54457;1438;91966;441519;4100;5931;27316;7403;4534;6839;51480;728096;27112;92129;101928917;140462;8241;6567;827;203569;27301;84548;645037;54413;100133053;7355;254065;79836;10084;347442;60343;51765;55593;139818;56180;6303;8269;142684;7626;10046;8409;203447;63932;2710;4515;8406;51248;56001;51616;2925;100130613;2564;1193;100132994;5354;11043;340533;22;3476;84631;26748;11238;203562;102723631;170261;58526;441525;4983;29944;6907;1536;2539;1478;9468;23597;2187;1287;81887;6611;3561;9767;9282;54857;347365;10800;139341;54539;11219;728062;169966;51209;23630;26548;1121;2000;645188;51438;2846;280658;1852;347344;23229;10857;56157;286430;101059915;438;5277;9758;1069;4674;154796;56548;51309;1184;645073;80712;1774;10245;2258;728343;9823;441531;11141;643311;90121;256643;23676;4114;6758;4107;286499;5009;1654;1831;51284;94121;170302;11230;79135;286410;9210;2491;441490;84187;633;6191;64743;4110;3598;389856;7789;55787;9452;50814;2157;139422;170062;57187;139067;4104;203427;4693;5456;10013;1964;55190;100996648;293;9016;100528062;30011;90316;93953;10178;6322;28952;24137;2332;4105;6845;94122;84968;64663;1538;9142;286530;2245;5634;9506;79576;3266;139212;5207;6535;8227;393;389852;170626;91851;27334;158866;550643;159013;407;7224;55796;10761;100132963;168400;4281;158835;24140;8471;90167;7737;7319;10149;11279;6134;64109;1678;139322;5063;55906;116442;84443;27197;8233;548313;6872;27018;100129239;139105;7102;10549;26071;2664;59353;8573;28985;79184;728049;728090;158521;3581;139886;282808;8263;9130;728082;778;90843;1756;5422;7317;5935;347454;29071;207063;4112;412;158506;340602;30848;5127;22866;93380;159091;10159;212;139285;9338;85417;8266;100132399;158584;494118;190;7569;89801;2892;1968;5230;57232;55559;57529;8277;63035;80231;286436;25975;51311;8905;55086;139735;395;83692;171484;10251;169981;1349;63904;139716;257397;142689;80258;27035;1641;55613;7105;100329135;84295;9459;4810;404281;4109;367;474384;6748;139760;347487;92745;158830;53344;4103;9203;139378;186;474343;2719;3597;140456;9248;402415;203430;9185;90161;728042;4129;65267;56849;8228;8226;728036;7114;6399;4952;83740;84889;8481;6757;347468;347475;414;6759;9500;51132;8823;541578;2158;55609;2556;494119;6756;9502;158880;8517;8242;474383;57595;51442;389895;100132304;9754;80311;6102;27328;695;56159;51213;90737;60506;10943;100873985;57526;728269;170082;474382;102723680;728656;3358;8273;83844;114824;389840;170067;81557;80823;8862;2002;7216;79979;158763;23641;55217;8270;57477;7592;2833;425054;340526;727866;139599;139804;54470;8450;959;139562;645864;10075;117154;57631;2010;54521;79589;51634;3750;653282;728072;7076;392490;9363;8623;3920;347411;7454;100506164;265;90293;645051;100529097;55511;158724;6197;203547;139135;5355;347516;203522;139081;6451;27336;158787;728458;7499;4841;347517;51360;340578;139596;1896;441509;54466;660;158798;4108;171482;79868;728075;158833;79366;1821;56156;392465;1260;5160;56062;5303;3054;51260;139628;653220;340596;554;28986;23133;57393;2623;28227;4113;57692;50945;3730;7739;100131755;57481;8260;139170;64219;4204;389860;2574;3563;65991;10325;6170;10813;79710;8712;26280;2316;256714;10742;6173;9104;494197;29057;139324;442444;6103;54880;90736;55558;2742;1736;369;255313;3654;170627;645974;3897;79983;727940;541466;347527;8243;4007;139741;29978;2182;7504;60401;84707;53336;1485;159090;94056;57502;55285;653067;1046;11152;641339;1947;8852;7712;23708;203523;4267;54967;340542;89885;2277;83550;644353;55916;340595;6594;139189;63947;9643;9843;4935;139728;100288814;10479;50943;53940;55026;100507170;5638;4478;8239;4068;51114;139411;246100;9968;84679;115201;100533997;1741;416;64840;10682;11326;25763;27330;171483;8908;27286;1038;7543;158800;90060;1288;84061;215;6247;292;55879;401612;1183;340527;55344;29935;158983;357;10009;2747;2652;286514;340543;54885;100129407;10495;6792;79742;140886;2239;2334;4128;441518;139604;4303;55869;25878;4115;11040;8473;6855;84636;55922;728712;5956;2705;55841;54821;729396;441521;8933;10735;729442;9949;4694;84528;51481;492;3028;100129520;795;10389;83604;7411;9947;9367;100463488;10134;79057;54552;6906;340547;30014;415;5255;680;158809;6990;4435;5475;340529;65109;64860;7030;729428;8776;4675;5030;51566;729201;56271;4943;79917;85012;114928;5256;26609;54960;538;6853;5365;4354;286451;29934;10838;139221;9189;347404;6473;3251;286464;158931;139793;100008586;2717;3052;5973;139065;5199;546;5613;51270;139231;9131;7547;474381;257240;11254;27238;64102;2543;158747;2273;56474;5165;64648;54440;140597;5631;728239;3188;100130086;5251;8237;286527;100130302,815
1,-1,X,60702,92362,31660,,0
-1,1,X,70140,9427683,9357543,414;51481;171482;425054;1438;5613;347527;415;207063;293;412;438;64109;51480;55344;8623;28227;286530;57502;8226;8228;3730;8225;3563;26609;25878;416;4267;7499;9189;6473;8227;171483;8908,34
-1,1,X,70297,643638,573341,55344;6473;28227;8225,4
-1,1,X,70297,8654089,8583792,414;51481;425054;1438;5613;347527;415;207063;293;412;438;64109;51480;55344;8623;28227;286530;57502;8226;8228;3730;8225;3563;26609;25878;416;4267;7499;9189;6473;8227;8908,32
1,1,X,70297,155228918,155158621,23096;64061;392509;10214;170685;23157;727837;55998;23439;729431;10916;158586;55859;331;3423;54830;4168;6901;5358;92002;27344;729447;54328;266740;9075;102723737;7552;729422;54954;84460;389874;56000;340562;644538;92552;254158;79649;56850;8225;2824;100272147;51186;3149;26576;100130361;1730;347541;139425;3547;728695;729408;79921;57826;59272;203413;2986;7512;9737;8544;55634;2857;3421;537;11013;340554;5716;6658;4101;54457;1438;91966;441519;4100;5931;27316;7403;4534;6839;51480;728096;27112;92129;101928917;140462;8241;6567;827;203569;27301;84548;645037;54413;100133053;7355;254065;79836;10084;347442;60343;51765;55593;139818;56180;6303;8269;142684;7626;10046;8409;203447;63932;2710;4515;8406;51248;56001;51616;2925;100130613;2564;1193;100132994;5354;11043;340533;22;3476;84631;26748;11238;203562;102723631;170261;58526;441525;4983;29944;6907;1536;2539;1478;9468;23597;2187;1287;81887;6611;3561;9767;9282;54857;347365;10800;139341;54539;11219;728062;169966;51209;23630;26548;1121;2000;645188;51438;2846;280658;1852;347344;23229;10857;56157;286430;101059915;438;5277;9758;1069;4674;154796;56548;51309;1184;645073;80712;1774;10245;2258;728343;9823;441531;11141;643311;90121;256643;23676;4114;6758;4107;286499;5009;1654;1831;51284;94121;170302;11230;79135;286410;9210;2491;441490;84187;633;6191;64743;4110;3598;389856;7789;55787;9452;50814;2157;139422;170062;57187;139067;4104;203427;4693;5456;10013;1964;55190;100996648;293;9016;100528062;30011;90316;93953;10178;6322;28952;24137;2332;4105;6845;94122;84968;64663;1538;9142;286530;2245;5634;9506;79576;3266;139212;5207;6535;8227;393;389852;170626;91851;27334;158866;550643;159013;407;7224;55796;10761;100132963;168400;4281;158835;24140;8471;90167;7737;7319;10149;11279;6134;64109;1678;139322;5063;55906;116442;84443;27197;8233;548313;6872;27018;100129239;139105;7102;10549;26071;2664;59353;8573;28985;79184;728049;728090;158521;3581;139886;282808;8263;9130;728082;778;90843;1756;5422;7317;5935;347454;29071;207063;4112;412;158506;340602;30848;5127;22866;93380;159091;10159;212;139285;9338;85417;8266;100132399;158584;494118;190;7569;89801;2892;1968;5230;57232;55559;57529;8277;63035;80231;286436;25975;51311;8905;55086;139735;395;83692;171484;10251;169981;1349;63904;139716;257397;142689;80258;27035;1641;55613;7105;100329135;84295;9459;4810;404281;4109;367;474384;6748;139760;347487;92745;158830;53344;4103;9203;139378;186;474343;2719;3597;140456;9248;402415;203430;9185;90161;728042;4129;65267;56849;8228;8226;728036;7114;6399;4952;83740;84889;8481;6757;347468;347475;414;6759;9500;51132;8823;541578;2158;55609;2556;494119;6756;9502;158880;8517;8242;474383;57595;51442;389895;100132304;9754;80311;6102;27328;695;56159;51213;90737;60506;10943;100873985;57526;728269;170082;474382;102723680;728656;3358;8273;83844;114824;389840;170067;81557;80823;8862;2002;7216;79979;158763;23641;55217;8270;57477;7592;2833;425054;340526;727866;139599;139804;54470;8450;959;139562;645864;10075;117154;57631;2010;54521;79589;51634;3750;653282;728072;7076;392490;9363;8623;3920;347411;7454;100506164;265;90293;645051;100529097;55511;158724;6197;203547;139135;5355;347516;203522;139081;6451;27336;158787;728458;7499;4841;347517;51360;340578;139596;1896;441509;54466;660;158798;4108;171482;79868;728075;158833;79366;1821;56156;392465;1260;5160;56062;5303;3054;51260;139628;653220;340596;554;28986;23133;57393;2623;28227;4113;57692;50945;3730;7739;100131755;57481;8260;139170;64219;4204;389860;2574;3563;65991;10325;6170;10813;79710;8712;26280;2316;256714;10742;6173;9104;494197;29057;139324;442444;6103;54880;90736;55558;2742;1736;369;255313;3654;170627;645974;3897;79983;727940;541466;347527;8243;4007;139741;29978;2182;7504;60401;84707;53336;1485;159090;94056;57502;55285;653067;1046;11152;641339;1947;8852;7712;23708;203523;4267;54967;340542;89885;2277;83550;644353;55916;340595;6594;139189;63947;9643;9843;4935;139728;100288814;10479;50943;53940;55026;100507170;5638;4478;8239;4068;51114;139411;246100;9968;84679;115201;100533997;1741;416;64840;10682;11326;25763;27330;171483;8908;27286;1038;7543;158800;90060;1288;84061;215;6247;292;55879;401612;1183;340527;55344;29935;158983;357;10009;2747;2652;286514;340543;54885;100129407;10495;6792;79742;140886;2239;2334;4128;441518;139604;4303;55869;25878;4115;11040;8473;6855;84636;55922;728712;5956;2705;55841;54821;729396;441521;8933;10735;729442;9949;4694;84528;51481;492;3028;100129520;795;10389;83604;7411;9947;9367;100463488;10134;79057;54552;6906;340547;30014;415;5255;680;158809;6990;4435;5475;340529;65109;64860;7030;729428;8776;4675;5030;51566;729201;56271;4943;79917;85012;114928;5256;26609;54960;538;6853;5365;4354;286451;29934;10838;139221;9189;347404;6473;3251;286464;158931;139793;100008586;2717;3052;5973;139065;5199;546;5613;51270;139231;9131;7547;474381;257240;11254;27238;64102;2543;158747;2273;56474;5165;64648;54440;140597;5631;728239;3188;100130086;5251;8237;286527;100130302,815
1,1,X,70297,155246585,155176288,23096;64061;392509;10214;170685;23157;727837;55998;23439;729431;10916;158586;55859;331;3423;54830;4168;6901;5358;92002;27344;729447;54328;266740;9075;102723737;7552;729422;54954;84460;389874;56000;340562;644538;92552;254158;79649;56850;8225;2824;100272147;51186;3149;26576;100130361;1730;347541;139425;3547;728695;729408;79921;57826;59272;203413;2986;7512;9737;8544;55634;2857;3421;537;11013;340554;5716;6658;4101;54457;1438;91966;441519;4100;5931;27316;7403;4534;6839;51480;728096;27112;92129;101928917;140462;8241;6567;827;203569;27301;84548;645037;54413;100133053;7355;254065;79836;10084;347442;60343;51765;55593;139818;56180;6303;8269;142684;7626;10046;8409;203447;63932;2710;4515;8406;51248;56001;51616;2925;100130613;2564;1193;100132994;5354;11043;340533;22;3476;84631;26748;11238;203562;102723631;170261;58526;441525;4983;29944;6907;1536;2539;1478;9468;23597;2187;1287;81887;6611;3561;9767;9282;54857;347365;10800;139341;54539;11219;728062;169966;51209;23630;26548;1121;2000;645188;51438;2846;280658;1852;347344;23229;10857;56157;286430;101059915;438;5277;9758;1069;4674;154796;56548;51309;1184;645073;80712;1774;10245;2258;728343;9823;441531;11141;643311;90121;256643;23676;4114;6758;4107;286499;5009;1654;1831;51284;94121;170302;11230;79135;286410;9210;2491;441490;84187;633;6191;64743;4110;3598;389856;7789;55787;9452;50814;2157;139422;170062;57187;139067;4104;203427;4693;5456;10013;1964;55190;100996648;293;9016;100528062;30011;90316;93953;10178;6322;28952;24137;2332;4105;6845;94122;84968;64663;1538;9142;286530;2245;5634;9506;79576;3266;139212;5207;6535;8227;393;389852;170626;91851;27334;158866;550643;159013;407;7224;55796;10761;100132963;168400;4281;158835;24140;8471;90167;7737;7319;10149;11279;6134;64109;1678;139322;5063;55906;116442;84443;27197;8233;548313;6872;27018;100129239;139105;7102;10549;26071;2664;59353;8573;28985;79184;728049;728090;158521;3581;139886;282808;8263;9130;728082;778;90843;1756;5422;7317;5935;347454;29071;207063;4112;412;158506;340602;30848;5127;22866;93380;159091;10159;212;139285;9338;85417;8266;100132399;158584;494118;190;7569;89801;2892;1968;5230;57232;55559;57529;8277;63035;80231;286436;25975;51311;8905;55086;139735;395;83692;171484;10251;169981;1349;63904;139716;257397;142689;80258;27035;1641;55613;7105;100329135;84295;9459;4810;404281;4109;367;474384;6748;139760;347487;92745;158830;53344;4103;9203;139378;186;474343;2719;3597;140456;9248;402415;203430;9185;90161;728042;4129;65267;56849;8228;8226;728036;7114;6399;4952;83740;84889;8481;6757;347468;347475;414;6759;9500;51132;8823;541578;2158;55609;2556;494119;6756;9502;158880;8517;8242;474383;57595;51442;389895;100132304;9754;80311;6102;27328;695;56159;51213;90737;60506;10943;100873985;57526;728269;170082;474382;102723680;728656;3358;8273;83844;114824;389840;170067;81557;80823;8862;2002;7216;79979;158763;23641;55217;8270;57477;7592;2833;425054;340526;727866;139599;139804;54470;8450;959;139562;645864;10075;117154;57631;2010;54521;79589;51634;3750;653282;728072;7076;392490;9363;8623;3920;347411;7454;100506164;265;90293;645051;100529097;55511;158724;6197;203547;139135;5355;347516;203522;139081;6451;27336;158787;728458;7499;4841;347517;51360;340578;139596;1896;441509;54466;660;158798;4108;171482;79868;728075;158833;79366;1821;56156;392465;1260;5160;56062;5303;3054;51260;139628;653220;340596;554;28986;23133;57393;2623;28227;4113;57692;50945;3730;7739;100131755;57481;8260;139170;64219;4204;389860;2574;3563;65991;10325;6170;10813;79710;8712;26280;2316;256714;10742;6173;9104;494197;29057;139324;442444;6103;54880;90736;55558;2742;1736;369;255313;3654;170627;645974;3897;79983;727940;541466;347527;8243;4007;139741;29978;2182;7504;60401;84707;53336;1485;159090;94056;57502;55285;653067;1046;11152;641339;1947;8852;7712;23708;203523;4267;54967;340542;89885;2277;83550;644353;55916;340595;6594;139189;63947;9643;9843;4935;139728;100288814;10479;50943;53940;55026;100507170;5638;4478;8239;4068;51114;139411;246100;9968;84679;115201;100533997;1741;416;64840;10682;11326;25763;27330;171483;8908;27286;1038;7543;158800;90060;1288;84061;215;6247;292;55879;401612;1183;340527;55344;29935;158983;357;10009;2747;2652;286514;340543;54885;100129407;10495;6792;79742;140886;2239;2334;4128;441518;139604;4303;55869;25878;4115;11040;8473;6855;84636;55922;728712;5956;2705;55841;54821;729396;441521;8933;10735;729442;9949;4694;84528;51481;492;3028;100129520;795;10389;83604;7411;9947;9367;100463488;10134;79057;54552;6906;340547;30014;415;5255;680;158809;6990;4435;5475;340529;65109;64860;7030;729428;8776;4675;5030;51566;729201;56271;4943;79917;85012;114928;5256;26609;54960;538;6853;5365;4354;286451;29934;10838;139221;9189;347404;6473;3251;286464;158931;139793;100008586;2717;3052;5973;139065;5199;546;5613;51270;139231;9131;7547;474381;257240;11254;27238;64102;2543;158747;2273;56474;5165;64648;54440;140597;5631;728239;3188;100130086;5251;8237;286527;100130302,815
1,1,X,70297,155246585,155176288,23096;64061;392509;10214;170685;23157;727837;55998;23439;729431;10916;158586;55859;331;3423;54830;4168;6901;5358;92002;27344;729447;54328;266740;9075;102723737;7552;729422;54954;84460;389874;56000;340562;644538;92552;254158;79649;56850;8225;2824;100272147;51186;3149;26576;100130361;1730;347541;139425;3547;728695;729408;79921;57826;59272;203413;2986;7512;9737;8544;55634;2857;3421;537;11013;340554;5716;6658;4101;54457;1438;91966;441519;4100;5931;27316;7403;4534;6839;51480;728096;27112;92129;101928917;140462;8241;6567;827;203569;27301;84548;645037;54413;100133053;7355;254065;79836;10084;347442;60343;51765;55593;139818;56180;6303;8269;142684;7626;10046;8409;203447;63932;2710;4515;8406;51248;56001;51616;2925;100130613;2564;1193;100132994;5354;11043;340533;22;3476;84631;26748;11238;203562;102723631;170261;58526;441525;4983;29944;6907;1536;2539;1478;9468;23597;2187;1287;81887;6611;3561;9767;9282;54857;347365;10800;139341;54539;11219;728062;169966;51209;23630;26548;1121;2000;645188;51438;2846;280658;1852;347344;23229;10857;56157;286430;101059915;438;5277;9758;1069;4674;154796;56548;51309;1184;645073;80712;1774;10245;2258;728343;9823;441531;11141;643311;90121;256643;23676;4114;6758;4107;286499;5009;1654;1831;51284;94121;170302;11230;79135;286410;9210;2491;441490;84187;633;6191;64743;4110;3598;389856;7789;55787;9452;50814;2157;139422;170062;57187;139067;4104;203427;4693;5456;10013;1964;55190;100996648;293;9016;100528062;30011;90316;93953;10178;6322;28952;24137;2332;4105;6845;94122;84968;64663;1538;9142;286530;2245;5634;9506;79576;3266;139212;5207;6535;8227;393;389852;170626;91851;27334;158866;550643;159013;407;7224;55796;10761;100132963;168400;4281;158835;24140;8471;90167;7737;7319;10149;11279;6134;64109;1678;139322;5063;55906;116442;84443;27197;8233;548313;6872;27018;100129239;139105;7102;10549;26071;2664;59353;8573;28985;79184;728049;728090;158521;3581;139886;282808;8263;9130;728082;778;90843;1756;5422;7317;5935;347454;29071;207063;4112;412;158506;340602;30848;5127;22866;93380;159091;10159;212;139285;9338;85417;8266;100132399;158584;494118;190;7569;89801;2892;1968;5230;57232;55559;57529;8277;63035;80231;286436;25975;51311;8905;55086;139735;395;83692;171484;10251;169981;1349;63904;139716;257397;142689;80258;27035;1641;55613;7105;100329135;84295;9459;4810;404281;4109;367;474384;6748;139760;347487;92745;158830;53344;4103;9203;139378;186;474343;2719;3597;140456;9248;402415;203430;9185;90161;728042;4129;65267;56849;8228;8226;728036;7114;6399;4952;83740;84889;8481;6757;347468;347475;414;6759;9500;51132;8823;541578;2158;55609;2556;494119;6756;9502;158880;8517;8242;474383;57595;51442;389895;100132304;9754;80311;6102;27328;695;56159;51213;90737;60506;10943;100873985;57526;728269;170082;474382;102723680;728656;3358;8273;83844;114824;389840;170067;81557;80823;8862;2002;7216;79979;158763;23641;55217;8270;57477;7592;2833;425054;340526;727866;139599;139804;54470;8450;959;139562;645864;10075;117154;57631;2010;54521;79589;51634;3750;653282;728072;7076;392490;9363;8623;3920;347411;7454;100506164;265;90293;645051;100529097;55511;158724;6197;203547;139135;5355;347516;203522;139081;6451;27336;158787;728458;7499;4841;347517;51360;340578;139596;1896;441509;54466;660;158798;4108;171482;79868;728075;158833;79366;1821;56156;392465;1260;5160;56062;5303;3054;51260;139628;653220;340596;554;28986;23133;57393;2623;28227;4113;57692;50945;3730;7739;100131755;57481;8260;139170;64219;4204;389860;2574;3563;65991;10325;6170;10813;79710;8712;26280;2316;256714;10742;6173;9104;494197;29057;139324;442444;6103;54880;90736;55558;2742;1736;369;255313;3654;170627;645974;3897;79983;727940;541466;347527;8243;4007;139741;29978;2182;7504;60401;84707;53336;1485;159090;94056;57502;55285;653067;1046;11152;641339;1947;8852;7712;23708;203523;4267;54967;340542;89885;2277;83550;644353;55916;340595;6594;139189;63947;9643;9843;4935;139728;100288814;10479;50943;53940;55026;100507170;5638;4478;8239;4068;51114;139411;246100;9968;84679;115201;100533997;1741;416;64840;10682;11326;25763;27330;171483;8908;27286;1038;7543;158800;90060;1288;84061;215;6247;292;55879;401612;1183;340527;55344;29935;158983;357;10009;2747;2652;286514;340543;54885;100129407;10495;6792;79742;140886;2239;2334;4128;441518;139604;4303;55869;25878;4115;11040;8473;6855;84636;55922;728712;5956;2705;55841;54821;729396;441521;8933;10735;729442;9949;4694;84528;51481;492;3028;100129520;795;10389;83604;7411;9947;9367;100463488;10134;79057;54552;6906;340547;30014;415;5255;680;158809;6990;4435;5475;340529;65109;64860;7030;729428;8776;4675;5030;51566;729201;56271;4943;79917;85012;114928;5256;26609;54960;538;6853;5365;4354;286451;29934;10838;139221;9189;347404;6473;3251;286464;158931;139793;100008586;2717;3052;5973;139065;5199;546;5613;51270;139231;9131;7547;474381;257240;11254;27238;64102;2543;158747;2273;56474;5165;64648;54440;140597;5631;728239;3188;100130086;5251;8237;286527;100130302,815
-1,1,X,70297,155246585,155176288,23096;64061;392509;10214;170685;23157;727837;55998;23439;729431;10916;158586;55859;331;3423;54830;4168;6901;5358;92002;27344;729447;54328;266740;9075;102723737;7552;729422;54954;84460;389874;56000;340562;644538;92552;254158;79649;56850;8225;2824;100272147;51186;3149;26576;100130361;1730;347541;139425;3547;728695;729408;79921;57826;59272;203413;2986;7512;9737;8544;55634;2857;3421;537;11013;340554;5716;6658;4101;54457;1438;91966;441519;4100;5931;27316;7403;4534;6839;51480;728096;27112;92129;101928917;140462;8241;6567;827;203569;27301;84548;645037;54413;100133053;7355;254065;79836;10084;347442;60343;51765;55593;139818;56180;6303;8269;142684;7626;10046;8409;203447;63932;2710;4515;8406;51248;56001;51616;2925;100130613;2564;1193;100132994;5354;11043;340533;22;3476;84631;26748;11238;203562;102723631;170261;58526;441525;4983;29944;6907;1536;2539;1478;9468;23597;2187;1287;81887;6611;3561;9767;9282;54857;347365;10800;139341;54539;11219;728062;169966;51209;23630;26548;1121;2000;645188;51438;2846;280658;1852;347344;23229;10857;56157;286430;101059915;438;5277;9758;1069;4674;154796;56548;51309;1184;645073;80712;1774;10245;2258;728343;9823;441531;11141;643311;90121;256643;23676;4114;6758;4107;286499;5009;1654;1831;51284;94121;170302;11230;79135;286410;9210;2491;441490;84187;633;6191;64743;4110;3598;389856;7789;55787;9452;50814;2157;139422;170062;57187;139067;4104;203427;4693;5456;10013;1964;55190;100996648;293;9016;100528062;30011;90316;93953;10178;6322;28952;24137;2332;4105;6845;94122;84968;64663;1538;9142;286530;2245;5634;9506;79576;3266;139212;5207;6535;8227;393;389852;170626;91851;27334;158866;550643;159013;407;7224;55796;10761;100132963;168400;4281;158835;24140;8471;90167;7737;7319;10149;11279;6134;64109;1678;139322;5063;55906;116442;84443;27197;8233;548313;6872;27018;100129239;139105;7102;10549;26071;2664;59353;8573;28985;79184;728049;728090;158521;3581;139886;282808;8263;9130;728082;778;90843;1756;5422;7317;5935;347454;29071;207063;4112;412;158506;340602;30848;5127;22866;93380;159091;10159;212;139285;9338;85417;8266;100132399;158584;494118;190;7569;89801;2892;1968;5230;57232;55559;57529;8277;63035;80231;286436;25975;51311;8905;55086;139735;395;83692;171484;10251;169981;1349;63904;139716;257397;142689;80258;27035;1641;55613;7105;100329135;84295;9459;4810;404281;4109;367;474384;6748;139760;347487;92745;158830;53344;4103;9203;139378;186;474343;2719;3597;140456;9248;402415;203430;9185;90161;728042;4129;65267;56849;8228;8226;728036;7114;6399;4952;83740;84889;8481;6757;347468;347475;414;6759;9500;51132;8823;541578;2158;55609;2556;494119;6756;9502;158880;8517;8242;474383;57595;51442;389895;100132304;9754;80311;6102;27328;695;56159;51213;90737;60506;10943;100873985;57526;728269;170082;474382;102723680;728656;3358;8273;83844;114824;389840;170067;81557;80823;8862;2002;7216;79979;158763;23641;55217;8270;57477;7592;2833;425054;340526;727866;139599;139804;54470;8450;959;139562;645864;10075;117154;57631;2010;54521;79589;51634;3750;653282;728072;7076;392490;9363;8623;3920;347411;7454;100506164;265;90293;645051;100529097;55511;158724;6197;203547;139135;5355;347516;203522;139081;6451;27336;158787;728458;7499;4841;347517;51360;340578;139596;1896;441509;54466;660;158798;4108;171482;79868;728075;158833;79366;1821;56156;392465;1260;5160;56062;5303;3054;51260;139628;653220;340596;554;28986;23133;57393;2623;28227;4113;57692;50945;3730;7739;100131755;57481;8260;139170;64219;4204;389860;2574;3563;65991;10325;6170;10813;79710;8712;26280;2316;256714;10742;6173;9104;494197;29057;139324;442444;6103;54880;90736;55558;2742;1736;369;255313;3654;170627;645974;3897;79983;727940;541466;347527;8243;4007;139741;29978;2182;7504;60401;84707;53336;1485;159090;94056;57502;55285;653067;1046;11152;641339;1947;8852;7712;23708;203523;4267;54967;340542;89885;2277;83550;644353;55916;340595;6594;139189;63947;9643;9843;4935;139728;100288814;10479;50943;53940;55026;100507170;5638;4478;8239;4068;51114;139411;246100;9968;84679;115201;100533997;1741;416;64840;10682;11326;25763;27330;171483;8908;27286;1038;7543;158800;90060;1288;84061;215;6247;292;55879;401612;1183;340527;55344;29935;158983;357;10009;2747;2652;286514;340543;54885;100129407;10495;6792;79742;140886;2239;2334;4128;441518;139604;4303;55869;25878;4115;11040;8473;6855;84636;55922;728712;5956;2705;55841;54821;729396;441521;8933;10735;729442;9949;4694;84528;51481;492;3028;100129520;795;10389;83604;7411;9947;9367;100463488;10134;79057;54552;6906;340547;30014;415;5255;680;158809;6990;4435;5475;340529;65109;64860;7030;729428;8776;4675;5030;51566;729201;56271;4943;79917;85012;114928;5256;26609;54960;538;6853;5365;4354;286451;29934;10838;139221;9189;347404;6473;3251;286464;158931;139793;100008586;2717;3052;5973;139065;5199;546;5613;51270;139231;9131;7547;474381;257240;11254;27238;64102;2543;158747;2273;56474;5165;64648;54440;140597;5631;728239;3188;100130086;5251;8237;286527;100130302,815
-1,1,X,70297,155255792,155185495,23096;64061;392509;10214;170685;23157;727837;55998;23439;729431;10916;158586;55859;331;3423;54830;4168;6901;5358;92002;27344;729447;54328;266740;9075;102723737;7552;729422;54954;84460;389874;56000;340562;644538;92552;254158;79649;56850;8225;2824;100272147;51186;3149;26576;100130361;1730;347541;139425;3547;728695;729408;79921;57826;59272;203413;2986;7512;9737;8544;55634;2857;3421;537;11013;340554;5716;6658;4101;54457;1438;91966;441519;4100;5931;27316;7403;4534;6839;51480;728096;27112;92129;101928917;140462;8241;6567;827;203569;27301;84548;645037;54413;100133053;7355;254065;79836;10084;347442;60343;51765;55593;139818;56180;6303;8269;142684;7626;10046;8409;203447;63932;2710;4515;8406;51248;56001;51616;2925;100130613;2564;1193;100132994;5354;11043;340533;22;3476;84631;26748;11238;203562;102723631;170261;58526;441525;4983;29944;6907;1536;2539;1478;9468;23597;2187;1287;81887;6611;3561;9767;9282;54857;347365;10800;139341;54539;11219;728062;169966;51209;23630;26548;1121;2000;645188;51438;2846;280658;1852;347344;23229;10857;56157;286430;101059915;438;5277;9758;1069;4674;154796;56548;51309;1184;645073;80712;1774;10245;2258;728343;9823;441531;11141;643311;90121;256643;23676;4114;6758;4107;286499;5009;1654;1831;51284;94121;170302;11230;79135;286410;9210;2491;441490;84187;633;6191;64743;4110;3598;389856;7789;55787;9452;50814;2157;139422;170062;57187;139067;4104;203427;4693;5456;10013;1964;55190;100996648;293;9016;100528062;30011;90316;93953;10178;6322;28952;24137;2332;4105;6845;94122;84968;64663;1538;9142;286530;2245;5634;9506;79576;3266;139212;5207;6535;8227;393;389852;170626;91851;27334;158866;550643;159013;407;7224;55796;10761;100132963;168400;4281;158835;24140;8471;90167;7737;7319;10149;11279;6134;64109;1678;139322;5063;55906;116442;84443;27197;8233;548313;6872;27018;100129239;139105;7102;10549;26071;2664;59353;8573;28985;79184;728049;728090;158521;3581;139886;282808;8263;9130;728082;778;90843;1756;5422;7317;5935;347454;29071;207063;4112;412;158506;340602;30848;5127;22866;93380;159091;10159;212;139285;9338;85417;8266;100132399;158584;494118;190;7569;89801;2892;1968;5230;57232;55559;57529;8277;63035;80231;286436;25975;51311;8905;55086;139735;395;83692;171484;10251;169981;1349;63904;139716;257397;142689;80258;27035;1641;55613;7105;100329135;84295;9459;4810;404281;4109;367;474384;6748;139760;347487;92745;158830;53344;4103;9203;139378;186;474343;2719;3597;140456;9248;402415;203430;9185;90161;728042;4129;65267;56849;8228;8226;728036;7114;6399;4952;83740;84889;8481;6757;347468;347475;414;6759;9500;51132;8823;541578;2158;55609;2556;494119;6756;9502;158880;8517;8242;474383;57595;51442;389895;100132304;9754;80311;6102;27328;695;56159;51213;90737;60506;10943;100873985;57526;728269;170082;474382;102723680;728656;3358;8273;83844;114824;389840;170067;81557;80823;8862;2002;7216;79979;158763;23641;55217;8270;57477;7592;2833;425054;340526;727866;139599;139804;54470;8450;959;139562;645864;10075;117154;57631;2010;54521;79589;51634;3750;653282;728072;7076;392490;9363;8623;3920;347411;7454;100506164;265;90293;645051;100529097;55511;158724;6197;203547;139135;5355;347516;203522;139081;6451;27336;158787;728458;7499;4841;347517;51360;340578;139596;1896;441509;54466;660;158798;4108;171482;79868;728075;158833;79366;1821;56156;392465;1260;5160;56062;5303;3054;51260;139628;653220;340596;554;28986;23133;57393;2623;28227;4113;57692;50945;3730;7739;100131755;57481;8260;139170;64219;4204;389860;2574;3563;65991;10325;6170;10813;79710;8712;26280;2316;256714;10742;6173;9104;494197;29057;139324;442444;6103;54880;90736;55558;2742;1736;369;255313;3654;170627;645974;3897;79983;727940;541466;347527;8243;4007;139741;29978;2182;7504;60401;84707;53336;1485;159090;94056;57502;55285;653067;1046;11152;641339;1947;8852;7712;23708;203523;4267;54967;340542;89885;2277;83550;644353;55916;340595;6594;139189;63947;9643;9843;4935;139728;100288814;10479;50943;53940;55026;100507170;5638;4478;8239;4068;51114;139411;246100;9968;84679;115201;100533997;1741;416;64840;10682;11326;25763;27330;171483;8908;27286;1038;7543;158800;90060;1288;84061;215;6247;292;55879;401612;1183;340527;55344;29935;158983;357;10009;2747;2652;286514;340543;54885;100129407;10495;6792;79742;140886;2239;2334;4128;441518;139604;4303;55869;25878;4115;11040;8473;6855;84636;55922;728712;5956;2705;55841;54821;729396;441521;8933;10735;729442;9949;4694;84528;51481;492;3028;100129520;795;10389;83604;7411;9947;9367;100463488;10134;79057;54552;6906;340547;30014;415;5255;680;158809;6990;4435;5475;340529;65109;64860;7030;729428;8776;4675;5030;51566;729201;56271;4943;79917;85012;114928;5256;26609;54960;538;6853;5365;4354;286451;29934;10838;139221;9189;347404;6473;3251;286464;158931;139793;100008586;2717;3052;5973;139065;5199;546;5613;51270;139231;9131;7547;474381;257240;11254;27238;64102;2543;158747;2273;56474;5165;64648;54440;140597;5631;728239;3188;100130086;5251;8237;286527;100130302,815
-1,1,X,70297,155255792,155185495,23096;64061;392509;10214;170685;23157;727837;55998;23439;729431;10916;158586;55859;331;3423;54830;4168;6901;5358;92002;27344;729447;54328;266740;9075;102723737;7552;729422;54954;84460;389874;56000;340562;644538;92552;254158;79649;56850;8225;2824;100272147;51186;3149;26576;100130361;1730;347541;139425;3547;728695;729408;79921;57826;59272;203413;2986;7512;9737;8544;55634;2857;3421;537;11013;340554;5716;6658;4101;54457;1438;91966;441519;4100;5931;27316;7403;4534;6839;51480;728096;27112;92129;101928917;140462;8241;6567;827;203569;27301;84548;645037;54413;100133053;7355;254065;79836;10084;347442;60343;51765;55593;139818;56180;6303;8269;142684;7626;10046;8409;203447;63932;2710;4515;8406;51248;56001;51616;2925;100130613;2564;1193;100132994;5354;11043;340533;22;3476;84631;26748;11238;203562;102723631;170261;58526;441525;4983;29944;6907;1536;2539;1478;9468;23597;2187;1287;81887;6611;3561;9767;9282;54857;347365;10800;139341;54539;11219;728062;169966;51209;23630;26548;1121;2000;645188;51438;2846;280658;1852;347344;23229;10857;56157;286430;101059915;438;5277;9758;1069;4674;154796;56548;51309;1184;645073;80712;1774;10245;2258;728343;9823;441531;11141;643311;90121;256643;23676;4114;6758;4107;286499;5009;1654;1831;51284;94121;170302;11230;79135;286410;9210;2491;441490;84187;633;6191;64743;4110;3598;389856;7789;55787;9452;50814;2157;139422;170062;57187;139067;4104;203427;4693;5456;10013;1964;55190;100996648;293;9016;100528062;30011;90316;93953;10178;6322;28952;24137;2332;4105;6845;94122;84968;64663;1538;9142;286530;2245;5634;9506;79576;3266;139212;5207;6535;8227;393;389852;170626;91851;27334;158866;550643;159013;407;7224;55796;10761;100132963;168400;4281;158835;24140;8471;90167;7737;7319;10149;11279;6134;64109;1678;139322;5063;55906;116442;84443;27197;8233;548313;6872;27018;100129239;139105;7102;10549;26071;2664;59353;8573;28985;79184;728049;728090;158521;3581;139886;282808;8263;9130;728082;778;90843;1756;5422;7317;5935;347454;29071;207063;4112;412;158506;340602;30848;5127;22866;93380;159091;10159;212;139285;9338;85417;8266;100132399;158584;494118;190;7569;89801;2892;1968;5230;57232;55559;57529;8277;63035;80231;286436;25975;51311;8905;55086;139735;395;83692;171484;10251;169981;1349;63904;139716;257397;142689;80258;27035;1641;55613;7105;100329135;84295;9459;4810;404281;4109;367;474384;6748;139760;347487;92745;158830;53344;4103;9203;139378;186;474343;2719;3597;140456;9248;402415;203430;9185;90161;728042;4129;65267;56849;8228;8226;728036;7114;6399;4952;83740;84889;8481;6757;347468;347475;414;6759;9500;51132;8823;541578;2158;55609;2556;494119;6756;9502;158880;8517;8242;474383;57595;51442;389895;100132304;9754;80311;6102;27328;695;56159;51213;90737;60506;10943;100873985;57526;728269;170082;474382;102723680;728656;3358;8273;83844;114824;389840;170067;81557;80823;8862;2002;7216;79979;158763;23641;55217;8270;57477;7592;2833;425054;340526;727866;139599;139804;54470;8450;959;139562;645864;10075;117154;57631;2010;54521;79589;51634;3750;653282;728072;7076;392490;9363;8623;3920;347411;7454;100506164;265;90293;645051;100529097;55511;158724;6197;203547;139135;5355;347516;203522;139081;6451;27336;158787;728458;7499;4841;347517;51360;340578;139596;1896;441509;54466;660;158798;4108;171482;79868;728075;158833;79366;1821;56156;392465;1260;5160;56062;5303;3054;51260;139628;653220;340596;554;28986;23133;57393;2623;28227;4113;57692;50945;3730;7739;100131755;57481;8260;139170;64219;4204;389860;2574;3563;65991;10325;6170;10813;79710;8712;26280;2316;256714;10742;6173;9104;494197;29057;139324;442444;6103;54880;90736;55558;2742;1736;369;255313;3654;170627;645974;3897;79983;727940;541466;347527;8243;4007;139741;29978;2182;7504;60401;84707;53336;1485;159090;94056;57502;55285;653067;1046;11152;641339;1947;8852;7712;23708;203523;4267;54967;340542;89885;2277;83550;644353;55916;340595;6594;139189;63947;9643;9843;4935;139728;100288814;10479;50943;53940;55026;100507170;5638;4478;8239;4068;51114;139411;246100;9968;84679;115201;100533997;1741;416;64840;10682;11326;25763;27330;171483;8908;27286;1038;7543;158800;90060;1288;84061;215;6247;292;55879;401612;1183;340527;55344;29935;158983;357;10009;2747;2652;286514;340543;54885;100129407;10495;6792;79742;140886;2239;2334;4128;441518;139604;4303;55869;25878;4115;11040;8473;6855;84636;55922;728712;5956;2705;55841;54821;729396;441521;8933;10735;729442;9949;4694;84528;51481;492;3028;100129520;795;10389;83604;7411;9947;9367;100463488;10134;79057;54552;6906;340547;30014;415;5255;680;158809;6990;4435;5475;340529;65109;64860;7030;729428;8776;4675;5030;51566;729201;56271;4943;79917;85012;114928;5256;26609;54960;538;6853;5365;4354;286451;29934;10838;139221;9189;347404;6473;3251;286464;158931;139793;100008586;2717;3052;5973;139065;5199;546;5613;51270;139231;9131;7547;474381;257240;11254;27238;64102;2543;158747;2273;56474;5165;64648;54440;140597;5631;728239;3188;100130086;5251;8237;286527;100130302,815
1,1,X,70297,155255792,155185495,23096;64061;392509;10214;170685;23157;727837;55998;23439;729431;10916;158586;55859;331;3423;54830;4168;6901;5358;92002;27344;729447;54328;266740;9075;102723737;7552;729422;54954;84460;389874;56000;340562;644538;92552;254158;79649;56850;8225;2824;100272147;51186;3149;26576;100130361;1730;347541;139425;3547;728695;729408;79921;57826;59272;203413;2986;7512;9737;8544;55634;2857;3421;537;11013;340554;5716;6658;4101;54457;1438;91966;441519;4100;5931;27316;7403;4534;6839;51480;728096;27112;92129;101928917;140462;8241;6567;827;203569;27301;84548;645037;54413;100133053;7355;254065;79836;10084;347442;60343;51765;55593;139818;56180;6303;8269;142684;7626;10046;8409;203447;63932;2710;4515;8406;51248;56001;51616;2925;100130613;2564;1193;100132994;5354;11043;340533;22;3476;84631;26748;11238;203562;102723631;170261;58526;441525;4983;29944;6907;1536;2539;1478;9468;23597;2187;1287;81887;6611;3561;9767;9282;54857;347365;10800;139341;54539;11219;728062;169966;51209;23630;26548;1121;2000;645188;51438;2846;280658;1852;347344;23229;10857;56157;286430;101059915;438;5277;9758;1069;4674;154796;56548;51309;1184;645073;80712;1774;10245;2258;728343;9823;441531;11141;643311;90121;256643;23676;4114;6758;4107;286499;5009;1654;1831;51284;94121;170302;11230;79135;286410;9210;2491;441490;84187;633;6191;64743;4110;3598;389856;7789;55787;9452;50814;2157;139422;170062;57187;139067;4104;203427;4693;5456;10013;1964;55190;100996648;293;9016;100528062;30011;90316;93953;10178;6322;28952;24137;2332;4105;6845;94122;84968;64663;1538;9142;286530;2245;5634;9506;79576;3266;139212;5207;6535;8227;393;389852;170626;91851;27334;158866;550643;159013;407;7224;55796;10761;100132963;168400;4281;158835;24140;8471;90167;7737;7319;10149;11279;6134;64109;1678;139322;5063;55906;116442;84443;27197;8233;548313;6872;27018;100129239;139105;7102;10549;26071;2664;59353;8573;28985;79184;728049;728090;158521;3581;139886;282808;8263;9130;728082;778;90843;1756;5422;7317;5935;347454;29071;207063;4112;412;158506;340602;30848;5127;22866;93380;159091;10159;212;139285;9338;85417;8266;100132399;158584;494118;190;7569;89801;2892;1968;5230;57232;55559;57529;8277;63035;80231;286436;25975;51311;8905;55086;139735;395;83692;171484;10251;169981;1349;63904;139716;257397;142689;80258;27035;1641;55613;7105;100329135;84295;9459;4810;404281;4109;367;474384;6748;139760;347487;92745;158830;53344;4103;9203;139378;186;474343;2719;3597;140456;9248;402415;203430;9185;90161;728042;4129;65267;56849;8228;8226;728036;7114;6399;4952;83740;84889;8481;6757;347468;347475;414;6759;9500;51132;8823;541578;2158;55609;2556;494119;6756;9502;158880;8517;8242;474383;57595;51442;389895;100132304;9754;80311;6102;27328;695;56159;51213;90737;60506;10943;100873985;57526;728269;170082;474382;102723680;728656;3358;8273;83844;114824;389840;170067;81557;80823;8862;2002;7216;79979;158763;23641;55217;8270;57477;7592;2833;425054;340526;727866;139599;139804;54470;8450;959;139562;645864;10075;117154;57631;2010;54521;79589;51634;3750;653282;728072;7076;392490;9363;8623;3920;347411;7454;100506164;265;90293;645051;100529097;55511;158724;6197;203547;139135;5355;347516;203522;139081;6451;27336;158787;728458;7499;4841;347517;51360;340578;139596;1896;441509;54466;660;158798;4108;171482;79868;728075;158833;79366;1821;56156;392465;1260;5160;56062;5303;3054;51260;139628;653220;340596;554;28986;23133;57393;2623;28227;4113;57692;50945;3730;7739;100131755;57481;8260;139170;64219;4204;389860;2574;3563;65991;10325;6170;10813;79710;8712;26280;2316;256714;10742;6173;9104;494197;29057;139324;442444;6103;54880;90736;55558;2742;1736;369;255313;3654;170627;645974;3897;79983;727940;541466;347527;8243;4007;139741;29978;2182;7504;60401;84707;53336;1485;159090;94056;57502;55285;653067;1046;11152;641339;1947;8852;7712;23708;203523;4267;54967;340542;89885;2277;83550;644353;55916;340595;6594;139189;63947;9643;9843;4935;139728;100288814;10479;50943;53940;55026;100507170;5638;4478;8239;4068;51114;139411;246100;9968;84679;115201;100533997;1741;416;64840;10682;11326;25763;27330;171483;8908;27286;1038;7543;158800;90060;1288;84061;215;6247;292;55879;401612;1183;340527;55344;29935;158983;357;10009;2747;2652;286514;340543;54885;100129407;10495;6792;79742;140886;2239;2334;4128;441518;139604;4303;55869;25878;4115;11040;8473;6855;84636;55922;728712;5956;2705;55841;54821;729396;441521;8933;10735;729442;9949;4694;84528;51481;492;3028;100129520;795;10389;83604;7411;9947;9367;100463488;10134;79057;54552;6906;340547;30014;415;5255;680;158809;6990;4435;5475;340529;65109;64860;7030;729428;8776;4675;5030;51566;729201;56271;4943;79917;85012;114928;5256;26609;54960;538;6853;5365;4354;286451;29934;10838;139221;9189;347404;6473;3251;286464;158931;139793;100008586;2717;3052;5973;139065;5199;546;5613;51270;139231;9131;7547;474381;257240;11254;27238;64102;2543;158747;2273;56474;5165;64648;54440;140597;5631;728239;3188;100130086;5251;8237;286527;100130302,815
-1,1,X,71267,2217264,2145997,28227;207063;293;286530;438;64109;6473;8227;8225;8623;55344;1438;3563,13
-1,1,X,71267,155255792,155184525,23096;64061;392509;10214;170685;23157;727837;55998;23439;729431;10916;158586;55859;331;3423;54830;4168;6901;5358;92002;27344;729447;54328;266740;9075;102723737;7552;729422;54954;84460;389874;56000;340562;644538;92552;254158;79649;56850;8225;2824;100272147;51186;3149;26576;100130361;1730;347541;139425;3547;728695;729408;79921;57826;59272;203413;2986;7512;9737;8544;55634;2857;3421;537;11013;340554;5716;6658;4101;54457;1438;91966;441519;4100;5931;27316;7403;4534;6839;51480;728096;27112;92129;101928917;140462;8241;6567;827;203569;27301;84548;645037;54413;100133053;7355;254065;79836;10084;347442;60343;51765;55593;139818;56180;6303;8269;142684;7626;10046;8409;203447;63932;2710;4515;8406;51248;56001;51616;2925;100130613;2564;1193;100132994;5354;11043;340533;22;3476;84631;26748;11238;203562;102723631;170261;58526;441525;4983;29944;6907;1536;2539;1478;9468;23597;2187;1287;81887;6611;3561;9767;9282;54857;347365;10800;139341;54539;11219;728062;169966;51209;23630;26548;1121;2000;645188;51438;2846;280658;1852;347344;23229;10857;56157;286430;101059915;438;5277;9758;1069;4674;154796;56548;51309;1184;645073;80712;1774;10245;2258;728343;9823;441531;11141;643311;90121;256643;23676;4114;6758;4107;286499;5009;1654;1831;51284;94121;170302;11230;79135;286410;9210;2491;441490;84187;633;6191;64743;4110;3598;389856;7789;55787;9452;50814;2157;139422;170062;57187;139067;4104;203427;4693;5456;10013;1964;55190;100996648;293;9016;100528062;30011;90316;93953;10178;6322;28952;24137;2332;4105;6845;94122;84968;64663;1538;9142;286530;2245;5634;9506;79576;3266;139212;5207;6535;8227;393;389852;170626;91851;27334;158866;550643;159013;407;7224;55796;10761;100132963;168400;4281;158835;24140;8471;90167;7737;7319;10149;11279;6134;64109;1678;139322;5063;55906;116442;84443;27197;8233;548313;6872;27018;100129239;139105;7102;10549;26071;2664;59353;8573;28985;79184;728049;728090;158521;3581;139886;282808;8263;9130;728082;778;90843;1756;5422;7317;5935;347454;29071;207063;4112;412;158506;340602;30848;5127;22866;93380;159091;10159;212;139285;9338;85417;8266;100132399;158584;494118;190;7569;89801;2892;1968;5230;57232;55559;57529;8277;63035;80231;286436;25975;51311;8905;55086;139735;395;83692;171484;10251;169981;1349;63904;139716;257397;142689;80258;27035;1641;55613;7105;100329135;84295;9459;4810;404281;4109;367;474384;6748;139760;347487;92745;158830;53344;4103;9203;139378;186;474343;2719;3597;140456;9248;402415;203430;9185;90161;728042;4129;65267;56849;8228;8226;728036;7114;6399;4952;83740;84889;8481;6757;347468;347475;414;6759;9500;51132;8823;541578;2158;55609;2556;494119;6756;9502;158880;8517;8242;474383;57595;51442;389895;100132304;9754;80311;6102;27328;695;56159;51213;90737;60506;10943;100873985;57526;728269;170082;474382;102723680;728656;3358;8273;83844;114824;389840;170067;81557;80823;8862;2002;7216;79979;158763;23641;55217;8270;57477;7592;2833;425054;340526;727866;139599;139804;54470;8450;959;139562;645864;10075;117154;57631;2010;54521;79589;51634;3750;653282;728072;7076;392490;9363;8623;3920;347411;7454;100506164;265;90293;645051;100529097;55511;158724;6197;203547;139135;5355;347516;203522;139081;6451;27336;158787;728458;7499;4841;347517;51360;340578;139596;1896;441509;54466;660;158798;4108;171482;79868;728075;158833;79366;1821;56156;392465;1260;5160;56062;5303;3054;51260;139628;653220;340596;554;28986;23133;57393;2623;28227;4113;57692;50945;3730;7739;100131755;57481;8260;139170;64219;4204;389860;2574;3563;65991;10325;6170;10813;79710;8712;26280;2316;256714;10742;6173;9104;494197;29057;139324;442444;6103;54880;90736;55558;2742;1736;369;255313;3654;170627;645974;3897;79983;727940;541466;347527;8243;4007;139741;29978;2182;7504;60401;84707;53336;1485;159090;94056;57502;55285;653067;1046;11152;641339;1947;8852;7712;23708;203523;4267;54967;340542;89885;2277;83550;644353;55916;340595;6594;139189;63947;9643;9843;4935;139728;100288814;10479;50943;53940;55026;100507170;5638;4478;8239;4068;51114;139411;246100;9968;84679;115201;100533997;1741;416;64840;10682;11326;25763;27330;171483;8908;27286;1038;7543;158800;90060;1288;84061;215;6247;292;55879;401612;1183;340527;55344;29935;158983;357;10009;2747;2652;286514;340543;54885;100129407;10495;6792;79742;140886;2239;2334;4128;441518;139604;4303;55869;25878;4115;11040;8473;6855;84636;55922;728712;5956;2705;55841;54821;729396;441521;8933;10735;729442;9949;4694;84528;51481;492;3028;100129520;795;10389;83604;7411;9947;9367;100463488;10134;79057;54552;6906;340547;30014;415;5255;680;158809;6990;4435;5475;340529;65109;64860;7030;729428;8776;4675;5030;51566;729201;56271;4943;79917;85012;114928;5256;26609;54960;538;6853;5365;4354;286451;29934;10838;139221;9189;347404;6473;3251;286464;158931;139793;100008586;2717;3052;5973;139065;5199;546;5613;51270;139231;9131;7547;474381;257240;11254;27238;64102;2543;158747;2273;56474;5165;64648;54440;140597;5631;728239;3188;100130086;5251;8237;286527;100130302,815
1,-1,X,77606,92362,14756,,0
-1,-1,X,77606,92362,14756,,0
1,-1,X,77606,92362,14756,,0
-1,-1,X,77606,92362,14756,,0
-1,-1,X,77606,92362,14756,,0
-1,-1,X,77606,92362,14756,,0
-1,-1,X,77606,92362,14756,,0
-1,-1,X,77606,92362,14756,,0
-1,-1,X,77606,92362,14756,,0
1,-1,X,77606,171878,94272,,0
-1,1,X,90904,155227831,155136927,23096;64061;392509;10214;170685;23157;727837;55998;23439;729431;10916;158586;55859;331;3423;54830;4168;6901;5358;92002;27344;729447;54328;266740;9075;102723737;7552;729422;54954;84460;389874;56000;340562;644538;92552;254158;79649;56850;8225;2824;100272147;51186;3149;26576;100130361;1730;347541;139425;3547;728695;729408;79921;57826;59272;203413;2986;7512;9737;8544;55634;2857;3421;537;11013;340554;5716;6658;4101;54457;1438;91966;441519;4100;5931;27316;7403;4534;6839;51480;728096;27112;92129;101928917;140462;8241;6567;827;203569;27301;84548;645037;54413;100133053;7355;254065;79836;10084;347442;60343;51765;55593;139818;56180;6303;8269;142684;7626;10046;8409;203447;63932;2710;4515;8406;51248;56001;51616;2925;100130613;2564;1193;100132994;5354;11043;340533;22;3476;84631;26748;11238;203562;102723631;170261;58526;441525;4983;29944;6907;1536;2539;1478;9468;23597;2187;1287;81887;6611;3561;9767;9282;54857;347365;10800;139341;54539;11219;728062;169966;51209;23630;26548;1121;2000;645188;51438;2846;280658;1852;347344;23229;10857;56157;286430;101059915;438;5277;9758;1069;4674;154796;56548;51309;1184;645073;80712;1774;10245;2258;728343;9823;441531;11141;643311;90121;256643;23676;4114;6758;4107;286499;5009;1654;1831;51284;94121;170302;11230;79135;286410;9210;2491;441490;84187;633;6191;64743;4110;3598;389856;7789;55787;9452;50814;2157;139422;170062;57187;139067;4104;203427;4693;5456;10013;1964;55190;100996648;293;9016;100528062;30011;90316;93953;10178;6322;28952;24137;2332;4105;6845;94122;84968;64663;1538;9142;286530;2245;5634;9506;79576;3266;139212;5207;6535;8227;393;389852;170626;91851;27334;158866;550643;159013;407;7224;55796;10761;100132963;168400;4281;158835;24140;8471;90167;7737;7319;10149;11279;6134;64109;1678;139322;5063;55906;116442;84443;27197;8233;548313;6872;27018;100129239;139105;7102;10549;26071;2664;59353;8573;28985;79184;728049;728090;158521;3581;139886;282808;8263;9130;728082;778;90843;1756;5422;7317;5935;347454;29071;207063;4112;412;158506;340602;30848;5127;22866;93380;159091;10159;212;139285;9338;85417;8266;100132399;158584;494118;190;7569;89801;2892;1968;5230;57232;55559;57529;8277;63035;80231;286436;25975;51311;8905;55086;139735;395;83692;171484;10251;169981;1349;63904;139716;257397;142689;80258;27035;1641;55613;7105;100329135;84295;9459;4810;404281;4109;367;474384;6748;139760;347487;92745;158830;53344;4103;9203;139378;186;474343;2719;3597;140456;9248;402415;203430;9185;90161;728042;4129;65267;56849;8228;8226;728036;7114;6399;4952;83740;84889;8481;6757;347468;347475;414;6759;9500;51132;8823;541578;2158;55609;2556;494119;6756;9502;158880;8517;8242;474383;57595;51442;389895;100132304;9754;80311;6102;27328;695;56159;51213;90737;60506;10943;100873985;57526;728269;170082;474382;102723680;728656;3358;8273;83844;114824;389840;170067;81557;80823;8862;2002;7216;79979;158763;23641;55217;8270;57477;7592;2833;425054;340526;727866;139599;139804;54470;8450;959;139562;645864;10075;117154;57631;2010;54521;79589;51634;3750;653282;728072;7076;392490;9363;8623;3920;347411;7454;100506164;265;90293;645051;100529097;55511;158724;6197;203547;139135;5355;347516;203522;139081;6451;27336;158787;728458;7499;4841;347517;51360;340578;139596;1896;441509;54466;660;158798;4108;171482;79868;728075;158833;79366;1821;56156;392465;1260;5160;56062;5303;3054;51260;139628;653220;340596;554;28986;23133;57393;2623;28227;4113;57692;50945;3730;7739;100131755;57481;8260;139170;64219;4204;389860;2574;3563;65991;10325;6170;10813;79710;8712;26280;2316;256714;10742;6173;9104;494197;29057;139324;442444;6103;54880;90736;55558;2742;1736;369;255313;3654;170627;645974;3897;79983;727940;541466;347527;8243;4007;139741;29978;2182;7504;60401;84707;53336;1485;159090;94056;57502;55285;653067;1046;11152;641339;1947;8852;7712;23708;203523;4267;54967;340542;89885;2277;83550;644353;55916;340595;6594;139189;63947;9643;9843;4935;139728;100288814;10479;50943;53940;55026;100507170;5638;4478;8239;4068;51114;139411;246100;9968;84679;115201;100533997;1741;416;64840;10682;11326;25763;27330;171483;8908;27286;1038;7543;158800;90060;1288;84061;215;6247;292;55879;401612;1183;340527;55344;29935;158983;357;10009;2747;2652;286514;340543;54885;100129407;10495;6792;79742;140886;2239;2334;4128;441518;139604;4303;55869;25878;4115;11040;8473;6855;84636;55922;728712;5956;2705;55841;54821;729396;441521;8933;10735;729442;9949;4694;84528;51481;492;3028;100129520;795;10389;83604;7411;9947;9367;100463488;10134;79057;54552;6906;340547;30014;415;5255;680;158809;6990;4435;5475;340529;65109;64860;7030;729428;8776;4675;5030;51566;729201;56271;4943;79917;85012;114928;5256;26609;54960;538;6853;5365;4354;286451;29934;10838;139221;9189;347404;6473;3251;286464;158931;139793;100008586;2717;3052;5973;139065;5199;546;5613;51270;139231;9131;7547;474381;257240;11254;27238;64102;2543;158747;2273;56474;5165;64648;54440;140597;5631;728239;3188;100130086;5251;8237;286527;100130302,815
-1,1,X,150002,37152232,37002230,414;55787;139422;170062;4935;100288814;1964;293;53940;30011;6322;80311;139411;286530;92552;254158;8225;10943;5634;2824;170082;416;347541;139425;8227;59272;389840;170067;171483;8908;8544;7543;425054;168400;4281;1438;6247;645864;5931;10149;64109;51480;1183;140462;55344;8623;357;8233;265;286514;6792;158724;6197;139105;347442;139604;10549;25878;6303;7499;4115;55841;51360;2710;660;2925;51481;171482;795;10389;5160;1756;83604;5422;9367;11238;415;207063;4112;412;158506;158809;22866;5475;57393;6907;28227;4113;190;3730;1968;9468;23597;2187;5256;3563;26609;54960;6611;80231;25975;51311;8905;9189;395;6473;171484;256714;286464;10742;442444;257397;2742;3052;4810;404281;5613;347527;438;140456;5277;9758;257240;9185;94056;57502;8228;8226;158747;11141;56474;5165;7114;256643;23676;4114;6399;4267;51284;2277;170302;79135;5251;8481;441490;100130302,146
1,1,X,164504,155209024,155044520,23096;64061;392509;10214;170685;23157;727837;55998;23439;729431;10916;158586;55859;331;3423;54830;4168;6901;5358;92002;27344;729447;54328;266740;9075;102723737;7552;729422;54954;84460;389874;56000;340562;644538;92552;254158;79649;56850;8225;2824;100272147;51186;3149;26576;100130361;1730;347541;139425;3547;728695;729408;79921;57826;59272;203413;2986;7512;9737;8544;55634;2857;3421;537;11013;340554;5716;6658;4101;54457;1438;91966;441519;4100;5931;27316;7403;4534;6839;51480;728096;27112;92129;101928917;140462;8241;6567;827;203569;27301;84548;645037;54413;100133053;7355;254065;79836;10084;347442;60343;51765;55593;139818;56180;6303;8269;142684;7626;10046;8409;203447;63932;2710;4515;8406;51248;56001;51616;2925;100130613;2564;1193;100132994;5354;11043;340533;22;3476;84631;26748;11238;203562;102723631;170261;58526;441525;4983;29944;6907;1536;2539;1478;9468;23597;2187;1287;81887;6611;3561;9767;9282;54857;347365;10800;139341;54539;11219;728062;169966;51209;23630;26548;1121;2000;645188;51438;2846;280658;1852;347344;23229;10857;56157;286430;101059915;438;5277;9758;1069;4674;154796;56548;51309;1184;645073;80712;1774;10245;2258;728343;9823;441531;11141;643311;90121;256643;23676;4114;6758;4107;286499;5009;1654;1831;51284;94121;170302;11230;79135;286410;9210;2491;441490;84187;633;6191;64743;4110;3598;389856;7789;55787;9452;50814;2157;139422;170062;57187;139067;4104;203427;4693;5456;10013;1964;55190;100996648;293;9016;100528062;30011;90316;93953;10178;6322;28952;24137;2332;4105;6845;94122;84968;64663;1538;9142;286530;2245;5634;9506;79576;3266;139212;5207;6535;8227;393;389852;170626;91851;27334;158866;550643;159013;407;7224;55796;10761;100132963;168400;4281;158835;24140;8471;90167;7737;7319;10149;11279;6134;64109;1678;139322;5063;55906;116442;84443;27197;8233;548313;6872;27018;100129239;139105;7102;10549;26071;2664;59353;8573;28985;79184;728049;728090;158521;139886;282808;8263;9130;728082;778;90843;1756;5422;7317;5935;347454;29071;207063;4112;412;158506;340602;30848;5127;22866;93380;159091;10159;212;139285;9338;85417;8266;100132399;158584;494118;190;7569;89801;2892;1968;5230;57232;55559;57529;8277;63035;80231;286436;25975;51311;8905;55086;139735;395;83692;171484;10251;169981;1349;63904;139716;257397;142689;80258;27035;1641;55613;7105;100329135;84295;9459;4810;404281;4109;367;474384;6748;139760;347487;92745;158830;53344;4103;9203;139378;186;474343;2719;3597;140456;9248;402415;203430;9185;90161;728042;4129;65267;56849;8228;8226;728036;7114;6399;4952;83740;84889;8481;6757;347468;347475;414;6759;9500;51132;8823;541578;2158;55609;2556;494119;6756;9502;158880;8517;8242;474383;57595;51442;389895;100132304;9754;80311;6102;27328;695;56159;51213;90737;60506;10943;100873985;57526;728269;170082;474382;102723680;728656;3358;8273;83844;114824;389840;170067;81557;80823;8862;2002;7216;79979;158763;23641;55217;8270;57477;7592;2833;425054;340526;727866;139599;139804;54470;8450;959;139562;645864;10075;117154;57631;2010;54521;79589;51634;3750;653282;728072;7076;392490;9363;8623;3920;347411;7454;100506164;265;90293;645051;100529097;55511;158724;6197;203547;139135;5355;347516;203522;139081;6451;27336;158787;728458;7499;4841;347517;51360;340578;139596;1896;441509;54466;660;158798;4108;171482;79868;728075;158833;79366;1821;56156;392465;1260;5160;56062;5303;3054;51260;139628;653220;340596;554;28986;23133;57393;2623;28227;4113;57692;50945;3730;7739;100131755;57481;8260;139170;64219;4204;389860;2574;3563;65991;10325;6170;10813;79710;8712;26280;2316;256714;10742;6173;9104;494197;29057;139324;442444;6103;54880;90736;55558;2742;1736;369;255313;3654;170627;645974;3897;79983;727940;541466;347527;8243;4007;139741;29978;2182;7504;60401;84707;53336;1485;159090;94056;57502;55285;653067;1046;11152;641339;1947;8852;7712;23708;203523;4267;54967;340542;89885;2277;83550;644353;55916;340595;6594;139189;63947;9643;9843;4935;139728;100288814;10479;50943;53940;55026;100507170;5638;4478;8239;4068;51114;139411;246100;9968;84679;115201;100533997;1741;416;64840;10682;11326;25763;27330;171483;8908;27286;1038;7543;158800;90060;1288;84061;215;6247;292;55879;401612;1183;340527;55344;29935;158983;357;10009;2747;2652;286514;340543;54885;100129407;10495;6792;79742;140886;2239;2334;4128;441518;139604;4303;55869;25878;4115;11040;8473;6855;84636;55922;728712;5956;2705;55841;54821;729396;441521;8933;10735;729442;9949;4694;84528;51481;492;3028;100129520;795;10389;83604;7411;9947;9367;100463488;10134;79057;54552;6906;340547;30014;415;5255;680;158809;6990;4435;5475;340529;65109;64860;7030;729428;8776;4675;5030;51566;729201;56271;4943;79917;85012;114928;5256;26609;54960;538;6853;5365;4354;286451;29934;10838;139221;9189;347404;6473;3251;286464;158931;139793;100008586;2717;3052;5973;139065;5199;546;5613;51270;139231;9131;7547;474381;257240;11254;27238;64102;2543;158747;2273;56474;5165;64648;54440;140597;5631;728239;3188;100130086;5251;8237;286527;100130302,814
1,1,X,168546,372029,203483,55344;28227;8225,3
-1,1,X,168546,1998539,1829993,28227;293;286530;438;64109;6473;8227;8225;8623;55344;1438;3563,12
1,1,X,168546,2674479,2505933,28227;286530;8225;1438;3563;207063;4267;293;7499;9189;438;64109;6473;8227;55344;8623,16
1,1,X,168546,2696762,2528216,28227;286530;8225;1438;3563;207063;4267;293;7499;9189;438;64109;6473;8227;55344;8623,16
1,1,X,168546,2696762,2528216,28227;286530;8225;1438;3563;207063;4267;293;7499;9189;438;64109;6473;8227;55344;8623,16
-1,1,X,168546,3259868,3091322,414;28227;286530;8225;1438;3563;25878;347527;415;416;207063;4267;293;7499;9189;438;64109;6473;8227;55344;8623;8908,22
-1,1,X,168546,5896155,5727609,414;28227;286530;57502;8225;1438;3563;5613;25878;347527;415;416;207063;4267;293;7499;9189;438;64109;6473;8227;55344;8623;8908,24
-1,1,X,168546,6502019,6333473,414;28227;51481;286530;57502;8225;1438;3563;5613;25878;347527;415;416;207063;4267;293;7499;9189;438;64109;6473;8227;55344;8623;8908,25
-1,1,X,168546,7721374,7552828,414;28227;51481;286530;57502;8226;8225;1438;3563;5613;25878;347527;415;416;207063;4267;293;412;7499;9189;438;64109;6473;8227;55344;8623;8908,27
-1,1,X,168546,9766970,9598424,414;51481;171482;425054;1438;4935;5613;347527;415;207063;293;412;438;64109;51480;55344;8623;6907;28227;357;286530;57502;8226;8228;3730;8225;3563;26609;25878;416;4267;7499;9189;6473;8227;171483;8908,37
-1,1,X,168546,9868031,9699485,414;51481;171482;425054;1438;4935;5613;347527;415;207063;293;412;438;64109;51480;55344;8623;6907;28227;357;286530;57502;8226;8228;3730;8225;3563;26609;25878;416;4267;7499;9189;6473;8227;171483;8908,37
-1,1,X,168546,16985413,16816867,414;660;2925;51481;171482;55787;795;9367;4935;100288814;11238;415;207063;293;412;57393;6907;28227;286530;3730;92552;8225;10943;5634;2824;2187;3563;26609;54960;170082;416;25975;51311;8905;9189;395;6473;171484;8227;59272;171483;8908;2742;8544;3052;425054;4281;1438;5613;645864;5931;347527;438;64109;51480;1183;140456;5277;9758;140462;55344;8623;9185;357;8233;265;94056;57502;8228;8226;158747;56474;7114;25878;6399;7499;4267;51284;2277;55841;8481,81
1,1,X,168546,24780527,24611981,414;660;2925;51481;171482;55787;795;10389;5160;5422;9367;4935;100288814;11238;1964;415;207063;293;412;158506;30011;22866;5475;6322;57393;6907;28227;80311;139411;286530;3730;1968;9468;92552;254158;23597;8225;10943;5634;2824;2187;5256;3563;26609;54960;6611;170082;416;25975;51311;8905;9189;395;6473;171484;8227;256714;59272;389840;170067;171483;10742;8908;2742;8544;7543;3052;4810;425054;404281;168400;4281;1438;6247;5613;645864;5931;347527;10149;438;64109;51480;1183;140456;5277;9758;140462;55344;8623;257240;9185;357;8233;265;94056;57502;8228;8226;158747;6792;56474;6197;5165;7114;139105;256643;23676;10549;25878;6303;6399;7499;4267;51284;2277;79135;55841;51360;5251;8481;100130302,121
-1,1,X,168546,31085327,30916781,414;55787;139422;4935;100288814;1964;293;30011;6322;80311;139411;286530;92552;254158;8225;10943;5634;2824;170082;416;347541;139425;8227;59272;389840;170067;171483;8908;8544;7543;425054;168400;4281;1438;6247;645864;5931;10149;64109;51480;1183;140462;55344;8623;357;8233;265;286514;6792;6197;139105;347442;10549;25878;6303;7499;4115;55841;51360;2710;660;2925;51481;171482;795;10389;5160;5422;9367;11238;415;207063;4112;412;158506;158809;22866;5475;57393;6907;28227;4113;190;3730;1968;9468;23597;2187;5256;3563;26609;54960;6611;80231;25975;51311;8905;9189;395;6473;171484;256714;10742;257397;2742;3052;4810;404281;5613;347527;438;140456;5277;9758;257240;9185;94056;57502;8228;8226;158747;11141;56474;5165;7114;256643;23676;4114;6399;4267;51284;2277;170302;79135;5251;8481;100130302,137
-1,1,X,168546,35841052,35672506,414;55787;139422;170062;4935;100288814;1964;293;53940;30011;6322;80311;139411;286530;92552;254158;8225;10943;5634;2824;170082;416;347541;139425;8227;59272;389840;170067;171483;8908;8544;7543;425054;168400;4281;1438;6247;645864;5931;10149;64109;51480;1183;140462;55344;8623;357;8233;265;286514;6792;158724;6197;139105;347442;139604;10549;25878;6303;7499;4115;55841;51360;2710;660;2925;51481;171482;795;10389;5160;1756;83604;5422;9367;11238;415;207063;4112;412;158506;158809;22866;5475;57393;6907;28227;4113;190;3730;1968;9468;23597;2187;5256;3563;26609;54960;6611;80231;25975;51311;8905;9189;395;6473;171484;256714;10742;257397;2742;3052;4810;404281;5613;347527;438;140456;5277;9758;257240;9185;94056;57502;8228;8226;158747;11141;56474;5165;7114;256643;23676;4114;6399;4267;51284;2277;170302;79135;5251;8481;100130302,143
-1,1,X,168546,35903121,35734575,414;55787;139422;170062;4935;100288814;1964;293;53940;30011;6322;80311;139411;286530;92552;254158;8225;10943;5634;2824;170082;416;347541;139425;8227;59272;389840;170067;171483;8908;8544;7543;425054;168400;4281;1438;6247;645864;5931;10149;64109;51480;1183;140462;55344;8623;357;8233;265;286514;6792;158724;6197;139105;347442;139604;10549;25878;6303;7499;4115;55841;51360;2710;660;2925;51481;171482;795;10389;5160;1756;83604;5422;9367;11238;415;207063;4112;412;158506;158809;22866;5475;57393;6907;28227;4113;190;3730;1968;9468;23597;2187;5256;3563;26609;54960;6611;80231;25975;51311;8905;9189;395;6473;171484;256714;10742;257397;2742;3052;4810;404281;5613;347527;438;140456;5277;9758;257240;9185;94056;57502;8228;8226;158747;11141;56474;5165;7114;256643;23676;4114;6399;4267;51284;2277;170302;79135;5251;8481;100130302,143
-1,1,X,168546,37515849,37347303,414;55787;139422;170062;4935;100288814;1964;293;53940;30011;6322;5638;80311;139411;286530;92552;254158;8225;10943;5634;2824;170082;416;347541;139425;8227;59272;389840;170067;171483;8908;8544;7543;425054;168400;4281;1438;6247;645864;5931;10149;64109;51480;1183;140462;55344;8623;357;8233;265;286514;6792;158724;6197;139105;347442;139604;10549;25878;6303;7499;4115;55841;51360;2710;660;2925;51481;171482;795;10389;5160;1756;83604;5422;9367;11238;415;207063;4112;412;158506;158809;22866;5475;57393;6907;28227;4113;190;3730;1968;9468;23597;2187;5256;3563;26609;54960;6611;80231;25975;51311;8905;9189;395;347404;6473;171484;256714;286464;10742;442444;257397;2742;3052;4810;404281;5613;347527;438;140456;5277;9758;257240;9185;94056;57502;8228;8226;158747;11141;56474;5165;7114;256643;23676;4114;6399;4267;51284;2277;170302;79135;5251;8481;441490;100130302,148
1,1,X,168546,43917011,43748465,414;55787;139422;170062;4935;4693;100288814;1964;293;53940;30011;6322;5638;8239;94122;80311;139411;286530;92552;254158;60506;8225;10943;5634;2824;100873985;170082;416;347541;139425;25763;8227;59272;389840;170067;171483;8908;159013;8544;7543;2857;425054;168400;4281;1438;6247;645864;5931;10149;64109;51480;1183;140462;55344;8623;347411;27197;357;8233;265;286514;6792;158724;6197;4128;139105;347442;139604;7102;10549;25878;6303;7499;4115;8573;55841;51360;2710;8406;660;2925;51481;171482;795;10389;5160;1756;83604;5422;9367;11238;415;207063;4112;412;158506;58526;158809;6990;22866;5475;10159;57393;6907;28227;4113;1536;190;3730;1968;9468;23597;2187;5256;3563;26609;54960;6611;80231;9282;25975;51311;8905;9189;395;347404;6473;171484;256714;286464;10742;442444;6103;54880;257397;2742;3052;4810;404281;5613;347527;438;140456;7504;5277;9758;257240;9185;94056;4129;57502;8228;8226;158747;11141;56474;5165;7114;256643;23676;4114;6399;5009;1654;4267;51284;2277;170302;79135;5251;8481;441490;100130302,173
-1,1,X,168546,50032363,49863817,414;6759;10214;729431;6756;27344;729447;729422;80311;6102;92552;254158;60506;56850;8225;10943;2824;100873985;170082;347541;139425;729408;59272;389840;170067;2002;8544;55634;2857;7592;425054;1438;645864;5931;7403;6839;51480;3750;7076;140462;8241;8623;347411;7454;265;645037;645051;158724;7355;6197;10084;347442;5355;55593;6303;7499;8409;51360;2710;8406;660;2925;171482;392465;5160;26748;11238;58526;57393;2623;6907;28227;4113;1536;3730;9468;23597;2187;6611;3563;2574;9767;9282;8712;139341;54539;256714;10742;9104;442444;6103;54880;2742;369;347344;347527;4007;438;7504;5277;9758;56548;1184;645073;94056;10245;57502;11141;11152;641339;256643;23676;4114;6758;8852;7712;5009;1654;4267;51284;2277;170302;79135;11230;441490;64743;389856;55787;139422;170062;4935;4693;100288814;10013;1964;293;50943;53940;30011;6322;5638;28952;8239;94122;139411;286530;5634;84679;9506;416;64840;10682;3266;25763;8227;389852;171483;8908;159013;7543;90060;168400;4281;24140;6247;10149;64109;1183;55344;27197;357;8233;286514;548313;6792;79742;4128;139105;139604;7102;10549;25878;4115;11040;6855;8573;55841;729396;729442;51481;795;10389;83604;1756;778;5422;9367;7317;5935;415;207063;4112;412;158506;158809;6990;5127;22866;5475;10159;85417;100132399;7030;729428;190;7569;729201;89801;1968;57232;4943;79917;5256;26609;54960;6853;80231;25975;51311;8905;9189;395;347404;6473;171484;286464;63904;257397;80258;100008586;3052;4810;404281;5199;92745;5613;140456;257240;9185;27238;4129;2543;8228;158747;8226;56474;5165;7114;6399;5251;8481;8237;100130302,263
-1,1,X,168546,52573789,52405243,414;6759;9500;10214;170685;729431;6756;9502;27344;729447;729422;80311;6102;92552;254158;60506;56850;8225;10943;2824;100873985;170082;347541;139425;729408;59272;389840;170067;81557;2002;8544;55634;2857;7592;57477;425054;1438;645864;5931;7403;6839;51480;3750;7076;140462;8241;8623;347411;7454;265;645037;645051;158724;7355;6197;10084;347442;5355;55593;6303;7499;8409;51360;2710;8406;660;2925;171482;392465;5160;26748;11238;653220;58526;57393;2623;6907;28227;4113;1536;3730;9468;23597;2187;6611;3563;2574;9767;9282;8712;139341;54539;256714;10742;9104;442444;6103;54880;2742;369;347344;347527;4007;438;7504;5277;9758;56548;1184;645073;94056;10245;57502;11141;653067;11152;641339;256643;23676;4114;6758;8852;7712;23708;5009;1654;4267;51284;2277;170302;79135;11230;9210;441490;64743;389856;55787;139189;139422;170062;4935;4693;100288814;10013;1964;55190;293;50943;53940;30011;6322;5638;28952;8239;94122;139411;286530;5634;84679;9506;416;64840;10682;3266;25763;8227;389852;171483;8908;159013;7543;90060;168400;4281;24140;6247;10149;64109;1183;55344;27197;357;8233;286514;548313;6792;79742;4128;139105;139604;7102;10549;25878;4115;11040;6855;8573;55841;729396;729442;51481;795;10389;83604;1756;778;5422;9367;7317;5935;415;207063;4112;412;158506;340602;158809;6990;5127;22866;5475;10159;85417;100132399;7030;729428;190;7569;729201;89801;1968;57232;4943;79917;5256;26609;54960;6853;80231;25975;51311;8905;9189;395;347404;6473;171484;286464;63904;257397;80258;100008586;3052;4810;404281;5199;92745;5613;140456;257240;9185;27238;4129;2543;8228;158747;8226;56474;5165;7114;6399;728239;5251;8481;8237;100130302,276
-1,1,X,168546,54996659,54828113,23096;414;64061;6759;9500;10214;170685;727837;729431;6756;9502;10916;8242;27344;729447;54328;729422;80311;6102;54954;92552;254158;60506;56850;8225;10943;2824;100873985;170082;347541;139425;729408;59272;389840;170067;81557;2002;7216;8544;55634;2857;7592;57477;425054;727866;1438;645864;5931;10075;7403;6839;51480;3750;7076;140462;8241;8623;347411;7454;265;645037;645051;158724;7355;6197;10084;347442;5355;55593;158787;6303;7499;8409;51360;2710;8406;660;2925;171482;392465;5160;26748;11238;653220;58526;23133;57393;2623;6907;28227;4113;1536;3730;9468;23597;2187;6611;3563;2574;9767;9282;8712;347365;139341;54539;256714;10742;9104;494197;29057;442444;6103;54880;2742;369;280658;170627;347344;347527;8243;4007;438;7504;5277;9758;56548;1184;645073;94056;10245;57502;11141;653067;11152;90121;641339;256643;23676;4114;6758;8852;7712;23708;5009;1654;4267;51284;2277;170302;79135;11230;9210;441490;64743;389856;55787;139189;139422;170062;4935;4693;100288814;10013;1964;55190;293;50943;53940;30011;6322;5638;28952;8239;94122;139411;286530;2245;5634;84679;9506;416;64840;10682;3266;5207;25763;8227;389852;170626;171483;8908;159013;7543;90060;168400;4281;24140;6247;10149;64109;1183;55344;27197;357;8233;286514;548313;6792;79742;4128;139105;139604;7102;10549;25878;4115;11040;6855;8573;55841;729396;729442;51481;3028;795;10389;83604;1756;778;5422;9367;7317;5935;54552;415;207063;4112;412;158506;340602;158809;6990;5127;22866;5475;10159;85417;100132399;7030;729428;190;7569;729201;89801;1968;57232;4943;79917;5256;26609;54960;6853;80231;25975;51311;8905;9189;395;347404;6473;171484;286464;63904;257397;80258;100008586;3052;4810;404281;5199;92745;5613;140456;257240;9185;27238;4129;2543;65267;8228;158747;8226;56474;5165;7114;6399;728239;5251;8481;8237;6757;100130302,302
-1,1,X,168546,55240087,55071541,23096;414;64061;6759;9500;10214;170685;727837;729431;10916;6756;9502;8242;27344;729447;54328;729422;80311;6102;54954;92552;254158;60506;56850;8225;2824;10943;100873985;170082;347541;139425;729408;59272;389840;170067;81557;2002;7216;8544;55634;2857;57477;7592;425054;727866;1438;645864;5931;10075;7403;6839;51480;3750;7076;140462;8241;8623;347411;203569;7454;27301;265;645037;645051;7355;158724;6197;10084;347442;5355;55593;158787;6303;7499;8409;51360;2710;8406;660;2925;171482;392465;5160;26748;11238;653220;58526;23133;57393;2623;6907;28227;4113;1536;9468;3730;23597;2187;389860;6611;2574;3563;9767;9282;347365;8712;139341;54539;256714;10742;9104;494197;29057;442444;6103;54880;90736;2742;369;280658;170627;347344;347527;8243;4007;438;7504;5277;9758;56548;1184;645073;10245;94056;57502;11141;653067;11152;90121;641339;256643;23676;4114;6758;8852;7712;23708;5009;1654;4267;51284;170302;11230;79135;2277;9210;441490;64743;389856;55787;139189;139422;170062;4935;4693;10013;100288814;1964;55190;293;50943;53940;30011;6322;28952;5638;8239;94122;139411;286530;2245;5634;84679;9506;416;3266;64840;10682;5207;25763;8227;389852;170626;171483;8908;159013;7543;90060;168400;4281;24140;6247;10149;64109;1183;55344;27197;357;8233;286514;548313;6792;79742;4128;139105;7102;139604;10549;25878;4115;11040;6855;8573;55841;729396;729442;51481;3028;778;795;10389;1756;83604;5422;7317;5935;9367;100463488;54552;415;207063;4112;412;158506;340602;158809;5127;6990;22866;5475;10159;212;85417;100132399;7030;729428;190;7569;89801;729201;1968;57232;4943;79917;5256;26609;54960;6853;80231;25975;51311;8905;9189;395;347404;171484;6473;286464;63904;257397;80258;100008586;3052;4810;404281;5199;92745;5613;140456;257240;9185;27238;4129;2543;65267;8228;158747;8226;56474;5165;7114;6399;728239;5251;8481;8237;6757;100130302,308
-1,1,X,168546,55529093,55360547,23096;414;64061;6759;9500;10214;170685;727837;729431;10916;6756;9502;158880;8242;27344;729447;54328;729422;80311;6102;54954;90737;92552;254158;60506;56850;8225;2824;10943;100873985;170082;347541;139425;729408;59272;389840;170067;81557;2002;7216;8544;55634;2857;57477;7592;425054;727866;1438;645864;5931;10075;7403;6839;51480;3750;7076;140462;8241;8623;347411;203569;7454;27301;265;645037;645051;7355;158724;6197;10084;347442;5355;55593;158787;6303;7499;8409;51360;2710;8406;660;2925;171482;392465;5160;26748;11238;653220;58526;28986;23133;57393;2623;6907;28227;4113;1536;9468;3730;23597;2187;389860;6611;2574;3563;9767;9282;347365;8712;139341;54539;256714;10742;9104;494197;29057;442444;6103;54880;90736;2742;369;280658;170627;347344;347527;8243;4007;438;7504;5277;9758;56548;1184;645073;10245;94056;57502;11141;653067;11152;90121;641339;256643;23676;4114;6758;8852;7712;23708;5009;1654;4267;51284;170302;11230;79135;2277;9210;441490;64743;389856;55787;139189;139422;170062;4935;4693;10013;100288814;1964;55190;293;50943;53940;30011;6322;28952;5638;8239;94122;139411;286530;2245;5634;84679;9506;416;3266;64840;10682;5207;25763;8227;389852;170626;171483;8908;159013;7543;90060;168400;4281;24140;6247;10149;64109;1183;55344;27197;357;8233;286514;548313;6792;79742;4128;139105;7102;139604;10549;25878;4115;11040;6855;8573;55841;729396;729442;51481;3028;778;795;10389;1756;83604;5422;7317;5935;9367;100463488;54552;415;207063;4112;412;158506;340602;158809;5127;6990;22866;5475;10159;212;85417;100132399;7030;729428;190;7569;89801;729201;1968;57232;4943;79917;5256;26609;54960;6853;80231;25975;51311;8905;9189;395;347404;171484;6473;286464;63904;257397;80258;139793;100008586;3052;4810;404281;5199;92745;5613;140456;257240;9185;27238;4129;2543;65267;8228;158747;8226;56474;5165;7114;6399;728239;5251;8481;8237;6757;100130302,312
-1,1,X,168546,56455292,56286746,23096;414;64061;6759;9500;10214;170685;727837;729431;10916;6756;9502;158880;8242;27344;729447;54328;729422;80311;6102;54954;90737;92552;254158;60506;56850;8225;2824;10943;100873985;170082;347541;139425;729408;59272;389840;170067;81557;2002;7216;8544;55634;2857;57477;7592;425054;727866;1438;645864;5931;10075;7403;6839;51480;3750;7076;140462;8241;8623;347411;203569;7454;27301;265;645037;645051;7355;158724;6197;10084;347442;5355;55593;158787;6303;7499;8409;51360;2710;8406;660;2925;171482;392465;5160;26748;11238;139628;653220;58526;28986;23133;57393;2623;6907;28227;4113;1536;9468;3730;23597;2187;389860;6611;2574;3563;9767;10325;9282;347365;8712;139341;54539;256714;10742;9104;494197;29057;442444;6103;54880;90736;2742;369;280658;170627;347344;347527;8243;4007;438;7504;5277;9758;56548;1184;645073;10245;94056;57502;11141;653067;11152;90121;641339;256643;23676;4114;6758;8852;7712;23708;5009;1654;4267;51284;170302;11230;79135;2277;9210;441490;64743;389856;55787;139189;139422;170062;4935;4693;10013;100288814;1964;55190;293;50943;53940;30011;6322;28952;5638;8239;94122;139411;286530;2245;5634;84679;9506;416;3266;64840;10682;5207;25763;8227;389852;170626;171483;8908;159013;7543;90060;168400;4281;24140;6247;10149;11279;64109;1183;55344;27197;357;8233;286514;548313;6792;79742;4128;139105;7102;139604;10549;25878;4115;11040;6855;8573;55841;729396;729442;51481;3028;778;795;10389;1756;83604;5422;7317;5935;9367;100463488;54552;415;207063;4112;412;158506;340602;158809;5127;6990;22866;5475;10159;212;85417;100132399;7030;729428;190;7569;89801;729201;1968;57232;4943;79917;5256;26609;54960;6853;80231;25975;51311;8905;9189;395;347404;171484;6473;286464;63904;257397;80258;139793;100008586;3052;4810;404281;5199;92745;5613;140456;257240;9185;27238;4129;2543;65267;8228;158747;8226;56474;5165;7114;6399;728239;5251;8481;8237;6757;100130302,315
-1,1,X,168546,56455292,56286746,23096;414;64061;6759;9500;10214;170685;727837;729431;10916;6756;9502;158880;8242;27344;729447;54328;729422;80311;6102;54954;90737;92552;254158;60506;56850;8225;2824;10943;100873985;170082;347541;139425;729408;59272;389840;170067;81557;2002;7216;8544;55634;2857;57477;7592;425054;727866;1438;645864;5931;10075;7403;6839;51480;3750;7076;140462;8241;8623;347411;203569;7454;27301;265;645037;645051;7355;158724;6197;10084;347442;5355;55593;158787;6303;7499;8409;51360;2710;8406;660;2925;171482;392465;5160;26748;11238;139628;653220;58526;28986;23133;57393;2623;6907;28227;4113;1536;9468;3730;23597;2187;389860;6611;2574;3563;9767;10325;9282;347365;8712;139341;54539;256714;10742;9104;494197;29057;442444;6103;54880;90736;2742;369;280658;170627;347344;347527;8243;4007;438;7504;5277;9758;56548;1184;645073;10245;94056;57502;11141;653067;11152;90121;641339;256643;23676;4114;6758;8852;7712;23708;5009;1654;4267;51284;170302;11230;79135;2277;9210;441490;64743;389856;55787;139189;139422;170062;4935;4693;10013;100288814;1964;55190;293;50943;53940;30011;6322;28952;5638;8239;94122;139411;286530;2245;5634;84679;9506;416;3266;64840;10682;5207;25763;8227;389852;170626;171483;8908;159013;7543;90060;168400;4281;24140;6247;10149;11279;64109;1183;55344;27197;357;8233;286514;548313;6792;79742;4128;139105;7102;139604;10549;25878;4115;11040;6855;8573;55841;729396;729442;51481;3028;778;795;10389;1756;83604;5422;7317;5935;9367;100463488;54552;415;207063;4112;412;158506;340602;158809;5127;6990;22866;5475;10159;212;85417;100132399;7030;729428;190;7569;89801;729201;1968;57232;4943;79917;5256;26609;54960;6853;80231;25975;51311;8905;9189;395;347404;171484;6473;286464;63904;257397;80258;139793;100008586;3052;4810;404281;5199;92745;5613;140456;257240;9185;27238;4129;2543;65267;8228;158747;8226;56474;5165;7114;6399;728239;5251;8481;8237;6757;100130302,315
-1,1,X,168546,56684082,56515536,23096;414;64061;6759;9500;10214;170685;727837;729431;10916;6756;9502;158880;8242;27344;729447;54328;729422;80311;6102;54954;90737;92552;254158;60506;56850;8225;2824;10943;100873985;170082;347541;139425;729408;59272;389840;170067;81557;2002;7216;8544;55634;2857;57477;7592;425054;727866;1438;645864;5931;10075;7403;6839;51480;3750;7076;140462;8241;8623;347411;203569;7454;27301;265;645037;645051;7355;158724;6197;10084;347442;5355;55593;158787;6303;7499;8409;51360;2710;8406;660;2925;171482;392465;5160;26748;11238;139628;653220;58526;28986;23133;57393;2623;6907;28227;4113;1536;9468;3730;23597;2187;389860;6611;2574;3563;9767;10325;9282;347365;8712;139341;54539;256714;10742;9104;494197;29057;442444;6103;54880;90736;2742;369;280658;170627;347344;347527;8243;4007;29978;438;7504;5277;9758;56548;1184;645073;10245;94056;57502;11141;653067;11152;90121;641339;256643;23676;4114;6758;8852;7712;23708;5009;1654;4267;51284;170302;11230;79135;2277;9210;441490;64743;389856;55787;139189;139422;170062;4935;4693;10013;100288814;1964;55190;293;50943;53940;30011;6322;28952;5638;8239;94122;139411;286530;2245;5634;84679;9506;416;3266;64840;10682;5207;25763;8227;389852;170626;171483;8908;159013;7543;90060;168400;4281;24140;6247;10149;11279;64109;1183;55344;27197;357;8233;286514;548313;6792;79742;4128;139105;7102;139604;10549;25878;4115;11040;6855;8573;55841;729396;729442;51481;3028;778;795;10389;1756;83604;5422;7317;5935;9367;100463488;54552;415;207063;4112;412;158506;340602;158809;5127;6990;22866;5475;10159;212;85417;100132399;7030;729428;190;7569;89801;729201;1968;57232;4943;79917;5256;26609;54960;6853;80231;25975;51311;8905;9189;395;347404;171484;6473;286464;63904;257397;80258;139793;100008586;3052;4810;404281;5199;92745;5613;140456;257240;9185;27238;4129;2543;65267;8228;158747;8226;56474;5165;7114;6399;728239;5251;8481;8237;6757;100130302,316
-1,1,X,168546,57504183,57335637,23096;414;64061;6759;9500;10214;170685;727837;729431;10916;6756;9502;158880;8242;27344;729447;54328;729422;80311;6102;54954;90737;92552;254158;60506;56850;8225;2824;10943;100873985;170082;347541;139425;729408;59272;389840;170067;81557;2002;7216;8544;55634;2857;57477;7592;425054;727866;1438;645864;5931;10075;7403;6839;51480;3750;7076;140462;8241;8623;347411;203569;7454;27301;265;645037;645051;7355;158724;6197;10084;347442;5355;55593;158787;6303;7499;8409;51360;2710;54466;8406;660;2925;171482;392465;5160;26748;11238;139628;653220;58526;28986;23133;57393;2623;6907;28227;4113;1536;9468;3730;23597;2187;389860;6611;2574;3563;9767;10325;9282;347365;8712;139341;54539;256714;10742;9104;494197;29057;442444;6103;54880;90736;2742;369;280658;170627;347344;347527;8243;4007;29978;438;7504;5277;9758;56548;1184;645073;10245;94056;57502;11141;653067;11152;90121;641339;256643;23676;4114;6758;8852;7712;23708;5009;1654;4267;51284;170302;11230;79135;2277;9210;441490;64743;389856;55787;139189;139422;170062;4935;4693;10013;100288814;1964;55190;293;50943;53940;30011;6322;28952;5638;8239;94122;139411;286530;2245;5634;84679;9506;416;3266;64840;10682;5207;25763;8227;389852;170626;171483;8908;550643;159013;7543;90060;168400;4281;24140;6247;10149;11279;64109;1183;55344;27197;357;8233;286514;548313;6792;79742;4128;139105;7102;139604;10549;25878;4115;11040;6855;8573;55841;729396;729442;51481;3028;778;795;10389;1756;83604;5422;7317;5935;9367;100463488;54552;415;207063;4112;412;158506;340602;158809;5127;6990;22866;5475;10159;212;85417;100132399;158584;7030;729428;190;7569;89801;729201;1968;57232;4943;79917;5256;26609;54960;6853;80231;25975;51311;8905;9189;395;347404;171484;6473;286464;169981;63904;257397;80258;139793;100008586;3052;4810;404281;5199;92745;5613;474343;140456;257240;9185;27238;4129;2543;65267;8228;158747;8226;56474;5165;7114;6399;728239;5251;8481;8237;6757;100130302,321
-1,1,X,168546,57683964,57515418,23096;414;64061;6759;9500;10214;170685;727837;729431;10916;158586;6756;9502;158880;8242;27344;729447;54328;729422;80311;6102;54954;90737;92552;254158;60506;56850;8225;2824;10943;100873985;170082;347541;139425;729408;59272;389840;170067;81557;2002;7216;8544;55634;2857;57477;7592;425054;727866;1438;645864;5931;10075;7403;6839;51480;3750;7076;140462;8241;8623;347411;203569;7454;27301;265;645037;645051;7355;158724;6197;10084;347442;5355;55593;158787;6303;7499;8409;51360;2710;54466;8406;660;2925;171482;392465;5160;26748;11238;139628;653220;58526;28986;23133;57393;2623;6907;28227;4113;1536;9468;3730;23597;2187;389860;6611;2574;3563;9767;10325;9282;347365;8712;139341;54539;256714;10742;9104;494197;29057;442444;6103;54880;90736;2742;369;280658;170627;347344;347527;8243;4007;29978;438;7504;5277;9758;56548;1184;645073;10245;94056;57502;11141;653067;11152;90121;641339;256643;23676;4114;6758;8852;7712;23708;5009;1654;4267;51284;170302;11230;79135;2277;9210;441490;64743;389856;55787;139189;139422;170062;4935;4693;10013;100288814;1964;55190;293;50943;53940;30011;6322;28952;5638;8239;94122;139411;286530;2245;5634;84679;9506;416;3266;64840;10682;5207;25763;8227;389852;170626;171483;8908;550643;159013;7543;90060;168400;4281;24140;6247;10149;11279;64109;1183;55344;27197;357;8233;286514;548313;6792;79742;4128;139105;7102;139604;10549;25878;4115;11040;6855;8573;55841;729396;729442;51481;3028;778;795;10389;1756;83604;5422;7317;5935;9367;100463488;54552;415;207063;4112;412;158506;340602;158809;5127;6990;22866;5475;10159;212;85417;100132399;158584;7030;729428;190;7569;89801;729201;1968;57232;4943;79917;5256;26609;54960;6853;80231;25975;51311;8905;9189;395;347404;171484;6473;286464;169981;63904;257397;80258;139793;100008586;3052;4810;404281;5199;92745;5613;474343;140456;257240;9185;27238;4129;2543;65267;8228;158747;8226;56474;5165;7114;6399;728239;5251;8481;8237;6757;100130302,322
-1,1,X,168546,58140271,57971725,23096;414;64061;6759;9500;10214;170685;727837;729431;10916;158586;6756;9502;158880;8242;27344;729447;54328;729422;80311;6102;54954;90737;92552;254158;60506;56850;8225;2824;10943;100873985;170082;347541;139425;729408;59272;389840;170067;81557;2002;7216;8544;55634;2857;57477;7592;425054;727866;1438;645864;5931;10075;7403;6839;51480;3750;7076;140462;8241;8623;347411;203569;7454;27301;265;645037;645051;7355;158724;6197;10084;347442;5355;55593;158787;6303;7499;8409;51360;2710;54466;8406;660;2925;171482;392465;5160;26748;11238;139628;653220;58526;28986;23133;57393;2623;6907;28227;4113;1536;9468;3730;23597;2187;389860;6611;2574;3563;9767;10325;9282;347365;8712;139341;54539;256714;10742;9104;494197;29057;442444;6103;54880;90736;2742;369;280658;170627;347344;347527;8243;4007;286430;29978;438;7504;5277;9758;56548;1184;645073;10245;94056;57502;11141;653067;11152;90121;641339;256643;23676;4114;6758;8852;7712;23708;5009;1654;4267;51284;170302;11230;79135;2277;9210;441490;64743;389856;7789;55787;139189;139422;170062;4935;4693;10013;100288814;1964;55190;293;50943;53940;30011;6322;28952;5638;8239;94122;139411;286530;2245;5634;84679;9506;416;3266;64840;10682;5207;25763;8227;389852;170626;171483;8908;550643;159013;7543;90060;168400;4281;24140;6247;10149;11279;64109;1183;55344;27197;357;8233;286514;548313;6792;79742;4128;139105;7102;139604;10549;25878;4115;11040;6855;8573;55841;729396;729442;51481;3028;778;795;10389;1756;83604;5422;7317;5935;9367;100463488;54552;415;207063;4112;412;158506;340602;158809;5127;6990;22866;5475;10159;212;85417;100132399;158584;7030;729428;190;7569;89801;729201;1968;57232;4943;79917;5256;26609;54960;6853;80231;25975;51311;8905;9189;395;347404;171484;6473;286464;169981;63904;257397;80258;139793;100008586;3052;4810;404281;5199;92745;5613;474343;140456;257240;9185;27238;4129;2543;65267;8228;158747;8226;56474;5165;7114;6399;728239;5251;8481;8237;6757;100130302,324
-1,1,X,168546,58527164,58358618,23096;414;64061;6759;9500;10214;170685;727837;729431;10916;158586;6756;9502;158880;8242;27344;729447;54328;729422;80311;6102;54954;90737;92552;254158;60506;56850;8225;2824;10943;100873985;170082;347541;139425;729408;59272;389840;170067;81557;2002;7216;8544;55634;2857;57477;7592;425054;727866;1438;645864;5931;10075;7403;6839;51480;3750;7076;140462;8241;8623;347411;203569;7454;27301;265;645037;645051;7355;158724;6197;10084;347442;5355;55593;158787;6303;7499;8409;51360;2710;54466;8406;660;2925;171482;392465;5160;26748;11238;139628;653220;58526;28986;23133;57393;2623;6907;28227;4113;1536;9468;3730;23597;2187;389860;6611;2574;3563;9767;10325;9282;347365;8712;139341;54539;256714;10742;9104;494197;29057;442444;6103;54880;90736;2742;369;280658;170627;347344;347527;8243;4007;286430;29978;438;7504;5277;9758;56548;1184;645073;10245;94056;57502;11141;653067;11152;90121;641339;256643;23676;4114;6758;8852;7712;23708;5009;1654;4267;51284;170302;11230;79135;2277;9210;441490;64743;389856;7789;55787;139189;139422;170062;4935;4693;10013;100288814;1964;55190;293;50943;53940;30011;6322;28952;5638;8239;94122;139411;286530;2245;5634;84679;9506;416;3266;64840;10682;5207;25763;8227;389852;170626;171483;8908;550643;159013;7543;90060;168400;4281;24140;6247;10149;11279;64109;1183;55344;27197;357;8233;286514;548313;6792;79742;4128;139105;7102;139604;10549;25878;4115;11040;6855;8573;55841;729396;729442;51481;3028;778;795;10389;1756;83604;5422;7317;5935;9367;100463488;54552;415;207063;4112;412;158506;340602;158809;5127;6990;22866;5475;10159;212;85417;100132399;158584;7030;729428;190;7569;89801;729201;1968;57232;4943;79917;5256;26609;54960;6853;80231;25975;51311;8905;9189;395;347404;171484;6473;286464;169981;63904;257397;80258;139793;100008586;3052;4810;404281;5199;92745;5613;474343;140456;257240;9185;27238;4129;2543;65267;8228;158747;8226;56474;5165;7114;6399;728239;5251;8481;8237;6757;100130302,324
-1,1,X,168546,74549686,74381140,23096;414;64061;6759;9500;10214;51132;170685;727837;729431;10916;158586;6756;9502;158880;8242;27344;729447;54328;100132304;729422;9754;80311;6102;54954;56159;389874;90737;92552;254158;60506;56850;8225;2824;10943;100873985;170082;100130361;347541;139425;728656;729408;59272;389840;170067;81557;2002;7216;8544;55634;2857;57477;7592;2833;340554;425054;340526;727866;1438;139562;645864;5931;10075;7403;6839;51480;3750;27112;7076;140462;8241;6567;392490;8623;347411;203569;7454;27301;265;645037;645051;54413;7355;158724;6197;10084;347442;5355;347516;55593;158787;6303;7499;4841;8409;347517;51360;139596;1896;2710;54466;8406;51248;660;2925;171482;100132994;158833;340533;392465;22;5160;5303;3476;26748;11238;139628;653220;58526;28986;23133;4983;57393;2623;6907;28227;4113;1536;9468;3730;23597;2187;81887;64219;389860;6611;2574;3563;3561;9767;10325;9282;54857;347365;8712;139341;54539;256714;10742;26548;9104;494197;29057;442444;6103;54880;90736;2742;369;280658;170627;645974;347344;23229;347527;8243;4007;286430;101059915;29978;438;7504;60401;5277;9758;4674;56548;1184;645073;10245;94056;57502;11141;653067;1046;11152;90121;641339;256643;23676;4114;6758;1947;8852;7712;23708;5009;1654;4267;51284;170302;11230;79135;2277;9210;441490;6191;64743;389856;7789;55787;139189;63947;139422;170062;9843;4935;4693;10013;100288814;1964;55190;293;50943;53940;30011;93953;6322;28952;24137;5638;4478;8239;94122;139411;286530;2245;9968;5634;84679;1741;9506;416;3266;64840;10682;11326;5207;25763;8227;389852;170626;171483;8908;550643;159013;407;7543;90060;168400;4281;158835;24140;6247;10149;11279;64109;1183;340527;55906;55344;27197;357;8233;286514;100129407;548313;6872;6792;79742;4128;139105;7102;139604;4303;10549;55869;25878;4115;11040;8473;6855;8573;2705;55841;54821;729396;729442;139886;51481;3028;778;795;10389;1756;83604;5422;7317;5935;9367;100463488;54552;415;207063;4112;412;158506;340602;5255;158809;5127;6990;22866;4435;5475;10159;212;139285;340529;85417;100132399;158584;7030;729428;5030;190;7569;89801;729201;1968;57232;4943;79917;5256;26609;54960;6853;80231;286451;29934;25975;51311;8905;9189;395;347404;171484;6473;286464;169981;63904;257397;142689;80258;139793;55613;100008586;3052;4810;404281;5199;367;92745;5613;158830;53344;9203;474343;140456;257240;9185;27238;4129;2543;65267;8228;158747;8226;56474;5165;7114;6399;728239;84889;5251;8481;8237;6757;100130302,399
1,1,X,168546,117981120,117812574,23096;64061;392509;10214;170685;727837;55998;729431;10916;158586;55859;54830;5358;27344;729447;54328;9075;7552;729422;54954;84460;389874;56000;340562;92552;254158;56850;8225;2824;51186;100130361;1730;347541;139425;729408;79921;59272;203413;2986;9737;8544;55634;2857;11013;340554;5716;54457;1438;5931;7403;6839;51480;27112;92129;140462;8241;6567;827;203569;27301;645037;54413;7355;254065;10084;347442;55593;139818;6303;142684;8409;203447;2710;8406;51248;56001;51616;2925;100132994;5354;11043;340533;22;3476;26748;11238;203562;170261;58526;4983;6907;1536;1478;9468;23597;2187;1287;81887;6611;3561;9767;9282;54857;347365;10800;139341;54539;169966;51209;23630;26548;1121;2846;280658;347344;23229;56157;286430;101059915;438;5277;9758;4674;154796;56548;51309;1184;645073;80712;10245;728343;9823;441531;11141;90121;256643;23676;4114;6758;286499;5009;1654;1831;51284;94121;170302;11230;79135;9210;2491;441490;84187;6191;64743;3598;389856;7789;55787;9452;139422;170062;4693;5456;10013;1964;55190;100996648;293;100528062;30011;90316;93953;6322;28952;24137;94122;1538;286530;2245;5634;9506;3266;139212;5207;8227;389852;170626;91851;27334;158866;550643;159013;407;7224;168400;4281;158835;24140;8471;10149;11279;64109;1678;139322;5063;55906;84443;27197;8233;548313;6872;27018;139105;7102;10549;59353;8573;139886;282808;778;90843;1756;5422;7317;5935;207063;4112;412;158506;340602;5127;22866;10159;212;139285;9338;85417;100132399;158584;190;7569;89801;1968;5230;57232;57529;80231;286436;25975;51311;8905;55086;395;171484;169981;1349;63904;257397;142689;80258;27035;1641;55613;7105;100329135;4810;404281;367;92745;158830;53344;9203;186;474343;3597;140456;402415;203430;9185;4129;65267;56849;8228;8226;7114;6399;84889;8481;6757;414;6759;9500;51132;8823;6756;9502;158880;8242;100132304;9754;80311;6102;27328;695;56159;51213;90737;60506;10943;100873985;57526;170082;728656;3358;389840;170067;81557;80823;2002;7216;79979;57477;7592;2833;425054;340526;727866;139599;139804;54470;139562;645864;10075;117154;57631;54521;79589;3750;7076;392490;8623;347411;7454;265;90293;645051;100529097;158724;6197;5355;347516;6451;158787;7499;4841;347517;51360;139596;1896;441509;54466;660;171482;79868;158833;79366;1821;56156;392465;5160;56062;5303;51260;139628;653220;340596;28986;23133;57393;2623;28227;4113;57692;50945;3730;100131755;64219;389860;2574;3563;10325;79710;8712;26280;256714;10742;6173;9104;494197;29057;139324;442444;6103;54880;90736;2742;369;170627;645974;79983;347527;8243;4007;29978;2182;7504;60401;84707;53336;94056;57502;55285;653067;1046;11152;641339;1947;8852;7712;23708;4267;340542;2277;644353;55916;340595;139189;63947;9643;9843;4935;100288814;50943;53940;5638;4478;8239;139411;9968;84679;115201;1741;416;64840;10682;11326;25763;27330;171483;8908;27286;7543;90060;1288;84061;6247;401612;1183;340527;55344;29935;158983;357;286514;340543;54885;100129407;6792;79742;140886;4128;139604;4303;55869;25878;4115;11040;8473;6855;84636;2705;55841;54821;729396;729442;9949;51481;3028;795;10389;83604;9367;100463488;54552;6906;340547;415;5255;158809;6990;4435;5475;340529;64860;7030;729428;4675;5030;51566;729201;56271;4943;79917;85012;114928;5256;26609;54960;538;6853;286451;29934;139221;9189;347404;6473;286464;158931;139793;100008586;2717;3052;5199;546;5613;139231;257240;11254;27238;64102;2543;158747;56474;5165;140597;5631;728239;3188;5251;8237;286527;100130302,562
1,1,X,168546,154930047,154761501,23096;64061;392509;10214;170685;23157;727837;55998;23439;729431;10916;158586;55859;331;3423;54830;4168;6901;5358;92002;27344;729447;54328;266740;9075;102723737;7552;729422;54954;84460;389874;56000;340562;644538;92552;254158;79649;56850;8225;2824;100272147;51186;3149;26576;100130361;1730;347541;139425;3547;728695;729408;79921;57826;59272;203413;2986;7512;9737;8544;55634;2857;3421;537;11013;340554;5716;6658;4101;54457;1438;91966;441519;4100;5931;27316;7403;4534;6839;51480;728096;27112;92129;101928917;140462;8241;6567;827;203569;27301;84548;645037;54413;100133053;7355;254065;79836;10084;347442;60343;51765;55593;139818;56180;6303;8269;142684;7626;10046;8409;203447;63932;2710;4515;8406;51248;56001;51616;2925;100130613;2564;1193;100132994;5354;11043;340533;22;3476;84631;26748;11238;203562;102723631;170261;58526;441525;4983;29944;6907;1536;2539;1478;9468;23597;2187;1287;81887;6611;3561;9767;9282;54857;347365;10800;139341;54539;11219;728062;169966;51209;23630;26548;1121;2000;645188;51438;2846;280658;1852;347344;23229;10857;56157;286430;101059915;438;5277;9758;1069;4674;154796;56548;51309;1184;645073;80712;1774;10245;2258;728343;9823;441531;11141;643311;90121;256643;23676;4114;6758;4107;286499;5009;1654;1831;51284;94121;170302;11230;79135;286410;9210;2491;441490;84187;633;6191;64743;4110;3598;389856;7789;55787;9452;50814;2157;139422;170062;57187;139067;4104;203427;4693;5456;10013;1964;55190;100996648;293;9016;100528062;30011;90316;93953;10178;6322;28952;24137;2332;4105;94122;84968;64663;1538;9142;286530;2245;5634;9506;79576;3266;139212;5207;6535;8227;393;389852;170626;91851;27334;158866;550643;159013;407;7224;55796;10761;100132963;168400;4281;158835;24140;8471;90167;7737;7319;10149;11279;6134;64109;1678;139322;5063;55906;116442;84443;27197;8233;548313;6872;27018;100129239;139105;7102;10549;26071;2664;59353;8573;28985;79184;728049;728090;158521;139886;282808;8263;9130;728082;778;90843;1756;5422;7317;5935;347454;29071;207063;4112;412;158506;340602;30848;5127;22866;93380;159091;10159;212;139285;9338;85417;8266;100132399;158584;494118;190;7569;89801;2892;1968;5230;57232;55559;57529;8277;63035;80231;286436;25975;51311;8905;55086;139735;395;83692;171484;10251;169981;1349;63904;139716;257397;142689;80258;27035;1641;55613;7105;100329135;84295;9459;4810;404281;4109;367;474384;6748;139760;347487;92745;158830;53344;4103;9203;139378;186;474343;2719;3597;140456;9248;402415;203430;9185;90161;728042;4129;65267;56849;8228;8226;728036;7114;6399;4952;83740;84889;8481;6757;347468;347475;414;6759;9500;51132;8823;541578;2158;55609;2556;494119;6756;9502;158880;8517;8242;474383;57595;51442;389895;100132304;9754;80311;6102;27328;695;56159;51213;90737;60506;10943;100873985;57526;728269;170082;474382;102723680;728656;3358;8273;83844;114824;389840;170067;81557;80823;8862;2002;7216;79979;158763;23641;55217;8270;57477;7592;2833;425054;340526;727866;139599;139804;54470;8450;959;139562;645864;10075;117154;57631;2010;54521;79589;51634;3750;653282;728072;7076;392490;9363;8623;3920;347411;7454;100506164;265;90293;645051;100529097;55511;158724;6197;203547;139135;5355;347516;203522;139081;6451;27336;158787;728458;7499;4841;347517;51360;340578;139596;1896;441509;54466;660;158798;4108;171482;79868;728075;158833;79366;1821;56156;392465;1260;5160;56062;5303;3054;51260;139628;653220;340596;554;28986;23133;57393;2623;28227;4113;57692;50945;3730;7739;100131755;57481;8260;139170;64219;4204;389860;2574;3563;65991;10325;6170;10813;79710;8712;26280;2316;256714;10742;6173;9104;494197;29057;139324;442444;6103;54880;90736;55558;2742;1736;369;255313;3654;170627;645974;3897;79983;727940;541466;347527;8243;4007;139741;29978;2182;7504;60401;84707;53336;1485;159090;94056;57502;55285;653067;1046;11152;641339;1947;8852;7712;23708;203523;4267;54967;340542;89885;2277;83550;644353;55916;340595;6594;139189;63947;9643;9843;4935;139728;100288814;10479;50943;53940;55026;100507170;5638;4478;8239;4068;51114;139411;246100;9968;84679;115201;100533997;1741;416;64840;10682;11326;25763;27330;171483;8908;27286;1038;7543;158800;90060;1288;84061;215;6247;292;55879;401612;1183;340527;55344;29935;158983;357;10009;2747;2652;286514;340543;54885;100129407;10495;6792;79742;140886;2239;2334;4128;441518;139604;4303;55869;25878;4115;11040;8473;6855;84636;55922;728712;5956;2705;55841;54821;729396;441521;8933;10735;729442;9949;4694;84528;51481;492;3028;100129520;795;10389;83604;7411;9947;9367;100463488;10134;79057;54552;6906;340547;30014;415;5255;680;158809;6990;4435;5475;340529;65109;64860;7030;729428;8776;4675;5030;51566;729201;56271;4943;79917;85012;114928;5256;26609;54960;538;6853;5365;4354;286451;29934;10838;139221;9189;347404;6473;3251;286464;158931;139793;100008586;2717;3052;5973;139065;5199;546;5613;51270;139231;9131;7547;474381;257240;11254;27238;64102;2543;158747;2273;56474;5165;64648;54440;140597;5631;728239;3188;100130086;5251;8237;286527;100130302,813
1,1,X,168546,155081533,154912987,23096;64061;392509;10214;170685;23157;727837;55998;23439;729431;10916;158586;55859;331;3423;54830;4168;6901;5358;92002;27344;729447;54328;266740;9075;102723737;7552;729422;54954;84460;389874;56000;340562;644538;92552;254158;79649;56850;8225;2824;100272147;51186;3149;26576;100130361;1730;347541;139425;3547;728695;729408;79921;57826;59272;203413;2986;7512;9737;8544;55634;2857;3421;537;11013;340554;5716;6658;4101;54457;1438;91966;441519;4100;5931;27316;7403;4534;6839;51480;728096;27112;92129;101928917;140462;8241;6567;827;203569;27301;84548;645037;54413;100133053;7355;254065;79836;10084;347442;60343;51765;55593;139818;56180;6303;8269;142684;7626;10046;8409;203447;63932;2710;4515;8406;51248;56001;51616;2925;100130613;2564;1193;100132994;5354;11043;340533;22;3476;84631;26748;11238;203562;102723631;170261;58526;441525;4983;29944;6907;1536;2539;1478;9468;23597;2187;1287;81887;6611;3561;9767;9282;54857;347365;10800;139341;54539;11219;728062;169966;51209;23630;26548;1121;2000;645188;51438;2846;280658;1852;347344;23229;10857;56157;286430;101059915;438;5277;9758;1069;4674;154796;56548;51309;1184;645073;80712;1774;10245;2258;728343;9823;441531;11141;643311;90121;256643;23676;4114;6758;4107;286499;5009;1654;1831;51284;94121;170302;11230;79135;286410;9210;2491;441490;84187;633;6191;64743;4110;3598;389856;7789;55787;9452;50814;2157;139422;170062;57187;139067;4104;203427;4693;5456;10013;1964;55190;100996648;293;9016;100528062;30011;90316;93953;10178;6322;28952;24137;2332;4105;94122;84968;64663;1538;9142;286530;2245;5634;9506;79576;3266;139212;5207;6535;8227;393;389852;170626;91851;27334;158866;550643;159013;407;7224;55796;10761;100132963;168400;4281;158835;24140;8471;90167;7737;7319;10149;11279;6134;64109;1678;139322;5063;55906;116442;84443;27197;8233;548313;6872;27018;100129239;139105;7102;10549;26071;2664;59353;8573;28985;79184;728049;728090;158521;139886;282808;8263;9130;728082;778;90843;1756;5422;7317;5935;347454;29071;207063;4112;412;158506;340602;30848;5127;22866;93380;159091;10159;212;139285;9338;85417;8266;100132399;158584;494118;190;7569;89801;2892;1968;5230;57232;55559;57529;8277;63035;80231;286436;25975;51311;8905;55086;139735;395;83692;171484;10251;169981;1349;63904;139716;257397;142689;80258;27035;1641;55613;7105;100329135;84295;9459;4810;404281;4109;367;474384;6748;139760;347487;92745;158830;53344;4103;9203;139378;186;474343;2719;3597;140456;9248;402415;203430;9185;90161;728042;4129;65267;56849;8228;8226;728036;7114;6399;4952;83740;84889;8481;6757;347468;347475;414;6759;9500;51132;8823;541578;2158;55609;2556;494119;6756;9502;158880;8517;8242;474383;57595;51442;389895;100132304;9754;80311;6102;27328;695;56159;51213;90737;60506;10943;100873985;57526;728269;170082;474382;102723680;728656;3358;8273;83844;114824;389840;170067;81557;80823;8862;2002;7216;79979;158763;23641;55217;8270;57477;7592;2833;425054;340526;727866;139599;139804;54470;8450;959;139562;645864;10075;117154;57631;2010;54521;79589;51634;3750;653282;728072;7076;392490;9363;8623;3920;347411;7454;100506164;265;90293;645051;100529097;55511;158724;6197;203547;139135;5355;347516;203522;139081;6451;27336;158787;728458;7499;4841;347517;51360;340578;139596;1896;441509;54466;660;158798;4108;171482;79868;728075;158833;79366;1821;56156;392465;1260;5160;56062;5303;3054;51260;139628;653220;340596;554;28986;23133;57393;2623;28227;4113;57692;50945;3730;7739;100131755;57481;8260;139170;64219;4204;389860;2574;3563;65991;10325;6170;10813;79710;8712;26280;2316;256714;10742;6173;9104;494197;29057;139324;442444;6103;54880;90736;55558;2742;1736;369;255313;3654;170627;645974;3897;79983;727940;541466;347527;8243;4007;139741;29978;2182;7504;60401;84707;53336;1485;159090;94056;57502;55285;653067;1046;11152;641339;1947;8852;7712;23708;203523;4267;54967;340542;89885;2277;83550;644353;55916;340595;6594;139189;63947;9643;9843;4935;139728;100288814;10479;50943;53940;55026;100507170;5638;4478;8239;4068;51114;139411;246100;9968;84679;115201;100533997;1741;416;64840;10682;11326;25763;27330;171483;8908;27286;1038;7543;158800;90060;1288;84061;215;6247;292;55879;401612;1183;340527;55344;29935;158983;357;10009;2747;2652;286514;340543;54885;100129407;10495;6792;79742;140886;2239;2334;4128;441518;139604;4303;55869;25878;4115;11040;8473;6855;84636;55922;728712;5956;2705;55841;54821;729396;441521;8933;10735;729442;9949;4694;84528;51481;492;3028;100129520;795;10389;83604;7411;9947;9367;100463488;10134;79057;54552;6906;340547;30014;415;5255;680;158809;6990;4435;5475;340529;65109;64860;7030;729428;8776;4675;5030;51566;729201;56271;4943;79917;85012;114928;5256;26609;54960;538;6853;5365;4354;286451;29934;10838;139221;9189;347404;6473;3251;286464;158931;139793;100008586;2717;3052;5973;139065;5199;546;5613;51270;139231;9131;7547;474381;257240;11254;27238;64102;2543;158747;2273;56474;5165;64648;54440;140597;5631;728239;3188;100130086;5251;8237;286527;100130302,813
1,1,X,168546,155196888,155028342,23096;64061;392509;10214;170685;23157;727837;55998;23439;729431;10916;158586;55859;331;3423;54830;4168;6901;5358;92002;27344;729447;54328;266740;9075;102723737;7552;729422;54954;84460;389874;56000;340562;644538;92552;254158;79649;56850;8225;2824;100272147;51186;3149;26576;100130361;1730;347541;139425;3547;728695;729408;79921;57826;59272;203413;2986;7512;9737;8544;55634;2857;3421;537;11013;340554;5716;6658;4101;54457;1438;91966;441519;4100;5931;27316;7403;4534;6839;51480;728096;27112;92129;101928917;140462;8241;6567;827;203569;27301;84548;645037;54413;100133053;7355;254065;79836;10084;347442;60343;51765;55593;139818;56180;6303;8269;142684;7626;10046;8409;203447;63932;2710;4515;8406;51248;56001;51616;2925;100130613;2564;1193;100132994;5354;11043;340533;22;3476;84631;26748;11238;203562;102723631;170261;58526;441525;4983;29944;6907;1536;2539;1478;9468;23597;2187;1287;81887;6611;3561;9767;9282;54857;347365;10800;139341;54539;11219;728062;169966;51209;23630;26548;1121;2000;645188;51438;2846;280658;1852;347344;23229;10857;56157;286430;101059915;438;5277;9758;1069;4674;154796;56548;51309;1184;645073;80712;1774;10245;2258;728343;9823;441531;11141;643311;90121;256643;23676;4114;6758;4107;286499;5009;1654;1831;51284;94121;170302;11230;79135;286410;9210;2491;441490;84187;633;6191;64743;4110;3598;389856;7789;55787;9452;50814;2157;139422;170062;57187;139067;4104;203427;4693;5456;10013;1964;55190;100996648;293;9016;100528062;30011;90316;93953;10178;6322;28952;24137;2332;4105;6845;94122;84968;64663;1538;9142;286530;2245;5634;9506;79576;3266;139212;5207;6535;8227;393;389852;170626;91851;27334;158866;550643;159013;407;7224;55796;10761;100132963;168400;4281;158835;24140;8471;90167;7737;7319;10149;11279;6134;64109;1678;139322;5063;55906;116442;84443;27197;8233;548313;6872;27018;100129239;139105;7102;10549;26071;2664;59353;8573;28985;79184;728049;728090;158521;139886;282808;8263;9130;728082;778;90843;1756;5422;7317;5935;347454;29071;207063;4112;412;158506;340602;30848;5127;22866;93380;159091;10159;212;139285;9338;85417;8266;100132399;158584;494118;190;7569;89801;2892;1968;5230;57232;55559;57529;8277;63035;80231;286436;25975;51311;8905;55086;139735;395;83692;171484;10251;169981;1349;63904;139716;257397;142689;80258;27035;1641;55613;7105;100329135;84295;9459;4810;404281;4109;367;474384;6748;139760;347487;92745;158830;53344;4103;9203;139378;186;474343;2719;3597;140456;9248;402415;203430;9185;90161;728042;4129;65267;56849;8228;8226;728036;7114;6399;4952;83740;84889;8481;6757;347468;347475;414;6759;9500;51132;8823;541578;2158;55609;2556;494119;6756;9502;158880;8517;8242;474383;57595;51442;389895;100132304;9754;80311;6102;27328;695;56159;51213;90737;60506;10943;100873985;57526;728269;170082;474382;102723680;728656;3358;8273;83844;114824;389840;170067;81557;80823;8862;2002;7216;79979;158763;23641;55217;8270;57477;7592;2833;425054;340526;727866;139599;139804;54470;8450;959;139562;645864;10075;117154;57631;2010;54521;79589;51634;3750;653282;728072;7076;392490;9363;8623;3920;347411;7454;100506164;265;90293;645051;100529097;55511;158724;6197;203547;139135;5355;347516;203522;139081;6451;27336;158787;728458;7499;4841;347517;51360;340578;139596;1896;441509;54466;660;158798;4108;171482;79868;728075;158833;79366;1821;56156;392465;1260;5160;56062;5303;3054;51260;139628;653220;340596;554;28986;23133;57393;2623;28227;4113;57692;50945;3730;7739;100131755;57481;8260;139170;64219;4204;389860;2574;3563;65991;10325;6170;10813;79710;8712;26280;2316;256714;10742;6173;9104;494197;29057;139324;442444;6103;54880;90736;55558;2742;1736;369;255313;3654;170627;645974;3897;79983;727940;541466;347527;8243;4007;139741;29978;2182;7504;60401;84707;53336;1485;159090;94056;57502;55285;653067;1046;11152;641339;1947;8852;7712;23708;203523;4267;54967;340542;89885;2277;83550;644353;55916;340595;6594;139189;63947;9643;9843;4935;139728;100288814;10479;50943;53940;55026;100507170;5638;4478;8239;4068;51114;139411;246100;9968;84679;115201;100533997;1741;416;64840;10682;11326;25763;27330;171483;8908;27286;1038;7543;158800;90060;1288;84061;215;6247;292;55879;401612;1183;340527;55344;29935;158983;357;10009;2747;2652;286514;340543;54885;100129407;10495;6792;79742;140886;2239;2334;4128;441518;139604;4303;55869;25878;4115;11040;8473;6855;84636;55922;728712;5956;2705;55841;54821;729396;441521;8933;10735;729442;9949;4694;84528;51481;492;3028;100129520;795;10389;83604;7411;9947;9367;100463488;10134;79057;54552;6906;340547;30014;415;5255;680;158809;6990;4435;5475;340529;65109;64860;7030;729428;8776;4675;5030;51566;729201;56271;4943;79917;85012;114928;5256;26609;54960;538;6853;5365;4354;286451;29934;10838;139221;9189;347404;6473;3251;286464;158931;139793;100008586;2717;3052;5973;139065;5199;546;5613;51270;139231;9131;7547;474381;257240;11254;27238;64102;2543;158747;2273;56474;5165;64648;54440;140597;5631;728239;3188;100130086;5251;8237;286527;100130302,814
-1,1,X,168546,155233731,155065185,23096;64061;392509;10214;170685;23157;727837;55998;23439;729431;10916;158586;55859;331;3423;54830;4168;6901;5358;92002;27344;729447;54328;266740;9075;102723737;7552;729422;54954;84460;389874;56000;340562;644538;92552;254158;79649;56850;8225;2824;100272147;51186;3149;26576;100130361;1730;347541;139425;3547;728695;729408;79921;57826;59272;203413;2986;7512;9737;8544;55634;2857;3421;537;11013;340554;5716;6658;4101;54457;1438;91966;441519;4100;5931;27316;7403;4534;6839;51480;728096;27112;92129;101928917;140462;8241;6567;827;203569;27301;84548;645037;54413;100133053;7355;254065;79836;10084;347442;60343;51765;55593;139818;56180;6303;8269;142684;7626;10046;8409;203447;63932;2710;4515;8406;51248;56001;51616;2925;100130613;2564;1193;100132994;5354;11043;340533;22;3476;84631;26748;11238;203562;102723631;170261;58526;441525;4983;29944;6907;1536;2539;1478;9468;23597;2187;1287;81887;6611;3561;9767;9282;54857;347365;10800;139341;54539;11219;728062;169966;51209;23630;26548;1121;2000;645188;51438;2846;280658;1852;347344;23229;10857;56157;286430;101059915;438;5277;9758;1069;4674;154796;56548;51309;1184;645073;80712;1774;10245;2258;728343;9823;441531;11141;643311;90121;256643;23676;4114;6758;4107;286499;5009;1654;1831;51284;94121;170302;11230;79135;286410;9210;2491;441490;84187;633;6191;64743;4110;3598;389856;7789;55787;9452;50814;2157;139422;170062;57187;139067;4104;203427;4693;5456;10013;1964;55190;100996648;293;9016;100528062;30011;90316;93953;10178;6322;28952;24137;2332;4105;6845;94122;84968;64663;1538;9142;286530;2245;5634;9506;79576;3266;139212;5207;6535;8227;393;389852;170626;91851;27334;158866;550643;159013;407;7224;55796;10761;100132963;168400;4281;158835;24140;8471;90167;7737;7319;10149;11279;6134;64109;1678;139322;5063;55906;116442;84443;27197;8233;548313;6872;27018;100129239;139105;7102;10549;26071;2664;59353;8573;28985;79184;728049;728090;158521;3581;139886;282808;8263;9130;728082;778;90843;1756;5422;7317;5935;347454;29071;207063;4112;412;158506;340602;30848;5127;22866;93380;159091;10159;212;139285;9338;85417;8266;100132399;158584;494118;190;7569;89801;2892;1968;5230;57232;55559;57529;8277;63035;80231;286436;25975;51311;8905;55086;139735;395;83692;171484;10251;169981;1349;63904;139716;257397;142689;80258;27035;1641;55613;7105;100329135;84295;9459;4810;404281;4109;367;474384;6748;139760;347487;92745;158830;53344;4103;9203;139378;186;474343;2719;3597;140456;9248;402415;203430;9185;90161;728042;4129;65267;56849;8228;8226;728036;7114;6399;4952;83740;84889;8481;6757;347468;347475;414;6759;9500;51132;8823;541578;2158;55609;2556;494119;6756;9502;158880;8517;8242;474383;57595;51442;389895;100132304;9754;80311;6102;27328;695;56159;51213;90737;60506;10943;100873985;57526;728269;170082;474382;102723680;728656;3358;8273;83844;114824;389840;170067;81557;80823;8862;2002;7216;79979;158763;23641;55217;8270;57477;7592;2833;425054;340526;727866;139599;139804;54470;8450;959;139562;645864;10075;117154;57631;2010;54521;79589;51634;3750;653282;728072;7076;392490;9363;8623;3920;347411;7454;100506164;265;90293;645051;100529097;55511;158724;6197;203547;139135;5355;347516;203522;139081;6451;27336;158787;728458;7499;4841;347517;51360;340578;139596;1896;441509;54466;660;158798;4108;171482;79868;728075;158833;79366;1821;56156;392465;1260;5160;56062;5303;3054;51260;139628;653220;340596;554;28986;23133;57393;2623;28227;4113;57692;50945;3730;7739;100131755;57481;8260;139170;64219;4204;389860;2574;3563;65991;10325;6170;10813;79710;8712;26280;2316;256714;10742;6173;9104;494197;29057;139324;442444;6103;54880;90736;55558;2742;1736;369;255313;3654;170627;645974;3897;79983;727940;541466;347527;8243;4007;139741;29978;2182;7504;60401;84707;53336;1485;159090;94056;57502;55285;653067;1046;11152;641339;1947;8852;7712;23708;203523;4267;54967;340542;89885;2277;83550;644353;55916;340595;6594;139189;63947;9643;9843;4935;139728;100288814;10479;50943;53940;55026;100507170;5638;4478;8239;4068;51114;139411;246100;9968;84679;115201;100533997;1741;416;64840;10682;11326;25763;27330;171483;8908;27286;1038;7543;158800;90060;1288;84061;215;6247;292;55879;401612;1183;340527;55344;29935;158983;357;10009;2747;2652;286514;340543;54885;100129407;10495;6792;79742;140886;2239;2334;4128;441518;139604;4303;55869;25878;4115;11040;8473;6855;84636;55922;728712;5956;2705;55841;54821;729396;441521;8933;10735;729442;9949;4694;84528;51481;492;3028;100129520;795;10389;83604;7411;9947;9367;100463488;10134;79057;54552;6906;340547;30014;415;5255;680;158809;6990;4435;5475;340529;65109;64860;7030;729428;8776;4675;5030;51566;729201;56271;4943;79917;85012;114928;5256;26609;54960;538;6853;5365;4354;286451;29934;10838;139221;9189;347404;6473;3251;286464;158931;139793;100008586;2717;3052;5973;139065;5199;546;5613;51270;139231;9131;7547;474381;257240;11254;27238;64102;2543;158747;2273;56474;5165;64648;54440;140597;5631;728239;3188;100130086;5251;8237;286527;100130302,815
-1,1,X,168546,155233731,155065185,23096;64061;392509;10214;170685;23157;727837;55998;23439;729431;10916;158586;55859;331;3423;54830;4168;6901;5358;92002;27344;729447;54328;266740;9075;102723737;7552;729422;54954;84460;389874;56000;340562;644538;92552;254158;79649;56850;8225;2824;100272147;51186;3149;26576;100130361;1730;347541;139425;3547;728695;729408;79921;57826;59272;203413;2986;7512;9737;8544;55634;2857;3421;537;11013;340554;5716;6658;4101;54457;1438;91966;441519;4100;5931;27316;7403;4534;6839;51480;728096;27112;92129;101928917;140462;8241;6567;827;203569;27301;84548;645037;54413;100133053;7355;254065;79836;10084;347442;60343;51765;55593;139818;56180;6303;8269;142684;7626;10046;8409;203447;63932;2710;4515;8406;51248;56001;51616;2925;100130613;2564;1193;100132994;5354;11043;340533;22;3476;84631;26748;11238;203562;102723631;170261;58526;441525;4983;29944;6907;1536;2539;1478;9468;23597;2187;1287;81887;6611;3561;9767;9282;54857;347365;10800;139341;54539;11219;728062;169966;51209;23630;26548;1121;2000;645188;51438;2846;280658;1852;347344;23229;10857;56157;286430;101059915;438;5277;9758;1069;4674;154796;56548;51309;1184;645073;80712;1774;10245;2258;728343;9823;441531;11141;643311;90121;256643;23676;4114;6758;4107;286499;5009;1654;1831;51284;94121;170302;11230;79135;286410;9210;2491;441490;84187;633;6191;64743;4110;3598;389856;7789;55787;9452;50814;2157;139422;170062;57187;139067;4104;203427;4693;5456;10013;1964;55190;100996648;293;9016;100528062;30011;90316;93953;10178;6322;28952;24137;2332;4105;6845;94122;84968;64663;1538;9142;286530;2245;5634;9506;79576;3266;139212;5207;6535;8227;393;389852;170626;91851;27334;158866;550643;159013;407;7224;55796;10761;100132963;168400;4281;158835;24140;8471;90167;7737;7319;10149;11279;6134;64109;1678;139322;5063;55906;116442;84443;27197;8233;548313;6872;27018;100129239;139105;7102;10549;26071;2664;59353;8573;28985;79184;728049;728090;158521;3581;139886;282808;8263;9130;728082;778;90843;1756;5422;7317;5935;347454;29071;207063;4112;412;158506;340602;30848;5127;22866;93380;159091;10159;212;139285;9338;85417;8266;100132399;158584;494118;190;7569;89801;2892;1968;5230;57232;55559;57529;8277;63035;80231;286436;25975;51311;8905;55086;139735;395;83692;171484;10251;169981;1349;63904;139716;257397;142689;80258;27035;1641;55613;7105;100329135;84295;9459;4810;404281;4109;367;474384;6748;139760;347487;92745;158830;53344;4103;9203;139378;186;474343;2719;3597;140456;9248;402415;203430;9185;90161;728042;4129;65267;56849;8228;8226;728036;7114;6399;4952;83740;84889;8481;6757;347468;347475;414;6759;9500;51132;8823;541578;2158;55609;2556;494119;6756;9502;158880;8517;8242;474383;57595;51442;389895;100132304;9754;80311;6102;27328;695;56159;51213;90737;60506;10943;100873985;57526;728269;170082;474382;102723680;728656;3358;8273;83844;114824;389840;170067;81557;80823;8862;2002;7216;79979;158763;23641;55217;8270;57477;7592;2833;425054;340526;727866;139599;139804;54470;8450;959;139562;645864;10075;117154;57631;2010;54521;79589;51634;3750;653282;728072;7076;392490;9363;8623;3920;347411;7454;100506164;265;90293;645051;100529097;55511;158724;6197;203547;139135;5355;347516;203522;139081;6451;27336;158787;728458;7499;4841;347517;51360;340578;139596;1896;441509;54466;660;158798;4108;171482;79868;728075;158833;79366;1821;56156;392465;1260;5160;56062;5303;3054;51260;139628;653220;340596;554;28986;23133;57393;2623;28227;4113;57692;50945;3730;7739;100131755;57481;8260;139170;64219;4204;389860;2574;3563;65991;10325;6170;10813;79710;8712;26280;2316;256714;10742;6173;9104;494197;29057;139324;442444;6103;54880;90736;55558;2742;1736;369;255313;3654;170627;645974;3897;79983;727940;541466;347527;8243;4007;139741;29978;2182;7504;60401;84707;53336;1485;159090;94056;57502;55285;653067;1046;11152;641339;1947;8852;7712;23708;203523;4267;54967;340542;89885;2277;83550;644353;55916;340595;6594;139189;63947;9643;9843;4935;139728;100288814;10479;50943;53940;55026;100507170;5638;4478;8239;4068;51114;139411;246100;9968;84679;115201;100533997;1741;416;64840;10682;11326;25763;27330;171483;8908;27286;1038;7543;158800;90060;1288;84061;215;6247;292;55879;401612;1183;340527;55344;29935;158983;357;10009;2747;2652;286514;340543;54885;100129407;10495;6792;79742;140886;2239;2334;4128;441518;139604;4303;55869;25878;4115;11040;8473;6855;84636;55922;728712;5956;2705;55841;54821;729396;441521;8933;10735;729442;9949;4694;84528;51481;492;3028;100129520;795;10389;83604;7411;9947;9367;100463488;10134;79057;54552;6906;340547;30014;415;5255;680;158809;6990;4435;5475;340529;65109;64860;7030;729428;8776;4675;5030;51566;729201;56271;4943;79917;85012;114928;5256;26609;54960;538;6853;5365;4354;286451;29934;10838;139221;9189;347404;6473;3251;286464;158931;139793;100008586;2717;3052;5973;139065;5199;546;5613;51270;139231;9131;7547;474381;257240;11254;27238;64102;2543;158747;2273;56474;5165;64648;54440;140597;5631;728239;3188;100130086;5251;8237;286527;100130302,815
1,1,X,168546,155233731,155065185,23096;64061;392509;10214;170685;23157;727837;55998;23439;729431;10916;158586;55859;331;3423;54830;4168;6901;5358;92002;27344;729447;54328;266740;9075;102723737;7552;729422;54954;84460;389874;56000;340562;644538;92552;254158;79649;56850;8225;2824;100272147;51186;3149;26576;100130361;1730;347541;139425;3547;728695;729408;79921;57826;59272;203413;2986;7512;9737;8544;55634;2857;3421;537;11013;340554;5716;6658;4101;54457;1438;91966;441519;4100;5931;27316;7403;4534;6839;51480;728096;27112;92129;101928917;140462;8241;6567;827;203569;27301;84548;645037;54413;100133053;7355;254065;79836;10084;347442;60343;51765;55593;139818;56180;6303;8269;142684;7626;10046;8409;203447;63932;2710;4515;8406;51248;56001;51616;2925;100130613;2564;1193;100132994;5354;11043;340533;22;3476;84631;26748;11238;203562;102723631;170261;58526;441525;4983;29944;6907;1536;2539;1478;9468;23597;2187;1287;81887;6611;3561;9767;9282;54857;347365;10800;139341;54539;11219;728062;169966;51209;23630;26548;1121;2000;645188;51438;2846;280658;1852;347344;23229;10857;56157;286430;101059915;438;5277;9758;1069;4674;154796;56548;51309;1184;645073;80712;1774;10245;2258;728343;9823;441531;11141;643311;90121;256643;23676;4114;6758;4107;286499;5009;1654;1831;51284;94121;170302;11230;79135;286410;9210;2491;441490;84187;633;6191;64743;4110;3598;389856;7789;55787;9452;50814;2157;139422;170062;57187;139067;4104;203427;4693;5456;10013;1964;55190;100996648;293;9016;100528062;30011;90316;93953;10178;6322;28952;24137;2332;4105;6845;94122;84968;64663;1538;9142;286530;2245;5634;9506;79576;3266;139212;5207;6535;8227;393;389852;170626;91851;27334;158866;550643;159013;407;7224;55796;10761;100132963;168400;4281;158835;24140;8471;90167;7737;7319;10149;11279;6134;64109;1678;139322;5063;55906;116442;84443;27197;8233;548313;6872;27018;100129239;139105;7102;10549;26071;2664;59353;8573;28985;79184;728049;728090;158521;3581;139886;282808;8263;9130;728082;778;90843;1756;5422;7317;5935;347454;29071;207063;4112;412;158506;340602;30848;5127;22866;93380;159091;10159;212;139285;9338;85417;8266;100132399;158584;494118;190;7569;89801;2892;1968;5230;57232;55559;57529;8277;63035;80231;286436;25975;51311;8905;55086;139735;395;83692;171484;10251;169981;1349;63904;139716;257397;142689;80258;27035;1641;55613;7105;100329135;84295;9459;4810;404281;4109;367;474384;6748;139760;347487;92745;158830;53344;4103;9203;139378;186;474343;2719;3597;140456;9248;402415;203430;9185;90161;728042;4129;65267;56849;8228;8226;728036;7114;6399;4952;83740;84889;8481;6757;347468;347475;414;6759;9500;51132;8823;541578;2158;55609;2556;494119;6756;9502;158880;8517;8242;474383;57595;51442;389895;100132304;9754;80311;6102;27328;695;56159;51213;90737;60506;10943;100873985;57526;728269;170082;474382;102723680;728656;3358;8273;83844;114824;389840;170067;81557;80823;8862;2002;7216;79979;158763;23641;55217;8270;57477;7592;2833;425054;340526;727866;139599;139804;54470;8450;959;139562;645864;10075;117154;57631;2010;54521;79589;51634;3750;653282;728072;7076;392490;9363;8623;3920;347411;7454;100506164;265;90293;645051;100529097;55511;158724;6197;203547;139135;5355;347516;203522;139081;6451;27336;158787;728458;7499;4841;347517;51360;340578;139596;1896;441509;54466;660;158798;4108;171482;79868;728075;158833;79366;1821;56156;392465;1260;5160;56062;5303;3054;51260;139628;653220;340596;554;28986;23133;57393;2623;28227;4113;57692;50945;3730;7739;100131755;57481;8260;139170;64219;4204;389860;2574;3563;65991;10325;6170;10813;79710;8712;26280;2316;256714;10742;6173;9104;494197;29057;139324;442444;6103;54880;90736;55558;2742;1736;369;255313;3654;170627;645974;3897;79983;727940;541466;347527;8243;4007;139741;29978;2182;7504;60401;84707;53336;1485;159090;94056;57502;55285;653067;1046;11152;641339;1947;8852;7712;23708;203523;4267;54967;340542;89885;2277;83550;644353;55916;340595;6594;139189;63947;9643;9843;4935;139728;100288814;10479;50943;53940;55026;100507170;5638;4478;8239;4068;51114;139411;246100;9968;84679;115201;100533997;1741;416;64840;10682;11326;25763;27330;171483;8908;27286;1038;7543;158800;90060;1288;84061;215;6247;292;55879;401612;1183;340527;55344;29935;158983;357;10009;2747;2652;286514;340543;54885;100129407;10495;6792;79742;140886;2239;2334;4128;441518;139604;4303;55869;25878;4115;11040;8473;6855;84636;55922;728712;5956;2705;55841;54821;729396;441521;8933;10735;729442;9949;4694;84528;51481;492;3028;100129520;795;10389;83604;7411;9947;9367;100463488;10134;79057;54552;6906;340547;30014;415;5255;680;158809;6990;4435;5475;340529;65109;64860;7030;729428;8776;4675;5030;51566;729201;56271;4943;79917;85012;114928;5256;26609;54960;538;6853;5365;4354;286451;29934;10838;139221;9189;347404;6473;3251;286464;158931;139793;100008586;2717;3052;5973;139065;5199;546;5613;51270;139231;9131;7547;474381;257240;11254;27238;64102;2543;158747;2273;56474;5165;64648;54440;140597;5631;728239;3188;100130086;5251;8237;286527;100130302,815
1,1,X,168546,155233731,155065185,23096;64061;392509;10214;170685;23157;727837;55998;23439;729431;10916;158586;55859;331;3423;54830;4168;6901;5358;92002;27344;729447;54328;266740;9075;102723737;7552;729422;54954;84460;389874;56000;340562;644538;92552;254158;79649;56850;8225;2824;100272147;51186;3149;26576;100130361;1730;347541;139425;3547;728695;729408;79921;57826;59272;203413;2986;7512;9737;8544;55634;2857;3421;537;11013;340554;5716;6658;4101;54457;1438;91966;441519;4100;5931;27316;7403;4534;6839;51480;728096;27112;92129;101928917;140462;8241;6567;827;203569;27301;84548;645037;54413;100133053;7355;254065;79836;10084;347442;60343;51765;55593;139818;56180;6303;8269;142684;7626;10046;8409;203447;63932;2710;4515;8406;51248;56001;51616;2925;100130613;2564;1193;100132994;5354;11043;340533;22;3476;84631;26748;11238;203562;102723631;170261;58526;441525;4983;29944;6907;1536;2539;1478;9468;23597;2187;1287;81887;6611;3561;9767;9282;54857;347365;10800;139341;54539;11219;728062;169966;51209;23630;26548;1121;2000;645188;51438;2846;280658;1852;347344;23229;10857;56157;286430;101059915;438;5277;9758;1069;4674;154796;56548;51309;1184;645073;80712;1774;10245;2258;728343;9823;441531;11141;643311;90121;256643;23676;4114;6758;4107;286499;5009;1654;1831;51284;94121;170302;11230;79135;286410;9210;2491;441490;84187;633;6191;64743;4110;3598;389856;7789;55787;9452;50814;2157;139422;170062;57187;139067;4104;203427;4693;5456;10013;1964;55190;100996648;293;9016;100528062;30011;90316;93953;10178;6322;28952;24137;2332;4105;6845;94122;84968;64663;1538;9142;286530;2245;5634;9506;79576;3266;139212;5207;6535;8227;393;389852;170626;91851;27334;158866;550643;159013;407;7224;55796;10761;100132963;168400;4281;158835;24140;8471;90167;7737;7319;10149;11279;6134;64109;1678;139322;5063;55906;116442;84443;27197;8233;548313;6872;27018;100129239;139105;7102;10549;26071;2664;59353;8573;28985;79184;728049;728090;158521;3581;139886;282808;8263;9130;728082;778;90843;1756;5422;7317;5935;347454;29071;207063;4112;412;158506;340602;30848;5127;22866;93380;159091;10159;212;139285;9338;85417;8266;100132399;158584;494118;190;7569;89801;2892;1968;5230;57232;55559;57529;8277;63035;80231;286436;25975;51311;8905;55086;139735;395;83692;171484;10251;169981;1349;63904;139716;257397;142689;80258;27035;1641;55613;7105;100329135;84295;9459;4810;404281;4109;367;474384;6748;139760;347487;92745;158830;53344;4103;9203;139378;186;474343;2719;3597;140456;9248;402415;203430;9185;90161;728042;4129;65267;56849;8228;8226;728036;7114;6399;4952;83740;84889;8481;6757;347468;347475;414;6759;9500;51132;8823;541578;2158;55609;2556;494119;6756;9502;158880;8517;8242;474383;57595;51442;389895;100132304;9754;80311;6102;27328;695;56159;51213;90737;60506;10943;100873985;57526;728269;170082;474382;102723680;728656;3358;8273;83844;114824;389840;170067;81557;80823;8862;2002;7216;79979;158763;23641;55217;8270;57477;7592;2833;425054;340526;727866;139599;139804;54470;8450;959;139562;645864;10075;117154;57631;2010;54521;79589;51634;3750;653282;728072;7076;392490;9363;8623;3920;347411;7454;100506164;265;90293;645051;100529097;55511;158724;6197;203547;139135;5355;347516;203522;139081;6451;27336;158787;728458;7499;4841;347517;51360;340578;139596;1896;441509;54466;660;158798;4108;171482;79868;728075;158833;79366;1821;56156;392465;1260;5160;56062;5303;3054;51260;139628;653220;340596;554;28986;23133;57393;2623;28227;4113;57692;50945;3730;7739;100131755;57481;8260;139170;64219;4204;389860;2574;3563;65991;10325;6170;10813;79710;8712;26280;2316;256714;10742;6173;9104;494197;29057;139324;442444;6103;54880;90736;55558;2742;1736;369;255313;3654;170627;645974;3897;79983;727940;541466;347527;8243;4007;139741;29978;2182;7504;60401;84707;53336;1485;159090;94056;57502;55285;653067;1046;11152;641339;1947;8852;7712;23708;203523;4267;54967;340542;89885;2277;83550;644353;55916;340595;6594;139189;63947;9643;9843;4935;139728;100288814;10479;50943;53940;55026;100507170;5638;4478;8239;4068;51114;139411;246100;9968;84679;115201;100533997;1741;416;64840;10682;11326;25763;27330;171483;8908;27286;1038;7543;158800;90060;1288;84061;215;6247;292;55879;401612;1183;340527;55344;29935;158983;357;10009;2747;2652;286514;340543;54885;100129407;10495;6792;79742;140886;2239;2334;4128;441518;139604;4303;55869;25878;4115;11040;8473;6855;84636;55922;728712;5956;2705;55841;54821;729396;441521;8933;10735;729442;9949;4694;84528;51481;492;3028;100129520;795;10389;83604;7411;9947;9367;100463488;10134;79057;54552;6906;340547;30014;415;5255;680;158809;6990;4435;5475;340529;65109;64860;7030;729428;8776;4675;5030;51566;729201;56271;4943;79917;85012;114928;5256;26609;54960;538;6853;5365;4354;286451;29934;10838;139221;9189;347404;6473;3251;286464;158931;139793;100008586;2717;3052;5973;139065;5199;546;5613;51270;139231;9131;7547;474381;257240;11254;27238;64102;2543;158747;2273;56474;5165;64648;54440;140597;5631;728239;3188;100130086;5251;8237;286527;100130302,815
1,1,X,168546,155233731,155065185,23096;64061;392509;10214;170685;23157;727837;55998;23439;729431;10916;158586;55859;331;3423;54830;4168;6901;5358;92002;27344;729447;54328;266740;9075;102723737;7552;729422;54954;84460;389874;56000;340562;644538;92552;254158;79649;56850;8225;2824;100272147;51186;3149;26576;100130361;1730;347541;139425;3547;728695;729408;79921;57826;59272;203413;2986;7512;9737;8544;55634;2857;3421;537;11013;340554;5716;6658;4101;54457;1438;91966;441519;4100;5931;27316;7403;4534;6839;51480;728096;27112;92129;101928917;140462;8241;6567;827;203569;27301;84548;645037;54413;100133053;7355;254065;79836;10084;347442;60343;51765;55593;139818;56180;6303;8269;142684;7626;10046;8409;203447;63932;2710;4515;8406;51248;56001;51616;2925;100130613;2564;1193;100132994;5354;11043;340533;22;3476;84631;26748;11238;203562;102723631;170261;58526;441525;4983;29944;6907;1536;2539;1478;9468;23597;2187;1287;81887;6611;3561;9767;9282;54857;347365;10800;139341;54539;11219;728062;169966;51209;23630;26548;1121;2000;645188;51438;2846;280658;1852;347344;23229;10857;56157;286430;101059915;438;5277;9758;1069;4674;154796;56548;51309;1184;645073;80712;1774;10245;2258;728343;9823;441531;11141;643311;90121;256643;23676;4114;6758;4107;286499;5009;1654;1831;51284;94121;170302;11230;79135;286410;9210;2491;441490;84187;633;6191;64743;4110;3598;389856;7789;55787;9452;50814;2157;139422;170062;57187;139067;4104;203427;4693;5456;10013;1964;55190;100996648;293;9016;100528062;30011;90316;93953;10178;6322;28952;24137;2332;4105;6845;94122;84968;64663;1538;9142;286530;2245;5634;9506;79576;3266;139212;5207;6535;8227;393;389852;170626;91851;27334;158866;550643;159013;407;7224;55796;10761;100132963;168400;4281;158835;24140;8471;90167;7737;7319;10149;11279;6134;64109;1678;139322;5063;55906;116442;84443;27197;8233;548313;6872;27018;100129239;139105;7102;10549;26071;2664;59353;8573;28985;79184;728049;728090;158521;3581;139886;282808;8263;9130;728082;778;90843;1756;5422;7317;5935;347454;29071;207063;4112;412;158506;340602;30848;5127;22866;93380;159091;10159;212;139285;9338;85417;8266;100132399;158584;494118;190;7569;89801;2892;1968;5230;57232;55559;57529;8277;63035;80231;286436;25975;51311;8905;55086;139735;395;83692;171484;10251;169981;1349;63904;139716;257397;142689;80258;27035;1641;55613;7105;100329135;84295;9459;4810;404281;4109;367;474384;6748;139760;347487;92745;158830;53344;4103;9203;139378;186;474343;2719;3597;140456;9248;402415;203430;9185;90161;728042;4129;65267;56849;8228;8226;728036;7114;6399;4952;83740;84889;8481;6757;347468;347475;414;6759;9500;51132;8823;541578;2158;55609;2556;494119;6756;9502;158880;8517;8242;474383;57595;51442;389895;100132304;9754;80311;6102;27328;695;56159;51213;90737;60506;10943;100873985;57526;728269;170082;474382;102723680;728656;3358;8273;83844;114824;389840;170067;81557;80823;8862;2002;7216;79979;158763;23641;55217;8270;57477;7592;2833;425054;340526;727866;139599;139804;54470;8450;959;139562;645864;10075;117154;57631;2010;54521;79589;51634;3750;653282;728072;7076;392490;9363;8623;3920;347411;7454;100506164;265;90293;645051;100529097;55511;158724;6197;203547;139135;5355;347516;203522;139081;6451;27336;158787;728458;7499;4841;347517;51360;340578;139596;1896;441509;54466;660;158798;4108;171482;79868;728075;158833;79366;1821;56156;392465;1260;5160;56062;5303;3054;51260;139628;653220;340596;554;28986;23133;57393;2623;28227;4113;57692;50945;3730;7739;100131755;57481;8260;139170;64219;4204;389860;2574;3563;65991;10325;6170;10813;79710;8712;26280;2316;256714;10742;6173;9104;494197;29057;139324;442444;6103;54880;90736;55558;2742;1736;369;255313;3654;170627;645974;3897;79983;727940;541466;347527;8243;4007;139741;29978;2182;7504;60401;84707;53336;1485;159090;94056;57502;55285;653067;1046;11152;641339;1947;8852;7712;23708;203523;4267;54967;340542;89885;2277;83550;644353;55916;340595;6594;139189;63947;9643;9843;4935;139728;100288814;10479;50943;53940;55026;100507170;5638;4478;8239;4068;51114;139411;246100;9968;84679;115201;100533997;1741;416;64840;10682;11326;25763;27330;171483;8908;27286;1038;7543;158800;90060;1288;84061;215;6247;292;55879;401612;1183;340527;55344;29935;158983;357;10009;2747;2652;286514;340543;54885;100129407;10495;6792;79742;140886;2239;2334;4128;441518;139604;4303;55869;25878;4115;11040;8473;6855;84636;55922;728712;5956;2705;55841;54821;729396;441521;8933;10735;729442;9949;4694;84528;51481;492;3028;100129520;795;10389;83604;7411;9947;9367;100463488;10134;79057;54552;6906;340547;30014;415;5255;680;158809;6990;4435;5475;340529;65109;64860;7030;729428;8776;4675;5030;51566;729201;56271;4943;79917;85012;114928;5256;26609;54960;538;6853;5365;4354;286451;29934;10838;139221;9189;347404;6473;3251;286464;158931;139793;100008586;2717;3052;5973;139065;5199;546;5613;51270;139231;9131;7547;474381;257240;11254;27238;64102;2543;158747;2273;56474;5165;64648;54440;140597;5631;728239;3188;100130086;5251;8237;286527;100130302,815
1,1,X,168546,155233731,155065185,23096;64061;392509;10214;170685;23157;727837;55998;23439;729431;10916;158586;55859;331;3423;54830;4168;6901;5358;92002;27344;729447;54328;266740;9075;102723737;7552;729422;54954;84460;389874;56000;340562;644538;92552;254158;79649;56850;8225;2824;100272147;51186;3149;26576;100130361;1730;347541;139425;3547;728695;729408;79921;57826;59272;203413;2986;7512;9737;8544;55634;2857;3421;537;11013;340554;5716;6658;4101;54457;1438;91966;441519;4100;5931;27316;7403;4534;6839;51480;728096;27112;92129;101928917;140462;8241;6567;827;203569;27301;84548;645037;54413;100133053;7355;254065;79836;10084;347442;60343;51765;55593;139818;56180;6303;8269;142684;7626;10046;8409;203447;63932;2710;4515;8406;51248;56001;51616;2925;100130613;2564;1193;100132994;5354;11043;340533;22;3476;84631;26748;11238;203562;102723631;170261;58526;441525;4983;29944;6907;1536;2539;1478;9468;23597;2187;1287;81887;6611;3561;9767;9282;54857;347365;10800;139341;54539;11219;728062;169966;51209;23630;26548;1121;2000;645188;51438;2846;280658;1852;347344;23229;10857;56157;286430;101059915;438;5277;9758;1069;4674;154796;56548;51309;1184;645073;80712;1774;10245;2258;728343;9823;441531;11141;643311;90121;256643;23676;4114;6758;4107;286499;5009;1654;1831;51284;94121;170302;11230;79135;286410;9210;2491;441490;84187;633;6191;64743;4110;3598;389856;7789;55787;9452;50814;2157;139422;170062;57187;139067;4104;203427;4693;5456;10013;1964;55190;100996648;293;9016;100528062;30011;90316;93953;10178;6322;28952;24137;2332;4105;6845;94122;84968;64663;1538;9142;286530;2245;5634;9506;79576;3266;139212;5207;6535;8227;393;389852;170626;91851;27334;158866;550643;159013;407;7224;55796;10761;100132963;168400;4281;158835;24140;8471;90167;7737;7319;10149;11279;6134;64109;1678;139322;5063;55906;116442;84443;27197;8233;548313;6872;27018;100129239;139105;7102;10549;26071;2664;59353;8573;28985;79184;728049;728090;158521;3581;139886;282808;8263;9130;728082;778;90843;1756;5422;7317;5935;347454;29071;207063;4112;412;158506;340602;30848;5127;22866;93380;159091;10159;212;139285;9338;85417;8266;100132399;158584;494118;190;7569;89801;2892;1968;5230;57232;55559;57529;8277;63035;80231;286436;25975;51311;8905;55086;139735;395;83692;171484;10251;169981;1349;63904;139716;257397;142689;80258;27035;1641;55613;7105;100329135;84295;9459;4810;404281;4109;367;474384;6748;139760;347487;92745;158830;53344;4103;9203;139378;186;474343;2719;3597;140456;9248;402415;203430;9185;90161;728042;4129;65267;56849;8228;8226;728036;7114;6399;4952;83740;84889;8481;6757;347468;347475;414;6759;9500;51132;8823;541578;2158;55609;2556;494119;6756;9502;158880;8517;8242;474383;57595;51442;389895;100132304;9754;80311;6102;27328;695;56159;51213;90737;60506;10943;100873985;57526;728269;170082;474382;102723680;728656;3358;8273;83844;114824;389840;170067;81557;80823;8862;2002;7216;79979;158763;23641;55217;8270;57477;7592;2833;425054;340526;727866;139599;139804;54470;8450;959;139562;645864;10075;117154;57631;2010;54521;79589;51634;3750;653282;728072;7076;392490;9363;8623;3920;347411;7454;100506164;265;90293;645051;100529097;55511;158724;6197;203547;139135;5355;347516;203522;139081;6451;27336;158787;728458;7499;4841;347517;51360;340578;139596;1896;441509;54466;660;158798;4108;171482;79868;728075;158833;79366;1821;56156;392465;1260;5160;56062;5303;3054;51260;139628;653220;340596;554;28986;23133;57393;2623;28227;4113;57692;50945;3730;7739;100131755;57481;8260;139170;64219;4204;389860;2574;3563;65991;10325;6170;10813;79710;8712;26280;2316;256714;10742;6173;9104;494197;29057;139324;442444;6103;54880;90736;55558;2742;1736;369;255313;3654;170627;645974;3897;79983;727940;541466;347527;8243;4007;139741;29978;2182;7504;60401;84707;53336;1485;159090;94056;57502;55285;653067;1046;11152;641339;1947;8852;7712;23708;203523;4267;54967;340542;89885;2277;83550;644353;55916;340595;6594;139189;63947;9643;9843;4935;139728;100288814;10479;50943;53940;55026;100507170;5638;4478;8239;4068;51114;139411;246100;9968;84679;115201;100533997;1741;416;64840;10682;11326;25763;27330;171483;8908;27286;1038;7543;158800;90060;1288;84061;215;6247;292;55879;401612;1183;340527;55344;29935;158983;357;10009;2747;2652;286514;340543;54885;100129407;10495;6792;79742;140886;2239;2334;4128;441518;139604;4303;55869;25878;4115;11040;8473;6855;84636;55922;728712;5956;2705;55841;54821;729396;441521;8933;10735;729442;9949;4694;84528;51481;492;3028;100129520;795;10389;83604;7411;9947;9367;100463488;10134;79057;54552;6906;340547;30014;415;5255;680;158809;6990;4435;5475;340529;65109;64860;7030;729428;8776;4675;5030;51566;729201;56271;4943;79917;85012;114928;5256;26609;54960;538;6853;5365;4354;286451;29934;10838;139221;9189;347404;6473;3251;286464;158931;139793;100008586;2717;3052;5973;139065;5199;546;5613;51270;139231;9131;7547;474381;257240;11254;27238;64102;2543;158747;2273;56474;5165;64648;54440;140597;5631;728239;3188;100130086;5251;8237;286527;100130302,815
-1,1,X,168546,155233731,155065185,23096;64061;392509;10214;170685;23157;727837;55998;23439;729431;10916;158586;55859;331;3423;54830;4168;6901;5358;92002;27344;729447;54328;266740;9075;102723737;7552;729422;54954;84460;389874;56000;340562;644538;92552;254158;79649;56850;8225;2824;100272147;51186;3149;26576;100130361;1730;347541;139425;3547;728695;729408;79921;57826;59272;203413;2986;7512;9737;8544;55634;2857;3421;537;11013;340554;5716;6658;4101;54457;1438;91966;441519;4100;5931;27316;7403;4534;6839;51480;728096;27112;92129;101928917;140462;8241;6567;827;203569;27301;84548;645037;54413;100133053;7355;254065;79836;10084;347442;60343;51765;55593;139818;56180;6303;8269;142684;7626;10046;8409;203447;63932;2710;4515;8406;51248;56001;51616;2925;100130613;2564;1193;100132994;5354;11043;340533;22;3476;84631;26748;11238;203562;102723631;170261;58526;441525;4983;29944;6907;1536;2539;1478;9468;23597;2187;1287;81887;6611;3561;9767;9282;54857;347365;10800;139341;54539;11219;728062;169966;51209;23630;26548;1121;2000;645188;51438;2846;280658;1852;347344;23229;10857;56157;286430;101059915;438;5277;9758;1069;4674;154796;56548;51309;1184;645073;80712;1774;10245;2258;728343;9823;441531;11141;643311;90121;256643;23676;4114;6758;4107;286499;5009;1654;1831;51284;94121;170302;11230;79135;286410;9210;2491;441490;84187;633;6191;64743;4110;3598;389856;7789;55787;9452;50814;2157;139422;170062;57187;139067;4104;203427;4693;5456;10013;1964;55190;100996648;293;9016;100528062;30011;90316;93953;10178;6322;28952;24137;2332;4105;6845;94122;84968;64663;1538;9142;286530;2245;5634;9506;79576;3266;139212;5207;6535;8227;393;389852;170626;91851;27334;158866;550643;159013;407;7224;55796;10761;100132963;168400;4281;158835;24140;8471;90167;7737;7319;10149;11279;6134;64109;1678;139322;5063;55906;116442;84443;27197;8233;548313;6872;27018;100129239;139105;7102;10549;26071;2664;59353;8573;28985;79184;728049;728090;158521;3581;139886;282808;8263;9130;728082;778;90843;1756;5422;7317;5935;347454;29071;207063;4112;412;158506;340602;30848;5127;22866;93380;159091;10159;212;139285;9338;85417;8266;100132399;158584;494118;190;7569;89801;2892;1968;5230;57232;55559;57529;8277;63035;80231;286436;25975;51311;8905;55086;139735;395;83692;171484;10251;169981;1349;63904;139716;257397;142689;80258;27035;1641;55613;7105;100329135;84295;9459;4810;404281;4109;367;474384;6748;139760;347487;92745;158830;53344;4103;9203;139378;186;474343;2719;3597;140456;9248;402415;203430;9185;90161;728042;4129;65267;56849;8228;8226;728036;7114;6399;4952;83740;84889;8481;6757;347468;347475;414;6759;9500;51132;8823;541578;2158;55609;2556;494119;6756;9502;158880;8517;8242;474383;57595;51442;389895;100132304;9754;80311;6102;27328;695;56159;51213;90737;60506;10943;100873985;57526;728269;170082;474382;102723680;728656;3358;8273;83844;114824;389840;170067;81557;80823;8862;2002;7216;79979;158763;23641;55217;8270;57477;7592;2833;425054;340526;727866;139599;139804;54470;8450;959;139562;645864;10075;117154;57631;2010;54521;79589;51634;3750;653282;728072;7076;392490;9363;8623;3920;347411;7454;100506164;265;90293;645051;100529097;55511;158724;6197;203547;139135;5355;347516;203522;139081;6451;27336;158787;728458;7499;4841;347517;51360;340578;139596;1896;441509;54466;660;158798;4108;171482;79868;728075;158833;79366;1821;56156;392465;1260;5160;56062;5303;3054;51260;139628;653220;340596;554;28986;23133;57393;2623;28227;4113;57692;50945;3730;7739;100131755;57481;8260;139170;64219;4204;389860;2574;3563;65991;10325;6170;10813;79710;8712;26280;2316;256714;10742;6173;9104;494197;29057;139324;442444;6103;54880;90736;55558;2742;1736;369;255313;3654;170627;645974;3897;79983;727940;541466;347527;8243;4007;139741;29978;2182;7504;60401;84707;53336;1485;159090;94056;57502;55285;653067;1046;11152;641339;1947;8852;7712;23708;203523;4267;54967;340542;89885;2277;83550;644353;55916;340595;6594;139189;63947;9643;9843;4935;139728;100288814;10479;50943;53940;55026;100507170;5638;4478;8239;4068;51114;139411;246100;9968;84679;115201;100533997;1741;416;64840;10682;11326;25763;27330;171483;8908;27286;1038;7543;158800;90060;1288;84061;215;6247;292;55879;401612;1183;340527;55344;29935;158983;357;10009;2747;2652;286514;340543;54885;100129407;10495;6792;79742;140886;2239;2334;4128;441518;139604;4303;55869;25878;4115;11040;8473;6855;84636;55922;728712;5956;2705;55841;54821;729396;441521;8933;10735;729442;9949;4694;84528;51481;492;3028;100129520;795;10389;83604;7411;9947;9367;100463488;10134;79057;54552;6906;340547;30014;415;5255;680;158809;6990;4435;5475;340529;65109;64860;7030;729428;8776;4675;5030;51566;729201;56271;4943;79917;85012;114928;5256;26609;54960;538;6853;5365;4354;286451;29934;10838;139221;9189;347404;6473;3251;286464;158931;139793;100008586;2717;3052;5973;139065;5199;546;5613;51270;139231;9131;7547;474381;257240;11254;27238;64102;2543;158747;2273;56474;5165;64648;54440;140597;5631;728239;3188;100130086;5251;8237;286527;100130302,815
1,1,X,168546,155233731,155065185,23096;64061;392509;10214;170685;23157;727837;55998;23439;729431;10916;158586;55859;331;3423;54830;4168;6901;5358;92002;27344;729447;54328;266740;9075;102723737;7552;729422;54954;84460;389874;56000;340562;644538;92552;254158;79649;56850;8225;2824;100272147;51186;3149;26576;100130361;1730;347541;139425;3547;728695;729408;79921;57826;59272;203413;2986;7512;9737;8544;55634;2857;3421;537;11013;340554;5716;6658;4101;54457;1438;91966;441519;4100;5931;27316;7403;4534;6839;51480;728096;27112;92129;101928917;140462;8241;6567;827;203569;27301;84548;645037;54413;100133053;7355;254065;79836;10084;347442;60343;51765;55593;139818;56180;6303;8269;142684;7626;10046;8409;203447;63932;2710;4515;8406;51248;56001;51616;2925;100130613;2564;1193;100132994;5354;11043;340533;22;3476;84631;26748;11238;203562;102723631;170261;58526;441525;4983;29944;6907;1536;2539;1478;9468;23597;2187;1287;81887;6611;3561;9767;9282;54857;347365;10800;139341;54539;11219;728062;169966;51209;23630;26548;1121;2000;645188;51438;2846;280658;1852;347344;23229;10857;56157;286430;101059915;438;5277;9758;1069;4674;154796;56548;51309;1184;645073;80712;1774;10245;2258;728343;9823;441531;11141;643311;90121;256643;23676;4114;6758;4107;286499;5009;1654;1831;51284;94121;170302;11230;79135;286410;9210;2491;441490;84187;633;6191;64743;4110;3598;389856;7789;55787;9452;50814;2157;139422;170062;57187;139067;4104;203427;4693;5456;10013;1964;55190;100996648;293;9016;100528062;30011;90316;93953;10178;6322;28952;24137;2332;4105;6845;94122;84968;64663;1538;9142;286530;2245;5634;9506;79576;3266;139212;5207;6535;8227;393;389852;170626;91851;27334;158866;550643;159013;407;7224;55796;10761;100132963;168400;4281;158835;24140;8471;90167;7737;7319;10149;11279;6134;64109;1678;139322;5063;55906;116442;84443;27197;8233;548313;6872;27018;100129239;139105;7102;10549;26071;2664;59353;8573;28985;79184;728049;728090;158521;3581;139886;282808;8263;9130;728082;778;90843;1756;5422;7317;5935;347454;29071;207063;4112;412;158506;340602;30848;5127;22866;93380;159091;10159;212;139285;9338;85417;8266;100132399;158584;494118;190;7569;89801;2892;1968;5230;57232;55559;57529;8277;63035;80231;286436;25975;51311;8905;55086;139735;395;83692;171484;10251;169981;1349;63904;139716;257397;142689;80258;27035;1641;55613;7105;100329135;84295;9459;4810;404281;4109;367;474384;6748;139760;347487;92745;158830;53344;4103;9203;139378;186;474343;2719;3597;140456;9248;402415;203430;9185;90161;728042;4129;65267;56849;8228;8226;728036;7114;6399;4952;83740;84889;8481;6757;347468;347475;414;6759;9500;51132;8823;541578;2158;55609;2556;494119;6756;9502;158880;8517;8242;474383;57595;51442;389895;100132304;9754;80311;6102;27328;695;56159;51213;90737;60506;10943;100873985;57526;728269;170082;474382;102723680;728656;3358;8273;83844;114824;389840;170067;81557;80823;8862;2002;7216;79979;158763;23641;55217;8270;57477;7592;2833;425054;340526;727866;139599;139804;54470;8450;959;139562;645864;10075;117154;57631;2010;54521;79589;51634;3750;653282;728072;7076;392490;9363;8623;3920;347411;7454;100506164;265;90293;645051;100529097;55511;158724;6197;203547;139135;5355;347516;203522;139081;6451;27336;158787;728458;7499;4841;347517;51360;340578;139596;1896;441509;54466;660;158798;4108;171482;79868;728075;158833;79366;1821;56156;392465;1260;5160;56062;5303;3054;51260;139628;653220;340596;554;28986;23133;57393;2623;28227;4113;57692;50945;3730;7739;100131755;57481;8260;139170;64219;4204;389860;2574;3563;65991;10325;6170;10813;79710;8712;26280;2316;256714;10742;6173;9104;494197;29057;139324;442444;6103;54880;90736;55558;2742;1736;369;255313;3654;170627;645974;3897;79983;727940;541466;347527;8243;4007;139741;29978;2182;7504;60401;84707;53336;1485;159090;94056;57502;55285;653067;1046;11152;641339;1947;8852;7712;23708;203523;4267;54967;340542;89885;2277;83550;644353;55916;340595;6594;139189;63947;9643;9843;4935;139728;100288814;10479;50943;53940;55026;100507170;5638;4478;8239;4068;51114;139411;246100;9968;84679;115201;100533997;1741;416;64840;10682;11326;25763;27330;171483;8908;27286;1038;7543;158800;90060;1288;84061;215;6247;292;55879;401612;1183;340527;55344;29935;158983;357;10009;2747;2652;286514;340543;54885;100129407;10495;6792;79742;140886;2239;2334;4128;441518;139604;4303;55869;25878;4115;11040;8473;6855;84636;55922;728712;5956;2705;55841;54821;729396;441521;8933;10735;729442;9949;4694;84528;51481;492;3028;100129520;795;10389;83604;7411;9947;9367;100463488;10134;79057;54552;6906;340547;30014;415;5255;680;158809;6990;4435;5475;340529;65109;64860;7030;729428;8776;4675;5030;51566;729201;56271;4943;79917;85012;114928;5256;26609;54960;538;6853;5365;4354;286451;29934;10838;139221;9189;347404;6473;3251;286464;158931;139793;100008586;2717;3052;5973;139065;5199;546;5613;51270;139231;9131;7547;474381;257240;11254;27238;64102;2543;158747;2273;56474;5165;64648;54440;140597;5631;728239;3188;100130086;5251;8237;286527;100130302,815
-1,1,X,168546,155233731,155065185,23096;64061;392509;10214;170685;23157;727837;55998;23439;729431;10916;158586;55859;331;3423;54830;4168;6901;5358;92002;27344;729447;54328;266740;9075;102723737;7552;729422;54954;84460;389874;56000;340562;644538;92552;254158;79649;56850;8225;2824;100272147;51186;3149;26576;100130361;1730;347541;139425;3547;728695;729408;79921;57826;59272;203413;2986;7512;9737;8544;55634;2857;3421;537;11013;340554;5716;6658;4101;54457;1438;91966;441519;4100;5931;27316;7403;4534;6839;51480;728096;27112;92129;101928917;140462;8241;6567;827;203569;27301;84548;645037;54413;100133053;7355;254065;79836;10084;347442;60343;51765;55593;139818;56180;6303;8269;142684;7626;10046;8409;203447;63932;2710;4515;8406;51248;56001;51616;2925;100130613;2564;1193;100132994;5354;11043;340533;22;3476;84631;26748;11238;203562;102723631;170261;58526;441525;4983;29944;6907;1536;2539;1478;9468;23597;2187;1287;81887;6611;3561;9767;9282;54857;347365;10800;139341;54539;11219;728062;169966;51209;23630;26548;1121;2000;645188;51438;2846;280658;1852;347344;23229;10857;56157;286430;101059915;438;5277;9758;1069;4674;154796;56548;51309;1184;645073;80712;1774;10245;2258;728343;9823;441531;11141;643311;90121;256643;23676;4114;6758;4107;286499;5009;1654;1831;51284;94121;170302;11230;79135;286410;9210;2491;441490;84187;633;6191;64743;4110;3598;389856;7789;55787;9452;50814;2157;139422;170062;57187;139067;4104;203427;4693;5456;10013;1964;55190;100996648;293;9016;100528062;30011;90316;93953;10178;6322;28952;24137;2332;4105;6845;94122;84968;64663;1538;9142;286530;2245;5634;9506;79576;3266;139212;5207;6535;8227;393;389852;170626;91851;27334;158866;550643;159013;407;7224;55796;10761;100132963;168400;4281;158835;24140;8471;90167;7737;7319;10149;11279;6134;64109;1678;139322;5063;55906;116442;84443;27197;8233;548313;6872;27018;100129239;139105;7102;10549;26071;2664;59353;8573;28985;79184;728049;728090;158521;3581;139886;282808;8263;9130;728082;778;90843;1756;5422;7317;5935;347454;29071;207063;4112;412;158506;340602;30848;5127;22866;93380;159091;10159;212;139285;9338;85417;8266;100132399;158584;494118;190;7569;89801;2892;1968;5230;57232;55559;57529;8277;63035;80231;286436;25975;51311;8905;55086;139735;395;83692;171484;10251;169981;1349;63904;139716;257397;142689;80258;27035;1641;55613;7105;100329135;84295;9459;4810;404281;4109;367;474384;6748;139760;347487;92745;158830;53344;4103;9203;139378;186;474343;2719;3597;140456;9248;402415;203430;9185;90161;728042;4129;65267;56849;8228;8226;728036;7114;6399;4952;83740;84889;8481;6757;347468;347475;414;6759;9500;51132;8823;541578;2158;55609;2556;494119;6756;9502;158880;8517;8242;474383;57595;51442;389895;100132304;9754;80311;6102;27328;695;56159;51213;90737;60506;10943;100873985;57526;728269;170082;474382;102723680;728656;3358;8273;83844;114824;389840;170067;81557;80823;8862;2002;7216;79979;158763;23641;55217;8270;57477;7592;2833;425054;340526;727866;139599;139804;54470;8450;959;139562;645864;10075;117154;57631;2010;54521;79589;51634;3750;653282;728072;7076;392490;9363;8623;3920;347411;7454;100506164;265;90293;645051;100529097;55511;158724;6197;203547;139135;5355;347516;203522;139081;6451;27336;158787;728458;7499;4841;347517;51360;340578;139596;1896;441509;54466;660;158798;4108;171482;79868;728075;158833;79366;1821;56156;392465;1260;5160;56062;5303;3054;51260;139628;653220;340596;554;28986;23133;57393;2623;28227;4113;57692;50945;3730;7739;100131755;57481;8260;139170;64219;4204;389860;2574;3563;65991;10325;6170;10813;79710;8712;26280;2316;256714;10742;6173;9104;494197;29057;139324;442444;6103;54880;90736;55558;2742;1736;369;255313;3654;170627;645974;3897;79983;727940;541466;347527;8243;4007;139741;29978;2182;7504;60401;84707;53336;1485;159090;94056;57502;55285;653067;1046;11152;641339;1947;8852;7712;23708;203523;4267;54967;340542;89885;2277;83550;644353;55916;340595;6594;139189;63947;9643;9843;4935;139728;100288814;10479;50943;53940;55026;100507170;5638;4478;8239;4068;51114;139411;246100;9968;84679;115201;100533997;1741;416;64840;10682;11326;25763;27330;171483;8908;27286;1038;7543;158800;90060;1288;84061;215;6247;292;55879;401612;1183;340527;55344;29935;158983;357;10009;2747;2652;286514;340543;54885;100129407;10495;6792;79742;140886;2239;2334;4128;441518;139604;4303;55869;25878;4115;11040;8473;6855;84636;55922;728712;5956;2705;55841;54821;729396;441521;8933;10735;729442;9949;4694;84528;51481;492;3028;100129520;795;10389;83604;7411;9947;9367;100463488;10134;79057;54552;6906;340547;30014;415;5255;680;158809;6990;4435;5475;340529;65109;64860;7030;729428;8776;4675;5030;51566;729201;56271;4943;79917;85012;114928;5256;26609;54960;538;6853;5365;4354;286451;29934;10838;139221;9189;347404;6473;3251;286464;158931;139793;100008586;2717;3052;5973;139065;5199;546;5613;51270;139231;9131;7547;474381;257240;11254;27238;64102;2543;158747;2273;56474;5165;64648;54440;140597;5631;728239;3188;100130086;5251;8237;286527;100130302,815
-1,1,X,168546,155233731,155065185,23096;64061;392509;10214;170685;23157;727837;55998;23439;729431;10916;158586;55859;331;3423;54830;4168;6901;5358;92002;27344;729447;54328;266740;9075;102723737;7552;729422;54954;84460;389874;56000;340562;644538;92552;254158;79649;56850;8225;2824;100272147;51186;3149;26576;100130361;1730;347541;139425;3547;728695;729408;79921;57826;59272;203413;2986;7512;9737;8544;55634;2857;3421;537;11013;340554;5716;6658;4101;54457;1438;91966;441519;4100;5931;27316;7403;4534;6839;51480;728096;27112;92129;101928917;140462;8241;6567;827;203569;27301;84548;645037;54413;100133053;7355;254065;79836;10084;347442;60343;51765;55593;139818;56180;6303;8269;142684;7626;10046;8409;203447;63932;2710;4515;8406;51248;56001;51616;2925;100130613;2564;1193;100132994;5354;11043;340533;22;3476;84631;26748;11238;203562;102723631;170261;58526;441525;4983;29944;6907;1536;2539;1478;9468;23597;2187;1287;81887;6611;3561;9767;9282;54857;347365;10800;139341;54539;11219;728062;169966;51209;23630;26548;1121;2000;645188;51438;2846;280658;1852;347344;23229;10857;56157;286430;101059915;438;5277;9758;1069;4674;154796;56548;51309;1184;645073;80712;1774;10245;2258;728343;9823;441531;11141;643311;90121;256643;23676;4114;6758;4107;286499;5009;1654;1831;51284;94121;170302;11230;79135;286410;9210;2491;441490;84187;633;6191;64743;4110;3598;389856;7789;55787;9452;50814;2157;139422;170062;57187;139067;4104;203427;4693;5456;10013;1964;55190;100996648;293;9016;100528062;30011;90316;93953;10178;6322;28952;24137;2332;4105;6845;94122;84968;64663;1538;9142;286530;2245;5634;9506;79576;3266;139212;5207;6535;8227;393;389852;170626;91851;27334;158866;550643;159013;407;7224;55796;10761;100132963;168400;4281;158835;24140;8471;90167;7737;7319;10149;11279;6134;64109;1678;139322;5063;55906;116442;84443;27197;8233;548313;6872;27018;100129239;139105;7102;10549;26071;2664;59353;8573;28985;79184;728049;728090;158521;3581;139886;282808;8263;9130;728082;778;90843;1756;5422;7317;5935;347454;29071;207063;4112;412;158506;340602;30848;5127;22866;93380;159091;10159;212;139285;9338;85417;8266;100132399;158584;494118;190;7569;89801;2892;1968;5230;57232;55559;57529;8277;63035;80231;286436;25975;51311;8905;55086;139735;395;83692;171484;10251;169981;1349;63904;139716;257397;142689;80258;27035;1641;55613;7105;100329135;84295;9459;4810;404281;4109;367;474384;6748;139760;347487;92745;158830;53344;4103;9203;139378;186;474343;2719;3597;140456;9248;402415;203430;9185;90161;728042;4129;65267;56849;8228;8226;728036;7114;6399;4952;83740;84889;8481;6757;347468;347475;414;6759;9500;51132;8823;541578;2158;55609;2556;494119;6756;9502;158880;8517;8242;474383;57595;51442;389895;100132304;9754;80311;6102;27328;695;56159;51213;90737;60506;10943;100873985;57526;728269;170082;474382;102723680;728656;3358;8273;83844;114824;389840;170067;81557;80823;8862;2002;7216;79979;158763;23641;55217;8270;57477;7592;2833;425054;340526;727866;139599;139804;54470;8450;959;139562;645864;10075;117154;57631;2010;54521;79589;51634;3750;653282;728072;7076;392490;9363;8623;3920;347411;7454;100506164;265;90293;645051;100529097;55511;158724;6197;203547;139135;5355;347516;203522;139081;6451;27336;158787;728458;7499;4841;347517;51360;340578;139596;1896;441509;54466;660;158798;4108;171482;79868;728075;158833;79366;1821;56156;392465;1260;5160;56062;5303;3054;51260;139628;653220;340596;554;28986;23133;57393;2623;28227;4113;57692;50945;3730;7739;100131755;57481;8260;139170;64219;4204;389860;2574;3563;65991;10325;6170;10813;79710;8712;26280;2316;256714;10742;6173;9104;494197;29057;139324;442444;6103;54880;90736;55558;2742;1736;369;255313;3654;170627;645974;3897;79983;727940;541466;347527;8243;4007;139741;29978;2182;7504;60401;84707;53336;1485;159090;94056;57502;55285;653067;1046;11152;641339;1947;8852;7712;23708;203523;4267;54967;340542;89885;2277;83550;644353;55916;340595;6594;139189;63947;9643;9843;4935;139728;100288814;10479;50943;53940;55026;100507170;5638;4478;8239;4068;51114;139411;246100;9968;84679;115201;100533997;1741;416;64840;10682;11326;25763;27330;171483;8908;27286;1038;7543;158800;90060;1288;84061;215;6247;292;55879;401612;1183;340527;55344;29935;158983;357;10009;2747;2652;286514;340543;54885;100129407;10495;6792;79742;140886;2239;2334;4128;441518;139604;4303;55869;25878;4115;11040;8473;6855;84636;55922;728712;5956;2705;55841;54821;729396;441521;8933;10735;729442;9949;4694;84528;51481;492;3028;100129520;795;10389;83604;7411;9947;9367;100463488;10134;79057;54552;6906;340547;30014;415;5255;680;158809;6990;4435;5475;340529;65109;64860;7030;729428;8776;4675;5030;51566;729201;56271;4943;79917;85012;114928;5256;26609;54960;538;6853;5365;4354;286451;29934;10838;139221;9189;347404;6473;3251;286464;158931;139793;100008586;2717;3052;5973;139065;5199;546;5613;51270;139231;9131;7547;474381;257240;11254;27238;64102;2543;158747;2273;56474;5165;64648;54440;140597;5631;728239;3188;100130086;5251;8237;286527;100130302,815
-1,1,X,168546,155233731,155065185,23096;64061;392509;10214;170685;23157;727837;55998;23439;729431;10916;158586;55859;331;3423;54830;4168;6901;5358;92002;27344;729447;54328;266740;9075;102723737;7552;729422;54954;84460;389874;56000;340562;644538;92552;254158;79649;56850;8225;2824;100272147;51186;3149;26576;100130361;1730;347541;139425;3547;728695;729408;79921;57826;59272;203413;2986;7512;9737;8544;55634;2857;3421;537;11013;340554;5716;6658;4101;54457;1438;91966;441519;4100;5931;27316;7403;4534;6839;51480;728096;27112;92129;101928917;140462;8241;6567;827;203569;27301;84548;645037;54413;100133053;7355;254065;79836;10084;347442;60343;51765;55593;139818;56180;6303;8269;142684;7626;10046;8409;203447;63932;2710;4515;8406;51248;56001;51616;2925;100130613;2564;1193;100132994;5354;11043;340533;22;3476;84631;26748;11238;203562;102723631;170261;58526;441525;4983;29944;6907;1536;2539;1478;9468;23597;2187;1287;81887;6611;3561;9767;9282;54857;347365;10800;139341;54539;11219;728062;169966;51209;23630;26548;1121;2000;645188;51438;2846;280658;1852;347344;23229;10857;56157;286430;101059915;438;5277;9758;1069;4674;154796;56548;51309;1184;645073;80712;1774;10245;2258;728343;9823;441531;11141;643311;90121;256643;23676;4114;6758;4107;286499;5009;1654;1831;51284;94121;170302;11230;79135;286410;9210;2491;441490;84187;633;6191;64743;4110;3598;389856;7789;55787;9452;50814;2157;139422;170062;57187;139067;4104;203427;4693;5456;10013;1964;55190;100996648;293;9016;100528062;30011;90316;93953;10178;6322;28952;24137;2332;4105;6845;94122;84968;64663;1538;9142;286530;2245;5634;9506;79576;3266;139212;5207;6535;8227;393;389852;170626;91851;27334;158866;550643;159013;407;7224;55796;10761;100132963;168400;4281;158835;24140;8471;90167;7737;7319;10149;11279;6134;64109;1678;139322;5063;55906;116442;84443;27197;8233;548313;6872;27018;100129239;139105;7102;10549;26071;2664;59353;8573;28985;79184;728049;728090;158521;3581;139886;282808;8263;9130;728082;778;90843;1756;5422;7317;5935;347454;29071;207063;4112;412;158506;340602;30848;5127;22866;93380;159091;10159;212;139285;9338;85417;8266;100132399;158584;494118;190;7569;89801;2892;1968;5230;57232;55559;57529;8277;63035;80231;286436;25975;51311;8905;55086;139735;395;83692;171484;10251;169981;1349;63904;139716;257397;142689;80258;27035;1641;55613;7105;100329135;84295;9459;4810;404281;4109;367;474384;6748;139760;347487;92745;158830;53344;4103;9203;139378;186;474343;2719;3597;140456;9248;402415;203430;9185;90161;728042;4129;65267;56849;8228;8226;728036;7114;6399;4952;83740;84889;8481;6757;347468;347475;414;6759;9500;51132;8823;541578;2158;55609;2556;494119;6756;9502;158880;8517;8242;474383;57595;51442;389895;100132304;9754;80311;6102;27328;695;56159;51213;90737;60506;10943;100873985;57526;728269;170082;474382;102723680;728656;3358;8273;83844;114824;389840;170067;81557;80823;8862;2002;7216;79979;158763;23641;55217;8270;57477;7592;2833;425054;340526;727866;139599;139804;54470;8450;959;139562;645864;10075;117154;57631;2010;54521;79589;51634;3750;653282;728072;7076;392490;9363;8623;3920;347411;7454;100506164;265;90293;645051;100529097;55511;158724;6197;203547;139135;5355;347516;203522;139081;6451;27336;158787;728458;7499;4841;347517;51360;340578;139596;1896;441509;54466;660;158798;4108;171482;79868;728075;158833;79366;1821;56156;392465;1260;5160;56062;5303;3054;51260;139628;653220;340596;554;28986;23133;57393;2623;28227;4113;57692;50945;3730;7739;100131755;57481;8260;139170;64219;4204;389860;2574;3563;65991;10325;6170;10813;79710;8712;26280;2316;256714;10742;6173;9104;494197;29057;139324;442444;6103;54880;90736;55558;2742;1736;369;255313;3654;170627;645974;3897;79983;727940;541466;347527;8243;4007;139741;29978;2182;7504;60401;84707;53336;1485;159090;94056;57502;55285;653067;1046;11152;641339;1947;8852;7712;23708;203523;4267;54967;340542;89885;2277;83550;644353;55916;340595;6594;139189;63947;9643;9843;4935;139728;100288814;10479;50943;53940;55026;100507170;5638;4478;8239;4068;51114;139411;246100;9968;84679;115201;100533997;1741;416;64840;10682;11326;25763;27330;171483;8908;27286;1038;7543;158800;90060;1288;84061;215;6247;292;55879;401612;1183;340527;55344;29935;158983;357;10009;2747;2652;286514;340543;54885;100129407;10495;6792;79742;140886;2239;2334;4128;441518;139604;4303;55869;25878;4115;11040;8473;6855;84636;55922;728712;5956;2705;55841;54821;729396;441521;8933;10735;729442;9949;4694;84528;51481;492;3028;100129520;795;10389;83604;7411;9947;9367;100463488;10134;79057;54552;6906;340547;30014;415;5255;680;158809;6990;4435;5475;340529;65109;64860;7030;729428;8776;4675;5030;51566;729201;56271;4943;79917;85012;114928;5256;26609;54960;538;6853;5365;4354;286451;29934;10838;139221;9189;347404;6473;3251;286464;158931;139793;100008586;2717;3052;5973;139065;5199;546;5613;51270;139231;9131;7547;474381;257240;11254;27238;64102;2543;158747;2273;56474;5165;64648;54440;140597;5631;728239;3188;100130086;5251;8237;286527;100130302,815
1,1,X,168546,155233731,155065185,23096;64061;392509;10214;170685;23157;727837;55998;23439;729431;10916;158586;55859;331;3423;54830;4168;6901;5358;92002;27344;729447;54328;266740;9075;102723737;7552;729422;54954;84460;389874;56000;340562;644538;92552;254158;79649;56850;8225;2824;100272147;51186;3149;26576;100130361;1730;347541;139425;3547;728695;729408;79921;57826;59272;203413;2986;7512;9737;8544;55634;2857;3421;537;11013;340554;5716;6658;4101;54457;1438;91966;441519;4100;5931;27316;7403;4534;6839;51480;728096;27112;92129;101928917;140462;8241;6567;827;203569;27301;84548;645037;54413;100133053;7355;254065;79836;10084;347442;60343;51765;55593;139818;56180;6303;8269;142684;7626;10046;8409;203447;63932;2710;4515;8406;51248;56001;51616;2925;100130613;2564;1193;100132994;5354;11043;340533;22;3476;84631;26748;11238;203562;102723631;170261;58526;441525;4983;29944;6907;1536;2539;1478;9468;23597;2187;1287;81887;6611;3561;9767;9282;54857;347365;10800;139341;54539;11219;728062;169966;51209;23630;26548;1121;2000;645188;51438;2846;280658;1852;347344;23229;10857;56157;286430;101059915;438;5277;9758;1069;4674;154796;56548;51309;1184;645073;80712;1774;10245;2258;728343;9823;441531;11141;643311;90121;256643;23676;4114;6758;4107;286499;5009;1654;1831;51284;94121;170302;11230;79135;286410;9210;2491;441490;84187;633;6191;64743;4110;3598;389856;7789;55787;9452;50814;2157;139422;170062;57187;139067;4104;203427;4693;5456;10013;1964;55190;100996648;293;9016;100528062;30011;90316;93953;10178;6322;28952;24137;2332;4105;6845;94122;84968;64663;1538;9142;286530;2245;5634;9506;79576;3266;139212;5207;6535;8227;393;389852;170626;91851;27334;158866;550643;159013;407;7224;55796;10761;100132963;168400;4281;158835;24140;8471;90167;7737;7319;10149;11279;6134;64109;1678;139322;5063;55906;116442;84443;27197;8233;548313;6872;27018;100129239;139105;7102;10549;26071;2664;59353;8573;28985;79184;728049;728090;158521;3581;139886;282808;8263;9130;728082;778;90843;1756;5422;7317;5935;347454;29071;207063;4112;412;158506;340602;30848;5127;22866;93380;159091;10159;212;139285;9338;85417;8266;100132399;158584;494118;190;7569;89801;2892;1968;5230;57232;55559;57529;8277;63035;80231;286436;25975;51311;8905;55086;139735;395;83692;171484;10251;169981;1349;63904;139716;257397;142689;80258;27035;1641;55613;7105;100329135;84295;9459;4810;404281;4109;367;474384;6748;139760;347487;92745;158830;53344;4103;9203;139378;186;474343;2719;3597;140456;9248;402415;203430;9185;90161;728042;4129;65267;56849;8228;8226;728036;7114;6399;4952;83740;84889;8481;6757;347468;347475;414;6759;9500;51132;8823;541578;2158;55609;2556;494119;6756;9502;158880;8517;8242;474383;57595;51442;389895;100132304;9754;80311;6102;27328;695;56159;51213;90737;60506;10943;100873985;57526;728269;170082;474382;102723680;728656;3358;8273;83844;114824;389840;170067;81557;80823;8862;2002;7216;79979;158763;23641;55217;8270;57477;7592;2833;425054;340526;727866;139599;139804;54470;8450;959;139562;645864;10075;117154;57631;2010;54521;79589;51634;3750;653282;728072;7076;392490;9363;8623;3920;347411;7454;100506164;265;90293;645051;100529097;55511;158724;6197;203547;139135;5355;347516;203522;139081;6451;27336;158787;728458;7499;4841;347517;51360;340578;139596;1896;441509;54466;660;158798;4108;171482;79868;728075;158833;79366;1821;56156;392465;1260;5160;56062;5303;3054;51260;139628;653220;340596;554;28986;23133;57393;2623;28227;4113;57692;50945;3730;7739;100131755;57481;8260;139170;64219;4204;389860;2574;3563;65991;10325;6170;10813;79710;8712;26280;2316;256714;10742;6173;9104;494197;29057;139324;442444;6103;54880;90736;55558;2742;1736;369;255313;3654;170627;645974;3897;79983;727940;541466;347527;8243;4007;139741;29978;2182;7504;60401;84707;53336;1485;159090;94056;57502;55285;653067;1046;11152;641339;1947;8852;7712;23708;203523;4267;54967;340542;89885;2277;83550;644353;55916;340595;6594;139189;63947;9643;9843;4935;139728;100288814;10479;50943;53940;55026;100507170;5638;4478;8239;4068;51114;139411;246100;9968;84679;115201;100533997;1741;416;64840;10682;11326;25763;27330;171483;8908;27286;1038;7543;158800;90060;1288;84061;215;6247;292;55879;401612;1183;340527;55344;29935;158983;357;10009;2747;2652;286514;340543;54885;100129407;10495;6792;79742;140886;2239;2334;4128;441518;139604;4303;55869;25878;4115;11040;8473;6855;84636;55922;728712;5956;2705;55841;54821;729396;441521;8933;10735;729442;9949;4694;84528;51481;492;3028;100129520;795;10389;83604;7411;9947;9367;100463488;10134;79057;54552;6906;340547;30014;415;5255;680;158809;6990;4435;5475;340529;65109;64860;7030;729428;8776;4675;5030;51566;729201;56271;4943;79917;85012;114928;5256;26609;54960;538;6853;5365;4354;286451;29934;10838;139221;9189;347404;6473;3251;286464;158931;139793;100008586;2717;3052;5973;139065;5199;546;5613;51270;139231;9131;7547;474381;257240;11254;27238;64102;2543;158747;2273;56474;5165;64648;54440;140597;5631;728239;3188;100130086;5251;8237;286527;100130302,815
1,1,X,168546,155233731,155065185,23096;64061;392509;10214;170685;23157;727837;55998;23439;729431;10916;158586;55859;331;3423;54830;4168;6901;5358;92002;27344;729447;54328;266740;9075;102723737;7552;729422;54954;84460;389874;56000;340562;644538;92552;254158;79649;56850;8225;2824;100272147;51186;3149;26576;100130361;1730;347541;139425;3547;728695;729408;79921;57826;59272;203413;2986;7512;9737;8544;55634;2857;3421;537;11013;340554;5716;6658;4101;54457;1438;91966;441519;4100;5931;27316;7403;4534;6839;51480;728096;27112;92129;101928917;140462;8241;6567;827;203569;27301;84548;645037;54413;100133053;7355;254065;79836;10084;347442;60343;51765;55593;139818;56180;6303;8269;142684;7626;10046;8409;203447;63932;2710;4515;8406;51248;56001;51616;2925;100130613;2564;1193;100132994;5354;11043;340533;22;3476;84631;26748;11238;203562;102723631;170261;58526;441525;4983;29944;6907;1536;2539;1478;9468;23597;2187;1287;81887;6611;3561;9767;9282;54857;347365;10800;139341;54539;11219;728062;169966;51209;23630;26548;1121;2000;645188;51438;2846;280658;1852;347344;23229;10857;56157;286430;101059915;438;5277;9758;1069;4674;154796;56548;51309;1184;645073;80712;1774;10245;2258;728343;9823;441531;11141;643311;90121;256643;23676;4114;6758;4107;286499;5009;1654;1831;51284;94121;170302;11230;79135;286410;9210;2491;441490;84187;633;6191;64743;4110;3598;389856;7789;55787;9452;50814;2157;139422;170062;57187;139067;4104;203427;4693;5456;10013;1964;55190;100996648;293;9016;100528062;30011;90316;93953;10178;6322;28952;24137;2332;4105;6845;94122;84968;64663;1538;9142;286530;2245;5634;9506;79576;3266;139212;5207;6535;8227;393;389852;170626;91851;27334;158866;550643;159013;407;7224;55796;10761;100132963;168400;4281;158835;24140;8471;90167;7737;7319;10149;11279;6134;64109;1678;139322;5063;55906;116442;84443;27197;8233;548313;6872;27018;100129239;139105;7102;10549;26071;2664;59353;8573;28985;79184;728049;728090;158521;3581;139886;282808;8263;9130;728082;778;90843;1756;5422;7317;5935;347454;29071;207063;4112;412;158506;340602;30848;5127;22866;93380;159091;10159;212;139285;9338;85417;8266;100132399;158584;494118;190;7569;89801;2892;1968;5230;57232;55559;57529;8277;63035;80231;286436;25975;51311;8905;55086;139735;395;83692;171484;10251;169981;1349;63904;139716;257397;142689;80258;27035;1641;55613;7105;100329135;84295;9459;4810;404281;4109;367;474384;6748;139760;347487;92745;158830;53344;4103;9203;139378;186;474343;2719;3597;140456;9248;402415;203430;9185;90161;728042;4129;65267;56849;8228;8226;728036;7114;6399;4952;83740;84889;8481;6757;347468;347475;414;6759;9500;51132;8823;541578;2158;55609;2556;494119;6756;9502;158880;8517;8242;474383;57595;51442;389895;100132304;9754;80311;6102;27328;695;56159;51213;90737;60506;10943;100873985;57526;728269;170082;474382;102723680;728656;3358;8273;83844;114824;389840;170067;81557;80823;8862;2002;7216;79979;158763;23641;55217;8270;57477;7592;2833;425054;340526;727866;139599;139804;54470;8450;959;139562;645864;10075;117154;57631;2010;54521;79589;51634;3750;653282;728072;7076;392490;9363;8623;3920;347411;7454;100506164;265;90293;645051;100529097;55511;158724;6197;203547;139135;5355;347516;203522;139081;6451;27336;158787;728458;7499;4841;347517;51360;340578;139596;1896;441509;54466;660;158798;4108;171482;79868;728075;158833;79366;1821;56156;392465;1260;5160;56062;5303;3054;51260;139628;653220;340596;554;28986;23133;57393;2623;28227;4113;57692;50945;3730;7739;100131755;57481;8260;139170;64219;4204;389860;2574;3563;65991;10325;6170;10813;79710;8712;26280;2316;256714;10742;6173;9104;494197;29057;139324;442444;6103;54880;90736;55558;2742;1736;369;255313;3654;170627;645974;3897;79983;727940;541466;347527;8243;4007;139741;29978;2182;7504;60401;84707;53336;1485;159090;94056;57502;55285;653067;1046;11152;641339;1947;8852;7712;23708;203523;4267;54967;340542;89885;2277;83550;644353;55916;340595;6594;139189;63947;9643;9843;4935;139728;100288814;10479;50943;53940;55026;100507170;5638;4478;8239;4068;51114;139411;246100;9968;84679;115201;100533997;1741;416;64840;10682;11326;25763;27330;171483;8908;27286;1038;7543;158800;90060;1288;84061;215;6247;292;55879;401612;1183;340527;55344;29935;158983;357;10009;2747;2652;286514;340543;54885;100129407;10495;6792;79742;140886;2239;2334;4128;441518;139604;4303;55869;25878;4115;11040;8473;6855;84636;55922;728712;5956;2705;55841;54821;729396;441521;8933;10735;729442;9949;4694;84528;51481;492;3028;100129520;795;10389;83604;7411;9947;9367;100463488;10134;79057;54552;6906;340547;30014;415;5255;680;158809;6990;4435;5475;340529;65109;64860;7030;729428;8776;4675;5030;51566;729201;56271;4943;79917;85012;114928;5256;26609;54960;538;6853;5365;4354;286451;29934;10838;139221;9189;347404;6473;3251;286464;158931;139793;100008586;2717;3052;5973;139065;5199;546;5613;51270;139231;9131;7547;474381;257240;11254;27238;64102;2543;158747;2273;56474;5165;64648;54440;140597;5631;728239;3188;100130086;5251;8237;286527;100130302,815
1,1,X,168546,155233731,155065185,23096;64061;392509;10214;170685;23157;727837;55998;23439;729431;10916;158586;55859;331;3423;54830;4168;6901;5358;92002;27344;729447;54328;266740;9075;102723737;7552;729422;54954;84460;389874;56000;340562;644538;92552;254158;79649;56850;8225;2824;100272147;51186;3149;26576;100130361;1730;347541;139425;3547;728695;729408;79921;57826;59272;203413;2986;7512;9737;8544;55634;2857;3421;537;11013;340554;5716;6658;4101;54457;1438;91966;441519;4100;5931;27316;7403;4534;6839;51480;728096;27112;92129;101928917;140462;8241;6567;827;203569;27301;84548;645037;54413;100133053;7355;254065;79836;10084;347442;60343;51765;55593;139818;56180;6303;8269;142684;7626;10046;8409;203447;63932;2710;4515;8406;51248;56001;51616;2925;100130613;2564;1193;100132994;5354;11043;340533;22;3476;84631;26748;11238;203562;102723631;170261;58526;441525;4983;29944;6907;1536;2539;1478;9468;23597;2187;1287;81887;6611;3561;9767;9282;54857;347365;10800;139341;54539;11219;728062;169966;51209;23630;26548;1121;2000;645188;51438;2846;280658;1852;347344;23229;10857;56157;286430;101059915;438;5277;9758;1069;4674;154796;56548;51309;1184;645073;80712;1774;10245;2258;728343;9823;441531;11141;643311;90121;256643;23676;4114;6758;4107;286499;5009;1654;1831;51284;94121;170302;11230;79135;286410;9210;2491;441490;84187;633;6191;64743;4110;3598;389856;7789;55787;9452;50814;2157;139422;170062;57187;139067;4104;203427;4693;5456;10013;1964;55190;100996648;293;9016;100528062;30011;90316;93953;10178;6322;28952;24137;2332;4105;6845;94122;84968;64663;1538;9142;286530;2245;5634;9506;79576;3266;139212;5207;6535;8227;393;389852;170626;91851;27334;158866;550643;159013;407;7224;55796;10761;100132963;168400;4281;158835;24140;8471;90167;7737;7319;10149;11279;6134;64109;1678;139322;5063;55906;116442;84443;27197;8233;548313;6872;27018;100129239;139105;7102;10549;26071;2664;59353;8573;28985;79184;728049;728090;158521;3581;139886;282808;8263;9130;728082;778;90843;1756;5422;7317;5935;347454;29071;207063;4112;412;158506;340602;30848;5127;22866;93380;159091;10159;212;139285;9338;85417;8266;100132399;158584;494118;190;7569;89801;2892;1968;5230;57232;55559;57529;8277;63035;80231;286436;25975;51311;8905;55086;139735;395;83692;171484;10251;169981;1349;63904;139716;257397;142689;80258;27035;1641;55613;7105;100329135;84295;9459;4810;404281;4109;367;474384;6748;139760;347487;92745;158830;53344;4103;9203;139378;186;474343;2719;3597;140456;9248;402415;203430;9185;90161;728042;4129;65267;56849;8228;8226;728036;7114;6399;4952;83740;84889;8481;6757;347468;347475;414;6759;9500;51132;8823;541578;2158;55609;2556;494119;6756;9502;158880;8517;8242;474383;57595;51442;389895;100132304;9754;80311;6102;27328;695;56159;51213;90737;60506;10943;100873985;57526;728269;170082;474382;102723680;728656;3358;8273;83844;114824;389840;170067;81557;80823;8862;2002;7216;79979;158763;23641;55217;8270;57477;7592;2833;425054;340526;727866;139599;139804;54470;8450;959;139562;645864;10075;117154;57631;2010;54521;79589;51634;3750;653282;728072;7076;392490;9363;8623;3920;347411;7454;100506164;265;90293;645051;100529097;55511;158724;6197;203547;139135;5355;347516;203522;139081;6451;27336;158787;728458;7499;4841;347517;51360;340578;139596;1896;441509;54466;660;158798;4108;171482;79868;728075;158833;79366;1821;56156;392465;1260;5160;56062;5303;3054;51260;139628;653220;340596;554;28986;23133;57393;2623;28227;4113;57692;50945;3730;7739;100131755;57481;8260;139170;64219;4204;389860;2574;3563;65991;10325;6170;10813;79710;8712;26280;2316;256714;10742;6173;9104;494197;29057;139324;442444;6103;54880;90736;55558;2742;1736;369;255313;3654;170627;645974;3897;79983;727940;541466;347527;8243;4007;139741;29978;2182;7504;60401;84707;53336;1485;159090;94056;57502;55285;653067;1046;11152;641339;1947;8852;7712;23708;203523;4267;54967;340542;89885;2277;83550;644353;55916;340595;6594;139189;63947;9643;9843;4935;139728;100288814;10479;50943;53940;55026;100507170;5638;4478;8239;4068;51114;139411;246100;9968;84679;115201;100533997;1741;416;64840;10682;11326;25763;27330;171483;8908;27286;1038;7543;158800;90060;1288;84061;215;6247;292;55879;401612;1183;340527;55344;29935;158983;357;10009;2747;2652;286514;340543;54885;100129407;10495;6792;79742;140886;2239;2334;4128;441518;139604;4303;55869;25878;4115;11040;8473;6855;84636;55922;728712;5956;2705;55841;54821;729396;441521;8933;10735;729442;9949;4694;84528;51481;492;3028;100129520;795;10389;83604;7411;9947;9367;100463488;10134;79057;54552;6906;340547;30014;415;5255;680;158809;6990;4435;5475;340529;65109;64860;7030;729428;8776;4675;5030;51566;729201;56271;4943;79917;85012;114928;5256;26609;54960;538;6853;5365;4354;286451;29934;10838;139221;9189;347404;6473;3251;286464;158931;139793;100008586;2717;3052;5973;139065;5199;546;5613;51270;139231;9131;7547;474381;257240;11254;27238;64102;2543;158747;2273;56474;5165;64648;54440;140597;5631;728239;3188;100130086;5251;8237;286527;100130302,815
1,1,X,168546,155233731,155065185,23096;64061;392509;10214;170685;23157;727837;55998;23439;729431;10916;158586;55859;331;3423;54830;4168;6901;5358;92002;27344;729447;54328;266740;9075;102723737;7552;729422;54954;84460;389874;56000;340562;644538;92552;254158;79649;56850;8225;2824;100272147;51186;3149;26576;100130361;1730;347541;139425;3547;728695;729408;79921;57826;59272;203413;2986;7512;9737;8544;55634;2857;3421;537;11013;340554;5716;6658;4101;54457;1438;91966;441519;4100;5931;27316;7403;4534;6839;51480;728096;27112;92129;101928917;140462;8241;6567;827;203569;27301;84548;645037;54413;100133053;7355;254065;79836;10084;347442;60343;51765;55593;139818;56180;6303;8269;142684;7626;10046;8409;203447;63932;2710;4515;8406;51248;56001;51616;2925;100130613;2564;1193;100132994;5354;11043;340533;22;3476;84631;26748;11238;203562;102723631;170261;58526;441525;4983;29944;6907;1536;2539;1478;9468;23597;2187;1287;81887;6611;3561;9767;9282;54857;347365;10800;139341;54539;11219;728062;169966;51209;23630;26548;1121;2000;645188;51438;2846;280658;1852;347344;23229;10857;56157;286430;101059915;438;5277;9758;1069;4674;154796;56548;51309;1184;645073;80712;1774;10245;2258;728343;9823;441531;11141;643311;90121;256643;23676;4114;6758;4107;286499;5009;1654;1831;51284;94121;170302;11230;79135;286410;9210;2491;441490;84187;633;6191;64743;4110;3598;389856;7789;55787;9452;50814;2157;139422;170062;57187;139067;4104;203427;4693;5456;10013;1964;55190;100996648;293;9016;100528062;30011;90316;93953;10178;6322;28952;24137;2332;4105;6845;94122;84968;64663;1538;9142;286530;2245;5634;9506;79576;3266;139212;5207;6535;8227;393;389852;170626;91851;27334;158866;550643;159013;407;7224;55796;10761;100132963;168400;4281;158835;24140;8471;90167;7737;7319;10149;11279;6134;64109;1678;139322;5063;55906;116442;84443;27197;8233;548313;6872;27018;100129239;139105;7102;10549;26071;2664;59353;8573;28985;79184;728049;728090;158521;3581;139886;282808;8263;9130;728082;778;90843;1756;5422;7317;5935;347454;29071;207063;4112;412;158506;340602;30848;5127;22866;93380;159091;10159;212;139285;9338;85417;8266;100132399;158584;494118;190;7569;89801;2892;1968;5230;57232;55559;57529;8277;63035;80231;286436;25975;51311;8905;55086;139735;395;83692;171484;10251;169981;1349;63904;139716;257397;142689;80258;27035;1641;55613;7105;100329135;84295;9459;4810;404281;4109;367;474384;6748;139760;347487;92745;158830;53344;4103;9203;139378;186;474343;2719;3597;140456;9248;402415;203430;9185;90161;728042;4129;65267;56849;8228;8226;728036;7114;6399;4952;83740;84889;8481;6757;347468;347475;414;6759;9500;51132;8823;541578;2158;55609;2556;494119;6756;9502;158880;8517;8242;474383;57595;51442;389895;100132304;9754;80311;6102;27328;695;56159;51213;90737;60506;10943;100873985;57526;728269;170082;474382;102723680;728656;3358;8273;83844;114824;389840;170067;81557;80823;8862;2002;7216;79979;158763;23641;55217;8270;57477;7592;2833;425054;340526;727866;139599;139804;54470;8450;959;139562;645864;10075;117154;57631;2010;54521;79589;51634;3750;653282;728072;7076;392490;9363;8623;3920;347411;7454;100506164;265;90293;645051;100529097;55511;158724;6197;203547;139135;5355;347516;203522;139081;6451;27336;158787;728458;7499;4841;347517;51360;340578;139596;1896;441509;54466;660;158798;4108;171482;79868;728075;158833;79366;1821;56156;392465;1260;5160;56062;5303;3054;51260;139628;653220;340596;554;28986;23133;57393;2623;28227;4113;57692;50945;3730;7739;100131755;57481;8260;139170;64219;4204;389860;2574;3563;65991;10325;6170;10813;79710;8712;26280;2316;256714;10742;6173;9104;494197;29057;139324;442444;6103;54880;90736;55558;2742;1736;369;255313;3654;170627;645974;3897;79983;727940;541466;347527;8243;4007;139741;29978;2182;7504;60401;84707;53336;1485;159090;94056;57502;55285;653067;1046;11152;641339;1947;8852;7712;23708;203523;4267;54967;340542;89885;2277;83550;644353;55916;340595;6594;139189;63947;9643;9843;4935;139728;100288814;10479;50943;53940;55026;100507170;5638;4478;8239;4068;51114;139411;246100;9968;84679;115201;100533997;1741;416;64840;10682;11326;25763;27330;171483;8908;27286;1038;7543;158800;90060;1288;84061;215;6247;292;55879;401612;1183;340527;55344;29935;158983;357;10009;2747;2652;286514;340543;54885;100129407;10495;6792;79742;140886;2239;2334;4128;441518;139604;4303;55869;25878;4115;11040;8473;6855;84636;55922;728712;5956;2705;55841;54821;729396;441521;8933;10735;729442;9949;4694;84528;51481;492;3028;100129520;795;10389;83604;7411;9947;9367;100463488;10134;79057;54552;6906;340547;30014;415;5255;680;158809;6990;4435;5475;340529;65109;64860;7030;729428;8776;4675;5030;51566;729201;56271;4943;79917;85012;114928;5256;26609;54960;538;6853;5365;4354;286451;29934;10838;139221;9189;347404;6473;3251;286464;158931;139793;100008586;2717;3052;5973;139065;5199;546;5613;51270;139231;9131;7547;474381;257240;11254;27238;64102;2543;158747;2273;56474;5165;64648;54440;140597;5631;728239;3188;100130086;5251;8237;286527;100130302,815
-1,1,X,168546,155233731,155065185,23096;64061;392509;10214;170685;23157;727837;55998;23439;729431;10916;158586;55859;331;3423;54830;4168;6901;5358;92002;27344;729447;54328;266740;9075;102723737;7552;729422;54954;84460;389874;56000;340562;644538;92552;254158;79649;56850;8225;2824;100272147;51186;3149;26576;100130361;1730;347541;139425;3547;728695;729408;79921;57826;59272;203413;2986;7512;9737;8544;55634;2857;3421;537;11013;340554;5716;6658;4101;54457;1438;91966;441519;4100;5931;27316;7403;4534;6839;51480;728096;27112;92129;101928917;140462;8241;6567;827;203569;27301;84548;645037;54413;100133053;7355;254065;79836;10084;347442;60343;51765;55593;139818;56180;6303;8269;142684;7626;10046;8409;203447;63932;2710;4515;8406;51248;56001;51616;2925;100130613;2564;1193;100132994;5354;11043;340533;22;3476;84631;26748;11238;203562;102723631;170261;58526;441525;4983;29944;6907;1536;2539;1478;9468;23597;2187;1287;81887;6611;3561;9767;9282;54857;347365;10800;139341;54539;11219;728062;169966;51209;23630;26548;1121;2000;645188;51438;2846;280658;1852;347344;23229;10857;56157;286430;101059915;438;5277;9758;1069;4674;154796;56548;51309;1184;645073;80712;1774;10245;2258;728343;9823;441531;11141;643311;90121;256643;23676;4114;6758;4107;286499;5009;1654;1831;51284;94121;170302;11230;79135;286410;9210;2491;441490;84187;633;6191;64743;4110;3598;389856;7789;55787;9452;50814;2157;139422;170062;57187;139067;4104;203427;4693;5456;10013;1964;55190;100996648;293;9016;100528062;30011;90316;93953;10178;6322;28952;24137;2332;4105;6845;94122;84968;64663;1538;9142;286530;2245;5634;9506;79576;3266;139212;5207;6535;8227;393;389852;170626;91851;27334;158866;550643;159013;407;7224;55796;10761;100132963;168400;4281;158835;24140;8471;90167;7737;7319;10149;11279;6134;64109;1678;139322;5063;55906;116442;84443;27197;8233;548313;6872;27018;100129239;139105;7102;10549;26071;2664;59353;8573;28985;79184;728049;728090;158521;3581;139886;282808;8263;9130;728082;778;90843;1756;5422;7317;5935;347454;29071;207063;4112;412;158506;340602;30848;5127;22866;93380;159091;10159;212;139285;9338;85417;8266;100132399;158584;494118;190;7569;89801;2892;1968;5230;57232;55559;57529;8277;63035;80231;286436;25975;51311;8905;55086;139735;395;83692;171484;10251;169981;1349;63904;139716;257397;142689;80258;27035;1641;55613;7105;100329135;84295;9459;4810;404281;4109;367;474384;6748;139760;347487;92745;158830;53344;4103;9203;139378;186;474343;2719;3597;140456;9248;402415;203430;9185;90161;728042;4129;65267;56849;8228;8226;728036;7114;6399;4952;83740;84889;8481;6757;347468;347475;414;6759;9500;51132;8823;541578;2158;55609;2556;494119;6756;9502;158880;8517;8242;474383;57595;51442;389895;100132304;9754;80311;6102;27328;695;56159;51213;90737;60506;10943;100873985;57526;728269;170082;474382;102723680;728656;3358;8273;83844;114824;389840;170067;81557;80823;8862;2002;7216;79979;158763;23641;55217;8270;57477;7592;2833;425054;340526;727866;139599;139804;54470;8450;959;139562;645864;10075;117154;57631;2010;54521;79589;51634;3750;653282;728072;7076;392490;9363;8623;3920;347411;7454;100506164;265;90293;645051;100529097;55511;158724;6197;203547;139135;5355;347516;203522;139081;6451;27336;158787;728458;7499;4841;347517;51360;340578;139596;1896;441509;54466;660;158798;4108;171482;79868;728075;158833;79366;1821;56156;392465;1260;5160;56062;5303;3054;51260;139628;653220;340596;554;28986;23133;57393;2623;28227;4113;57692;50945;3730;7739;100131755;57481;8260;139170;64219;4204;389860;2574;3563;65991;10325;6170;10813;79710;8712;26280;2316;256714;10742;6173;9104;494197;29057;139324;442444;6103;54880;90736;55558;2742;1736;369;255313;3654;170627;645974;3897;79983;727940;541466;347527;8243;4007;139741;29978;2182;7504;60401;84707;53336;1485;159090;94056;57502;55285;653067;1046;11152;641339;1947;8852;7712;23708;203523;4267;54967;340542;89885;2277;83550;644353;55916;340595;6594;139189;63947;9643;9843;4935;139728;100288814;10479;50943;53940;55026;100507170;5638;4478;8239;4068;51114;139411;246100;9968;84679;115201;100533997;1741;416;64840;10682;11326;25763;27330;171483;8908;27286;1038;7543;158800;90060;1288;84061;215;6247;292;55879;401612;1183;340527;55344;29935;158983;357;10009;2747;2652;286514;340543;54885;100129407;10495;6792;79742;140886;2239;2334;4128;441518;139604;4303;55869;25878;4115;11040;8473;6855;84636;55922;728712;5956;2705;55841;54821;729396;441521;8933;10735;729442;9949;4694;84528;51481;492;3028;100129520;795;10389;83604;7411;9947;9367;100463488;10134;79057;54552;6906;340547;30014;415;5255;680;158809;6990;4435;5475;340529;65109;64860;7030;729428;8776;4675;5030;51566;729201;56271;4943;79917;85012;114928;5256;26609;54960;538;6853;5365;4354;286451;29934;10838;139221;9189;347404;6473;3251;286464;158931;139793;100008586;2717;3052;5973;139065;5199;546;5613;51270;139231;9131;7547;474381;257240;11254;27238;64102;2543;158747;2273;56474;5165;64648;54440;140597;5631;728239;3188;100130086;5251;8237;286527;100130302,815
-1,1,X,168546,155233731,155065185,23096;64061;392509;10214;170685;23157;727837;55998;23439;729431;10916;158586;55859;331;3423;54830;4168;6901;5358;92002;27344;729447;54328;266740;9075;102723737;7552;729422;54954;84460;389874;56000;340562;644538;92552;254158;79649;56850;8225;2824;100272147;51186;3149;26576;100130361;1730;347541;139425;3547;728695;729408;79921;57826;59272;203413;2986;7512;9737;8544;55634;2857;3421;537;11013;340554;5716;6658;4101;54457;1438;91966;441519;4100;5931;27316;7403;4534;6839;51480;728096;27112;92129;101928917;140462;8241;6567;827;203569;27301;84548;645037;54413;100133053;7355;254065;79836;10084;347442;60343;51765;55593;139818;56180;6303;8269;142684;7626;10046;8409;203447;63932;2710;4515;8406;51248;56001;51616;2925;100130613;2564;1193;100132994;5354;11043;340533;22;3476;84631;26748;11238;203562;102723631;170261;58526;441525;4983;29944;6907;1536;2539;1478;9468;23597;2187;1287;81887;6611;3561;9767;9282;54857;347365;10800;139341;54539;11219;728062;169966;51209;23630;26548;1121;2000;645188;51438;2846;280658;1852;347344;23229;10857;56157;286430;101059915;438;5277;9758;1069;4674;154796;56548;51309;1184;645073;80712;1774;10245;2258;728343;9823;441531;11141;643311;90121;256643;23676;4114;6758;4107;286499;5009;1654;1831;51284;94121;170302;11230;79135;286410;9210;2491;441490;84187;633;6191;64743;4110;3598;389856;7789;55787;9452;50814;2157;139422;170062;57187;139067;4104;203427;4693;5456;10013;1964;55190;100996648;293;9016;100528062;30011;90316;93953;10178;6322;28952;24137;2332;4105;6845;94122;84968;64663;1538;9142;286530;2245;5634;9506;79576;3266;139212;5207;6535;8227;393;389852;170626;91851;27334;158866;550643;159013;407;7224;55796;10761;100132963;168400;4281;158835;24140;8471;90167;7737;7319;10149;11279;6134;64109;1678;139322;5063;55906;116442;84443;27197;8233;548313;6872;27018;100129239;139105;7102;10549;26071;2664;59353;8573;28985;79184;728049;728090;158521;3581;139886;282808;8263;9130;728082;778;90843;1756;5422;7317;5935;347454;29071;207063;4112;412;158506;340602;30848;5127;22866;93380;159091;10159;212;139285;9338;85417;8266;100132399;158584;494118;190;7569;89801;2892;1968;5230;57232;55559;57529;8277;63035;80231;286436;25975;51311;8905;55086;139735;395;83692;171484;10251;169981;1349;63904;139716;257397;142689;80258;27035;1641;55613;7105;100329135;84295;9459;4810;404281;4109;367;474384;6748;139760;347487;92745;158830;53344;4103;9203;139378;186;474343;2719;3597;140456;9248;402415;203430;9185;90161;728042;4129;65267;56849;8228;8226;728036;7114;6399;4952;83740;84889;8481;6757;347468;347475;414;6759;9500;51132;8823;541578;2158;55609;2556;494119;6756;9502;158880;8517;8242;474383;57595;51442;389895;100132304;9754;80311;6102;27328;695;56159;51213;90737;60506;10943;100873985;57526;728269;170082;474382;102723680;728656;3358;8273;83844;114824;389840;170067;81557;80823;8862;2002;7216;79979;158763;23641;55217;8270;57477;7592;2833;425054;340526;727866;139599;139804;54470;8450;959;139562;645864;10075;117154;57631;2010;54521;79589;51634;3750;653282;728072;7076;392490;9363;8623;3920;347411;7454;100506164;265;90293;645051;100529097;55511;158724;6197;203547;139135;5355;347516;203522;139081;6451;27336;158787;728458;7499;4841;347517;51360;340578;139596;1896;441509;54466;660;158798;4108;171482;79868;728075;158833;79366;1821;56156;392465;1260;5160;56062;5303;3054;51260;139628;653220;340596;554;28986;23133;57393;2623;28227;4113;57692;50945;3730;7739;100131755;57481;8260;139170;64219;4204;389860;2574;3563;65991;10325;6170;10813;79710;8712;26280;2316;256714;10742;6173;9104;494197;29057;139324;442444;6103;54880;90736;55558;2742;1736;369;255313;3654;170627;645974;3897;79983;727940;541466;347527;8243;4007;139741;29978;2182;7504;60401;84707;53336;1485;159090;94056;57502;55285;653067;1046;11152;641339;1947;8852;7712;23708;203523;4267;54967;340542;89885;2277;83550;644353;55916;340595;6594;139189;63947;9643;9843;4935;139728;100288814;10479;50943;53940;55026;100507170;5638;4478;8239;4068;51114;139411;246100;9968;84679;115201;100533997;1741;416;64840;10682;11326;25763;27330;171483;8908;27286;1038;7543;158800;90060;1288;84061;215;6247;292;55879;401612;1183;340527;55344;29935;158983;357;10009;2747;2652;286514;340543;54885;100129407;10495;6792;79742;140886;2239;2334;4128;441518;139604;4303;55869;25878;4115;11040;8473;6855;84636;55922;728712;5956;2705;55841;54821;729396;441521;8933;10735;729442;9949;4694;84528;51481;492;3028;100129520;795;10389;83604;7411;9947;9367;100463488;10134;79057;54552;6906;340547;30014;415;5255;680;158809;6990;4435;5475;340529;65109;64860;7030;729428;8776;4675;5030;51566;729201;56271;4943;79917;85012;114928;5256;26609;54960;538;6853;5365;4354;286451;29934;10838;139221;9189;347404;6473;3251;286464;158931;139793;100008586;2717;3052;5973;139065;5199;546;5613;51270;139231;9131;7547;474381;257240;11254;27238;64102;2543;158747;2273;56474;5165;64648;54440;140597;5631;728239;3188;100130086;5251;8237;286527;100130302,815
-1,1,X,168546,155233731,155065185,23096;64061;392509;10214;170685;23157;727837;55998;23439;729431;10916;158586;55859;331;3423;54830;4168;6901;5358;92002;27344;729447;54328;266740;9075;102723737;7552;729422;54954;84460;389874;56000;340562;644538;92552;254158;79649;56850;8225;2824;100272147;51186;3149;26576;100130361;1730;347541;139425;3547;728695;729408;79921;57826;59272;203413;2986;7512;9737;8544;55634;2857;3421;537;11013;340554;5716;6658;4101;54457;1438;91966;441519;4100;5931;27316;7403;4534;6839;51480;728096;27112;92129;101928917;140462;8241;6567;827;203569;27301;84548;645037;54413;100133053;7355;254065;79836;10084;347442;60343;51765;55593;139818;56180;6303;8269;142684;7626;10046;8409;203447;63932;2710;4515;8406;51248;56001;51616;2925;100130613;2564;1193;100132994;5354;11043;340533;22;3476;84631;26748;11238;203562;102723631;170261;58526;441525;4983;29944;6907;1536;2539;1478;9468;23597;2187;1287;81887;6611;3561;9767;9282;54857;347365;10800;139341;54539;11219;728062;169966;51209;23630;26548;1121;2000;645188;51438;2846;280658;1852;347344;23229;10857;56157;286430;101059915;438;5277;9758;1069;4674;154796;56548;51309;1184;645073;80712;1774;10245;2258;728343;9823;441531;11141;643311;90121;256643;23676;4114;6758;4107;286499;5009;1654;1831;51284;94121;170302;11230;79135;286410;9210;2491;441490;84187;633;6191;64743;4110;3598;389856;7789;55787;9452;50814;2157;139422;170062;57187;139067;4104;203427;4693;5456;10013;1964;55190;100996648;293;9016;100528062;30011;90316;93953;10178;6322;28952;24137;2332;4105;6845;94122;84968;64663;1538;9142;286530;2245;5634;9506;79576;3266;139212;5207;6535;8227;393;389852;170626;91851;27334;158866;550643;159013;407;7224;55796;10761;100132963;168400;4281;158835;24140;8471;90167;7737;7319;10149;11279;6134;64109;1678;139322;5063;55906;116442;84443;27197;8233;548313;6872;27018;100129239;139105;7102;10549;26071;2664;59353;8573;28985;79184;728049;728090;158521;3581;139886;282808;8263;9130;728082;778;90843;1756;5422;7317;5935;347454;29071;207063;4112;412;158506;340602;30848;5127;22866;93380;159091;10159;212;139285;9338;85417;8266;100132399;158584;494118;190;7569;89801;2892;1968;5230;57232;55559;57529;8277;63035;80231;286436;25975;51311;8905;55086;139735;395;83692;171484;10251;169981;1349;63904;139716;257397;142689;80258;27035;1641;55613;7105;100329135;84295;9459;4810;404281;4109;367;474384;6748;139760;347487;92745;158830;53344;4103;9203;139378;186;474343;2719;3597;140456;9248;402415;203430;9185;90161;728042;4129;65267;56849;8228;8226;728036;7114;6399;4952;83740;84889;8481;6757;347468;347475;414;6759;9500;51132;8823;541578;2158;55609;2556;494119;6756;9502;158880;8517;8242;474383;57595;51442;389895;100132304;9754;80311;6102;27328;695;56159;51213;90737;60506;10943;100873985;57526;728269;170082;474382;102723680;728656;3358;8273;83844;114824;389840;170067;81557;80823;8862;2002;7216;79979;158763;23641;55217;8270;57477;7592;2833;425054;340526;727866;139599;139804;54470;8450;959;139562;645864;10075;117154;57631;2010;54521;79589;51634;3750;653282;728072;7076;392490;9363;8623;3920;347411;7454;100506164;265;90293;645051;100529097;55511;158724;6197;203547;139135;5355;347516;203522;139081;6451;27336;158787;728458;7499;4841;347517;51360;340578;139596;1896;441509;54466;660;158798;4108;171482;79868;728075;158833;79366;1821;56156;392465;1260;5160;56062;5303;3054;51260;139628;653220;340596;554;28986;23133;57393;2623;28227;4113;57692;50945;3730;7739;100131755;57481;8260;139170;64219;4204;389860;2574;3563;65991;10325;6170;10813;79710;8712;26280;2316;256714;10742;6173;9104;494197;29057;139324;442444;6103;54880;90736;55558;2742;1736;369;255313;3654;170627;645974;3897;79983;727940;541466;347527;8243;4007;139741;29978;2182;7504;60401;84707;53336;1485;159090;94056;57502;55285;653067;1046;11152;641339;1947;8852;7712;23708;203523;4267;54967;340542;89885;2277;83550;644353;55916;340595;6594;139189;63947;9643;9843;4935;139728;100288814;10479;50943;53940;55026;100507170;5638;4478;8239;4068;51114;139411;246100;9968;84679;115201;100533997;1741;416;64840;10682;11326;25763;27330;171483;8908;27286;1038;7543;158800;90060;1288;84061;215;6247;292;55879;401612;1183;340527;55344;29935;158983;357;10009;2747;2652;286514;340543;54885;100129407;10495;6792;79742;140886;2239;2334;4128;441518;139604;4303;55869;25878;4115;11040;8473;6855;84636;55922;728712;5956;2705;55841;54821;729396;441521;8933;10735;729442;9949;4694;84528;51481;492;3028;100129520;795;10389;83604;7411;9947;9367;100463488;10134;79057;54552;6906;340547;30014;415;5255;680;158809;6990;4435;5475;340529;65109;64860;7030;729428;8776;4675;5030;51566;729201;56271;4943;79917;85012;114928;5256;26609;54960;538;6853;5365;4354;286451;29934;10838;139221;9189;347404;6473;3251;286464;158931;139793;100008586;2717;3052;5973;139065;5199;546;5613;51270;139231;9131;7547;474381;257240;11254;27238;64102;2543;158747;2273;56474;5165;64648;54440;140597;5631;728239;3188;100130086;5251;8237;286527;100130302,815
1,1,X,168546,155233731,155065185,23096;64061;392509;10214;170685;23157;727837;55998;23439;729431;10916;158586;55859;331;3423;54830;4168;6901;5358;92002;27344;729447;54328;266740;9075;102723737;7552;729422;54954;84460;389874;56000;340562;644538;92552;254158;79649;56850;8225;2824;100272147;51186;3149;26576;100130361;1730;347541;139425;3547;728695;729408;79921;57826;59272;203413;2986;7512;9737;8544;55634;2857;3421;537;11013;340554;5716;6658;4101;54457;1438;91966;441519;4100;5931;27316;7403;4534;6839;51480;728096;27112;92129;101928917;140462;8241;6567;827;203569;27301;84548;645037;54413;100133053;7355;254065;79836;10084;347442;60343;51765;55593;139818;56180;6303;8269;142684;7626;10046;8409;203447;63932;2710;4515;8406;51248;56001;51616;2925;100130613;2564;1193;100132994;5354;11043;340533;22;3476;84631;26748;11238;203562;102723631;170261;58526;441525;4983;29944;6907;1536;2539;1478;9468;23597;2187;1287;81887;6611;3561;9767;9282;54857;347365;10800;139341;54539;11219;728062;169966;51209;23630;26548;1121;2000;645188;51438;2846;280658;1852;347344;23229;10857;56157;286430;101059915;438;5277;9758;1069;4674;154796;56548;51309;1184;645073;80712;1774;10245;2258;728343;9823;441531;11141;643311;90121;256643;23676;4114;6758;4107;286499;5009;1654;1831;51284;94121;170302;11230;79135;286410;9210;2491;441490;84187;633;6191;64743;4110;3598;389856;7789;55787;9452;50814;2157;139422;170062;57187;139067;4104;203427;4693;5456;10013;1964;55190;100996648;293;9016;100528062;30011;90316;93953;10178;6322;28952;24137;2332;4105;6845;94122;84968;64663;1538;9142;286530;2245;5634;9506;79576;3266;139212;5207;6535;8227;393;389852;170626;91851;27334;158866;550643;159013;407;7224;55796;10761;100132963;168400;4281;158835;24140;8471;90167;7737;7319;10149;11279;6134;64109;1678;139322;5063;55906;116442;84443;27197;8233;548313;6872;27018;100129239;139105;7102;10549;26071;2664;59353;8573;28985;79184;728049;728090;158521;3581;139886;282808;8263;9130;728082;778;90843;1756;5422;7317;5935;347454;29071;207063;4112;412;158506;340602;30848;5127;22866;93380;159091;10159;212;139285;9338;85417;8266;100132399;158584;494118;190;7569;89801;2892;1968;5230;57232;55559;57529;8277;63035;80231;286436;25975;51311;8905;55086;139735;395;83692;171484;10251;169981;1349;63904;139716;257397;142689;80258;27035;1641;55613;7105;100329135;84295;9459;4810;404281;4109;367;474384;6748;139760;347487;92745;158830;53344;4103;9203;139378;186;474343;2719;3597;140456;9248;402415;203430;9185;90161;728042;4129;65267;56849;8228;8226;728036;7114;6399;4952;83740;84889;8481;6757;347468;347475;414;6759;9500;51132;8823;541578;2158;55609;2556;494119;6756;9502;158880;8517;8242;474383;57595;51442;389895;100132304;9754;80311;6102;27328;695;56159;51213;90737;60506;10943;100873985;57526;728269;170082;474382;102723680;728656;3358;8273;83844;114824;389840;170067;81557;80823;8862;2002;7216;79979;158763;23641;55217;8270;57477;7592;2833;425054;340526;727866;139599;139804;54470;8450;959;139562;645864;10075;117154;57631;2010;54521;79589;51634;3750;653282;728072;7076;392490;9363;8623;3920;347411;7454;100506164;265;90293;645051;100529097;55511;158724;6197;203547;139135;5355;347516;203522;139081;6451;27336;158787;728458;7499;4841;347517;51360;340578;139596;1896;441509;54466;660;158798;4108;171482;79868;728075;158833;79366;1821;56156;392465;1260;5160;56062;5303;3054;51260;139628;653220;340596;554;28986;23133;57393;2623;28227;4113;57692;50945;3730;7739;100131755;57481;8260;139170;64219;4204;389860;2574;3563;65991;10325;6170;10813;79710;8712;26280;2316;256714;10742;6173;9104;494197;29057;139324;442444;6103;54880;90736;55558;2742;1736;369;255313;3654;170627;645974;3897;79983;727940;541466;347527;8243;4007;139741;29978;2182;7504;60401;84707;53336;1485;159090;94056;57502;55285;653067;1046;11152;641339;1947;8852;7712;23708;203523;4267;54967;340542;89885;2277;83550;644353;55916;340595;6594;139189;63947;9643;9843;4935;139728;100288814;10479;50943;53940;55026;100507170;5638;4478;8239;4068;51114;139411;246100;9968;84679;115201;100533997;1741;416;64840;10682;11326;25763;27330;171483;8908;27286;1038;7543;158800;90060;1288;84061;215;6247;292;55879;401612;1183;340527;55344;29935;158983;357;10009;2747;2652;286514;340543;54885;100129407;10495;6792;79742;140886;2239;2334;4128;441518;139604;4303;55869;25878;4115;11040;8473;6855;84636;55922;728712;5956;2705;55841;54821;729396;441521;8933;10735;729442;9949;4694;84528;51481;492;3028;100129520;795;10389;83604;7411;9947;9367;100463488;10134;79057;54552;6906;340547;30014;415;5255;680;158809;6990;4435;5475;340529;65109;64860;7030;729428;8776;4675;5030;51566;729201;56271;4943;79917;85012;114928;5256;26609;54960;538;6853;5365;4354;286451;29934;10838;139221;9189;347404;6473;3251;286464;158931;139793;100008586;2717;3052;5973;139065;5199;546;5613;51270;139231;9131;7547;474381;257240;11254;27238;64102;2543;158747;2273;56474;5165;64648;54440;140597;5631;728239;3188;100130086;5251;8237;286527;100130302,815
1,1,X,168546,155233731,155065185,23096;64061;392509;10214;170685;23157;727837;55998;23439;729431;10916;158586;55859;331;3423;54830;4168;6901;5358;92002;27344;729447;54328;266740;9075;102723737;7552;729422;54954;84460;389874;56000;340562;644538;92552;254158;79649;56850;8225;2824;100272147;51186;3149;26576;100130361;1730;347541;139425;3547;728695;729408;79921;57826;59272;203413;2986;7512;9737;8544;55634;2857;3421;537;11013;340554;5716;6658;4101;54457;1438;91966;441519;4100;5931;27316;7403;4534;6839;51480;728096;27112;92129;101928917;140462;8241;6567;827;203569;27301;84548;645037;54413;100133053;7355;254065;79836;10084;347442;60343;51765;55593;139818;56180;6303;8269;142684;7626;10046;8409;203447;63932;2710;4515;8406;51248;56001;51616;2925;100130613;2564;1193;100132994;5354;11043;340533;22;3476;84631;26748;11238;203562;102723631;170261;58526;441525;4983;29944;6907;1536;2539;1478;9468;23597;2187;1287;81887;6611;3561;9767;9282;54857;347365;10800;139341;54539;11219;728062;169966;51209;23630;26548;1121;2000;645188;51438;2846;280658;1852;347344;23229;10857;56157;286430;101059915;438;5277;9758;1069;4674;154796;56548;51309;1184;645073;80712;1774;10245;2258;728343;9823;441531;11141;643311;90121;256643;23676;4114;6758;4107;286499;5009;1654;1831;51284;94121;170302;11230;79135;286410;9210;2491;441490;84187;633;6191;64743;4110;3598;389856;7789;55787;9452;50814;2157;139422;170062;57187;139067;4104;203427;4693;5456;10013;1964;55190;100996648;293;9016;100528062;30011;90316;93953;10178;6322;28952;24137;2332;4105;6845;94122;84968;64663;1538;9142;286530;2245;5634;9506;79576;3266;139212;5207;6535;8227;393;389852;170626;91851;27334;158866;550643;159013;407;7224;55796;10761;100132963;168400;4281;158835;24140;8471;90167;7737;7319;10149;11279;6134;64109;1678;139322;5063;55906;116442;84443;27197;8233;548313;6872;27018;100129239;139105;7102;10549;26071;2664;59353;8573;28985;79184;728049;728090;158521;3581;139886;282808;8263;9130;728082;778;90843;1756;5422;7317;5935;347454;29071;207063;4112;412;158506;340602;30848;5127;22866;93380;159091;10159;212;139285;9338;85417;8266;100132399;158584;494118;190;7569;89801;2892;1968;5230;57232;55559;57529;8277;63035;80231;286436;25975;51311;8905;55086;139735;395;83692;171484;10251;169981;1349;63904;139716;257397;142689;80258;27035;1641;55613;7105;100329135;84295;9459;4810;404281;4109;367;474384;6748;139760;347487;92745;158830;53344;4103;9203;139378;186;474343;2719;3597;140456;9248;402415;203430;9185;90161;728042;4129;65267;56849;8228;8226;728036;7114;6399;4952;83740;84889;8481;6757;347468;347475;414;6759;9500;51132;8823;541578;2158;55609;2556;494119;6756;9502;158880;8517;8242;474383;57595;51442;389895;100132304;9754;80311;6102;27328;695;56159;51213;90737;60506;10943;100873985;57526;728269;170082;474382;102723680;728656;3358;8273;83844;114824;389840;170067;81557;80823;8862;2002;7216;79979;158763;23641;55217;8270;57477;7592;2833;425054;340526;727866;139599;139804;54470;8450;959;139562;645864;10075;117154;57631;2010;54521;79589;51634;3750;653282;728072;7076;392490;9363;8623;3920;347411;7454;100506164;265;90293;645051;100529097;55511;158724;6197;203547;139135;5355;347516;203522;139081;6451;27336;158787;728458;7499;4841;347517;51360;340578;139596;1896;441509;54466;660;158798;4108;171482;79868;728075;158833;79366;1821;56156;392465;1260;5160;56062;5303;3054;51260;139628;653220;340596;554;28986;23133;57393;2623;28227;4113;57692;50945;3730;7739;100131755;57481;8260;139170;64219;4204;389860;2574;3563;65991;10325;6170;10813;79710;8712;26280;2316;256714;10742;6173;9104;494197;29057;139324;442444;6103;54880;90736;55558;2742;1736;369;255313;3654;170627;645974;3897;79983;727940;541466;347527;8243;4007;139741;29978;2182;7504;60401;84707;53336;1485;159090;94056;57502;55285;653067;1046;11152;641339;1947;8852;7712;23708;203523;4267;54967;340542;89885;2277;83550;644353;55916;340595;6594;139189;63947;9643;9843;4935;139728;100288814;10479;50943;53940;55026;100507170;5638;4478;8239;4068;51114;139411;246100;9968;84679;115201;100533997;1741;416;64840;10682;11326;25763;27330;171483;8908;27286;1038;7543;158800;90060;1288;84061;215;6247;292;55879;401612;1183;340527;55344;29935;158983;357;10009;2747;2652;286514;340543;54885;100129407;10495;6792;79742;140886;2239;2334;4128;441518;139604;4303;55869;25878;4115;11040;8473;6855;84636;55922;728712;5956;2705;55841;54821;729396;441521;8933;10735;729442;9949;4694;84528;51481;492;3028;100129520;795;10389;83604;7411;9947;9367;100463488;10134;79057;54552;6906;340547;30014;415;5255;680;158809;6990;4435;5475;340529;65109;64860;7030;729428;8776;4675;5030;51566;729201;56271;4943;79917;85012;114928;5256;26609;54960;538;6853;5365;4354;286451;29934;10838;139221;9189;347404;6473;3251;286464;158931;139793;100008586;2717;3052;5973;139065;5199;546;5613;51270;139231;9131;7547;474381;257240;11254;27238;64102;2543;158747;2273;56474;5165;64648;54440;140597;5631;728239;3188;100130086;5251;8237;286527;100130302,815
-1,1,X,168546,155233731,155065185,23096;64061;392509;10214;170685;23157;727837;55998;23439;729431;10916;158586;55859;331;3423;54830;4168;6901;5358;92002;27344;729447;54328;266740;9075;102723737;7552;729422;54954;84460;389874;56000;340562;644538;92552;254158;79649;56850;8225;2824;100272147;51186;3149;26576;100130361;1730;347541;139425;3547;728695;729408;79921;57826;59272;203413;2986;7512;9737;8544;55634;2857;3421;537;11013;340554;5716;6658;4101;54457;1438;91966;441519;4100;5931;27316;7403;4534;6839;51480;728096;27112;92129;101928917;140462;8241;6567;827;203569;27301;84548;645037;54413;100133053;7355;254065;79836;10084;347442;60343;51765;55593;139818;56180;6303;8269;142684;7626;10046;8409;203447;63932;2710;4515;8406;51248;56001;51616;2925;100130613;2564;1193;100132994;5354;11043;340533;22;3476;84631;26748;11238;203562;102723631;170261;58526;441525;4983;29944;6907;1536;2539;1478;9468;23597;2187;1287;81887;6611;3561;9767;9282;54857;347365;10800;139341;54539;11219;728062;169966;51209;23630;26548;1121;2000;645188;51438;2846;280658;1852;347344;23229;10857;56157;286430;101059915;438;5277;9758;1069;4674;154796;56548;51309;1184;645073;80712;1774;10245;2258;728343;9823;441531;11141;643311;90121;256643;23676;4114;6758;4107;286499;5009;1654;1831;51284;94121;170302;11230;79135;286410;9210;2491;441490;84187;633;6191;64743;4110;3598;389856;7789;55787;9452;50814;2157;139422;170062;57187;139067;4104;203427;4693;5456;10013;1964;55190;100996648;293;9016;100528062;30011;90316;93953;10178;6322;28952;24137;2332;4105;6845;94122;84968;64663;1538;9142;286530;2245;5634;9506;79576;3266;139212;5207;6535;8227;393;389852;170626;91851;27334;158866;550643;159013;407;7224;55796;10761;100132963;168400;4281;158835;24140;8471;90167;7737;7319;10149;11279;6134;64109;1678;139322;5063;55906;116442;84443;27197;8233;548313;6872;27018;100129239;139105;7102;10549;26071;2664;59353;8573;28985;79184;728049;728090;158521;3581;139886;282808;8263;9130;728082;778;90843;1756;5422;7317;5935;347454;29071;207063;4112;412;158506;340602;30848;5127;22866;93380;159091;10159;212;139285;9338;85417;8266;100132399;158584;494118;190;7569;89801;2892;1968;5230;57232;55559;57529;8277;63035;80231;286436;25975;51311;8905;55086;139735;395;83692;171484;10251;169981;1349;63904;139716;257397;142689;80258;27035;1641;55613;7105;100329135;84295;9459;4810;404281;4109;367;474384;6748;139760;347487;92745;158830;53344;4103;9203;139378;186;474343;2719;3597;140456;9248;402415;203430;9185;90161;728042;4129;65267;56849;8228;8226;728036;7114;6399;4952;83740;84889;8481;6757;347468;347475;414;6759;9500;51132;8823;541578;2158;55609;2556;494119;6756;9502;158880;8517;8242;474383;57595;51442;389895;100132304;9754;80311;6102;27328;695;56159;51213;90737;60506;10943;100873985;57526;728269;170082;474382;102723680;728656;3358;8273;83844;114824;389840;170067;81557;80823;8862;2002;7216;79979;158763;23641;55217;8270;57477;7592;2833;425054;340526;727866;139599;139804;54470;8450;959;139562;645864;10075;117154;57631;2010;54521;79589;51634;3750;653282;728072;7076;392490;9363;8623;3920;347411;7454;100506164;265;90293;645051;100529097;55511;158724;6197;203547;139135;5355;347516;203522;139081;6451;27336;158787;728458;7499;4841;347517;51360;340578;139596;1896;441509;54466;660;158798;4108;171482;79868;728075;158833;79366;1821;56156;392465;1260;5160;56062;5303;3054;51260;139628;653220;340596;554;28986;23133;57393;2623;28227;4113;57692;50945;3730;7739;100131755;57481;8260;139170;64219;4204;389860;2574;3563;65991;10325;6170;10813;79710;8712;26280;2316;256714;10742;6173;9104;494197;29057;139324;442444;6103;54880;90736;55558;2742;1736;369;255313;3654;170627;645974;3897;79983;727940;541466;347527;8243;4007;139741;29978;2182;7504;60401;84707;53336;1485;159090;94056;57502;55285;653067;1046;11152;641339;1947;8852;7712;23708;203523;4267;54967;340542;89885;2277;83550;644353;55916;340595;6594;139189;63947;9643;9843;4935;139728;100288814;10479;50943;53940;55026;100507170;5638;4478;8239;4068;51114;139411;246100;9968;84679;115201;100533997;1741;416;64840;10682;11326;25763;27330;171483;8908;27286;1038;7543;158800;90060;1288;84061;215;6247;292;55879;401612;1183;340527;55344;29935;158983;357;10009;2747;2652;286514;340543;54885;100129407;10495;6792;79742;140886;2239;2334;4128;441518;139604;4303;55869;25878;4115;11040;8473;6855;84636;55922;728712;5956;2705;55841;54821;729396;441521;8933;10735;729442;9949;4694;84528;51481;492;3028;100129520;795;10389;83604;7411;9947;9367;100463488;10134;79057;54552;6906;340547;30014;415;5255;680;158809;6990;4435;5475;340529;65109;64860;7030;729428;8776;4675;5030;51566;729201;56271;4943;79917;85012;114928;5256;26609;54960;538;6853;5365;4354;286451;29934;10838;139221;9189;347404;6473;3251;286464;158931;139793;100008586;2717;3052;5973;139065;5199;546;5613;51270;139231;9131;7547;474381;257240;11254;27238;64102;2543;158747;2273;56474;5165;64648;54440;140597;5631;728239;3188;100130086;5251;8237;286527;100130302,815
-1,1,X,168547,3880686,3712139,414;28227;286530;8225;1438;3563;5613;25878;347527;415;416;207063;4267;293;7499;9189;438;64109;6473;8227;55344;8623;8908,23
-1,1,X,168547,51386559,51218012,414;6759;10214;170685;729431;6756;27344;729447;729422;80311;6102;92552;254158;60506;56850;8225;10943;2824;100873985;170082;347541;139425;729408;59272;389840;170067;2002;8544;55634;2857;7592;57477;425054;1438;645864;5931;7403;6839;51480;3750;7076;140462;8241;8623;347411;7454;265;645037;645051;158724;7355;6197;10084;347442;5355;55593;6303;7499;8409;51360;2710;8406;660;2925;171482;392465;5160;26748;11238;58526;57393;2623;6907;28227;4113;1536;3730;9468;23597;2187;6611;3563;2574;9767;9282;8712;139341;54539;256714;10742;9104;442444;6103;54880;2742;369;347344;347527;4007;438;7504;5277;9758;56548;1184;645073;94056;10245;57502;11141;11152;641339;256643;23676;4114;6758;8852;7712;5009;1654;4267;51284;2277;170302;79135;11230;9210;441490;64743;389856;55787;139189;139422;170062;4935;4693;100288814;10013;1964;55190;293;50943;53940;30011;6322;5638;28952;8239;94122;139411;286530;5634;84679;9506;416;64840;10682;3266;25763;8227;389852;171483;8908;159013;7543;90060;168400;4281;24140;6247;10149;64109;1183;55344;27197;357;8233;286514;548313;6792;79742;4128;139105;139604;7102;10549;25878;4115;11040;6855;8573;55841;729396;729442;51481;795;10389;83604;1756;778;5422;9367;7317;5935;415;207063;4112;412;158506;340602;158809;6990;5127;22866;5475;10159;85417;100132399;7030;729428;190;7569;729201;89801;1968;57232;4943;79917;5256;26609;54960;6853;80231;25975;51311;8905;9189;395;347404;6473;171484;286464;63904;257397;80258;100008586;3052;4810;404281;5199;92745;5613;140456;257240;9185;27238;4129;2543;8228;158747;8226;56474;5165;7114;6399;5251;8481;8237;100130302,269
-1,1,X,168547,65665687,65497140,23096;414;64061;6759;9500;10214;170685;727837;729431;10916;158586;6756;9502;158880;8242;27344;729447;54328;729422;80311;6102;54954;90737;92552;254158;60506;56850;8225;2824;10943;100873985;170082;347541;139425;729408;59272;389840;170067;81557;2002;7216;8544;55634;2857;57477;7592;340554;425054;727866;1438;645864;5931;10075;7403;6839;51480;3750;7076;140462;8241;8623;347411;203569;7454;27301;265;645037;645051;7355;158724;6197;10084;347442;5355;55593;158787;6303;7499;8409;51360;2710;54466;8406;660;2925;171482;392465;5160;26748;11238;139628;653220;58526;28986;23133;57393;2623;6907;28227;4113;1536;9468;3730;23597;2187;81887;389860;6611;2574;3563;9767;10325;9282;347365;8712;139341;54539;256714;10742;9104;494197;29057;442444;6103;54880;90736;2742;369;280658;170627;347344;23229;347527;8243;4007;286430;29978;438;7504;5277;9758;56548;1184;645073;10245;94056;57502;11141;653067;11152;90121;641339;256643;23676;4114;6758;8852;7712;23708;5009;1654;4267;51284;170302;11230;79135;2277;9210;441490;64743;389856;7789;55787;139189;139422;170062;9843;4935;4693;10013;100288814;1964;55190;293;50943;53940;30011;6322;28952;5638;4478;8239;94122;139411;286530;2245;5634;84679;9506;416;3266;64840;10682;11326;5207;25763;8227;389852;170626;171483;8908;550643;159013;7543;90060;168400;4281;24140;6247;10149;11279;64109;1183;55906;55344;27197;357;8233;286514;548313;6792;79742;4128;139105;7102;139604;10549;25878;4115;11040;6855;8573;55841;729396;729442;139886;51481;3028;778;795;10389;1756;83604;5422;7317;5935;9367;100463488;54552;415;207063;4112;412;158506;340602;158809;5127;6990;22866;5475;10159;212;139285;85417;100132399;158584;7030;729428;190;7569;89801;729201;1968;57232;4943;79917;5256;26609;54960;6853;80231;25975;51311;8905;9189;395;347404;171484;6473;286464;169981;63904;257397;142689;80258;139793;55613;100008586;3052;4810;404281;5199;92745;5613;474343;140456;257240;9185;27238;4129;2543;65267;8228;158747;8226;56474;5165;7114;6399;728239;5251;8481;8237;6757;100130302,335
-1,1,X,168547,112474026,112305479,23096;64061;392509;10214;170685;727837;55998;729431;10916;158586;55859;54830;27344;729447;54328;9075;7552;729422;54954;84460;389874;56000;340562;92552;254158;56850;8225;2824;51186;100130361;1730;347541;139425;729408;79921;59272;2986;9737;8544;55634;2857;11013;340554;5716;54457;1438;5931;7403;6839;51480;27112;92129;140462;8241;6567;827;203569;27301;645037;54413;7355;254065;10084;347442;55593;6303;142684;8409;203447;2710;8406;51248;56001;51616;2925;100132994;5354;11043;340533;22;3476;26748;11238;203562;58526;4983;6907;1536;1478;9468;23597;2187;1287;81887;6611;3561;9767;9282;54857;347365;10800;139341;54539;169966;51209;23630;26548;1121;2846;280658;347344;23229;56157;286430;101059915;438;5277;9758;4674;154796;56548;51309;1184;645073;80712;10245;728343;9823;441531;11141;90121;256643;23676;4114;6758;286499;5009;1654;1831;51284;94121;170302;11230;79135;9210;2491;441490;84187;6191;64743;389856;7789;55787;9452;139422;170062;4693;5456;10013;1964;55190;100996648;293;100528062;30011;90316;93953;6322;28952;24137;94122;1538;286530;2245;5634;9506;3266;139212;5207;8227;389852;170626;91851;27334;158866;550643;159013;407;7224;168400;4281;158835;24140;8471;10149;11279;64109;1678;139322;5063;55906;84443;27197;8233;548313;6872;27018;139105;7102;10549;59353;8573;139886;282808;778;90843;1756;5422;7317;5935;207063;4112;412;158506;340602;5127;22866;10159;212;139285;9338;85417;100132399;158584;190;7569;89801;1968;5230;57232;57529;80231;286436;25975;51311;8905;55086;395;171484;169981;1349;63904;257397;142689;80258;27035;1641;55613;7105;100329135;4810;404281;367;92745;158830;53344;9203;474343;140456;402415;203430;9185;4129;65267;56849;8228;8226;7114;6399;84889;8481;6757;414;6759;9500;51132;8823;6756;9502;158880;8242;100132304;9754;80311;6102;27328;695;56159;90737;60506;10943;100873985;57526;170082;728656;389840;170067;81557;80823;2002;7216;79979;57477;7592;2833;425054;340526;727866;139599;54470;139562;645864;10075;117154;79589;3750;7076;392490;8623;347411;7454;265;645051;100529097;158724;6197;5355;347516;6451;158787;7499;4841;347517;51360;139596;1896;441509;54466;660;171482;79868;158833;79366;1821;56156;392465;5160;56062;5303;51260;139628;653220;340596;28986;23133;57393;2623;28227;4113;57692;50945;3730;100131755;64219;389860;2574;3563;10325;79710;8712;26280;256714;10742;6173;9104;494197;29057;139324;442444;6103;54880;90736;2742;369;170627;645974;79983;347527;8243;4007;29978;2182;7504;60401;84707;53336;94056;57502;55285;653067;1046;11152;641339;1947;8852;7712;23708;4267;340542;2277;644353;55916;340595;139189;63947;9643;9843;4935;100288814;50943;53940;5638;4478;8239;139411;9968;84679;115201;1741;416;64840;10682;11326;25763;27330;171483;8908;27286;7543;90060;1288;84061;6247;401612;1183;340527;55344;29935;158983;357;286514;340543;54885;100129407;6792;79742;140886;4128;139604;4303;55869;25878;4115;11040;8473;6855;84636;2705;55841;54821;729396;729442;9949;51481;3028;795;10389;83604;9367;100463488;54552;6906;340547;415;5255;158809;6990;4435;5475;340529;64860;7030;729428;4675;5030;51566;729201;56271;4943;79917;85012;114928;5256;26609;54960;538;6853;286451;29934;139221;9189;347404;6473;286464;158931;139793;100008586;2717;3052;5199;546;5613;139231;257240;27238;64102;2543;158747;56474;5165;140597;5631;728239;3188;5251;8237;286527;100130302,548
-1,1,X,168547,151304063,151135516,23096;64061;392509;10214;170685;23157;727837;55998;23439;729431;10916;158586;55859;331;3423;54830;4168;5358;27344;729447;54328;9075;102723737;7552;729422;54954;84460;389874;56000;340562;644538;92552;254158;79649;56850;8225;2824;51186;3149;100130361;1730;347541;139425;3547;728695;729408;79921;57826;59272;203413;2986;7512;9737;8544;55634;2857;11013;340554;5716;6658;54457;1438;91966;441519;5931;27316;7403;4534;6839;51480;728096;27112;92129;101928917;140462;8241;6567;827;203569;27301;84548;645037;54413;100133053;7355;254065;79836;10084;347442;51765;55593;139818;56180;6303;142684;7626;10046;8409;203447;63932;2710;8406;51248;56001;51616;2925;100130613;2564;100132994;5354;11043;340533;22;3476;84631;26748;11238;203562;102723631;170261;58526;441525;4983;6907;1536;1478;9468;23597;2187;1287;81887;6611;3561;9767;9282;54857;347365;10800;139341;54539;728062;169966;51209;23630;26548;1121;2000;645188;51438;2846;280658;347344;23229;10857;56157;286430;101059915;438;5277;9758;4674;154796;56548;51309;1184;645073;80712;10245;2258;728343;9823;441531;11141;643311;90121;256643;23676;4114;6758;4107;286499;5009;1654;1831;51284;94121;170302;11230;79135;286410;9210;2491;441490;84187;6191;64743;4110;3598;389856;7789;55787;9452;139422;170062;57187;139067;4104;203427;4693;5456;10013;1964;55190;100996648;293;9016;100528062;30011;90316;93953;10178;6322;28952;24137;2332;94122;64663;1538;9142;286530;2245;5634;9506;79576;3266;139212;5207;8227;389852;170626;91851;27334;158866;550643;159013;407;7224;55796;10761;168400;4281;158835;24140;8471;90167;7737;7319;10149;11279;64109;1678;139322;5063;55906;84443;27197;8233;548313;6872;27018;100129239;139105;7102;10549;26071;59353;8573;28985;728049;728090;158521;139886;282808;728082;778;90843;1756;5422;7317;5935;347454;29071;207063;4112;412;158506;340602;5127;22866;93380;159091;10159;212;139285;9338;85417;100132399;158584;494118;190;7569;89801;2892;1968;5230;57232;57529;63035;80231;286436;25975;51311;8905;55086;395;83692;171484;169981;1349;63904;257397;142689;80258;27035;1641;55613;7105;100329135;84295;9459;4810;404281;4109;367;139760;347487;92745;158830;53344;4103;9203;139378;186;474343;2719;3597;140456;9248;402415;203430;9185;90161;728042;4129;65267;56849;8228;8226;728036;7114;6399;4952;84889;8481;6757;347468;347475;414;6759;9500;51132;8823;541578;2158;55609;494119;6756;9502;158880;8242;51442;389895;100132304;9754;80311;6102;27328;695;56159;51213;90737;60506;10943;100873985;57526;728269;170082;102723680;728656;3358;83844;389840;170067;81557;80823;8862;2002;7216;79979;158763;23641;57477;7592;2833;425054;340526;727866;139599;139804;54470;8450;959;139562;645864;10075;117154;57631;54521;79589;51634;3750;653282;728072;7076;392490;9363;8623;3920;347411;7454;100506164;265;90293;645051;100529097;55511;158724;6197;203547;139135;5355;347516;203522;139081;6451;27336;158787;7499;4841;347517;51360;340578;139596;1896;441509;54466;660;158798;4108;171482;79868;728075;158833;79366;1821;56156;392465;1260;5160;56062;5303;51260;139628;653220;340596;28986;23133;57393;2623;28227;4113;57692;50945;3730;100131755;57481;139170;64219;389860;2574;3563;10325;6170;10813;79710;8712;26280;256714;10742;6173;9104;494197;29057;139324;442444;6103;54880;90736;2742;369;255313;170627;645974;79983;727940;541466;347527;8243;4007;139741;29978;2182;7504;60401;84707;53336;159090;94056;57502;55285;653067;1046;11152;641339;1947;8852;7712;23708;203523;4267;54967;340542;89885;2277;83550;644353;55916;340595;6594;139189;63947;9643;9843;4935;100288814;10479;50943;53940;55026;100507170;5638;4478;8239;4068;51114;139411;9968;84679;115201;100533997;1741;416;64840;10682;11326;25763;27330;171483;8908;27286;1038;7543;158800;90060;1288;84061;6247;292;401612;1183;340527;55344;29935;158983;357;10009;2747;286514;340543;54885;100129407;10495;6792;79742;140886;2239;2334;4128;441518;139604;4303;55869;25878;4115;11040;8473;6855;84636;55922;728712;2705;55841;54821;729396;441521;8933;10735;729442;9949;4694;84528;51481;3028;100129520;795;10389;83604;9947;9367;100463488;79057;54552;6906;340547;30014;415;5255;680;158809;6990;4435;5475;340529;65109;64860;7030;729428;8776;4675;5030;51566;729201;56271;4943;79917;85012;114928;5256;26609;54960;538;6853;286451;29934;139221;9189;347404;6473;3251;286464;158931;139793;100008586;2717;3052;139065;5199;546;5613;51270;139231;9131;7547;257240;11254;27238;64102;2543;158747;2273;56474;5165;64648;54440;140597;5631;728239;3188;100130086;5251;8237;286527;100130302,733
-1,1,X,168547,155233731,155065184,23096;64061;392509;10214;170685;23157;727837;55998;23439;729431;10916;158586;55859;331;3423;54830;4168;6901;5358;92002;27344;729447;54328;266740;9075;102723737;7552;729422;54954;84460;389874;56000;340562;644538;92552;254158;79649;56850;8225;2824;100272147;51186;3149;26576;100130361;1730;347541;139425;3547;728695;729408;79921;57826;59272;203413;2986;7512;9737;8544;55634;2857;3421;537;11013;340554;5716;6658;4101;54457;1438;91966;441519;4100;5931;27316;7403;4534;6839;51480;728096;27112;92129;101928917;140462;8241;6567;827;203569;27301;84548;645037;54413;100133053;7355;254065;79836;10084;347442;60343;51765;55593;139818;56180;6303;8269;142684;7626;10046;8409;203447;63932;2710;4515;8406;51248;56001;51616;2925;100130613;2564;1193;100132994;5354;11043;340533;22;3476;84631;26748;11238;203562;102723631;170261;58526;441525;4983;29944;6907;1536;2539;1478;9468;23597;2187;1287;81887;6611;3561;9767;9282;54857;347365;10800;139341;54539;11219;728062;169966;51209;23630;26548;1121;2000;645188;51438;2846;280658;1852;347344;23229;10857;56157;286430;101059915;438;5277;9758;1069;4674;154796;56548;51309;1184;645073;80712;1774;10245;2258;728343;9823;441531;11141;643311;90121;256643;23676;4114;6758;4107;286499;5009;1654;1831;51284;94121;170302;11230;79135;286410;9210;2491;441490;84187;633;6191;64743;4110;3598;389856;7789;55787;9452;50814;2157;139422;170062;57187;139067;4104;203427;4693;5456;10013;1964;55190;100996648;293;9016;100528062;30011;90316;93953;10178;6322;28952;24137;2332;4105;6845;94122;84968;64663;1538;9142;286530;2245;5634;9506;79576;3266;139212;5207;6535;8227;393;389852;170626;91851;27334;158866;550643;159013;407;7224;55796;10761;100132963;168400;4281;158835;24140;8471;90167;7737;7319;10149;11279;6134;64109;1678;139322;5063;55906;116442;84443;27197;8233;548313;6872;27018;100129239;139105;7102;10549;26071;2664;59353;8573;28985;79184;728049;728090;158521;3581;139886;282808;8263;9130;728082;778;90843;1756;5422;7317;5935;347454;29071;207063;4112;412;158506;340602;30848;5127;22866;93380;159091;10159;212;139285;9338;85417;8266;100132399;158584;494118;190;7569;89801;2892;1968;5230;57232;55559;57529;8277;63035;80231;286436;25975;51311;8905;55086;139735;395;83692;171484;10251;169981;1349;63904;139716;257397;142689;80258;27035;1641;55613;7105;100329135;84295;9459;4810;404281;4109;367;474384;6748;139760;347487;92745;158830;53344;4103;9203;139378;186;474343;2719;3597;140456;9248;402415;203430;9185;90161;728042;4129;65267;56849;8228;8226;728036;7114;6399;4952;83740;84889;8481;6757;347468;347475;414;6759;9500;51132;8823;541578;2158;55609;2556;494119;6756;9502;158880;8517;8242;474383;57595;51442;389895;100132304;9754;80311;6102;27328;695;56159;51213;90737;60506;10943;100873985;57526;728269;170082;474382;102723680;728656;3358;8273;83844;114824;389840;170067;81557;80823;8862;2002;7216;79979;158763;23641;55217;8270;57477;7592;2833;425054;340526;727866;139599;139804;54470;8450;959;139562;645864;10075;117154;57631;2010;54521;79589;51634;3750;653282;728072;7076;392490;9363;8623;3920;347411;7454;100506164;265;90293;645051;100529097;55511;158724;6197;203547;139135;5355;347516;203522;139081;6451;27336;158787;728458;7499;4841;347517;51360;340578;139596;1896;441509;54466;660;158798;4108;171482;79868;728075;158833;79366;1821;56156;392465;1260;5160;56062;5303;3054;51260;139628;653220;340596;554;28986;23133;57393;2623;28227;4113;57692;50945;3730;7739;100131755;57481;8260;139170;64219;4204;389860;2574;3563;65991;10325;6170;10813;79710;8712;26280;2316;256714;10742;6173;9104;494197;29057;139324;442444;6103;54880;90736;55558;2742;1736;369;255313;3654;170627;645974;3897;79983;727940;541466;347527;8243;4007;139741;29978;2182;7504;60401;84707;53336;1485;159090;94056;57502;55285;653067;1046;11152;641339;1947;8852;7712;23708;203523;4267;54967;340542;89885;2277;83550;644353;55916;340595;6594;139189;63947;9643;9843;4935;139728;100288814;10479;50943;53940;55026;100507170;5638;4478;8239;4068;51114;139411;246100;9968;84679;115201;100533997;1741;416;64840;10682;11326;25763;27330;171483;8908;27286;1038;7543;158800;90060;1288;84061;215;6247;292;55879;401612;1183;340527;55344;29935;158983;357;10009;2747;2652;286514;340543;54885;100129407;10495;6792;79742;140886;2239;2334;4128;441518;139604;4303;55869;25878;4115;11040;8473;6855;84636;55922;728712;5956;2705;55841;54821;729396;441521;8933;10735;729442;9949;4694;84528;51481;492;3028;100129520;795;10389;83604;7411;9947;9367;100463488;10134;79057;54552;6906;340547;30014;415;5255;680;158809;6990;4435;5475;340529;65109;64860;7030;729428;8776;4675;5030;51566;729201;56271;4943;79917;85012;114928;5256;26609;54960;538;6853;5365;4354;286451;29934;10838;139221;9189;347404;6473;3251;286464;158931;139793;100008586;2717;3052;5973;139065;5199;546;5613;51270;139231;9131;7547;474381;257240;11254;27238;64102;2543;158747;2273;56474;5165;64648;54440;140597;5631;728239;3188;100130086;5251;8237;286527;100130302,815
1,1,X,168547,155233731,155065184,23096;64061;392509;10214;170685;23157;727837;55998;23439;729431;10916;158586;55859;331;3423;54830;4168;6901;5358;92002;27344;729447;54328;266740;9075;102723737;7552;729422;54954;84460;389874;56000;340562;644538;92552;254158;79649;56850;8225;2824;100272147;51186;3149;26576;100130361;1730;347541;139425;3547;728695;729408;79921;57826;59272;203413;2986;7512;9737;8544;55634;2857;3421;537;11013;340554;5716;6658;4101;54457;1438;91966;441519;4100;5931;27316;7403;4534;6839;51480;728096;27112;92129;101928917;140462;8241;6567;827;203569;27301;84548;645037;54413;100133053;7355;254065;79836;10084;347442;60343;51765;55593;139818;56180;6303;8269;142684;7626;10046;8409;203447;63932;2710;4515;8406;51248;56001;51616;2925;100130613;2564;1193;100132994;5354;11043;340533;22;3476;84631;26748;11238;203562;102723631;170261;58526;441525;4983;29944;6907;1536;2539;1478;9468;23597;2187;1287;81887;6611;3561;9767;9282;54857;347365;10800;139341;54539;11219;728062;169966;51209;23630;26548;1121;2000;645188;51438;2846;280658;1852;347344;23229;10857;56157;286430;101059915;438;5277;9758;1069;4674;154796;56548;51309;1184;645073;80712;1774;10245;2258;728343;9823;441531;11141;643311;90121;256643;23676;4114;6758;4107;286499;5009;1654;1831;51284;94121;170302;11230;79135;286410;9210;2491;441490;84187;633;6191;64743;4110;3598;389856;7789;55787;9452;50814;2157;139422;170062;57187;139067;4104;203427;4693;5456;10013;1964;55190;100996648;293;9016;100528062;30011;90316;93953;10178;6322;28952;24137;2332;4105;6845;94122;84968;64663;1538;9142;286530;2245;5634;9506;79576;3266;139212;5207;6535;8227;393;389852;170626;91851;27334;158866;550643;159013;407;7224;55796;10761;100132963;168400;4281;158835;24140;8471;90167;7737;7319;10149;11279;6134;64109;1678;139322;5063;55906;116442;84443;27197;8233;548313;6872;27018;100129239;139105;7102;10549;26071;2664;59353;8573;28985;79184;728049;728090;158521;3581;139886;282808;8263;9130;728082;778;90843;1756;5422;7317;5935;347454;29071;207063;4112;412;158506;340602;30848;5127;22866;93380;159091;10159;212;139285;9338;85417;8266;100132399;158584;494118;190;7569;89801;2892;1968;5230;57232;55559;57529;8277;63035;80231;286436;25975;51311;8905;55086;139735;395;83692;171484;10251;169981;1349;63904;139716;257397;142689;80258;27035;1641;55613;7105;100329135;84295;9459;4810;404281;4109;367;474384;6748;139760;347487;92745;158830;53344;4103;9203;139378;186;474343;2719;3597;140456;9248;402415;203430;9185;90161;728042;4129;65267;56849;8228;8226;728036;7114;6399;4952;83740;84889;8481;6757;347468;347475;414;6759;9500;51132;8823;541578;2158;55609;2556;494119;6756;9502;158880;8517;8242;474383;57595;51442;389895;100132304;9754;80311;6102;27328;695;56159;51213;90737;60506;10943;100873985;57526;728269;170082;474382;102723680;728656;3358;8273;83844;114824;389840;170067;81557;80823;8862;2002;7216;79979;158763;23641;55217;8270;57477;7592;2833;425054;340526;727866;139599;139804;54470;8450;959;139562;645864;10075;117154;57631;2010;54521;79589;51634;3750;653282;728072;7076;392490;9363;8623;3920;347411;7454;100506164;265;90293;645051;100529097;55511;158724;6197;203547;139135;5355;347516;203522;139081;6451;27336;158787;728458;7499;4841;347517;51360;340578;139596;1896;441509;54466;660;158798;4108;171482;79868;728075;158833;79366;1821;56156;392465;1260;5160;56062;5303;3054;51260;139628;653220;340596;554;28986;23133;57393;2623;28227;4113;57692;50945;3730;7739;100131755;57481;8260;139170;64219;4204;389860;2574;3563;65991;10325;6170;10813;79710;8712;26280;2316;256714;10742;6173;9104;494197;29057;139324;442444;6103;54880;90736;55558;2742;1736;369;255313;3654;170627;645974;3897;79983;727940;541466;347527;8243;4007;139741;29978;2182;7504;60401;84707;53336;1485;159090;94056;57502;55285;653067;1046;11152;641339;1947;8852;7712;23708;203523;4267;54967;340542;89885;2277;83550;644353;55916;340595;6594;139189;63947;9643;9843;4935;139728;100288814;10479;50943;53940;55026;100507170;5638;4478;8239;4068;51114;139411;246100;9968;84679;115201;100533997;1741;416;64840;10682;11326;25763;27330;171483;8908;27286;1038;7543;158800;90060;1288;84061;215;6247;292;55879;401612;1183;340527;55344;29935;158983;357;10009;2747;2652;286514;340543;54885;100129407;10495;6792;79742;140886;2239;2334;4128;441518;139604;4303;55869;25878;4115;11040;8473;6855;84636;55922;728712;5956;2705;55841;54821;729396;441521;8933;10735;729442;9949;4694;84528;51481;492;3028;100129520;795;10389;83604;7411;9947;9367;100463488;10134;79057;54552;6906;340547;30014;415;5255;680;158809;6990;4435;5475;340529;65109;64860;7030;729428;8776;4675;5030;51566;729201;56271;4943;79917;85012;114928;5256;26609;54960;538;6853;5365;4354;286451;29934;10838;139221;9189;347404;6473;3251;286464;158931;139793;100008586;2717;3052;5973;139065;5199;546;5613;51270;139231;9131;7547;474381;257240;11254;27238;64102;2543;158747;2273;56474;5165;64648;54440;140597;5631;728239;3188;100130086;5251;8237;286527;100130302,815
-1,1,X,168547,155233731,155065184,23096;64061;392509;10214;170685;23157;727837;55998;23439;729431;10916;158586;55859;331;3423;54830;4168;6901;5358;92002;27344;729447;54328;266740;9075;102723737;7552;729422;54954;84460;389874;56000;340562;644538;92552;254158;79649;56850;8225;2824;100272147;51186;3149;26576;100130361;1730;347541;139425;3547;728695;729408;79921;57826;59272;203413;2986;7512;9737;8544;55634;2857;3421;537;11013;340554;5716;6658;4101;54457;1438;91966;441519;4100;5931;27316;7403;4534;6839;51480;728096;27112;92129;101928917;140462;8241;6567;827;203569;27301;84548;645037;54413;100133053;7355;254065;79836;10084;347442;60343;51765;55593;139818;56180;6303;8269;142684;7626;10046;8409;203447;63932;2710;4515;8406;51248;56001;51616;2925;100130613;2564;1193;100132994;5354;11043;340533;22;3476;84631;26748;11238;203562;102723631;170261;58526;441525;4983;29944;6907;1536;2539;1478;9468;23597;2187;1287;81887;6611;3561;9767;9282;54857;347365;10800;139341;54539;11219;728062;169966;51209;23630;26548;1121;2000;645188;51438;2846;280658;1852;347344;23229;10857;56157;286430;101059915;438;5277;9758;1069;4674;154796;56548;51309;1184;645073;80712;1774;10245;2258;728343;9823;441531;11141;643311;90121;256643;23676;4114;6758;4107;286499;5009;1654;1831;51284;94121;170302;11230;79135;286410;9210;2491;441490;84187;633;6191;64743;4110;3598;389856;7789;55787;9452;50814;2157;139422;170062;57187;139067;4104;203427;4693;5456;10013;1964;55190;100996648;293;9016;100528062;30011;90316;93953;10178;6322;28952;24137;2332;4105;6845;94122;84968;64663;1538;9142;286530;2245;5634;9506;79576;3266;139212;5207;6535;8227;393;389852;170626;91851;27334;158866;550643;159013;407;7224;55796;10761;100132963;168400;4281;158835;24140;8471;90167;7737;7319;10149;11279;6134;64109;1678;139322;5063;55906;116442;84443;27197;8233;548313;6872;27018;100129239;139105;7102;10549;26071;2664;59353;8573;28985;79184;728049;728090;158521;3581;139886;282808;8263;9130;728082;778;90843;1756;5422;7317;5935;347454;29071;207063;4112;412;158506;340602;30848;5127;22866;93380;159091;10159;212;139285;9338;85417;8266;100132399;158584;494118;190;7569;89801;2892;1968;5230;57232;55559;57529;8277;63035;80231;286436;25975;51311;8905;55086;139735;395;83692;171484;10251;169981;1349;63904;139716;257397;142689;80258;27035;1641;55613;7105;100329135;84295;9459;4810;404281;4109;367;474384;6748;139760;347487;92745;158830;53344;4103;9203;139378;186;474343;2719;3597;140456;9248;402415;203430;9185;90161;728042;4129;65267;56849;8228;8226;728036;7114;6399;4952;83740;84889;8481;6757;347468;347475;414;6759;9500;51132;8823;541578;2158;55609;2556;494119;6756;9502;158880;8517;8242;474383;57595;51442;389895;100132304;9754;80311;6102;27328;695;56159;51213;90737;60506;10943;100873985;57526;728269;170082;474382;102723680;728656;3358;8273;83844;114824;389840;170067;81557;80823;8862;2002;7216;79979;158763;23641;55217;8270;57477;7592;2833;425054;340526;727866;139599;139804;54470;8450;959;139562;645864;10075;117154;57631;2010;54521;79589;51634;3750;653282;728072;7076;392490;9363;8623;3920;347411;7454;100506164;265;90293;645051;100529097;55511;158724;6197;203547;139135;5355;347516;203522;139081;6451;27336;158787;728458;7499;4841;347517;51360;340578;139596;1896;441509;54466;660;158798;4108;171482;79868;728075;158833;79366;1821;56156;392465;1260;5160;56062;5303;3054;51260;139628;653220;340596;554;28986;23133;57393;2623;28227;4113;57692;50945;3730;7739;100131755;57481;8260;139170;64219;4204;389860;2574;3563;65991;10325;6170;10813;79710;8712;26280;2316;256714;10742;6173;9104;494197;29057;139324;442444;6103;54880;90736;55558;2742;1736;369;255313;3654;170627;645974;3897;79983;727940;541466;347527;8243;4007;139741;29978;2182;7504;60401;84707;53336;1485;159090;94056;57502;55285;653067;1046;11152;641339;1947;8852;7712;23708;203523;4267;54967;340542;89885;2277;83550;644353;55916;340595;6594;139189;63947;9643;9843;4935;139728;100288814;10479;50943;53940;55026;100507170;5638;4478;8239;4068;51114;139411;246100;9968;84679;115201;100533997;1741;416;64840;10682;11326;25763;27330;171483;8908;27286;1038;7543;158800;90060;1288;84061;215;6247;292;55879;401612;1183;340527;55344;29935;158983;357;10009;2747;2652;286514;340543;54885;100129407;10495;6792;79742;140886;2239;2334;4128;441518;139604;4303;55869;25878;4115;11040;8473;6855;84636;55922;728712;5956;2705;55841;54821;729396;441521;8933;10735;729442;9949;4694;84528;51481;492;3028;100129520;795;10389;83604;7411;9947;9367;100463488;10134;79057;54552;6906;340547;30014;415;5255;680;158809;6990;4435;5475;340529;65109;64860;7030;729428;8776;4675;5030;51566;729201;56271;4943;79917;85012;114928;5256;26609;54960;538;6853;5365;4354;286451;29934;10838;139221;9189;347404;6473;3251;286464;158931;139793;100008586;2717;3052;5973;139065;5199;546;5613;51270;139231;9131;7547;474381;257240;11254;27238;64102;2543;158747;2273;56474;5165;64648;54440;140597;5631;728239;3188;100130086;5251;8237;286527;100130302,815
1,1,X,168547,155233731,155065184,23096;64061;392509;10214;170685;23157;727837;55998;23439;729431;10916;158586;55859;331;3423;54830;4168;6901;5358;92002;27344;729447;54328;266740;9075;102723737;7552;729422;54954;84460;389874;56000;340562;644538;92552;254158;79649;56850;8225;2824;100272147;51186;3149;26576;100130361;1730;347541;139425;3547;728695;729408;79921;57826;59272;203413;2986;7512;9737;8544;55634;2857;3421;537;11013;340554;5716;6658;4101;54457;1438;91966;441519;4100;5931;27316;7403;4534;6839;51480;728096;27112;92129;101928917;140462;8241;6567;827;203569;27301;84548;645037;54413;100133053;7355;254065;79836;10084;347442;60343;51765;55593;139818;56180;6303;8269;142684;7626;10046;8409;203447;63932;2710;4515;8406;51248;56001;51616;2925;100130613;2564;1193;100132994;5354;11043;340533;22;3476;84631;26748;11238;203562;102723631;170261;58526;441525;4983;29944;6907;1536;2539;1478;9468;23597;2187;1287;81887;6611;3561;9767;9282;54857;347365;10800;139341;54539;11219;728062;169966;51209;23630;26548;1121;2000;645188;51438;2846;280658;1852;347344;23229;10857;56157;286430;101059915;438;5277;9758;1069;4674;154796;56548;51309;1184;645073;80712;1774;10245;2258;728343;9823;441531;11141;643311;90121;256643;23676;4114;6758;4107;286499;5009;1654;1831;51284;94121;170302;11230;79135;286410;9210;2491;441490;84187;633;6191;64743;4110;3598;389856;7789;55787;9452;50814;2157;139422;170062;57187;139067;4104;203427;4693;5456;10013;1964;55190;100996648;293;9016;100528062;30011;90316;93953;10178;6322;28952;24137;2332;4105;6845;94122;84968;64663;1538;9142;286530;2245;5634;9506;79576;3266;139212;5207;6535;8227;393;389852;170626;91851;27334;158866;550643;159013;407;7224;55796;10761;100132963;168400;4281;158835;24140;8471;90167;7737;7319;10149;11279;6134;64109;1678;139322;5063;55906;116442;84443;27197;8233;548313;6872;27018;100129239;139105;7102;10549;26071;2664;59353;8573;28985;79184;728049;728090;158521;3581;139886;282808;8263;9130;728082;778;90843;1756;5422;7317;5935;347454;29071;207063;4112;412;158506;340602;30848;5127;22866;93380;159091;10159;212;139285;9338;85417;8266;100132399;158584;494118;190;7569;89801;2892;1968;5230;57232;55559;57529;8277;63035;80231;286436;25975;51311;8905;55086;139735;395;83692;171484;10251;169981;1349;63904;139716;257397;142689;80258;27035;1641;55613;7105;100329135;84295;9459;4810;404281;4109;367;474384;6748;139760;347487;92745;158830;53344;4103;9203;139378;186;474343;2719;3597;140456;9248;402415;203430;9185;90161;728042;4129;65267;56849;8228;8226;728036;7114;6399;4952;83740;84889;8481;6757;347468;347475;414;6759;9500;51132;8823;541578;2158;55609;2556;494119;6756;9502;158880;8517;8242;474383;57595;51442;389895;100132304;9754;80311;6102;27328;695;56159;51213;90737;60506;10943;100873985;57526;728269;170082;474382;102723680;728656;3358;8273;83844;114824;389840;170067;81557;80823;8862;2002;7216;79979;158763;23641;55217;8270;57477;7592;2833;425054;340526;727866;139599;139804;54470;8450;959;139562;645864;10075;117154;57631;2010;54521;79589;51634;3750;653282;728072;7076;392490;9363;8623;3920;347411;7454;100506164;265;90293;645051;100529097;55511;158724;6197;203547;139135;5355;347516;203522;139081;6451;27336;158787;728458;7499;4841;347517;51360;340578;139596;1896;441509;54466;660;158798;4108;171482;79868;728075;158833;79366;1821;56156;392465;1260;5160;56062;5303;3054;51260;139628;653220;340596;554;28986;23133;57393;2623;28227;4113;57692;50945;3730;7739;100131755;57481;8260;139170;64219;4204;389860;2574;3563;65991;10325;6170;10813;79710;8712;26280;2316;256714;10742;6173;9104;494197;29057;139324;442444;6103;54880;90736;55558;2742;1736;369;255313;3654;170627;645974;3897;79983;727940;541466;347527;8243;4007;139741;29978;2182;7504;60401;84707;53336;1485;159090;94056;57502;55285;653067;1046;11152;641339;1947;8852;7712;23708;203523;4267;54967;340542;89885;2277;83550;644353;55916;340595;6594;139189;63947;9643;9843;4935;139728;100288814;10479;50943;53940;55026;100507170;5638;4478;8239;4068;51114;139411;246100;9968;84679;115201;100533997;1741;416;64840;10682;11326;25763;27330;171483;8908;27286;1038;7543;158800;90060;1288;84061;215;6247;292;55879;401612;1183;340527;55344;29935;158983;357;10009;2747;2652;286514;340543;54885;100129407;10495;6792;79742;140886;2239;2334;4128;441518;139604;4303;55869;25878;4115;11040;8473;6855;84636;55922;728712;5956;2705;55841;54821;729396;441521;8933;10735;729442;9949;4694;84528;51481;492;3028;100129520;795;10389;83604;7411;9947;9367;100463488;10134;79057;54552;6906;340547;30014;415;5255;680;158809;6990;4435;5475;340529;65109;64860;7030;729428;8776;4675;5030;51566;729201;56271;4943;79917;85012;114928;5256;26609;54960;538;6853;5365;4354;286451;29934;10838;139221;9189;347404;6473;3251;286464;158931;139793;100008586;2717;3052;5973;139065;5199;546;5613;51270;139231;9131;7547;474381;257240;11254;27238;64102;2543;158747;2273;56474;5165;64648;54440;140597;5631;728239;3188;100130086;5251;8237;286527;100130302,815
1,1,X,168547,155233731,155065184,23096;64061;392509;10214;170685;23157;727837;55998;23439;729431;10916;158586;55859;331;3423;54830;4168;6901;5358;92002;27344;729447;54328;266740;9075;102723737;7552;729422;54954;84460;389874;56000;340562;644538;92552;254158;79649;56850;8225;2824;100272147;51186;3149;26576;100130361;1730;347541;139425;3547;728695;729408;79921;57826;59272;203413;2986;7512;9737;8544;55634;2857;3421;537;11013;340554;5716;6658;4101;54457;1438;91966;441519;4100;5931;27316;7403;4534;6839;51480;728096;27112;92129;101928917;140462;8241;6567;827;203569;27301;84548;645037;54413;100133053;7355;254065;79836;10084;347442;60343;51765;55593;139818;56180;6303;8269;142684;7626;10046;8409;203447;63932;2710;4515;8406;51248;56001;51616;2925;100130613;2564;1193;100132994;5354;11043;340533;22;3476;84631;26748;11238;203562;102723631;170261;58526;441525;4983;29944;6907;1536;2539;1478;9468;23597;2187;1287;81887;6611;3561;9767;9282;54857;347365;10800;139341;54539;11219;728062;169966;51209;23630;26548;1121;2000;645188;51438;2846;280658;1852;347344;23229;10857;56157;286430;101059915;438;5277;9758;1069;4674;154796;56548;51309;1184;645073;80712;1774;10245;2258;728343;9823;441531;11141;643311;90121;256643;23676;4114;6758;4107;286499;5009;1654;1831;51284;94121;170302;11230;79135;286410;9210;2491;441490;84187;633;6191;64743;4110;3598;389856;7789;55787;9452;50814;2157;139422;170062;57187;139067;4104;203427;4693;5456;10013;1964;55190;100996648;293;9016;100528062;30011;90316;93953;10178;6322;28952;24137;2332;4105;6845;94122;84968;64663;1538;9142;286530;2245;5634;9506;79576;3266;139212;5207;6535;8227;393;389852;170626;91851;27334;158866;550643;159013;407;7224;55796;10761;100132963;168400;4281;158835;24140;8471;90167;7737;7319;10149;11279;6134;64109;1678;139322;5063;55906;116442;84443;27197;8233;548313;6872;27018;100129239;139105;7102;10549;26071;2664;59353;8573;28985;79184;728049;728090;158521;3581;139886;282808;8263;9130;728082;778;90843;1756;5422;7317;5935;347454;29071;207063;4112;412;158506;340602;30848;5127;22866;93380;159091;10159;212;139285;9338;85417;8266;100132399;158584;494118;190;7569;89801;2892;1968;5230;57232;55559;57529;8277;63035;80231;286436;25975;51311;8905;55086;139735;395;83692;171484;10251;169981;1349;63904;139716;257397;142689;80258;27035;1641;55613;7105;100329135;84295;9459;4810;404281;4109;367;474384;6748;139760;347487;92745;158830;53344;4103;9203;139378;186;474343;2719;3597;140456;9248;402415;203430;9185;90161;728042;4129;65267;56849;8228;8226;728036;7114;6399;4952;83740;84889;8481;6757;347468;347475;414;6759;9500;51132;8823;541578;2158;55609;2556;494119;6756;9502;158880;8517;8242;474383;57595;51442;389895;100132304;9754;80311;6102;27328;695;56159;51213;90737;60506;10943;100873985;57526;728269;170082;474382;102723680;728656;3358;8273;83844;114824;389840;170067;81557;80823;8862;2002;7216;79979;158763;23641;55217;8270;57477;7592;2833;425054;340526;727866;139599;139804;54470;8450;959;139562;645864;10075;117154;57631;2010;54521;79589;51634;3750;653282;728072;7076;392490;9363;8623;3920;347411;7454;100506164;265;90293;645051;100529097;55511;158724;6197;203547;139135;5355;347516;203522;139081;6451;27336;158787;728458;7499;4841;347517;51360;340578;139596;1896;441509;54466;660;158798;4108;171482;79868;728075;158833;79366;1821;56156;392465;1260;5160;56062;5303;3054;51260;139628;653220;340596;554;28986;23133;57393;2623;28227;4113;57692;50945;3730;7739;100131755;57481;8260;139170;64219;4204;389860;2574;3563;65991;10325;6170;10813;79710;8712;26280;2316;256714;10742;6173;9104;494197;29057;139324;442444;6103;54880;90736;55558;2742;1736;369;255313;3654;170627;645974;3897;79983;727940;541466;347527;8243;4007;139741;29978;2182;7504;60401;84707;53336;1485;159090;94056;57502;55285;653067;1046;11152;641339;1947;8852;7712;23708;203523;4267;54967;340542;89885;2277;83550;644353;55916;340595;6594;139189;63947;9643;9843;4935;139728;100288814;10479;50943;53940;55026;100507170;5638;4478;8239;4068;51114;139411;246100;9968;84679;115201;100533997;1741;416;64840;10682;11326;25763;27330;171483;8908;27286;1038;7543;158800;90060;1288;84061;215;6247;292;55879;401612;1183;340527;55344;29935;158983;357;10009;2747;2652;286514;340543;54885;100129407;10495;6792;79742;140886;2239;2334;4128;441518;139604;4303;55869;25878;4115;11040;8473;6855;84636;55922;728712;5956;2705;55841;54821;729396;441521;8933;10735;729442;9949;4694;84528;51481;492;3028;100129520;795;10389;83604;7411;9947;9367;100463488;10134;79057;54552;6906;340547;30014;415;5255;680;158809;6990;4435;5475;340529;65109;64860;7030;729428;8776;4675;5030;51566;729201;56271;4943;79917;85012;114928;5256;26609;54960;538;6853;5365;4354;286451;29934;10838;139221;9189;347404;6473;3251;286464;158931;139793;100008586;2717;3052;5973;139065;5199;546;5613;51270;139231;9131;7547;474381;257240;11254;27238;64102;2543;158747;2273;56474;5165;64648;54440;140597;5631;728239;3188;100130086;5251;8237;286527;100130302,815
-1,1,X,168547,155233731,155065184,23096;64061;392509;10214;170685;23157;727837;55998;23439;729431;10916;158586;55859;331;3423;54830;4168;6901;5358;92002;27344;729447;54328;266740;9075;102723737;7552;729422;54954;84460;389874;56000;340562;644538;92552;254158;79649;56850;8225;2824;100272147;51186;3149;26576;100130361;1730;347541;139425;3547;728695;729408;79921;57826;59272;203413;2986;7512;9737;8544;55634;2857;3421;537;11013;340554;5716;6658;4101;54457;1438;91966;441519;4100;5931;27316;7403;4534;6839;51480;728096;27112;92129;101928917;140462;8241;6567;827;203569;27301;84548;645037;54413;100133053;7355;254065;79836;10084;347442;60343;51765;55593;139818;56180;6303;8269;142684;7626;10046;8409;203447;63932;2710;4515;8406;51248;56001;51616;2925;100130613;2564;1193;100132994;5354;11043;340533;22;3476;84631;26748;11238;203562;102723631;170261;58526;441525;4983;29944;6907;1536;2539;1478;9468;23597;2187;1287;81887;6611;3561;9767;9282;54857;347365;10800;139341;54539;11219;728062;169966;51209;23630;26548;1121;2000;645188;51438;2846;280658;1852;347344;23229;10857;56157;286430;101059915;438;5277;9758;1069;4674;154796;56548;51309;1184;645073;80712;1774;10245;2258;728343;9823;441531;11141;643311;90121;256643;23676;4114;6758;4107;286499;5009;1654;1831;51284;94121;170302;11230;79135;286410;9210;2491;441490;84187;633;6191;64743;4110;3598;389856;7789;55787;9452;50814;2157;139422;170062;57187;139067;4104;203427;4693;5456;10013;1964;55190;100996648;293;9016;100528062;30011;90316;93953;10178;6322;28952;24137;2332;4105;6845;94122;84968;64663;1538;9142;286530;2245;5634;9506;79576;3266;139212;5207;6535;8227;393;389852;170626;91851;27334;158866;550643;159013;407;7224;55796;10761;100132963;168400;4281;158835;24140;8471;90167;7737;7319;10149;11279;6134;64109;1678;139322;5063;55906;116442;84443;27197;8233;548313;6872;27018;100129239;139105;7102;10549;26071;2664;59353;8573;28985;79184;728049;728090;158521;3581;139886;282808;8263;9130;728082;778;90843;1756;5422;7317;5935;347454;29071;207063;4112;412;158506;340602;30848;5127;22866;93380;159091;10159;212;139285;9338;85417;8266;100132399;158584;494118;190;7569;89801;2892;1968;5230;57232;55559;57529;8277;63035;80231;286436;25975;51311;8905;55086;139735;395;83692;171484;10251;169981;1349;63904;139716;257397;142689;80258;27035;1641;55613;7105;100329135;84295;9459;4810;404281;4109;367;474384;6748;139760;347487;92745;158830;53344;4103;9203;139378;186;474343;2719;3597;140456;9248;402415;203430;9185;90161;728042;4129;65267;56849;8228;8226;728036;7114;6399;4952;83740;84889;8481;6757;347468;347475;414;6759;9500;51132;8823;541578;2158;55609;2556;494119;6756;9502;158880;8517;8242;474383;57595;51442;389895;100132304;9754;80311;6102;27328;695;56159;51213;90737;60506;10943;100873985;57526;728269;170082;474382;102723680;728656;3358;8273;83844;114824;389840;170067;81557;80823;8862;2002;7216;79979;158763;23641;55217;8270;57477;7592;2833;425054;340526;727866;139599;139804;54470;8450;959;139562;645864;10075;117154;57631;2010;54521;79589;51634;3750;653282;728072;7076;392490;9363;8623;3920;347411;7454;100506164;265;90293;645051;100529097;55511;158724;6197;203547;139135;5355;347516;203522;139081;6451;27336;158787;728458;7499;4841;347517;51360;340578;139596;1896;441509;54466;660;158798;4108;171482;79868;728075;158833;79366;1821;56156;392465;1260;5160;56062;5303;3054;51260;139628;653220;340596;554;28986;23133;57393;2623;28227;4113;57692;50945;3730;7739;100131755;57481;8260;139170;64219;4204;389860;2574;3563;65991;10325;6170;10813;79710;8712;26280;2316;256714;10742;6173;9104;494197;29057;139324;442444;6103;54880;90736;55558;2742;1736;369;255313;3654;170627;645974;3897;79983;727940;541466;347527;8243;4007;139741;29978;2182;7504;60401;84707;53336;1485;159090;94056;57502;55285;653067;1046;11152;641339;1947;8852;7712;23708;203523;4267;54967;340542;89885;2277;83550;644353;55916;340595;6594;139189;63947;9643;9843;4935;139728;100288814;10479;50943;53940;55026;100507170;5638;4478;8239;4068;51114;139411;246100;9968;84679;115201;100533997;1741;416;64840;10682;11326;25763;27330;171483;8908;27286;1038;7543;158800;90060;1288;84061;215;6247;292;55879;401612;1183;340527;55344;29935;158983;357;10009;2747;2652;286514;340543;54885;100129407;10495;6792;79742;140886;2239;2334;4128;441518;139604;4303;55869;25878;4115;11040;8473;6855;84636;55922;728712;5956;2705;55841;54821;729396;441521;8933;10735;729442;9949;4694;84528;51481;492;3028;100129520;795;10389;83604;7411;9947;9367;100463488;10134;79057;54552;6906;340547;30014;415;5255;680;158809;6990;4435;5475;340529;65109;64860;7030;729428;8776;4675;5030;51566;729201;56271;4943;79917;85012;114928;5256;26609;54960;538;6853;5365;4354;286451;29934;10838;139221;9189;347404;6473;3251;286464;158931;139793;100008586;2717;3052;5973;139065;5199;546;5613;51270;139231;9131;7547;474381;257240;11254;27238;64102;2543;158747;2273;56474;5165;64648;54440;140597;5631;728239;3188;100130086;5251;8237;286527;100130302,815
1,1,X,168547,155233731,155065184,23096;64061;392509;10214;170685;23157;727837;55998;23439;729431;10916;158586;55859;331;3423;54830;4168;6901;5358;92002;27344;729447;54328;266740;9075;102723737;7552;729422;54954;84460;389874;56000;340562;644538;92552;254158;79649;56850;8225;2824;100272147;51186;3149;26576;100130361;1730;347541;139425;3547;728695;729408;79921;57826;59272;203413;2986;7512;9737;8544;55634;2857;3421;537;11013;340554;5716;6658;4101;54457;1438;91966;441519;4100;5931;27316;7403;4534;6839;51480;728096;27112;92129;101928917;140462;8241;6567;827;203569;27301;84548;645037;54413;100133053;7355;254065;79836;10084;347442;60343;51765;55593;139818;56180;6303;8269;142684;7626;10046;8409;203447;63932;2710;4515;8406;51248;56001;51616;2925;100130613;2564;1193;100132994;5354;11043;340533;22;3476;84631;26748;11238;203562;102723631;170261;58526;441525;4983;29944;6907;1536;2539;1478;9468;23597;2187;1287;81887;6611;3561;9767;9282;54857;347365;10800;139341;54539;11219;728062;169966;51209;23630;26548;1121;2000;645188;51438;2846;280658;1852;347344;23229;10857;56157;286430;101059915;438;5277;9758;1069;4674;154796;56548;51309;1184;645073;80712;1774;10245;2258;728343;9823;441531;11141;643311;90121;256643;23676;4114;6758;4107;286499;5009;1654;1831;51284;94121;170302;11230;79135;286410;9210;2491;441490;84187;633;6191;64743;4110;3598;389856;7789;55787;9452;50814;2157;139422;170062;57187;139067;4104;203427;4693;5456;10013;1964;55190;100996648;293;9016;100528062;30011;90316;93953;10178;6322;28952;24137;2332;4105;6845;94122;84968;64663;1538;9142;286530;2245;5634;9506;79576;3266;139212;5207;6535;8227;393;389852;170626;91851;27334;158866;550643;159013;407;7224;55796;10761;100132963;168400;4281;158835;24140;8471;90167;7737;7319;10149;11279;6134;64109;1678;139322;5063;55906;116442;84443;27197;8233;548313;6872;27018;100129239;139105;7102;10549;26071;2664;59353;8573;28985;79184;728049;728090;158521;3581;139886;282808;8263;9130;728082;778;90843;1756;5422;7317;5935;347454;29071;207063;4112;412;158506;340602;30848;5127;22866;93380;159091;10159;212;139285;9338;85417;8266;100132399;158584;494118;190;7569;89801;2892;1968;5230;57232;55559;57529;8277;63035;80231;286436;25975;51311;8905;55086;139735;395;83692;171484;10251;169981;1349;63904;139716;257397;142689;80258;27035;1641;55613;7105;100329135;84295;9459;4810;404281;4109;367;474384;6748;139760;347487;92745;158830;53344;4103;9203;139378;186;474343;2719;3597;140456;9248;402415;203430;9185;90161;728042;4129;65267;56849;8228;8226;728036;7114;6399;4952;83740;84889;8481;6757;347468;347475;414;6759;9500;51132;8823;541578;2158;55609;2556;494119;6756;9502;158880;8517;8242;474383;57595;51442;389895;100132304;9754;80311;6102;27328;695;56159;51213;90737;60506;10943;100873985;57526;728269;170082;474382;102723680;728656;3358;8273;83844;114824;389840;170067;81557;80823;8862;2002;7216;79979;158763;23641;55217;8270;57477;7592;2833;425054;340526;727866;139599;139804;54470;8450;959;139562;645864;10075;117154;57631;2010;54521;79589;51634;3750;653282;728072;7076;392490;9363;8623;3920;347411;7454;100506164;265;90293;645051;100529097;55511;158724;6197;203547;139135;5355;347516;203522;139081;6451;27336;158787;728458;7499;4841;347517;51360;340578;139596;1896;441509;54466;660;158798;4108;171482;79868;728075;158833;79366;1821;56156;392465;1260;5160;56062;5303;3054;51260;139628;653220;340596;554;28986;23133;57393;2623;28227;4113;57692;50945;3730;7739;100131755;57481;8260;139170;64219;4204;389860;2574;3563;65991;10325;6170;10813;79710;8712;26280;2316;256714;10742;6173;9104;494197;29057;139324;442444;6103;54880;90736;55558;2742;1736;369;255313;3654;170627;645974;3897;79983;727940;541466;347527;8243;4007;139741;29978;2182;7504;60401;84707;53336;1485;159090;94056;57502;55285;653067;1046;11152;641339;1947;8852;7712;23708;203523;4267;54967;340542;89885;2277;83550;644353;55916;340595;6594;139189;63947;9643;9843;4935;139728;100288814;10479;50943;53940;55026;100507170;5638;4478;8239;4068;51114;139411;246100;9968;84679;115201;100533997;1741;416;64840;10682;11326;25763;27330;171483;8908;27286;1038;7543;158800;90060;1288;84061;215;6247;292;55879;401612;1183;340527;55344;29935;158983;357;10009;2747;2652;286514;340543;54885;100129407;10495;6792;79742;140886;2239;2334;4128;441518;139604;4303;55869;25878;4115;11040;8473;6855;84636;55922;728712;5956;2705;55841;54821;729396;441521;8933;10735;729442;9949;4694;84528;51481;492;3028;100129520;795;10389;83604;7411;9947;9367;100463488;10134;79057;54552;6906;340547;30014;415;5255;680;158809;6990;4435;5475;340529;65109;64860;7030;729428;8776;4675;5030;51566;729201;56271;4943;79917;85012;114928;5256;26609;54960;538;6853;5365;4354;286451;29934;10838;139221;9189;347404;6473;3251;286464;158931;139793;100008586;2717;3052;5973;139065;5199;546;5613;51270;139231;9131;7547;474381;257240;11254;27238;64102;2543;158747;2273;56474;5165;64648;54440;140597;5631;728239;3188;100130086;5251;8237;286527;100130302,815
1,1,X,168547,155233731,155065184,23096;64061;392509;10214;170685;23157;727837;55998;23439;729431;10916;158586;55859;331;3423;54830;4168;6901;5358;92002;27344;729447;54328;266740;9075;102723737;7552;729422;54954;84460;389874;56000;340562;644538;92552;254158;79649;56850;8225;2824;100272147;51186;3149;26576;100130361;1730;347541;139425;3547;728695;729408;79921;57826;59272;203413;2986;7512;9737;8544;55634;2857;3421;537;11013;340554;5716;6658;4101;54457;1438;91966;441519;4100;5931;27316;7403;4534;6839;51480;728096;27112;92129;101928917;140462;8241;6567;827;203569;27301;84548;645037;54413;100133053;7355;254065;79836;10084;347442;60343;51765;55593;139818;56180;6303;8269;142684;7626;10046;8409;203447;63932;2710;4515;8406;51248;56001;51616;2925;100130613;2564;1193;100132994;5354;11043;340533;22;3476;84631;26748;11238;203562;102723631;170261;58526;441525;4983;29944;6907;1536;2539;1478;9468;23597;2187;1287;81887;6611;3561;9767;9282;54857;347365;10800;139341;54539;11219;728062;169966;51209;23630;26548;1121;2000;645188;51438;2846;280658;1852;347344;23229;10857;56157;286430;101059915;438;5277;9758;1069;4674;154796;56548;51309;1184;645073;80712;1774;10245;2258;728343;9823;441531;11141;643311;90121;256643;23676;4114;6758;4107;286499;5009;1654;1831;51284;94121;170302;11230;79135;286410;9210;2491;441490;84187;633;6191;64743;4110;3598;389856;7789;55787;9452;50814;2157;139422;170062;57187;139067;4104;203427;4693;5456;10013;1964;55190;100996648;293;9016;100528062;30011;90316;93953;10178;6322;28952;24137;2332;4105;6845;94122;84968;64663;1538;9142;286530;2245;5634;9506;79576;3266;139212;5207;6535;8227;393;389852;170626;91851;27334;158866;550643;159013;407;7224;55796;10761;100132963;168400;4281;158835;24140;8471;90167;7737;7319;10149;11279;6134;64109;1678;139322;5063;55906;116442;84443;27197;8233;548313;6872;27018;100129239;139105;7102;10549;26071;2664;59353;8573;28985;79184;728049;728090;158521;3581;139886;282808;8263;9130;728082;778;90843;1756;5422;7317;5935;347454;29071;207063;4112;412;158506;340602;30848;5127;22866;93380;159091;10159;212;139285;9338;85417;8266;100132399;158584;494118;190;7569;89801;2892;1968;5230;57232;55559;57529;8277;63035;80231;286436;25975;51311;8905;55086;139735;395;83692;171484;10251;169981;1349;63904;139716;257397;142689;80258;27035;1641;55613;7105;100329135;84295;9459;4810;404281;4109;367;474384;6748;139760;347487;92745;158830;53344;4103;9203;139378;186;474343;2719;3597;140456;9248;402415;203430;9185;90161;728042;4129;65267;56849;8228;8226;728036;7114;6399;4952;83740;84889;8481;6757;347468;347475;414;6759;9500;51132;8823;541578;2158;55609;2556;494119;6756;9502;158880;8517;8242;474383;57595;51442;389895;100132304;9754;80311;6102;27328;695;56159;51213;90737;60506;10943;100873985;57526;728269;170082;474382;102723680;728656;3358;8273;83844;114824;389840;170067;81557;80823;8862;2002;7216;79979;158763;23641;55217;8270;57477;7592;2833;425054;340526;727866;139599;139804;54470;8450;959;139562;645864;10075;117154;57631;2010;54521;79589;51634;3750;653282;728072;7076;392490;9363;8623;3920;347411;7454;100506164;265;90293;645051;100529097;55511;158724;6197;203547;139135;5355;347516;203522;139081;6451;27336;158787;728458;7499;4841;347517;51360;340578;139596;1896;441509;54466;660;158798;4108;171482;79868;728075;158833;79366;1821;56156;392465;1260;5160;56062;5303;3054;51260;139628;653220;340596;554;28986;23133;57393;2623;28227;4113;57692;50945;3730;7739;100131755;57481;8260;139170;64219;4204;389860;2574;3563;65991;10325;6170;10813;79710;8712;26280;2316;256714;10742;6173;9104;494197;29057;139324;442444;6103;54880;90736;55558;2742;1736;369;255313;3654;170627;645974;3897;79983;727940;541466;347527;8243;4007;139741;29978;2182;7504;60401;84707;53336;1485;159090;94056;57502;55285;653067;1046;11152;641339;1947;8852;7712;23708;203523;4267;54967;340542;89885;2277;83550;644353;55916;340595;6594;139189;63947;9643;9843;4935;139728;100288814;10479;50943;53940;55026;100507170;5638;4478;8239;4068;51114;139411;246100;9968;84679;115201;100533997;1741;416;64840;10682;11326;25763;27330;171483;8908;27286;1038;7543;158800;90060;1288;84061;215;6247;292;55879;401612;1183;340527;55344;29935;158983;357;10009;2747;2652;286514;340543;54885;100129407;10495;6792;79742;140886;2239;2334;4128;441518;139604;4303;55869;25878;4115;11040;8473;6855;84636;55922;728712;5956;2705;55841;54821;729396;441521;8933;10735;729442;9949;4694;84528;51481;492;3028;100129520;795;10389;83604;7411;9947;9367;100463488;10134;79057;54552;6906;340547;30014;415;5255;680;158809;6990;4435;5475;340529;65109;64860;7030;729428;8776;4675;5030;51566;729201;56271;4943;79917;85012;114928;5256;26609;54960;538;6853;5365;4354;286451;29934;10838;139221;9189;347404;6473;3251;286464;158931;139793;100008586;2717;3052;5973;139065;5199;546;5613;51270;139231;9131;7547;474381;257240;11254;27238;64102;2543;158747;2273;56474;5165;64648;54440;140597;5631;728239;3188;100130086;5251;8237;286527;100130302,815
1,1,X,168547,155233731,155065184,23096;64061;392509;10214;170685;23157;727837;55998;23439;729431;10916;158586;55859;331;3423;54830;4168;6901;5358;92002;27344;729447;54328;266740;9075;102723737;7552;729422;54954;84460;389874;56000;340562;644538;92552;254158;79649;56850;8225;2824;100272147;51186;3149;26576;100130361;1730;347541;139425;3547;728695;729408;79921;57826;59272;203413;2986;7512;9737;8544;55634;2857;3421;537;11013;340554;5716;6658;4101;54457;1438;91966;441519;4100;5931;27316;7403;4534;6839;51480;728096;27112;92129;101928917;140462;8241;6567;827;203569;27301;84548;645037;54413;100133053;7355;254065;79836;10084;347442;60343;51765;55593;139818;56180;6303;8269;142684;7626;10046;8409;203447;63932;2710;4515;8406;51248;56001;51616;2925;100130613;2564;1193;100132994;5354;11043;340533;22;3476;84631;26748;11238;203562;102723631;170261;58526;441525;4983;29944;6907;1536;2539;1478;9468;23597;2187;1287;81887;6611;3561;9767;9282;54857;347365;10800;139341;54539;11219;728062;169966;51209;23630;26548;1121;2000;645188;51438;2846;280658;1852;347344;23229;10857;56157;286430;101059915;438;5277;9758;1069;4674;154796;56548;51309;1184;645073;80712;1774;10245;2258;728343;9823;441531;11141;643311;90121;256643;23676;4114;6758;4107;286499;5009;1654;1831;51284;94121;170302;11230;79135;286410;9210;2491;441490;84187;633;6191;64743;4110;3598;389856;7789;55787;9452;50814;2157;139422;170062;57187;139067;4104;203427;4693;5456;10013;1964;55190;100996648;293;9016;100528062;30011;90316;93953;10178;6322;28952;24137;2332;4105;6845;94122;84968;64663;1538;9142;286530;2245;5634;9506;79576;3266;139212;5207;6535;8227;393;389852;170626;91851;27334;158866;550643;159013;407;7224;55796;10761;100132963;168400;4281;158835;24140;8471;90167;7737;7319;10149;11279;6134;64109;1678;139322;5063;55906;116442;84443;27197;8233;548313;6872;27018;100129239;139105;7102;10549;26071;2664;59353;8573;28985;79184;728049;728090;158521;3581;139886;282808;8263;9130;728082;778;90843;1756;5422;7317;5935;347454;29071;207063;4112;412;158506;340602;30848;5127;22866;93380;159091;10159;212;139285;9338;85417;8266;100132399;158584;494118;190;7569;89801;2892;1968;5230;57232;55559;57529;8277;63035;80231;286436;25975;51311;8905;55086;139735;395;83692;171484;10251;169981;1349;63904;139716;257397;142689;80258;27035;1641;55613;7105;100329135;84295;9459;4810;404281;4109;367;474384;6748;139760;347487;92745;158830;53344;4103;9203;139378;186;474343;2719;3597;140456;9248;402415;203430;9185;90161;728042;4129;65267;56849;8228;8226;728036;7114;6399;4952;83740;84889;8481;6757;347468;347475;414;6759;9500;51132;8823;541578;2158;55609;2556;494119;6756;9502;158880;8517;8242;474383;57595;51442;389895;100132304;9754;80311;6102;27328;695;56159;51213;90737;60506;10943;100873985;57526;728269;170082;474382;102723680;728656;3358;8273;83844;114824;389840;170067;81557;80823;8862;2002;7216;79979;158763;23641;55217;8270;57477;7592;2833;425054;340526;727866;139599;139804;54470;8450;959;139562;645864;10075;117154;57631;2010;54521;79589;51634;3750;653282;728072;7076;392490;9363;8623;3920;347411;7454;100506164;265;90293;645051;100529097;55511;158724;6197;203547;139135;5355;347516;203522;139081;6451;27336;158787;728458;7499;4841;347517;51360;340578;139596;1896;441509;54466;660;158798;4108;171482;79868;728075;158833;79366;1821;56156;392465;1260;5160;56062;5303;3054;51260;139628;653220;340596;554;28986;23133;57393;2623;28227;4113;57692;50945;3730;7739;100131755;57481;8260;139170;64219;4204;389860;2574;3563;65991;10325;6170;10813;79710;8712;26280;2316;256714;10742;6173;9104;494197;29057;139324;442444;6103;54880;90736;55558;2742;1736;369;255313;3654;170627;645974;3897;79983;727940;541466;347527;8243;4007;139741;29978;2182;7504;60401;84707;53336;1485;159090;94056;57502;55285;653067;1046;11152;641339;1947;8852;7712;23708;203523;4267;54967;340542;89885;2277;83550;644353;55916;340595;6594;139189;63947;9643;9843;4935;139728;100288814;10479;50943;53940;55026;100507170;5638;4478;8239;4068;51114;139411;246100;9968;84679;115201;100533997;1741;416;64840;10682;11326;25763;27330;171483;8908;27286;1038;7543;158800;90060;1288;84061;215;6247;292;55879;401612;1183;340527;55344;29935;158983;357;10009;2747;2652;286514;340543;54885;100129407;10495;6792;79742;140886;2239;2334;4128;441518;139604;4303;55869;25878;4115;11040;8473;6855;84636;55922;728712;5956;2705;55841;54821;729396;441521;8933;10735;729442;9949;4694;84528;51481;492;3028;100129520;795;10389;83604;7411;9947;9367;100463488;10134;79057;54552;6906;340547;30014;415;5255;680;158809;6990;4435;5475;340529;65109;64860;7030;729428;8776;4675;5030;51566;729201;56271;4943;79917;85012;114928;5256;26609;54960;538;6853;5365;4354;286451;29934;10838;139221;9189;347404;6473;3251;286464;158931;139793;100008586;2717;3052;5973;139065;5199;546;5613;51270;139231;9131;7547;474381;257240;11254;27238;64102;2543;158747;2273;56474;5165;64648;54440;140597;5631;728239;3188;100130086;5251;8237;286527;100130302,815
1,1,X,168547,155233731,155065184,23096;64061;392509;10214;170685;23157;727837;55998;23439;729431;10916;158586;55859;331;3423;54830;4168;6901;5358;92002;27344;729447;54328;266740;9075;102723737;7552;729422;54954;84460;389874;56000;340562;644538;92552;254158;79649;56850;8225;2824;100272147;51186;3149;26576;100130361;1730;347541;139425;3547;728695;729408;79921;57826;59272;203413;2986;7512;9737;8544;55634;2857;3421;537;11013;340554;5716;6658;4101;54457;1438;91966;441519;4100;5931;27316;7403;4534;6839;51480;728096;27112;92129;101928917;140462;8241;6567;827;203569;27301;84548;645037;54413;100133053;7355;254065;79836;10084;347442;60343;51765;55593;139818;56180;6303;8269;142684;7626;10046;8409;203447;63932;2710;4515;8406;51248;56001;51616;2925;100130613;2564;1193;100132994;5354;11043;340533;22;3476;84631;26748;11238;203562;102723631;170261;58526;441525;4983;29944;6907;1536;2539;1478;9468;23597;2187;1287;81887;6611;3561;9767;9282;54857;347365;10800;139341;54539;11219;728062;169966;51209;23630;26548;1121;2000;645188;51438;2846;280658;1852;347344;23229;10857;56157;286430;101059915;438;5277;9758;1069;4674;154796;56548;51309;1184;645073;80712;1774;10245;2258;728343;9823;441531;11141;643311;90121;256643;23676;4114;6758;4107;286499;5009;1654;1831;51284;94121;170302;11230;79135;286410;9210;2491;441490;84187;633;6191;64743;4110;3598;389856;7789;55787;9452;50814;2157;139422;170062;57187;139067;4104;203427;4693;5456;10013;1964;55190;100996648;293;9016;100528062;30011;90316;93953;10178;6322;28952;24137;2332;4105;6845;94122;84968;64663;1538;9142;286530;2245;5634;9506;79576;3266;139212;5207;6535;8227;393;389852;170626;91851;27334;158866;550643;159013;407;7224;55796;10761;100132963;168400;4281;158835;24140;8471;90167;7737;7319;10149;11279;6134;64109;1678;139322;5063;55906;116442;84443;27197;8233;548313;6872;27018;100129239;139105;7102;10549;26071;2664;59353;8573;28985;79184;728049;728090;158521;3581;139886;282808;8263;9130;728082;778;90843;1756;5422;7317;5935;347454;29071;207063;4112;412;158506;340602;30848;5127;22866;93380;159091;10159;212;139285;9338;85417;8266;100132399;158584;494118;190;7569;89801;2892;1968;5230;57232;55559;57529;8277;63035;80231;286436;25975;51311;8905;55086;139735;395;83692;171484;10251;169981;1349;63904;139716;257397;142689;80258;27035;1641;55613;7105;100329135;84295;9459;4810;404281;4109;367;474384;6748;139760;347487;92745;158830;53344;4103;9203;139378;186;474343;2719;3597;140456;9248;402415;203430;9185;90161;728042;4129;65267;56849;8228;8226;728036;7114;6399;4952;83740;84889;8481;6757;347468;347475;414;6759;9500;51132;8823;541578;2158;55609;2556;494119;6756;9502;158880;8517;8242;474383;57595;51442;389895;100132304;9754;80311;6102;27328;695;56159;51213;90737;60506;10943;100873985;57526;728269;170082;474382;102723680;728656;3358;8273;83844;114824;389840;170067;81557;80823;8862;2002;7216;79979;158763;23641;55217;8270;57477;7592;2833;425054;340526;727866;139599;139804;54470;8450;959;139562;645864;10075;117154;57631;2010;54521;79589;51634;3750;653282;728072;7076;392490;9363;8623;3920;347411;7454;100506164;265;90293;645051;100529097;55511;158724;6197;203547;139135;5355;347516;203522;139081;6451;27336;158787;728458;7499;4841;347517;51360;340578;139596;1896;441509;54466;660;158798;4108;171482;79868;728075;158833;79366;1821;56156;392465;1260;5160;56062;5303;3054;51260;139628;653220;340596;554;28986;23133;57393;2623;28227;4113;57692;50945;3730;7739;100131755;57481;8260;139170;64219;4204;389860;2574;3563;65991;10325;6170;10813;79710;8712;26280;2316;256714;10742;6173;9104;494197;29057;139324;442444;6103;54880;90736;55558;2742;1736;369;255313;3654;170627;645974;3897;79983;727940;541466;347527;8243;4007;139741;29978;2182;7504;60401;84707;53336;1485;159090;94056;57502;55285;653067;1046;11152;641339;1947;8852;7712;23708;203523;4267;54967;340542;89885;2277;83550;644353;55916;340595;6594;139189;63947;9643;9843;4935;139728;100288814;10479;50943;53940;55026;100507170;5638;4478;8239;4068;51114;139411;246100;9968;84679;115201;100533997;1741;416;64840;10682;11326;25763;27330;171483;8908;27286;1038;7543;158800;90060;1288;84061;215;6247;292;55879;401612;1183;340527;55344;29935;158983;357;10009;2747;2652;286514;340543;54885;100129407;10495;6792;79742;140886;2239;2334;4128;441518;139604;4303;55869;25878;4115;11040;8473;6855;84636;55922;728712;5956;2705;55841;54821;729396;441521;8933;10735;729442;9949;4694;84528;51481;492;3028;100129520;795;10389;83604;7411;9947;9367;100463488;10134;79057;54552;6906;340547;30014;415;5255;680;158809;6990;4435;5475;340529;65109;64860;7030;729428;8776;4675;5030;51566;729201;56271;4943;79917;85012;114928;5256;26609;54960;538;6853;5365;4354;286451;29934;10838;139221;9189;347404;6473;3251;286464;158931;139793;100008586;2717;3052;5973;139065;5199;546;5613;51270;139231;9131;7547;474381;257240;11254;27238;64102;2543;158747;2273;56474;5165;64648;54440;140597;5631;728239;3188;100130086;5251;8237;286527;100130302,815
1,1,X,168547,155233731,155065184,23096;64061;392509;10214;170685;23157;727837;55998;23439;729431;10916;158586;55859;331;3423;54830;4168;6901;5358;92002;27344;729447;54328;266740;9075;102723737;7552;729422;54954;84460;389874;56000;340562;644538;92552;254158;79649;56850;8225;2824;100272147;51186;3149;26576;100130361;1730;347541;139425;3547;728695;729408;79921;57826;59272;203413;2986;7512;9737;8544;55634;2857;3421;537;11013;340554;5716;6658;4101;54457;1438;91966;441519;4100;5931;27316;7403;4534;6839;51480;728096;27112;92129;101928917;140462;8241;6567;827;203569;27301;84548;645037;54413;100133053;7355;254065;79836;10084;347442;60343;51765;55593;139818;56180;6303;8269;142684;7626;10046;8409;203447;63932;2710;4515;8406;51248;56001;51616;2925;100130613;2564;1193;100132994;5354;11043;340533;22;3476;84631;26748;11238;203562;102723631;170261;58526;441525;4983;29944;6907;1536;2539;1478;9468;23597;2187;1287;81887;6611;3561;9767;9282;54857;347365;10800;139341;54539;11219;728062;169966;51209;23630;26548;1121;2000;645188;51438;2846;280658;1852;347344;23229;10857;56157;286430;101059915;438;5277;9758;1069;4674;154796;56548;51309;1184;645073;80712;1774;10245;2258;728343;9823;441531;11141;643311;90121;256643;23676;4114;6758;4107;286499;5009;1654;1831;51284;94121;170302;11230;79135;286410;9210;2491;441490;84187;633;6191;64743;4110;3598;389856;7789;55787;9452;50814;2157;139422;170062;57187;139067;4104;203427;4693;5456;10013;1964;55190;100996648;293;9016;100528062;30011;90316;93953;10178;6322;28952;24137;2332;4105;6845;94122;84968;64663;1538;9142;286530;2245;5634;9506;79576;3266;139212;5207;6535;8227;393;389852;170626;91851;27334;158866;550643;159013;407;7224;55796;10761;100132963;168400;4281;158835;24140;8471;90167;7737;7319;10149;11279;6134;64109;1678;139322;5063;55906;116442;84443;27197;8233;548313;6872;27018;100129239;139105;7102;10549;26071;2664;59353;8573;28985;79184;728049;728090;158521;3581;139886;282808;8263;9130;728082;778;90843;1756;5422;7317;5935;347454;29071;207063;4112;412;158506;340602;30848;5127;22866;93380;159091;10159;212;139285;9338;85417;8266;100132399;158584;494118;190;7569;89801;2892;1968;5230;57232;55559;57529;8277;63035;80231;286436;25975;51311;8905;55086;139735;395;83692;171484;10251;169981;1349;63904;139716;257397;142689;80258;27035;1641;55613;7105;100329135;84295;9459;4810;404281;4109;367;474384;6748;139760;347487;92745;158830;53344;4103;9203;139378;186;474343;2719;3597;140456;9248;402415;203430;9185;90161;728042;4129;65267;56849;8228;8226;728036;7114;6399;4952;83740;84889;8481;6757;347468;347475;414;6759;9500;51132;8823;541578;2158;55609;2556;494119;6756;9502;158880;8517;8242;474383;57595;51442;389895;100132304;9754;80311;6102;27328;695;56159;51213;90737;60506;10943;100873985;57526;728269;170082;474382;102723680;728656;3358;8273;83844;114824;389840;170067;81557;80823;8862;2002;7216;79979;158763;23641;55217;8270;57477;7592;2833;425054;340526;727866;139599;139804;54470;8450;959;139562;645864;10075;117154;57631;2010;54521;79589;51634;3750;653282;728072;7076;392490;9363;8623;3920;347411;7454;100506164;265;90293;645051;100529097;55511;158724;6197;203547;139135;5355;347516;203522;139081;6451;27336;158787;728458;7499;4841;347517;51360;340578;139596;1896;441509;54466;660;158798;4108;171482;79868;728075;158833;79366;1821;56156;392465;1260;5160;56062;5303;3054;51260;139628;653220;340596;554;28986;23133;57393;2623;28227;4113;57692;50945;3730;7739;100131755;57481;8260;139170;64219;4204;389860;2574;3563;65991;10325;6170;10813;79710;8712;26280;2316;256714;10742;6173;9104;494197;29057;139324;442444;6103;54880;90736;55558;2742;1736;369;255313;3654;170627;645974;3897;79983;727940;541466;347527;8243;4007;139741;29978;2182;7504;60401;84707;53336;1485;159090;94056;57502;55285;653067;1046;11152;641339;1947;8852;7712;23708;203523;4267;54967;340542;89885;2277;83550;644353;55916;340595;6594;139189;63947;9643;9843;4935;139728;100288814;10479;50943;53940;55026;100507170;5638;4478;8239;4068;51114;139411;246100;9968;84679;115201;100533997;1741;416;64840;10682;11326;25763;27330;171483;8908;27286;1038;7543;158800;90060;1288;84061;215;6247;292;55879;401612;1183;340527;55344;29935;158983;357;10009;2747;2652;286514;340543;54885;100129407;10495;6792;79742;140886;2239;2334;4128;441518;139604;4303;55869;25878;4115;11040;8473;6855;84636;55922;728712;5956;2705;55841;54821;729396;441521;8933;10735;729442;9949;4694;84528;51481;492;3028;100129520;795;10389;83604;7411;9947;9367;100463488;10134;79057;54552;6906;340547;30014;415;5255;680;158809;6990;4435;5475;340529;65109;64860;7030;729428;8776;4675;5030;51566;729201;56271;4943;79917;85012;114928;5256;26609;54960;538;6853;5365;4354;286451;29934;10838;139221;9189;347404;6473;3251;286464;158931;139793;100008586;2717;3052;5973;139065;5199;546;5613;51270;139231;9131;7547;474381;257240;11254;27238;64102;2543;158747;2273;56474;5165;64648;54440;140597;5631;728239;3188;100130086;5251;8237;286527;100130302,815
-1,1,X,168547,155233731,155065184,23096;64061;392509;10214;170685;23157;727837;55998;23439;729431;10916;158586;55859;331;3423;54830;4168;6901;5358;92002;27344;729447;54328;266740;9075;102723737;7552;729422;54954;84460;389874;56000;340562;644538;92552;254158;79649;56850;8225;2824;100272147;51186;3149;26576;100130361;1730;347541;139425;3547;728695;729408;79921;57826;59272;203413;2986;7512;9737;8544;55634;2857;3421;537;11013;340554;5716;6658;4101;54457;1438;91966;441519;4100;5931;27316;7403;4534;6839;51480;728096;27112;92129;101928917;140462;8241;6567;827;203569;27301;84548;645037;54413;100133053;7355;254065;79836;10084;347442;60343;51765;55593;139818;56180;6303;8269;142684;7626;10046;8409;203447;63932;2710;4515;8406;51248;56001;51616;2925;100130613;2564;1193;100132994;5354;11043;340533;22;3476;84631;26748;11238;203562;102723631;170261;58526;441525;4983;29944;6907;1536;2539;1478;9468;23597;2187;1287;81887;6611;3561;9767;9282;54857;347365;10800;139341;54539;11219;728062;169966;51209;23630;26548;1121;2000;645188;51438;2846;280658;1852;347344;23229;10857;56157;286430;101059915;438;5277;9758;1069;4674;154796;56548;51309;1184;645073;80712;1774;10245;2258;728343;9823;441531;11141;643311;90121;256643;23676;4114;6758;4107;286499;5009;1654;1831;51284;94121;170302;11230;79135;286410;9210;2491;441490;84187;633;6191;64743;4110;3598;389856;7789;55787;9452;50814;2157;139422;170062;57187;139067;4104;203427;4693;5456;10013;1964;55190;100996648;293;9016;100528062;30011;90316;93953;10178;6322;28952;24137;2332;4105;6845;94122;84968;64663;1538;9142;286530;2245;5634;9506;79576;3266;139212;5207;6535;8227;393;389852;170626;91851;27334;158866;550643;159013;407;7224;55796;10761;100132963;168400;4281;158835;24140;8471;90167;7737;7319;10149;11279;6134;64109;1678;139322;5063;55906;116442;84443;27197;8233;548313;6872;27018;100129239;139105;7102;10549;26071;2664;59353;8573;28985;79184;728049;728090;158521;3581;139886;282808;8263;9130;728082;778;90843;1756;5422;7317;5935;347454;29071;207063;4112;412;158506;340602;30848;5127;22866;93380;159091;10159;212;139285;9338;85417;8266;100132399;158584;494118;190;7569;89801;2892;1968;5230;57232;55559;57529;8277;63035;80231;286436;25975;51311;8905;55086;139735;395;83692;171484;10251;169981;1349;63904;139716;257397;142689;80258;27035;1641;55613;7105;100329135;84295;9459;4810;404281;4109;367;474384;6748;139760;347487;92745;158830;53344;4103;9203;139378;186;474343;2719;3597;140456;9248;402415;203430;9185;90161;728042;4129;65267;56849;8228;8226;728036;7114;6399;4952;83740;84889;8481;6757;347468;347475;414;6759;9500;51132;8823;541578;2158;55609;2556;494119;6756;9502;158880;8517;8242;474383;57595;51442;389895;100132304;9754;80311;6102;27328;695;56159;51213;90737;60506;10943;100873985;57526;728269;170082;474382;102723680;728656;3358;8273;83844;114824;389840;170067;81557;80823;8862;2002;7216;79979;158763;23641;55217;8270;57477;7592;2833;425054;340526;727866;139599;139804;54470;8450;959;139562;645864;10075;117154;57631;2010;54521;79589;51634;3750;653282;728072;7076;392490;9363;8623;3920;347411;7454;100506164;265;90293;645051;100529097;55511;158724;6197;203547;139135;5355;347516;203522;139081;6451;27336;158787;728458;7499;4841;347517;51360;340578;139596;1896;441509;54466;660;158798;4108;171482;79868;728075;158833;79366;1821;56156;392465;1260;5160;56062;5303;3054;51260;139628;653220;340596;554;28986;23133;57393;2623;28227;4113;57692;50945;3730;7739;100131755;57481;8260;139170;64219;4204;389860;2574;3563;65991;10325;6170;10813;79710;8712;26280;2316;256714;10742;6173;9104;494197;29057;139324;442444;6103;54880;90736;55558;2742;1736;369;255313;3654;170627;645974;3897;79983;727940;541466;347527;8243;4007;139741;29978;2182;7504;60401;84707;53336;1485;159090;94056;57502;55285;653067;1046;11152;641339;1947;8852;7712;23708;203523;4267;54967;340542;89885;2277;83550;644353;55916;340595;6594;139189;63947;9643;9843;4935;139728;100288814;10479;50943;53940;55026;100507170;5638;4478;8239;4068;51114;139411;246100;9968;84679;115201;100533997;1741;416;64840;10682;11326;25763;27330;171483;8908;27286;1038;7543;158800;90060;1288;84061;215;6247;292;55879;401612;1183;340527;55344;29935;158983;357;10009;2747;2652;286514;340543;54885;100129407;10495;6792;79742;140886;2239;2334;4128;441518;139604;4303;55869;25878;4115;11040;8473;6855;84636;55922;728712;5956;2705;55841;54821;729396;441521;8933;10735;729442;9949;4694;84528;51481;492;3028;100129520;795;10389;83604;7411;9947;9367;100463488;10134;79057;54552;6906;340547;30014;415;5255;680;158809;6990;4435;5475;340529;65109;64860;7030;729428;8776;4675;5030;51566;729201;56271;4943;79917;85012;114928;5256;26609;54960;538;6853;5365;4354;286451;29934;10838;139221;9189;347404;6473;3251;286464;158931;139793;100008586;2717;3052;5973;139065;5199;546;5613;51270;139231;9131;7547;474381;257240;11254;27238;64102;2543;158747;2273;56474;5165;64648;54440;140597;5631;728239;3188;100130086;5251;8237;286527;100130302,815
1,1,X,168547,155233731,155065184,23096;64061;392509;10214;170685;23157;727837;55998;23439;729431;10916;158586;55859;331;3423;54830;4168;6901;5358;92002;27344;729447;54328;266740;9075;102723737;7552;729422;54954;84460;389874;56000;340562;644538;92552;254158;79649;56850;8225;2824;100272147;51186;3149;26576;100130361;1730;347541;139425;3547;728695;729408;79921;57826;59272;203413;2986;7512;9737;8544;55634;2857;3421;537;11013;340554;5716;6658;4101;54457;1438;91966;441519;4100;5931;27316;7403;4534;6839;51480;728096;27112;92129;101928917;140462;8241;6567;827;203569;27301;84548;645037;54413;100133053;7355;254065;79836;10084;347442;60343;51765;55593;139818;56180;6303;8269;142684;7626;10046;8409;203447;63932;2710;4515;8406;51248;56001;51616;2925;100130613;2564;1193;100132994;5354;11043;340533;22;3476;84631;26748;11238;203562;102723631;170261;58526;441525;4983;29944;6907;1536;2539;1478;9468;23597;2187;1287;81887;6611;3561;9767;9282;54857;347365;10800;139341;54539;11219;728062;169966;51209;23630;26548;1121;2000;645188;51438;2846;280658;1852;347344;23229;10857;56157;286430;101059915;438;5277;9758;1069;4674;154796;56548;51309;1184;645073;80712;1774;10245;2258;728343;9823;441531;11141;643311;90121;256643;23676;4114;6758;4107;286499;5009;1654;1831;51284;94121;170302;11230;79135;286410;9210;2491;441490;84187;633;6191;64743;4110;3598;389856;7789;55787;9452;50814;2157;139422;170062;57187;139067;4104;203427;4693;5456;10013;1964;55190;100996648;293;9016;100528062;30011;90316;93953;10178;6322;28952;24137;2332;4105;6845;94122;84968;64663;1538;9142;286530;2245;5634;9506;79576;3266;139212;5207;6535;8227;393;389852;170626;91851;27334;158866;550643;159013;407;7224;55796;10761;100132963;168400;4281;158835;24140;8471;90167;7737;7319;10149;11279;6134;64109;1678;139322;5063;55906;116442;84443;27197;8233;548313;6872;27018;100129239;139105;7102;10549;26071;2664;59353;8573;28985;79184;728049;728090;158521;3581;139886;282808;8263;9130;728082;778;90843;1756;5422;7317;5935;347454;29071;207063;4112;412;158506;340602;30848;5127;22866;93380;159091;10159;212;139285;9338;85417;8266;100132399;158584;494118;190;7569;89801;2892;1968;5230;57232;55559;57529;8277;63035;80231;286436;25975;51311;8905;55086;139735;395;83692;171484;10251;169981;1349;63904;139716;257397;142689;80258;27035;1641;55613;7105;100329135;84295;9459;4810;404281;4109;367;474384;6748;139760;347487;92745;158830;53344;4103;9203;139378;186;474343;2719;3597;140456;9248;402415;203430;9185;90161;728042;4129;65267;56849;8228;8226;728036;7114;6399;4952;83740;84889;8481;6757;347468;347475;414;6759;9500;51132;8823;541578;2158;55609;2556;494119;6756;9502;158880;8517;8242;474383;57595;51442;389895;100132304;9754;80311;6102;27328;695;56159;51213;90737;60506;10943;100873985;57526;728269;170082;474382;102723680;728656;3358;8273;83844;114824;389840;170067;81557;80823;8862;2002;7216;79979;158763;23641;55217;8270;57477;7592;2833;425054;340526;727866;139599;139804;54470;8450;959;139562;645864;10075;117154;57631;2010;54521;79589;51634;3750;653282;728072;7076;392490;9363;8623;3920;347411;7454;100506164;265;90293;645051;100529097;55511;158724;6197;203547;139135;5355;347516;203522;139081;6451;27336;158787;728458;7499;4841;347517;51360;340578;139596;1896;441509;54466;660;158798;4108;171482;79868;728075;158833;79366;1821;56156;392465;1260;5160;56062;5303;3054;51260;139628;653220;340596;554;28986;23133;57393;2623;28227;4113;57692;50945;3730;7739;100131755;57481;8260;139170;64219;4204;389860;2574;3563;65991;10325;6170;10813;79710;8712;26280;2316;256714;10742;6173;9104;494197;29057;139324;442444;6103;54880;90736;55558;2742;1736;369;255313;3654;170627;645974;3897;79983;727940;541466;347527;8243;4007;139741;29978;2182;7504;60401;84707;53336;1485;159090;94056;57502;55285;653067;1046;11152;641339;1947;8852;7712;23708;203523;4267;54967;340542;89885;2277;83550;644353;55916;340595;6594;139189;63947;9643;9843;4935;139728;100288814;10479;50943;53940;55026;100507170;5638;4478;8239;4068;51114;139411;246100;9968;84679;115201;100533997;1741;416;64840;10682;11326;25763;27330;171483;8908;27286;1038;7543;158800;90060;1288;84061;215;6247;292;55879;401612;1183;340527;55344;29935;158983;357;10009;2747;2652;286514;340543;54885;100129407;10495;6792;79742;140886;2239;2334;4128;441518;139604;4303;55869;25878;4115;11040;8473;6855;84636;55922;728712;5956;2705;55841;54821;729396;441521;8933;10735;729442;9949;4694;84528;51481;492;3028;100129520;795;10389;83604;7411;9947;9367;100463488;10134;79057;54552;6906;340547;30014;415;5255;680;158809;6990;4435;5475;340529;65109;64860;7030;729428;8776;4675;5030;51566;729201;56271;4943;79917;85012;114928;5256;26609;54960;538;6853;5365;4354;286451;29934;10838;139221;9189;347404;6473;3251;286464;158931;139793;100008586;2717;3052;5973;139065;5199;546;5613;51270;139231;9131;7547;474381;257240;11254;27238;64102;2543;158747;2273;56474;5165;64648;54440;140597;5631;728239;3188;100130086;5251;8237;286527;100130302,815
1,1,X,168547,155233731,155065184,23096;64061;392509;10214;170685;23157;727837;55998;23439;729431;10916;158586;55859;331;3423;54830;4168;6901;5358;92002;27344;729447;54328;266740;9075;102723737;7552;729422;54954;84460;389874;56000;340562;644538;92552;254158;79649;56850;8225;2824;100272147;51186;3149;26576;100130361;1730;347541;139425;3547;728695;729408;79921;57826;59272;203413;2986;7512;9737;8544;55634;2857;3421;537;11013;340554;5716;6658;4101;54457;1438;91966;441519;4100;5931;27316;7403;4534;6839;51480;728096;27112;92129;101928917;140462;8241;6567;827;203569;27301;84548;645037;54413;100133053;7355;254065;79836;10084;347442;60343;51765;55593;139818;56180;6303;8269;142684;7626;10046;8409;203447;63932;2710;4515;8406;51248;56001;51616;2925;100130613;2564;1193;100132994;5354;11043;340533;22;3476;84631;26748;11238;203562;102723631;170261;58526;441525;4983;29944;6907;1536;2539;1478;9468;23597;2187;1287;81887;6611;3561;9767;9282;54857;347365;10800;139341;54539;11219;728062;169966;51209;23630;26548;1121;2000;645188;51438;2846;280658;1852;347344;23229;10857;56157;286430;101059915;438;5277;9758;1069;4674;154796;56548;51309;1184;645073;80712;1774;10245;2258;728343;9823;441531;11141;643311;90121;256643;23676;4114;6758;4107;286499;5009;1654;1831;51284;94121;170302;11230;79135;286410;9210;2491;441490;84187;633;6191;64743;4110;3598;389856;7789;55787;9452;50814;2157;139422;170062;57187;139067;4104;203427;4693;5456;10013;1964;55190;100996648;293;9016;100528062;30011;90316;93953;10178;6322;28952;24137;2332;4105;6845;94122;84968;64663;1538;9142;286530;2245;5634;9506;79576;3266;139212;5207;6535;8227;393;389852;170626;91851;27334;158866;550643;159013;407;7224;55796;10761;100132963;168400;4281;158835;24140;8471;90167;7737;7319;10149;11279;6134;64109;1678;139322;5063;55906;116442;84443;27197;8233;548313;6872;27018;100129239;139105;7102;10549;26071;2664;59353;8573;28985;79184;728049;728090;158521;3581;139886;282808;8263;9130;728082;778;90843;1756;5422;7317;5935;347454;29071;207063;4112;412;158506;340602;30848;5127;22866;93380;159091;10159;212;139285;9338;85417;8266;100132399;158584;494118;190;7569;89801;2892;1968;5230;57232;55559;57529;8277;63035;80231;286436;25975;51311;8905;55086;139735;395;83692;171484;10251;169981;1349;63904;139716;257397;142689;80258;27035;1641;55613;7105;100329135;84295;9459;4810;404281;4109;367;474384;6748;139760;347487;92745;158830;53344;4103;9203;139378;186;474343;2719;3597;140456;9248;402415;203430;9185;90161;728042;4129;65267;56849;8228;8226;728036;7114;6399;4952;83740;84889;8481;6757;347468;347475;414;6759;9500;51132;8823;541578;2158;55609;2556;494119;6756;9502;158880;8517;8242;474383;57595;51442;389895;100132304;9754;80311;6102;27328;695;56159;51213;90737;60506;10943;100873985;57526;728269;170082;474382;102723680;728656;3358;8273;83844;114824;389840;170067;81557;80823;8862;2002;7216;79979;158763;23641;55217;8270;57477;7592;2833;425054;340526;727866;139599;139804;54470;8450;959;139562;645864;10075;117154;57631;2010;54521;79589;51634;3750;653282;728072;7076;392490;9363;8623;3920;347411;7454;100506164;265;90293;645051;100529097;55511;158724;6197;203547;139135;5355;347516;203522;139081;6451;27336;158787;728458;7499;4841;347517;51360;340578;139596;1896;441509;54466;660;158798;4108;171482;79868;728075;158833;79366;1821;56156;392465;1260;5160;56062;5303;3054;51260;139628;653220;340596;554;28986;23133;57393;2623;28227;4113;57692;50945;3730;7739;100131755;57481;8260;139170;64219;4204;389860;2574;3563;65991;10325;6170;10813;79710;8712;26280;2316;256714;10742;6173;9104;494197;29057;139324;442444;6103;54880;90736;55558;2742;1736;369;255313;3654;170627;645974;3897;79983;727940;541466;347527;8243;4007;139741;29978;2182;7504;60401;84707;53336;1485;159090;94056;57502;55285;653067;1046;11152;641339;1947;8852;7712;23708;203523;4267;54967;340542;89885;2277;83550;644353;55916;340595;6594;139189;63947;9643;9843;4935;139728;100288814;10479;50943;53940;55026;100507170;5638;4478;8239;4068;51114;139411;246100;9968;84679;115201;100533997;1741;416;64840;10682;11326;25763;27330;171483;8908;27286;1038;7543;158800;90060;1288;84061;215;6247;292;55879;401612;1183;340527;55344;29935;158983;357;10009;2747;2652;286514;340543;54885;100129407;10495;6792;79742;140886;2239;2334;4128;441518;139604;4303;55869;25878;4115;11040;8473;6855;84636;55922;728712;5956;2705;55841;54821;729396;441521;8933;10735;729442;9949;4694;84528;51481;492;3028;100129520;795;10389;83604;7411;9947;9367;100463488;10134;79057;54552;6906;340547;30014;415;5255;680;158809;6990;4435;5475;340529;65109;64860;7030;729428;8776;4675;5030;51566;729201;56271;4943;79917;85012;114928;5256;26609;54960;538;6853;5365;4354;286451;29934;10838;139221;9189;347404;6473;3251;286464;158931;139793;100008586;2717;3052;5973;139065;5199;546;5613;51270;139231;9131;7547;474381;257240;11254;27238;64102;2543;158747;2273;56474;5165;64648;54440;140597;5631;728239;3188;100130086;5251;8237;286527;100130302,815
1,1,X,168547,155233731,155065184,23096;64061;392509;10214;170685;23157;727837;55998;23439;729431;10916;158586;55859;331;3423;54830;4168;6901;5358;92002;27344;729447;54328;266740;9075;102723737;7552;729422;54954;84460;389874;56000;340562;644538;92552;254158;79649;56850;8225;2824;100272147;51186;3149;26576;100130361;1730;347541;139425;3547;728695;729408;79921;57826;59272;203413;2986;7512;9737;8544;55634;2857;3421;537;11013;340554;5716;6658;4101;54457;1438;91966;441519;4100;5931;27316;7403;4534;6839;51480;728096;27112;92129;101928917;140462;8241;6567;827;203569;27301;84548;645037;54413;100133053;7355;254065;79836;10084;347442;60343;51765;55593;139818;56180;6303;8269;142684;7626;10046;8409;203447;63932;2710;4515;8406;51248;56001;51616;2925;100130613;2564;1193;100132994;5354;11043;340533;22;3476;84631;26748;11238;203562;102723631;170261;58526;441525;4983;29944;6907;1536;2539;1478;9468;23597;2187;1287;81887;6611;3561;9767;9282;54857;347365;10800;139341;54539;11219;728062;169966;51209;23630;26548;1121;2000;645188;51438;2846;280658;1852;347344;23229;10857;56157;286430;101059915;438;5277;9758;1069;4674;154796;56548;51309;1184;645073;80712;1774;10245;2258;728343;9823;441531;11141;643311;90121;256643;23676;4114;6758;4107;286499;5009;1654;1831;51284;94121;170302;11230;79135;286410;9210;2491;441490;84187;633;6191;64743;4110;3598;389856;7789;55787;9452;50814;2157;139422;170062;57187;139067;4104;203427;4693;5456;10013;1964;55190;100996648;293;9016;100528062;30011;90316;93953;10178;6322;28952;24137;2332;4105;6845;94122;84968;64663;1538;9142;286530;2245;5634;9506;79576;3266;139212;5207;6535;8227;393;389852;170626;91851;27334;158866;550643;159013;407;7224;55796;10761;100132963;168400;4281;158835;24140;8471;90167;7737;7319;10149;11279;6134;64109;1678;139322;5063;55906;116442;84443;27197;8233;548313;6872;27018;100129239;139105;7102;10549;26071;2664;59353;8573;28985;79184;728049;728090;158521;3581;139886;282808;8263;9130;728082;778;90843;1756;5422;7317;5935;347454;29071;207063;4112;412;158506;340602;30848;5127;22866;93380;159091;10159;212;139285;9338;85417;8266;100132399;158584;494118;190;7569;89801;2892;1968;5230;57232;55559;57529;8277;63035;80231;286436;25975;51311;8905;55086;139735;395;83692;171484;10251;169981;1349;63904;139716;257397;142689;80258;27035;1641;55613;7105;100329135;84295;9459;4810;404281;4109;367;474384;6748;139760;347487;92745;158830;53344;4103;9203;139378;186;474343;2719;3597;140456;9248;402415;203430;9185;90161;728042;4129;65267;56849;8228;8226;728036;7114;6399;4952;83740;84889;8481;6757;347468;347475;414;6759;9500;51132;8823;541578;2158;55609;2556;494119;6756;9502;158880;8517;8242;474383;57595;51442;389895;100132304;9754;80311;6102;27328;695;56159;51213;90737;60506;10943;100873985;57526;728269;170082;474382;102723680;728656;3358;8273;83844;114824;389840;170067;81557;80823;8862;2002;7216;79979;158763;23641;55217;8270;57477;7592;2833;425054;340526;727866;139599;139804;54470;8450;959;139562;645864;10075;117154;57631;2010;54521;79589;51634;3750;653282;728072;7076;392490;9363;8623;3920;347411;7454;100506164;265;90293;645051;100529097;55511;158724;6197;203547;139135;5355;347516;203522;139081;6451;27336;158787;728458;7499;4841;347517;51360;340578;139596;1896;441509;54466;660;158798;4108;171482;79868;728075;158833;79366;1821;56156;392465;1260;5160;56062;5303;3054;51260;139628;653220;340596;554;28986;23133;57393;2623;28227;4113;57692;50945;3730;7739;100131755;57481;8260;139170;64219;4204;389860;2574;3563;65991;10325;6170;10813;79710;8712;26280;2316;256714;10742;6173;9104;494197;29057;139324;442444;6103;54880;90736;55558;2742;1736;369;255313;3654;170627;645974;3897;79983;727940;541466;347527;8243;4007;139741;29978;2182;7504;60401;84707;53336;1485;159090;94056;57502;55285;653067;1046;11152;641339;1947;8852;7712;23708;203523;4267;54967;340542;89885;2277;83550;644353;55916;340595;6594;139189;63947;9643;9843;4935;139728;100288814;10479;50943;53940;55026;100507170;5638;4478;8239;4068;51114;139411;246100;9968;84679;115201;100533997;1741;416;64840;10682;11326;25763;27330;171483;8908;27286;1038;7543;158800;90060;1288;84061;215;6247;292;55879;401612;1183;340527;55344;29935;158983;357;10009;2747;2652;286514;340543;54885;100129407;10495;6792;79742;140886;2239;2334;4128;441518;139604;4303;55869;25878;4115;11040;8473;6855;84636;55922;728712;5956;2705;55841;54821;729396;441521;8933;10735;729442;9949;4694;84528;51481;492;3028;100129520;795;10389;83604;7411;9947;9367;100463488;10134;79057;54552;6906;340547;30014;415;5255;680;158809;6990;4435;5475;340529;65109;64860;7030;729428;8776;4675;5030;51566;729201;56271;4943;79917;85012;114928;5256;26609;54960;538;6853;5365;4354;286451;29934;10838;139221;9189;347404;6473;3251;286464;158931;139793;100008586;2717;3052;5973;139065;5199;546;5613;51270;139231;9131;7547;474381;257240;11254;27238;64102;2543;158747;2273;56474;5165;64648;54440;140597;5631;728239;3188;100130086;5251;8237;286527;100130302,815
-1,1,X,168547,155233731,155065184,23096;64061;392509;10214;170685;23157;727837;55998;23439;729431;10916;158586;55859;331;3423;54830;4168;6901;5358;92002;27344;729447;54328;266740;9075;102723737;7552;729422;54954;84460;389874;56000;340562;644538;92552;254158;79649;56850;8225;2824;100272147;51186;3149;26576;100130361;1730;347541;139425;3547;728695;729408;79921;57826;59272;203413;2986;7512;9737;8544;55634;2857;3421;537;11013;340554;5716;6658;4101;54457;1438;91966;441519;4100;5931;27316;7403;4534;6839;51480;728096;27112;92129;101928917;140462;8241;6567;827;203569;27301;84548;645037;54413;100133053;7355;254065;79836;10084;347442;60343;51765;55593;139818;56180;6303;8269;142684;7626;10046;8409;203447;63932;2710;4515;8406;51248;56001;51616;2925;100130613;2564;1193;100132994;5354;11043;340533;22;3476;84631;26748;11238;203562;102723631;170261;58526;441525;4983;29944;6907;1536;2539;1478;9468;23597;2187;1287;81887;6611;3561;9767;9282;54857;347365;10800;139341;54539;11219;728062;169966;51209;23630;26548;1121;2000;645188;51438;2846;280658;1852;347344;23229;10857;56157;286430;101059915;438;5277;9758;1069;4674;154796;56548;51309;1184;645073;80712;1774;10245;2258;728343;9823;441531;11141;643311;90121;256643;23676;4114;6758;4107;286499;5009;1654;1831;51284;94121;170302;11230;79135;286410;9210;2491;441490;84187;633;6191;64743;4110;3598;389856;7789;55787;9452;50814;2157;139422;170062;57187;139067;4104;203427;4693;5456;10013;1964;55190;100996648;293;9016;100528062;30011;90316;93953;10178;6322;28952;24137;2332;4105;6845;94122;84968;64663;1538;9142;286530;2245;5634;9506;79576;3266;139212;5207;6535;8227;393;389852;170626;91851;27334;158866;550643;159013;407;7224;55796;10761;100132963;168400;4281;158835;24140;8471;90167;7737;7319;10149;11279;6134;64109;1678;139322;5063;55906;116442;84443;27197;8233;548313;6872;27018;100129239;139105;7102;10549;26071;2664;59353;8573;28985;79184;728049;728090;158521;3581;139886;282808;8263;9130;728082;778;90843;1756;5422;7317;5935;347454;29071;207063;4112;412;158506;340602;30848;5127;22866;93380;159091;10159;212;139285;9338;85417;8266;100132399;158584;494118;190;7569;89801;2892;1968;5230;57232;55559;57529;8277;63035;80231;286436;25975;51311;8905;55086;139735;395;83692;171484;10251;169981;1349;63904;139716;257397;142689;80258;27035;1641;55613;7105;100329135;84295;9459;4810;404281;4109;367;474384;6748;139760;347487;92745;158830;53344;4103;9203;139378;186;474343;2719;3597;140456;9248;402415;203430;9185;90161;728042;4129;65267;56849;8228;8226;728036;7114;6399;4952;83740;84889;8481;6757;347468;347475;414;6759;9500;51132;8823;541578;2158;55609;2556;494119;6756;9502;158880;8517;8242;474383;57595;51442;389895;100132304;9754;80311;6102;27328;695;56159;51213;90737;60506;10943;100873985;57526;728269;170082;474382;102723680;728656;3358;8273;83844;114824;389840;170067;81557;80823;8862;2002;7216;79979;158763;23641;55217;8270;57477;7592;2833;425054;340526;727866;139599;139804;54470;8450;959;139562;645864;10075;117154;57631;2010;54521;79589;51634;3750;653282;728072;7076;392490;9363;8623;3920;347411;7454;100506164;265;90293;645051;100529097;55511;158724;6197;203547;139135;5355;347516;203522;139081;6451;27336;158787;728458;7499;4841;347517;51360;340578;139596;1896;441509;54466;660;158798;4108;171482;79868;728075;158833;79366;1821;56156;392465;1260;5160;56062;5303;3054;51260;139628;653220;340596;554;28986;23133;57393;2623;28227;4113;57692;50945;3730;7739;100131755;57481;8260;139170;64219;4204;389860;2574;3563;65991;10325;6170;10813;79710;8712;26280;2316;256714;10742;6173;9104;494197;29057;139324;442444;6103;54880;90736;55558;2742;1736;369;255313;3654;170627;645974;3897;79983;727940;541466;347527;8243;4007;139741;29978;2182;7504;60401;84707;53336;1485;159090;94056;57502;55285;653067;1046;11152;641339;1947;8852;7712;23708;203523;4267;54967;340542;89885;2277;83550;644353;55916;340595;6594;139189;63947;9643;9843;4935;139728;100288814;10479;50943;53940;55026;100507170;5638;4478;8239;4068;51114;139411;246100;9968;84679;115201;100533997;1741;416;64840;10682;11326;25763;27330;171483;8908;27286;1038;7543;158800;90060;1288;84061;215;6247;292;55879;401612;1183;340527;55344;29935;158983;357;10009;2747;2652;286514;340543;54885;100129407;10495;6792;79742;140886;2239;2334;4128;441518;139604;4303;55869;25878;4115;11040;8473;6855;84636;55922;728712;5956;2705;55841;54821;729396;441521;8933;10735;729442;9949;4694;84528;51481;492;3028;100129520;795;10389;83604;7411;9947;9367;100463488;10134;79057;54552;6906;340547;30014;415;5255;680;158809;6990;4435;5475;340529;65109;64860;7030;729428;8776;4675;5030;51566;729201;56271;4943;79917;85012;114928;5256;26609;54960;538;6853;5365;4354;286451;29934;10838;139221;9189;347404;6473;3251;286464;158931;139793;100008586;2717;3052;5973;139065;5199;546;5613;51270;139231;9131;7547;474381;257240;11254;27238;64102;2543;158747;2273;56474;5165;64648;54440;140597;5631;728239;3188;100130086;5251;8237;286527;100130302,815
1,1,X,168547,155233731,155065184,23096;64061;392509;10214;170685;23157;727837;55998;23439;729431;10916;158586;55859;331;3423;54830;4168;6901;5358;92002;27344;729447;54328;266740;9075;102723737;7552;729422;54954;84460;389874;56000;340562;644538;92552;254158;79649;56850;8225;2824;100272147;51186;3149;26576;100130361;1730;347541;139425;3547;728695;729408;79921;57826;59272;203413;2986;7512;9737;8544;55634;2857;3421;537;11013;340554;5716;6658;4101;54457;1438;91966;441519;4100;5931;27316;7403;4534;6839;51480;728096;27112;92129;101928917;140462;8241;6567;827;203569;27301;84548;645037;54413;100133053;7355;254065;79836;10084;347442;60343;51765;55593;139818;56180;6303;8269;142684;7626;10046;8409;203447;63932;2710;4515;8406;51248;56001;51616;2925;100130613;2564;1193;100132994;5354;11043;340533;22;3476;84631;26748;11238;203562;102723631;170261;58526;441525;4983;29944;6907;1536;2539;1478;9468;23597;2187;1287;81887;6611;3561;9767;9282;54857;347365;10800;139341;54539;11219;728062;169966;51209;23630;26548;1121;2000;645188;51438;2846;280658;1852;347344;23229;10857;56157;286430;101059915;438;5277;9758;1069;4674;154796;56548;51309;1184;645073;80712;1774;10245;2258;728343;9823;441531;11141;643311;90121;256643;23676;4114;6758;4107;286499;5009;1654;1831;51284;94121;170302;11230;79135;286410;9210;2491;441490;84187;633;6191;64743;4110;3598;389856;7789;55787;9452;50814;2157;139422;170062;57187;139067;4104;203427;4693;5456;10013;1964;55190;100996648;293;9016;100528062;30011;90316;93953;10178;6322;28952;24137;2332;4105;6845;94122;84968;64663;1538;9142;286530;2245;5634;9506;79576;3266;139212;5207;6535;8227;393;389852;170626;91851;27334;158866;550643;159013;407;7224;55796;10761;100132963;168400;4281;158835;24140;8471;90167;7737;7319;10149;11279;6134;64109;1678;139322;5063;55906;116442;84443;27197;8233;548313;6872;27018;100129239;139105;7102;10549;26071;2664;59353;8573;28985;79184;728049;728090;158521;3581;139886;282808;8263;9130;728082;778;90843;1756;5422;7317;5935;347454;29071;207063;4112;412;158506;340602;30848;5127;22866;93380;159091;10159;212;139285;9338;85417;8266;100132399;158584;494118;190;7569;89801;2892;1968;5230;57232;55559;57529;8277;63035;80231;286436;25975;51311;8905;55086;139735;395;83692;171484;10251;169981;1349;63904;139716;257397;142689;80258;27035;1641;55613;7105;100329135;84295;9459;4810;404281;4109;367;474384;6748;139760;347487;92745;158830;53344;4103;9203;139378;186;474343;2719;3597;140456;9248;402415;203430;9185;90161;728042;4129;65267;56849;8228;8226;728036;7114;6399;4952;83740;84889;8481;6757;347468;347475;414;6759;9500;51132;8823;541578;2158;55609;2556;494119;6756;9502;158880;8517;8242;474383;57595;51442;389895;100132304;9754;80311;6102;27328;695;56159;51213;90737;60506;10943;100873985;57526;728269;170082;474382;102723680;728656;3358;8273;83844;114824;389840;170067;81557;80823;8862;2002;7216;79979;158763;23641;55217;8270;57477;7592;2833;425054;340526;727866;139599;139804;54470;8450;959;139562;645864;10075;117154;57631;2010;54521;79589;51634;3750;653282;728072;7076;392490;9363;8623;3920;347411;7454;100506164;265;90293;645051;100529097;55511;158724;6197;203547;139135;5355;347516;203522;139081;6451;27336;158787;728458;7499;4841;347517;51360;340578;139596;1896;441509;54466;660;158798;4108;171482;79868;728075;158833;79366;1821;56156;392465;1260;5160;56062;5303;3054;51260;139628;653220;340596;554;28986;23133;57393;2623;28227;4113;57692;50945;3730;7739;100131755;57481;8260;139170;64219;4204;389860;2574;3563;65991;10325;6170;10813;79710;8712;26280;2316;256714;10742;6173;9104;494197;29057;139324;442444;6103;54880;90736;55558;2742;1736;369;255313;3654;170627;645974;3897;79983;727940;541466;347527;8243;4007;139741;29978;2182;7504;60401;84707;53336;1485;159090;94056;57502;55285;653067;1046;11152;641339;1947;8852;7712;23708;203523;4267;54967;340542;89885;2277;83550;644353;55916;340595;6594;139189;63947;9643;9843;4935;139728;100288814;10479;50943;53940;55026;100507170;5638;4478;8239;4068;51114;139411;246100;9968;84679;115201;100533997;1741;416;64840;10682;11326;25763;27330;171483;8908;27286;1038;7543;158800;90060;1288;84061;215;6247;292;55879;401612;1183;340527;55344;29935;158983;357;10009;2747;2652;286514;340543;54885;100129407;10495;6792;79742;140886;2239;2334;4128;441518;139604;4303;55869;25878;4115;11040;8473;6855;84636;55922;728712;5956;2705;55841;54821;729396;441521;8933;10735;729442;9949;4694;84528;51481;492;3028;100129520;795;10389;83604;7411;9947;9367;100463488;10134;79057;54552;6906;340547;30014;415;5255;680;158809;6990;4435;5475;340529;65109;64860;7030;729428;8776;4675;5030;51566;729201;56271;4943;79917;85012;114928;5256;26609;54960;538;6853;5365;4354;286451;29934;10838;139221;9189;347404;6473;3251;286464;158931;139793;100008586;2717;3052;5973;139065;5199;546;5613;51270;139231;9131;7547;474381;257240;11254;27238;64102;2543;158747;2273;56474;5165;64648;54440;140597;5631;728239;3188;100130086;5251;8237;286527;100130302,815
-1,1,X,168547,155233731,155065184,23096;64061;392509;10214;170685;23157;727837;55998;23439;729431;10916;158586;55859;331;3423;54830;4168;6901;5358;92002;27344;729447;54328;266740;9075;102723737;7552;729422;54954;84460;389874;56000;340562;644538;92552;254158;79649;56850;8225;2824;100272147;51186;3149;26576;100130361;1730;347541;139425;3547;728695;729408;79921;57826;59272;203413;2986;7512;9737;8544;55634;2857;3421;537;11013;340554;5716;6658;4101;54457;1438;91966;441519;4100;5931;27316;7403;4534;6839;51480;728096;27112;92129;101928917;140462;8241;6567;827;203569;27301;84548;645037;54413;100133053;7355;254065;79836;10084;347442;60343;51765;55593;139818;56180;6303;8269;142684;7626;10046;8409;203447;63932;2710;4515;8406;51248;56001;51616;2925;100130613;2564;1193;100132994;5354;11043;340533;22;3476;84631;26748;11238;203562;102723631;170261;58526;441525;4983;29944;6907;1536;2539;1478;9468;23597;2187;1287;81887;6611;3561;9767;9282;54857;347365;10800;139341;54539;11219;728062;169966;51209;23630;26548;1121;2000;645188;51438;2846;280658;1852;347344;23229;10857;56157;286430;101059915;438;5277;9758;1069;4674;154796;56548;51309;1184;645073;80712;1774;10245;2258;728343;9823;441531;11141;643311;90121;256643;23676;4114;6758;4107;286499;5009;1654;1831;51284;94121;170302;11230;79135;286410;9210;2491;441490;84187;633;6191;64743;4110;3598;389856;7789;55787;9452;50814;2157;139422;170062;57187;139067;4104;203427;4693;5456;10013;1964;55190;100996648;293;9016;100528062;30011;90316;93953;10178;6322;28952;24137;2332;4105;6845;94122;84968;64663;1538;9142;286530;2245;5634;9506;79576;3266;139212;5207;6535;8227;393;389852;170626;91851;27334;158866;550643;159013;407;7224;55796;10761;100132963;168400;4281;158835;24140;8471;90167;7737;7319;10149;11279;6134;64109;1678;139322;5063;55906;116442;84443;27197;8233;548313;6872;27018;100129239;139105;7102;10549;26071;2664;59353;8573;28985;79184;728049;728090;158521;3581;139886;282808;8263;9130;728082;778;90843;1756;5422;7317;5935;347454;29071;207063;4112;412;158506;340602;30848;5127;22866;93380;159091;10159;212;139285;9338;85417;8266;100132399;158584;494118;190;7569;89801;2892;1968;5230;57232;55559;57529;8277;63035;80231;286436;25975;51311;8905;55086;139735;395;83692;171484;10251;169981;1349;63904;139716;257397;142689;80258;27035;1641;55613;7105;100329135;84295;9459;4810;404281;4109;367;474384;6748;139760;347487;92745;158830;53344;4103;9203;139378;186;474343;2719;3597;140456;9248;402415;203430;9185;90161;728042;4129;65267;56849;8228;8226;728036;7114;6399;4952;83740;84889;8481;6757;347468;347475;414;6759;9500;51132;8823;541578;2158;55609;2556;494119;6756;9502;158880;8517;8242;474383;57595;51442;389895;100132304;9754;80311;6102;27328;695;56159;51213;90737;60506;10943;100873985;57526;728269;170082;474382;102723680;728656;3358;8273;83844;114824;389840;170067;81557;80823;8862;2002;7216;79979;158763;23641;55217;8270;57477;7592;2833;425054;340526;727866;139599;139804;54470;8450;959;139562;645864;10075;117154;57631;2010;54521;79589;51634;3750;653282;728072;7076;392490;9363;8623;3920;347411;7454;100506164;265;90293;645051;100529097;55511;158724;6197;203547;139135;5355;347516;203522;139081;6451;27336;158787;728458;7499;4841;347517;51360;340578;139596;1896;441509;54466;660;158798;4108;171482;79868;728075;158833;79366;1821;56156;392465;1260;5160;56062;5303;3054;51260;139628;653220;340596;554;28986;23133;57393;2623;28227;4113;57692;50945;3730;7739;100131755;57481;8260;139170;64219;4204;389860;2574;3563;65991;10325;6170;10813;79710;8712;26280;2316;256714;10742;6173;9104;494197;29057;139324;442444;6103;54880;90736;55558;2742;1736;369;255313;3654;170627;645974;3897;79983;727940;541466;347527;8243;4007;139741;29978;2182;7504;60401;84707;53336;1485;159090;94056;57502;55285;653067;1046;11152;641339;1947;8852;7712;23708;203523;4267;54967;340542;89885;2277;83550;644353;55916;340595;6594;139189;63947;9643;9843;4935;139728;100288814;10479;50943;53940;55026;100507170;5638;4478;8239;4068;51114;139411;246100;9968;84679;115201;100533997;1741;416;64840;10682;11326;25763;27330;171483;8908;27286;1038;7543;158800;90060;1288;84061;215;6247;292;55879;401612;1183;340527;55344;29935;158983;357;10009;2747;2652;286514;340543;54885;100129407;10495;6792;79742;140886;2239;2334;4128;441518;139604;4303;55869;25878;4115;11040;8473;6855;84636;55922;728712;5956;2705;55841;54821;729396;441521;8933;10735;729442;9949;4694;84528;51481;492;3028;100129520;795;10389;83604;7411;9947;9367;100463488;10134;79057;54552;6906;340547;30014;415;5255;680;158809;6990;4435;5475;340529;65109;64860;7030;729428;8776;4675;5030;51566;729201;56271;4943;79917;85012;114928;5256;26609;54960;538;6853;5365;4354;286451;29934;10838;139221;9189;347404;6473;3251;286464;158931;139793;100008586;2717;3052;5973;139065;5199;546;5613;51270;139231;9131;7547;474381;257240;11254;27238;64102;2543;158747;2273;56474;5165;64648;54440;140597;5631;728239;3188;100130086;5251;8237;286527;100130302,815
1,1,X,168547,155233731,155065184,23096;64061;392509;10214;170685;23157;727837;55998;23439;729431;10916;158586;55859;331;3423;54830;4168;6901;5358;92002;27344;729447;54328;266740;9075;102723737;7552;729422;54954;84460;389874;56000;340562;644538;92552;254158;79649;56850;8225;2824;100272147;51186;3149;26576;100130361;1730;347541;139425;3547;728695;729408;79921;57826;59272;203413;2986;7512;9737;8544;55634;2857;3421;537;11013;340554;5716;6658;4101;54457;1438;91966;441519;4100;5931;27316;7403;4534;6839;51480;728096;27112;92129;101928917;140462;8241;6567;827;203569;27301;84548;645037;54413;100133053;7355;254065;79836;10084;347442;60343;51765;55593;139818;56180;6303;8269;142684;7626;10046;8409;203447;63932;2710;4515;8406;51248;56001;51616;2925;100130613;2564;1193;100132994;5354;11043;340533;22;3476;84631;26748;11238;203562;102723631;170261;58526;441525;4983;29944;6907;1536;2539;1478;9468;23597;2187;1287;81887;6611;3561;9767;9282;54857;347365;10800;139341;54539;11219;728062;169966;51209;23630;26548;1121;2000;645188;51438;2846;280658;1852;347344;23229;10857;56157;286430;101059915;438;5277;9758;1069;4674;154796;56548;51309;1184;645073;80712;1774;10245;2258;728343;9823;441531;11141;643311;90121;256643;23676;4114;6758;4107;286499;5009;1654;1831;51284;94121;170302;11230;79135;286410;9210;2491;441490;84187;633;6191;64743;4110;3598;389856;7789;55787;9452;50814;2157;139422;170062;57187;139067;4104;203427;4693;5456;10013;1964;55190;100996648;293;9016;100528062;30011;90316;93953;10178;6322;28952;24137;2332;4105;6845;94122;84968;64663;1538;9142;286530;2245;5634;9506;79576;3266;139212;5207;6535;8227;393;389852;170626;91851;27334;158866;550643;159013;407;7224;55796;10761;100132963;168400;4281;158835;24140;8471;90167;7737;7319;10149;11279;6134;64109;1678;139322;5063;55906;116442;84443;27197;8233;548313;6872;27018;100129239;139105;7102;10549;26071;2664;59353;8573;28985;79184;728049;728090;158521;3581;139886;282808;8263;9130;728082;778;90843;1756;5422;7317;5935;347454;29071;207063;4112;412;158506;340602;30848;5127;22866;93380;159091;10159;212;139285;9338;85417;8266;100132399;158584;494118;190;7569;89801;2892;1968;5230;57232;55559;57529;8277;63035;80231;286436;25975;51311;8905;55086;139735;395;83692;171484;10251;169981;1349;63904;139716;257397;142689;80258;27035;1641;55613;7105;100329135;84295;9459;4810;404281;4109;367;474384;6748;139760;347487;92745;158830;53344;4103;9203;139378;186;474343;2719;3597;140456;9248;402415;203430;9185;90161;728042;4129;65267;56849;8228;8226;728036;7114;6399;4952;83740;84889;8481;6757;347468;347475;414;6759;9500;51132;8823;541578;2158;55609;2556;494119;6756;9502;158880;8517;8242;474383;57595;51442;389895;100132304;9754;80311;6102;27328;695;56159;51213;90737;60506;10943;100873985;57526;728269;170082;474382;102723680;728656;3358;8273;83844;114824;389840;170067;81557;80823;8862;2002;7216;79979;158763;23641;55217;8270;57477;7592;2833;425054;340526;727866;139599;139804;54470;8450;959;139562;645864;10075;117154;57631;2010;54521;79589;51634;3750;653282;728072;7076;392490;9363;8623;3920;347411;7454;100506164;265;90293;645051;100529097;55511;158724;6197;203547;139135;5355;347516;203522;139081;6451;27336;158787;728458;7499;4841;347517;51360;340578;139596;1896;441509;54466;660;158798;4108;171482;79868;728075;158833;79366;1821;56156;392465;1260;5160;56062;5303;3054;51260;139628;653220;340596;554;28986;23133;57393;2623;28227;4113;57692;50945;3730;7739;100131755;57481;8260;139170;64219;4204;389860;2574;3563;65991;10325;6170;10813;79710;8712;26280;2316;256714;10742;6173;9104;494197;29057;139324;442444;6103;54880;90736;55558;2742;1736;369;255313;3654;170627;645974;3897;79983;727940;541466;347527;8243;4007;139741;29978;2182;7504;60401;84707;53336;1485;159090;94056;57502;55285;653067;1046;11152;641339;1947;8852;7712;23708;203523;4267;54967;340542;89885;2277;83550;644353;55916;340595;6594;139189;63947;9643;9843;4935;139728;100288814;10479;50943;53940;55026;100507170;5638;4478;8239;4068;51114;139411;246100;9968;84679;115201;100533997;1741;416;64840;10682;11326;25763;27330;171483;8908;27286;1038;7543;158800;90060;1288;84061;215;6247;292;55879;401612;1183;340527;55344;29935;158983;357;10009;2747;2652;286514;340543;54885;100129407;10495;6792;79742;140886;2239;2334;4128;441518;139604;4303;55869;25878;4115;11040;8473;6855;84636;55922;728712;5956;2705;55841;54821;729396;441521;8933;10735;729442;9949;4694;84528;51481;492;3028;100129520;795;10389;83604;7411;9947;9367;100463488;10134;79057;54552;6906;340547;30014;415;5255;680;158809;6990;4435;5475;340529;65109;64860;7030;729428;8776;4675;5030;51566;729201;56271;4943;79917;85012;114928;5256;26609;54960;538;6853;5365;4354;286451;29934;10838;139221;9189;347404;6473;3251;286464;158931;139793;100008586;2717;3052;5973;139065;5199;546;5613;51270;139231;9131;7547;474381;257240;11254;27238;64102;2543;158747;2273;56474;5165;64648;54440;140597;5631;728239;3188;100130086;5251;8237;286527;100130302,815
1,1,X,168547,155233731,155065184,23096;64061;392509;10214;170685;23157;727837;55998;23439;729431;10916;158586;55859;331;3423;54830;4168;6901;5358;92002;27344;729447;54328;266740;9075;102723737;7552;729422;54954;84460;389874;56000;340562;644538;92552;254158;79649;56850;8225;2824;100272147;51186;3149;26576;100130361;1730;347541;139425;3547;728695;729408;79921;57826;59272;203413;2986;7512;9737;8544;55634;2857;3421;537;11013;340554;5716;6658;4101;54457;1438;91966;441519;4100;5931;27316;7403;4534;6839;51480;728096;27112;92129;101928917;140462;8241;6567;827;203569;27301;84548;645037;54413;100133053;7355;254065;79836;10084;347442;60343;51765;55593;139818;56180;6303;8269;142684;7626;10046;8409;203447;63932;2710;4515;8406;51248;56001;51616;2925;100130613;2564;1193;100132994;5354;11043;340533;22;3476;84631;26748;11238;203562;102723631;170261;58526;441525;4983;29944;6907;1536;2539;1478;9468;23597;2187;1287;81887;6611;3561;9767;9282;54857;347365;10800;139341;54539;11219;728062;169966;51209;23630;26548;1121;2000;645188;51438;2846;280658;1852;347344;23229;10857;56157;286430;101059915;438;5277;9758;1069;4674;154796;56548;51309;1184;645073;80712;1774;10245;2258;728343;9823;441531;11141;643311;90121;256643;23676;4114;6758;4107;286499;5009;1654;1831;51284;94121;170302;11230;79135;286410;9210;2491;441490;84187;633;6191;64743;4110;3598;389856;7789;55787;9452;50814;2157;139422;170062;57187;139067;4104;203427;4693;5456;10013;1964;55190;100996648;293;9016;100528062;30011;90316;93953;10178;6322;28952;24137;2332;4105;6845;94122;84968;64663;1538;9142;286530;2245;5634;9506;79576;3266;139212;5207;6535;8227;393;389852;170626;91851;27334;158866;550643;159013;407;7224;55796;10761;100132963;168400;4281;158835;24140;8471;90167;7737;7319;10149;11279;6134;64109;1678;139322;5063;55906;116442;84443;27197;8233;548313;6872;27018;100129239;139105;7102;10549;26071;2664;59353;8573;28985;79184;728049;728090;158521;3581;139886;282808;8263;9130;728082;778;90843;1756;5422;7317;5935;347454;29071;207063;4112;412;158506;340602;30848;5127;22866;93380;159091;10159;212;139285;9338;85417;8266;100132399;158584;494118;190;7569;89801;2892;1968;5230;57232;55559;57529;8277;63035;80231;286436;25975;51311;8905;55086;139735;395;83692;171484;10251;169981;1349;63904;139716;257397;142689;80258;27035;1641;55613;7105;100329135;84295;9459;4810;404281;4109;367;474384;6748;139760;347487;92745;158830;53344;4103;9203;139378;186;474343;2719;3597;140456;9248;402415;203430;9185;90161;728042;4129;65267;56849;8228;8226;728036;7114;6399;4952;83740;84889;8481;6757;347468;347475;414;6759;9500;51132;8823;541578;2158;55609;2556;494119;6756;9502;158880;8517;8242;474383;57595;51442;389895;100132304;9754;80311;6102;27328;695;56159;51213;90737;60506;10943;100873985;57526;728269;170082;474382;102723680;728656;3358;8273;83844;114824;389840;170067;81557;80823;8862;2002;7216;79979;158763;23641;55217;8270;57477;7592;2833;425054;340526;727866;139599;139804;54470;8450;959;139562;645864;10075;117154;57631;2010;54521;79589;51634;3750;653282;728072;7076;392490;9363;8623;3920;347411;7454;100506164;265;90293;645051;100529097;55511;158724;6197;203547;139135;5355;347516;203522;139081;6451;27336;158787;728458;7499;4841;347517;51360;340578;139596;1896;441509;54466;660;158798;4108;171482;79868;728075;158833;79366;1821;56156;392465;1260;5160;56062;5303;3054;51260;139628;653220;340596;554;28986;23133;57393;2623;28227;4113;57692;50945;3730;7739;100131755;57481;8260;139170;64219;4204;389860;2574;3563;65991;10325;6170;10813;79710;8712;26280;2316;256714;10742;6173;9104;494197;29057;139324;442444;6103;54880;90736;55558;2742;1736;369;255313;3654;170627;645974;3897;79983;727940;541466;347527;8243;4007;139741;29978;2182;7504;60401;84707;53336;1485;159090;94056;57502;55285;653067;1046;11152;641339;1947;8852;7712;23708;203523;4267;54967;340542;89885;2277;83550;644353;55916;340595;6594;139189;63947;9643;9843;4935;139728;100288814;10479;50943;53940;55026;100507170;5638;4478;8239;4068;51114;139411;246100;9968;84679;115201;100533997;1741;416;64840;10682;11326;25763;27330;171483;8908;27286;1038;7543;158800;90060;1288;84061;215;6247;292;55879;401612;1183;340527;55344;29935;158983;357;10009;2747;2652;286514;340543;54885;100129407;10495;6792;79742;140886;2239;2334;4128;441518;139604;4303;55869;25878;4115;11040;8473;6855;84636;55922;728712;5956;2705;55841;54821;729396;441521;8933;10735;729442;9949;4694;84528;51481;492;3028;100129520;795;10389;83604;7411;9947;9367;100463488;10134;79057;54552;6906;340547;30014;415;5255;680;158809;6990;4435;5475;340529;65109;64860;7030;729428;8776;4675;5030;51566;729201;56271;4943;79917;85012;114928;5256;26609;54960;538;6853;5365;4354;286451;29934;10838;139221;9189;347404;6473;3251;286464;158931;139793;100008586;2717;3052;5973;139065;5199;546;5613;51270;139231;9131;7547;474381;257240;11254;27238;64102;2543;158747;2273;56474;5165;64648;54440;140597;5631;728239;3188;100130086;5251;8237;286527;100130302,815
-1,1,X,168547,155233731,155065184,23096;64061;392509;10214;170685;23157;727837;55998;23439;729431;10916;158586;55859;331;3423;54830;4168;6901;5358;92002;27344;729447;54328;266740;9075;102723737;7552;729422;54954;84460;389874;56000;340562;644538;92552;254158;79649;56850;8225;2824;100272147;51186;3149;26576;100130361;1730;347541;139425;3547;728695;729408;79921;57826;59272;203413;2986;7512;9737;8544;55634;2857;3421;537;11013;340554;5716;6658;4101;54457;1438;91966;441519;4100;5931;27316;7403;4534;6839;51480;728096;27112;92129;101928917;140462;8241;6567;827;203569;27301;84548;645037;54413;100133053;7355;254065;79836;10084;347442;60343;51765;55593;139818;56180;6303;8269;142684;7626;10046;8409;203447;63932;2710;4515;8406;51248;56001;51616;2925;100130613;2564;1193;100132994;5354;11043;340533;22;3476;84631;26748;11238;203562;102723631;170261;58526;441525;4983;29944;6907;1536;2539;1478;9468;23597;2187;1287;81887;6611;3561;9767;9282;54857;347365;10800;139341;54539;11219;728062;169966;51209;23630;26548;1121;2000;645188;51438;2846;280658;1852;347344;23229;10857;56157;286430;101059915;438;5277;9758;1069;4674;154796;56548;51309;1184;645073;80712;1774;10245;2258;728343;9823;441531;11141;643311;90121;256643;23676;4114;6758;4107;286499;5009;1654;1831;51284;94121;170302;11230;79135;286410;9210;2491;441490;84187;633;6191;64743;4110;3598;389856;7789;55787;9452;50814;2157;139422;170062;57187;139067;4104;203427;4693;5456;10013;1964;55190;100996648;293;9016;100528062;30011;90316;93953;10178;6322;28952;24137;2332;4105;6845;94122;84968;64663;1538;9142;286530;2245;5634;9506;79576;3266;139212;5207;6535;8227;393;389852;170626;91851;27334;158866;550643;159013;407;7224;55796;10761;100132963;168400;4281;158835;24140;8471;90167;7737;7319;10149;11279;6134;64109;1678;139322;5063;55906;116442;84443;27197;8233;548313;6872;27018;100129239;139105;7102;10549;26071;2664;59353;8573;28985;79184;728049;728090;158521;3581;139886;282808;8263;9130;728082;778;90843;1756;5422;7317;5935;347454;29071;207063;4112;412;158506;340602;30848;5127;22866;93380;159091;10159;212;139285;9338;85417;8266;100132399;158584;494118;190;7569;89801;2892;1968;5230;57232;55559;57529;8277;63035;80231;286436;25975;51311;8905;55086;139735;395;83692;171484;10251;169981;1349;63904;139716;257397;142689;80258;27035;1641;55613;7105;100329135;84295;9459;4810;404281;4109;367;474384;6748;139760;347487;92745;158830;53344;4103;9203;139378;186;474343;2719;3597;140456;9248;402415;203430;9185;90161;728042;4129;65267;56849;8228;8226;728036;7114;6399;4952;83740;84889;8481;6757;347468;347475;414;6759;9500;51132;8823;541578;2158;55609;2556;494119;6756;9502;158880;8517;8242;474383;57595;51442;389895;100132304;9754;80311;6102;27328;695;56159;51213;90737;60506;10943;100873985;57526;728269;170082;474382;102723680;728656;3358;8273;83844;114824;389840;170067;81557;80823;8862;2002;7216;79979;158763;23641;55217;8270;57477;7592;2833;425054;340526;727866;139599;139804;54470;8450;959;139562;645864;10075;117154;57631;2010;54521;79589;51634;3750;653282;728072;7076;392490;9363;8623;3920;347411;7454;100506164;265;90293;645051;100529097;55511;158724;6197;203547;139135;5355;347516;203522;139081;6451;27336;158787;728458;7499;4841;347517;51360;340578;139596;1896;441509;54466;660;158798;4108;171482;79868;728075;158833;79366;1821;56156;392465;1260;5160;56062;5303;3054;51260;139628;653220;340596;554;28986;23133;57393;2623;28227;4113;57692;50945;3730;7739;100131755;57481;8260;139170;64219;4204;389860;2574;3563;65991;10325;6170;10813;79710;8712;26280;2316;256714;10742;6173;9104;494197;29057;139324;442444;6103;54880;90736;55558;2742;1736;369;255313;3654;170627;645974;3897;79983;727940;541466;347527;8243;4007;139741;29978;2182;7504;60401;84707;53336;1485;159090;94056;57502;55285;653067;1046;11152;641339;1947;8852;7712;23708;203523;4267;54967;340542;89885;2277;83550;644353;55916;340595;6594;139189;63947;9643;9843;4935;139728;100288814;10479;50943;53940;55026;100507170;5638;4478;8239;4068;51114;139411;246100;9968;84679;115201;100533997;1741;416;64840;10682;11326;25763;27330;171483;8908;27286;1038;7543;158800;90060;1288;84061;215;6247;292;55879;401612;1183;340527;55344;29935;158983;357;10009;2747;2652;286514;340543;54885;100129407;10495;6792;79742;140886;2239;2334;4128;441518;139604;4303;55869;25878;4115;11040;8473;6855;84636;55922;728712;5956;2705;55841;54821;729396;441521;8933;10735;729442;9949;4694;84528;51481;492;3028;100129520;795;10389;83604;7411;9947;9367;100463488;10134;79057;54552;6906;340547;30014;415;5255;680;158809;6990;4435;5475;340529;65109;64860;7030;729428;8776;4675;5030;51566;729201;56271;4943;79917;85012;114928;5256;26609;54960;538;6853;5365;4354;286451;29934;10838;139221;9189;347404;6473;3251;286464;158931;139793;100008586;2717;3052;5973;139065;5199;546;5613;51270;139231;9131;7547;474381;257240;11254;27238;64102;2543;158747;2273;56474;5165;64648;54440;140597;5631;728239;3188;100130086;5251;8237;286527;100130302,815
1,1,X,168547,155233731,155065184,23096;64061;392509;10214;170685;23157;727837;55998;23439;729431;10916;158586;55859;331;3423;54830;4168;6901;5358;92002;27344;729447;54328;266740;9075;102723737;7552;729422;54954;84460;389874;56000;340562;644538;92552;254158;79649;56850;8225;2824;100272147;51186;3149;26576;100130361;1730;347541;139425;3547;728695;729408;79921;57826;59272;203413;2986;7512;9737;8544;55634;2857;3421;537;11013;340554;5716;6658;4101;54457;1438;91966;441519;4100;5931;27316;7403;4534;6839;51480;728096;27112;92129;101928917;140462;8241;6567;827;203569;27301;84548;645037;54413;100133053;7355;254065;79836;10084;347442;60343;51765;55593;139818;56180;6303;8269;142684;7626;10046;8409;203447;63932;2710;4515;8406;51248;56001;51616;2925;100130613;2564;1193;100132994;5354;11043;340533;22;3476;84631;26748;11238;203562;102723631;170261;58526;441525;4983;29944;6907;1536;2539;1478;9468;23597;2187;1287;81887;6611;3561;9767;9282;54857;347365;10800;139341;54539;11219;728062;169966;51209;23630;26548;1121;2000;645188;51438;2846;280658;1852;347344;23229;10857;56157;286430;101059915;438;5277;9758;1069;4674;154796;56548;51309;1184;645073;80712;1774;10245;2258;728343;9823;441531;11141;643311;90121;256643;23676;4114;6758;4107;286499;5009;1654;1831;51284;94121;170302;11230;79135;286410;9210;2491;441490;84187;633;6191;64743;4110;3598;389856;7789;55787;9452;50814;2157;139422;170062;57187;139067;4104;203427;4693;5456;10013;1964;55190;100996648;293;9016;100528062;30011;90316;93953;10178;6322;28952;24137;2332;4105;6845;94122;84968;64663;1538;9142;286530;2245;5634;9506;79576;3266;139212;5207;6535;8227;393;389852;170626;91851;27334;158866;550643;159013;407;7224;55796;10761;100132963;168400;4281;158835;24140;8471;90167;7737;7319;10149;11279;6134;64109;1678;139322;5063;55906;116442;84443;27197;8233;548313;6872;27018;100129239;139105;7102;10549;26071;2664;59353;8573;28985;79184;728049;728090;158521;3581;139886;282808;8263;9130;728082;778;90843;1756;5422;7317;5935;347454;29071;207063;4112;412;158506;340602;30848;5127;22866;93380;159091;10159;212;139285;9338;85417;8266;100132399;158584;494118;190;7569;89801;2892;1968;5230;57232;55559;57529;8277;63035;80231;286436;25975;51311;8905;55086;139735;395;83692;171484;10251;169981;1349;63904;139716;257397;142689;80258;27035;1641;55613;7105;100329135;84295;9459;4810;404281;4109;367;474384;6748;139760;347487;92745;158830;53344;4103;9203;139378;186;474343;2719;3597;140456;9248;402415;203430;9185;90161;728042;4129;65267;56849;8228;8226;728036;7114;6399;4952;83740;84889;8481;6757;347468;347475;414;6759;9500;51132;8823;541578;2158;55609;2556;494119;6756;9502;158880;8517;8242;474383;57595;51442;389895;100132304;9754;80311;6102;27328;695;56159;51213;90737;60506;10943;100873985;57526;728269;170082;474382;102723680;728656;3358;8273;83844;114824;389840;170067;81557;80823;8862;2002;7216;79979;158763;23641;55217;8270;57477;7592;2833;425054;340526;727866;139599;139804;54470;8450;959;139562;645864;10075;117154;57631;2010;54521;79589;51634;3750;653282;728072;7076;392490;9363;8623;3920;347411;7454;100506164;265;90293;645051;100529097;55511;158724;6197;203547;139135;5355;347516;203522;139081;6451;27336;158787;728458;7499;4841;347517;51360;340578;139596;1896;441509;54466;660;158798;4108;171482;79868;728075;158833;79366;1821;56156;392465;1260;5160;56062;5303;3054;51260;139628;653220;340596;554;28986;23133;57393;2623;28227;4113;57692;50945;3730;7739;100131755;57481;8260;139170;64219;4204;389860;2574;3563;65991;10325;6170;10813;79710;8712;26280;2316;256714;10742;6173;9104;494197;29057;139324;442444;6103;54880;90736;55558;2742;1736;369;255313;3654;170627;645974;3897;79983;727940;541466;347527;8243;4007;139741;29978;2182;7504;60401;84707;53336;1485;159090;94056;57502;55285;653067;1046;11152;641339;1947;8852;7712;23708;203523;4267;54967;340542;89885;2277;83550;644353;55916;340595;6594;139189;63947;9643;9843;4935;139728;100288814;10479;50943;53940;55026;100507170;5638;4478;8239;4068;51114;139411;246100;9968;84679;115201;100533997;1741;416;64840;10682;11326;25763;27330;171483;8908;27286;1038;7543;158800;90060;1288;84061;215;6247;292;55879;401612;1183;340527;55344;29935;158983;357;10009;2747;2652;286514;340543;54885;100129407;10495;6792;79742;140886;2239;2334;4128;441518;139604;4303;55869;25878;4115;11040;8473;6855;84636;55922;728712;5956;2705;55841;54821;729396;441521;8933;10735;729442;9949;4694;84528;51481;492;3028;100129520;795;10389;83604;7411;9947;9367;100463488;10134;79057;54552;6906;340547;30014;415;5255;680;158809;6990;4435;5475;340529;65109;64860;7030;729428;8776;4675;5030;51566;729201;56271;4943;79917;85012;114928;5256;26609;54960;538;6853;5365;4354;286451;29934;10838;139221;9189;347404;6473;3251;286464;158931;139793;100008586;2717;3052;5973;139065;5199;546;5613;51270;139231;9131;7547;474381;257240;11254;27238;64102;2543;158747;2273;56474;5165;64648;54440;140597;5631;728239;3188;100130086;5251;8237;286527;100130302,815
-1,1,X,168547,155233731,155065184,23096;64061;392509;10214;170685;23157;727837;55998;23439;729431;10916;158586;55859;331;3423;54830;4168;6901;5358;92002;27344;729447;54328;266740;9075;102723737;7552;729422;54954;84460;389874;56000;340562;644538;92552;254158;79649;56850;8225;2824;100272147;51186;3149;26576;100130361;1730;347541;139425;3547;728695;729408;79921;57826;59272;203413;2986;7512;9737;8544;55634;2857;3421;537;11013;340554;5716;6658;4101;54457;1438;91966;441519;4100;5931;27316;7403;4534;6839;51480;728096;27112;92129;101928917;140462;8241;6567;827;203569;27301;84548;645037;54413;100133053;7355;254065;79836;10084;347442;60343;51765;55593;139818;56180;6303;8269;142684;7626;10046;8409;203447;63932;2710;4515;8406;51248;56001;51616;2925;100130613;2564;1193;100132994;5354;11043;340533;22;3476;84631;26748;11238;203562;102723631;170261;58526;441525;4983;29944;6907;1536;2539;1478;9468;23597;2187;1287;81887;6611;3561;9767;9282;54857;347365;10800;139341;54539;11219;728062;169966;51209;23630;26548;1121;2000;645188;51438;2846;280658;1852;347344;23229;10857;56157;286430;101059915;438;5277;9758;1069;4674;154796;56548;51309;1184;645073;80712;1774;10245;2258;728343;9823;441531;11141;643311;90121;256643;23676;4114;6758;4107;286499;5009;1654;1831;51284;94121;170302;11230;79135;286410;9210;2491;441490;84187;633;6191;64743;4110;3598;389856;7789;55787;9452;50814;2157;139422;170062;57187;139067;4104;203427;4693;5456;10013;1964;55190;100996648;293;9016;100528062;30011;90316;93953;10178;6322;28952;24137;2332;4105;6845;94122;84968;64663;1538;9142;286530;2245;5634;9506;79576;3266;139212;5207;6535;8227;393;389852;170626;91851;27334;158866;550643;159013;407;7224;55796;10761;100132963;168400;4281;158835;24140;8471;90167;7737;7319;10149;11279;6134;64109;1678;139322;5063;55906;116442;84443;27197;8233;548313;6872;27018;100129239;139105;7102;10549;26071;2664;59353;8573;28985;79184;728049;728090;158521;3581;139886;282808;8263;9130;728082;778;90843;1756;5422;7317;5935;347454;29071;207063;4112;412;158506;340602;30848;5127;22866;93380;159091;10159;212;139285;9338;85417;8266;100132399;158584;494118;190;7569;89801;2892;1968;5230;57232;55559;57529;8277;63035;80231;286436;25975;51311;8905;55086;139735;395;83692;171484;10251;169981;1349;63904;139716;257397;142689;80258;27035;1641;55613;7105;100329135;84295;9459;4810;404281;4109;367;474384;6748;139760;347487;92745;158830;53344;4103;9203;139378;186;474343;2719;3597;140456;9248;402415;203430;9185;90161;728042;4129;65267;56849;8228;8226;728036;7114;6399;4952;83740;84889;8481;6757;347468;347475;414;6759;9500;51132;8823;541578;2158;55609;2556;494119;6756;9502;158880;8517;8242;474383;57595;51442;389895;100132304;9754;80311;6102;27328;695;56159;51213;90737;60506;10943;100873985;57526;728269;170082;474382;102723680;728656;3358;8273;83844;114824;389840;170067;81557;80823;8862;2002;7216;79979;158763;23641;55217;8270;57477;7592;2833;425054;340526;727866;139599;139804;54470;8450;959;139562;645864;10075;117154;57631;2010;54521;79589;51634;3750;653282;728072;7076;392490;9363;8623;3920;347411;7454;100506164;265;90293;645051;100529097;55511;158724;6197;203547;139135;5355;347516;203522;139081;6451;27336;158787;728458;7499;4841;347517;51360;340578;139596;1896;441509;54466;660;158798;4108;171482;79868;728075;158833;79366;1821;56156;392465;1260;5160;56062;5303;3054;51260;139628;653220;340596;554;28986;23133;57393;2623;28227;4113;57692;50945;3730;7739;100131755;57481;8260;139170;64219;4204;389860;2574;3563;65991;10325;6170;10813;79710;8712;26280;2316;256714;10742;6173;9104;494197;29057;139324;442444;6103;54880;90736;55558;2742;1736;369;255313;3654;170627;645974;3897;79983;727940;541466;347527;8243;4007;139741;29978;2182;7504;60401;84707;53336;1485;159090;94056;57502;55285;653067;1046;11152;641339;1947;8852;7712;23708;203523;4267;54967;340542;89885;2277;83550;644353;55916;340595;6594;139189;63947;9643;9843;4935;139728;100288814;10479;50943;53940;55026;100507170;5638;4478;8239;4068;51114;139411;246100;9968;84679;115201;100533997;1741;416;64840;10682;11326;25763;27330;171483;8908;27286;1038;7543;158800;90060;1288;84061;215;6247;292;55879;401612;1183;340527;55344;29935;158983;357;10009;2747;2652;286514;340543;54885;100129407;10495;6792;79742;140886;2239;2334;4128;441518;139604;4303;55869;25878;4115;11040;8473;6855;84636;55922;728712;5956;2705;55841;54821;729396;441521;8933;10735;729442;9949;4694;84528;51481;492;3028;100129520;795;10389;83604;7411;9947;9367;100463488;10134;79057;54552;6906;340547;30014;415;5255;680;158809;6990;4435;5475;340529;65109;64860;7030;729428;8776;4675;5030;51566;729201;56271;4943;79917;85012;114928;5256;26609;54960;538;6853;5365;4354;286451;29934;10838;139221;9189;347404;6473;3251;286464;158931;139793;100008586;2717;3052;5973;139065;5199;546;5613;51270;139231;9131;7547;474381;257240;11254;27238;64102;2543;158747;2273;56474;5165;64648;54440;140597;5631;728239;3188;100130086;5251;8237;286527;100130302,815
1,1,X,168547,155233731,155065184,23096;64061;392509;10214;170685;23157;727837;55998;23439;729431;10916;158586;55859;331;3423;54830;4168;6901;5358;92002;27344;729447;54328;266740;9075;102723737;7552;729422;54954;84460;389874;56000;340562;644538;92552;254158;79649;56850;8225;2824;100272147;51186;3149;26576;100130361;1730;347541;139425;3547;728695;729408;79921;57826;59272;203413;2986;7512;9737;8544;55634;2857;3421;537;11013;340554;5716;6658;4101;54457;1438;91966;441519;4100;5931;27316;7403;4534;6839;51480;728096;27112;92129;101928917;140462;8241;6567;827;203569;27301;84548;645037;54413;100133053;7355;254065;79836;10084;347442;60343;51765;55593;139818;56180;6303;8269;142684;7626;10046;8409;203447;63932;2710;4515;8406;51248;56001;51616;2925;100130613;2564;1193;100132994;5354;11043;340533;22;3476;84631;26748;11238;203562;102723631;170261;58526;441525;4983;29944;6907;1536;2539;1478;9468;23597;2187;1287;81887;6611;3561;9767;9282;54857;347365;10800;139341;54539;11219;728062;169966;51209;23630;26548;1121;2000;645188;51438;2846;280658;1852;347344;23229;10857;56157;286430;101059915;438;5277;9758;1069;4674;154796;56548;51309;1184;645073;80712;1774;10245;2258;728343;9823;441531;11141;643311;90121;256643;23676;4114;6758;4107;286499;5009;1654;1831;51284;94121;170302;11230;79135;286410;9210;2491;441490;84187;633;6191;64743;4110;3598;389856;7789;55787;9452;50814;2157;139422;170062;57187;139067;4104;203427;4693;5456;10013;1964;55190;100996648;293;9016;100528062;30011;90316;93953;10178;6322;28952;24137;2332;4105;6845;94122;84968;64663;1538;9142;286530;2245;5634;9506;79576;3266;139212;5207;6535;8227;393;389852;170626;91851;27334;158866;550643;159013;407;7224;55796;10761;100132963;168400;4281;158835;24140;8471;90167;7737;7319;10149;11279;6134;64109;1678;139322;5063;55906;116442;84443;27197;8233;548313;6872;27018;100129239;139105;7102;10549;26071;2664;59353;8573;28985;79184;728049;728090;158521;3581;139886;282808;8263;9130;728082;778;90843;1756;5422;7317;5935;347454;29071;207063;4112;412;158506;340602;30848;5127;22866;93380;159091;10159;212;139285;9338;85417;8266;100132399;158584;494118;190;7569;89801;2892;1968;5230;57232;55559;57529;8277;63035;80231;286436;25975;51311;8905;55086;139735;395;83692;171484;10251;169981;1349;63904;139716;257397;142689;80258;27035;1641;55613;7105;100329135;84295;9459;4810;404281;4109;367;474384;6748;139760;347487;92745;158830;53344;4103;9203;139378;186;474343;2719;3597;140456;9248;402415;203430;9185;90161;728042;4129;65267;56849;8228;8226;728036;7114;6399;4952;83740;84889;8481;6757;347468;347475;414;6759;9500;51132;8823;541578;2158;55609;2556;494119;6756;9502;158880;8517;8242;474383;57595;51442;389895;100132304;9754;80311;6102;27328;695;56159;51213;90737;60506;10943;100873985;57526;728269;170082;474382;102723680;728656;3358;8273;83844;114824;389840;170067;81557;80823;8862;2002;7216;79979;158763;23641;55217;8270;57477;7592;2833;425054;340526;727866;139599;139804;54470;8450;959;139562;645864;10075;117154;57631;2010;54521;79589;51634;3750;653282;728072;7076;392490;9363;8623;3920;347411;7454;100506164;265;90293;645051;100529097;55511;158724;6197;203547;139135;5355;347516;203522;139081;6451;27336;158787;728458;7499;4841;347517;51360;340578;139596;1896;441509;54466;660;158798;4108;171482;79868;728075;158833;79366;1821;56156;392465;1260;5160;56062;5303;3054;51260;139628;653220;340596;554;28986;23133;57393;2623;28227;4113;57692;50945;3730;7739;100131755;57481;8260;139170;64219;4204;389860;2574;3563;65991;10325;6170;10813;79710;8712;26280;2316;256714;10742;6173;9104;494197;29057;139324;442444;6103;54880;90736;55558;2742;1736;369;255313;3654;170627;645974;3897;79983;727940;541466;347527;8243;4007;139741;29978;2182;7504;60401;84707;53336;1485;159090;94056;57502;55285;653067;1046;11152;641339;1947;8852;7712;23708;203523;4267;54967;340542;89885;2277;83550;644353;55916;340595;6594;139189;63947;9643;9843;4935;139728;100288814;10479;50943;53940;55026;100507170;5638;4478;8239;4068;51114;139411;246100;9968;84679;115201;100533997;1741;416;64840;10682;11326;25763;27330;171483;8908;27286;1038;7543;158800;90060;1288;84061;215;6247;292;55879;401612;1183;340527;55344;29935;158983;357;10009;2747;2652;286514;340543;54885;100129407;10495;6792;79742;140886;2239;2334;4128;441518;139604;4303;55869;25878;4115;11040;8473;6855;84636;55922;728712;5956;2705;55841;54821;729396;441521;8933;10735;729442;9949;4694;84528;51481;492;3028;100129520;795;10389;83604;7411;9947;9367;100463488;10134;79057;54552;6906;340547;30014;415;5255;680;158809;6990;4435;5475;340529;65109;64860;7030;729428;8776;4675;5030;51566;729201;56271;4943;79917;85012;114928;5256;26609;54960;538;6853;5365;4354;286451;29934;10838;139221;9189;347404;6473;3251;286464;158931;139793;100008586;2717;3052;5973;139065;5199;546;5613;51270;139231;9131;7547;474381;257240;11254;27238;64102;2543;158747;2273;56474;5165;64648;54440;140597;5631;728239;3188;100130086;5251;8237;286527;100130302,815
1,1,X,168547,155233731,155065184,23096;64061;392509;10214;170685;23157;727837;55998;23439;729431;10916;158586;55859;331;3423;54830;4168;6901;5358;92002;27344;729447;54328;266740;9075;102723737;7552;729422;54954;84460;389874;56000;340562;644538;92552;254158;79649;56850;8225;2824;100272147;51186;3149;26576;100130361;1730;347541;139425;3547;728695;729408;79921;57826;59272;203413;2986;7512;9737;8544;55634;2857;3421;537;11013;340554;5716;6658;4101;54457;1438;91966;441519;4100;5931;27316;7403;4534;6839;51480;728096;27112;92129;101928917;140462;8241;6567;827;203569;27301;84548;645037;54413;100133053;7355;254065;79836;10084;347442;60343;51765;55593;139818;56180;6303;8269;142684;7626;10046;8409;203447;63932;2710;4515;8406;51248;56001;51616;2925;100130613;2564;1193;100132994;5354;11043;340533;22;3476;84631;26748;11238;203562;102723631;170261;58526;441525;4983;29944;6907;1536;2539;1478;9468;23597;2187;1287;81887;6611;3561;9767;9282;54857;347365;10800;139341;54539;11219;728062;169966;51209;23630;26548;1121;2000;645188;51438;2846;280658;1852;347344;23229;10857;56157;286430;101059915;438;5277;9758;1069;4674;154796;56548;51309;1184;645073;80712;1774;10245;2258;728343;9823;441531;11141;643311;90121;256643;23676;4114;6758;4107;286499;5009;1654;1831;51284;94121;170302;11230;79135;286410;9210;2491;441490;84187;633;6191;64743;4110;3598;389856;7789;55787;9452;50814;2157;139422;170062;57187;139067;4104;203427;4693;5456;10013;1964;55190;100996648;293;9016;100528062;30011;90316;93953;10178;6322;28952;24137;2332;4105;6845;94122;84968;64663;1538;9142;286530;2245;5634;9506;79576;3266;139212;5207;6535;8227;393;389852;170626;91851;27334;158866;550643;159013;407;7224;55796;10761;100132963;168400;4281;158835;24140;8471;90167;7737;7319;10149;11279;6134;64109;1678;139322;5063;55906;116442;84443;27197;8233;548313;6872;27018;100129239;139105;7102;10549;26071;2664;59353;8573;28985;79184;728049;728090;158521;3581;139886;282808;8263;9130;728082;778;90843;1756;5422;7317;5935;347454;29071;207063;4112;412;158506;340602;30848;5127;22866;93380;159091;10159;212;139285;9338;85417;8266;100132399;158584;494118;190;7569;89801;2892;1968;5230;57232;55559;57529;8277;63035;80231;286436;25975;51311;8905;55086;139735;395;83692;171484;10251;169981;1349;63904;139716;257397;142689;80258;27035;1641;55613;7105;100329135;84295;9459;4810;404281;4109;367;474384;6748;139760;347487;92745;158830;53344;4103;9203;139378;186;474343;2719;3597;140456;9248;402415;203430;9185;90161;728042;4129;65267;56849;8228;8226;728036;7114;6399;4952;83740;84889;8481;6757;347468;347475;414;6759;9500;51132;8823;541578;2158;55609;2556;494119;6756;9502;158880;8517;8242;474383;57595;51442;389895;100132304;9754;80311;6102;27328;695;56159;51213;90737;60506;10943;100873985;57526;728269;170082;474382;102723680;728656;3358;8273;83844;114824;389840;170067;81557;80823;8862;2002;7216;79979;158763;23641;55217;8270;57477;7592;2833;425054;340526;727866;139599;139804;54470;8450;959;139562;645864;10075;117154;57631;2010;54521;79589;51634;3750;653282;728072;7076;392490;9363;8623;3920;347411;7454;100506164;265;90293;645051;100529097;55511;158724;6197;203547;139135;5355;347516;203522;139081;6451;27336;158787;728458;7499;4841;347517;51360;340578;139596;1896;441509;54466;660;158798;4108;171482;79868;728075;158833;79366;1821;56156;392465;1260;5160;56062;5303;3054;51260;139628;653220;340596;554;28986;23133;57393;2623;28227;4113;57692;50945;3730;7739;100131755;57481;8260;139170;64219;4204;389860;2574;3563;65991;10325;6170;10813;79710;8712;26280;2316;256714;10742;6173;9104;494197;29057;139324;442444;6103;54880;90736;55558;2742;1736;369;255313;3654;170627;645974;3897;79983;727940;541466;347527;8243;4007;139741;29978;2182;7504;60401;84707;53336;1485;159090;94056;57502;55285;653067;1046;11152;641339;1947;8852;7712;23708;203523;4267;54967;340542;89885;2277;83550;644353;55916;340595;6594;139189;63947;9643;9843;4935;139728;100288814;10479;50943;53940;55026;100507170;5638;4478;8239;4068;51114;139411;246100;9968;84679;115201;100533997;1741;416;64840;10682;11326;25763;27330;171483;8908;27286;1038;7543;158800;90060;1288;84061;215;6247;292;55879;401612;1183;340527;55344;29935;158983;357;10009;2747;2652;286514;340543;54885;100129407;10495;6792;79742;140886;2239;2334;4128;441518;139604;4303;55869;25878;4115;11040;8473;6855;84636;55922;728712;5956;2705;55841;54821;729396;441521;8933;10735;729442;9949;4694;84528;51481;492;3028;100129520;795;10389;83604;7411;9947;9367;100463488;10134;79057;54552;6906;340547;30014;415;5255;680;158809;6990;4435;5475;340529;65109;64860;7030;729428;8776;4675;5030;51566;729201;56271;4943;79917;85012;114928;5256;26609;54960;538;6853;5365;4354;286451;29934;10838;139221;9189;347404;6473;3251;286464;158931;139793;100008586;2717;3052;5973;139065;5199;546;5613;51270;139231;9131;7547;474381;257240;11254;27238;64102;2543;158747;2273;56474;5165;64648;54440;140597;5631;728239;3188;100130086;5251;8237;286527;100130302,815
-1,1,X,168547,155233731,155065184,23096;64061;392509;10214;170685;23157;727837;55998;23439;729431;10916;158586;55859;331;3423;54830;4168;6901;5358;92002;27344;729447;54328;266740;9075;102723737;7552;729422;54954;84460;389874;56000;340562;644538;92552;254158;79649;56850;8225;2824;100272147;51186;3149;26576;100130361;1730;347541;139425;3547;728695;729408;79921;57826;59272;203413;2986;7512;9737;8544;55634;2857;3421;537;11013;340554;5716;6658;4101;54457;1438;91966;441519;4100;5931;27316;7403;4534;6839;51480;728096;27112;92129;101928917;140462;8241;6567;827;203569;27301;84548;645037;54413;100133053;7355;254065;79836;10084;347442;60343;51765;55593;139818;56180;6303;8269;142684;7626;10046;8409;203447;63932;2710;4515;8406;51248;56001;51616;2925;100130613;2564;1193;100132994;5354;11043;340533;22;3476;84631;26748;11238;203562;102723631;170261;58526;441525;4983;29944;6907;1536;2539;1478;9468;23597;2187;1287;81887;6611;3561;9767;9282;54857;347365;10800;139341;54539;11219;728062;169966;51209;23630;26548;1121;2000;645188;51438;2846;280658;1852;347344;23229;10857;56157;286430;101059915;438;5277;9758;1069;4674;154796;56548;51309;1184;645073;80712;1774;10245;2258;728343;9823;441531;11141;643311;90121;256643;23676;4114;6758;4107;286499;5009;1654;1831;51284;94121;170302;11230;79135;286410;9210;2491;441490;84187;633;6191;64743;4110;3598;389856;7789;55787;9452;50814;2157;139422;170062;57187;139067;4104;203427;4693;5456;10013;1964;55190;100996648;293;9016;100528062;30011;90316;93953;10178;6322;28952;24137;2332;4105;6845;94122;84968;64663;1538;9142;286530;2245;5634;9506;79576;3266;139212;5207;6535;8227;393;389852;170626;91851;27334;158866;550643;159013;407;7224;55796;10761;100132963;168400;4281;158835;24140;8471;90167;7737;7319;10149;11279;6134;64109;1678;139322;5063;55906;116442;84443;27197;8233;548313;6872;27018;100129239;139105;7102;10549;26071;2664;59353;8573;28985;79184;728049;728090;158521;3581;139886;282808;8263;9130;728082;778;90843;1756;5422;7317;5935;347454;29071;207063;4112;412;158506;340602;30848;5127;22866;93380;159091;10159;212;139285;9338;85417;8266;100132399;158584;494118;190;7569;89801;2892;1968;5230;57232;55559;57529;8277;63035;80231;286436;25975;51311;8905;55086;139735;395;83692;171484;10251;169981;1349;63904;139716;257397;142689;80258;27035;1641;55613;7105;100329135;84295;9459;4810;404281;4109;367;474384;6748;139760;347487;92745;158830;53344;4103;9203;139378;186;474343;2719;3597;140456;9248;402415;203430;9185;90161;728042;4129;65267;56849;8228;8226;728036;7114;6399;4952;83740;84889;8481;6757;347468;347475;414;6759;9500;51132;8823;541578;2158;55609;2556;494119;6756;9502;158880;8517;8242;474383;57595;51442;389895;100132304;9754;80311;6102;27328;695;56159;51213;90737;60506;10943;100873985;57526;728269;170082;474382;102723680;728656;3358;8273;83844;114824;389840;170067;81557;80823;8862;2002;7216;79979;158763;23641;55217;8270;57477;7592;2833;425054;340526;727866;139599;139804;54470;8450;959;139562;645864;10075;117154;57631;2010;54521;79589;51634;3750;653282;728072;7076;392490;9363;8623;3920;347411;7454;100506164;265;90293;645051;100529097;55511;158724;6197;203547;139135;5355;347516;203522;139081;6451;27336;158787;728458;7499;4841;347517;51360;340578;139596;1896;441509;54466;660;158798;4108;171482;79868;728075;158833;79366;1821;56156;392465;1260;5160;56062;5303;3054;51260;139628;653220;340596;554;28986;23133;57393;2623;28227;4113;57692;50945;3730;7739;100131755;57481;8260;139170;64219;4204;389860;2574;3563;65991;10325;6170;10813;79710;8712;26280;2316;256714;10742;6173;9104;494197;29057;139324;442444;6103;54880;90736;55558;2742;1736;369;255313;3654;170627;645974;3897;79983;727940;541466;347527;8243;4007;139741;29978;2182;7504;60401;84707;53336;1485;159090;94056;57502;55285;653067;1046;11152;641339;1947;8852;7712;23708;203523;4267;54967;340542;89885;2277;83550;644353;55916;340595;6594;139189;63947;9643;9843;4935;139728;100288814;10479;50943;53940;55026;100507170;5638;4478;8239;4068;51114;139411;246100;9968;84679;115201;100533997;1741;416;64840;10682;11326;25763;27330;171483;8908;27286;1038;7543;158800;90060;1288;84061;215;6247;292;55879;401612;1183;340527;55344;29935;158983;357;10009;2747;2652;286514;340543;54885;100129407;10495;6792;79742;140886;2239;2334;4128;441518;139604;4303;55869;25878;4115;11040;8473;6855;84636;55922;728712;5956;2705;55841;54821;729396;441521;8933;10735;729442;9949;4694;84528;51481;492;3028;100129520;795;10389;83604;7411;9947;9367;100463488;10134;79057;54552;6906;340547;30014;415;5255;680;158809;6990;4435;5475;340529;65109;64860;7030;729428;8776;4675;5030;51566;729201;56271;4943;79917;85012;114928;5256;26609;54960;538;6853;5365;4354;286451;29934;10838;139221;9189;347404;6473;3251;286464;158931;139793;100008586;2717;3052;5973;139065;5199;546;5613;51270;139231;9131;7547;474381;257240;11254;27238;64102;2543;158747;2273;56474;5165;64648;54440;140597;5631;728239;3188;100130086;5251;8237;286527;100130302,815
1,1,X,168547,155233731,155065184,23096;64061;392509;10214;170685;23157;727837;55998;23439;729431;10916;158586;55859;331;3423;54830;4168;6901;5358;92002;27344;729447;54328;266740;9075;102723737;7552;729422;54954;84460;389874;56000;340562;644538;92552;254158;79649;56850;8225;2824;100272147;51186;3149;26576;100130361;1730;347541;139425;3547;728695;729408;79921;57826;59272;203413;2986;7512;9737;8544;55634;2857;3421;537;11013;340554;5716;6658;4101;54457;1438;91966;441519;4100;5931;27316;7403;4534;6839;51480;728096;27112;92129;101928917;140462;8241;6567;827;203569;27301;84548;645037;54413;100133053;7355;254065;79836;10084;347442;60343;51765;55593;139818;56180;6303;8269;142684;7626;10046;8409;203447;63932;2710;4515;8406;51248;56001;51616;2925;100130613;2564;1193;100132994;5354;11043;340533;22;3476;84631;26748;11238;203562;102723631;170261;58526;441525;4983;29944;6907;1536;2539;1478;9468;23597;2187;1287;81887;6611;3561;9767;9282;54857;347365;10800;139341;54539;11219;728062;169966;51209;23630;26548;1121;2000;645188;51438;2846;280658;1852;347344;23229;10857;56157;286430;101059915;438;5277;9758;1069;4674;154796;56548;51309;1184;645073;80712;1774;10245;2258;728343;9823;441531;11141;643311;90121;256643;23676;4114;6758;4107;286499;5009;1654;1831;51284;94121;170302;11230;79135;286410;9210;2491;441490;84187;633;6191;64743;4110;3598;389856;7789;55787;9452;50814;2157;139422;170062;57187;139067;4104;203427;4693;5456;10013;1964;55190;100996648;293;9016;100528062;30011;90316;93953;10178;6322;28952;24137;2332;4105;6845;94122;84968;64663;1538;9142;286530;2245;5634;9506;79576;3266;139212;5207;6535;8227;393;389852;170626;91851;27334;158866;550643;159013;407;7224;55796;10761;100132963;168400;4281;158835;24140;8471;90167;7737;7319;10149;11279;6134;64109;1678;139322;5063;55906;116442;84443;27197;8233;548313;6872;27018;100129239;139105;7102;10549;26071;2664;59353;8573;28985;79184;728049;728090;158521;3581;139886;282808;8263;9130;728082;778;90843;1756;5422;7317;5935;347454;29071;207063;4112;412;158506;340602;30848;5127;22866;93380;159091;10159;212;139285;9338;85417;8266;100132399;158584;494118;190;7569;89801;2892;1968;5230;57232;55559;57529;8277;63035;80231;286436;25975;51311;8905;55086;139735;395;83692;171484;10251;169981;1349;63904;139716;257397;142689;80258;27035;1641;55613;7105;100329135;84295;9459;4810;404281;4109;367;474384;6748;139760;347487;92745;158830;53344;4103;9203;139378;186;474343;2719;3597;140456;9248;402415;203430;9185;90161;728042;4129;65267;56849;8228;8226;728036;7114;6399;4952;83740;84889;8481;6757;347468;347475;414;6759;9500;51132;8823;541578;2158;55609;2556;494119;6756;9502;158880;8517;8242;474383;57595;51442;389895;100132304;9754;80311;6102;27328;695;56159;51213;90737;60506;10943;100873985;57526;728269;170082;474382;102723680;728656;3358;8273;83844;114824;389840;170067;81557;80823;8862;2002;7216;79979;158763;23641;55217;8270;57477;7592;2833;425054;340526;727866;139599;139804;54470;8450;959;139562;645864;10075;117154;57631;2010;54521;79589;51634;3750;653282;728072;7076;392490;9363;8623;3920;347411;7454;100506164;265;90293;645051;100529097;55511;158724;6197;203547;139135;5355;347516;203522;139081;6451;27336;158787;728458;7499;4841;347517;51360;340578;139596;1896;441509;54466;660;158798;4108;171482;79868;728075;158833;79366;1821;56156;392465;1260;5160;56062;5303;3054;51260;139628;653220;340596;554;28986;23133;57393;2623;28227;4113;57692;50945;3730;7739;100131755;57481;8260;139170;64219;4204;389860;2574;3563;65991;10325;6170;10813;79710;8712;26280;2316;256714;10742;6173;9104;494197;29057;139324;442444;6103;54880;90736;55558;2742;1736;369;255313;3654;170627;645974;3897;79983;727940;541466;347527;8243;4007;139741;29978;2182;7504;60401;84707;53336;1485;159090;94056;57502;55285;653067;1046;11152;641339;1947;8852;7712;23708;203523;4267;54967;340542;89885;2277;83550;644353;55916;340595;6594;139189;63947;9643;9843;4935;139728;100288814;10479;50943;53940;55026;100507170;5638;4478;8239;4068;51114;139411;246100;9968;84679;115201;100533997;1741;416;64840;10682;11326;25763;27330;171483;8908;27286;1038;7543;158800;90060;1288;84061;215;6247;292;55879;401612;1183;340527;55344;29935;158983;357;10009;2747;2652;286514;340543;54885;100129407;10495;6792;79742;140886;2239;2334;4128;441518;139604;4303;55869;25878;4115;11040;8473;6855;84636;55922;728712;5956;2705;55841;54821;729396;441521;8933;10735;729442;9949;4694;84528;51481;492;3028;100129520;795;10389;83604;7411;9947;9367;100463488;10134;79057;54552;6906;340547;30014;415;5255;680;158809;6990;4435;5475;340529;65109;64860;7030;729428;8776;4675;5030;51566;729201;56271;4943;79917;85012;114928;5256;26609;54960;538;6853;5365;4354;286451;29934;10838;139221;9189;347404;6473;3251;286464;158931;139793;100008586;2717;3052;5973;139065;5199;546;5613;51270;139231;9131;7547;474381;257240;11254;27238;64102;2543;158747;2273;56474;5165;64648;54440;140597;5631;728239;3188;100130086;5251;8237;286527;100130302,815
-1,1,X,168547,155233731,155065184,23096;64061;392509;10214;170685;23157;727837;55998;23439;729431;10916;158586;55859;331;3423;54830;4168;6901;5358;92002;27344;729447;54328;266740;9075;102723737;7552;729422;54954;84460;389874;56000;340562;644538;92552;254158;79649;56850;8225;2824;100272147;51186;3149;26576;100130361;1730;347541;139425;3547;728695;729408;79921;57826;59272;203413;2986;7512;9737;8544;55634;2857;3421;537;11013;340554;5716;6658;4101;54457;1438;91966;441519;4100;5931;27316;7403;4534;6839;51480;728096;27112;92129;101928917;140462;8241;6567;827;203569;27301;84548;645037;54413;100133053;7355;254065;79836;10084;347442;60343;51765;55593;139818;56180;6303;8269;142684;7626;10046;8409;203447;63932;2710;4515;8406;51248;56001;51616;2925;100130613;2564;1193;100132994;5354;11043;340533;22;3476;84631;26748;11238;203562;102723631;170261;58526;441525;4983;29944;6907;1536;2539;1478;9468;23597;2187;1287;81887;6611;3561;9767;9282;54857;347365;10800;139341;54539;11219;728062;169966;51209;23630;26548;1121;2000;645188;51438;2846;280658;1852;347344;23229;10857;56157;286430;101059915;438;5277;9758;1069;4674;154796;56548;51309;1184;645073;80712;1774;10245;2258;728343;9823;441531;11141;643311;90121;256643;23676;4114;6758;4107;286499;5009;1654;1831;51284;94121;170302;11230;79135;286410;9210;2491;441490;84187;633;6191;64743;4110;3598;389856;7789;55787;9452;50814;2157;139422;170062;57187;139067;4104;203427;4693;5456;10013;1964;55190;100996648;293;9016;100528062;30011;90316;93953;10178;6322;28952;24137;2332;4105;6845;94122;84968;64663;1538;9142;286530;2245;5634;9506;79576;3266;139212;5207;6535;8227;393;389852;170626;91851;27334;158866;550643;159013;407;7224;55796;10761;100132963;168400;4281;158835;24140;8471;90167;7737;7319;10149;11279;6134;64109;1678;139322;5063;55906;116442;84443;27197;8233;548313;6872;27018;100129239;139105;7102;10549;26071;2664;59353;8573;28985;79184;728049;728090;158521;3581;139886;282808;8263;9130;728082;778;90843;1756;5422;7317;5935;347454;29071;207063;4112;412;158506;340602;30848;5127;22866;93380;159091;10159;212;139285;9338;85417;8266;100132399;158584;494118;190;7569;89801;2892;1968;5230;57232;55559;57529;8277;63035;80231;286436;25975;51311;8905;55086;139735;395;83692;171484;10251;169981;1349;63904;139716;257397;142689;80258;27035;1641;55613;7105;100329135;84295;9459;4810;404281;4109;367;474384;6748;139760;347487;92745;158830;53344;4103;9203;139378;186;474343;2719;3597;140456;9248;402415;203430;9185;90161;728042;4129;65267;56849;8228;8226;728036;7114;6399;4952;83740;84889;8481;6757;347468;347475;414;6759;9500;51132;8823;541578;2158;55609;2556;494119;6756;9502;158880;8517;8242;474383;57595;51442;389895;100132304;9754;80311;6102;27328;695;56159;51213;90737;60506;10943;100873985;57526;728269;170082;474382;102723680;728656;3358;8273;83844;114824;389840;170067;81557;80823;8862;2002;7216;79979;158763;23641;55217;8270;57477;7592;2833;425054;340526;727866;139599;139804;54470;8450;959;139562;645864;10075;117154;57631;2010;54521;79589;51634;3750;653282;728072;7076;392490;9363;8623;3920;347411;7454;100506164;265;90293;645051;100529097;55511;158724;6197;203547;139135;5355;347516;203522;139081;6451;27336;158787;728458;7499;4841;347517;51360;340578;139596;1896;441509;54466;660;158798;4108;171482;79868;728075;158833;79366;1821;56156;392465;1260;5160;56062;5303;3054;51260;139628;653220;340596;554;28986;23133;57393;2623;28227;4113;57692;50945;3730;7739;100131755;57481;8260;139170;64219;4204;389860;2574;3563;65991;10325;6170;10813;79710;8712;26280;2316;256714;10742;6173;9104;494197;29057;139324;442444;6103;54880;90736;55558;2742;1736;369;255313;3654;170627;645974;3897;79983;727940;541466;347527;8243;4007;139741;29978;2182;7504;60401;84707;53336;1485;159090;94056;57502;55285;653067;1046;11152;641339;1947;8852;7712;23708;203523;4267;54967;340542;89885;2277;83550;644353;55916;340595;6594;139189;63947;9643;9843;4935;139728;100288814;10479;50943;53940;55026;100507170;5638;4478;8239;4068;51114;139411;246100;9968;84679;115201;100533997;1741;416;64840;10682;11326;25763;27330;171483;8908;27286;1038;7543;158800;90060;1288;84061;215;6247;292;55879;401612;1183;340527;55344;29935;158983;357;10009;2747;2652;286514;340543;54885;100129407;10495;6792;79742;140886;2239;2334;4128;441518;139604;4303;55869;25878;4115;11040;8473;6855;84636;55922;728712;5956;2705;55841;54821;729396;441521;8933;10735;729442;9949;4694;84528;51481;492;3028;100129520;795;10389;83604;7411;9947;9367;100463488;10134;79057;54552;6906;340547;30014;415;5255;680;158809;6990;4435;5475;340529;65109;64860;7030;729428;8776;4675;5030;51566;729201;56271;4943;79917;85012;114928;5256;26609;54960;538;6853;5365;4354;286451;29934;10838;139221;9189;347404;6473;3251;286464;158931;139793;100008586;2717;3052;5973;139065;5199;546;5613;51270;139231;9131;7547;474381;257240;11254;27238;64102;2543;158747;2273;56474;5165;64648;54440;140597;5631;728239;3188;100130086;5251;8237;286527;100130302,815
-1,1,X,168547,155233731,155065184,23096;64061;392509;10214;170685;23157;727837;55998;23439;729431;10916;158586;55859;331;3423;54830;4168;6901;5358;92002;27344;729447;54328;266740;9075;102723737;7552;729422;54954;84460;389874;56000;340562;644538;92552;254158;79649;56850;8225;2824;100272147;51186;3149;26576;100130361;1730;347541;139425;3547;728695;729408;79921;57826;59272;203413;2986;7512;9737;8544;55634;2857;3421;537;11013;340554;5716;6658;4101;54457;1438;91966;441519;4100;5931;27316;7403;4534;6839;51480;728096;27112;92129;101928917;140462;8241;6567;827;203569;27301;84548;645037;54413;100133053;7355;254065;79836;10084;347442;60343;51765;55593;139818;56180;6303;8269;142684;7626;10046;8409;203447;63932;2710;4515;8406;51248;56001;51616;2925;100130613;2564;1193;100132994;5354;11043;340533;22;3476;84631;26748;11238;203562;102723631;170261;58526;441525;4983;29944;6907;1536;2539;1478;9468;23597;2187;1287;81887;6611;3561;9767;9282;54857;347365;10800;139341;54539;11219;728062;169966;51209;23630;26548;1121;2000;645188;51438;2846;280658;1852;347344;23229;10857;56157;286430;101059915;438;5277;9758;1069;4674;154796;56548;51309;1184;645073;80712;1774;10245;2258;728343;9823;441531;11141;643311;90121;256643;23676;4114;6758;4107;286499;5009;1654;1831;51284;94121;170302;11230;79135;286410;9210;2491;441490;84187;633;6191;64743;4110;3598;389856;7789;55787;9452;50814;2157;139422;170062;57187;139067;4104;203427;4693;5456;10013;1964;55190;100996648;293;9016;100528062;30011;90316;93953;10178;6322;28952;24137;2332;4105;6845;94122;84968;64663;1538;9142;286530;2245;5634;9506;79576;3266;139212;5207;6535;8227;393;389852;170626;91851;27334;158866;550643;159013;407;7224;55796;10761;100132963;168400;4281;158835;24140;8471;90167;7737;7319;10149;11279;6134;64109;1678;139322;5063;55906;116442;84443;27197;8233;548313;6872;27018;100129239;139105;7102;10549;26071;2664;59353;8573;28985;79184;728049;728090;158521;3581;139886;282808;8263;9130;728082;778;90843;1756;5422;7317;5935;347454;29071;207063;4112;412;158506;340602;30848;5127;22866;93380;159091;10159;212;139285;9338;85417;8266;100132399;158584;494118;190;7569;89801;2892;1968;5230;57232;55559;57529;8277;63035;80231;286436;25975;51311;8905;55086;139735;395;83692;171484;10251;169981;1349;63904;139716;257397;142689;80258;27035;1641;55613;7105;100329135;84295;9459;4810;404281;4109;367;474384;6748;139760;347487;92745;158830;53344;4103;9203;139378;186;474343;2719;3597;140456;9248;402415;203430;9185;90161;728042;4129;65267;56849;8228;8226;728036;7114;6399;4952;83740;84889;8481;6757;347468;347475;414;6759;9500;51132;8823;541578;2158;55609;2556;494119;6756;9502;158880;8517;8242;474383;57595;51442;389895;100132304;9754;80311;6102;27328;695;56159;51213;90737;60506;10943;100873985;57526;728269;170082;474382;102723680;728656;3358;8273;83844;114824;389840;170067;81557;80823;8862;2002;7216;79979;158763;23641;55217;8270;57477;7592;2833;425054;340526;727866;139599;139804;54470;8450;959;139562;645864;10075;117154;57631;2010;54521;79589;51634;3750;653282;728072;7076;392490;9363;8623;3920;347411;7454;100506164;265;90293;645051;100529097;55511;158724;6197;203547;139135;5355;347516;203522;139081;6451;27336;158787;728458;7499;4841;347517;51360;340578;139596;1896;441509;54466;660;158798;4108;171482;79868;728075;158833;79366;1821;56156;392465;1260;5160;56062;5303;3054;51260;139628;653220;340596;554;28986;23133;57393;2623;28227;4113;57692;50945;3730;7739;100131755;57481;8260;139170;64219;4204;389860;2574;3563;65991;10325;6170;10813;79710;8712;26280;2316;256714;10742;6173;9104;494197;29057;139324;442444;6103;54880;90736;55558;2742;1736;369;255313;3654;170627;645974;3897;79983;727940;541466;347527;8243;4007;139741;29978;2182;7504;60401;84707;53336;1485;159090;94056;57502;55285;653067;1046;11152;641339;1947;8852;7712;23708;203523;4267;54967;340542;89885;2277;83550;644353;55916;340595;6594;139189;63947;9643;9843;4935;139728;100288814;10479;50943;53940;55026;100507170;5638;4478;8239;4068;51114;139411;246100;9968;84679;115201;100533997;1741;416;64840;10682;11326;25763;27330;171483;8908;27286;1038;7543;158800;90060;1288;84061;215;6247;292;55879;401612;1183;340527;55344;29935;158983;357;10009;2747;2652;286514;340543;54885;100129407;10495;6792;79742;140886;2239;2334;4128;441518;139604;4303;55869;25878;4115;11040;8473;6855;84636;55922;728712;5956;2705;55841;54821;729396;441521;8933;10735;729442;9949;4694;84528;51481;492;3028;100129520;795;10389;83604;7411;9947;9367;100463488;10134;79057;54552;6906;340547;30014;415;5255;680;158809;6990;4435;5475;340529;65109;64860;7030;729428;8776;4675;5030;51566;729201;56271;4943;79917;85012;114928;5256;26609;54960;538;6853;5365;4354;286451;29934;10838;139221;9189;347404;6473;3251;286464;158931;139793;100008586;2717;3052;5973;139065;5199;546;5613;51270;139231;9131;7547;474381;257240;11254;27238;64102;2543;158747;2273;56474;5165;64648;54440;140597;5631;728239;3188;100130086;5251;8237;286527;100130302,815
1,1,X,168547,155233731,155065184,23096;64061;392509;10214;170685;23157;727837;55998;23439;729431;10916;158586;55859;331;3423;54830;4168;6901;5358;92002;27344;729447;54328;266740;9075;102723737;7552;729422;54954;84460;389874;56000;340562;644538;92552;254158;79649;56850;8225;2824;100272147;51186;3149;26576;100130361;1730;347541;139425;3547;728695;729408;79921;57826;59272;203413;2986;7512;9737;8544;55634;2857;3421;537;11013;340554;5716;6658;4101;54457;1438;91966;441519;4100;5931;27316;7403;4534;6839;51480;728096;27112;92129;101928917;140462;8241;6567;827;203569;27301;84548;645037;54413;100133053;7355;254065;79836;10084;347442;60343;51765;55593;139818;56180;6303;8269;142684;7626;10046;8409;203447;63932;2710;4515;8406;51248;56001;51616;2925;100130613;2564;1193;100132994;5354;11043;340533;22;3476;84631;26748;11238;203562;102723631;170261;58526;441525;4983;29944;6907;1536;2539;1478;9468;23597;2187;1287;81887;6611;3561;9767;9282;54857;347365;10800;139341;54539;11219;728062;169966;51209;23630;26548;1121;2000;645188;51438;2846;280658;1852;347344;23229;10857;56157;286430;101059915;438;5277;9758;1069;4674;154796;56548;51309;1184;645073;80712;1774;10245;2258;728343;9823;441531;11141;643311;90121;256643;23676;4114;6758;4107;286499;5009;1654;1831;51284;94121;170302;11230;79135;286410;9210;2491;441490;84187;633;6191;64743;4110;3598;389856;7789;55787;9452;50814;2157;139422;170062;57187;139067;4104;203427;4693;5456;10013;1964;55190;100996648;293;9016;100528062;30011;90316;93953;10178;6322;28952;24137;2332;4105;6845;94122;84968;64663;1538;9142;286530;2245;5634;9506;79576;3266;139212;5207;6535;8227;393;389852;170626;91851;27334;158866;550643;159013;407;7224;55796;10761;100132963;168400;4281;158835;24140;8471;90167;7737;7319;10149;11279;6134;64109;1678;139322;5063;55906;116442;84443;27197;8233;548313;6872;27018;100129239;139105;7102;10549;26071;2664;59353;8573;28985;79184;728049;728090;158521;3581;139886;282808;8263;9130;728082;778;90843;1756;5422;7317;5935;347454;29071;207063;4112;412;158506;340602;30848;5127;22866;93380;159091;10159;212;139285;9338;85417;8266;100132399;158584;494118;190;7569;89801;2892;1968;5230;57232;55559;57529;8277;63035;80231;286436;25975;51311;8905;55086;139735;395;83692;171484;10251;169981;1349;63904;139716;257397;142689;80258;27035;1641;55613;7105;100329135;84295;9459;4810;404281;4109;367;474384;6748;139760;347487;92745;158830;53344;4103;9203;139378;186;474343;2719;3597;140456;9248;402415;203430;9185;90161;728042;4129;65267;56849;8228;8226;728036;7114;6399;4952;83740;84889;8481;6757;347468;347475;414;6759;9500;51132;8823;541578;2158;55609;2556;494119;6756;9502;158880;8517;8242;474383;57595;51442;389895;100132304;9754;80311;6102;27328;695;56159;51213;90737;60506;10943;100873985;57526;728269;170082;474382;102723680;728656;3358;8273;83844;114824;389840;170067;81557;80823;8862;2002;7216;79979;158763;23641;55217;8270;57477;7592;2833;425054;340526;727866;139599;139804;54470;8450;959;139562;645864;10075;117154;57631;2010;54521;79589;51634;3750;653282;728072;7076;392490;9363;8623;3920;347411;7454;100506164;265;90293;645051;100529097;55511;158724;6197;203547;139135;5355;347516;203522;139081;6451;27336;158787;728458;7499;4841;347517;51360;340578;139596;1896;441509;54466;660;158798;4108;171482;79868;728075;158833;79366;1821;56156;392465;1260;5160;56062;5303;3054;51260;139628;653220;340596;554;28986;23133;57393;2623;28227;4113;57692;50945;3730;7739;100131755;57481;8260;139170;64219;4204;389860;2574;3563;65991;10325;6170;10813;79710;8712;26280;2316;256714;10742;6173;9104;494197;29057;139324;442444;6103;54880;90736;55558;2742;1736;369;255313;3654;170627;645974;3897;79983;727940;541466;347527;8243;4007;139741;29978;2182;7504;60401;84707;53336;1485;159090;94056;57502;55285;653067;1046;11152;641339;1947;8852;7712;23708;203523;4267;54967;340542;89885;2277;83550;644353;55916;340595;6594;139189;63947;9643;9843;4935;139728;100288814;10479;50943;53940;55026;100507170;5638;4478;8239;4068;51114;139411;246100;9968;84679;115201;100533997;1741;416;64840;10682;11326;25763;27330;171483;8908;27286;1038;7543;158800;90060;1288;84061;215;6247;292;55879;401612;1183;340527;55344;29935;158983;357;10009;2747;2652;286514;340543;54885;100129407;10495;6792;79742;140886;2239;2334;4128;441518;139604;4303;55869;25878;4115;11040;8473;6855;84636;55922;728712;5956;2705;55841;54821;729396;441521;8933;10735;729442;9949;4694;84528;51481;492;3028;100129520;795;10389;83604;7411;9947;9367;100463488;10134;79057;54552;6906;340547;30014;415;5255;680;158809;6990;4435;5475;340529;65109;64860;7030;729428;8776;4675;5030;51566;729201;56271;4943;79917;85012;114928;5256;26609;54960;538;6853;5365;4354;286451;29934;10838;139221;9189;347404;6473;3251;286464;158931;139793;100008586;2717;3052;5973;139065;5199;546;5613;51270;139231;9131;7547;474381;257240;11254;27238;64102;2543;158747;2273;56474;5165;64648;54440;140597;5631;728239;3188;100130086;5251;8237;286527;100130302,815
-1,1,X,168547,155233731,155065184,23096;64061;392509;10214;170685;23157;727837;55998;23439;729431;10916;158586;55859;331;3423;54830;4168;6901;5358;92002;27344;729447;54328;266740;9075;102723737;7552;729422;54954;84460;389874;56000;340562;644538;92552;254158;79649;56850;8225;2824;100272147;51186;3149;26576;100130361;1730;347541;139425;3547;728695;729408;79921;57826;59272;203413;2986;7512;9737;8544;55634;2857;3421;537;11013;340554;5716;6658;4101;54457;1438;91966;441519;4100;5931;27316;7403;4534;6839;51480;728096;27112;92129;101928917;140462;8241;6567;827;203569;27301;84548;645037;54413;100133053;7355;254065;79836;10084;347442;60343;51765;55593;139818;56180;6303;8269;142684;7626;10046;8409;203447;63932;2710;4515;8406;51248;56001;51616;2925;100130613;2564;1193;100132994;5354;11043;340533;22;3476;84631;26748;11238;203562;102723631;170261;58526;441525;4983;29944;6907;1536;2539;1478;9468;23597;2187;1287;81887;6611;3561;9767;9282;54857;347365;10800;139341;54539;11219;728062;169966;51209;23630;26548;1121;2000;645188;51438;2846;280658;1852;347344;23229;10857;56157;286430;101059915;438;5277;9758;1069;4674;154796;56548;51309;1184;645073;80712;1774;10245;2258;728343;9823;441531;11141;643311;90121;256643;23676;4114;6758;4107;286499;5009;1654;1831;51284;94121;170302;11230;79135;286410;9210;2491;441490;84187;633;6191;64743;4110;3598;389856;7789;55787;9452;50814;2157;139422;170062;57187;139067;4104;203427;4693;5456;10013;1964;55190;100996648;293;9016;100528062;30011;90316;93953;10178;6322;28952;24137;2332;4105;6845;94122;84968;64663;1538;9142;286530;2245;5634;9506;79576;3266;139212;5207;6535;8227;393;389852;170626;91851;27334;158866;550643;159013;407;7224;55796;10761;100132963;168400;4281;158835;24140;8471;90167;7737;7319;10149;11279;6134;64109;1678;139322;5063;55906;116442;84443;27197;8233;548313;6872;27018;100129239;139105;7102;10549;26071;2664;59353;8573;28985;79184;728049;728090;158521;3581;139886;282808;8263;9130;728082;778;90843;1756;5422;7317;5935;347454;29071;207063;4112;412;158506;340602;30848;5127;22866;93380;159091;10159;212;139285;9338;85417;8266;100132399;158584;494118;190;7569;89801;2892;1968;5230;57232;55559;57529;8277;63035;80231;286436;25975;51311;8905;55086;139735;395;83692;171484;10251;169981;1349;63904;139716;257397;142689;80258;27035;1641;55613;7105;100329135;84295;9459;4810;404281;4109;367;474384;6748;139760;347487;92745;158830;53344;4103;9203;139378;186;474343;2719;3597;140456;9248;402415;203430;9185;90161;728042;4129;65267;56849;8228;8226;728036;7114;6399;4952;83740;84889;8481;6757;347468;347475;414;6759;9500;51132;8823;541578;2158;55609;2556;494119;6756;9502;158880;8517;8242;474383;57595;51442;389895;100132304;9754;80311;6102;27328;695;56159;51213;90737;60506;10943;100873985;57526;728269;170082;474382;102723680;728656;3358;8273;83844;114824;389840;170067;81557;80823;8862;2002;7216;79979;158763;23641;55217;8270;57477;7592;2833;425054;340526;727866;139599;139804;54470;8450;959;139562;645864;10075;117154;57631;2010;54521;79589;51634;3750;653282;728072;7076;392490;9363;8623;3920;347411;7454;100506164;265;90293;645051;100529097;55511;158724;6197;203547;139135;5355;347516;203522;139081;6451;27336;158787;728458;7499;4841;347517;51360;340578;139596;1896;441509;54466;660;158798;4108;171482;79868;728075;158833;79366;1821;56156;392465;1260;5160;56062;5303;3054;51260;139628;653220;340596;554;28986;23133;57393;2623;28227;4113;57692;50945;3730;7739;100131755;57481;8260;139170;64219;4204;389860;2574;3563;65991;10325;6170;10813;79710;8712;26280;2316;256714;10742;6173;9104;494197;29057;139324;442444;6103;54880;90736;55558;2742;1736;369;255313;3654;170627;645974;3897;79983;727940;541466;347527;8243;4007;139741;29978;2182;7504;60401;84707;53336;1485;159090;94056;57502;55285;653067;1046;11152;641339;1947;8852;7712;23708;203523;4267;54967;340542;89885;2277;83550;644353;55916;340595;6594;139189;63947;9643;9843;4935;139728;100288814;10479;50943;53940;55026;100507170;5638;4478;8239;4068;51114;139411;246100;9968;84679;115201;100533997;1741;416;64840;10682;11326;25763;27330;171483;8908;27286;1038;7543;158800;90060;1288;84061;215;6247;292;55879;401612;1183;340527;55344;29935;158983;357;10009;2747;2652;286514;340543;54885;100129407;10495;6792;79742;140886;2239;2334;4128;441518;139604;4303;55869;25878;4115;11040;8473;6855;84636;55922;728712;5956;2705;55841;54821;729396;441521;8933;10735;729442;9949;4694;84528;51481;492;3028;100129520;795;10389;83604;7411;9947;9367;100463488;10134;79057;54552;6906;340547;30014;415;5255;680;158809;6990;4435;5475;340529;65109;64860;7030;729428;8776;4675;5030;51566;729201;56271;4943;79917;85012;114928;5256;26609;54960;538;6853;5365;4354;286451;29934;10838;139221;9189;347404;6473;3251;286464;158931;139793;100008586;2717;3052;5973;139065;5199;546;5613;51270;139231;9131;7547;474381;257240;11254;27238;64102;2543;158747;2273;56474;5165;64648;54440;140597;5631;728239;3188;100130086;5251;8237;286527;100130302,815
1,1,X,168547,155233731,155065184,23096;64061;392509;10214;170685;23157;727837;55998;23439;729431;10916;158586;55859;331;3423;54830;4168;6901;5358;92002;27344;729447;54328;266740;9075;102723737;7552;729422;54954;84460;389874;56000;340562;644538;92552;254158;79649;56850;8225;2824;100272147;51186;3149;26576;100130361;1730;347541;139425;3547;728695;729408;79921;57826;59272;203413;2986;7512;9737;8544;55634;2857;3421;537;11013;340554;5716;6658;4101;54457;1438;91966;441519;4100;5931;27316;7403;4534;6839;51480;728096;27112;92129;101928917;140462;8241;6567;827;203569;27301;84548;645037;54413;100133053;7355;254065;79836;10084;347442;60343;51765;55593;139818;56180;6303;8269;142684;7626;10046;8409;203447;63932;2710;4515;8406;51248;56001;51616;2925;100130613;2564;1193;100132994;5354;11043;340533;22;3476;84631;26748;11238;203562;102723631;170261;58526;441525;4983;29944;6907;1536;2539;1478;9468;23597;2187;1287;81887;6611;3561;9767;9282;54857;347365;10800;139341;54539;11219;728062;169966;51209;23630;26548;1121;2000;645188;51438;2846;280658;1852;347344;23229;10857;56157;286430;101059915;438;5277;9758;1069;4674;154796;56548;51309;1184;645073;80712;1774;10245;2258;728343;9823;441531;11141;643311;90121;256643;23676;4114;6758;4107;286499;5009;1654;1831;51284;94121;170302;11230;79135;286410;9210;2491;441490;84187;633;6191;64743;4110;3598;389856;7789;55787;9452;50814;2157;139422;170062;57187;139067;4104;203427;4693;5456;10013;1964;55190;100996648;293;9016;100528062;30011;90316;93953;10178;6322;28952;24137;2332;4105;6845;94122;84968;64663;1538;9142;286530;2245;5634;9506;79576;3266;139212;5207;6535;8227;393;389852;170626;91851;27334;158866;550643;159013;407;7224;55796;10761;100132963;168400;4281;158835;24140;8471;90167;7737;7319;10149;11279;6134;64109;1678;139322;5063;55906;116442;84443;27197;8233;548313;6872;27018;100129239;139105;7102;10549;26071;2664;59353;8573;28985;79184;728049;728090;158521;3581;139886;282808;8263;9130;728082;778;90843;1756;5422;7317;5935;347454;29071;207063;4112;412;158506;340602;30848;5127;22866;93380;159091;10159;212;139285;9338;85417;8266;100132399;158584;494118;190;7569;89801;2892;1968;5230;57232;55559;57529;8277;63035;80231;286436;25975;51311;8905;55086;139735;395;83692;171484;10251;169981;1349;63904;139716;257397;142689;80258;27035;1641;55613;7105;100329135;84295;9459;4810;404281;4109;367;474384;6748;139760;347487;92745;158830;53344;4103;9203;139378;186;474343;2719;3597;140456;9248;402415;203430;9185;90161;728042;4129;65267;56849;8228;8226;728036;7114;6399;4952;83740;84889;8481;6757;347468;347475;414;6759;9500;51132;8823;541578;2158;55609;2556;494119;6756;9502;158880;8517;8242;474383;57595;51442;389895;100132304;9754;80311;6102;27328;695;56159;51213;90737;60506;10943;100873985;57526;728269;170082;474382;102723680;728656;3358;8273;83844;114824;389840;170067;81557;80823;8862;2002;7216;79979;158763;23641;55217;8270;57477;7592;2833;425054;340526;727866;139599;139804;54470;8450;959;139562;645864;10075;117154;57631;2010;54521;79589;51634;3750;653282;728072;7076;392490;9363;8623;3920;347411;7454;100506164;265;90293;645051;100529097;55511;158724;6197;203547;139135;5355;347516;203522;139081;6451;27336;158787;728458;7499;4841;347517;51360;340578;139596;1896;441509;54466;660;158798;4108;171482;79868;728075;158833;79366;1821;56156;392465;1260;5160;56062;5303;3054;51260;139628;653220;340596;554;28986;23133;57393;2623;28227;4113;57692;50945;3730;7739;100131755;57481;8260;139170;64219;4204;389860;2574;3563;65991;10325;6170;10813;79710;8712;26280;2316;256714;10742;6173;9104;494197;29057;139324;442444;6103;54880;90736;55558;2742;1736;369;255313;3654;170627;645974;3897;79983;727940;541466;347527;8243;4007;139741;29978;2182;7504;60401;84707;53336;1485;159090;94056;57502;55285;653067;1046;11152;641339;1947;8852;7712;23708;203523;4267;54967;340542;89885;2277;83550;644353;55916;340595;6594;139189;63947;9643;9843;4935;139728;100288814;10479;50943;53940;55026;100507170;5638;4478;8239;4068;51114;139411;246100;9968;84679;115201;100533997;1741;416;64840;10682;11326;25763;27330;171483;8908;27286;1038;7543;158800;90060;1288;84061;215;6247;292;55879;401612;1183;340527;55344;29935;158983;357;10009;2747;2652;286514;340543;54885;100129407;10495;6792;79742;140886;2239;2334;4128;441518;139604;4303;55869;25878;4115;11040;8473;6855;84636;55922;728712;5956;2705;55841;54821;729396;441521;8933;10735;729442;9949;4694;84528;51481;492;3028;100129520;795;10389;83604;7411;9947;9367;100463488;10134;79057;54552;6906;340547;30014;415;5255;680;158809;6990;4435;5475;340529;65109;64860;7030;729428;8776;4675;5030;51566;729201;56271;4943;79917;85012;114928;5256;26609;54960;538;6853;5365;4354;286451;29934;10838;139221;9189;347404;6473;3251;286464;158931;139793;100008586;2717;3052;5973;139065;5199;546;5613;51270;139231;9131;7547;474381;257240;11254;27238;64102;2543;158747;2273;56474;5165;64648;54440;140597;5631;728239;3188;100130086;5251;8237;286527;100130302,815
-1,1,X,168547,155233731,155065184,23096;64061;392509;10214;170685;23157;727837;55998;23439;729431;10916;158586;55859;331;3423;54830;4168;6901;5358;92002;27344;729447;54328;266740;9075;102723737;7552;729422;54954;84460;389874;56000;340562;644538;92552;254158;79649;56850;8225;2824;100272147;51186;3149;26576;100130361;1730;347541;139425;3547;728695;729408;79921;57826;59272;203413;2986;7512;9737;8544;55634;2857;3421;537;11013;340554;5716;6658;4101;54457;1438;91966;441519;4100;5931;27316;7403;4534;6839;51480;728096;27112;92129;101928917;140462;8241;6567;827;203569;27301;84548;645037;54413;100133053;7355;254065;79836;10084;347442;60343;51765;55593;139818;56180;6303;8269;142684;7626;10046;8409;203447;63932;2710;4515;8406;51248;56001;51616;2925;100130613;2564;1193;100132994;5354;11043;340533;22;3476;84631;26748;11238;203562;102723631;170261;58526;441525;4983;29944;6907;1536;2539;1478;9468;23597;2187;1287;81887;6611;3561;9767;9282;54857;347365;10800;139341;54539;11219;728062;169966;51209;23630;26548;1121;2000;645188;51438;2846;280658;1852;347344;23229;10857;56157;286430;101059915;438;5277;9758;1069;4674;154796;56548;51309;1184;645073;80712;1774;10245;2258;728343;9823;441531;11141;643311;90121;256643;23676;4114;6758;4107;286499;5009;1654;1831;51284;94121;170302;11230;79135;286410;9210;2491;441490;84187;633;6191;64743;4110;3598;389856;7789;55787;9452;50814;2157;139422;170062;57187;139067;4104;203427;4693;5456;10013;1964;55190;100996648;293;9016;100528062;30011;90316;93953;10178;6322;28952;24137;2332;4105;6845;94122;84968;64663;1538;9142;286530;2245;5634;9506;79576;3266;139212;5207;6535;8227;393;389852;170626;91851;27334;158866;550643;159013;407;7224;55796;10761;100132963;168400;4281;158835;24140;8471;90167;7737;7319;10149;11279;6134;64109;1678;139322;5063;55906;116442;84443;27197;8233;548313;6872;27018;100129239;139105;7102;10549;26071;2664;59353;8573;28985;79184;728049;728090;158521;3581;139886;282808;8263;9130;728082;778;90843;1756;5422;7317;5935;347454;29071;207063;4112;412;158506;340602;30848;5127;22866;93380;159091;10159;212;139285;9338;85417;8266;100132399;158584;494118;190;7569;89801;2892;1968;5230;57232;55559;57529;8277;63035;80231;286436;25975;51311;8905;55086;139735;395;83692;171484;10251;169981;1349;63904;139716;257397;142689;80258;27035;1641;55613;7105;100329135;84295;9459;4810;404281;4109;367;474384;6748;139760;347487;92745;158830;53344;4103;9203;139378;186;474343;2719;3597;140456;9248;402415;203430;9185;90161;728042;4129;65267;56849;8228;8226;728036;7114;6399;4952;83740;84889;8481;6757;347468;347475;414;6759;9500;51132;8823;541578;2158;55609;2556;494119;6756;9502;158880;8517;8242;474383;57595;51442;389895;100132304;9754;80311;6102;27328;695;56159;51213;90737;60506;10943;100873985;57526;728269;170082;474382;102723680;728656;3358;8273;83844;114824;389840;170067;81557;80823;8862;2002;7216;79979;158763;23641;55217;8270;57477;7592;2833;425054;340526;727866;139599;139804;54470;8450;959;139562;645864;10075;117154;57631;2010;54521;79589;51634;3750;653282;728072;7076;392490;9363;8623;3920;347411;7454;100506164;265;90293;645051;100529097;55511;158724;6197;203547;139135;5355;347516;203522;139081;6451;27336;158787;728458;7499;4841;347517;51360;340578;139596;1896;441509;54466;660;158798;4108;171482;79868;728075;158833;79366;1821;56156;392465;1260;5160;56062;5303;3054;51260;139628;653220;340596;554;28986;23133;57393;2623;28227;4113;57692;50945;3730;7739;100131755;57481;8260;139170;64219;4204;389860;2574;3563;65991;10325;6170;10813;79710;8712;26280;2316;256714;10742;6173;9104;494197;29057;139324;442444;6103;54880;90736;55558;2742;1736;369;255313;3654;170627;645974;3897;79983;727940;541466;347527;8243;4007;139741;29978;2182;7504;60401;84707;53336;1485;159090;94056;57502;55285;653067;1046;11152;641339;1947;8852;7712;23708;203523;4267;54967;340542;89885;2277;83550;644353;55916;340595;6594;139189;63947;9643;9843;4935;139728;100288814;10479;50943;53940;55026;100507170;5638;4478;8239;4068;51114;139411;246100;9968;84679;115201;100533997;1741;416;64840;10682;11326;25763;27330;171483;8908;27286;1038;7543;158800;90060;1288;84061;215;6247;292;55879;401612;1183;340527;55344;29935;158983;357;10009;2747;2652;286514;340543;54885;100129407;10495;6792;79742;140886;2239;2334;4128;441518;139604;4303;55869;25878;4115;11040;8473;6855;84636;55922;728712;5956;2705;55841;54821;729396;441521;8933;10735;729442;9949;4694;84528;51481;492;3028;100129520;795;10389;83604;7411;9947;9367;100463488;10134;79057;54552;6906;340547;30014;415;5255;680;158809;6990;4435;5475;340529;65109;64860;7030;729428;8776;4675;5030;51566;729201;56271;4943;79917;85012;114928;5256;26609;54960;538;6853;5365;4354;286451;29934;10838;139221;9189;347404;6473;3251;286464;158931;139793;100008586;2717;3052;5973;139065;5199;546;5613;51270;139231;9131;7547;474381;257240;11254;27238;64102;2543;158747;2273;56474;5165;64648;54440;140597;5631;728239;3188;100130086;5251;8237;286527;100130302,815
1,1,X,168547,155233731,155065184,23096;64061;392509;10214;170685;23157;727837;55998;23439;729431;10916;158586;55859;331;3423;54830;4168;6901;5358;92002;27344;729447;54328;266740;9075;102723737;7552;729422;54954;84460;389874;56000;340562;644538;92552;254158;79649;56850;8225;2824;100272147;51186;3149;26576;100130361;1730;347541;139425;3547;728695;729408;79921;57826;59272;203413;2986;7512;9737;8544;55634;2857;3421;537;11013;340554;5716;6658;4101;54457;1438;91966;441519;4100;5931;27316;7403;4534;6839;51480;728096;27112;92129;101928917;140462;8241;6567;827;203569;27301;84548;645037;54413;100133053;7355;254065;79836;10084;347442;60343;51765;55593;139818;56180;6303;8269;142684;7626;10046;8409;203447;63932;2710;4515;8406;51248;56001;51616;2925;100130613;2564;1193;100132994;5354;11043;340533;22;3476;84631;26748;11238;203562;102723631;170261;58526;441525;4983;29944;6907;1536;2539;1478;9468;23597;2187;1287;81887;6611;3561;9767;9282;54857;347365;10800;139341;54539;11219;728062;169966;51209;23630;26548;1121;2000;645188;51438;2846;280658;1852;347344;23229;10857;56157;286430;101059915;438;5277;9758;1069;4674;154796;56548;51309;1184;645073;80712;1774;10245;2258;728343;9823;441531;11141;643311;90121;256643;23676;4114;6758;4107;286499;5009;1654;1831;51284;94121;170302;11230;79135;286410;9210;2491;441490;84187;633;6191;64743;4110;3598;389856;7789;55787;9452;50814;2157;139422;170062;57187;139067;4104;203427;4693;5456;10013;1964;55190;100996648;293;9016;100528062;30011;90316;93953;10178;6322;28952;24137;2332;4105;6845;94122;84968;64663;1538;9142;286530;2245;5634;9506;79576;3266;139212;5207;6535;8227;393;389852;170626;91851;27334;158866;550643;159013;407;7224;55796;10761;100132963;168400;4281;158835;24140;8471;90167;7737;7319;10149;11279;6134;64109;1678;139322;5063;55906;116442;84443;27197;8233;548313;6872;27018;100129239;139105;7102;10549;26071;2664;59353;8573;28985;79184;728049;728090;158521;3581;139886;282808;8263;9130;728082;778;90843;1756;5422;7317;5935;347454;29071;207063;4112;412;158506;340602;30848;5127;22866;93380;159091;10159;212;139285;9338;85417;8266;100132399;158584;494118;190;7569;89801;2892;1968;5230;57232;55559;57529;8277;63035;80231;286436;25975;51311;8905;55086;139735;395;83692;171484;10251;169981;1349;63904;139716;257397;142689;80258;27035;1641;55613;7105;100329135;84295;9459;4810;404281;4109;367;474384;6748;139760;347487;92745;158830;53344;4103;9203;139378;186;474343;2719;3597;140456;9248;402415;203430;9185;90161;728042;4129;65267;56849;8228;8226;728036;7114;6399;4952;83740;84889;8481;6757;347468;347475;414;6759;9500;51132;8823;541578;2158;55609;2556;494119;6756;9502;158880;8517;8242;474383;57595;51442;389895;100132304;9754;80311;6102;27328;695;56159;51213;90737;60506;10943;100873985;57526;728269;170082;474382;102723680;728656;3358;8273;83844;114824;389840;170067;81557;80823;8862;2002;7216;79979;158763;23641;55217;8270;57477;7592;2833;425054;340526;727866;139599;139804;54470;8450;959;139562;645864;10075;117154;57631;2010;54521;79589;51634;3750;653282;728072;7076;392490;9363;8623;3920;347411;7454;100506164;265;90293;645051;100529097;55511;158724;6197;203547;139135;5355;347516;203522;139081;6451;27336;158787;728458;7499;4841;347517;51360;340578;139596;1896;441509;54466;660;158798;4108;171482;79868;728075;158833;79366;1821;56156;392465;1260;5160;56062;5303;3054;51260;139628;653220;340596;554;28986;23133;57393;2623;28227;4113;57692;50945;3730;7739;100131755;57481;8260;139170;64219;4204;389860;2574;3563;65991;10325;6170;10813;79710;8712;26280;2316;256714;10742;6173;9104;494197;29057;139324;442444;6103;54880;90736;55558;2742;1736;369;255313;3654;170627;645974;3897;79983;727940;541466;347527;8243;4007;139741;29978;2182;7504;60401;84707;53336;1485;159090;94056;57502;55285;653067;1046;11152;641339;1947;8852;7712;23708;203523;4267;54967;340542;89885;2277;83550;644353;55916;340595;6594;139189;63947;9643;9843;4935;139728;100288814;10479;50943;53940;55026;100507170;5638;4478;8239;4068;51114;139411;246100;9968;84679;115201;100533997;1741;416;64840;10682;11326;25763;27330;171483;8908;27286;1038;7543;158800;90060;1288;84061;215;6247;292;55879;401612;1183;340527;55344;29935;158983;357;10009;2747;2652;286514;340543;54885;100129407;10495;6792;79742;140886;2239;2334;4128;441518;139604;4303;55869;25878;4115;11040;8473;6855;84636;55922;728712;5956;2705;55841;54821;729396;441521;8933;10735;729442;9949;4694;84528;51481;492;3028;100129520;795;10389;83604;7411;9947;9367;100463488;10134;79057;54552;6906;340547;30014;415;5255;680;158809;6990;4435;5475;340529;65109;64860;7030;729428;8776;4675;5030;51566;729201;56271;4943;79917;85012;114928;5256;26609;54960;538;6853;5365;4354;286451;29934;10838;139221;9189;347404;6473;3251;286464;158931;139793;100008586;2717;3052;5973;139065;5199;546;5613;51270;139231;9131;7547;474381;257240;11254;27238;64102;2543;158747;2273;56474;5165;64648;54440;140597;5631;728239;3188;100130086;5251;8237;286527;100130302,815
1,1,X,168547,155233731,155065184,23096;64061;392509;10214;170685;23157;727837;55998;23439;729431;10916;158586;55859;331;3423;54830;4168;6901;5358;92002;27344;729447;54328;266740;9075;102723737;7552;729422;54954;84460;389874;56000;340562;644538;92552;254158;79649;56850;8225;2824;100272147;51186;3149;26576;100130361;1730;347541;139425;3547;728695;729408;79921;57826;59272;203413;2986;7512;9737;8544;55634;2857;3421;537;11013;340554;5716;6658;4101;54457;1438;91966;441519;4100;5931;27316;7403;4534;6839;51480;728096;27112;92129;101928917;140462;8241;6567;827;203569;27301;84548;645037;54413;100133053;7355;254065;79836;10084;347442;60343;51765;55593;139818;56180;6303;8269;142684;7626;10046;8409;203447;63932;2710;4515;8406;51248;56001;51616;2925;100130613;2564;1193;100132994;5354;11043;340533;22;3476;84631;26748;11238;203562;102723631;170261;58526;441525;4983;29944;6907;1536;2539;1478;9468;23597;2187;1287;81887;6611;3561;9767;9282;54857;347365;10800;139341;54539;11219;728062;169966;51209;23630;26548;1121;2000;645188;51438;2846;280658;1852;347344;23229;10857;56157;286430;101059915;438;5277;9758;1069;4674;154796;56548;51309;1184;645073;80712;1774;10245;2258;728343;9823;441531;11141;643311;90121;256643;23676;4114;6758;4107;286499;5009;1654;1831;51284;94121;170302;11230;79135;286410;9210;2491;441490;84187;633;6191;64743;4110;3598;389856;7789;55787;9452;50814;2157;139422;170062;57187;139067;4104;203427;4693;5456;10013;1964;55190;100996648;293;9016;100528062;30011;90316;93953;10178;6322;28952;24137;2332;4105;6845;94122;84968;64663;1538;9142;286530;2245;5634;9506;79576;3266;139212;5207;6535;8227;393;389852;170626;91851;27334;158866;550643;159013;407;7224;55796;10761;100132963;168400;4281;158835;24140;8471;90167;7737;7319;10149;11279;6134;64109;1678;139322;5063;55906;116442;84443;27197;8233;548313;6872;27018;100129239;139105;7102;10549;26071;2664;59353;8573;28985;79184;728049;728090;158521;3581;139886;282808;8263;9130;728082;778;90843;1756;5422;7317;5935;347454;29071;207063;4112;412;158506;340602;30848;5127;22866;93380;159091;10159;212;139285;9338;85417;8266;100132399;158584;494118;190;7569;89801;2892;1968;5230;57232;55559;57529;8277;63035;80231;286436;25975;51311;8905;55086;139735;395;83692;171484;10251;169981;1349;63904;139716;257397;142689;80258;27035;1641;55613;7105;100329135;84295;9459;4810;404281;4109;367;474384;6748;139760;347487;92745;158830;53344;4103;9203;139378;186;474343;2719;3597;140456;9248;402415;203430;9185;90161;728042;4129;65267;56849;8228;8226;728036;7114;6399;4952;83740;84889;8481;6757;347468;347475;414;6759;9500;51132;8823;541578;2158;55609;2556;494119;6756;9502;158880;8517;8242;474383;57595;51442;389895;100132304;9754;80311;6102;27328;695;56159;51213;90737;60506;10943;100873985;57526;728269;170082;474382;102723680;728656;3358;8273;83844;114824;389840;170067;81557;80823;8862;2002;7216;79979;158763;23641;55217;8270;57477;7592;2833;425054;340526;727866;139599;139804;54470;8450;959;139562;645864;10075;117154;57631;2010;54521;79589;51634;3750;653282;728072;7076;392490;9363;8623;3920;347411;7454;100506164;265;90293;645051;100529097;55511;158724;6197;203547;139135;5355;347516;203522;139081;6451;27336;158787;728458;7499;4841;347517;51360;340578;139596;1896;441509;54466;660;158798;4108;171482;79868;728075;158833;79366;1821;56156;392465;1260;5160;56062;5303;3054;51260;139628;653220;340596;554;28986;23133;57393;2623;28227;4113;57692;50945;3730;7739;100131755;57481;8260;139170;64219;4204;389860;2574;3563;65991;10325;6170;10813;79710;8712;26280;2316;256714;10742;6173;9104;494197;29057;139324;442444;6103;54880;90736;55558;2742;1736;369;255313;3654;170627;645974;3897;79983;727940;541466;347527;8243;4007;139741;29978;2182;7504;60401;84707;53336;1485;159090;94056;57502;55285;653067;1046;11152;641339;1947;8852;7712;23708;203523;4267;54967;340542;89885;2277;83550;644353;55916;340595;6594;139189;63947;9643;9843;4935;139728;100288814;10479;50943;53940;55026;100507170;5638;4478;8239;4068;51114;139411;246100;9968;84679;115201;100533997;1741;416;64840;10682;11326;25763;27330;171483;8908;27286;1038;7543;158800;90060;1288;84061;215;6247;292;55879;401612;1183;340527;55344;29935;158983;357;10009;2747;2652;286514;340543;54885;100129407;10495;6792;79742;140886;2239;2334;4128;441518;139604;4303;55869;25878;4115;11040;8473;6855;84636;55922;728712;5956;2705;55841;54821;729396;441521;8933;10735;729442;9949;4694;84528;51481;492;3028;100129520;795;10389;83604;7411;9947;9367;100463488;10134;79057;54552;6906;340547;30014;415;5255;680;158809;6990;4435;5475;340529;65109;64860;7030;729428;8776;4675;5030;51566;729201;56271;4943;79917;85012;114928;5256;26609;54960;538;6853;5365;4354;286451;29934;10838;139221;9189;347404;6473;3251;286464;158931;139793;100008586;2717;3052;5973;139065;5199;546;5613;51270;139231;9131;7547;474381;257240;11254;27238;64102;2543;158747;2273;56474;5165;64648;54440;140597;5631;728239;3188;100130086;5251;8237;286527;100130302,815
1,1,X,168547,155233731,155065184,23096;64061;392509;10214;170685;23157;727837;55998;23439;729431;10916;158586;55859;331;3423;54830;4168;6901;5358;92002;27344;729447;54328;266740;9075;102723737;7552;729422;54954;84460;389874;56000;340562;644538;92552;254158;79649;56850;8225;2824;100272147;51186;3149;26576;100130361;1730;347541;139425;3547;728695;729408;79921;57826;59272;203413;2986;7512;9737;8544;55634;2857;3421;537;11013;340554;5716;6658;4101;54457;1438;91966;441519;4100;5931;27316;7403;4534;6839;51480;728096;27112;92129;101928917;140462;8241;6567;827;203569;27301;84548;645037;54413;100133053;7355;254065;79836;10084;347442;60343;51765;55593;139818;56180;6303;8269;142684;7626;10046;8409;203447;63932;2710;4515;8406;51248;56001;51616;2925;100130613;2564;1193;100132994;5354;11043;340533;22;3476;84631;26748;11238;203562;102723631;170261;58526;441525;4983;29944;6907;1536;2539;1478;9468;23597;2187;1287;81887;6611;3561;9767;9282;54857;347365;10800;139341;54539;11219;728062;169966;51209;23630;26548;1121;2000;645188;51438;2846;280658;1852;347344;23229;10857;56157;286430;101059915;438;5277;9758;1069;4674;154796;56548;51309;1184;645073;80712;1774;10245;2258;728343;9823;441531;11141;643311;90121;256643;23676;4114;6758;4107;286499;5009;1654;1831;51284;94121;170302;11230;79135;286410;9210;2491;441490;84187;633;6191;64743;4110;3598;389856;7789;55787;9452;50814;2157;139422;170062;57187;139067;4104;203427;4693;5456;10013;1964;55190;100996648;293;9016;100528062;30011;90316;93953;10178;6322;28952;24137;2332;4105;6845;94122;84968;64663;1538;9142;286530;2245;5634;9506;79576;3266;139212;5207;6535;8227;393;389852;170626;91851;27334;158866;550643;159013;407;7224;55796;10761;100132963;168400;4281;158835;24140;8471;90167;7737;7319;10149;11279;6134;64109;1678;139322;5063;55906;116442;84443;27197;8233;548313;6872;27018;100129239;139105;7102;10549;26071;2664;59353;8573;28985;79184;728049;728090;158521;3581;139886;282808;8263;9130;728082;778;90843;1756;5422;7317;5935;347454;29071;207063;4112;412;158506;340602;30848;5127;22866;93380;159091;10159;212;139285;9338;85417;8266;100132399;158584;494118;190;7569;89801;2892;1968;5230;57232;55559;57529;8277;63035;80231;286436;25975;51311;8905;55086;139735;395;83692;171484;10251;169981;1349;63904;139716;257397;142689;80258;27035;1641;55613;7105;100329135;84295;9459;4810;404281;4109;367;474384;6748;139760;347487;92745;158830;53344;4103;9203;139378;186;474343;2719;3597;140456;9248;402415;203430;9185;90161;728042;4129;65267;56849;8228;8226;728036;7114;6399;4952;83740;84889;8481;6757;347468;347475;414;6759;9500;51132;8823;541578;2158;55609;2556;494119;6756;9502;158880;8517;8242;474383;57595;51442;389895;100132304;9754;80311;6102;27328;695;56159;51213;90737;60506;10943;100873985;57526;728269;170082;474382;102723680;728656;3358;8273;83844;114824;389840;170067;81557;80823;8862;2002;7216;79979;158763;23641;55217;8270;57477;7592;2833;425054;340526;727866;139599;139804;54470;8450;959;139562;645864;10075;117154;57631;2010;54521;79589;51634;3750;653282;728072;7076;392490;9363;8623;3920;347411;7454;100506164;265;90293;645051;100529097;55511;158724;6197;203547;139135;5355;347516;203522;139081;6451;27336;158787;728458;7499;4841;347517;51360;340578;139596;1896;441509;54466;660;158798;4108;171482;79868;728075;158833;79366;1821;56156;392465;1260;5160;56062;5303;3054;51260;139628;653220;340596;554;28986;23133;57393;2623;28227;4113;57692;50945;3730;7739;100131755;57481;8260;139170;64219;4204;389860;2574;3563;65991;10325;6170;10813;79710;8712;26280;2316;256714;10742;6173;9104;494197;29057;139324;442444;6103;54880;90736;55558;2742;1736;369;255313;3654;170627;645974;3897;79983;727940;541466;347527;8243;4007;139741;29978;2182;7504;60401;84707;53336;1485;159090;94056;57502;55285;653067;1046;11152;641339;1947;8852;7712;23708;203523;4267;54967;340542;89885;2277;83550;644353;55916;340595;6594;139189;63947;9643;9843;4935;139728;100288814;10479;50943;53940;55026;100507170;5638;4478;8239;4068;51114;139411;246100;9968;84679;115201;100533997;1741;416;64840;10682;11326;25763;27330;171483;8908;27286;1038;7543;158800;90060;1288;84061;215;6247;292;55879;401612;1183;340527;55344;29935;158983;357;10009;2747;2652;286514;340543;54885;100129407;10495;6792;79742;140886;2239;2334;4128;441518;139604;4303;55869;25878;4115;11040;8473;6855;84636;55922;728712;5956;2705;55841;54821;729396;441521;8933;10735;729442;9949;4694;84528;51481;492;3028;100129520;795;10389;83604;7411;9947;9367;100463488;10134;79057;54552;6906;340547;30014;415;5255;680;158809;6990;4435;5475;340529;65109;64860;7030;729428;8776;4675;5030;51566;729201;56271;4943;79917;85012;114928;5256;26609;54960;538;6853;5365;4354;286451;29934;10838;139221;9189;347404;6473;3251;286464;158931;139793;100008586;2717;3052;5973;139065;5199;546;5613;51270;139231;9131;7547;474381;257240;11254;27238;64102;2543;158747;2273;56474;5165;64648;54440;140597;5631;728239;3188;100130086;5251;8237;286527;100130302,815
-1,1,X,168547,155233731,155065184,23096;64061;392509;10214;170685;23157;727837;55998;23439;729431;10916;158586;55859;331;3423;54830;4168;6901;5358;92002;27344;729447;54328;266740;9075;102723737;7552;729422;54954;84460;389874;56000;340562;644538;92552;254158;79649;56850;8225;2824;100272147;51186;3149;26576;100130361;1730;347541;139425;3547;728695;729408;79921;57826;59272;203413;2986;7512;9737;8544;55634;2857;3421;537;11013;340554;5716;6658;4101;54457;1438;91966;441519;4100;5931;27316;7403;4534;6839;51480;728096;27112;92129;101928917;140462;8241;6567;827;203569;27301;84548;645037;54413;100133053;7355;254065;79836;10084;347442;60343;51765;55593;139818;56180;6303;8269;142684;7626;10046;8409;203447;63932;2710;4515;8406;51248;56001;51616;2925;100130613;2564;1193;100132994;5354;11043;340533;22;3476;84631;26748;11238;203562;102723631;170261;58526;441525;4983;29944;6907;1536;2539;1478;9468;23597;2187;1287;81887;6611;3561;9767;9282;54857;347365;10800;139341;54539;11219;728062;169966;51209;23630;26548;1121;2000;645188;51438;2846;280658;1852;347344;23229;10857;56157;286430;101059915;438;5277;9758;1069;4674;154796;56548;51309;1184;645073;80712;1774;10245;2258;728343;9823;441531;11141;643311;90121;256643;23676;4114;6758;4107;286499;5009;1654;1831;51284;94121;170302;11230;79135;286410;9210;2491;441490;84187;633;6191;64743;4110;3598;389856;7789;55787;9452;50814;2157;139422;170062;57187;139067;4104;203427;4693;5456;10013;1964;55190;100996648;293;9016;100528062;30011;90316;93953;10178;6322;28952;24137;2332;4105;6845;94122;84968;64663;1538;9142;286530;2245;5634;9506;79576;3266;139212;5207;6535;8227;393;389852;170626;91851;27334;158866;550643;159013;407;7224;55796;10761;100132963;168400;4281;158835;24140;8471;90167;7737;7319;10149;11279;6134;64109;1678;139322;5063;55906;116442;84443;27197;8233;548313;6872;27018;100129239;139105;7102;10549;26071;2664;59353;8573;28985;79184;728049;728090;158521;3581;139886;282808;8263;9130;728082;778;90843;1756;5422;7317;5935;347454;29071;207063;4112;412;158506;340602;30848;5127;22866;93380;159091;10159;212;139285;9338;85417;8266;100132399;158584;494118;190;7569;89801;2892;1968;5230;57232;55559;57529;8277;63035;80231;286436;25975;51311;8905;55086;139735;395;83692;171484;10251;169981;1349;63904;139716;257397;142689;80258;27035;1641;55613;7105;100329135;84295;9459;4810;404281;4109;367;474384;6748;139760;347487;92745;158830;53344;4103;9203;139378;186;474343;2719;3597;140456;9248;402415;203430;9185;90161;728042;4129;65267;56849;8228;8226;728036;7114;6399;4952;83740;84889;8481;6757;347468;347475;414;6759;9500;51132;8823;541578;2158;55609;2556;494119;6756;9502;158880;8517;8242;474383;57595;51442;389895;100132304;9754;80311;6102;27328;695;56159;51213;90737;60506;10943;100873985;57526;728269;170082;474382;102723680;728656;3358;8273;83844;114824;389840;170067;81557;80823;8862;2002;7216;79979;158763;23641;55217;8270;57477;7592;2833;425054;340526;727866;139599;139804;54470;8450;959;139562;645864;10075;117154;57631;2010;54521;79589;51634;3750;653282;728072;7076;392490;9363;8623;3920;347411;7454;100506164;265;90293;645051;100529097;55511;158724;6197;203547;139135;5355;347516;203522;139081;6451;27336;158787;728458;7499;4841;347517;51360;340578;139596;1896;441509;54466;660;158798;4108;171482;79868;728075;158833;79366;1821;56156;392465;1260;5160;56062;5303;3054;51260;139628;653220;340596;554;28986;23133;57393;2623;28227;4113;57692;50945;3730;7739;100131755;57481;8260;139170;64219;4204;389860;2574;3563;65991;10325;6170;10813;79710;8712;26280;2316;256714;10742;6173;9104;494197;29057;139324;442444;6103;54880;90736;55558;2742;1736;369;255313;3654;170627;645974;3897;79983;727940;541466;347527;8243;4007;139741;29978;2182;7504;60401;84707;53336;1485;159090;94056;57502;55285;653067;1046;11152;641339;1947;8852;7712;23708;203523;4267;54967;340542;89885;2277;83550;644353;55916;340595;6594;139189;63947;9643;9843;4935;139728;100288814;10479;50943;53940;55026;100507170;5638;4478;8239;4068;51114;139411;246100;9968;84679;115201;100533997;1741;416;64840;10682;11326;25763;27330;171483;8908;27286;1038;7543;158800;90060;1288;84061;215;6247;292;55879;401612;1183;340527;55344;29935;158983;357;10009;2747;2652;286514;340543;54885;100129407;10495;6792;79742;140886;2239;2334;4128;441518;139604;4303;55869;25878;4115;11040;8473;6855;84636;55922;728712;5956;2705;55841;54821;729396;441521;8933;10735;729442;9949;4694;84528;51481;492;3028;100129520;795;10389;83604;7411;9947;9367;100463488;10134;79057;54552;6906;340547;30014;415;5255;680;158809;6990;4435;5475;340529;65109;64860;7030;729428;8776;4675;5030;51566;729201;56271;4943;79917;85012;114928;5256;26609;54960;538;6853;5365;4354;286451;29934;10838;139221;9189;347404;6473;3251;286464;158931;139793;100008586;2717;3052;5973;139065;5199;546;5613;51270;139231;9131;7547;474381;257240;11254;27238;64102;2543;158747;2273;56474;5165;64648;54440;140597;5631;728239;3188;100130086;5251;8237;286527;100130302,815
-1,1,X,168547,155233731,155065184,23096;64061;392509;10214;170685;23157;727837;55998;23439;729431;10916;158586;55859;331;3423;54830;4168;6901;5358;92002;27344;729447;54328;266740;9075;102723737;7552;729422;54954;84460;389874;56000;340562;644538;92552;254158;79649;56850;8225;2824;100272147;51186;3149;26576;100130361;1730;347541;139425;3547;728695;729408;79921;57826;59272;203413;2986;7512;9737;8544;55634;2857;3421;537;11013;340554;5716;6658;4101;54457;1438;91966;441519;4100;5931;27316;7403;4534;6839;51480;728096;27112;92129;101928917;140462;8241;6567;827;203569;27301;84548;645037;54413;100133053;7355;254065;79836;10084;347442;60343;51765;55593;139818;56180;6303;8269;142684;7626;10046;8409;203447;63932;2710;4515;8406;51248;56001;51616;2925;100130613;2564;1193;100132994;5354;11043;340533;22;3476;84631;26748;11238;203562;102723631;170261;58526;441525;4983;29944;6907;1536;2539;1478;9468;23597;2187;1287;81887;6611;3561;9767;9282;54857;347365;10800;139341;54539;11219;728062;169966;51209;23630;26548;1121;2000;645188;51438;2846;280658;1852;347344;23229;10857;56157;286430;101059915;438;5277;9758;1069;4674;154796;56548;51309;1184;645073;80712;1774;10245;2258;728343;9823;441531;11141;643311;90121;256643;23676;4114;6758;4107;286499;5009;1654;1831;51284;94121;170302;11230;79135;286410;9210;2491;441490;84187;633;6191;64743;4110;3598;389856;7789;55787;9452;50814;2157;139422;170062;57187;139067;4104;203427;4693;5456;10013;1964;55190;100996648;293;9016;100528062;30011;90316;93953;10178;6322;28952;24137;2332;4105;6845;94122;84968;64663;1538;9142;286530;2245;5634;9506;79576;3266;139212;5207;6535;8227;393;389852;170626;91851;27334;158866;550643;159013;407;7224;55796;10761;100132963;168400;4281;158835;24140;8471;90167;7737;7319;10149;11279;6134;64109;1678;139322;5063;55906;116442;84443;27197;8233;548313;6872;27018;100129239;139105;7102;10549;26071;2664;59353;8573;28985;79184;728049;728090;158521;3581;139886;282808;8263;9130;728082;778;90843;1756;5422;7317;5935;347454;29071;207063;4112;412;158506;340602;30848;5127;22866;93380;159091;10159;212;139285;9338;85417;8266;100132399;158584;494118;190;7569;89801;2892;1968;5230;57232;55559;57529;8277;63035;80231;286436;25975;51311;8905;55086;139735;395;83692;171484;10251;169981;1349;63904;139716;257397;142689;80258;27035;1641;55613;7105;100329135;84295;9459;4810;404281;4109;367;474384;6748;139760;347487;92745;158830;53344;4103;9203;139378;186;474343;2719;3597;140456;9248;402415;203430;9185;90161;728042;4129;65267;56849;8228;8226;728036;7114;6399;4952;83740;84889;8481;6757;347468;347475;414;6759;9500;51132;8823;541578;2158;55609;2556;494119;6756;9502;158880;8517;8242;474383;57595;51442;389895;100132304;9754;80311;6102;27328;695;56159;51213;90737;60506;10943;100873985;57526;728269;170082;474382;102723680;728656;3358;8273;83844;114824;389840;170067;81557;80823;8862;2002;7216;79979;158763;23641;55217;8270;57477;7592;2833;425054;340526;727866;139599;139804;54470;8450;959;139562;645864;10075;117154;57631;2010;54521;79589;51634;3750;653282;728072;7076;392490;9363;8623;3920;347411;7454;100506164;265;90293;645051;100529097;55511;158724;6197;203547;139135;5355;347516;203522;139081;6451;27336;158787;728458;7499;4841;347517;51360;340578;139596;1896;441509;54466;660;158798;4108;171482;79868;728075;158833;79366;1821;56156;392465;1260;5160;56062;5303;3054;51260;139628;653220;340596;554;28986;23133;57393;2623;28227;4113;57692;50945;3730;7739;100131755;57481;8260;139170;64219;4204;389860;2574;3563;65991;10325;6170;10813;79710;8712;26280;2316;256714;10742;6173;9104;494197;29057;139324;442444;6103;54880;90736;55558;2742;1736;369;255313;3654;170627;645974;3897;79983;727940;541466;347527;8243;4007;139741;29978;2182;7504;60401;84707;53336;1485;159090;94056;57502;55285;653067;1046;11152;641339;1947;8852;7712;23708;203523;4267;54967;340542;89885;2277;83550;644353;55916;340595;6594;139189;63947;9643;9843;4935;139728;100288814;10479;50943;53940;55026;100507170;5638;4478;8239;4068;51114;139411;246100;9968;84679;115201;100533997;1741;416;64840;10682;11326;25763;27330;171483;8908;27286;1038;7543;158800;90060;1288;84061;215;6247;292;55879;401612;1183;340527;55344;29935;158983;357;10009;2747;2652;286514;340543;54885;100129407;10495;6792;79742;140886;2239;2334;4128;441518;139604;4303;55869;25878;4115;11040;8473;6855;84636;55922;728712;5956;2705;55841;54821;729396;441521;8933;10735;729442;9949;4694;84528;51481;492;3028;100129520;795;10389;83604;7411;9947;9367;100463488;10134;79057;54552;6906;340547;30014;415;5255;680;158809;6990;4435;5475;340529;65109;64860;7030;729428;8776;4675;5030;51566;729201;56271;4943;79917;85012;114928;5256;26609;54960;538;6853;5365;4354;286451;29934;10838;139221;9189;347404;6473;3251;286464;158931;139793;100008586;2717;3052;5973;139065;5199;546;5613;51270;139231;9131;7547;474381;257240;11254;27238;64102;2543;158747;2273;56474;5165;64648;54440;140597;5631;728239;3188;100130086;5251;8237;286527;100130302,815
1,1,X,168547,155233731,155065184,23096;64061;392509;10214;170685;23157;727837;55998;23439;729431;10916;158586;55859;331;3423;54830;4168;6901;5358;92002;27344;729447;54328;266740;9075;102723737;7552;729422;54954;84460;389874;56000;340562;644538;92552;254158;79649;56850;8225;2824;100272147;51186;3149;26576;100130361;1730;347541;139425;3547;728695;729408;79921;57826;59272;203413;2986;7512;9737;8544;55634;2857;3421;537;11013;340554;5716;6658;4101;54457;1438;91966;441519;4100;5931;27316;7403;4534;6839;51480;728096;27112;92129;101928917;140462;8241;6567;827;203569;27301;84548;645037;54413;100133053;7355;254065;79836;10084;347442;60343;51765;55593;139818;56180;6303;8269;142684;7626;10046;8409;203447;63932;2710;4515;8406;51248;56001;51616;2925;100130613;2564;1193;100132994;5354;11043;340533;22;3476;84631;26748;11238;203562;102723631;170261;58526;441525;4983;29944;6907;1536;2539;1478;9468;23597;2187;1287;81887;6611;3561;9767;9282;54857;347365;10800;139341;54539;11219;728062;169966;51209;23630;26548;1121;2000;645188;51438;2846;280658;1852;347344;23229;10857;56157;286430;101059915;438;5277;9758;1069;4674;154796;56548;51309;1184;645073;80712;1774;10245;2258;728343;9823;441531;11141;643311;90121;256643;23676;4114;6758;4107;286499;5009;1654;1831;51284;94121;170302;11230;79135;286410;9210;2491;441490;84187;633;6191;64743;4110;3598;389856;7789;55787;9452;50814;2157;139422;170062;57187;139067;4104;203427;4693;5456;10013;1964;55190;100996648;293;9016;100528062;30011;90316;93953;10178;6322;28952;24137;2332;4105;6845;94122;84968;64663;1538;9142;286530;2245;5634;9506;79576;3266;139212;5207;6535;8227;393;389852;170626;91851;27334;158866;550643;159013;407;7224;55796;10761;100132963;168400;4281;158835;24140;8471;90167;7737;7319;10149;11279;6134;64109;1678;139322;5063;55906;116442;84443;27197;8233;548313;6872;27018;100129239;139105;7102;10549;26071;2664;59353;8573;28985;79184;728049;728090;158521;3581;139886;282808;8263;9130;728082;778;90843;1756;5422;7317;5935;347454;29071;207063;4112;412;158506;340602;30848;5127;22866;93380;159091;10159;212;139285;9338;85417;8266;100132399;158584;494118;190;7569;89801;2892;1968;5230;57232;55559;57529;8277;63035;80231;286436;25975;51311;8905;55086;139735;395;83692;171484;10251;169981;1349;63904;139716;257397;142689;80258;27035;1641;55613;7105;100329135;84295;9459;4810;404281;4109;367;474384;6748;139760;347487;92745;158830;53344;4103;9203;139378;186;474343;2719;3597;140456;9248;402415;203430;9185;90161;728042;4129;65267;56849;8228;8226;728036;7114;6399;4952;83740;84889;8481;6757;347468;347475;414;6759;9500;51132;8823;541578;2158;55609;2556;494119;6756;9502;158880;8517;8242;474383;57595;51442;389895;100132304;9754;80311;6102;27328;695;56159;51213;90737;60506;10943;100873985;57526;728269;170082;474382;102723680;728656;3358;8273;83844;114824;389840;170067;81557;80823;8862;2002;7216;79979;158763;23641;55217;8270;57477;7592;2833;425054;340526;727866;139599;139804;54470;8450;959;139562;645864;10075;117154;57631;2010;54521;79589;51634;3750;653282;728072;7076;392490;9363;8623;3920;347411;7454;100506164;265;90293;645051;100529097;55511;158724;6197;203547;139135;5355;347516;203522;139081;6451;27336;158787;728458;7499;4841;347517;51360;340578;139596;1896;441509;54466;660;158798;4108;171482;79868;728075;158833;79366;1821;56156;392465;1260;5160;56062;5303;3054;51260;139628;653220;340596;554;28986;23133;57393;2623;28227;4113;57692;50945;3730;7739;100131755;57481;8260;139170;64219;4204;389860;2574;3563;65991;10325;6170;10813;79710;8712;26280;2316;256714;10742;6173;9104;494197;29057;139324;442444;6103;54880;90736;55558;2742;1736;369;255313;3654;170627;645974;3897;79983;727940;541466;347527;8243;4007;139741;29978;2182;7504;60401;84707;53336;1485;159090;94056;57502;55285;653067;1046;11152;641339;1947;8852;7712;23708;203523;4267;54967;340542;89885;2277;83550;644353;55916;340595;6594;139189;63947;9643;9843;4935;139728;100288814;10479;50943;53940;55026;100507170;5638;4478;8239;4068;51114;139411;246100;9968;84679;115201;100533997;1741;416;64840;10682;11326;25763;27330;171483;8908;27286;1038;7543;158800;90060;1288;84061;215;6247;292;55879;401612;1183;340527;55344;29935;158983;357;10009;2747;2652;286514;340543;54885;100129407;10495;6792;79742;140886;2239;2334;4128;441518;139604;4303;55869;25878;4115;11040;8473;6855;84636;55922;728712;5956;2705;55841;54821;729396;441521;8933;10735;729442;9949;4694;84528;51481;492;3028;100129520;795;10389;83604;7411;9947;9367;100463488;10134;79057;54552;6906;340547;30014;415;5255;680;158809;6990;4435;5475;340529;65109;64860;7030;729428;8776;4675;5030;51566;729201;56271;4943;79917;85012;114928;5256;26609;54960;538;6853;5365;4354;286451;29934;10838;139221;9189;347404;6473;3251;286464;158931;139793;100008586;2717;3052;5973;139065;5199;546;5613;51270;139231;9131;7547;474381;257240;11254;27238;64102;2543;158747;2273;56474;5165;64648;54440;140597;5631;728239;3188;100130086;5251;8237;286527;100130302,815
1,1,X,168547,155233846,155065299,23096;64061;392509;10214;170685;23157;727837;55998;23439;729431;10916;158586;55859;331;3423;54830;4168;6901;5358;92002;27344;729447;54328;266740;9075;102723737;7552;729422;54954;84460;389874;56000;340562;644538;92552;254158;79649;56850;8225;2824;100272147;51186;3149;26576;100130361;1730;347541;139425;3547;728695;729408;79921;57826;59272;203413;2986;7512;9737;8544;55634;2857;3421;537;11013;340554;5716;6658;4101;54457;1438;91966;441519;4100;5931;27316;7403;4534;6839;51480;728096;27112;92129;101928917;140462;8241;6567;827;203569;27301;84548;645037;54413;100133053;7355;254065;79836;10084;347442;60343;51765;55593;139818;56180;6303;8269;142684;7626;10046;8409;203447;63932;2710;4515;8406;51248;56001;51616;2925;100130613;2564;1193;100132994;5354;11043;340533;22;3476;84631;26748;11238;203562;102723631;170261;58526;441525;4983;29944;6907;1536;2539;1478;9468;23597;2187;1287;81887;6611;3561;9767;9282;54857;347365;10800;139341;54539;11219;728062;169966;51209;23630;26548;1121;2000;645188;51438;2846;280658;1852;347344;23229;10857;56157;286430;101059915;438;5277;9758;1069;4674;154796;56548;51309;1184;645073;80712;1774;10245;2258;728343;9823;441531;11141;643311;90121;256643;23676;4114;6758;4107;286499;5009;1654;1831;51284;94121;170302;11230;79135;286410;9210;2491;441490;84187;633;6191;64743;4110;3598;389856;7789;55787;9452;50814;2157;139422;170062;57187;139067;4104;203427;4693;5456;10013;1964;55190;100996648;293;9016;100528062;30011;90316;93953;10178;6322;28952;24137;2332;4105;6845;94122;84968;64663;1538;9142;286530;2245;5634;9506;79576;3266;139212;5207;6535;8227;393;389852;170626;91851;27334;158866;550643;159013;407;7224;55796;10761;100132963;168400;4281;158835;24140;8471;90167;7737;7319;10149;11279;6134;64109;1678;139322;5063;55906;116442;84443;27197;8233;548313;6872;27018;100129239;139105;7102;10549;26071;2664;59353;8573;28985;79184;728049;728090;158521;3581;139886;282808;8263;9130;728082;778;90843;1756;5422;7317;5935;347454;29071;207063;4112;412;158506;340602;30848;5127;22866;93380;159091;10159;212;139285;9338;85417;8266;100132399;158584;494118;190;7569;89801;2892;1968;5230;57232;55559;57529;8277;63035;80231;286436;25975;51311;8905;55086;139735;395;83692;171484;10251;169981;1349;63904;139716;257397;142689;80258;27035;1641;55613;7105;100329135;84295;9459;4810;404281;4109;367;474384;6748;139760;347487;92745;158830;53344;4103;9203;139378;186;474343;2719;3597;140456;9248;402415;203430;9185;90161;728042;4129;65267;56849;8228;8226;728036;7114;6399;4952;83740;84889;8481;6757;347468;347475;414;6759;9500;51132;8823;541578;2158;55609;2556;494119;6756;9502;158880;8517;8242;474383;57595;51442;389895;100132304;9754;80311;6102;27328;695;56159;51213;90737;60506;10943;100873985;57526;728269;170082;474382;102723680;728656;3358;8273;83844;114824;389840;170067;81557;80823;8862;2002;7216;79979;158763;23641;55217;8270;57477;7592;2833;425054;340526;727866;139599;139804;54470;8450;959;139562;645864;10075;117154;57631;2010;54521;79589;51634;3750;653282;728072;7076;392490;9363;8623;3920;347411;7454;100506164;265;90293;645051;100529097;55511;158724;6197;203547;139135;5355;347516;203522;139081;6451;27336;158787;728458;7499;4841;347517;51360;340578;139596;1896;441509;54466;660;158798;4108;171482;79868;728075;158833;79366;1821;56156;392465;1260;5160;56062;5303;3054;51260;139628;653220;340596;554;28986;23133;57393;2623;28227;4113;57692;50945;3730;7739;100131755;57481;8260;139170;64219;4204;389860;2574;3563;65991;10325;6170;10813;79710;8712;26280;2316;256714;10742;6173;9104;494197;29057;139324;442444;6103;54880;90736;55558;2742;1736;369;255313;3654;170627;645974;3897;79983;727940;541466;347527;8243;4007;139741;29978;2182;7504;60401;84707;53336;1485;159090;94056;57502;55285;653067;1046;11152;641339;1947;8852;7712;23708;203523;4267;54967;340542;89885;2277;83550;644353;55916;340595;6594;139189;63947;9643;9843;4935;139728;100288814;10479;50943;53940;55026;100507170;5638;4478;8239;4068;51114;139411;246100;9968;84679;115201;100533997;1741;416;64840;10682;11326;25763;27330;171483;8908;27286;1038;7543;158800;90060;1288;84061;215;6247;292;55879;401612;1183;340527;55344;29935;158983;357;10009;2747;2652;286514;340543;54885;100129407;10495;6792;79742;140886;2239;2334;4128;441518;139604;4303;55869;25878;4115;11040;8473;6855;84636;55922;728712;5956;2705;55841;54821;729396;441521;8933;10735;729442;9949;4694;84528;51481;492;3028;100129520;795;10389;83604;7411;9947;9367;100463488;10134;79057;54552;6906;340547;30014;415;5255;680;158809;6990;4435;5475;340529;65109;64860;7030;729428;8776;4675;5030;51566;729201;56271;4943;79917;85012;114928;5256;26609;54960;538;6853;5365;4354;286451;29934;10838;139221;9189;347404;6473;3251;286464;158931;139793;100008586;2717;3052;5973;139065;5199;546;5613;51270;139231;9131;7547;474381;257240;11254;27238;64102;2543;158747;2273;56474;5165;64648;54440;140597;5631;728239;3188;100130086;5251;8237;286527;100130302,815
-1,1,X,168564,57413442,57244878,23096;414;64061;6759;9500;10214;170685;727837;729431;10916;6756;9502;158880;8242;27344;729447;54328;729422;80311;6102;54954;90737;92552;254158;60506;56850;8225;2824;10943;100873985;170082;347541;139425;729408;59272;389840;170067;81557;2002;7216;8544;55634;2857;57477;7592;425054;727866;1438;645864;5931;10075;7403;6839;51480;3750;7076;140462;8241;8623;347411;203569;7454;27301;265;645037;645051;7355;158724;6197;10084;347442;5355;55593;158787;6303;7499;8409;51360;2710;54466;8406;660;2925;171482;392465;5160;26748;11238;139628;653220;58526;28986;23133;57393;2623;6907;28227;4113;1536;9468;3730;23597;2187;389860;6611;2574;3563;9767;10325;9282;347365;8712;139341;54539;256714;10742;9104;494197;29057;442444;6103;54880;90736;2742;369;280658;170627;347344;347527;8243;4007;29978;438;7504;5277;9758;56548;1184;645073;10245;94056;57502;11141;653067;11152;90121;641339;256643;23676;4114;6758;8852;7712;23708;5009;1654;4267;51284;170302;11230;79135;2277;9210;441490;64743;389856;55787;139189;139422;170062;4935;4693;10013;100288814;1964;55190;293;50943;53940;30011;6322;28952;5638;8239;94122;139411;286530;2245;5634;84679;9506;416;3266;64840;10682;5207;25763;8227;389852;170626;171483;8908;550643;159013;7543;90060;168400;4281;24140;6247;10149;11279;64109;1183;55344;27197;357;8233;286514;548313;6792;79742;4128;139105;7102;139604;10549;25878;4115;11040;6855;8573;55841;729396;729442;51481;3028;778;795;10389;1756;83604;5422;7317;5935;9367;100463488;54552;415;207063;4112;412;158506;340602;158809;5127;6990;22866;5475;10159;212;85417;100132399;158584;7030;729428;190;7569;89801;729201;1968;57232;4943;79917;5256;26609;54960;6853;80231;25975;51311;8905;9189;395;347404;171484;6473;286464;169981;63904;257397;80258;139793;100008586;3052;4810;404281;5199;92745;5613;474343;140456;257240;9185;27238;4129;2543;65267;8228;158747;8226;56474;5165;7114;6399;728239;5251;8481;8237;6757;100130302,321
-1,1,X,168566,155233731,155065165,23096;64061;392509;10214;170685;23157;727837;55998;23439;729431;10916;158586;55859;331;3423;54830;4168;6901;5358;92002;27344;729447;54328;266740;9075;102723737;7552;729422;54954;84460;389874;56000;340562;644538;92552;254158;79649;56850;8225;2824;100272147;51186;3149;26576;100130361;1730;347541;139425;3547;728695;729408;79921;57826;59272;203413;2986;7512;9737;8544;55634;2857;3421;537;11013;340554;5716;6658;4101;54457;1438;91966;441519;4100;5931;27316;7403;4534;6839;51480;728096;27112;92129;101928917;140462;8241;6567;827;203569;27301;84548;645037;54413;100133053;7355;254065;79836;10084;347442;60343;51765;55593;139818;56180;6303;8269;142684;7626;10046;8409;203447;63932;2710;4515;8406;51248;56001;51616;2925;100130613;2564;1193;100132994;5354;11043;340533;22;3476;84631;26748;11238;203562;102723631;170261;58526;441525;4983;29944;6907;1536;2539;1478;9468;23597;2187;1287;81887;6611;3561;9767;9282;54857;347365;10800;139341;54539;11219;728062;169966;51209;23630;26548;1121;2000;645188;51438;2846;280658;1852;347344;23229;10857;56157;286430;101059915;438;5277;9758;1069;4674;154796;56548;51309;1184;645073;80712;1774;10245;2258;728343;9823;441531;11141;643311;90121;256643;23676;4114;6758;4107;286499;5009;1654;1831;51284;94121;170302;11230;79135;286410;9210;2491;441490;84187;633;6191;64743;4110;3598;389856;7789;55787;9452;50814;2157;139422;170062;57187;139067;4104;203427;4693;5456;10013;1964;55190;100996648;293;9016;100528062;30011;90316;93953;10178;6322;28952;24137;2332;4105;6845;94122;84968;64663;1538;9142;286530;2245;5634;9506;79576;3266;139212;5207;6535;8227;393;389852;170626;91851;27334;158866;550643;159013;407;7224;55796;10761;100132963;168400;4281;158835;24140;8471;90167;7737;7319;10149;11279;6134;64109;1678;139322;5063;55906;116442;84443;27197;8233;548313;6872;27018;100129239;139105;7102;10549;26071;2664;59353;8573;28985;79184;728049;728090;158521;3581;139886;282808;8263;9130;728082;778;90843;1756;5422;7317;5935;347454;29071;207063;4112;412;158506;340602;30848;5127;22866;93380;159091;10159;212;139285;9338;85417;8266;100132399;158584;494118;190;7569;89801;2892;1968;5230;57232;55559;57529;8277;63035;80231;286436;25975;51311;8905;55086;139735;395;83692;171484;10251;169981;1349;63904;139716;257397;142689;80258;27035;1641;55613;7105;100329135;84295;9459;4810;404281;4109;367;474384;6748;139760;347487;92745;158830;53344;4103;9203;139378;186;474343;2719;3597;140456;9248;402415;203430;9185;90161;728042;4129;65267;56849;8228;8226;728036;7114;6399;4952;83740;84889;8481;6757;347468;347475;414;6759;9500;51132;8823;541578;2158;55609;2556;494119;6756;9502;158880;8517;8242;474383;57595;51442;389895;100132304;9754;80311;6102;27328;695;56159;51213;90737;60506;10943;100873985;57526;728269;170082;474382;102723680;728656;3358;8273;83844;114824;389840;170067;81557;80823;8862;2002;7216;79979;158763;23641;55217;8270;57477;7592;2833;425054;340526;727866;139599;139804;54470;8450;959;139562;645864;10075;117154;57631;2010;54521;79589;51634;3750;653282;728072;7076;392490;9363;8623;3920;347411;7454;100506164;265;90293;645051;100529097;55511;158724;6197;203547;139135;5355;347516;203522;139081;6451;27336;158787;728458;7499;4841;347517;51360;340578;139596;1896;441509;54466;660;158798;4108;171482;79868;728075;158833;79366;1821;56156;392465;1260;5160;56062;5303;3054;51260;139628;653220;340596;554;28986;23133;57393;2623;28227;4113;57692;50945;3730;7739;100131755;57481;8260;139170;64219;4204;389860;2574;3563;65991;10325;6170;10813;79710;8712;26280;2316;256714;10742;6173;9104;494197;29057;139324;442444;6103;54880;90736;55558;2742;1736;369;255313;3654;170627;645974;3897;79983;727940;541466;347527;8243;4007;139741;29978;2182;7504;60401;84707;53336;1485;159090;94056;57502;55285;653067;1046;11152;641339;1947;8852;7712;23708;203523;4267;54967;340542;89885;2277;83550;644353;55916;340595;6594;139189;63947;9643;9843;4935;139728;100288814;10479;50943;53940;55026;100507170;5638;4478;8239;4068;51114;139411;246100;9968;84679;115201;100533997;1741;416;64840;10682;11326;25763;27330;171483;8908;27286;1038;7543;158800;90060;1288;84061;215;6247;292;55879;401612;1183;340527;55344;29935;158983;357;10009;2747;2652;286514;340543;54885;100129407;10495;6792;79742;140886;2239;2334;4128;441518;139604;4303;55869;25878;4115;11040;8473;6855;84636;55922;728712;5956;2705;55841;54821;729396;441521;8933;10735;729442;9949;4694;84528;51481;492;3028;100129520;795;10389;83604;7411;9947;9367;100463488;10134;79057;54552;6906;340547;30014;415;5255;680;158809;6990;4435;5475;340529;65109;64860;7030;729428;8776;4675;5030;51566;729201;56271;4943;79917;85012;114928;5256;26609;54960;538;6853;5365;4354;286451;29934;10838;139221;9189;347404;6473;3251;286464;158931;139793;100008586;2717;3052;5973;139065;5199;546;5613;51270;139231;9131;7547;474381;257240;11254;27238;64102;2543;158747;2273;56474;5165;64648;54440;140597;5631;728239;3188;100130086;5251;8237;286527;100130302,815
-1,1,X,169791,12949463,12779672,414;51481;171482;3052;425054;4281;1438;4935;5613;347527;100288814;415;207063;293;412;438;64109;51480;1183;9758;55344;8623;6907;28227;357;265;286530;57502;8226;8228;3730;8225;10943;5634;3563;26609;25878;416;4267;7499;51284;51311;9189;395;6473;55841;8227;171483;8908,49
1,1,X,169921,2666411,2496490,28227;207063;4267;293;286530;9189;438;64109;6473;8227;8225;8623;55344;1438;3563,15
1,-1,X,176426,697169,520743,55344;6473;28227;8225,4
-1,1,X,219609,1342026,1122417,28227;6473;8225;55344;64109,5
1,-1,X,225816,438701,212885,28227;8225,2
1,-1,X,225816,477447,251631,28227;8225,2
1,-1,X,281527,456062,174535,28227,1
1,-1,X,281527,580777,299250,28227,1
1,-1,X,281527,697169,415642,28227;6473,2
1,-1,X,298643,438701,140058,28227,1
1,-1,X,298643,524370,225727,28227,1
-1,1,X,318707,155224707,154906000,23096;64061;392509;10214;170685;23157;727837;55998;23439;729431;10916;158586;55859;331;3423;54830;4168;6901;5358;92002;27344;729447;54328;266740;9075;102723737;7552;729422;54954;84460;389874;56000;340562;644538;92552;254158;79649;56850;2824;100272147;51186;3149;26576;100130361;1730;347541;139425;3547;728695;729408;79921;57826;59272;203413;2986;7512;9737;8544;55634;2857;3421;537;11013;340554;5716;6658;4101;54457;1438;91966;441519;4100;5931;27316;7403;4534;6839;51480;728096;27112;92129;101928917;140462;8241;6567;827;203569;27301;84548;645037;54413;100133053;7355;254065;79836;10084;347442;60343;51765;55593;139818;56180;6303;8269;142684;7626;10046;8409;203447;63932;2710;4515;8406;51248;56001;51616;2925;100130613;2564;1193;100132994;5354;11043;340533;22;3476;84631;26748;11238;203562;102723631;170261;58526;441525;4983;29944;6907;1536;2539;1478;9468;23597;2187;1287;81887;6611;3561;9767;9282;54857;347365;10800;139341;54539;11219;728062;169966;51209;23630;26548;1121;2000;645188;51438;2846;280658;1852;347344;23229;10857;56157;286430;101059915;438;5277;9758;1069;4674;154796;56548;51309;1184;645073;80712;1774;10245;2258;728343;9823;441531;11141;643311;90121;256643;23676;4114;6758;4107;286499;5009;1654;1831;51284;94121;170302;11230;79135;286410;9210;2491;441490;84187;633;6191;64743;4110;3598;389856;7789;55787;9452;50814;2157;139422;170062;57187;139067;4104;203427;4693;5456;10013;1964;55190;100996648;293;9016;100528062;30011;90316;93953;10178;6322;28952;24137;2332;4105;6845;94122;84968;64663;1538;9142;286530;2245;5634;9506;79576;3266;139212;5207;6535;8227;393;389852;170626;91851;27334;158866;550643;159013;407;7224;55796;10761;100132963;168400;4281;158835;24140;8471;90167;7737;7319;10149;11279;6134;64109;1678;139322;5063;55906;116442;84443;27197;8233;548313;6872;27018;100129239;139105;7102;10549;26071;2664;59353;8573;28985;79184;728049;728090;158521;139886;282808;8263;9130;728082;778;90843;1756;5422;7317;5935;347454;29071;207063;4112;412;158506;340602;30848;5127;22866;93380;159091;10159;212;139285;9338;85417;8266;100132399;158584;494118;190;7569;89801;2892;1968;5230;57232;55559;57529;8277;63035;80231;286436;25975;51311;8905;55086;139735;395;83692;171484;10251;169981;1349;63904;139716;257397;142689;80258;27035;1641;55613;7105;100329135;84295;9459;4810;404281;4109;367;474384;6748;139760;347487;92745;158830;53344;4103;9203;139378;186;474343;2719;3597;140456;9248;402415;203430;9185;90161;728042;4129;65267;56849;8228;8226;728036;7114;6399;4952;83740;84889;8481;6757;347468;347475;414;6759;9500;51132;8823;541578;2158;55609;2556;494119;6756;9502;158880;8517;8242;474383;57595;51442;389895;100132304;9754;80311;6102;27328;695;56159;51213;90737;60506;10943;100873985;57526;728269;170082;474382;102723680;728656;3358;8273;83844;114824;389840;170067;81557;80823;8862;2002;7216;79979;158763;23641;55217;8270;57477;7592;2833;425054;340526;727866;139599;139804;54470;8450;959;139562;645864;10075;117154;57631;2010;54521;79589;51634;3750;653282;728072;7076;392490;9363;8623;3920;347411;7454;100506164;265;90293;645051;100529097;55511;158724;6197;203547;139135;5355;347516;203522;139081;6451;27336;158787;728458;7499;4841;347517;51360;340578;139596;1896;441509;54466;660;158798;4108;171482;79868;728075;158833;79366;1821;56156;392465;1260;5160;56062;5303;3054;51260;139628;653220;340596;554;28986;23133;57393;2623;28227;4113;57692;50945;3730;7739;100131755;57481;8260;139170;64219;4204;389860;2574;3563;65991;10325;6170;10813;79710;8712;26280;2316;256714;10742;6173;9104;494197;29057;139324;442444;6103;54880;90736;55558;2742;1736;369;255313;3654;170627;645974;3897;79983;727940;541466;347527;8243;4007;139741;29978;2182;7504;60401;84707;53336;1485;159090;94056;57502;55285;653067;1046;11152;641339;1947;8852;7712;23708;203523;4267;54967;340542;89885;2277;83550;644353;55916;340595;6594;139189;63947;9643;9843;4935;139728;100288814;10479;50943;53940;55026;100507170;5638;4478;8239;4068;51114;139411;246100;9968;84679;115201;100533997;1741;416;64840;10682;11326;25763;27330;171483;8908;27286;1038;7543;158800;90060;1288;84061;215;6247;292;55879;401612;1183;340527;29935;158983;357;10009;2747;2652;286514;340543;54885;100129407;10495;6792;79742;140886;2239;2334;4128;441518;139604;4303;55869;25878;4115;11040;8473;6855;84636;55922;728712;5956;2705;55841;54821;729396;441521;8933;10735;729442;9949;4694;84528;51481;492;3028;100129520;795;10389;83604;7411;9947;9367;100463488;10134;79057;54552;6906;340547;30014;415;5255;680;158809;6990;4435;5475;340529;65109;64860;7030;729428;8776;4675;5030;51566;729201;56271;4943;79917;85012;114928;5256;26609;54960;538;6853;5365;4354;286451;29934;10838;139221;9189;347404;6473;3251;286464;158931;139793;100008586;2717;3052;5973;139065;5199;546;5613;51270;139231;9131;7547;474381;257240;11254;27238;64102;2543;158747;2273;56474;5165;64648;54440;140597;5631;728239;3188;100130086;5251;8237;286527;100130302,812
1,1,X,332881,2749927,2417046,28227;207063;4267;293;7499;286530;9189;438;64109;6473;8227;1438;3563;8623;8908,15
1,-1,X,338874,580777,241903,28227,1
-1,1,X,344213,673537,329324,28227;6473,2
-1,-1,X,352512,353164,652,,0
-1,-1,X,353093,387718,34625,,0
1,1,X,395646,2696692,2301046,207063;4267;293;7499;286530;9189;438;64109;6473;8227;8623;1438;3563,13
-1,1,X,401671,1342026,940355,6473;64109,2
-1,-1,X,426624,456062,29438,,0
1,-1,X,438701,524370,85669,,0
-1,-1,X,456062,498819,42757,,0
1,-1,X,456062,809513,353451,6473,1
1,-1,X,456062,983987,527925,6473,1
-1,1,X,463756,1217076,753320,6473,1
-1,1,X,513354,640818,127464,6473,1
-1,1,X,513354,650520,137166,6473,1
-1,1,X,517225,839488,322263,6473,1
-1,1,X,519455,592812,73357,6473,1
-1,1,X,545953,803877,257924,6473,1
-1,1,X,553069,155233731,154680662,23096;64061;392509;10214;170685;23157;727837;55998;23439;729431;10916;158586;55859;331;3423;54830;4168;6901;5358;92002;27344;729447;54328;266740;9075;102723737;7552;729422;54954;84460;389874;56000;340562;644538;92552;254158;79649;56850;2824;100272147;51186;3149;26576;100130361;1730;347541;139425;3547;728695;729408;79921;57826;59272;203413;2986;7512;9737;8544;55634;2857;3421;537;11013;340554;5716;6658;4101;54457;1438;91966;441519;4100;5931;27316;7403;4534;6839;51480;728096;27112;92129;101928917;140462;8241;6567;827;203569;27301;84548;645037;54413;100133053;7355;254065;79836;10084;347442;60343;51765;55593;139818;56180;6303;8269;142684;7626;10046;8409;203447;63932;2710;4515;8406;51248;56001;51616;2925;100130613;2564;1193;100132994;5354;11043;340533;22;3476;84631;26748;11238;203562;102723631;170261;58526;441525;4983;29944;6907;1536;2539;1478;9468;23597;2187;1287;81887;6611;3561;9767;9282;54857;347365;10800;139341;54539;11219;728062;169966;51209;23630;26548;1121;2000;645188;51438;2846;280658;1852;347344;23229;10857;56157;286430;101059915;438;5277;9758;1069;4674;154796;56548;51309;1184;645073;80712;1774;10245;2258;728343;9823;441531;11141;643311;90121;256643;23676;4114;6758;4107;286499;5009;1654;1831;51284;94121;170302;11230;79135;286410;9210;2491;441490;84187;633;6191;64743;4110;3598;389856;7789;55787;9452;50814;2157;139422;170062;57187;139067;4104;203427;4693;5456;10013;1964;55190;100996648;293;9016;100528062;30011;90316;93953;10178;6322;28952;24137;2332;4105;6845;94122;84968;64663;1538;9142;286530;2245;5634;9506;79576;3266;139212;5207;6535;8227;393;389852;170626;91851;27334;158866;550643;159013;407;7224;55796;10761;100132963;168400;4281;158835;24140;8471;90167;7737;7319;10149;11279;6134;64109;1678;139322;5063;55906;116442;84443;27197;8233;548313;6872;27018;100129239;139105;7102;10549;26071;2664;59353;8573;28985;79184;728049;728090;158521;3581;139886;282808;8263;9130;728082;778;90843;1756;5422;7317;5935;347454;29071;207063;4112;412;158506;340602;30848;5127;22866;93380;159091;10159;212;139285;9338;85417;8266;100132399;158584;494118;190;7569;89801;2892;1968;5230;57232;55559;57529;8277;63035;80231;286436;25975;51311;8905;55086;139735;395;83692;171484;10251;169981;1349;63904;139716;257397;142689;80258;27035;1641;55613;7105;100329135;84295;9459;4810;404281;4109;367;474384;6748;139760;347487;92745;158830;53344;4103;9203;139378;186;474343;2719;3597;140456;9248;402415;203430;9185;90161;728042;4129;65267;56849;8228;8226;728036;7114;6399;4952;83740;84889;8481;6757;347468;347475;414;6759;9500;51132;8823;541578;2158;55609;2556;494119;6756;9502;158880;8517;8242;474383;57595;51442;389895;100132304;9754;80311;6102;27328;695;56159;51213;90737;60506;10943;100873985;57526;728269;170082;474382;102723680;728656;3358;8273;83844;114824;389840;170067;81557;80823;8862;2002;7216;79979;158763;23641;55217;8270;57477;7592;2833;425054;340526;727866;139599;139804;54470;8450;959;139562;645864;10075;117154;57631;2010;54521;79589;51634;3750;653282;728072;7076;392490;9363;8623;3920;347411;7454;100506164;265;90293;645051;100529097;55511;158724;6197;203547;139135;5355;347516;203522;139081;6451;27336;158787;728458;7499;4841;347517;51360;340578;139596;1896;441509;54466;660;158798;4108;171482;79868;728075;158833;79366;1821;56156;392465;1260;5160;56062;5303;3054;51260;139628;653220;340596;554;28986;23133;57393;2623;4113;57692;50945;3730;7739;100131755;57481;8260;139170;64219;4204;389860;2574;3563;65991;10325;6170;10813;79710;8712;26280;2316;256714;10742;6173;9104;494197;29057;139324;442444;6103;54880;90736;55558;2742;1736;369;255313;3654;170627;645974;3897;79983;727940;541466;347527;8243;4007;139741;29978;2182;7504;60401;84707;53336;1485;159090;94056;57502;55285;653067;1046;11152;641339;1947;8852;7712;23708;203523;4267;54967;340542;89885;2277;83550;644353;55916;340595;6594;139189;63947;9643;9843;4935;139728;100288814;10479;50943;53940;55026;100507170;5638;4478;8239;4068;51114;139411;246100;9968;84679;115201;100533997;1741;416;64840;10682;11326;25763;27330;171483;8908;27286;1038;7543;158800;90060;1288;84061;215;6247;292;55879;401612;1183;340527;29935;158983;357;10009;2747;2652;286514;340543;54885;100129407;10495;6792;79742;140886;2239;2334;4128;441518;139604;4303;55869;25878;4115;11040;8473;6855;84636;55922;728712;5956;2705;55841;54821;729396;441521;8933;10735;729442;9949;4694;84528;51481;492;3028;100129520;795;10389;83604;7411;9947;9367;100463488;10134;79057;54552;6906;340547;30014;415;5255;680;158809;6990;4435;5475;340529;65109;64860;7030;729428;8776;4675;5030;51566;729201;56271;4943;79917;85012;114928;5256;26609;54960;538;6853;5365;4354;286451;29934;10838;139221;9189;347404;6473;3251;286464;158931;139793;100008586;2717;3052;5973;139065;5199;546;5613;51270;139231;9131;7547;474381;257240;11254;27238;64102;2543;158747;2273;56474;5165;64648;54440;140597;5631;728239;3188;100130086;5251;8237;286527;100130302,812
1,-1,X,571286,590637,19351,6473,1
-1,-1,X,628237,836076,207839,,0
1,-1,X,628237,1252522,624285,,0
-1,-1,X,677536,723469,45933,,0
1,-1,X,697169,756122,58953,,0
-1,-1,X,697169,1238257,541088,,0
1,-1,X,714137,1505988,791851,293;1438;3563;64109,4
1,-1,X,756122,1618582,862460,8623;293;1438;286530;3563;64109,6
1,-1,X,809513,1321581,512068,64109,1
1,-1,X,876551,1378591,502040,64109,1
1,-1,X,909049,1252522,343473,,0
1,-1,X,909049,1252522,343473,,0
1,-1,X,909049,1252522,343473,,0
1,-1,X,909049,1252522,343473,,0
1,-1,X,909049,1252522,343473,,0
1,-1,X,909049,1252522,343473,,0
1,-1,X,909049,1252522,343473,,0
1,-1,X,909049,1252522,343473,,0
1,-1,X,909049,1252522,343473,,0
1,-1,X,909049,1252522,343473,,0
1,-1,X,909049,1252522,343473,,0
1,-1,X,917876,1471350,553474,1438;3563;64109,3
1,-1,X,958625,1378591,419966,64109,1
1,-1,X,974682,1252522,277840,,0
1,-1,X,974682,1414338,439656,1438;64109,2
1,-1,X,1015836,1238257,222421,,0
1,-1,X,1015836,1347283,331447,64109,1
1,-1,X,1015836,1505988,490152,293;1438;3563;64109,4
-1,-1,X,1035386,1199297,163911,,0
1,-1,X,1110841,1583754,472913,8623;293;1438;286530;3563;64109,6
-1,1,X,1118268,154929305,153811037,23096;64061;392509;10214;170685;23157;727837;55998;23439;729431;10916;158586;55859;331;3423;54830;4168;6901;5358;92002;27344;729447;54328;266740;9075;102723737;7552;729422;54954;84460;389874;56000;340562;644538;92552;254158;79649;56850;2824;100272147;51186;3149;26576;100130361;1730;347541;139425;3547;728695;729408;79921;57826;59272;203413;2986;7512;9737;8544;55634;2857;3421;537;11013;340554;5716;6658;4101;54457;1438;91966;441519;4100;5931;27316;7403;4534;6839;51480;728096;27112;92129;101928917;140462;8241;6567;827;203569;27301;84548;645037;54413;100133053;7355;254065;79836;10084;347442;60343;51765;55593;139818;56180;6303;8269;142684;7626;10046;8409;203447;63932;2710;4515;8406;51248;56001;51616;2925;100130613;2564;1193;100132994;5354;11043;340533;22;3476;84631;26748;11238;203562;102723631;170261;58526;441525;4983;29944;6907;1536;2539;1478;9468;23597;2187;1287;81887;6611;3561;9767;9282;54857;347365;10800;139341;54539;11219;728062;169966;51209;23630;26548;1121;2000;645188;51438;2846;280658;1852;347344;23229;10857;56157;286430;101059915;438;5277;9758;1069;4674;154796;56548;51309;1184;645073;80712;1774;10245;2258;728343;9823;441531;11141;643311;90121;256643;23676;4114;6758;4107;286499;5009;1654;1831;51284;94121;170302;11230;79135;286410;9210;2491;441490;84187;633;6191;64743;4110;3598;389856;7789;55787;9452;50814;2157;139422;170062;57187;139067;4104;203427;4693;5456;10013;1964;55190;100996648;293;9016;100528062;30011;90316;93953;10178;6322;28952;24137;2332;4105;94122;84968;64663;1538;9142;286530;2245;5634;9506;79576;3266;139212;5207;6535;8227;393;389852;170626;91851;27334;158866;550643;159013;407;7224;55796;10761;100132963;168400;4281;158835;24140;8471;90167;7737;7319;10149;11279;6134;64109;1678;139322;5063;55906;116442;84443;27197;8233;548313;6872;27018;100129239;139105;7102;10549;26071;2664;59353;8573;28985;79184;728049;728090;158521;139886;282808;8263;9130;728082;778;90843;1756;5422;7317;5935;347454;29071;207063;4112;412;158506;340602;30848;5127;22866;93380;159091;10159;212;139285;9338;85417;8266;100132399;158584;494118;190;7569;89801;2892;1968;5230;57232;55559;57529;8277;63035;80231;286436;25975;51311;8905;55086;139735;395;83692;171484;10251;169981;1349;63904;139716;257397;142689;80258;27035;1641;55613;7105;100329135;84295;9459;4810;404281;4109;367;474384;6748;139760;347487;92745;158830;53344;4103;9203;139378;186;474343;2719;3597;140456;9248;402415;203430;9185;90161;728042;4129;65267;56849;8228;8226;728036;7114;6399;4952;83740;84889;8481;6757;347468;347475;414;6759;9500;51132;8823;541578;2158;55609;2556;494119;6756;9502;158880;8517;8242;474383;57595;51442;389895;100132304;9754;80311;6102;27328;695;56159;51213;90737;60506;10943;100873985;57526;728269;170082;474382;102723680;728656;3358;8273;83844;114824;389840;170067;81557;80823;8862;2002;7216;79979;158763;23641;55217;8270;57477;7592;2833;425054;340526;727866;139599;139804;54470;8450;959;139562;645864;10075;117154;57631;2010;54521;79589;51634;3750;653282;728072;7076;392490;9363;8623;3920;347411;7454;100506164;265;90293;645051;100529097;55511;158724;6197;203547;139135;5355;347516;203522;139081;6451;27336;158787;728458;7499;4841;347517;51360;340578;139596;1896;441509;54466;660;158798;4108;171482;79868;728075;158833;79366;1821;56156;392465;1260;5160;56062;5303;3054;51260;139628;653220;340596;554;28986;23133;57393;2623;4113;57692;50945;3730;7739;100131755;57481;8260;139170;64219;4204;389860;2574;3563;65991;10325;6170;10813;79710;8712;26280;2316;256714;10742;6173;9104;494197;29057;139324;442444;6103;54880;90736;55558;2742;1736;369;255313;3654;170627;645974;3897;79983;727940;541466;347527;8243;4007;139741;29978;2182;7504;60401;84707;53336;1485;159090;94056;57502;55285;653067;1046;11152;641339;1947;8852;7712;23708;203523;4267;54967;340542;89885;2277;83550;644353;55916;340595;6594;139189;63947;9643;9843;4935;139728;100288814;10479;50943;53940;55026;100507170;5638;4478;8239;4068;51114;139411;246100;9968;84679;115201;100533997;1741;416;64840;10682;11326;25763;27330;171483;8908;27286;1038;7543;158800;90060;1288;84061;215;6247;292;55879;401612;1183;340527;29935;158983;357;10009;2747;2652;286514;340543;54885;100129407;10495;6792;79742;140886;2239;2334;4128;441518;139604;4303;55869;25878;4115;11040;8473;6855;84636;55922;728712;5956;2705;55841;54821;729396;441521;8933;10735;729442;9949;4694;84528;51481;492;3028;100129520;795;10389;83604;7411;9947;9367;100463488;10134;79057;54552;6906;340547;30014;415;5255;680;158809;6990;4435;5475;340529;65109;64860;7030;729428;8776;4675;5030;51566;729201;56271;4943;79917;85012;114928;5256;26609;54960;538;6853;5365;4354;286451;29934;10838;139221;9189;347404;3251;286464;158931;139793;100008586;2717;3052;5973;139065;5199;546;5613;51270;139231;9131;7547;474381;257240;11254;27238;64102;2543;158747;2273;56474;5165;64648;54440;140597;5631;728239;3188;100130086;5251;8237;286527;100130302,809
1,-1,X,1123365,1505988,382623,293;1438;3563;64109,4
1,-1,X,1223372,1321581,98209,64109,1
1,-1,X,1321581,1430714,109133,1438;64109,2
1,-1,X,1321581,1430714,109133,1438;64109,2
1,-1,X,1321581,1448838,127257,1438;64109,2
1,-1,X,1321581,1570890,249309,8623;293;1438;3563;64109,5
-1,1,X,1321581,7896531,6574950,414;51481;286530;57502;8226;8228;1438;3563;26609;5613;25878;347527;415;416;207063;4267;293;412;7499;9189;438;64109;8227;8623;8908,25
1,-1,X,1347283,1464141,116858,1438;3563,2
1,-1,X,1378591,1414338,35747,1438,1
1,-1,X,1378591,1414338,35747,1438,1
1,-1,X,1378591,1430714,52123,1438,1
1,-1,X,1378597,1414338,35741,1438,1
-1,1,X,1658660,9442004,7783344,414;6907;51481;171482;57502;8228;8226;3730;425054;26609;5613;25878;347527;415;416;207063;4267;7499;412;9189;438;51480;8227;171483;8908,25
1,-1,X,1729895,2066618,336723,438,1
1,-1,X,1748418,2066618,318200,438,1
1,-1,X,1793480,1942205,148725,,0
1,-1,X,1793480,2017309,223829,,0
1,-1,X,1793480,2066618,273138,,0
1,-1,X,1810323,1926298,115975,,0
1,-1,X,1810323,2066618,256295,,0
1,-1,X,1810323,2066618,256295,,0
1,-1,X,1810323,2066618,256295,,0
-1,1,X,1837147,3618538,1781391,414;25878;5613;347527;415;416;207063;4267;7499;9189;8908,11
1,-1,X,1936120,1938684,2564,,0
-1,-1,X,1936120,1938684,2564,,0
1,-1,X,1936120,1942198,6078,,0
1,-1,X,1942205,2272030,329825,207063,1
1,-1,X,2066618,2166859,100241,207063,1
1,-1,X,2066618,2166859,100241,207063,1
1,-1,X,2066618,2272030,205412,207063,1
1,-1,X,2066618,2361399,294781,207063,1
-1,-1,X,2118389,2289645,171256,207063,1
1,1,X,2217264,155221853,153004589,23096;64061;392509;10214;170685;23157;727837;55998;23439;729431;10916;158586;55859;331;3423;54830;4168;6901;5358;92002;27344;729447;54328;266740;9075;102723737;7552;729422;54954;84460;389874;56000;340562;644538;92552;254158;79649;56850;2824;100272147;51186;3149;26576;100130361;1730;347541;139425;3547;728695;729408;79921;57826;59272;203413;2986;7512;9737;8544;55634;2857;3421;537;11013;340554;5716;6658;4101;54457;91966;441519;4100;5931;27316;7403;4534;6839;51480;728096;27112;92129;101928917;140462;8241;6567;827;203569;27301;84548;645037;54413;100133053;7355;254065;79836;10084;347442;60343;51765;55593;139818;56180;6303;8269;142684;7626;10046;8409;203447;63932;2710;4515;8406;51248;56001;51616;2925;100130613;2564;1193;100132994;5354;11043;340533;22;3476;84631;26748;11238;203562;102723631;170261;58526;441525;4983;29944;6907;1536;2539;1478;9468;23597;2187;1287;81887;6611;3561;9767;9282;54857;347365;10800;139341;54539;11219;728062;169966;51209;23630;26548;1121;2000;645188;51438;2846;280658;1852;347344;23229;10857;56157;286430;101059915;5277;9758;1069;4674;154796;56548;51309;1184;645073;80712;1774;10245;2258;728343;9823;441531;11141;643311;90121;256643;23676;4114;6758;4107;286499;5009;1654;1831;51284;94121;170302;11230;79135;286410;9210;2491;441490;84187;633;6191;64743;4110;3598;389856;7789;55787;9452;50814;2157;139422;170062;57187;139067;4104;203427;4693;5456;10013;1964;55190;100996648;9016;100528062;30011;90316;93953;10178;6322;28952;24137;2332;4105;6845;94122;84968;64663;1538;9142;2245;5634;9506;79576;3266;139212;5207;6535;393;389852;170626;91851;27334;158866;550643;159013;407;7224;55796;10761;100132963;168400;4281;158835;24140;8471;90167;7737;7319;10149;11279;6134;1678;139322;5063;55906;116442;84443;27197;8233;548313;6872;27018;100129239;139105;7102;10549;26071;2664;59353;8573;28985;79184;728049;728090;158521;139886;282808;8263;9130;728082;778;90843;1756;5422;7317;5935;347454;29071;207063;4112;412;158506;340602;30848;5127;22866;93380;159091;10159;212;139285;9338;85417;8266;100132399;158584;494118;190;7569;89801;2892;1968;5230;57232;55559;57529;8277;63035;80231;286436;25975;51311;8905;55086;139735;395;83692;171484;10251;169981;1349;63904;139716;257397;142689;80258;27035;1641;55613;7105;100329135;84295;9459;4810;404281;4109;367;474384;6748;139760;347487;92745;158830;53344;4103;9203;139378;186;474343;2719;3597;140456;9248;402415;203430;9185;90161;728042;4129;65267;56849;8228;8226;728036;7114;6399;4952;83740;84889;8481;6757;347468;347475;414;6759;9500;51132;8823;541578;2158;55609;2556;494119;6756;9502;158880;8517;8242;474383;57595;51442;389895;100132304;9754;80311;6102;27328;695;56159;51213;90737;60506;10943;100873985;57526;728269;170082;474382;102723680;728656;3358;8273;83844;114824;389840;170067;81557;80823;8862;2002;7216;79979;158763;23641;55217;8270;57477;7592;2833;425054;340526;727866;139599;139804;54470;8450;959;139562;645864;10075;117154;57631;2010;54521;79589;51634;3750;653282;728072;7076;392490;9363;3920;100506164;347411;7454;265;90293;645051;100529097;55511;158724;6197;203547;139135;5355;347516;203522;139081;6451;27336;158787;728458;7499;4841;347517;51360;340578;139596;1896;441509;54466;660;158798;4108;171482;79868;728075;158833;79366;1821;56156;392465;1260;5160;56062;5303;3054;51260;139628;653220;340596;554;28986;23133;57393;2623;4113;57692;50945;3730;7739;100131755;57481;8260;139170;64219;4204;389860;2574;65991;10325;6170;10813;79710;8712;26280;2316;256714;10742;6173;9104;494197;29057;139324;442444;6103;54880;90736;55558;2742;1736;369;255313;3654;170627;645974;3897;79983;727940;541466;347527;8243;4007;139741;29978;2182;7504;60401;84707;53336;1485;159090;94056;57502;55285;653067;1046;11152;641339;1947;8852;7712;23708;203523;4267;54967;340542;89885;2277;83550;644353;55916;340595;6594;139189;63947;9643;9843;4935;139728;100288814;10479;50943;53940;55026;100507170;5638;4478;8239;4068;51114;139411;246100;9968;84679;115201;100533997;1741;416;64840;10682;11326;25763;27330;171483;8908;27286;1038;7543;158800;90060;1288;84061;215;6247;292;55879;401612;1183;340527;29935;158983;357;10009;2747;2652;286514;340543;54885;100129407;10495;6792;79742;140886;2239;2334;4128;441518;139604;4303;55869;25878;4115;11040;8473;6855;84636;55922;728712;5956;2705;55841;54821;729396;441521;8933;10735;729442;9949;4694;84528;51481;492;3028;100129520;795;10389;83604;7411;9947;9367;100463488;10134;79057;54552;6906;340547;30014;415;5255;680;158809;6990;4435;5475;340529;65109;64860;7030;729428;8776;4675;5030;51566;729201;56271;4943;79917;85012;114928;5256;26609;54960;538;6853;5365;4354;286451;29934;10838;139221;9189;347404;3251;286464;158931;139793;100008586;2717;3052;5973;139065;5199;546;5613;51270;139231;9131;7547;474381;257240;11254;27238;64102;2543;158747;2273;56474;5165;64648;54440;140597;5631;728239;3188;100130086;5251;8237;286527;100130302,802
1,-1,X,2326635,2615004,288369,207063;4267;9189,3
1,-1,X,2524696,2576743,52047,,0
-1,1,X,2683677,6235107,3551430,414;25878;5613;347527;415;416;7499;57502;8908,9
1,1,X,2683677,154751965,152068288,23096;64061;392509;10214;170685;23157;727837;55998;23439;729431;10916;158586;55859;331;3423;54830;4168;6901;5358;92002;27344;729447;54328;266740;9075;102723737;7552;729422;54954;84460;389874;56000;340562;644538;92552;254158;79649;56850;2824;100272147;51186;3149;26576;100130361;1730;347541;139425;3547;728695;729408;79921;57826;59272;203413;2986;7512;9737;8544;55634;2857;3421;537;11013;340554;5716;6658;4101;54457;91966;441519;4100;5931;27316;7403;4534;6839;51480;728096;27112;92129;101928917;140462;8241;6567;827;203569;27301;84548;645037;54413;100133053;7355;254065;79836;10084;347442;60343;51765;55593;139818;56180;6303;8269;142684;7626;10046;8409;203447;63932;2710;4515;8406;51248;56001;51616;2925;100130613;2564;1193;100132994;5354;11043;340533;22;3476;84631;26748;11238;203562;102723631;170261;58526;441525;4983;29944;6907;1536;2539;1478;9468;23597;2187;1287;81887;6611;3561;9767;9282;54857;347365;10800;139341;54539;11219;728062;169966;51209;23630;26548;1121;2000;645188;51438;2846;280658;1852;347344;23229;10857;56157;286430;101059915;5277;9758;1069;4674;154796;56548;51309;1184;645073;80712;1774;10245;2258;728343;9823;441531;11141;643311;90121;256643;23676;4114;6758;4107;286499;5009;1654;1831;51284;94121;170302;11230;79135;286410;9210;2491;441490;84187;633;6191;64743;4110;3598;389856;7789;55787;9452;50814;2157;139422;170062;57187;139067;4104;203427;4693;5456;10013;1964;55190;100996648;9016;100528062;30011;90316;93953;10178;6322;28952;24137;2332;4105;94122;84968;64663;1538;9142;2245;5634;9506;79576;3266;139212;5207;6535;393;389852;170626;91851;27334;158866;550643;159013;407;7224;55796;10761;100132963;168400;4281;158835;24140;8471;90167;7737;7319;10149;11279;6134;1678;139322;5063;55906;116442;84443;27197;8233;548313;6872;27018;100129239;139105;7102;10549;26071;2664;59353;8573;28985;79184;728049;728090;158521;139886;282808;8263;9130;728082;778;90843;1756;5422;7317;5935;347454;29071;4112;412;158506;340602;30848;5127;22866;93380;159091;10159;212;139285;9338;85417;8266;100132399;158584;494118;190;7569;89801;2892;1968;5230;57232;55559;57529;8277;63035;80231;286436;25975;51311;8905;55086;139735;395;83692;171484;169981;1349;63904;139716;257397;142689;80258;27035;1641;55613;7105;100329135;84295;9459;4810;404281;4109;367;474384;6748;139760;347487;92745;158830;53344;4103;9203;139378;186;474343;2719;3597;140456;9248;402415;203430;9185;90161;728042;4129;65267;56849;8228;8226;728036;7114;6399;4952;83740;84889;8481;6757;347468;347475;414;6759;9500;51132;8823;541578;2158;55609;2556;494119;6756;9502;158880;8517;8242;474383;57595;51442;389895;100132304;9754;80311;6102;27328;695;56159;51213;90737;60506;10943;100873985;57526;728269;170082;474382;102723680;728656;3358;8273;83844;114824;389840;170067;81557;80823;8862;2002;7216;79979;158763;23641;55217;8270;57477;7592;2833;425054;340526;727866;139599;139804;54470;8450;959;139562;645864;10075;117154;57631;2010;54521;79589;51634;3750;653282;728072;7076;392490;9363;3920;100506164;347411;7454;265;90293;645051;100529097;55511;158724;6197;203547;139135;5355;347516;203522;139081;6451;27336;158787;728458;7499;4841;347517;51360;340578;139596;1896;441509;54466;660;158798;4108;171482;79868;728075;158833;79366;1821;56156;392465;1260;5160;56062;5303;3054;51260;139628;653220;340596;554;28986;23133;57393;2623;4113;57692;50945;3730;7739;100131755;57481;8260;139170;64219;4204;389860;2574;65991;10325;6170;10813;79710;8712;26280;2316;256714;10742;6173;9104;494197;29057;139324;442444;6103;54880;90736;55558;2742;1736;369;255313;3654;170627;645974;3897;79983;727940;541466;347527;8243;4007;139741;29978;2182;7504;60401;84707;53336;1485;159090;94056;57502;55285;653067;1046;11152;641339;1947;8852;7712;23708;203523;54967;340542;89885;2277;83550;644353;55916;340595;6594;139189;63947;9643;9843;4935;139728;100288814;10479;50943;53940;55026;100507170;5638;4478;8239;4068;51114;139411;246100;9968;84679;115201;100533997;1741;416;64840;10682;11326;25763;27330;171483;8908;27286;1038;7543;158800;90060;1288;84061;215;6247;292;55879;401612;1183;340527;29935;158983;357;10009;2747;2652;286514;340543;54885;100129407;10495;6792;79742;140886;2239;2334;4128;441518;139604;4303;55869;25878;4115;11040;8473;6855;84636;55922;728712;5956;2705;55841;54821;729396;441521;8933;10735;729442;9949;4694;84528;51481;492;3028;100129520;795;10389;83604;7411;9947;9367;100463488;10134;79057;54552;6906;340547;30014;415;5255;680;158809;6990;4435;5475;340529;65109;64860;7030;729428;8776;4675;5030;51566;729201;56271;4943;79917;85012;114928;5256;26609;54960;538;6853;5365;4354;286451;29934;10838;139221;347404;3251;286464;158931;139793;100008586;2717;3052;5973;139065;5199;546;5613;51270;139231;9131;7547;474381;257240;11254;27238;64102;2543;158747;2273;56474;5165;64648;54440;140597;5631;728239;3188;100130086;5251;8237;286527;100130302,797
1,-1,X,2700316,2799420,99104,7499;8908,2
1,1,X,2700316,154785891,152085575,23096;64061;392509;10214;170685;23157;727837;55998;23439;729431;10916;158586;55859;331;3423;54830;4168;6901;5358;92002;27344;729447;54328;266740;9075;102723737;7552;729422;54954;84460;389874;56000;340562;644538;92552;254158;79649;56850;2824;100272147;51186;3149;26576;100130361;1730;347541;139425;3547;728695;729408;79921;57826;59272;203413;2986;7512;9737;8544;55634;2857;3421;537;11013;340554;5716;6658;4101;54457;91966;441519;4100;5931;27316;7403;4534;6839;51480;728096;27112;92129;101928917;140462;8241;6567;827;203569;27301;84548;645037;54413;100133053;7355;254065;79836;10084;347442;60343;51765;55593;139818;56180;6303;8269;142684;7626;10046;8409;203447;63932;2710;4515;8406;51248;56001;51616;2925;100130613;2564;1193;100132994;5354;11043;340533;22;3476;84631;26748;11238;203562;102723631;170261;58526;441525;4983;29944;6907;1536;2539;1478;9468;23597;2187;1287;81887;6611;3561;9767;9282;54857;347365;10800;139341;54539;11219;728062;169966;51209;23630;26548;1121;2000;645188;51438;2846;280658;1852;347344;23229;10857;56157;286430;101059915;5277;9758;1069;4674;154796;56548;51309;1184;645073;80712;1774;10245;2258;728343;9823;441531;11141;643311;90121;256643;23676;4114;6758;4107;286499;5009;1654;1831;51284;94121;170302;11230;79135;286410;9210;2491;441490;84187;633;6191;64743;4110;3598;389856;7789;55787;9452;50814;2157;139422;170062;57187;139067;4104;203427;4693;5456;10013;1964;55190;100996648;9016;100528062;30011;90316;93953;10178;6322;28952;24137;2332;4105;94122;84968;64663;1538;9142;2245;5634;9506;79576;3266;139212;5207;6535;393;389852;170626;91851;27334;158866;550643;159013;407;7224;55796;10761;100132963;168400;4281;158835;24140;8471;90167;7737;7319;10149;11279;6134;1678;139322;5063;55906;116442;84443;27197;8233;548313;6872;27018;100129239;139105;7102;10549;26071;2664;59353;8573;28985;79184;728049;728090;158521;139886;282808;8263;9130;728082;778;90843;1756;5422;7317;5935;347454;29071;4112;412;158506;340602;30848;5127;22866;93380;159091;10159;212;139285;9338;85417;8266;100132399;158584;494118;190;7569;89801;2892;1968;5230;57232;55559;57529;8277;63035;80231;286436;25975;51311;8905;55086;139735;395;83692;171484;169981;1349;63904;139716;257397;142689;80258;27035;1641;55613;7105;100329135;84295;9459;4810;404281;4109;367;474384;6748;139760;347487;92745;158830;53344;4103;9203;139378;186;474343;2719;3597;140456;9248;402415;203430;9185;90161;728042;4129;65267;56849;8228;8226;728036;7114;6399;4952;83740;84889;8481;6757;347468;347475;414;6759;9500;51132;8823;541578;2158;55609;2556;494119;6756;9502;158880;8517;8242;474383;57595;51442;389895;100132304;9754;80311;6102;27328;695;56159;51213;90737;60506;10943;100873985;57526;728269;170082;474382;102723680;728656;3358;8273;83844;114824;389840;170067;81557;80823;8862;2002;7216;79979;158763;23641;55217;8270;57477;7592;2833;425054;340526;727866;139599;139804;54470;8450;959;139562;645864;10075;117154;57631;2010;54521;79589;51634;3750;653282;728072;7076;392490;9363;3920;100506164;347411;7454;265;90293;645051;100529097;55511;158724;6197;203547;139135;5355;347516;203522;139081;6451;27336;158787;728458;7499;4841;347517;51360;340578;139596;1896;441509;54466;660;158798;4108;171482;79868;728075;158833;79366;1821;56156;392465;1260;5160;56062;5303;3054;51260;139628;653220;340596;554;28986;23133;57393;2623;4113;57692;50945;3730;7739;100131755;57481;8260;139170;64219;4204;389860;2574;65991;10325;6170;10813;79710;8712;26280;2316;256714;10742;6173;9104;494197;29057;139324;442444;6103;54880;90736;55558;2742;1736;369;255313;3654;170627;645974;3897;79983;727940;541466;347527;8243;4007;139741;29978;2182;7504;60401;84707;53336;1485;159090;94056;57502;55285;653067;1046;11152;641339;1947;8852;7712;23708;203523;54967;340542;89885;2277;83550;644353;55916;340595;6594;139189;63947;9643;9843;4935;139728;100288814;10479;50943;53940;55026;100507170;5638;4478;8239;4068;51114;139411;246100;9968;84679;115201;100533997;1741;416;64840;10682;11326;25763;27330;171483;8908;27286;1038;7543;158800;90060;1288;84061;215;6247;292;55879;401612;1183;340527;29935;158983;357;10009;2747;2652;286514;340543;54885;100129407;10495;6792;79742;140886;2239;2334;4128;441518;139604;4303;55869;25878;4115;11040;8473;6855;84636;55922;728712;5956;2705;55841;54821;729396;441521;8933;10735;729442;9949;4694;84528;51481;492;3028;100129520;795;10389;83604;7411;9947;9367;100463488;10134;79057;54552;6906;340547;30014;415;5255;680;158809;6990;4435;5475;340529;65109;64860;7030;729428;8776;4675;5030;51566;729201;56271;4943;79917;85012;114928;5256;26609;54960;538;6853;5365;4354;286451;29934;10838;139221;347404;3251;286464;158931;139793;100008586;2717;3052;5973;139065;5199;546;5613;51270;139231;9131;7547;474381;257240;11254;27238;64102;2543;158747;2273;56474;5165;64648;54440;140597;5631;728239;3188;100130086;5251;8237;286527;100130302,797
-1,1,X,2703632,155233731,152530099,23096;64061;392509;10214;170685;23157;727837;55998;23439;729431;10916;158586;55859;331;3423;54830;4168;6901;5358;92002;27344;729447;54328;266740;9075;102723737;7552;729422;54954;84460;389874;56000;340562;644538;92552;254158;79649;56850;2824;100272147;51186;3149;26576;100130361;1730;347541;139425;3547;728695;729408;79921;57826;59272;203413;2986;7512;9737;8544;55634;2857;3421;537;11013;340554;5716;6658;4101;54457;91966;441519;4100;5931;27316;7403;4534;6839;51480;728096;27112;92129;101928917;140462;8241;6567;827;203569;27301;84548;645037;54413;100133053;7355;254065;79836;10084;347442;60343;51765;55593;139818;56180;6303;8269;142684;7626;10046;8409;203447;63932;2710;4515;8406;51248;56001;51616;2925;100130613;2564;1193;100132994;5354;11043;340533;22;3476;84631;26748;11238;203562;102723631;170261;58526;441525;4983;29944;6907;1536;2539;1478;9468;23597;2187;1287;81887;6611;3561;9767;9282;54857;347365;10800;139341;54539;11219;728062;169966;51209;23630;26548;1121;2000;645188;51438;2846;280658;1852;347344;23229;10857;56157;286430;101059915;5277;9758;1069;4674;154796;56548;51309;1184;645073;80712;1774;10245;2258;728343;9823;441531;11141;643311;90121;256643;23676;4114;6758;4107;286499;5009;1654;1831;51284;94121;170302;11230;79135;286410;9210;2491;441490;84187;633;6191;64743;4110;3598;389856;7789;55787;9452;50814;2157;139422;170062;57187;139067;4104;203427;4693;5456;10013;1964;55190;100996648;9016;100528062;30011;90316;93953;10178;6322;28952;24137;2332;4105;6845;94122;84968;64663;1538;9142;2245;5634;9506;79576;3266;139212;5207;6535;393;389852;170626;91851;27334;158866;550643;159013;407;7224;55796;10761;100132963;168400;4281;158835;24140;8471;90167;7737;7319;10149;11279;6134;1678;139322;5063;55906;116442;84443;27197;8233;548313;6872;27018;100129239;139105;7102;10549;26071;2664;59353;8573;28985;79184;728049;728090;158521;3581;139886;282808;8263;9130;728082;778;90843;1756;5422;7317;5935;347454;29071;4112;412;158506;340602;30848;5127;22866;93380;159091;10159;212;139285;9338;85417;8266;100132399;158584;494118;190;7569;89801;2892;1968;5230;57232;55559;57529;8277;63035;80231;286436;25975;51311;8905;55086;139735;395;83692;171484;10251;169981;1349;63904;139716;257397;142689;80258;27035;1641;55613;7105;100329135;84295;9459;4810;404281;4109;367;474384;6748;139760;347487;92745;158830;53344;4103;9203;139378;186;474343;2719;3597;140456;9248;402415;203430;9185;90161;728042;4129;65267;56849;8228;8226;728036;7114;6399;4952;83740;84889;8481;6757;347468;347475;414;6759;9500;51132;8823;541578;2158;55609;2556;494119;6756;9502;158880;8517;8242;474383;57595;51442;389895;100132304;9754;80311;6102;27328;695;56159;51213;90737;60506;10943;100873985;57526;728269;170082;474382;102723680;728656;3358;8273;83844;114824;389840;170067;81557;80823;8862;2002;7216;79979;158763;23641;55217;8270;57477;7592;2833;425054;340526;727866;139599;139804;54470;8450;959;139562;645864;10075;117154;57631;2010;54521;79589;51634;3750;653282;728072;7076;392490;9363;3920;100506164;347411;7454;265;90293;645051;100529097;55511;158724;6197;203547;139135;5355;347516;203522;139081;6451;27336;158787;728458;7499;4841;347517;51360;340578;139596;1896;441509;54466;660;158798;4108;171482;79868;728075;158833;79366;1821;56156;392465;1260;5160;56062;5303;3054;51260;139628;653220;340596;554;28986;23133;57393;2623;4113;57692;50945;3730;7739;100131755;57481;8260;139170;64219;4204;389860;2574;65991;10325;6170;10813;79710;8712;26280;2316;256714;10742;6173;9104;494197;29057;139324;442444;6103;54880;90736;55558;2742;1736;369;255313;3654;170627;645974;3897;79983;727940;541466;347527;8243;4007;139741;29978;2182;7504;60401;84707;53336;1485;159090;94056;57502;55285;653067;1046;11152;641339;1947;8852;7712;23708;203523;54967;340542;89885;2277;83550;644353;55916;340595;6594;139189;63947;9643;9843;4935;139728;100288814;10479;50943;53940;55026;100507170;5638;4478;8239;4068;51114;139411;246100;9968;84679;115201;100533997;1741;416;64840;10682;11326;25763;27330;171483;8908;27286;1038;7543;158800;90060;1288;84061;215;6247;292;55879;401612;1183;340527;29935;158983;357;10009;2747;2652;286514;340543;54885;100129407;10495;6792;79742;140886;2239;2334;4128;441518;139604;4303;55869;25878;4115;11040;8473;6855;84636;55922;728712;5956;2705;55841;54821;729396;441521;8933;10735;729442;9949;4694;84528;51481;492;3028;100129520;795;10389;83604;7411;9947;9367;100463488;10134;79057;54552;6906;340547;30014;415;5255;680;158809;6990;4435;5475;340529;65109;64860;7030;729428;8776;4675;5030;51566;729201;56271;4943;79917;85012;114928;5256;26609;54960;538;6853;5365;4354;286451;29934;10838;139221;347404;3251;286464;158931;139793;100008586;2717;3052;5973;139065;5199;546;5613;51270;139231;9131;7547;474381;257240;11254;27238;64102;2543;158747;2273;56474;5165;64648;54440;140597;5631;728239;3188;100130086;5251;8237;286527;100130302,800
1,-1,X,2707626,2802518,94892,7499;8908,2
-1,1,X,2708886,6413964,3705078,414;25878;5613;347527;415;416;7499;57502;8908,9
1,-1,X,2709027,2802518,93491,7499;8908,2
1,-1,X,2709027,2802518,93491,7499;8908,2
1,-1,X,2741284,2799420,58136,8908,1
1,-1,X,2852856,2856474,3618,415,1
1,1,X,2854502,17305446,14450944,660;2742;2925;51481;171482;8544;55787;3052;425054;795;4281;9367;4935;5613;347527;100288814;415;11238;645864;5931;412;51480;1183;140456;5277;9758;140462;57393;9185;6907;357;8233;265;94056;57502;8228;8226;3730;92552;158747;56474;10943;2824;5634;7114;2187;26609;54960;25878;170082;6399;416;25975;51311;51284;8905;395;2277;55841;171484;8481;59272;171483,63
1,-1,X,2856291,2856474,183,415,1
1,-1,X,2856291,2856474,183,415,1
1,1,X,2881940,4934968,2053028,5613;25878;347527;415;416,5
1,-1,X,2970843,3140922,170079,416,1
1,1,X,3669874,154974696,151304822,23096;64061;392509;10214;170685;23157;727837;55998;23439;729431;10916;158586;55859;331;3423;54830;4168;6901;5358;92002;27344;729447;54328;266740;9075;102723737;7552;729422;54954;84460;389874;56000;340562;644538;92552;254158;79649;56850;2824;100272147;51186;3149;26576;100130361;1730;347541;139425;3547;728695;729408;79921;57826;59272;203413;2986;7512;9737;8544;55634;2857;3421;537;11013;340554;5716;6658;4101;54457;91966;441519;4100;5931;27316;7403;4534;6839;51480;728096;27112;92129;101928917;140462;8241;6567;827;203569;27301;84548;645037;54413;100133053;7355;254065;79836;10084;347442;60343;51765;55593;139818;56180;6303;8269;142684;7626;10046;8409;203447;63932;2710;4515;8406;51248;56001;51616;2925;100130613;2564;1193;100132994;5354;11043;340533;22;3476;84631;26748;11238;203562;102723631;170261;58526;441525;4983;29944;6907;1536;2539;1478;9468;23597;2187;1287;81887;6611;3561;9767;9282;54857;347365;10800;139341;54539;11219;728062;169966;51209;23630;26548;1121;2000;645188;51438;2846;280658;1852;347344;23229;10857;56157;286430;101059915;5277;9758;1069;4674;154796;56548;51309;1184;645073;80712;1774;10245;2258;728343;9823;441531;11141;643311;90121;256643;23676;4114;6758;4107;286499;5009;1654;1831;51284;94121;170302;11230;79135;286410;9210;2491;441490;84187;633;6191;64743;4110;3598;389856;7789;55787;9452;50814;2157;139422;170062;57187;139067;4104;203427;4693;5456;10013;1964;55190;100996648;9016;100528062;30011;90316;93953;10178;6322;28952;24137;2332;4105;94122;84968;64663;1538;9142;2245;5634;9506;79576;3266;139212;5207;6535;393;389852;170626;91851;27334;158866;550643;159013;407;7224;55796;10761;100132963;168400;4281;158835;24140;8471;90167;7737;7319;10149;11279;6134;1678;139322;5063;55906;116442;84443;27197;8233;548313;6872;27018;100129239;139105;7102;10549;26071;2664;59353;8573;28985;79184;728049;728090;158521;139886;282808;8263;9130;728082;778;90843;1756;5422;7317;5935;347454;29071;4112;412;158506;340602;30848;5127;22866;93380;159091;10159;212;139285;9338;85417;8266;100132399;158584;494118;190;7569;89801;2892;1968;5230;57232;55559;57529;8277;63035;80231;286436;25975;51311;8905;55086;139735;395;83692;171484;10251;169981;1349;63904;139716;257397;142689;80258;27035;1641;55613;7105;100329135;84295;9459;4810;404281;4109;367;474384;6748;139760;347487;92745;158830;53344;4103;9203;139378;186;474343;2719;3597;140456;9248;402415;203430;9185;90161;728042;4129;65267;56849;8228;8226;728036;7114;6399;4952;83740;84889;8481;6757;347468;347475;6759;9500;51132;8823;541578;2158;55609;2556;494119;6756;9502;158880;8517;8242;474383;57595;51442;389895;100132304;9754;80311;6102;27328;695;56159;51213;90737;60506;10943;100873985;57526;728269;170082;474382;102723680;728656;3358;8273;83844;114824;389840;170067;81557;80823;8862;2002;7216;79979;158763;23641;55217;8270;57477;7592;2833;425054;340526;727866;139599;139804;54470;8450;959;139562;645864;10075;117154;57631;2010;54521;79589;51634;3750;653282;728072;7076;392490;9363;3920;100506164;347411;7454;265;90293;645051;100529097;55511;158724;6197;203547;139135;5355;347516;203522;139081;6451;27336;158787;728458;4841;347517;51360;340578;139596;1896;441509;54466;660;158798;4108;171482;79868;728075;158833;79366;1821;56156;392465;1260;5160;56062;5303;3054;51260;139628;653220;340596;554;28986;23133;57393;2623;4113;57692;50945;3730;7739;100131755;57481;8260;139170;64219;4204;389860;2574;65991;10325;6170;10813;79710;8712;26280;2316;256714;10742;6173;9104;494197;29057;139324;442444;6103;54880;90736;55558;2742;1736;369;255313;3654;170627;645974;3897;79983;727940;541466;8243;4007;139741;29978;2182;7504;60401;84707;53336;1485;159090;94056;57502;55285;653067;1046;11152;641339;1947;8852;7712;23708;203523;54967;340542;89885;2277;83550;644353;55916;340595;6594;139189;63947;9643;9843;4935;139728;100288814;10479;50943;53940;55026;100507170;5638;4478;8239;4068;51114;139411;246100;9968;84679;115201;100533997;1741;64840;10682;11326;25763;27330;171483;27286;1038;7543;158800;90060;1288;84061;215;6247;292;55879;401612;1183;340527;29935;158983;357;10009;2747;2652;286514;340543;54885;100129407;10495;6792;79742;140886;2239;2334;4128;441518;139604;4303;55869;4115;11040;8473;6855;84636;55922;728712;5956;2705;55841;54821;729396;441521;8933;10735;729442;9949;4694;84528;51481;492;3028;100129520;795;10389;83604;7411;9947;9367;100463488;10134;79057;54552;6906;340547;30014;5255;680;158809;6990;4435;5475;340529;65109;64860;7030;729428;8776;4675;5030;51566;729201;56271;4943;79917;85012;114928;5256;26609;54960;538;6853;5365;4354;286451;29934;10838;139221;347404;3251;286464;158931;139793;100008586;2717;3052;5973;139065;5199;546;51270;139231;9131;7547;474381;257240;11254;27238;64102;2543;158747;2273;56474;5165;64648;54440;140597;5631;728239;3188;100130086;5251;8237;286527;100130302,790
-1,1,X,3711398,9389098,5677700,51481;171482;412;57502;8228;8226;51480;3730;425054;171483;26609,11
1,-1,X,4524506,5028348,503842,,0
-1,1,X,5803207,5833017,29810,57502,1
-1,1,X,5900508,6018691,118183,57502,1
-1,-1,X,6018632,6022691,4059,57502,1
1,-1,X,6324569,6653705,329136,51481,1
-1,1,X,6445297,8137963,1692666,51481;412;8228;26609;8226,5
-1,1,X,6445297,8137963,1692666,51481;412;8228;26609;8226,5
-1,1,X,6445297,8137963,1692666,51481;412;8228;26609;8226,5
1,-1,X,6449644,6454095,4451,51481,1
-1,1,X,6449644,8115094,1665450,51481;412;8228;26609;8226,5
1,-1,X,6449688,8115094,1665406,51481;412;8228;26609;8226,5
-1,1,X,6449752,8067142,1617390,51481;412;8228;26609;8226,5
-1,1,X,6449752,8135644,1685892,51481;412;8228;26609;8226,5
-1,1,X,6449752,8135644,1685892,51481;412;8228;26609;8226,5
-1,1,X,6449752,8135644,1685892,51481;412;8228;26609;8226,5
-1,1,X,6449752,8135644,1685892,51481;412;8228;26609;8226,5
-1,1,X,6449752,8135644,1685892,51481;412;8228;26609;8226,5
1,-1,X,6452681,8097511,1644830,51481;412;8228;26609;8226,5
1,-1,X,6452681,8097511,1644830,51481;412;8228;26609;8226,5
1,-1,X,6452681,8097511,1644830,51481;412;8228;26609;8226,5
1,-1,X,6452689,6592470,139781,51481,1
-1,1,X,6452689,8115153,1662464,51481;412;8228;26609;8226,5
1,-1,X,6452695,8097511,1644816,51481;412;8228;26609;8226,5
-1,1,X,6452695,8097511,1644816,51481;412;8228;26609;8226,5
1,-1,X,6452695,8497777,2045082,51481;412;8228;3730;8226;51480;425054;26609,8
1,-1,X,6453036,6507660,54624,51481,1
1,-1,X,6453036,6570937,117901,51481,1
1,-1,X,6453036,6570937,117901,51481,1
1,-1,X,6453036,6653705,200669,51481,1
1,-1,X,6453036,8139186,1686150,51481;412;8228;26609;8226;51480,6
1,-1,X,6453049,8097511,1644462,51481;412;8228;26609;8226,5
1,-1,X,6453072,7809341,1356269,51481;412;8226,3
-1,1,X,6453129,155260560,148807431,23096;64061;392509;10214;170685;23157;727837;55998;23439;729431;10916;158586;55859;331;3423;54830;4168;6901;5358;92002;27344;729447;54328;266740;9075;102723737;7552;729422;54954;84460;389874;56000;340562;644538;92552;254158;79649;56850;2824;100272147;51186;3149;26576;100130361;1730;347541;139425;3547;728695;729408;79921;57826;59272;203413;2986;7512;9737;8544;55634;2857;3421;537;11013;340554;5716;6658;4101;54457;91966;441519;4100;5931;27316;7403;4534;6839;51480;728096;27112;92129;101928917;140462;8241;6567;827;203569;27301;84548;645037;54413;100133053;7355;254065;79836;10084;347442;60343;51765;55593;139818;56180;6303;8269;142684;7626;10046;8409;203447;63932;2710;4515;8406;51248;56001;51616;2925;100130613;2564;1193;100132994;5354;11043;340533;22;3476;84631;26748;11238;203562;102723631;170261;58526;441525;4983;29944;6907;1536;2539;1478;9468;23597;2187;1287;81887;6611;3561;9767;9282;54857;347365;10800;139341;54539;11219;728062;169966;51209;23630;26548;1121;2000;645188;51438;2846;280658;1852;347344;23229;10857;56157;286430;101059915;5277;9758;1069;4674;154796;56548;51309;1184;645073;80712;1774;10245;2258;728343;9823;441531;11141;643311;90121;256643;23676;4114;6758;4107;286499;5009;1654;1831;51284;94121;170302;11230;79135;286410;9210;2491;441490;84187;633;6191;64743;4110;3598;389856;7789;55787;9452;50814;2157;139422;170062;57187;139067;4104;203427;4693;5456;10013;1964;55190;100996648;9016;100528062;30011;90316;93953;10178;6322;28952;24137;2332;4105;6845;94122;84968;64663;1538;9142;2245;5634;9506;79576;3266;139212;5207;6535;393;389852;170626;91851;27334;158866;550643;159013;407;7224;55796;10761;100132963;168400;4281;158835;24140;8471;90167;7737;7319;10149;11279;6134;1678;139322;5063;55906;116442;84443;27197;8233;548313;6872;27018;100129239;139105;7102;10549;26071;2664;59353;8573;28985;79184;728049;728090;158521;3581;139886;282808;8263;9130;728082;778;90843;1756;5422;7317;5935;347454;29071;4112;412;158506;340602;30848;5127;22866;93380;159091;10159;212;139285;9338;85417;8266;100132399;158584;494118;190;7569;89801;2892;1968;5230;57232;55559;57529;8277;63035;80231;286436;25975;51311;8905;55086;139735;395;83692;171484;10251;169981;1349;63904;139716;257397;142689;80258;27035;1641;55613;7105;100329135;84295;9459;4810;404281;4109;367;474384;6748;139760;347487;92745;158830;53344;4103;9203;139378;186;474343;2719;3597;140456;9248;402415;203430;9185;90161;728042;4129;65267;56849;8228;8226;728036;7114;6399;4952;83740;84889;8481;6757;347468;347475;6759;9500;51132;8823;541578;2158;55609;2556;494119;6756;9502;158880;8517;8242;474383;57595;51442;389895;100132304;9754;80311;6102;27328;695;56159;51213;90737;60506;10943;100873985;57526;728269;170082;474382;102723680;728656;3358;8273;83844;114824;389840;170067;81557;80823;8862;2002;7216;79979;158763;23641;55217;8270;57477;7592;2833;425054;340526;727866;139599;139804;54470;8450;959;139562;645864;10075;117154;57631;2010;54521;79589;51634;3750;653282;728072;7076;392490;9363;3920;100506164;347411;7454;265;90293;645051;100529097;55511;158724;6197;203547;139135;5355;347516;203522;139081;6451;27336;158787;728458;4841;347517;51360;340578;139596;1896;441509;54466;660;158798;4108;171482;79868;728075;158833;79366;1821;56156;392465;1260;5160;56062;5303;3054;51260;139628;653220;340596;554;28986;23133;57393;2623;4113;57692;50945;3730;7739;100131755;57481;8260;139170;64219;4204;389860;2574;65991;10325;6170;10813;79710;8712;26280;2316;256714;10742;6173;9104;494197;29057;139324;442444;6103;54880;90736;55558;2742;1736;369;255313;3654;170627;645974;3897;79983;727940;541466;8243;4007;139741;29978;2182;7504;60401;84707;53336;1485;159090;94056;55285;653067;1046;11152;641339;1947;8852;7712;23708;203523;54967;340542;89885;2277;83550;644353;55916;340595;6594;139189;63947;9643;9843;4935;139728;100288814;10479;50943;53940;55026;100507170;5638;4478;8239;4068;51114;139411;246100;9968;84679;115201;100533997;1741;64840;10682;11326;25763;27330;171483;27286;1038;7543;158800;90060;1288;84061;215;6247;292;55879;401612;1183;340527;29935;158983;357;10009;2747;2652;286514;340543;54885;100129407;10495;6792;79742;140886;2239;2334;4128;441518;139604;4303;55869;4115;11040;8473;6855;84636;55922;728712;5956;2705;55841;54821;729396;441521;8933;10735;729442;9949;4694;84528;51481;492;3028;100129520;795;10389;83604;7411;9947;9367;100463488;10134;79057;54552;6906;340547;30014;5255;680;158809;6990;4435;5475;340529;65109;64860;7030;729428;8776;4675;5030;51566;729201;56271;4943;79917;85012;114928;5256;26609;54960;538;6853;5365;4354;286451;29934;10838;139221;347404;3251;286464;158931;139793;100008586;2717;3052;5973;139065;5199;546;51270;139231;9131;7547;474381;257240;11254;27238;64102;2543;158747;2273;56474;5165;64648;54440;140597;5631;728239;3188;100130086;5251;8237;286527;100130302,791
1,-1,X,6453272,6453313,41,,0
1,-1,X,6453272,6939872,486600,,0
1,-1,X,6454212,8115094,1660882,412;8228;26609;8226,4
-1,1,X,6454212,8115094,1660882,412;8228;26609;8226,4
-1,1,X,6454212,8115153,1660941,412;8228;26609;8226,4
-1,1,X,6454212,8115153,1660941,412;8228;26609;8226,4
-1,1,X,6454368,8115153,1660785,412;8228;26609;8226,4
-1,1,X,6454368,8115153,1660785,412;8228;26609;8226,4
1,-1,X,6456036,6570937,114901,,0
-1,1,X,6456036,8131751,1675715,412;8228;26609;8226,4
-1,1,X,6456036,8131751,1675715,412;8228;26609;8226,4
-1,1,X,6458939,8135053,1676114,412;8228;26609;8226,4
-1,1,X,6458939,8135644,1676705,412;8228;26609;8226,4
-1,1,X,6458939,8135644,1676705,412;8228;26609;8226,4
1,-1,X,6460492,6552712,92220,,0
-1,-1,X,6488462,8097511,1609049,412;8228;26609;8226,4
-1,1,X,6488721,8097511,1608790,412;8228;26609;8226,4
-1,1,X,6488721,8097511,1608790,412;8228;26609;8226,4
-1,-1,X,6488721,8097511,1608790,412;8228;26609;8226,4
-1,1,X,6488721,8097511,1608790,412;8228;26609;8226,4
-1,1,X,6488721,8097511,1608790,412;8228;26609;8226,4
-1,1,X,6488721,8097511,1608790,412;8228;26609;8226,4
1,-1,X,6488721,8097511,1608790,412;8228;26609;8226,4
-1,-1,X,6488721,8097511,1608790,412;8228;26609;8226,4
1,-1,X,6488721,8097511,1608790,412;8228;26609;8226,4
-1,-1,X,6488721,8097511,1608790,412;8228;26609;8226,4
-1,1,X,6488721,8097511,1608790,412;8228;26609;8226,4
-1,1,X,6512892,7936824,1423932,412;8228;26609;8226,4
-1,1,X,6523326,8127576,1604250,412;8228;26609;8226,4
-1,1,X,6551155,8032120,1480965,412;8228;26609;8226,4
-1,1,X,6551155,8032120,1480965,412;8228;26609;8226,4
-1,1,X,6628264,7828224,1199960,412;26609;8226,3
1,1,X,6628264,8097511,1469247,412;8228;26609;8226,4
-1,-1,X,6705268,7885155,1179887,412;8228;26609;8226,4
-1,1,X,6705268,7939269,1234001,412;8228;26609;8226,4
-1,1,X,6722953,8135053,1412100,412;8228;26609;8226,4
-1,-1,X,6755142,6818667,63525,,0
-1,-1,X,6755142,6818667,63525,,0
-1,1,X,6755142,7867359,1112217,412;8228;26609;8226,4
-1,1,X,6783100,7744191,961091,412;8226,2
-1,1,X,6807735,7828224,1020489,412;26609;8226,3
1,-1,X,6880529,7346525,465996,412;8226,2
-1,1,X,6939872,8097511,1157639,412;8228;26609;8226,4
-1,1,X,6990250,9342357,2352107,171482;412;8228;3730;8226;51480;425054;171483;26609,9
-1,1,X,7145359,7177501,32142,412,1
1,-1,X,7218800,7391581,172781,412,1
1,-1,X,7269569,7706446,436877,412,1
-1,-1,X,7381734,7482524,100790,,0
1,-1,X,7398741,7803244,404503,,0
1,-1,X,7433896,7584692,150796,,0
-1,-1,X,7469576,7744132,274556,,0
1,-1,X,7491589,7828224,336635,26609,1
1,-1,X,7513049,8137963,624914,8228;26609,2
1,-1,X,7513049,8138346,625297,8228;26609;51480,3
1,-1,X,7513049,8164722,651673,8228;26609;51480,3
1,-1,X,7532546,8097511,564965,8228;26609,2
1,-1,X,7532546,8115094,582548,8228;26609,2
1,-1,X,7533820,8151615,617795,8228;26609;51480,3
1,-1,X,7613959,8224972,611013,8228;26609;51480,3
1,-1,X,7679108,7960118,281010,8228;26609,2
1,-1,X,7828165,8097452,269287,8228,1
1,-1,X,7920725,8131751,211026,,0
1,-1,X,7920725,8151615,230890,51480,1
1,-1,X,7964677,8131751,167074,,0
1,-1,X,8067038,8184213,117175,51480,1
1,-1,X,8076652,8131751,55099,,0
1,-1,X,8144071,8184213,40142,,0
-1,1,X,8144071,53989266,45845195,23096;64061;6759;9500;10214;170685;727837;729431;6756;9502;8242;27344;729447;54328;729422;80311;6102;92552;254158;60506;56850;10943;2824;100873985;170082;347541;139425;729408;59272;389840;170067;81557;2002;8544;55634;2857;7592;57477;425054;727866;645864;5931;10075;7403;6839;3750;7076;140462;8241;347411;7454;265;645037;645051;158724;7355;6197;10084;347442;5355;55593;158787;6303;8409;51360;2710;8406;660;2925;171482;392465;5160;26748;11238;653220;58526;23133;57393;2623;6907;4113;1536;3730;9468;23597;2187;6611;2574;9767;9282;8712;139341;54539;256714;10742;9104;494197;29057;442444;6103;54880;2742;369;280658;170627;347344;8243;4007;7504;5277;9758;56548;1184;645073;94056;10245;11141;653067;11152;641339;256643;23676;4114;6758;8852;7712;23708;5009;1654;51284;2277;170302;79135;11230;9210;441490;64743;389856;55787;139189;139422;170062;4935;4693;100288814;10013;1964;55190;50943;53940;30011;6322;5638;28952;8239;94122;139411;5634;84679;9506;64840;10682;3266;25763;389852;170626;171483;159013;7543;90060;168400;4281;24140;6247;10149;1183;27197;357;8233;286514;548313;6792;79742;4128;139105;139604;7102;10549;4115;11040;6855;8573;55841;729396;729442;3028;795;10389;83604;1756;778;5422;9367;7317;5935;4112;340602;158506;158809;6990;5127;22866;5475;10159;85417;100132399;7030;729428;190;7569;729201;89801;1968;57232;4943;79917;5256;54960;6853;80231;25975;51311;8905;395;347404;171484;286464;63904;257397;80258;100008586;3052;4810;404281;5199;92745;140456;257240;9185;27238;4129;2543;158747;56474;5165;7114;6399;728239;5251;8481;8237;6757;100130302,263
-1,1,X,8250344,9702358,1452014,4935;6907;425054;171482;171483;3730,6
1,-1,X,8250338,8391952,141614,,0
1,-1,X,8250338,8391952,141614,,0
1,-1,X,8250338,8391952,141614,,0
-1,1,X,8419281,8833845,414564,171482;425054;3730,3
1,-1,X,8448259,8536442,88183,3730,1
1,-1,X,8448259,8674356,226097,3730,1
1,-1,X,9985848,10002126,16278,55841,1
-1,1,X,10533428,10669918,136490,4281,1
-1,1,X,11258243,14177713,2919470,265;92552;10943;2824;7114;5634;9367;54960;170082;6399;25975;51311;51284;395;171484;8481;9758,17
1,-1,X,11641372,11681931,40559,395,1
-1,1,X,12272674,30428697,18156023,660;2925;55787;139422;795;10389;5160;5422;9367;11238;1964;4112;158506;158809;30011;22866;5475;6322;57393;4113;80311;190;139411;9468;1968;92552;254158;23597;2824;2187;5634;5256;6611;54960;170082;347541;139425;25975;51311;8905;171484;256714;59272;170067;389840;10742;2742;8544;7543;4810;404281;168400;6247;645864;5931;10149;140456;5277;9758;140462;257240;9185;8233;286514;94056;158747;6792;11141;56474;6197;5165;7114;139105;347442;256643;23676;4114;10549;6303;6399;4115;51284;2277;170302;79135;51360;5251;8481;100130302,89
-1,1,X,13038260,142561303,129523043,23096;64061;392509;10214;170685;23157;727837;55998;23439;729431;10916;158586;55859;331;54830;4168;5358;27344;729447;54328;9075;102723737;7552;729422;54954;84460;389874;56000;340562;644538;92552;254158;79649;56850;2824;51186;100130361;1730;347541;139425;3547;728695;729408;79921;57826;59272;203413;2986;7512;9737;8544;55634;2857;11013;340554;5716;6658;54457;441519;5931;27316;7403;6839;728096;27112;92129;140462;8241;6567;827;203569;27301;645037;54413;7355;254065;79836;10084;347442;51765;55593;139818;56180;6303;142684;7626;8409;203447;63932;2710;8406;51248;56001;51616;2925;100130613;100132994;5354;11043;340533;22;3476;26748;11238;203562;102723631;170261;58526;441525;4983;1536;1478;9468;23597;2187;1287;81887;6611;3561;9767;9282;54857;347365;10800;139341;54539;728062;169966;51209;23630;26548;1121;2000;645188;51438;2846;280658;347344;23229;10857;56157;286430;101059915;5277;4674;154796;56548;51309;1184;645073;80712;10245;2258;728343;9823;441531;11141;643311;90121;256643;23676;4114;6758;286499;5009;1654;1831;94121;170302;11230;79135;286410;9210;2491;441490;84187;6191;64743;3598;389856;7789;55787;9452;139422;170062;57187;203427;4693;5456;10013;1964;55190;100996648;9016;100528062;30011;90316;93953;10178;6322;28952;24137;94122;64663;1538;2245;9506;79576;3266;139212;5207;389852;170626;91851;27334;158866;550643;159013;407;7224;55796;10761;168400;158835;24140;8471;90167;7737;7319;10149;11279;1678;139322;5063;55906;84443;27197;8233;548313;6872;27018;139105;7102;10549;26071;59353;8573;28985;728049;728090;139886;282808;728082;778;90843;1756;5422;7317;5935;347454;29071;4112;340602;158506;5127;22866;93380;159091;10159;212;139285;9338;85417;100132399;158584;190;7569;89801;2892;1968;5230;57232;57529;63035;80231;286436;25975;8905;55086;171484;169981;1349;63904;257397;142689;80258;27035;1641;55613;7105;100329135;84295;9459;4810;404281;367;139760;347487;92745;158830;53344;9203;139378;186;474343;2719;3597;140456;402415;203430;9185;90161;728042;4129;65267;56849;728036;6399;4952;84889;8481;6757;347468;347475;6759;9500;51132;8823;2158;55609;6756;9502;158880;8242;51442;389895;100132304;9754;80311;6102;27328;695;56159;51213;90737;60506;100873985;57526;170082;102723680;728656;3358;83844;170067;389840;81557;80823;8862;2002;7216;79979;158763;23641;57477;7592;2833;139599;340526;727866;8450;139804;54470;959;139562;645864;10075;117154;57631;54521;79589;51634;3750;653282;728072;7076;392490;9363;3920;347411;7454;90293;645051;100529097;55511;158724;6197;5355;347516;203522;139081;6451;27336;158787;4841;347517;51360;340578;139596;1896;441509;54466;660;158798;79868;728075;158833;79366;1821;56156;392465;5160;56062;5303;51260;139628;653220;340596;28986;23133;57393;2623;4113;57692;50945;100131755;57481;139170;64219;389860;2574;10325;6170;10813;79710;8712;26280;256714;10742;6173;9104;494197;29057;139324;442444;6103;54880;90736;2742;369;255313;170627;645974;79983;727940;541466;8243;4007;139741;29978;2182;7504;60401;84707;53336;159090;94056;55285;653067;1046;11152;641339;1947;8852;7712;23708;203523;54967;340542;2277;83550;644353;55916;340595;6594;139189;63947;9643;9843;10479;50943;53940;55026;100507170;5638;4478;8239;4068;51114;139411;9968;84679;115201;1741;64840;10682;11326;25763;27330;27286;1038;7543;158800;90060;1288;84061;6247;292;401612;340527;29935;158983;10009;2747;286514;340543;54885;100129407;10495;6792;79742;140886;2239;4128;441518;139604;4303;55869;4115;11040;8473;6855;84636;55922;728712;2705;54821;729396;441521;8933;10735;729442;9949;4694;84528;3028;100129520;795;10389;83604;9947;9367;100463488;54552;6906;340547;30014;5255;680;158809;6990;4435;5475;340529;65109;64860;7030;729428;4675;5030;51566;729201;56271;4943;79917;85012;114928;5256;54960;538;6853;286451;29934;139221;347404;3251;286464;158931;139793;100008586;2717;5199;546;51270;139231;9131;7547;257240;11254;27238;64102;2543;158747;2273;56474;5165;64648;54440;140597;5631;728239;3188;5251;8237;286527;100130302,645
1,-1,X,13399913,13495629,95716,,0
1,-1,X,14356913,14428075,71162,,0
-1,1,X,14878636,14942042,63406,158747;2187,2
1,1,X,15191748,23970702,8778954,660;10742;2925;8544;55787;4810;404281;795;10389;5160;168400;6247;11238;645864;5931;1964;10149;158506;140456;30011;5277;22866;5475;6322;140462;57393;257240;9185;8233;94056;139411;6792;23597;254158;56474;6197;139105;5256;256643;23676;6611;10549;6303;8905;2277;79135;256714;51360;5251;59272;389840,51
-1,1,X,15807916,18920546,3112630,8233;2925;94056;55787;6792;4810;56474;795;10389;139105;5256;6247;645864;5931;8905;5475;6322;10742;9185,19
1,-1,X,16083896,16497277,413381,645864;2925,2
-1,1,X,18372715,18491396,118681,6792;10389,2
1,1,X,18578748,18606226,27478,6792,1
-1,1,X,18582314,18613550,31236,6792,1
-1,1,X,18662177,18690178,28001,6792;6247,2
-1,1,X,18662232,18695095,32863,6792;6247,2
1,-1,X,19127936,19351757,223821,10149,1
-1,1,X,20173087,20235708,62621,6197,1
-1,1,X,20258161,20813822,555661,6197,1
1,-1,X,22129362,22129540,178,5251,1
1,-1,X,22129362,22129540,178,5251,1
1,-1,X,22129362,22129540,178,5251,1
1,1,X,22166967,22219901,52934,5251,1
1,1,X,22166967,22219901,52934,5251,1
1,-1,X,22815879,22871355,55476,,0
-1,-1,X,22894147,22960744,66597,,0
-1,1,X,22960744,23019707,58963,168400,1
-1,1,X,22960744,23019707,58963,168400,1
-1,1,X,23351370,23449835,98465,139411,1
1,-1,X,26255142,26345329,90187,,0
1,-1,X,28252469,28304589,52120,,0
-1,1,X,30045134,30341004,295870,4113;4112;190;4115;4114,5
-1,1,X,30112028,34078784,3966756,4113;80231;257397;190;4115;4112;53940;1756;2710;4114,10
1,1,X,30322057,30341063,19006,190,1
1,-1,X,30326814,30327501,687,190,1
1,-1,X,30962926,31375215,412289,1756;53940,2
-1,1,X,31088082,155233731,124145649,23096;64061;392509;10214;170685;23157;727837;55998;23439;729431;10916;158586;55859;331;3423;54830;4168;6901;5358;92002;27344;729447;54328;266740;9075;102723737;7552;729422;54954;84460;389874;56000;340562;644538;79649;56850;100272147;51186;3149;26576;100130361;1730;3547;728695;729408;79921;57826;203413;2986;7512;9737;55634;537;2857;3421;11013;340554;5716;6658;4101;54457;91966;441519;4100;27316;7403;4534;6839;728096;27112;92129;101928917;6567;8241;827;203569;27301;84548;645037;54413;100133053;7355;254065;79836;10084;60343;51765;55593;139818;56180;8269;142684;7626;10046;8409;203447;63932;4515;8406;51248;56001;51616;100130613;2564;1193;100132994;5354;11043;340533;22;3476;84631;26748;203562;102723631;170261;58526;441525;4983;29944;1536;2539;1478;1287;81887;3561;9767;9282;54857;347365;10800;139341;54539;11219;728062;169966;51209;23630;26548;1121;2000;645188;51438;2846;280658;1852;347344;23229;10857;56157;286430;101059915;1069;4674;154796;56548;51309;1184;645073;80712;1774;10245;2258;728343;9823;441531;643311;90121;4107;6758;286499;5009;1654;1831;94121;286410;11230;9210;2491;441490;84187;633;6191;64743;4110;3598;389856;7789;2157;9452;50814;170062;57187;139067;4104;203427;4693;5456;10013;55190;100996648;9016;100528062;90316;93953;10178;24137;28952;4105;2332;6845;94122;84968;64663;1538;9142;2245;9506;79576;3266;139212;5207;6535;393;389852;170626;91851;27334;158866;550643;159013;407;7224;55796;10761;100132963;158835;24140;8471;90167;7737;7319;11279;6134;1678;139322;5063;55906;116442;84443;27197;548313;6872;27018;100129239;7102;26071;2664;59353;8573;28985;79184;728049;728090;158521;3581;139886;282808;8263;9130;728082;778;90843;1756;347454;7317;5935;29071;340602;30848;5127;93380;159091;10159;212;139285;9338;85417;8266;100132399;158584;494118;7569;89801;2892;5230;57232;55559;57529;8277;63035;286436;55086;139735;83692;10251;169981;1349;63904;139716;142689;80258;27035;1641;55613;7105;100329135;84295;9459;4109;367;474384;6748;139760;347487;92745;158830;53344;4103;9203;139378;186;474343;2719;3597;9248;402415;203430;90161;728042;4129;65267;56849;728036;4952;83740;84889;6757;347468;347475;6759;9500;51132;8823;541578;2158;55609;2556;494119;6756;9502;158880;8517;8242;474383;57595;51442;389895;100132304;9754;6102;27328;695;56159;51213;90737;60506;100873985;57526;728269;474382;102723680;728656;3358;8273;83844;114824;81557;80823;8862;2002;7216;79979;158763;23641;55217;8270;57477;7592;2833;139599;340526;727866;8450;139804;54470;959;139562;57631;10075;117154;2010;54521;79589;51634;3750;653282;728072;7076;392490;9363;3920;100506164;347411;7454;90293;645051;100529097;55511;158724;203547;139135;5355;347516;203522;139081;6451;27336;158787;728458;4841;347517;340578;139596;1896;441509;54466;158798;4108;79868;728075;158833;79366;1821;56156;392465;1260;56062;5303;3054;51260;139628;653220;340596;554;28986;23133;2623;57692;50945;7739;8260;100131755;57481;139170;64219;4204;389860;2574;65991;10325;6170;10813;79710;8712;26280;2316;6173;9104;494197;29057;139324;442444;6103;54880;90736;55558;1736;369;255313;3654;170627;645974;3897;79983;727940;541466;8243;4007;139741;29978;2182;7504;60401;84707;53336;1485;159090;55285;653067;1046;11152;641339;1947;8852;7712;23708;203523;54967;340542;89885;83550;644353;55916;340595;6594;139189;63947;9643;9843;139728;10479;50943;53940;55026;100507170;5638;4478;8239;4068;51114;246100;9968;84679;115201;100533997;1741;64840;10682;11326;25763;27330;27286;1038;158800;90060;1288;84061;215;292;55879;401612;340527;29935;158983;10009;2747;2652;340543;54885;100129407;10495;79742;140886;2239;2334;4128;441518;139604;4303;55869;8473;11040;5956;6855;84636;55922;728712;2705;54821;729396;441521;8933;10735;729442;9949;4694;84528;492;3028;100129520;83604;7411;9947;100463488;10134;79057;54552;6906;340547;30014;5255;680;6990;4435;340529;65109;64860;7030;729428;8776;4675;5030;51566;729201;56271;4943;79917;85012;114928;5365;538;6853;4354;286451;29934;10838;139221;347404;3251;286464;158931;139793;100008586;2717;5973;139065;5199;546;51270;139231;9131;7547;474381;11254;27238;64102;2543;2273;64648;54440;140597;5631;728239;3188;100130086;8237;286527,678
1,1,X,31207964,31963300,755336,1756,1
-1,1,X,31449215,31543991,94776,1756,1
1,1,X,31537077,31619941,82864,1756,1
-1,1,X,31558361,32077563,519202,1756,1
-1,1,X,31637969,31894898,256929,1756,1
-1,1,X,31658889,31683682,24793,1756,1
-1,1,X,31664103,31792102,127999,1756,1
-1,1,X,31683623,31766614,82991,1756,1
-1,1,X,31713409,31858935,145526,1756,1
-1,1,X,31743030,31824743,81713,1756,1
-1,1,X,31762980,31864904,101924,1756,1
-1,1,X,31762980,31864904,101924,1756,1
-1,1,X,31763002,32580328,817326,1756,1
-1,1,X,31875003,32501088,626085,1756,1
-1,1,X,31888992,31920827,31835,1756,1
-1,1,X,31888825,32371709,482884,1756,1
-1,1,X,31916929,32040440,123511,1756,1
-1,1,X,31923771,32043955,120184,1756,1
-1,1,X,31942461,32104259,161798,1756,1
-1,1,X,31951570,32096169,144599,1756,1
-1,-1,X,32035638,32077563,41925,1756,1
-1,1,X,32053680,32248240,194560,1756,1
-1,1,X,32077637,32237871,160234,1756,1
-1,1,X,32221858,32371650,149792,1756,1
-1,1,X,32285940,32390689,104749,1756,1
-1,1,X,32293846,32371702,77856,1756,1
-1,1,X,32349168,32534563,185395,1756,1
1,1,X,32470878,32663191,192313,1756,1
1,1,X,32519833,32950412,430579,1756,1
-1,1,X,32575523,32772668,197145,1756,1
1,1,X,32644702,32681484,36782,1756,1
-1,1,X,32649520,32925773,276253,1756,1
-1,1,X,32684174,32719596,35422,1756,1
-1,1,X,33140639,35911784,2771145,158724;170062;83604;1756;139604,5
1,-1,X,33595181,34078725,483544,,0
1,-1,X,33656151,33708829,52678,,0
-1,-1,X,33897006,34008729,111723,,0
-1,1,X,36255823,155251871,118996048,23096;64061;392509;10214;170685;23157;727837;55998;23439;729431;10916;158586;55859;331;3423;54830;4168;6901;5358;92002;27344;729447;54328;266740;9075;102723737;7552;729422;54954;84460;389874;56000;340562;644538;79649;56850;100272147;51186;3149;26576;100130361;1730;3547;728695;729408;79921;57826;203413;2986;7512;9737;55634;537;2857;3421;11013;340554;5716;6658;4101;54457;91966;441519;4100;27316;7403;4534;6839;728096;27112;92129;101928917;6567;8241;827;203569;27301;84548;645037;54413;100133053;7355;254065;79836;10084;60343;51765;55593;139818;56180;8269;142684;7626;10046;8409;203447;63932;4515;8406;51248;56001;51616;100130613;2564;1193;100132994;5354;11043;340533;22;3476;84631;26748;203562;102723631;170261;58526;441525;4983;29944;1536;2539;1478;1287;81887;3561;9767;9282;54857;347365;10800;139341;54539;11219;728062;169966;51209;23630;26548;1121;2000;645188;51438;2846;280658;1852;347344;23229;10857;56157;286430;101059915;1069;4674;154796;56548;51309;1184;645073;80712;1774;10245;2258;728343;9823;441531;643311;90121;4107;6758;286499;5009;1654;1831;94121;286410;11230;9210;2491;441490;84187;633;6191;64743;4110;3598;389856;7789;2157;9452;50814;57187;139067;4104;203427;4693;5456;10013;55190;100996648;9016;100528062;90316;93953;10178;24137;28952;4105;2332;6845;94122;84968;64663;1538;9142;2245;9506;79576;3266;139212;5207;6535;393;389852;170626;91851;27334;158866;550643;159013;407;7224;55796;10761;100132963;158835;24140;8471;90167;7737;7319;11279;6134;1678;139322;5063;55906;116442;84443;27197;548313;6872;27018;100129239;7102;26071;2664;59353;8573;28985;79184;728049;728090;158521;3581;139886;282808;8263;9130;728082;778;90843;347454;7317;5935;29071;340602;30848;5127;93380;159091;10159;212;139285;9338;85417;8266;100132399;158584;494118;7569;89801;2892;5230;57232;55559;57529;8277;63035;286436;55086;139735;83692;10251;169981;1349;63904;139716;142689;80258;27035;1641;55613;7105;100329135;84295;9459;4109;367;474384;6748;139760;347487;92745;158830;53344;4103;9203;139378;186;474343;2719;3597;9248;402415;203430;90161;728042;4129;65267;56849;728036;4952;83740;84889;6757;347468;347475;6759;9500;51132;8823;541578;2158;55609;2556;494119;6756;9502;158880;8517;8242;474383;57595;51442;389895;100132304;9754;6102;27328;695;56159;51213;90737;60506;100873985;57526;728269;474382;102723680;728656;3358;8273;83844;114824;81557;80823;8862;2002;7216;79979;158763;23641;55217;8270;57477;7592;2833;139599;340526;727866;8450;139804;54470;959;139562;57631;10075;117154;2010;54521;79589;51634;3750;653282;728072;7076;392490;9363;3920;100506164;347411;7454;90293;645051;100529097;55511;203547;139135;5355;347516;203522;139081;6451;27336;158787;728458;4841;347517;340578;139596;1896;441509;54466;158798;4108;79868;728075;158833;79366;1821;56156;392465;1260;56062;5303;3054;51260;139628;653220;340596;554;28986;23133;2623;57692;50945;7739;8260;100131755;57481;139170;64219;4204;389860;2574;65991;10325;6170;10813;79710;8712;26280;2316;6173;9104;494197;29057;139324;442444;6103;54880;90736;55558;1736;369;255313;3654;170627;645974;3897;79983;727940;541466;8243;4007;139741;29978;2182;7504;60401;84707;53336;1485;159090;55285;653067;1046;11152;641339;1947;8852;7712;23708;203523;54967;340542;89885;83550;644353;55916;340595;6594;139189;63947;9643;9843;139728;10479;50943;55026;100507170;5638;4478;8239;4068;51114;246100;9968;84679;115201;100533997;1741;64840;10682;11326;25763;27330;27286;1038;158800;90060;1288;84061;215;292;55879;401612;340527;29935;158983;10009;2747;2652;340543;54885;100129407;10495;79742;140886;2239;2334;4128;441518;4303;55869;8473;11040;5956;6855;84636;55922;728712;2705;54821;729396;441521;8933;10735;729442;9949;4694;84528;492;3028;100129520;7411;9947;100463488;10134;79057;54552;6906;340547;30014;5255;680;6990;4435;340529;65109;64860;7030;729428;8776;4675;5030;51566;729201;56271;4943;79917;85012;114928;5365;538;6853;4354;286451;29934;10838;139221;347404;3251;286464;158931;139793;100008586;2717;5973;139065;5199;546;51270;139231;9131;7547;474381;11254;27238;64102;2543;2273;64648;54440;140597;5631;728239;3188;100130086;8237;286527,672
-1,1,X,36667388,44316141,7648753,27197;442444;6103;8406;54880;1536;4129;80258;159013;2857;60506;100873985;4128;7102;4693;5009;9282;1654;58526;7504;6990;347404;8573;441490;25763;10159;5638;8239;94122;347411,30
-1,1,X,37094357,155246585,118152228,23096;64061;392509;10214;170685;23157;727837;55998;23439;729431;10916;158586;55859;331;3423;54830;4168;6901;5358;92002;27344;729447;54328;266740;9075;102723737;7552;729422;54954;84460;389874;56000;340562;644538;79649;56850;100272147;51186;3149;26576;100130361;1730;3547;728695;729408;79921;57826;203413;2986;7512;9737;55634;537;2857;3421;11013;340554;5716;6658;4101;54457;91966;441519;4100;27316;7403;4534;6839;728096;27112;92129;101928917;6567;8241;827;203569;27301;84548;645037;54413;100133053;7355;254065;79836;10084;60343;51765;55593;139818;56180;8269;142684;7626;10046;8409;203447;63932;4515;8406;51248;56001;51616;100130613;2564;1193;100132994;5354;11043;340533;22;3476;84631;26748;203562;102723631;170261;58526;441525;4983;29944;1536;2539;1478;1287;81887;3561;9767;9282;54857;347365;10800;139341;54539;11219;728062;169966;51209;23630;26548;1121;2000;645188;51438;2846;280658;1852;347344;23229;10857;56157;286430;101059915;1069;4674;154796;56548;51309;1184;645073;80712;1774;10245;2258;728343;9823;441531;643311;90121;4107;6758;286499;5009;1654;1831;94121;286410;11230;9210;2491;84187;633;6191;64743;4110;3598;389856;7789;2157;9452;50814;57187;139067;4104;203427;4693;5456;10013;55190;100996648;9016;100528062;90316;93953;10178;24137;28952;4105;2332;6845;94122;84968;64663;1538;9142;2245;9506;79576;3266;139212;5207;6535;393;389852;170626;91851;27334;158866;550643;159013;407;7224;55796;10761;100132963;158835;24140;8471;90167;7737;7319;11279;6134;1678;139322;5063;55906;116442;84443;27197;548313;6872;27018;100129239;7102;26071;2664;59353;8573;28985;79184;728049;728090;158521;3581;139886;282808;8263;9130;728082;778;90843;347454;7317;5935;29071;340602;30848;5127;93380;159091;10159;212;139285;9338;85417;8266;100132399;158584;494118;7569;89801;2892;5230;57232;55559;57529;8277;63035;286436;55086;139735;83692;10251;169981;1349;63904;139716;142689;80258;27035;1641;55613;7105;100329135;84295;9459;4109;367;474384;6748;139760;347487;92745;158830;53344;4103;9203;139378;186;474343;2719;3597;9248;402415;203430;90161;728042;4129;65267;56849;728036;4952;83740;84889;6757;347468;347475;6759;9500;51132;8823;541578;2158;55609;2556;494119;6756;9502;158880;8517;8242;474383;57595;51442;389895;100132304;9754;6102;27328;695;56159;51213;90737;60506;100873985;57526;728269;474382;102723680;728656;3358;8273;83844;114824;81557;80823;8862;2002;7216;79979;158763;23641;55217;8270;57477;7592;2833;139599;340526;727866;8450;139804;54470;959;139562;57631;10075;117154;2010;54521;79589;51634;3750;653282;728072;7076;392490;9363;3920;100506164;347411;7454;90293;645051;100529097;55511;203547;139135;5355;347516;203522;139081;6451;27336;158787;728458;4841;347517;340578;139596;1896;441509;54466;158798;4108;79868;728075;158833;79366;1821;56156;392465;1260;56062;5303;3054;51260;139628;653220;340596;554;28986;23133;2623;57692;50945;7739;8260;100131755;57481;139170;64219;4204;389860;2574;65991;10325;6170;10813;79710;8712;26280;2316;6173;9104;494197;29057;139324;6103;90736;54880;55558;1736;369;255313;3654;170627;645974;3897;79983;727940;541466;8243;4007;139741;29978;2182;7504;60401;84707;53336;1485;159090;55285;653067;1046;11152;641339;1947;8852;7712;23708;203523;54967;340542;89885;83550;644353;55916;340595;6594;139189;63947;9643;9843;139728;10479;50943;55026;100507170;5638;4478;8239;4068;51114;246100;9968;84679;115201;100533997;1741;64840;10682;11326;25763;27330;27286;1038;158800;90060;1288;84061;215;292;55879;401612;340527;29935;158983;10009;2747;2652;340543;54885;100129407;10495;79742;140886;2239;2334;4128;441518;4303;55869;8473;11040;5956;6855;84636;55922;728712;2705;54821;729396;441521;8933;10735;729442;9949;4694;84528;492;3028;100129520;7411;9947;100463488;10134;79057;54552;6906;340547;30014;5255;680;6990;4435;340529;65109;64860;7030;729428;8776;4675;5030;51566;729201;56271;4943;79917;85012;114928;5365;538;6853;4354;286451;29934;10838;139221;347404;3251;158931;139793;100008586;2717;5973;139065;5199;546;51270;139231;9131;7547;474381;11254;27238;64102;2543;2273;64648;54440;140597;5631;728239;3188;100130086;8237;286527,669
1,-1,X,37423768,37669766,245998,347404;1536;7504,3
-1,1,X,37521774,98488534,60966760,23096;64061;6759;9500;10214;51132;8823;170685;727837;729431;6756;9502;10916;158880;158586;8242;27344;729447;54328;100132304;729422;9754;7552;6102;27328;54954;56159;389874;340562;90737;60506;56850;100873985;100130361;1730;728656;729408;81557;2002;7216;55634;7592;2857;57477;2833;340554;340526;727866;139599;139562;10075;117154;7403;6839;3750;27112;7076;6567;8241;392490;347411;7454;203569;27301;645037;645051;54413;7355;254065;10084;5355;347516;55593;6451;158787;4841;8409;347517;139596;1896;54466;8406;51248;51616;100132994;158833;79366;340533;392465;22;56062;5303;3476;26748;51260;139628;653220;58526;28986;23133;4983;2623;1536;57692;50945;81887;64219;389860;2574;3561;9767;10325;9282;54857;8712;347365;10800;139341;54539;169966;9104;494197;29057;26548;6103;90736;54880;139324;1121;369;2846;280658;170627;645974;347344;23229;79983;8243;4007;286430;101059915;29978;7504;60401;4674;53336;56548;1184;645073;10245;441531;653067;1046;11152;90121;641339;6758;1947;8852;7712;23708;5009;286499;1654;11230;9210;6191;64743;389856;7789;9452;139189;63947;9843;4693;5456;10013;55190;50943;90316;93953;24137;28952;4478;8239;94122;1538;2245;9968;84679;1741;9506;64840;10682;3266;11326;5207;25763;27330;389852;170626;27334;158866;550643;159013;407;90060;84061;158835;24140;11279;340527;139322;55906;29935;27197;100129407;548313;6872;79742;140886;4128;7102;4303;55869;8473;11040;6855;84636;8573;2705;54821;729396;729442;139886;3028;778;7317;5935;100463488;54552;340602;5255;6990;5127;4435;340529;10159;212;139285;85417;100132399;7030;729428;158584;4675;5030;7569;729201;89801;5230;57232;4943;79917;538;6853;286451;29934;347404;169981;1349;63904;142689;80258;139793;100008586;55613;5199;367;546;92745;158830;53344;9203;474343;203430;27238;4129;2543;65267;728239;84889;8237;6757,294
-1,1,X,38135974,38957292,821318,6103;5009;58526;7102,4
1,1,X,38486799,38628556,141757,7102,1
1,-1,X,38488617,38547951,59334,7102,1
1,-1,X,38488617,38547951,59334,7102,1
-1,1,X,41150139,46528262,5378123,27197;63904;4129;80258;55634;60506;2857;79742;641339;4128;84679;4693;1654;7403;8573;139341;56548,17
-1,1,X,41687057,43144754,1457697,8573,1
-1,1,X,41708906,41713659,4753,8573,1
-1,-1,X,42331117,42441959,110842,,0
-1,1,X,42740733,43608143,867410,4128,1
1,1,X,43221119,50674794,7453675,729442;64743;6759;10214;389856;139189;392465;778;729431;6756;7317;5935;4693;26748;10013;50943;5127;27344;28952;729447;85417;100132399;7030;729428;729422;2623;6102;7569;729201;89801;57232;4943;56850;79917;84679;2574;9506;6853;9767;64840;10682;3266;8712;139341;54539;729408;389852;9104;2002;63904;80258;369;100008586;55634;7592;57477;90060;5199;347344;24140;92745;4007;7403;6839;3750;7076;8241;56548;1184;7454;27238;645073;645037;645051;4129;10245;2543;548313;79742;7355;11152;4128;641339;10084;5355;6758;55593;8852;7712;11040;6855;11230;8409;9210;8237;729396,96
1,1,X,43499856,43982742,482886,4128;4693;4129,3
1,-1,X,44514646,44703618,188972,63904,1
1,-1,X,46407630,46532878,125248,84679;56548,2
1,1,X,46818746,53957191,7138445,23096;729442;64743;64061;6759;9500;10214;389856;170685;3028;727837;139189;392465;778;729431;6756;9502;7317;5935;26748;10013;55190;8242;653220;50943;340602;5127;27344;28952;729447;54328;85417;100132399;7030;729428;729422;2623;7569;729201;89801;57232;4943;56850;79917;2574;9506;6853;9767;64840;10682;3266;8712;54539;729408;389852;81557;170626;9104;494197;29057;2002;6757;369;100008586;57477;7592;280658;90060;170627;727866;5199;347344;24140;92745;10075;8243;4007;6839;3750;7076;8241;1184;7454;27238;645073;645037;645051;10245;2543;548313;653067;7355;11152;10084;5355;6758;55593;8852;158787;7712;23708;728239;11040;6855;11230;8409;9210;8237;729396,109
1,-1,X,46950670,47024580,73910,8241;54539;9104,3
1,1,X,47881447,52616581,4735134,729442;64743;6759;9500;10214;389856;170685;139189;392465;778;5935;6756;729431;9502;26748;10013;55190;653220;50943;340602;27344;28952;729447;85417;100132399;7030;729428;2623;729422;729201;89801;57232;4943;56850;79917;2574;9506;64840;10682;3266;8712;729408;81557;100008586;57477;90060;24140;92745;4007;6839;3750;1184;7454;27238;645073;645037;10245;645051;2543;548313;653067;7355;11152;10084;5355;6758;55593;8852;23708;728239;11040;6855;11230;9210;729396,75
1,1,X,48120296,52616581,4496285,729442;64743;6759;9500;10214;389856;170685;139189;392465;778;5935;6756;729431;9502;26748;10013;55190;653220;50943;340602;27344;28952;729447;85417;100132399;7030;729428;2623;729422;89801;4943;56850;79917;2574;9506;64840;10682;3266;8712;729408;81557;100008586;57477;90060;24140;92745;4007;6839;3750;1184;7454;27238;645073;645037;10245;645051;2543;548313;653067;7355;11152;10084;5355;55593;8852;23708;728239;11040;6855;11230;9210;729396,72
1,1,X,48204101,58081470,9877369,23096;729442;64743;64061;6759;9500;10214;389856;7789;170685;3028;727837;139189;392465;778;729431;9502;10916;158880;158586;5935;100463488;54552;10013;26748;139628;55190;8242;653220;50943;340602;28986;27344;212;28952;729447;54328;23133;85417;100132399;7030;729428;729422;2623;158584;54954;89801;2245;90737;4943;56850;79917;389860;2574;9506;10325;64840;10682;3266;8712;5207;347365;729408;169981;81557;170626;6757;494197;29057;7216;90736;550643;139793;100008586;57477;280658;90060;170627;727866;24140;92745;10075;8243;4007;286430;474343;29978;11279;6839;3750;1184;7454;203569;27301;27238;645073;645037;645051;10245;2543;65267;548313;653067;7355;11152;90121;10084;5355;55593;8852;158787;23708;728239;11040;6855;11230;9210;729396;54466,119
1,1,X,48224454,52813336,4588882,729442;64743;6759;9500;389856;170685;727837;139189;392465;778;5935;729431;9502;26748;10013;55190;653220;50943;340602;27344;28952;729447;85417;100132399;7030;729428;2623;729422;89801;4943;56850;79917;2574;9506;64840;10682;3266;8712;729408;81557;6757;100008586;57477;280658;90060;24140;92745;4007;6839;3750;1184;7454;27238;645073;645037;10245;645051;2543;548313;653067;7355;11152;10084;5355;55593;8852;23708;728239;11040;6855;11230;9210;729396,73
1,1,X,48245740,52616581,4370841,729442;64743;6759;9500;389856;170685;139189;392465;778;5935;729431;9502;26748;10013;55190;653220;50943;340602;27344;28952;729447;85417;100132399;7030;729428;2623;729422;89801;4943;56850;79917;2574;9506;64840;10682;3266;8712;729408;81557;100008586;57477;90060;24140;92745;4007;6839;3750;1184;7454;27238;645073;645037;10245;645051;2543;548313;653067;7355;11152;10084;5355;55593;8852;23708;728239;11040;6855;11230;9210;729396,70
1,1,X,48287896,52616581,4328685,729442;64743;9500;389856;170685;139189;392465;778;5935;729431;9502;26748;10013;55190;653220;50943;340602;27344;28952;729447;85417;100132399;7030;729428;2623;729422;89801;4943;56850;79917;2574;9506;64840;10682;3266;8712;729408;81557;100008586;57477;90060;24140;92745;4007;6839;3750;1184;7454;27238;645073;645037;10245;645051;2543;653067;7355;11152;10084;5355;55593;8852;23708;728239;11040;6855;11230;9210;729396,68
-1,1,X,48287896,52616581,4328685,729442;64743;9500;389856;170685;139189;392465;778;5935;729431;9502;26748;10013;55190;653220;50943;340602;27344;28952;729447;85417;100132399;7030;729428;2623;729422;89801;4943;56850;79917;2574;9506;64840;10682;3266;8712;729408;81557;100008586;57477;90060;24140;92745;4007;6839;3750;1184;7454;27238;645073;645037;10245;645051;2543;653067;7355;11152;10084;5355;55593;8852;23708;728239;11040;6855;11230;9210;729396,68
1,1,X,48290189,52154997,3864808,729442;64743;9500;389856;170685;139189;392465;778;5935;729431;9502;26748;10013;55190;50943;340602;27344;28952;729447;85417;100132399;7030;729428;2623;729422;89801;4943;56850;79917;2574;9506;64840;10682;3266;8712;729408;81557;100008586;57477;90060;24140;92745;4007;6839;3750;1184;7454;27238;645073;645037;10245;645051;2543;7355;11152;10084;5355;55593;8852;23708;728239;11040;6855;11230;9210;729396,66
1,1,X,48317353,51497588,3180235,729442;64743;389856;100008586;57477;170685;90060;392465;139189;778;24140;5935;729431;92745;26748;10013;4007;55190;50943;340602;6839;3750;27344;28952;729447;85417;100132399;7030;729428;7454;2623;27238;729422;645073;1184;645037;10245;89801;645051;2543;4943;7355;56850;11152;79917;10084;5355;2574;55593;9506;8852;23708;64840;10682;3266;11040;8712;6855;11230;9210;729408;729396,62
1,1,X,48317353,51497588,3180235,729442;64743;389856;100008586;57477;170685;90060;392465;139189;778;24140;5935;729431;92745;26748;10013;4007;55190;50943;340602;6839;3750;27344;28952;729447;85417;100132399;7030;729428;7454;2623;27238;729422;645073;1184;645037;10245;89801;645051;2543;4943;7355;56850;11152;79917;10084;5355;2574;55593;9506;8852;23708;64840;10682;3266;11040;8712;6855;11230;9210;729408;729396,62
1,-1,X,48369787,48370706,919,64840,1
1,-1,X,48369856,48370750,894,64840,1
1,-1,X,48369856,48370750,894,64840,1
1,-1,X,48369856,48371066,1210,64840,1
1,-1,X,48369856,48371066,1210,64840,1
1,1,X,48811187,53303085,4491898,23096;729442;64061;9500;389856;100008586;57477;170685;280658;90060;139189;727837;170627;729396;778;727866;729431;9502;26748;4007;55190;653220;8242;50943;340602;3750;28952;729447;54328;85417;100132399;7030;729428;27238;729422;645073;1184;645037;645051;89801;2543;653067;56850;11152;79917;5355;2574;55593;9506;8852;23708;728239;8712;6855;11230;9210;729408;81557;170626;6757;494197;29057,62
-1,1,X,48957474,101429714,52472240,23096;64061;9500;392509;389856;7789;51132;8823;170685;727837;139189;9452;63947;55998;729431;9502;10916;158880;158586;9843;5456;55190;8242;50943;90316;93953;24137;28952;729447;54328;4478;100132304;729422;9754;7552;27328;54954;1538;56159;2245;389874;340562;90737;695;84460;9968;57526;1741;9506;100130361;1730;11326;5207;728656;729408;27330;81557;170626;27334;7216;158866;27286;79979;550643;407;57477;2833;340554;340526;727866;139599;158835;84061;54457;54470;139562;10075;117154;11279;1678;340527;27112;139322;6567;55906;392490;29935;203569;27301;645037;645051;54413;100129407;6872;100529097;140886;254065;5355;347516;4303;6451;55869;158787;4841;8473;6855;84636;59353;2705;347517;54821;729396;139596;1896;54466;729442;51248;51616;139886;100132994;158833;3028;340533;79366;1821;22;778;56062;5303;100463488;54552;3476;26748;51260;139628;653220;340602;5255;4435;28986;340529;212;23133;139285;85417;4983;100132399;158584;729428;4675;5030;57692;51566;1478;89801;50945;5230;100131755;79917;81887;64219;389860;2574;538;3561;10325;286451;29934;54857;8712;347365;10800;169966;169981;6173;26548;494197;29057;1349;90736;139324;1121;158931;142689;27035;2846;139793;100008586;55613;7105;280658;2717;170627;645974;367;23229;546;79983;158830;53344;8243;4007;286430;9203;474343;29978;101059915;60401;402415;4674;53336;203430;51309;1184;27238;645073;64102;2543;65267;9823;441531;653067;1046;11152;90121;1947;8852;23708;286499;140597;728239;84889;3188;340542;94121;9210;2491;6191;6757,239
-1,1,X,49102754,122869859,73767105,23096;64061;392509;9500;51132;8823;170685;23157;727837;55998;23439;729431;10916;158586;9502;158880;55859;8242;54830;5358;729447;54328;9075;7552;729422;100132304;9754;27328;54954;84460;695;389874;56000;340562;56159;51213;90737;57526;51186;100130361;1730;728656;3358;729408;79921;203413;81557;80823;2986;7216;79979;9737;57477;11013;340554;2833;139599;5716;340526;727866;54457;8450;139804;54470;139562;57631;10075;117154;54521;79589;728096;27112;92129;653282;728072;6567;392490;3920;827;203569;27301;90293;645037;645051;54413;100529097;254065;79836;347516;6451;139818;158787;142684;4841;347517;203447;139596;63932;1896;441509;54466;51248;56001;158798;51616;79868;728075;100132994;5354;11043;340533;56156;158833;79366;22;1821;56062;5303;3476;26748;51260;139628;203562;653220;170261;340596;28986;23133;4983;57692;1478;50945;100131755;57481;1287;81887;64219;389860;2574;3561;10325;6170;54857;79710;347365;10800;8712;26280;728062;169966;6173;51209;23630;26548;494197;29057;1121;139324;90736;2846;255313;280658;170627;645974;23229;79983;727940;10857;8243;56157;286430;101059915;29978;2182;60401;84707;4674;53336;154796;51309;1184;645073;80712;728343;9823;55285;441531;653067;1046;643311;90121;1947;8852;286499;23708;1831;340542;94121;9210;2491;84187;6191;644353;3598;55916;389856;7789;340595;9452;139189;63947;9643;57187;9843;203427;5456;55190;100996648;50943;55026;100528062;90316;93953;100507170;24137;28952;4478;1538;2245;9968;115201;1741;9506;79576;139212;11326;5207;27330;170626;91851;27334;158866;27286;550643;407;158800;7224;1288;84061;158835;8471;292;7737;7319;11279;401612;1678;340527;139322;5063;55906;84443;29935;158983;10009;2747;340543;54885;100129407;27018;6872;140886;4303;55869;8473;59353;84636;55922;2705;28985;54821;729396;728049;728090;729442;9949;4694;139886;282808;84528;3028;728082;90843;347454;29071;100463488;54552;6906;340547;340602;5255;4435;340529;212;139285;9338;65109;85417;100132399;158584;64860;729428;4675;5030;51566;56271;89801;2892;5230;85012;57529;114928;286527;538;286451;286436;55086;29934;139221;169981;1349;158931;142689;27035;1641;100329135;55613;7105;139793;100008586;2717;367;546;158830;53344;9203;186;474343;139231;3597;402415;203430;11254;64102;728042;2543;65267;56849;728036;140597;5631;728239;84889;3188;6757,365
-1,1,X,50032384,118431567,68399183,23096;64061;9500;392509;51132;8823;170685;727837;55998;10916;9502;158880;158586;55859;8242;54830;5358;54328;9075;100132304;7552;9754;27328;54954;695;56159;389874;84460;340562;90737;56000;51213;57526;51186;100130361;1730;728656;3358;79921;81557;203413;80823;2986;7216;79979;9737;57477;2833;340554;340526;727866;139599;11013;54470;54457;5716;139804;139562;57631;10075;117154;54521;79589;27112;92129;6567;392490;827;203569;27301;90293;54413;100529097;254065;79836;347516;6451;139818;158787;4841;142684;347517;203447;139596;1896;441509;54466;51248;56001;51616;79868;100132994;56156;158833;340533;79366;1821;5354;22;11043;56062;5303;3476;51260;139628;203562;653220;170261;340596;28986;23133;4983;57692;1478;50945;100131755;57481;1287;81887;64219;389860;3561;10325;54857;79710;347365;10800;26280;169966;6173;51209;23630;26548;494197;29057;139324;90736;1121;2846;280658;170627;645974;23229;79983;10857;8243;56157;286430;101059915;29978;2182;60401;84707;4674;53336;154796;51309;80712;728343;9823;55285;441531;653067;1046;90121;1947;23708;286499;1831;340542;94121;9210;2491;84187;6191;644353;55916;3598;7789;340595;9452;139189;63947;9643;9843;5456;55190;100996648;100528062;90316;93953;24137;4478;1538;2245;9968;115201;1741;11326;139212;5207;27330;170626;6757;91851;27334;158866;27286;550643;407;7224;1288;84061;158835;8471;11279;401612;1678;340527;139322;5063;55906;84443;29935;158983;340543;54885;100129407;27018;6872;140886;4303;55869;8473;59353;84636;2705;54821;9949;139886;282808;3028;90843;100463488;54552;6906;340547;340602;5255;4435;340529;212;139285;9338;85417;158584;64860;4675;5030;51566;56271;5230;85012;57529;114928;538;286451;29934;286436;139221;55086;169981;1349;158931;142689;27035;1641;139793;55613;7105;2717;100329135;367;546;158830;53344;9203;139231;474343;186;3597;402415;203430;11254;64102;65267;56849;140597;5631;728239;84889;3188;286527,303
-1,1,X,51397726,58495933,7098207,23096;7216;90736;550643;64061;9500;7789;139793;280658;727837;3028;170627;727866;10916;9502;100463488;158880;54552;158586;139628;8243;10075;286430;653220;8242;474343;29978;11279;28986;212;23133;54328;158584;203569;81557;27301;54954;65267;2245;90737;653067;90121;389860;23708;158787;10325;54466;728239;347365;5207;169981;6757;170626;494197;29057,55
-1,1,X,51450890,53258946,1808056,81557;64061;9500;280658;653067;727837;170627;727866;9502;54328;23708;653220;728239;8242;6757;170626;494197;29057,18
1,1,X,52570756,74232626,21661870,23096;51248;64061;139886;7789;51132;100132994;158833;3028;727837;340533;63947;5303;10916;158586;158880;9843;100463488;54552;3476;139628;8242;5255;4435;93953;28986;24137;340529;54328;4478;212;23133;139285;4983;100132304;158584;9754;5030;54954;56159;2245;389874;90737;9968;81887;64219;389860;1741;3561;10325;100130361;286451;29934;54857;11326;347365;5207;728656;169981;170626;26548;494197;29057;7216;90736;550643;142689;139793;55613;407;280658;170627;2833;340554;340526;727866;645974;158835;367;23229;139562;158830;53344;10075;8243;286430;9203;474343;29978;11279;101059915;60401;340527;27112;4674;6567;55906;392490;203569;27301;54413;100129407;65267;6872;1046;90121;347516;4303;1947;55869;158787;4841;8473;84889;2705;347517;54821;6191;6757;1896;54466,121
1,1,X,52838147,64525424,11687277,23096;7216;90736;550643;142689;64061;139886;7789;139793;55613;3028;170627;727866;23229;10916;100463488;158880;158586;54552;139628;8243;10075;286430;8242;474343;29978;11279;28986;212;23133;54328;139285;55906;158584;203569;27301;54954;65267;2245;90737;90121;389860;158787;10325;54466;347365;5207;169981;170626;29057,50
-1,1,X,53321095,155232907,101911812,23096;392509;23157;55998;23439;10916;158586;55859;331;3423;54830;4168;6901;5358;92002;266740;9075;102723737;7552;54954;84460;389874;56000;340562;644538;79649;100272147;51186;3149;26576;100130361;1730;3547;728695;57826;79921;203413;2986;7512;9737;537;3421;11013;340554;5716;6658;4101;54457;91966;441519;4100;27316;4534;728096;27112;92129;101928917;6567;827;203569;27301;84548;54413;100133053;254065;79836;60343;51765;139818;56180;8269;142684;7626;10046;203447;63932;4515;51248;56001;51616;100130613;2564;1193;100132994;5354;11043;340533;22;3476;84631;203562;102723631;170261;441525;4983;29944;2539;1478;1287;81887;3561;54857;347365;10800;11219;728062;169966;51209;23630;26548;1121;2000;645188;51438;2846;1852;23229;10857;56157;286430;101059915;1069;4674;154796;51309;80712;1774;2258;728343;9823;441531;643311;90121;4107;286499;1831;94121;286410;2491;84187;633;6191;4110;3598;7789;2157;9452;50814;57187;139067;4104;203427;5456;100996648;9016;100528062;90316;93953;10178;24137;4105;2332;6845;84968;64663;1538;9142;2245;79576;139212;5207;6535;393;91851;27334;158866;550643;407;7224;55796;10761;100132963;158835;8471;90167;7737;7319;11279;6134;1678;139322;5063;55906;116442;84443;27018;6872;100129239;26071;2664;59353;28985;79184;728049;728090;158521;3581;139886;282808;8263;9130;728082;90843;347454;29071;30848;93380;159091;212;139285;9338;8266;158584;494118;2892;5230;55559;57529;8277;63035;286436;55086;139735;83692;10251;169981;1349;139716;142689;27035;1641;100329135;55613;7105;84295;9459;4109;367;474384;6748;139760;347487;158830;53344;4103;9203;139378;186;474343;2719;3597;9248;402415;203430;90161;728042;65267;56849;728036;4952;83740;84889;347468;347475;51132;8823;541578;2158;55609;2556;494119;158880;8517;474383;57595;51442;389895;100132304;9754;27328;695;56159;51213;90737;57526;728269;474382;102723680;728656;3358;8273;83844;114824;80823;8862;7216;79979;158763;23641;55217;8270;2833;8450;340526;139599;139804;54470;959;139562;57631;10075;117154;2010;54521;79589;51634;653282;728072;392490;9363;3920;100506164;90293;100529097;55511;203547;139135;347516;203522;139081;6451;27336;158787;728458;4841;347517;340578;139596;1896;441509;54466;158798;4108;79868;728075;56156;158833;79366;1821;1260;56062;5303;3054;51260;139628;340596;554;28986;23133;57692;50945;7739;8260;100131755;57481;139170;64219;4204;389860;65991;10325;6170;10813;79710;26280;2316;6173;139324;55558;90736;1736;255313;3654;645974;3897;79983;727940;541466;8243;139741;29978;2182;60401;84707;53336;1485;159090;55285;1046;1947;203523;54967;340542;89885;83550;644353;55916;340595;6594;63947;9643;9843;139728;10479;55026;100507170;4478;4068;51114;246100;9968;115201;100533997;1741;11326;27330;27286;1038;158800;1288;84061;215;292;55879;401612;340527;29935;158983;10009;2747;2652;340543;54885;100129407;10495;140886;2239;2334;441518;4303;55869;8473;5956;728712;84636;55922;2705;54821;441521;8933;10735;9949;4694;84528;492;3028;100129520;7411;9947;100463488;10134;79057;54552;6906;340547;30014;5255;680;4435;340529;65109;64860;8776;4675;5030;51566;56271;85012;114928;5365;538;4354;286451;29934;10838;139221;3251;158931;139793;2717;5973;139065;546;51270;139231;9131;7547;474381;11254;64102;2273;64648;54440;140597;5631;3188;100130086;286527,528
1,1,X,53559548,53622547,62999,10075,1
1,1,X,53559548,53622547,62999,10075,1
1,1,X,53559732,53790650,230918,10075,1
1,1,X,53559732,53790650,230918,10075,1
1,1,X,53776863,62203737,8426874,7216;90736;550643;7789;139793;100463488;10916;158880;158586;54552;139628;286430;474343;29978;11279;28986;212;23133;158584;203569;27301;54954;65267;2245;90737;90121;389860;10325;347365;5207;169981;54466,32
1,1,X,53790650,58041201,4250551,7216;90736;550643;7789;139793;100463488;10916;158880;158586;54552;139628;286430;474343;29978;11279;28986;212;23133;158584;203569;27301;54954;65267;2245;90737;90121;389860;10325;347365;5207;169981;54466,32
-1,1,X,54012008,91458107,37446099,7789;51132;8823;9452;63947;10916;158586;158880;9843;5456;90316;93953;24137;4478;100132304;7552;9754;27328;54954;1538;56159;2245;389874;340562;90737;9968;1741;100130361;11326;5207;728656;27330;27334;7216;158866;550643;407;2833;340554;340526;139599;84061;158835;139562;117154;11279;340527;27112;139322;6567;55906;392490;203569;27301;54413;100129407;6872;140886;254065;347516;4303;6451;55869;4841;8473;84636;2705;347517;54821;139596;1896;54466;51248;51616;139886;100132994;158833;79366;340533;22;56062;5303;100463488;54552;3476;51260;139628;5255;4435;28986;340529;212;23133;139285;4983;158584;5030;57692;50945;5230;81887;64219;389860;538;3561;10325;286451;29934;54857;347365;10800;169966;169981;26548;139324;1349;90736;1121;142689;2846;139793;55613;645974;367;23229;546;79983;158830;53344;286430;9203;474343;29978;101059915;60401;4674;53336;203430;65267;441531;1046;90121;1947;84889;6191,145
1,1,X,55000501,155230750,100230249,392509;23157;55998;23439;158586;55859;331;3423;54830;4168;6901;5358;92002;266740;9075;102723737;7552;84460;389874;56000;340562;644538;79649;100272147;51186;3149;26576;100130361;1730;3547;728695;57826;79921;203413;2986;7512;9737;537;3421;11013;340554;5716;6658;4101;54457;91966;441519;4100;27316;4534;728096;27112;92129;101928917;6567;827;203569;27301;84548;54413;100133053;254065;79836;60343;51765;139818;56180;8269;142684;7626;10046;203447;63932;4515;51248;56001;51616;100130613;2564;1193;100132994;5354;11043;340533;22;3476;84631;203562;102723631;170261;441525;4983;29944;2539;1478;1287;81887;3561;54857;10800;11219;728062;169966;51209;23630;26548;1121;2000;645188;51438;2846;1852;23229;10857;56157;286430;101059915;1069;4674;154796;51309;80712;1774;2258;728343;9823;441531;643311;4107;286499;1831;94121;286410;2491;84187;633;6191;4110;3598;7789;2157;9452;50814;57187;139067;4104;203427;5456;100996648;9016;100528062;90316;93953;10178;24137;4105;2332;6845;84968;64663;1538;9142;79576;139212;5207;6535;393;91851;27334;158866;550643;407;7224;55796;10761;100132963;158835;8471;90167;7737;7319;11279;6134;1678;139322;5063;55906;116442;84443;27018;6872;100129239;26071;2664;59353;28985;79184;728049;728090;158521;3581;139886;282808;8263;9130;728082;90843;347454;29071;30848;93380;159091;212;139285;9338;8266;158584;494118;2892;5230;55559;57529;8277;63035;286436;55086;139735;83692;10251;169981;1349;139716;142689;27035;1641;100329135;55613;7105;84295;9459;4109;367;474384;6748;139760;347487;158830;53344;4103;9203;139378;186;474343;2719;3597;9248;402415;203430;90161;728042;56849;728036;4952;83740;84889;347468;347475;51132;8823;541578;2158;55609;2556;494119;158880;8517;474383;57595;51442;389895;100132304;9754;27328;695;56159;51213;90737;57526;728269;474382;102723680;728656;3358;8273;83844;114824;80823;8862;23641;79979;158763;55217;8270;2833;8450;340526;139599;139804;54470;959;139562;57631;117154;2010;54521;79589;51634;653282;728072;392490;9363;3920;100506164;90293;100529097;55511;203547;139135;347516;203522;139081;6451;27336;728458;4841;347517;340578;139596;1896;441509;54466;158798;4108;79868;728075;158833;79366;1821;56156;1260;56062;5303;3054;51260;139628;340596;554;28986;57692;50945;7739;8260;100131755;57481;139170;64219;4204;389860;65991;10325;6170;10813;79710;26280;2316;6173;139324;55558;90736;1736;255313;3654;645974;3897;79983;727940;541466;139741;29978;2182;60401;84707;53336;1485;159090;55285;1046;1947;203523;54967;340542;89885;83550;644353;55916;340595;6594;63947;9643;9843;139728;10479;55026;100507170;4478;4068;51114;246100;9968;115201;100533997;1741;11326;27330;27286;1038;158800;1288;84061;215;292;55879;401612;340527;29935;158983;10009;2747;2652;340543;54885;100129407;10495;140886;2239;2334;441518;4303;55869;8473;5956;728712;84636;55922;2705;54821;441521;8933;10735;9949;4694;84528;492;100129520;7411;9947;100463488;10134;79057;6906;340547;30014;5255;680;4435;340529;65109;64860;8776;4675;5030;51566;56271;85012;114928;5365;538;4354;286451;29934;10838;139221;3251;158931;139793;2717;5973;139065;546;51270;139231;9131;7547;474381;11254;64102;2273;64648;54440;140597;5631;3188;100130086;286527,514
1,-1,X,55101485,55117828,16343,203569;389860,2
1,-1,X,55101485,55117828,16343,203569;389860,2
-1,1,X,55240087,78225374,22985287,51248;51616;139886;7789;51132;8823;100132994;158833;340533;63947;22;5303;9843;158586;158880;3476;51260;139628;5255;4435;93953;28986;24137;340529;139285;4478;4983;158584;100132304;9754;5030;57692;56159;389874;5230;90737;9968;81887;64219;1741;538;3561;10325;100130361;286451;29934;54857;11326;10800;728656;169981;26548;27334;1349;158866;550643;142689;2846;139793;55613;407;2833;340554;340526;139599;84061;158835;645974;367;23229;546;139562;158830;53344;286430;9203;474343;29978;11279;101059915;60401;340527;27112;4674;6567;203430;55906;392490;54413;100129407;6872;441531;1046;347516;4303;1947;55869;4841;8473;84889;2705;347517;54821;6191;139596;1896;54466,107
-1,1,X,55532799,150239235,94706436,392509;51132;8823;23157;55998;541578;2158;55609;23439;494119;158586;55859;331;3423;54830;4168;5358;51442;9075;102723737;389895;7552;100132304;9754;27328;84460;695;56159;389874;56000;340562;644538;79649;51213;57526;728269;51186;3149;100130361;1730;3547;102723680;728656;3358;728695;57826;79921;83844;203413;80823;2986;8862;23641;7512;79979;158763;9737;11013;340554;2833;8450;5716;6658;340526;54457;91966;139599;441519;139804;54470;959;139562;57631;117154;27316;54521;4534;79589;51634;728096;27112;92129;101928917;653282;728072;6567;392490;9363;3920;100506164;827;84548;90293;54413;100529097;55511;100133053;254065;79836;347516;203522;51765;139081;6451;139818;56180;27336;142684;7626;4841;10046;347517;340578;203447;139596;63932;1896;441509;54466;51248;56001;158798;51616;100130613;4108;79868;728075;100132994;5354;11043;340533;158833;79366;1821;22;56156;56062;5303;3476;84631;51260;139628;203562;102723631;170261;340596;441525;4983;57692;1478;50945;100131755;57481;139170;1287;81887;64219;3561;10325;6170;10813;54857;79710;10800;26280;728062;169966;6173;51209;23630;26548;139324;1121;2000;645188;51438;2846;255313;645974;23229;79983;727940;10857;541466;139741;56157;286430;101059915;29978;2182;60401;84707;4674;53336;154796;51309;80712;159090;2258;728343;9823;55285;441531;1046;643311;4107;1947;286499;203523;1831;54967;340542;94121;286410;2491;84187;83550;6191;4110;644353;3598;55916;7789;340595;6594;9452;63947;9643;57187;139067;9843;203427;5456;100996648;10479;9016;55026;100528062;90316;93953;10178;24137;100507170;2332;4478;4068;51114;64663;1538;9142;9968;115201;1741;79576;139212;11326;27330;91851;27334;158866;27286;550643;1038;407;158800;7224;55796;10761;1288;84061;158835;8471;90167;292;7737;7319;11279;401612;1678;340527;139322;5063;55906;84443;29935;158983;10009;2747;340543;54885;100129407;10495;27018;6872;100129239;140886;2239;2334;441518;4303;55869;26071;8473;59353;728712;84636;55922;2705;28985;54821;441521;728049;728090;8933;10735;158521;9949;4694;139886;282808;84528;100129520;728082;90843;347454;29071;9947;6906;340547;30014;5255;680;93380;4435;159091;139285;9338;340529;65109;158584;64860;8776;494118;4675;5030;51566;56271;2892;5230;85012;57529;114928;538;63035;286451;286436;55086;29934;139221;83692;3251;169981;1349;158931;142689;27035;1641;100329135;55613;7105;2717;84295;9459;139065;367;139760;546;347487;158830;53344;51270;9203;139378;186;474343;139231;2719;3597;9131;7547;402415;203430;11254;90161;64102;728042;56849;2273;728036;64648;54440;140597;4952;5631;84889;3188;100130086;286527;347468;347475,410
1,1,X,56154308,63087733,6933425,550643;286430;139886;7789;474343;29978;11279;158584;169981;23229;158586;54466,12
1,1,X,56457791,155233731,98775940,392509;51132;8823;23157;55998;541578;2158;55609;2556;23439;494119;158586;8517;55859;331;3423;54830;4168;6901;5358;92002;474383;57595;51442;266740;9075;102723737;389895;7552;100132304;9754;27328;84460;695;56159;389874;56000;340562;644538;79649;51213;57526;100272147;728269;51186;3149;26576;474382;100130361;1730;3547;102723680;728656;3358;8273;728695;57826;79921;83844;114824;203413;80823;2986;8862;23641;7512;79979;158763;9737;55217;8270;537;3421;11013;340554;2833;8450;5716;6658;4101;54457;91966;340526;441519;4100;139804;54470;959;139562;57631;117154;2010;27316;54521;4534;79589;51634;728096;27112;92129;101928917;653282;728072;6567;392490;9363;3920;100506164;827;84548;90293;54413;100529097;55511;100133053;254065;203547;139135;79836;60343;347516;51765;203522;139081;139818;56180;6451;27336;728458;8269;142684;7626;4841;10046;347517;340578;203447;139596;63932;1896;441509;4515;54466;51248;56001;158798;51616;100130613;4108;2564;1193;79868;728075;100132994;5354;11043;340533;158833;79366;1821;22;56156;1260;56062;5303;3054;3476;84631;51260;203562;102723631;170261;340596;441525;554;4983;29944;2539;57692;1478;50945;7739;8260;100131755;57481;139170;1287;81887;64219;4204;65991;3561;6170;10813;54857;79710;10800;26280;2316;11219;728062;169966;6173;51209;23630;26548;139324;1121;55558;2000;645188;51438;1736;2846;255313;3654;1852;645974;3897;23229;79983;727940;10857;541466;139741;56157;286430;101059915;29978;2182;60401;84707;1069;4674;53336;154796;51309;80712;1485;159090;1774;2258;728343;9823;55285;441531;1046;643311;4107;1947;286499;203523;1831;54967;340542;89885;94121;286410;2491;84187;633;83550;6191;4110;644353;3598;55916;7789;340595;6594;2157;9452;50814;63947;9643;57187;139067;4104;9843;203427;139728;5456;100996648;10479;9016;55026;100528062;90316;93953;10178;24137;4105;100507170;2332;6845;4478;84968;4068;51114;64663;139599;1538;9142;246100;9968;115201;100533997;1741;79576;139212;11326;6535;393;27330;91851;27334;158866;27286;550643;1038;407;158800;7224;55796;10761;100132963;1288;84061;158835;215;8471;90167;292;7737;55879;7319;6134;1678;401612;340527;139322;5063;55906;116442;84443;29935;158983;10009;2747;2652;340543;54885;100129407;10495;27018;6872;100129239;140886;2239;2334;441518;4303;55869;26071;8473;2664;59353;5956;728712;84636;55922;2705;28985;79184;54821;441521;728049;728090;8933;10735;158521;3581;9949;4694;139886;282808;8263;84528;9130;492;100129520;728082;90843;7411;347454;29071;9947;10134;79057;6906;340547;30014;5255;30848;680;93380;4435;159091;139285;9338;8266;340529;65109;158584;64860;8776;494118;4675;5030;51566;56271;2892;5230;55559;85012;57529;114928;8277;5365;538;63035;4354;286451;286436;55086;29934;10838;139221;139735;83692;3251;10251;169981;1349;139716;158931;142689;27035;1641;100329135;55613;7105;2717;84295;9459;5973;4109;139065;367;474384;6748;139760;546;347487;158830;53344;4103;51270;9203;139378;186;474343;139231;2719;3597;9131;9248;7547;474381;402415;203430;11254;90161;64102;728042;56849;2273;728036;64648;54440;140597;4952;5631;83740;84889;3188;100130086;286527;347468;347475,500
-1,1,X,56457792,75777827,19320035,51248;139886;7789;51132;100132994;158833;340533;63947;22;5303;9843;158586;3476;51260;5255;4435;93953;340529;24137;139285;4478;4983;158584;100132304;9754;5030;57692;56159;389874;9968;81887;64219;1741;3561;100130361;286451;29934;54857;11326;728656;169981;26548;158866;550643;142689;55613;407;2833;340554;340526;139599;645974;158835;367;23229;139562;158830;53344;286430;9203;474343;29978;101059915;60401;340527;27112;4674;6567;55906;392490;54413;100129407;6872;1046;347516;4303;1947;55869;4841;8473;84889;2705;347517;54821;6191;139596;1896;54466,88
1,1,X,57415659,155233731,97818072,392509;51132;8823;23157;55998;541578;2158;55609;2556;23439;494119;158586;8517;55859;331;3423;54830;4168;6901;5358;92002;474383;57595;51442;266740;9075;102723737;389895;7552;100132304;9754;27328;84460;695;56159;389874;56000;340562;644538;79649;51213;57526;100272147;728269;51186;3149;26576;474382;100130361;1730;3547;102723680;728656;3358;8273;728695;57826;79921;83844;114824;203413;80823;2986;8862;23641;7512;79979;158763;9737;55217;8270;537;3421;11013;340554;2833;8450;5716;6658;4101;54457;91966;340526;441519;4100;139804;54470;959;139562;57631;117154;2010;27316;54521;4534;79589;51634;728096;27112;92129;101928917;653282;728072;6567;392490;9363;3920;100506164;827;84548;90293;54413;100529097;55511;100133053;254065;203547;139135;79836;60343;347516;51765;203522;139081;139818;56180;6451;27336;728458;8269;142684;7626;4841;10046;347517;340578;203447;139596;63932;1896;441509;4515;51248;56001;158798;51616;100130613;4108;2564;1193;79868;728075;100132994;5354;11043;340533;158833;79366;1821;22;56156;1260;56062;5303;3054;3476;84631;51260;203562;102723631;170261;340596;441525;554;4983;29944;2539;57692;1478;50945;7739;8260;100131755;57481;139170;1287;81887;64219;4204;65991;3561;6170;10813;54857;79710;10800;26280;2316;11219;728062;169966;6173;51209;23630;26548;139324;1121;55558;2000;645188;51438;1736;2846;255313;3654;1852;645974;3897;23229;79983;727940;10857;541466;139741;56157;286430;101059915;2182;60401;84707;1069;4674;53336;154796;51309;80712;1485;159090;1774;2258;728343;9823;55285;441531;1046;643311;4107;1947;286499;203523;1831;54967;340542;89885;94121;286410;2491;84187;633;83550;6191;4110;644353;3598;55916;7789;340595;6594;2157;9452;50814;63947;9643;57187;139067;4104;9843;203427;139728;5456;100996648;10479;9016;55026;100528062;90316;93953;10178;24137;4105;100507170;2332;6845;4478;84968;4068;51114;64663;139599;1538;9142;246100;9968;115201;100533997;1741;79576;139212;11326;6535;393;27330;91851;27334;158866;27286;1038;407;158800;7224;55796;10761;100132963;1288;84061;158835;215;8471;90167;292;7737;55879;7319;6134;1678;401612;340527;139322;5063;55906;116442;84443;29935;158983;10009;2747;2652;340543;54885;100129407;10495;27018;6872;100129239;140886;2239;2334;441518;4303;55869;26071;8473;2664;59353;5956;728712;84636;55922;2705;28985;79184;54821;441521;728049;728090;8933;10735;158521;3581;9949;4694;139886;282808;8263;84528;9130;492;100129520;728082;90843;7411;347454;29071;9947;10134;79057;6906;340547;30014;5255;30848;680;93380;4435;159091;139285;9338;8266;340529;65109;158584;64860;8776;494118;4675;5030;51566;56271;2892;5230;55559;85012;57529;114928;8277;5365;538;63035;4354;286451;286436;55086;29934;10838;139221;139735;83692;3251;10251;1349;139716;158931;142689;27035;1641;100329135;55613;7105;2717;84295;9459;5973;4109;139065;367;474384;6748;139760;546;347487;158830;53344;4103;51270;9203;139378;186;139231;2719;3597;9131;9248;7547;474381;402415;203430;11254;90161;64102;728042;56849;2273;728036;64648;54440;140597;4952;5631;83740;84889;3188;100130086;286527;347468;347475,495
1,1,X,57511767,155233731,97721964,392509;51132;8823;23157;55998;541578;2158;55609;2556;23439;494119;158586;8517;55859;331;3423;54830;4168;6901;5358;92002;474383;57595;51442;266740;9075;102723737;389895;7552;100132304;9754;27328;84460;695;56159;389874;56000;340562;644538;79649;51213;57526;100272147;728269;51186;3149;26576;474382;100130361;1730;3547;102723680;728656;3358;8273;728695;57826;79921;83844;114824;203413;80823;2986;8862;23641;7512;79979;158763;9737;55217;8270;537;3421;11013;340554;2833;8450;5716;6658;4101;54457;91966;340526;441519;4100;139804;54470;959;139562;57631;117154;2010;27316;54521;4534;79589;51634;728096;27112;92129;101928917;653282;728072;6567;392490;9363;3920;100506164;827;84548;90293;54413;100529097;55511;100133053;254065;203547;139135;79836;60343;347516;51765;203522;139081;139818;56180;6451;27336;728458;8269;142684;7626;4841;10046;347517;340578;203447;139596;63932;1896;441509;4515;51248;56001;158798;51616;100130613;4108;2564;1193;79868;728075;100132994;5354;11043;340533;158833;79366;1821;22;56156;1260;56062;5303;3054;3476;84631;51260;203562;102723631;170261;340596;441525;554;4983;29944;2539;57692;1478;50945;7739;8260;100131755;57481;139170;1287;81887;64219;4204;65991;3561;6170;10813;54857;79710;10800;26280;2316;11219;728062;169966;6173;51209;23630;26548;139324;1121;55558;2000;645188;51438;1736;2846;255313;3654;1852;645974;3897;23229;79983;727940;10857;541466;139741;56157;286430;101059915;2182;60401;84707;1069;4674;53336;154796;51309;80712;1485;159090;1774;2258;728343;9823;55285;441531;1046;643311;4107;1947;286499;203523;1831;54967;340542;89885;94121;286410;2491;84187;633;83550;6191;4110;644353;3598;55916;7789;340595;6594;2157;9452;50814;63947;9643;57187;139067;4104;9843;203427;139728;5456;100996648;10479;9016;55026;100528062;90316;93953;10178;24137;4105;100507170;2332;6845;4478;84968;4068;51114;64663;139599;1538;9142;246100;9968;115201;100533997;1741;79576;139212;11326;6535;393;27330;91851;27334;158866;27286;1038;407;158800;7224;55796;10761;100132963;1288;84061;158835;215;8471;90167;292;7737;55879;7319;6134;1678;401612;340527;139322;5063;55906;116442;84443;29935;158983;10009;2747;2652;340543;54885;100129407;10495;27018;6872;100129239;140886;2239;2334;441518;4303;55869;26071;8473;2664;59353;5956;728712;84636;55922;2705;28985;79184;54821;441521;728049;728090;8933;10735;158521;3581;9949;4694;139886;282808;8263;84528;9130;492;100129520;728082;90843;7411;347454;29071;9947;10134;79057;6906;340547;30014;5255;30848;680;93380;4435;159091;139285;9338;8266;340529;65109;158584;64860;8776;494118;4675;5030;51566;56271;2892;5230;55559;85012;57529;114928;8277;5365;538;63035;4354;286451;286436;55086;29934;10838;139221;139735;83692;3251;10251;1349;139716;158931;142689;27035;1641;100329135;55613;7105;2717;84295;9459;5973;4109;139065;367;474384;6748;139760;546;347487;158830;53344;4103;51270;9203;139378;186;139231;2719;3597;9131;9248;7547;474381;402415;203430;11254;90161;64102;728042;56849;2273;728036;64648;54440;140597;4952;5631;83740;84889;3188;100130086;286527;347468;347475,495
1,1,X,58140271,155046703,96906432,392509;51132;8823;23157;55998;541578;2158;55609;2556;23439;494119;8517;55859;331;3423;54830;4168;6901;5358;92002;474383;57595;51442;266740;9075;102723737;389895;7552;100132304;9754;27328;84460;695;56159;389874;56000;340562;644538;79649;51213;57526;100272147;728269;51186;3149;26576;474382;100130361;1730;3547;102723680;728656;3358;8273;728695;57826;79921;83844;114824;203413;80823;2986;8862;23641;7512;79979;158763;9737;55217;8270;537;3421;11013;340554;2833;8450;5716;6658;4101;54457;91966;340526;441519;4100;139804;54470;959;139562;57631;117154;2010;27316;54521;4534;79589;51634;728096;27112;92129;101928917;653282;728072;6567;392490;9363;3920;100506164;827;84548;90293;54413;100529097;55511;100133053;254065;203547;139135;79836;60343;347516;51765;203522;139081;139818;56180;6451;27336;728458;8269;142684;7626;4841;10046;347517;340578;203447;139596;63932;1896;441509;4515;51248;56001;158798;51616;100130613;4108;2564;1193;79868;728075;100132994;5354;11043;340533;158833;79366;1821;22;56156;1260;56062;5303;3054;3476;84631;51260;203562;102723631;170261;340596;441525;554;4983;29944;2539;57692;1478;50945;7739;8260;100131755;57481;139170;1287;81887;64219;4204;65991;3561;6170;10813;54857;79710;10800;26280;2316;11219;728062;169966;6173;51209;23630;26548;139324;1121;55558;2000;645188;51438;1736;2846;255313;3654;1852;645974;3897;23229;79983;727940;10857;541466;139741;56157;101059915;2182;60401;84707;1069;4674;53336;154796;51309;80712;1485;159090;1774;2258;728343;9823;55285;441531;1046;643311;4107;1947;286499;203523;1831;54967;340542;89885;94121;286410;2491;84187;633;83550;6191;4110;644353;3598;55916;340595;6594;2157;9452;50814;63947;9643;57187;139067;4104;9843;203427;139728;5456;100996648;10479;9016;55026;100528062;90316;93953;10178;24137;4105;100507170;2332;4478;84968;4068;51114;64663;139599;1538;9142;246100;9968;115201;100533997;1741;79576;139212;11326;6535;393;27330;91851;27334;158866;27286;1038;407;158800;7224;55796;10761;100132963;1288;84061;158835;215;8471;90167;292;7737;55879;7319;6134;1678;401612;340527;139322;5063;55906;116442;84443;29935;158983;10009;2747;2652;340543;54885;100129407;10495;27018;6872;100129239;140886;2239;2334;441518;4303;55869;26071;8473;2664;59353;5956;728712;84636;55922;2705;28985;79184;54821;441521;728049;728090;8933;10735;158521;9949;4694;139886;282808;8263;84528;9130;492;100129520;728082;90843;7411;347454;29071;9947;10134;79057;6906;340547;30014;5255;30848;680;93380;4435;159091;139285;9338;8266;340529;65109;64860;8776;494118;4675;5030;51566;56271;2892;5230;55559;85012;57529;114928;8277;5365;538;63035;4354;286451;286436;55086;29934;10838;139221;139735;83692;3251;10251;1349;139716;158931;142689;27035;1641;100329135;55613;7105;2717;84295;9459;5973;4109;139065;367;474384;6748;139760;546;347487;158830;53344;4103;51270;9203;139378;186;139231;2719;3597;9131;9248;7547;474381;402415;203430;11254;90161;64102;728042;56849;2273;728036;64648;54440;140597;4952;5631;83740;84889;3188;100130086;286527;347468;347475,489
1,1,X,61781074,155232907,93451833,392509;51132;8823;23157;55998;541578;2158;55609;2556;23439;494119;8517;55859;331;3423;54830;4168;6901;5358;92002;474383;57595;51442;266740;9075;102723737;389895;7552;100132304;9754;27328;84460;695;56159;389874;56000;340562;644538;79649;51213;57526;100272147;728269;51186;3149;26576;474382;100130361;1730;3547;102723680;728656;3358;8273;728695;57826;79921;83844;114824;203413;80823;2986;8862;23641;7512;79979;158763;9737;55217;8270;537;3421;11013;340554;2833;8450;5716;6658;4101;54457;91966;340526;441519;4100;139804;54470;959;139562;57631;117154;2010;27316;54521;4534;79589;51634;728096;27112;92129;101928917;653282;728072;6567;392490;9363;3920;100506164;827;84548;90293;54413;100529097;55511;100133053;254065;203547;139135;79836;60343;347516;51765;203522;139081;139818;56180;6451;27336;728458;8269;142684;7626;4841;10046;347517;340578;203447;139596;63932;1896;441509;4515;51248;56001;158798;51616;100130613;4108;2564;1193;79868;728075;100132994;5354;11043;340533;158833;79366;1821;22;56156;1260;56062;5303;3054;3476;84631;51260;203562;102723631;170261;340596;441525;554;4983;29944;2539;57692;1478;50945;7739;8260;100131755;57481;139170;1287;81887;64219;4204;65991;3561;6170;10813;54857;79710;10800;26280;2316;11219;728062;169966;6173;51209;23630;26548;139324;1121;55558;2000;645188;51438;1736;2846;255313;3654;1852;645974;3897;23229;79983;727940;10857;541466;139741;56157;101059915;2182;60401;84707;1069;4674;53336;154796;51309;80712;1485;159090;1774;2258;728343;9823;55285;441531;1046;643311;4107;1947;286499;203523;1831;54967;340542;89885;94121;286410;2491;84187;633;83550;6191;4110;644353;3598;55916;340595;6594;2157;9452;50814;63947;9643;57187;139067;4104;9843;203427;139728;5456;100996648;10479;9016;55026;100528062;90316;93953;10178;24137;4105;100507170;2332;6845;4478;84968;4068;51114;64663;139599;1538;9142;246100;9968;115201;100533997;1741;79576;139212;11326;6535;393;27330;91851;27334;158866;27286;1038;407;158800;7224;55796;10761;100132963;1288;84061;158835;215;8471;90167;292;7737;55879;7319;6134;1678;401612;340527;139322;5063;55906;116442;84443;29935;158983;10009;2747;2652;340543;54885;100129407;10495;27018;6872;100129239;140886;2239;2334;441518;4303;55869;26071;8473;2664;59353;5956;728712;84636;55922;2705;28985;79184;54821;441521;728049;728090;8933;10735;158521;3581;9949;4694;139886;282808;8263;84528;9130;492;100129520;728082;90843;7411;347454;29071;9947;10134;79057;6906;340547;30014;5255;30848;680;93380;4435;159091;139285;9338;8266;340529;65109;64860;8776;494118;4675;5030;51566;56271;2892;5230;55559;85012;57529;114928;8277;5365;538;63035;4354;286451;286436;55086;29934;10838;139221;139735;83692;3251;10251;1349;139716;158931;142689;27035;1641;100329135;55613;7105;2717;84295;9459;5973;4109;139065;367;474384;6748;139760;546;347487;158830;53344;4103;51270;9203;139378;186;139231;2719;3597;9131;9248;7547;474381;402415;203430;11254;90161;64102;728042;56849;2273;728036;64648;54440;140597;4952;5631;83740;84889;3188;100130086;286527;347468;347475,491
-1,1,X,61781848,63455936,1674088,23229;139285;142689;139886,4
1,-1,X,61931689,62146866,215177,,0
1,-1,X,61931689,62146866,215177,,0
1,-1,X,61931689,62146866,215177,,0
1,-1,X,61931689,62146866,215177,,0
1,-1,X,61931689,62146866,215177,,0
1,-1,X,61931689,62148398,216709,,0
1,-1,X,61931689,62178500,246811,,0
1,1,X,61931689,77860506,15928817,51248;51616;139886;51132;8823;100132994;158833;340533;63947;22;5303;9843;3476;51260;5255;4435;93953;340529;24137;139285;4478;4983;100132304;9754;5030;57692;56159;389874;5230;9968;64219;81887;1741;538;3561;100130361;286451;29934;54857;11326;10800;728656;26548;1349;158866;142689;55613;407;2833;340554;340526;139599;84061;158835;645974;367;23229;546;139562;158830;53344;9203;101059915;60401;340527;27112;4674;6567;55906;392490;54413;100129407;6872;441531;1046;347516;4303;1947;55869;4841;8473;84889;2705;347517;54821;6191;139596;1896,88
1,1,X,61931689,155232907,93301218,392509;51132;8823;23157;55998;541578;2158;55609;2556;23439;494119;8517;55859;331;3423;54830;4168;6901;5358;92002;474383;57595;51442;266740;9075;102723737;389895;7552;100132304;9754;27328;84460;695;56159;389874;56000;340562;644538;79649;51213;57526;100272147;728269;51186;3149;26576;474382;100130361;1730;3547;102723680;728656;3358;8273;728695;57826;79921;83844;114824;203413;80823;2986;8862;23641;7512;79979;158763;9737;55217;8270;537;3421;11013;340554;2833;8450;5716;6658;4101;54457;91966;340526;441519;4100;139804;54470;959;139562;57631;117154;2010;27316;54521;4534;79589;51634;728096;27112;92129;101928917;653282;728072;6567;392490;9363;3920;100506164;827;84548;90293;54413;100529097;55511;100133053;254065;203547;139135;79836;60343;347516;51765;203522;139081;139818;56180;6451;27336;728458;8269;142684;7626;4841;10046;347517;340578;203447;139596;63932;1896;441509;4515;51248;56001;158798;51616;100130613;4108;2564;1193;79868;728075;100132994;5354;11043;340533;158833;79366;1821;22;56156;1260;56062;5303;3054;3476;84631;51260;203562;102723631;170261;340596;441525;554;4983;29944;2539;57692;1478;50945;7739;8260;100131755;57481;139170;1287;81887;64219;4204;65991;3561;6170;10813;54857;79710;10800;26280;2316;11219;728062;169966;6173;51209;23630;26548;139324;1121;55558;2000;645188;51438;1736;2846;255313;3654;1852;645974;3897;23229;79983;727940;10857;541466;139741;56157;101059915;2182;60401;84707;1069;4674;53336;154796;51309;80712;1485;159090;1774;2258;728343;9823;55285;441531;1046;643311;4107;1947;286499;203523;1831;54967;340542;89885;94121;286410;2491;84187;633;83550;6191;4110;644353;3598;55916;340595;6594;2157;9452;50814;63947;9643;57187;139067;4104;9843;203427;139728;5456;100996648;10479;9016;55026;100528062;90316;93953;10178;24137;4105;100507170;2332;6845;4478;84968;4068;51114;64663;139599;1538;9142;246100;9968;115201;100533997;1741;79576;139212;11326;6535;393;27330;91851;27334;158866;27286;1038;407;158800;7224;55796;10761;100132963;1288;84061;158835;215;8471;90167;292;7737;55879;7319;6134;1678;401612;340527;139322;5063;55906;116442;84443;29935;158983;10009;2747;2652;340543;54885;100129407;10495;27018;6872;100129239;140886;2239;2334;441518;4303;55869;26071;8473;2664;59353;5956;728712;84636;55922;2705;28985;79184;54821;441521;728049;728090;8933;10735;158521;3581;9949;4694;139886;282808;8263;84528;9130;492;100129520;728082;90843;7411;347454;29071;9947;10134;79057;6906;340547;30014;5255;30848;680;93380;4435;159091;139285;9338;8266;340529;65109;64860;8776;494118;4675;5030;51566;56271;2892;5230;55559;85012;57529;114928;8277;5365;538;63035;4354;286451;286436;55086;29934;10838;139221;139735;83692;3251;10251;1349;139716;158931;142689;27035;1641;100329135;55613;7105;2717;84295;9459;5973;4109;139065;367;474384;6748;139760;546;347487;158830;53344;4103;51270;9203;139378;186;139231;2719;3597;9131;9248;7547;474381;402415;203430;11254;90161;64102;728042;56849;2273;728036;64648;54440;140597;4952;5631;83740;84889;3188;100130086;286527;347468;347475,491
1,1,X,61931700,155208553,93276853,392509;51132;8823;23157;55998;541578;2158;55609;2556;23439;494119;8517;55859;331;3423;54830;4168;6901;5358;92002;474383;57595;51442;266740;9075;102723737;389895;7552;100132304;9754;27328;84460;695;56159;389874;56000;340562;644538;79649;51213;57526;100272147;728269;51186;3149;26576;474382;100130361;1730;3547;102723680;728656;3358;8273;728695;57826;79921;83844;114824;203413;80823;2986;8862;23641;7512;79979;158763;9737;55217;8270;537;3421;11013;340554;2833;8450;5716;6658;4101;54457;91966;340526;441519;4100;139804;54470;959;139562;57631;117154;2010;27316;54521;4534;79589;51634;728096;27112;92129;101928917;653282;728072;6567;392490;9363;3920;100506164;827;84548;90293;54413;100529097;55511;100133053;254065;203547;139135;79836;60343;347516;51765;203522;139081;139818;56180;6451;27336;728458;8269;142684;7626;4841;10046;347517;340578;203447;139596;63932;1896;441509;4515;51248;56001;158798;51616;100130613;4108;2564;1193;79868;728075;100132994;5354;11043;340533;158833;79366;1821;22;56156;1260;56062;5303;3054;3476;84631;51260;203562;102723631;170261;340596;441525;554;4983;29944;2539;57692;1478;50945;7739;8260;100131755;57481;139170;1287;81887;64219;4204;65991;3561;6170;10813;54857;79710;10800;26280;2316;11219;728062;169966;6173;51209;23630;26548;139324;1121;55558;2000;645188;51438;1736;2846;255313;3654;1852;645974;3897;23229;79983;727940;10857;541466;139741;56157;101059915;2182;60401;84707;1069;4674;53336;154796;51309;80712;1485;159090;1774;2258;728343;9823;55285;441531;1046;643311;4107;1947;286499;203523;1831;54967;340542;89885;94121;286410;2491;84187;633;83550;6191;4110;644353;3598;55916;340595;6594;2157;9452;50814;63947;9643;57187;139067;4104;9843;203427;139728;5456;100996648;10479;9016;55026;100528062;90316;93953;10178;24137;4105;100507170;2332;6845;4478;84968;4068;51114;64663;139599;1538;9142;246100;9968;115201;100533997;1741;79576;139212;11326;6535;393;27330;91851;27334;158866;27286;1038;407;158800;7224;55796;10761;100132963;1288;84061;158835;215;8471;90167;292;7737;55879;7319;6134;1678;401612;340527;139322;5063;55906;116442;84443;29935;158983;10009;2747;2652;340543;54885;100129407;10495;27018;6872;100129239;140886;2239;2334;441518;4303;55869;26071;8473;2664;59353;5956;728712;84636;55922;2705;28985;79184;54821;441521;728049;728090;8933;10735;158521;9949;4694;139886;282808;8263;84528;9130;492;100129520;728082;90843;7411;347454;29071;9947;10134;79057;6906;340547;30014;5255;30848;680;93380;4435;159091;139285;9338;8266;340529;65109;64860;8776;494118;4675;5030;51566;56271;2892;5230;55559;85012;57529;114928;8277;5365;538;63035;4354;286451;286436;55086;29934;10838;139221;139735;83692;3251;10251;1349;139716;158931;142689;27035;1641;100329135;55613;7105;2717;84295;9459;5973;4109;139065;367;474384;6748;139760;546;347487;158830;53344;4103;51270;9203;139378;186;139231;2719;3597;9131;9248;7547;474381;402415;203430;11254;90161;64102;728042;56849;2273;728036;64648;54440;140597;4952;5631;83740;84889;3188;100130086;286527;347468;347475,490
1,-1,X,61998756,62133212,134456,,0
1,-1,X,62215643,62278218,62575,,0
-1,-1,X,63882845,63971002,88157,,0
-1,1,X,64174689,64450154,275465,55906,1
1,1,X,65665749,77427705,11761956,51248;51616;51132;8823;100132994;158833;340533;63947;22;5303;3476;51260;5255;4435;93953;340529;24137;4983;100132304;9754;5030;57692;56159;389874;5230;9968;64219;1741;538;3561;286451;100130361;29934;54857;728656;26548;1349;158866;407;2833;139599;340526;645974;84061;158835;367;546;139562;158830;53344;9203;101059915;60401;340527;27112;4674;6567;392490;54413;100129407;6872;441531;1046;347516;1947;4303;55869;4841;8473;84889;2705;347517;54821;6191;139596;1896,76
1,-1,X,65815490,65895015,79525,60401,1
1,-1,X,66516192,66630636,114444,,0
1,-1,X,66647877,66728634,80757,,0
1,-1,X,66647877,66728634,80757,,0
-1,1,X,66752153,67573743,821590,367;4983,2
1,-1,X,66911026,67265082,354056,367;4983,2
1,-1,X,67176568,67573802,397234,4983,1
1,1,X,67280452,67573802,293350,4983,1
-1,1,X,67497166,67594258,97092,4983,1
-1,1,X,67497166,68081565,584399,9754;4983;1947;286451,4
1,1,X,68701338,155233731,86532393,392509;51132;8823;23157;55998;541578;2158;55609;2556;23439;494119;8517;55859;331;3423;54830;4168;6901;5358;92002;474383;57595;51442;266740;9075;102723737;389895;7552;100132304;27328;84460;695;56159;389874;56000;340562;644538;79649;51213;57526;100272147;728269;51186;3149;26576;474382;100130361;1730;3547;102723680;728656;3358;8273;728695;57826;79921;83844;114824;203413;80823;2986;8862;23641;7512;79979;158763;9737;55217;8270;537;3421;11013;2833;8450;139599;5716;6658;4101;54457;91966;340526;441519;4100;139804;54470;959;139562;57631;117154;2010;27316;54521;4534;79589;51634;728096;27112;92129;101928917;653282;728072;6567;392490;9363;3920;100506164;827;84548;90293;54413;100529097;55511;100133053;254065;203547;139135;79836;60343;347516;51765;203522;139081;139818;56180;6451;27336;728458;8269;142684;7626;4841;10046;347517;340578;203447;139596;63932;1896;441509;4515;51248;56001;158798;51616;100130613;4108;2564;1193;79868;728075;100132994;5354;11043;340533;158833;79366;1821;22;56156;1260;56062;5303;3054;3476;84631;51260;203562;102723631;170261;340596;441525;554;29944;2539;57692;1478;50945;7739;8260;100131755;57481;139170;1287;4204;65991;3561;6170;10813;54857;79710;10800;26280;2316;11219;728062;169966;6173;51209;23630;26548;139324;1121;55558;2000;645188;51438;1736;2846;255313;3654;1852;645974;3897;79983;727940;10857;541466;139741;56157;101059915;2182;84707;1069;4674;53336;154796;51309;80712;1485;159090;1774;2258;728343;9823;55285;441531;1046;643311;4107;286499;203523;1831;54967;340542;89885;94121;286410;2491;84187;633;83550;6191;4110;644353;3598;55916;340595;6594;2157;9452;50814;63947;9643;57187;139067;4104;203427;139728;5456;100996648;10479;9016;55026;100528062;90316;93953;10178;24137;4105;100507170;2332;6845;84968;4068;51114;64663;1538;9142;246100;9968;115201;100533997;1741;79576;139212;6535;393;27330;91851;27334;158866;27286;1038;407;158800;7224;10761;55796;100132963;1288;84061;158835;215;8471;90167;292;7737;55879;7319;6134;1678;401612;340527;139322;5063;116442;84443;29935;158983;10009;2747;2652;340543;54885;100129407;10495;27018;6872;100129239;140886;2239;2334;441518;4303;55869;26071;8473;2664;59353;5956;728712;84636;55922;2705;28985;79184;54821;441521;728049;728090;8933;10735;158521;3581;9949;4694;84528;282808;8263;9130;492;100129520;728082;90843;7411;347454;29071;9947;10134;79057;6906;340547;30014;5255;30848;680;93380;4435;159091;9338;8266;340529;65109;64860;8776;494118;4675;5030;51566;56271;2892;5230;55559;85012;57529;114928;8277;5365;538;63035;4354;286436;55086;29934;10838;139221;139735;83692;3251;10251;1349;139716;158931;27035;1641;100329135;7105;2717;84295;9459;5973;4109;139065;474384;6748;139760;546;347487;158830;53344;4103;51270;9203;139378;186;139231;2719;3597;9131;9248;7547;474381;402415;203430;11254;90161;64102;728042;56849;2273;728036;64648;54440;140597;4952;5631;83740;84889;3188;100130086;286527;347468;347475,473
-1,-1,X,69732435,69756363,23928,56159,1
1,-1,X,71047501,71094447,46946,,0
1,-1,X,72224362,72298286,73924,645974;340529,2
1,-1,X,72224362,72298286,73924,645974;340529,2
1,1,X,72224362,139262228,67037866,392509;51132;8823;23157;55998;2158;55609;23439;55859;331;54830;4168;5358;51442;9075;102723737;389895;7552;27328;695;84460;389874;56000;340562;51213;644538;79649;57526;51186;1730;3547;102723680;3358;57826;79921;83844;203413;80823;2986;8862;79979;7512;158763;9737;11013;139599;8450;5716;139804;54470;54457;959;441519;57631;117154;27316;54521;79589;51634;653282;728072;92129;728096;6567;9363;3920;827;90293;100529097;55511;254065;79836;203522;51765;6451;139818;56180;27336;142684;7626;340578;203447;139596;63932;441509;56001;158798;51616;100130613;79868;728075;11043;5354;79366;340533;1821;56156;22;56062;51260;203562;102723631;170261;340596;57692;1478;50945;100131755;57481;139170;1287;6170;10813;79710;10800;26280;728062;169966;6173;51209;23630;139324;1121;2000;2846;255313;645974;79983;727940;10857;541466;139741;56157;2182;84707;4674;53336;154796;51309;80712;159090;2258;728343;9823;55285;441531;1046;643311;286499;203523;1831;54967;340542;94121;286410;2491;84187;83550;644353;55916;3598;340595;6594;9452;9643;57187;203427;5456;100996648;10479;9016;55026;100528062;90316;100507170;10178;4068;51114;1538;115201;79576;139212;27330;91851;27334;158866;27286;158800;1288;10761;84061;7224;55796;8471;90167;292;7737;7319;401612;1678;139322;5063;84443;29935;158983;10009;2747;340543;54885;10495;27018;140886;2239;441518;26071;59353;84636;55922;28985;441521;728049;728090;8933;10735;9949;4694;84528;282808;100129520;728082;90843;347454;29071;6906;340547;680;93380;340529;9338;159091;65109;64860;4675;51566;56271;2892;5230;85012;57529;114928;538;63035;286436;55086;139221;3251;1349;158931;27035;1641;100329135;7105;2717;84295;9459;139760;546;347487;51270;53344;139378;139231;186;9131;3597;2719;7547;402415;203430;11254;90161;64102;728042;56849;2273;728036;54440;140597;5631;4952;3188;286527;347468;347475,294
1,1,X,73111197,74781209,1670012,340533;158866;139596;22;6567;51132;389874,7
-1,1,X,73729951,155251871,81521920,392509;51132;8823;23157;55998;541578;2158;55609;2556;23439;494119;8517;55859;331;3423;54830;4168;6901;5358;92002;474383;57595;51442;266740;9075;102723737;389895;7552;27328;84460;695;56000;340562;644538;79649;51213;57526;100272147;728269;51186;3149;26576;474382;1730;3547;102723680;3358;8273;728695;57826;79921;83844;114824;203413;80823;2986;8862;23641;7512;79979;158763;9737;55217;8270;537;3421;11013;139599;8450;6658;5716;4101;54457;91966;139804;441519;4100;54470;959;57631;117154;2010;27316;54521;4534;79589;51634;728096;101928917;92129;653282;728072;6567;9363;3920;100506164;827;84548;90293;100529097;55511;100133053;254065;203547;139135;79836;60343;139081;51765;203522;6451;139818;56180;27336;728458;8269;142684;7626;10046;340578;203447;139596;63932;441509;4515;56001;158798;51616;100130613;4108;2564;1193;79868;728075;11043;5354;56156;340533;79366;1821;1260;22;56062;3054;84631;51260;203562;102723631;170261;340596;441525;554;29944;2539;57692;1478;50945;7739;8260;100131755;57481;139170;1287;4204;65991;6170;10813;79710;10800;26280;2316;11219;728062;169966;6173;51209;23630;139324;1121;55558;2000;645188;51438;1736;2846;255313;3654;1852;3897;79983;727940;10857;541466;139741;56157;2182;84707;1069;53336;154796;51309;80712;1485;159090;1774;2258;728343;9823;55285;441531;643311;4107;286499;203523;1831;54967;340542;89885;94121;286410;2491;84187;633;83550;4110;644353;3598;55916;340595;6594;2157;9452;50814;9643;57187;139067;4104;203427;139728;5456;100996648;10479;9016;55026;100528062;90316;10178;4105;100507170;2332;6845;84968;4068;51114;64663;1538;9142;246100;115201;100533997;79576;139212;6535;393;27330;91851;27334;158866;27286;1038;158800;7224;10761;55796;100132963;1288;84061;215;8471;90167;292;7737;55879;7319;6134;1678;401612;139322;5063;116442;84443;29935;158983;10009;2747;2652;340543;54885;10495;27018;100129239;140886;2239;2334;441518;26071;2664;59353;5956;728712;84636;55922;28985;79184;441521;728049;728090;8933;10735;158521;3581;9949;4694;84528;282808;8263;9130;492;100129520;728082;90843;7411;347454;29071;9947;10134;79057;6906;340547;30014;30848;680;93380;159091;9338;8266;65109;64860;8776;494118;4675;51566;56271;2892;5230;55559;85012;57529;114928;8277;5365;538;63035;4354;286436;55086;10838;139221;139735;83692;3251;10251;1349;139716;158931;27035;1641;100329135;7105;2717;84295;9459;5973;4109;139065;474384;6748;139760;546;347487;51270;4103;139378;186;139231;2719;3597;9131;9248;7547;474381;402415;203430;11254;90161;64102;728042;56849;2273;728036;64648;54440;140597;4952;5631;83740;3188;100130086;286527;347468;347475,421
-1,1,X,73904450,155233731,81329281,392509;8823;23157;55998;541578;2158;55609;2556;23439;494119;8517;55859;331;3423;54830;4168;6901;5358;92002;474383;57595;51442;266740;9075;102723737;389895;7552;27328;84460;695;56000;340562;644538;79649;51213;57526;100272147;728269;51186;3149;26576;474382;1730;3547;102723680;3358;8273;728695;57826;79921;83844;114824;203413;80823;2986;8862;23641;7512;79979;158763;9737;55217;8270;537;3421;11013;139599;8450;6658;5716;4101;54457;91966;139804;441519;4100;54470;959;57631;117154;2010;27316;54521;4534;79589;51634;728096;101928917;92129;653282;728072;9363;3920;100506164;827;84548;90293;100529097;55511;100133053;254065;203547;139135;79836;60343;139081;51765;203522;6451;139818;56180;27336;728458;8269;142684;7626;10046;340578;203447;139596;63932;441509;4515;56001;158798;51616;100130613;4108;2564;1193;79868;728075;11043;5354;56156;340533;79366;1821;1260;22;56062;3054;84631;51260;203562;102723631;170261;340596;441525;554;29944;2539;57692;1478;50945;7739;8260;100131755;57481;139170;1287;4204;65991;6170;10813;79710;10800;26280;2316;11219;728062;169966;6173;51209;23630;139324;1121;55558;2000;645188;51438;1736;2846;255313;3654;1852;3897;79983;727940;10857;541466;139741;56157;2182;84707;1069;53336;154796;51309;80712;1485;159090;1774;2258;728343;9823;55285;441531;643311;4107;286499;203523;1831;54967;340542;89885;94121;286410;2491;84187;633;83550;4110;644353;3598;55916;340595;6594;2157;9452;50814;9643;57187;139067;4104;203427;139728;5456;100996648;10479;9016;55026;100528062;90316;10178;4105;100507170;2332;6845;84968;4068;51114;64663;1538;9142;246100;115201;100533997;79576;139212;6535;393;27330;91851;27334;158866;27286;1038;158800;7224;10761;55796;100132963;1288;84061;215;8471;90167;292;7737;55879;7319;6134;1678;401612;139322;5063;116442;84443;29935;158983;10009;2747;2652;340543;54885;10495;27018;100129239;140886;2239;2334;441518;26071;2664;59353;5956;728712;84636;55922;28985;79184;441521;728049;728090;8933;10735;158521;3581;9949;4694;84528;282808;8263;9130;492;100129520;728082;90843;7411;347454;29071;9947;10134;79057;6906;340547;30014;30848;680;93380;159091;9338;8266;65109;64860;8776;494118;4675;51566;56271;2892;5230;55559;85012;57529;114928;8277;5365;538;63035;4354;286436;55086;10838;139221;139735;83692;3251;10251;1349;139716;158931;27035;1641;100329135;7105;2717;84295;9459;5973;4109;139065;474384;6748;139760;546;347487;51270;4103;139378;186;139231;2719;3597;9131;9248;7547;474381;402415;203430;11254;90161;64102;728042;56849;2273;728036;64648;54440;140597;4952;5631;83740;3188;100130086;286527;347468;347475,419
-1,1,X,74306252,155251871,80945619,392509;8823;23157;55998;541578;2158;55609;2556;23439;494119;8517;55859;331;3423;54830;4168;6901;5358;92002;474383;57595;51442;266740;9075;102723737;389895;7552;27328;84460;695;56000;340562;644538;79649;51213;57526;100272147;728269;51186;3149;26576;474382;1730;3547;102723680;3358;8273;728695;57826;79921;83844;114824;203413;80823;2986;8862;23641;7512;79979;158763;9737;55217;8270;537;3421;11013;139599;8450;6658;5716;4101;54457;91966;139804;441519;4100;54470;959;57631;117154;2010;27316;54521;4534;79589;51634;728096;101928917;92129;653282;728072;9363;3920;100506164;827;84548;90293;100529097;55511;100133053;254065;203547;139135;79836;60343;139081;51765;203522;6451;139818;56180;27336;728458;8269;142684;7626;10046;340578;203447;139596;63932;441509;4515;56001;158798;51616;100130613;4108;2564;1193;79868;728075;11043;5354;56156;79366;1821;1260;22;56062;3054;84631;51260;203562;102723631;170261;340596;441525;554;29944;2539;57692;1478;50945;7739;8260;100131755;57481;139170;1287;4204;65991;6170;10813;79710;10800;26280;2316;11219;728062;169966;6173;51209;23630;139324;1121;55558;2000;645188;51438;1736;2846;255313;3654;1852;3897;79983;727940;10857;541466;139741;56157;2182;84707;1069;53336;154796;51309;80712;1485;159090;1774;2258;728343;9823;55285;441531;643311;4107;286499;203523;1831;54967;340542;89885;94121;286410;2491;84187;633;83550;4110;644353;3598;55916;340595;6594;2157;9452;50814;9643;57187;139067;4104;203427;139728;5456;100996648;10479;9016;55026;100528062;90316;10178;4105;100507170;2332;6845;84968;4068;51114;64663;1538;9142;246100;115201;100533997;79576;139212;6535;393;27330;91851;27334;158866;27286;1038;158800;7224;10761;55796;100132963;1288;84061;215;8471;90167;292;7737;55879;7319;6134;1678;401612;139322;5063;116442;84443;29935;158983;10009;2747;2652;340543;54885;10495;27018;100129239;140886;2239;2334;441518;26071;2664;59353;5956;728712;84636;55922;28985;79184;441521;728049;728090;8933;10735;158521;3581;9949;4694;84528;282808;8263;9130;492;100129520;728082;90843;7411;347454;29071;9947;10134;79057;6906;340547;30014;30848;680;93380;159091;9338;8266;65109;64860;8776;494118;4675;51566;56271;2892;5230;55559;85012;57529;114928;8277;5365;538;63035;4354;286436;55086;10838;139221;139735;83692;3251;10251;1349;139716;158931;27035;1641;100329135;7105;2717;84295;9459;5973;4109;139065;474384;6748;139760;546;347487;51270;4103;139378;186;139231;2719;3597;9131;9248;7547;474381;402415;203430;11254;90161;64102;728042;56849;2273;728036;64648;54440;140597;4952;5631;83740;3188;100130086;286527;347468;347475,418
1,-1,X,74360310,74516106,155796,139596;22,2
-1,1,X,74560735,116609286,42048551,644353;392509;55916;3598;8823;340595;9452;55998;9643;5456;55859;100996648;100528062;54830;90316;5358;9075;7552;27328;695;1538;84460;56000;340562;51213;57526;115201;51186;1730;139212;3358;79921;27330;203413;80823;2986;27334;91851;158866;27286;79979;9737;1288;11013;139599;84061;7224;5716;139804;54470;54457;8471;57631;117154;401612;1678;79589;139322;92129;5063;84443;29935;158983;827;340543;54885;27018;100529097;140886;254065;6451;142684;59353;84636;203447;441509;56001;9949;51616;282808;79868;11043;5354;79366;1821;56156;90843;56062;6906;340547;51260;203562;340596;9338;64860;4675;57692;51566;1478;56271;50945;5230;100131755;85012;1287;57529;114928;538;286436;55086;139221;79710;10800;26280;169966;6173;51209;23630;139324;1349;1121;158931;27035;2846;1641;7105;100329135;2717;546;79983;56157;139231;186;2182;402415;84707;53336;203430;154796;51309;11254;64102;80712;728343;56849;9823;55285;441531;286499;140597;5631;1831;3188;340542;94121;2491;84187;286527,158
-1,1,X,74787886,155233731,80445845,392509;8823;23157;55998;541578;2158;55609;2556;23439;494119;8517;55859;331;3423;54830;4168;6901;5358;92002;474383;57595;51442;266740;9075;102723737;389895;7552;27328;84460;695;56000;340562;644538;79649;51213;57526;100272147;728269;51186;3149;26576;474382;1730;3547;102723680;3358;8273;728695;57826;79921;83844;114824;203413;80823;2986;8862;23641;7512;79979;158763;9737;55217;8270;537;3421;11013;139599;8450;6658;5716;4101;54457;91966;139804;441519;4100;54470;959;57631;117154;2010;27316;54521;4534;79589;51634;728096;101928917;92129;653282;728072;9363;3920;100506164;827;84548;90293;100529097;55511;100133053;254065;203547;139135;79836;60343;139081;51765;203522;6451;139818;56180;27336;728458;8269;142684;7626;10046;340578;203447;63932;441509;4515;56001;158798;51616;100130613;4108;2564;1193;79868;728075;11043;5354;56156;79366;1821;1260;56062;3054;84631;51260;203562;102723631;170261;340596;441525;554;29944;2539;57692;1478;50945;7739;8260;100131755;57481;139170;1287;4204;65991;6170;10813;79710;10800;26280;2316;11219;728062;169966;6173;51209;23630;139324;1121;55558;2000;645188;51438;1736;2846;255313;3654;1852;3897;79983;727940;10857;541466;139741;56157;2182;84707;1069;53336;154796;51309;80712;1485;159090;1774;2258;728343;9823;55285;441531;643311;4107;286499;203523;1831;54967;340542;89885;94121;286410;2491;84187;633;83550;4110;644353;3598;55916;340595;6594;2157;9452;50814;9643;57187;139067;4104;203427;139728;5456;100996648;10479;9016;55026;100528062;90316;10178;4105;100507170;2332;6845;84968;4068;51114;64663;1538;9142;246100;115201;100533997;79576;139212;6535;393;27330;91851;27334;27286;1038;158800;7224;10761;55796;100132963;1288;84061;215;8471;90167;292;7737;55879;7319;6134;1678;401612;139322;5063;116442;84443;29935;158983;10009;2747;2652;340543;54885;10495;27018;100129239;140886;2239;2334;441518;26071;2664;59353;5956;728712;84636;55922;28985;79184;441521;728049;728090;8933;10735;158521;3581;9949;4694;84528;282808;8263;9130;492;100129520;728082;90843;7411;347454;29071;9947;10134;79057;6906;340547;30014;30848;680;93380;159091;9338;8266;65109;64860;8776;494118;4675;51566;56271;2892;5230;55559;85012;57529;114928;8277;5365;538;63035;4354;286436;55086;10838;139221;139735;83692;3251;10251;1349;139716;158931;27035;1641;100329135;7105;2717;84295;9459;5973;4109;139065;474384;6748;139760;546;347487;51270;4103;139378;186;139231;2719;3597;9131;9248;7547;474381;402415;203430;11254;90161;64102;728042;56849;2273;728036;64648;54440;140597;4952;5631;83740;3188;100130086;286527;347468;347475,415
1,-1,X,75251957,75360247,108290,,0
-1,1,X,75777833,155233731,79455898,392509;8823;23157;55998;541578;2158;55609;2556;23439;494119;8517;55859;331;3423;54830;4168;6901;5358;92002;474383;57595;51442;266740;9075;102723737;389895;7552;27328;84460;695;56000;340562;644538;79649;51213;57526;100272147;728269;51186;3149;26576;474382;1730;3547;102723680;3358;8273;728695;57826;79921;83844;114824;203413;80823;2986;8862;23641;7512;79979;158763;9737;55217;8270;537;3421;11013;8450;6658;5716;4101;54457;91966;139804;441519;4100;54470;959;57631;117154;2010;27316;54521;4534;79589;51634;728096;101928917;92129;653282;728072;9363;3920;100506164;827;84548;90293;100529097;55511;100133053;254065;203547;139135;79836;60343;139081;51765;203522;6451;139818;56180;27336;728458;8269;142684;7626;10046;340578;203447;63932;441509;4515;56001;158798;51616;100130613;4108;2564;1193;79868;728075;11043;5354;56156;79366;1821;1260;56062;3054;84631;203562;102723631;170261;340596;441525;554;29944;2539;1478;50945;7739;8260;100131755;57481;139170;1287;4204;65991;6170;10813;79710;10800;26280;2316;11219;728062;169966;6173;51209;23630;139324;1121;55558;2000;645188;51438;1736;2846;255313;3654;1852;3897;79983;727940;10857;541466;139741;56157;2182;84707;1069;53336;154796;51309;80712;1485;159090;1774;2258;728343;9823;55285;441531;643311;4107;286499;203523;1831;54967;340542;89885;94121;286410;2491;84187;633;83550;4110;644353;3598;55916;340595;6594;2157;9452;50814;9643;57187;139067;4104;203427;139728;5456;100996648;10479;9016;55026;100528062;90316;10178;4105;100507170;2332;6845;84968;4068;51114;64663;1538;9142;246100;115201;100533997;79576;139212;6535;393;27330;91851;27334;27286;1038;158800;7224;10761;55796;100132963;1288;84061;215;8471;90167;292;7737;55879;7319;6134;1678;401612;139322;5063;116442;84443;29935;158983;10009;2747;2652;340543;54885;10495;27018;100129239;140886;2239;2334;441518;26071;2664;59353;5956;728712;84636;55922;28985;79184;441521;728049;728090;8933;10735;158521;3581;9949;4694;84528;282808;8263;9130;492;100129520;728082;90843;7411;347454;29071;9947;10134;79057;6906;340547;30014;30848;680;93380;159091;9338;8266;65109;64860;8776;494118;4675;51566;56271;2892;5230;55559;85012;57529;114928;8277;5365;538;63035;4354;286436;55086;10838;139221;139735;83692;3251;10251;1349;139716;158931;27035;1641;100329135;7105;2717;84295;9459;5973;4109;139065;474384;6748;139760;546;347487;51270;4103;139378;186;139231;2719;3597;9131;9248;7547;474381;402415;203430;11254;90161;64102;728042;56849;2273;728036;64648;54440;140597;4952;5631;83740;3188;100130086;286527;347468;347475,412
-1,1,X,75824420,155251871,79427451,392509;8823;23157;55998;541578;2158;55609;2556;23439;494119;8517;55859;331;3423;54830;4168;6901;5358;92002;474383;57595;51442;266740;9075;102723737;389895;7552;27328;84460;695;56000;340562;644538;79649;51213;57526;100272147;728269;51186;3149;26576;474382;1730;3547;102723680;3358;8273;728695;57826;79921;83844;114824;203413;80823;2986;8862;23641;7512;79979;158763;9737;55217;8270;537;3421;11013;8450;6658;5716;4101;54457;91966;139804;441519;4100;54470;959;57631;117154;2010;27316;54521;4534;79589;51634;728096;101928917;92129;653282;728072;9363;3920;100506164;827;84548;90293;100529097;55511;100133053;254065;203547;139135;79836;60343;139081;51765;203522;6451;139818;56180;27336;728458;8269;142684;7626;10046;340578;203447;63932;441509;4515;56001;158798;51616;100130613;4108;2564;1193;79868;728075;11043;5354;56156;79366;1821;1260;56062;3054;84631;203562;102723631;170261;340596;441525;554;29944;2539;1478;50945;7739;8260;100131755;57481;139170;1287;4204;65991;6170;10813;79710;10800;26280;2316;11219;728062;169966;6173;51209;23630;139324;1121;55558;2000;645188;51438;1736;2846;255313;3654;1852;3897;79983;727940;10857;541466;139741;56157;2182;84707;1069;53336;154796;51309;80712;1485;159090;1774;2258;728343;9823;55285;441531;643311;4107;286499;203523;1831;54967;340542;89885;94121;286410;2491;84187;633;83550;4110;644353;3598;55916;340595;6594;2157;9452;50814;9643;57187;139067;4104;203427;139728;5456;100996648;10479;9016;55026;100528062;90316;10178;4105;100507170;2332;6845;84968;4068;51114;64663;1538;9142;246100;115201;100533997;79576;139212;6535;393;27330;91851;27334;27286;1038;158800;7224;10761;55796;100132963;1288;84061;215;8471;90167;292;7737;55879;7319;6134;1678;401612;139322;5063;116442;84443;29935;158983;10009;2747;2652;340543;54885;10495;27018;100129239;140886;2239;2334;441518;26071;2664;59353;5956;728712;84636;55922;28985;79184;441521;728049;728090;8933;10735;158521;3581;9949;4694;84528;282808;8263;9130;492;100129520;728082;90843;7411;347454;29071;9947;10134;79057;6906;340547;30014;30848;680;93380;159091;9338;8266;65109;64860;8776;494118;4675;51566;56271;2892;5230;55559;85012;57529;114928;8277;5365;538;63035;4354;286436;55086;10838;139221;139735;83692;3251;10251;1349;139716;158931;27035;1641;100329135;7105;2717;84295;9459;5973;4109;139065;474384;6748;139760;546;347487;51270;4103;139378;186;139231;2719;3597;9131;9248;7547;474381;402415;203430;11254;90161;64102;728042;56849;2273;728036;64648;54440;140597;4952;5631;83740;3188;100130086;286527;347468;347475,412
-1,1,X,76634813,155242832,78608019,392509;8823;23157;55998;541578;2158;55609;2556;23439;494119;8517;55859;331;3423;54830;4168;6901;5358;92002;474383;57595;51442;266740;9075;102723737;389895;7552;27328;84460;695;56000;340562;644538;79649;51213;57526;100272147;728269;51186;3149;26576;474382;1730;3547;102723680;3358;8273;728695;57826;79921;83844;114824;203413;80823;2986;8862;23641;7512;79979;158763;9737;55217;8270;537;3421;11013;8450;6658;5716;4101;54457;91966;139804;441519;4100;54470;959;57631;117154;2010;27316;54521;4534;79589;51634;728096;101928917;92129;653282;728072;9363;3920;100506164;827;84548;90293;100529097;55511;100133053;254065;203547;139135;79836;60343;139081;51765;203522;6451;139818;56180;27336;728458;8269;142684;7626;10046;340578;203447;63932;441509;4515;56001;158798;51616;100130613;4108;2564;1193;79868;728075;11043;5354;56156;79366;1821;1260;56062;3054;84631;203562;102723631;170261;340596;441525;554;29944;2539;1478;50945;7739;8260;100131755;57481;139170;1287;4204;65991;6170;10813;79710;10800;26280;2316;11219;728062;169966;6173;51209;23630;139324;1121;55558;2000;645188;51438;1736;2846;255313;3654;1852;3897;79983;727940;10857;541466;139741;56157;2182;84707;1069;53336;154796;51309;80712;1485;159090;1774;2258;728343;9823;55285;441531;643311;4107;286499;203523;1831;54967;340542;89885;94121;286410;2491;84187;633;83550;4110;644353;3598;55916;340595;6594;2157;9452;50814;9643;57187;139067;4104;203427;139728;5456;100996648;10479;9016;55026;100528062;90316;10178;4105;100507170;2332;6845;84968;4068;51114;64663;1538;9142;246100;115201;100533997;79576;139212;6535;393;27330;91851;27334;27286;1038;158800;7224;10761;55796;100132963;1288;84061;215;8471;90167;292;7737;55879;7319;6134;1678;401612;139322;5063;116442;84443;29935;158983;10009;2747;2652;340543;54885;10495;27018;100129239;140886;2239;2334;441518;26071;2664;59353;5956;728712;84636;55922;28985;79184;441521;728049;728090;8933;10735;158521;3581;9949;4694;84528;282808;8263;9130;492;100129520;728082;90843;7411;347454;29071;9947;10134;79057;6906;340547;30014;30848;680;93380;159091;9338;8266;65109;64860;8776;494118;4675;51566;56271;2892;5230;55559;85012;57529;114928;8277;5365;538;63035;4354;286436;55086;10838;139221;139735;83692;3251;10251;1349;139716;158931;27035;1641;100329135;7105;2717;84295;9459;5973;4109;139065;474384;6748;139760;546;347487;51270;4103;139378;186;139231;2719;3597;9131;9248;7547;474381;402415;203430;11254;90161;64102;728042;56849;2273;728036;64648;54440;140597;4952;5631;83740;3188;100130086;286527;347468;347475,412
1,1,X,77054444,77143054,88610,84061,1
-1,1,X,77250619,77294719,44100,538,1
-1,1,X,77442685,155233731,77791046,392509;23157;55998;541578;2158;55609;2556;23439;494119;8517;55859;331;3423;54830;4168;6901;5358;92002;474383;57595;51442;266740;9075;102723737;389895;7552;27328;84460;695;56000;340562;644538;79649;51213;57526;100272147;728269;51186;3149;26576;474382;1730;3547;102723680;3358;8273;728695;57826;79921;83844;114824;203413;80823;2986;8862;23641;7512;79979;158763;9737;55217;8270;537;3421;11013;8450;6658;5716;4101;54457;91966;139804;441519;4100;54470;959;57631;117154;2010;27316;54521;4534;79589;51634;728096;101928917;92129;653282;728072;9363;3920;100506164;827;84548;90293;100529097;55511;100133053;254065;203547;139135;79836;60343;139081;51765;203522;6451;139818;56180;27336;728458;8269;142684;7626;10046;340578;203447;63932;441509;4515;56001;4108;100130613;158798;2564;1193;79868;728075;11043;5354;56156;79366;1821;1260;56062;3054;84631;203562;102723631;170261;340596;441525;554;29944;2539;1478;50945;7739;8260;100131755;57481;139170;1287;4204;65991;6170;10813;79710;10800;26280;2316;11219;728062;169966;6173;51209;23630;139324;1121;55558;2000;645188;51438;1736;2846;255313;3654;1852;3897;79983;727940;10857;541466;139741;56157;2182;84707;1069;53336;154796;51309;80712;1485;159090;1774;2258;728343;9823;55285;643311;4107;286499;203523;1831;54967;340542;89885;94121;286410;2491;84187;633;83550;4110;644353;3598;55916;340595;6594;2157;9452;50814;9643;57187;139067;4104;203427;139728;5456;100996648;10479;9016;55026;100528062;90316;10178;4105;100507170;2332;6845;84968;4068;51114;64663;1538;9142;246100;115201;100533997;79576;139212;6535;393;27330;91851;27334;27286;1038;158800;7224;55796;10761;100132963;1288;215;8471;90167;292;7737;55879;7319;6134;1678;401612;139322;5063;116442;84443;29935;158983;10009;2747;2652;340543;54885;10495;27018;100129239;140886;2239;2334;441518;26071;2664;59353;5956;728712;84636;55922;28985;79184;441521;728049;728090;8933;10735;158521;3581;9949;4694;84528;282808;8263;9130;492;100129520;728082;90843;7411;347454;29071;9947;10134;79057;6906;340547;30014;30848;680;93380;159091;9338;8266;65109;64860;8776;494118;4675;51566;56271;2892;55559;85012;57529;114928;8277;5365;63035;4354;286436;55086;10838;139221;139735;83692;3251;10251;139716;158931;27035;1641;100329135;7105;2717;84295;9459;5973;4109;139065;474384;6748;139760;347487;51270;4103;139378;186;139231;2719;3597;9131;9248;7547;474381;402415;203430;11254;90161;64102;728042;56849;2273;728036;64648;54440;140597;4952;5631;83740;3188;100130086;286527;347468;347475,404
-1,1,X,77450503,89938535,12488032,1121;27330;50945;2846;1538;340562;79366;9452;27334;254065;56062;79983;6451;5456;117154;139324;10800;84636;90316;139322;169966;53336;203430;7552,24
-1,1,X,77860506,155246225,77385719,392509;23157;55998;541578;2158;55609;2556;23439;494119;8517;55859;331;3423;54830;4168;6901;5358;92002;474383;57595;51442;266740;9075;102723737;389895;7552;27328;84460;695;56000;340562;644538;79649;51213;57526;100272147;728269;51186;3149;26576;474382;1730;3547;102723680;3358;8273;728695;57826;79921;83844;114824;203413;80823;2986;8862;23641;7512;79979;158763;9737;55217;8270;537;3421;11013;8450;6658;5716;4101;54457;91966;139804;441519;4100;54470;959;57631;117154;2010;27316;54521;4534;79589;51634;728096;101928917;92129;653282;728072;9363;3920;100506164;827;84548;90293;100529097;55511;100133053;254065;203547;139135;79836;60343;139081;51765;203522;6451;139818;56180;27336;728458;8269;142684;7626;10046;340578;203447;63932;441509;4515;56001;4108;100130613;158798;2564;1193;79868;728075;11043;5354;56156;79366;1821;1260;56062;3054;84631;203562;102723631;170261;340596;441525;554;29944;2539;1478;50945;7739;8260;100131755;57481;139170;1287;4204;65991;6170;10813;79710;26280;2316;11219;728062;169966;6173;51209;23630;139324;1121;55558;2000;645188;51438;1736;2846;255313;3654;1852;3897;79983;727940;10857;541466;139741;56157;2182;84707;1069;53336;154796;51309;80712;1485;159090;1774;2258;728343;9823;55285;643311;4107;286499;203523;1831;54967;340542;89885;94121;286410;2491;84187;633;83550;4110;644353;3598;55916;340595;6594;2157;9452;50814;9643;57187;139067;4104;203427;139728;5456;100996648;10479;9016;55026;100528062;90316;10178;4105;100507170;2332;6845;84968;4068;51114;64663;1538;9142;246100;115201;100533997;79576;139212;6535;393;27330;91851;27334;27286;1038;158800;7224;55796;10761;100132963;1288;215;8471;90167;292;7737;55879;7319;6134;1678;401612;139322;5063;116442;84443;29935;158983;10009;2747;2652;340543;54885;10495;27018;100129239;140886;2239;2334;441518;26071;2664;59353;5956;728712;84636;55922;28985;79184;441521;728049;728090;8933;10735;158521;3581;9949;4694;84528;282808;8263;9130;492;100129520;728082;90843;7411;347454;29071;9947;10134;79057;6906;340547;30014;30848;680;93380;159091;9338;8266;65109;64860;8776;494118;4675;51566;56271;2892;55559;85012;57529;114928;8277;5365;63035;4354;286436;55086;10838;139221;139735;83692;3251;10251;139716;158931;27035;1641;100329135;7105;2717;84295;9459;5973;4109;139065;474384;6748;139760;347487;51270;4103;139378;186;139231;2719;3597;9131;9248;7547;474381;402415;203430;11254;90161;64102;728042;56849;2273;728036;64648;54440;140597;4952;5631;83740;3188;100130086;286527;347468;347475,403
-1,1,X,78230501,155233731,77003230,392509;23157;55998;541578;2158;55609;2556;23439;494119;8517;55859;331;3423;54830;4168;6901;5358;92002;474383;57595;51442;266740;9075;102723737;389895;7552;27328;84460;695;56000;340562;644538;79649;51213;57526;100272147;728269;51186;3149;26576;474382;1730;3547;102723680;3358;8273;728695;57826;79921;83844;114824;203413;80823;2986;8862;23641;7512;79979;158763;9737;55217;8270;537;3421;11013;8450;6658;5716;4101;54457;91966;139804;441519;4100;54470;959;57631;117154;2010;27316;54521;4534;79589;51634;728096;101928917;92129;653282;728072;9363;3920;100506164;827;84548;90293;100529097;55511;100133053;254065;203547;139135;79836;60343;139081;51765;203522;6451;139818;56180;27336;728458;8269;142684;7626;10046;340578;203447;63932;441509;4515;56001;4108;100130613;158798;2564;1193;79868;728075;11043;5354;56156;79366;1821;1260;56062;3054;84631;203562;102723631;170261;340596;441525;554;29944;2539;1478;50945;7739;8260;100131755;57481;139170;1287;4204;65991;6170;10813;79710;26280;2316;11219;728062;169966;6173;51209;23630;139324;1121;55558;2000;645188;51438;1736;255313;3654;1852;3897;79983;727940;10857;541466;139741;56157;2182;84707;1069;53336;154796;51309;80712;1485;159090;1774;2258;728343;9823;55285;643311;4107;286499;203523;1831;54967;340542;89885;94121;286410;2491;84187;633;83550;4110;644353;3598;55916;340595;6594;2157;9452;50814;9643;57187;139067;4104;203427;139728;5456;100996648;10479;9016;55026;100528062;90316;10178;4105;100507170;2332;6845;84968;4068;51114;64663;1538;9142;246100;115201;100533997;79576;139212;6535;393;27330;91851;27286;1038;158800;7224;55796;10761;100132963;1288;215;8471;90167;292;7737;55879;7319;6134;1678;401612;139322;5063;116442;84443;29935;158983;10009;2747;2652;340543;54885;10495;27018;100129239;140886;2239;2334;441518;26071;2664;59353;5956;728712;84636;55922;28985;79184;441521;728049;728090;8933;10735;158521;3581;9949;4694;84528;282808;8263;9130;492;100129520;728082;90843;7411;347454;29071;9947;10134;79057;6906;340547;30014;30848;680;93380;159091;9338;8266;65109;64860;8776;494118;4675;51566;56271;2892;55559;85012;57529;114928;8277;5365;63035;4354;286436;55086;10838;139221;139735;83692;3251;10251;139716;158931;27035;1641;100329135;7105;2717;84295;9459;5973;4109;139065;474384;6748;139760;347487;51270;4103;139378;186;139231;2719;3597;9131;9248;7547;474381;402415;11254;90161;64102;728042;56849;2273;728036;64648;54440;140597;4952;5631;83740;3188;100130086;286527;347468;347475,400
-1,1,X,78348649,155232894,76884245,392509;23157;55998;541578;2158;55609;2556;23439;494119;8517;55859;331;3423;54830;4168;6901;5358;92002;474383;57595;51442;266740;9075;102723737;389895;7552;27328;84460;695;56000;340562;644538;79649;51213;57526;100272147;728269;51186;3149;26576;474382;1730;3547;102723680;3358;8273;728695;57826;79921;83844;114824;203413;80823;2986;8862;23641;7512;79979;158763;9737;55217;8270;537;3421;11013;8450;6658;5716;4101;54457;91966;139804;441519;4100;54470;959;57631;117154;2010;27316;54521;4534;79589;51634;728096;101928917;92129;653282;728072;9363;3920;100506164;827;84548;90293;100529097;55511;100133053;254065;203547;139135;79836;60343;139081;51765;203522;6451;139818;56180;27336;728458;8269;142684;7626;10046;340578;203447;63932;441509;4515;56001;4108;100130613;158798;2564;1193;79868;728075;11043;5354;56156;79366;1821;1260;56062;3054;84631;203562;102723631;170261;340596;441525;554;29944;2539;1478;50945;7739;8260;100131755;57481;139170;1287;4204;65991;6170;10813;79710;26280;2316;11219;728062;169966;6173;51209;23630;139324;1121;55558;2000;645188;51438;1736;255313;3654;1852;3897;79983;727940;10857;541466;139741;56157;2182;84707;1069;53336;154796;51309;80712;1485;159090;1774;2258;728343;9823;55285;643311;4107;286499;203523;1831;54967;340542;89885;94121;286410;2491;84187;633;83550;4110;644353;3598;55916;340595;6594;2157;9452;50814;9643;57187;139067;4104;203427;139728;5456;100996648;10479;9016;55026;100528062;90316;10178;4105;100507170;2332;6845;84968;4068;51114;64663;1538;9142;246100;115201;100533997;79576;139212;6535;393;27330;91851;27286;1038;158800;7224;55796;10761;100132963;1288;215;8471;90167;292;7737;55879;7319;6134;1678;401612;139322;5063;116442;84443;29935;158983;10009;2747;2652;340543;54885;10495;27018;100129239;140886;2239;2334;441518;26071;2664;59353;5956;728712;84636;55922;28985;79184;441521;728049;728090;8933;10735;158521;3581;9949;4694;84528;282808;8263;9130;492;100129520;728082;90843;7411;347454;29071;9947;10134;79057;6906;340547;30014;30848;680;93380;159091;9338;8266;65109;64860;8776;494118;4675;51566;56271;2892;55559;85012;57529;114928;8277;5365;63035;4354;286436;55086;10838;139221;139735;83692;3251;10251;139716;158931;27035;1641;100329135;7105;2717;84295;9459;5973;4109;139065;474384;6748;139760;347487;51270;4103;139378;186;139231;2719;3597;9131;9248;7547;474381;402415;11254;90161;64102;728042;56849;2273;728036;64648;54440;140597;4952;5631;83740;3188;100130086;286527;347468;347475,400
-1,1,X,79166568,155232894,76066326,392509;23157;55998;541578;2158;55609;2556;23439;494119;8517;55859;331;3423;54830;4168;6901;5358;92002;474383;57595;51442;266740;9075;102723737;389895;7552;27328;84460;695;56000;340562;644538;79649;51213;57526;100272147;728269;51186;3149;26576;474382;1730;3547;102723680;3358;8273;728695;57826;79921;83844;114824;203413;80823;2986;8862;23641;7512;79979;158763;9737;55217;8270;537;3421;11013;8450;6658;5716;4101;54457;91966;139804;441519;4100;54470;959;57631;117154;2010;27316;54521;4534;79589;51634;728096;101928917;92129;653282;728072;9363;3920;100506164;827;84548;90293;100529097;55511;100133053;254065;203547;139135;79836;60343;139081;51765;203522;6451;139818;56180;27336;728458;8269;142684;7626;10046;340578;203447;63932;441509;4515;56001;4108;100130613;158798;2564;1193;79868;728075;11043;5354;56156;79366;1821;1260;56062;3054;84631;203562;102723631;170261;340596;441525;554;29944;2539;1478;50945;7739;8260;100131755;57481;139170;1287;4204;65991;6170;10813;79710;26280;2316;11219;728062;169966;6173;51209;23630;139324;1121;55558;2000;645188;51438;1736;255313;3654;1852;3897;79983;727940;10857;541466;139741;56157;2182;84707;1069;53336;154796;51309;80712;1485;159090;1774;2258;728343;9823;55285;643311;4107;286499;203523;1831;54967;340542;89885;94121;286410;2491;84187;633;83550;4110;644353;3598;55916;340595;6594;2157;50814;9643;57187;139067;4104;203427;139728;5456;100996648;10479;9016;55026;100528062;90316;10178;4105;100507170;2332;6845;84968;4068;51114;64663;1538;9142;246100;115201;100533997;79576;139212;6535;393;27330;91851;27286;1038;158800;7224;55796;10761;100132963;1288;215;8471;90167;292;7737;55879;7319;6134;1678;401612;139322;5063;116442;84443;29935;158983;10009;2747;2652;340543;54885;10495;27018;100129239;140886;2239;2334;441518;26071;2664;59353;5956;728712;55922;28985;79184;441521;728049;728090;8933;10735;158521;3581;9949;4694;84528;282808;8263;9130;492;100129520;728082;90843;7411;347454;29071;9947;10134;79057;6906;340547;30014;30848;680;93380;159091;9338;8266;65109;64860;8776;494118;4675;51566;56271;2892;55559;85012;57529;114928;8277;5365;63035;4354;286436;55086;10838;139221;139735;83692;3251;10251;139716;158931;27035;1641;100329135;7105;2717;84295;9459;5973;4109;139065;474384;6748;139760;347487;51270;4103;139378;186;139231;2719;3597;9131;9248;7547;474381;402415;11254;90161;64102;728042;56849;2273;728036;64648;54440;140597;4952;5631;83740;3188;100130086;286527;347468;347475,398
-1,1,X,79862302,155233731,75371429,392509;23157;55998;541578;2158;55609;2556;23439;494119;8517;55859;331;3423;54830;4168;6901;5358;92002;474383;57595;51442;266740;9075;102723737;389895;7552;27328;84460;695;56000;340562;644538;79649;51213;57526;100272147;728269;51186;3149;26576;474382;1730;3547;102723680;3358;8273;728695;57826;79921;83844;114824;203413;80823;2986;8862;23641;7512;79979;158763;9737;55217;8270;537;3421;11013;8450;6658;5716;4101;54457;91966;139804;441519;4100;54470;959;57631;117154;2010;27316;54521;4534;79589;51634;728096;101928917;92129;653282;728072;9363;3920;100506164;827;84548;90293;100529097;55511;100133053;254065;203547;139135;79836;60343;139081;51765;203522;6451;139818;56180;27336;728458;8269;142684;7626;10046;340578;203447;63932;441509;4515;56001;4108;100130613;158798;2564;1193;79868;728075;11043;5354;56156;79366;1821;1260;56062;3054;84631;203562;102723631;170261;340596;441525;554;29944;2539;1478;7739;8260;100131755;57481;139170;1287;4204;65991;6170;10813;79710;26280;2316;11219;728062;6173;51209;23630;139324;1121;55558;2000;645188;51438;1736;255313;3654;1852;3897;79983;727940;10857;541466;139741;56157;2182;84707;1069;53336;154796;51309;80712;1485;159090;1774;2258;728343;9823;55285;643311;4107;286499;203523;1831;54967;340542;89885;94121;286410;2491;84187;633;83550;4110;644353;3598;55916;340595;6594;2157;50814;9643;57187;139067;4104;203427;139728;5456;100996648;10479;9016;55026;100528062;90316;10178;4105;100507170;2332;6845;84968;4068;51114;64663;1538;9142;246100;115201;100533997;79576;139212;6535;393;27330;91851;27286;1038;158800;7224;55796;10761;100132963;1288;215;8471;90167;292;7737;55879;7319;6134;1678;401612;139322;5063;116442;84443;29935;158983;10009;2747;2652;340543;54885;10495;27018;100129239;140886;2239;2334;441518;26071;2664;59353;5956;728712;55922;28985;79184;441521;728049;728090;8933;10735;158521;3581;9949;4694;84528;282808;8263;9130;492;100129520;728082;90843;7411;347454;29071;9947;10134;79057;6906;340547;30014;30848;680;93380;159091;9338;8266;65109;64860;8776;494118;4675;51566;56271;2892;55559;85012;57529;114928;8277;5365;63035;4354;286436;55086;10838;139221;139735;83692;3251;10251;139716;158931;27035;1641;100329135;7105;2717;84295;9459;5973;4109;139065;474384;6748;139760;347487;51270;4103;139378;186;139231;2719;3597;9131;9248;7547;474381;402415;11254;90161;64102;728042;56849;2273;728036;64648;54440;140597;4952;5631;83740;3188;100130086;286527;347468;347475,396
-1,1,X,79977813,91407618,11429805,1121;27328;1538;340562;79366;140886;254065;56062;79983;6451;5456;117154;90316;139322;27330;53336;7552;139324,18
-1,1,X,80177055,82970633,2793578,6451;5456;79366,3
-1,1,X,80364969,108686022,28321053,56001;644353;392509;282808;11043;5354;79366;55998;1821;56156;9643;90843;56062;6906;5456;340547;55859;100996648;203562;100528062;54830;90316;9338;9075;64860;7552;4675;51566;27328;1478;695;1538;84460;56271;56000;340562;100131755;57526;85012;1287;114928;115201;51186;1730;286436;55086;139212;139221;79710;26280;79921;27330;6173;51209;80823;2986;139324;1121;27286;79979;158931;9737;27035;7105;2717;1288;11013;5716;54470;54457;8471;79983;117154;56157;139231;401612;1678;79589;139322;92129;402415;84707;53336;51309;84443;29935;158983;64102;80712;340543;54885;728343;56849;27018;100529097;9823;55285;140886;6451;286499;140597;5631;1831;142684;3188;59353;340542;94121;2491;203447;286527;441509,112
-1,1,X,81186415,85220287,4033872,1121;5456;1538;340562;139322;27330;7552;79983;139324,9
1,-1,X,81202690,81314758,112068,,0
1,-1,X,81202690,81314758,112068,,0
1,-1,X,81202690,81314758,112068,,0
-1,1,X,81352168,155233731,73881563,392509;23157;55998;541578;2158;55609;2556;23439;494119;8517;55859;331;3423;54830;4168;6901;5358;92002;474383;57595;51442;266740;9075;102723737;389895;7552;27328;84460;695;56000;340562;644538;79649;51213;57526;100272147;728269;51186;3149;26576;474382;1730;3547;102723680;3358;8273;728695;57826;79921;83844;114824;203413;80823;2986;8862;23641;7512;79979;158763;9737;55217;8270;537;3421;11013;8450;6658;5716;4101;54457;91966;139804;441519;4100;54470;959;57631;117154;2010;27316;54521;4534;79589;51634;728096;101928917;92129;653282;728072;9363;3920;100506164;827;84548;90293;100529097;55511;100133053;203547;139135;79836;60343;139081;51765;203522;139818;56180;27336;728458;8269;142684;7626;10046;340578;203447;63932;441509;4515;56001;4108;100130613;158798;2564;1193;79868;728075;11043;5354;56156;1260;1821;56062;3054;84631;203562;102723631;170261;340596;441525;554;29944;2539;1478;7739;8260;100131755;57481;139170;1287;4204;65991;6170;10813;79710;26280;2316;11219;728062;6173;51209;23630;139324;1121;55558;2000;645188;51438;1736;255313;3654;1852;3897;79983;727940;10857;541466;139741;56157;2182;84707;1069;53336;154796;51309;80712;1485;159090;1774;2258;728343;9823;55285;643311;4107;286499;203523;1831;54967;340542;89885;94121;286410;2491;84187;633;83550;4110;644353;3598;55916;340595;6594;2157;50814;9643;57187;139067;4104;203427;139728;5456;100996648;10479;9016;55026;100528062;90316;10178;4105;100507170;2332;6845;84968;4068;51114;64663;1538;9142;246100;115201;100533997;79576;139212;6535;393;27330;91851;27286;1038;158800;7224;55796;10761;100132963;1288;215;8471;90167;292;7737;55879;7319;6134;1678;401612;139322;5063;116442;84443;29935;158983;10009;2747;2652;340543;54885;10495;27018;100129239;140886;2239;2334;441518;26071;2664;59353;5956;728712;55922;28985;79184;441521;728049;728090;8933;10735;158521;3581;9949;4694;84528;282808;8263;9130;492;100129520;728082;90843;7411;347454;29071;9947;10134;79057;6906;340547;30014;30848;680;93380;159091;9338;8266;65109;64860;8776;494118;4675;51566;56271;2892;55559;85012;57529;114928;8277;5365;63035;4354;286436;55086;10838;139221;139735;83692;3251;10251;139716;158931;27035;1641;100329135;7105;2717;84295;9459;5973;4109;139065;474384;6748;139760;347487;51270;4103;139378;186;139231;2719;3597;9131;9248;7547;474381;402415;11254;90161;64102;728042;56849;2273;728036;64648;54440;140597;4952;5631;83740;3188;100130086;286527;347468;347475,393
-1,1,X,81466759,155232894,73766135,392509;23157;55998;541578;2158;55609;2556;23439;494119;8517;55859;331;3423;54830;4168;6901;5358;92002;474383;57595;51442;266740;9075;102723737;389895;7552;27328;84460;695;56000;340562;644538;79649;51213;57526;100272147;728269;51186;3149;26576;474382;1730;3547;102723680;3358;8273;728695;57826;79921;83844;114824;203413;80823;2986;8862;23641;7512;79979;158763;9737;55217;8270;537;3421;11013;8450;6658;5716;4101;54457;91966;139804;441519;4100;54470;959;57631;117154;2010;27316;54521;4534;79589;51634;728096;101928917;92129;653282;728072;9363;3920;100506164;827;84548;90293;100529097;55511;100133053;203547;139135;79836;60343;139081;51765;203522;139818;56180;27336;728458;8269;142684;7626;10046;340578;203447;63932;441509;4515;56001;4108;100130613;158798;2564;1193;79868;728075;11043;5354;56156;1260;1821;56062;3054;84631;203562;102723631;170261;340596;441525;554;29944;2539;1478;7739;8260;100131755;57481;139170;1287;4204;65991;6170;10813;79710;26280;2316;11219;728062;6173;51209;23630;139324;1121;55558;2000;645188;51438;1736;255313;3654;1852;3897;79983;727940;10857;541466;139741;56157;2182;84707;1069;53336;154796;51309;80712;1485;159090;1774;2258;728343;9823;55285;643311;4107;286499;203523;1831;54967;340542;89885;94121;286410;2491;84187;633;83550;4110;644353;3598;55916;340595;6594;2157;50814;9643;57187;139067;4104;203427;139728;5456;100996648;10479;9016;55026;100528062;90316;10178;4105;100507170;2332;6845;84968;4068;51114;64663;1538;9142;246100;115201;100533997;79576;139212;6535;393;27330;91851;27286;1038;158800;7224;55796;10761;100132963;1288;215;8471;90167;292;7737;55879;7319;6134;1678;401612;139322;5063;116442;84443;29935;158983;10009;2747;2652;340543;54885;10495;27018;100129239;140886;2239;2334;441518;26071;2664;59353;5956;728712;55922;28985;79184;441521;728049;728090;8933;10735;158521;3581;9949;4694;84528;282808;8263;9130;492;100129520;728082;90843;7411;347454;29071;9947;10134;79057;6906;340547;30014;30848;680;93380;159091;9338;8266;65109;64860;8776;494118;4675;51566;56271;2892;55559;85012;57529;114928;8277;5365;63035;4354;286436;55086;10838;139221;139735;83692;3251;10251;139716;158931;27035;1641;100329135;7105;2717;84295;9459;5973;4109;139065;474384;6748;139760;347487;51270;4103;139378;186;139231;2719;3597;9131;9248;7547;474381;402415;11254;90161;64102;728042;56849;2273;728036;64648;54440;140597;4952;5631;83740;3188;100130086;286527;347468;347475,393
-1,-1,X,84030980,84132021,101041,,0
1,1,X,84378746,155251871,70873125,392509;23157;55998;541578;2158;55609;2556;23439;494119;8517;55859;331;3423;54830;4168;6901;5358;92002;474383;57595;51442;266740;9075;102723737;389895;7552;27328;84460;695;56000;644538;79649;51213;57526;100272147;728269;51186;3149;26576;474382;1730;3547;102723680;3358;8273;728695;57826;79921;83844;114824;203413;80823;2986;8862;23641;7512;79979;158763;9737;55217;8270;537;3421;11013;8450;6658;5716;4101;54457;91966;139804;441519;4100;54470;959;57631;117154;2010;27316;54521;4534;79589;51634;728096;101928917;92129;653282;728072;9363;3920;100506164;827;84548;90293;100529097;55511;100133053;203547;139135;79836;60343;139081;51765;203522;139818;56180;27336;728458;8269;142684;7626;10046;340578;203447;63932;441509;4515;56001;4108;100130613;158798;2564;1193;79868;728075;11043;5354;56156;1260;1821;56062;3054;84631;203562;102723631;170261;340596;441525;554;29944;2539;1478;7739;8260;100131755;57481;139170;1287;4204;65991;6170;10813;79710;26280;2316;11219;728062;6173;51209;23630;1121;55558;2000;645188;51438;1736;255313;3654;1852;3897;79983;727940;10857;541466;139741;56157;2182;84707;1069;53336;154796;51309;80712;1485;159090;1774;2258;728343;9823;55285;643311;4107;286499;203523;1831;54967;340542;89885;94121;286410;2491;84187;633;83550;4110;644353;3598;55916;340595;6594;2157;50814;9643;57187;139067;4104;203427;139728;100996648;10479;9016;55026;100528062;90316;10178;4105;100507170;2332;6845;84968;4068;51114;64663;9142;246100;115201;100533997;79576;139212;6535;393;91851;27286;1038;158800;7224;55796;10761;100132963;1288;215;8471;90167;292;7737;55879;7319;6134;1678;401612;5063;116442;84443;29935;158983;10009;2747;2652;340543;54885;10495;27018;100129239;140886;2239;2334;441518;26071;2664;59353;5956;728712;55922;28985;79184;441521;728049;728090;8933;10735;158521;3581;9949;4694;84528;282808;8263;9130;492;100129520;728082;90843;7411;347454;29071;9947;10134;79057;6906;340547;30014;30848;680;93380;159091;9338;8266;65109;64860;8776;494118;4675;51566;56271;2892;55559;85012;57529;114928;8277;5365;63035;4354;286436;55086;10838;139221;139735;83692;3251;10251;139716;158931;27035;1641;100329135;7105;2717;84295;9459;5973;4109;139065;474384;6748;139760;347487;51270;4103;139378;186;139231;2719;3597;9131;9248;7547;474381;402415;11254;90161;64102;728042;56849;2273;728036;64648;54440;140597;4952;5631;83740;3188;100130086;286527;347468;347475,387
1,1,X,84378746,155251871,70873125,392509;23157;55998;541578;2158;55609;2556;23439;494119;8517;55859;331;3423;54830;4168;6901;5358;92002;474383;57595;51442;266740;9075;102723737;389895;7552;27328;84460;695;56000;644538;79649;51213;57526;100272147;728269;51186;3149;26576;474382;1730;3547;102723680;3358;8273;728695;57826;79921;83844;114824;203413;80823;2986;8862;23641;7512;79979;158763;9737;55217;8270;537;3421;11013;8450;6658;5716;4101;54457;91966;139804;441519;4100;54470;959;57631;117154;2010;27316;54521;4534;79589;51634;728096;101928917;92129;653282;728072;9363;3920;100506164;827;84548;90293;100529097;55511;100133053;203547;139135;79836;60343;139081;51765;203522;139818;56180;27336;728458;8269;142684;7626;10046;340578;203447;63932;441509;4515;56001;4108;100130613;158798;2564;1193;79868;728075;11043;5354;56156;1260;1821;56062;3054;84631;203562;102723631;170261;340596;441525;554;29944;2539;1478;7739;8260;100131755;57481;139170;1287;4204;65991;6170;10813;79710;26280;2316;11219;728062;6173;51209;23630;1121;55558;2000;645188;51438;1736;255313;3654;1852;3897;79983;727940;10857;541466;139741;56157;2182;84707;1069;53336;154796;51309;80712;1485;159090;1774;2258;728343;9823;55285;643311;4107;286499;203523;1831;54967;340542;89885;94121;286410;2491;84187;633;83550;4110;644353;3598;55916;340595;6594;2157;50814;9643;57187;139067;4104;203427;139728;100996648;10479;9016;55026;100528062;90316;10178;4105;100507170;2332;6845;84968;4068;51114;64663;9142;246100;115201;100533997;79576;139212;6535;393;91851;27286;1038;158800;7224;55796;10761;100132963;1288;215;8471;90167;292;7737;55879;7319;6134;1678;401612;5063;116442;84443;29935;158983;10009;2747;2652;340543;54885;10495;27018;100129239;140886;2239;2334;441518;26071;2664;59353;5956;728712;55922;28985;79184;441521;728049;728090;8933;10735;158521;3581;9949;4694;84528;282808;8263;9130;492;100129520;728082;90843;7411;347454;29071;9947;10134;79057;6906;340547;30014;30848;680;93380;159091;9338;8266;65109;64860;8776;494118;4675;51566;56271;2892;55559;85012;57529;114928;8277;5365;63035;4354;286436;55086;10838;139221;139735;83692;3251;10251;139716;158931;27035;1641;100329135;7105;2717;84295;9459;5973;4109;139065;474384;6748;139760;347487;51270;4103;139378;186;139231;2719;3597;9131;9248;7547;474381;402415;11254;90161;64102;728042;56849;2273;728036;64648;54440;140597;4952;5631;83740;3188;100130086;286527;347468;347475,387
-1,1,X,85881434,155233731,69352297,392509;23157;55998;541578;2158;55609;2556;23439;494119;8517;55859;331;3423;54830;4168;6901;5358;92002;474383;57595;51442;266740;9075;102723737;389895;27328;84460;695;56000;644538;79649;51213;57526;100272147;728269;51186;3149;26576;474382;1730;3547;102723680;3358;8273;728695;57826;79921;83844;114824;203413;80823;2986;8862;23641;7512;79979;158763;9737;55217;8270;537;3421;11013;8450;6658;5716;4101;54457;91966;139804;441519;4100;54470;959;57631;117154;2010;27316;54521;4534;79589;51634;728096;101928917;92129;653282;728072;9363;3920;100506164;827;84548;90293;100529097;55511;100133053;203547;139135;79836;60343;139081;51765;203522;139818;56180;27336;728458;8269;142684;7626;10046;340578;203447;63932;441509;4515;56001;4108;100130613;158798;2564;1193;79868;728075;11043;5354;56156;1260;1821;56062;3054;84631;203562;102723631;170261;340596;441525;554;29944;2539;1478;7739;8260;100131755;57481;139170;1287;4204;65991;6170;10813;79710;26280;2316;11219;728062;6173;51209;23630;55558;2000;645188;51438;1736;255313;3654;1852;3897;727940;10857;541466;139741;56157;2182;84707;1069;53336;154796;51309;80712;1485;159090;1774;2258;728343;9823;55285;643311;4107;286499;203523;1831;54967;340542;89885;94121;286410;2491;84187;633;83550;4110;644353;3598;55916;340595;6594;2157;50814;9643;57187;139067;4104;203427;139728;100996648;10479;9016;55026;100528062;90316;10178;4105;100507170;2332;6845;84968;4068;51114;64663;9142;246100;115201;100533997;79576;139212;6535;393;91851;27286;1038;158800;7224;55796;10761;100132963;1288;215;8471;90167;292;7737;55879;7319;6134;1678;401612;5063;116442;84443;29935;158983;10009;2747;2652;340543;54885;10495;27018;100129239;140886;2239;2334;441518;26071;2664;59353;5956;728712;55922;28985;79184;441521;728049;728090;8933;10735;158521;3581;9949;4694;84528;282808;8263;9130;492;100129520;728082;90843;7411;347454;29071;9947;10134;79057;6906;340547;30014;30848;680;93380;159091;9338;8266;65109;64860;8776;494118;4675;51566;56271;2892;55559;85012;57529;114928;8277;5365;63035;4354;286436;55086;10838;139221;139735;83692;3251;10251;139716;158931;27035;1641;100329135;7105;2717;84295;9459;5973;4109;139065;474384;6748;139760;347487;51270;4103;139378;186;139231;2719;3597;9131;9248;7547;474381;402415;11254;90161;64102;728042;56849;2273;728036;64648;54440;140597;4952;5631;83740;3188;100130086;286527;347468;347475,384
-1,-1,X,86428535,86473678,45143,,0
-1,1,X,86776682,114054291,27277609,56001;644353;9949;392509;55916;282808;79868;340595;11043;5354;56156;55998;1821;9643;90843;56062;6906;340547;55859;100996648;203562;340596;100528062;54830;90316;9338;9075;64860;4675;51566;27328;1478;695;84460;56271;56000;100131755;57526;85012;1287;57529;114928;115201;51186;1730;286436;55086;139212;139221;79710;3358;26280;79921;6173;51209;23630;80823;2986;91851;27286;79979;158931;9737;27035;1641;100329135;7105;2717;1288;11013;7224;5716;54470;54457;8471;56157;139231;2182;401612;1678;79589;402415;92129;84707;5063;53336;154796;51309;84443;29935;158983;827;64102;80712;340543;54885;728343;56849;27018;100529097;9823;55285;140886;286499;140597;5631;1831;142684;3188;59353;340542;94121;2491;84187;203447;286527;441509,117
-1,1,X,86900388,155233731,68333343,392509;23157;55998;541578;2158;55609;2556;23439;494119;8517;55859;331;3423;54830;4168;6901;5358;92002;474383;57595;51442;266740;9075;102723737;389895;27328;84460;695;56000;644538;79649;51213;57526;100272147;728269;51186;3149;26576;474382;1730;3547;102723680;3358;8273;728695;57826;79921;83844;114824;203413;80823;2986;8862;23641;7512;79979;158763;9737;55217;8270;537;3421;11013;8450;6658;5716;4101;54457;91966;139804;441519;4100;54470;959;57631;2010;27316;54521;4534;79589;51634;728096;101928917;92129;653282;728072;9363;3920;100506164;827;84548;90293;100529097;55511;100133053;203547;139135;79836;60343;139081;51765;203522;139818;56180;27336;728458;8269;142684;7626;10046;340578;203447;63932;441509;4515;56001;4108;100130613;158798;2564;1193;79868;728075;11043;5354;56156;1260;1821;56062;3054;84631;203562;102723631;170261;340596;441525;554;29944;2539;1478;7739;8260;100131755;57481;139170;1287;4204;65991;6170;10813;79710;26280;2316;11219;728062;6173;51209;23630;55558;2000;645188;51438;1736;255313;3654;1852;3897;727940;10857;541466;139741;56157;2182;84707;1069;53336;154796;51309;80712;1485;159090;1774;2258;728343;9823;55285;643311;4107;286499;203523;1831;54967;340542;89885;94121;286410;2491;84187;633;83550;4110;644353;3598;55916;340595;6594;2157;50814;9643;57187;139067;4104;203427;139728;100996648;10479;9016;55026;100528062;90316;10178;4105;100507170;2332;6845;84968;4068;51114;64663;9142;246100;115201;100533997;79576;139212;6535;393;91851;27286;1038;158800;7224;55796;10761;100132963;1288;215;8471;90167;292;7737;55879;7319;6134;1678;401612;5063;116442;84443;29935;158983;10009;2747;2652;340543;54885;10495;27018;100129239;140886;2239;2334;441518;26071;2664;59353;5956;728712;55922;28985;79184;441521;728049;728090;8933;10735;158521;3581;9949;4694;84528;282808;8263;9130;492;100129520;728082;90843;7411;347454;29071;9947;10134;79057;6906;340547;30014;30848;680;93380;159091;9338;8266;65109;64860;8776;494118;4675;51566;56271;2892;55559;85012;57529;114928;8277;5365;63035;4354;286436;55086;10838;139221;139735;83692;3251;10251;139716;158931;27035;1641;100329135;7105;2717;84295;9459;5973;4109;139065;474384;6748;139760;347487;51270;4103;139378;186;139231;2719;3597;9131;9248;7547;474381;402415;11254;90161;64102;728042;56849;2273;728036;64648;54440;140597;4952;5631;83740;3188;100130086;286527;347468;347475,383
1,1,X,87062750,99541150,12478400,4675;286499;1730;27328;140886;90316;53336;29935,8
-1,1,X,87594927,155232907,67637980,392509;23157;55998;541578;2158;55609;2556;23439;494119;8517;55859;331;3423;54830;4168;6901;5358;92002;474383;57595;51442;266740;9075;102723737;389895;27328;84460;695;56000;644538;79649;51213;57526;100272147;728269;51186;3149;26576;474382;1730;3547;102723680;3358;8273;728695;57826;79921;83844;114824;203413;80823;2986;8862;23641;7512;79979;158763;9737;55217;8270;537;3421;11013;8450;6658;5716;4101;54457;91966;139804;441519;4100;54470;959;57631;2010;27316;54521;4534;79589;51634;728096;101928917;92129;653282;728072;9363;3920;100506164;827;84548;90293;100529097;55511;100133053;203547;139135;79836;60343;139081;51765;203522;139818;56180;27336;728458;8269;142684;7626;10046;340578;203447;63932;441509;4515;56001;4108;100130613;158798;2564;1193;79868;728075;11043;5354;56156;1260;1821;3054;84631;203562;102723631;170261;340596;441525;554;29944;2539;1478;7739;8260;100131755;57481;139170;1287;4204;65991;6170;10813;79710;26280;2316;11219;728062;6173;51209;23630;55558;2000;645188;51438;1736;255313;3654;1852;3897;727940;10857;541466;139741;56157;2182;84707;1069;53336;154796;51309;80712;1485;159090;1774;2258;728343;9823;55285;643311;4107;286499;203523;1831;54967;340542;89885;94121;286410;2491;84187;633;83550;4110;644353;3598;55916;340595;6594;2157;50814;9643;57187;139067;4104;203427;139728;100996648;10479;9016;55026;100528062;90316;10178;4105;100507170;2332;6845;84968;4068;51114;64663;9142;246100;115201;100533997;79576;139212;6535;393;91851;27286;1038;158800;7224;55796;10761;100132963;1288;215;8471;90167;292;7737;55879;7319;6134;1678;401612;5063;116442;84443;29935;158983;10009;2747;2652;340543;54885;10495;27018;100129239;140886;2239;2334;441518;26071;2664;59353;5956;728712;55922;28985;79184;441521;728049;728090;8933;10735;158521;3581;9949;4694;84528;282808;8263;9130;492;100129520;728082;90843;7411;347454;29071;9947;10134;79057;6906;340547;30014;30848;680;93380;159091;9338;8266;65109;64860;8776;494118;4675;51566;56271;2892;55559;85012;57529;114928;8277;5365;63035;4354;286436;55086;10838;139221;139735;83692;3251;10251;139716;158931;27035;1641;100329135;7105;2717;84295;9459;5973;4109;139065;474384;6748;139760;347487;51270;4103;139378;186;139231;2719;3597;9131;9248;7547;474381;402415;11254;90161;64102;728042;56849;2273;728036;64648;54440;140597;4952;5631;83740;3188;100130086;286527;347468;347475,382
1,1,X,88489463,92357412,3867949,140886;90316;27328,3
-1,1,X,88812621,155233731,66421110,392509;23157;55998;541578;2158;55609;2556;23439;494119;8517;55859;331;3423;54830;4168;6901;5358;92002;474383;57595;51442;266740;9075;102723737;389895;27328;84460;695;56000;644538;79649;51213;57526;100272147;728269;51186;3149;26576;474382;1730;3547;102723680;3358;8273;728695;57826;79921;83844;114824;203413;80823;2986;8862;23641;7512;79979;158763;9737;55217;8270;537;3421;11013;8450;6658;5716;4101;54457;91966;139804;441519;4100;54470;959;57631;2010;27316;54521;4534;79589;51634;728096;101928917;92129;653282;728072;9363;3920;100506164;827;84548;90293;100529097;55511;100133053;203547;139135;79836;60343;139081;51765;203522;139818;56180;27336;728458;8269;142684;7626;10046;340578;203447;63932;441509;4515;56001;4108;100130613;158798;2564;1193;79868;728075;11043;5354;56156;1260;1821;3054;84631;203562;102723631;170261;340596;441525;554;29944;2539;1478;7739;8260;100131755;57481;139170;1287;4204;65991;6170;10813;79710;26280;2316;11219;728062;6173;51209;23630;55558;2000;645188;51438;1736;255313;3654;1852;3897;727940;10857;541466;139741;56157;2182;84707;1069;154796;51309;80712;1485;159090;1774;2258;728343;9823;55285;643311;4107;286499;203523;1831;54967;340542;89885;94121;286410;2491;84187;633;83550;4110;644353;3598;55916;340595;6594;2157;50814;9643;57187;139067;4104;203427;139728;100996648;10479;9016;55026;100528062;90316;10178;4105;100507170;2332;6845;84968;4068;51114;64663;9142;246100;115201;100533997;79576;139212;6535;393;91851;27286;1038;158800;7224;55796;10761;100132963;1288;215;8471;90167;292;7737;55879;7319;6134;1678;401612;5063;116442;84443;29935;158983;10009;2747;2652;340543;54885;10495;27018;100129239;140886;2239;2334;441518;26071;2664;59353;5956;728712;55922;28985;79184;441521;728049;728090;8933;10735;158521;3581;9949;4694;84528;282808;8263;9130;492;100129520;728082;90843;7411;347454;29071;9947;10134;79057;6906;340547;30014;30848;680;93380;159091;9338;8266;65109;64860;8776;494118;4675;51566;56271;2892;55559;85012;57529;114928;8277;5365;63035;4354;286436;55086;10838;139221;139735;83692;3251;10251;139716;158931;27035;1641;100329135;7105;2717;84295;9459;5973;4109;139065;474384;6748;139760;347487;51270;4103;139378;186;139231;2719;3597;9131;9248;7547;474381;402415;11254;90161;64102;728042;56849;2273;728036;64648;54440;140597;4952;5631;83740;3188;100130086;286527;347468;347475,381
-1,1,X,90480161,100281763,9801602,4675;27286;79979;64102;27328;1478;27035;392509;7105;140886;57526;286499;1730;94121;402415;29935,16
-1,-1,X,91214315,91246061,31746,27328,1
1,-1,X,91214315,91246061,31746,27328,1
1,-1,X,91434301,91519622,85321,27328,1
-1,1,X,91477679,155246585,63768906,392509;23157;55998;541578;2158;55609;2556;23439;494119;8517;55859;331;3423;54830;4168;6901;5358;92002;474383;57595;51442;266740;9075;102723737;389895;27328;84460;695;56000;644538;79649;51213;57526;100272147;728269;51186;3149;26576;474382;1730;3547;102723680;3358;8273;728695;57826;79921;83844;114824;203413;80823;2986;8862;23641;7512;79979;158763;9737;55217;8270;537;3421;11013;8450;6658;5716;4101;54457;91966;139804;441519;4100;54470;959;57631;2010;27316;54521;4534;79589;51634;728096;101928917;92129;653282;728072;9363;3920;100506164;827;84548;90293;100529097;55511;100133053;203547;139135;79836;60343;139081;51765;203522;139818;56180;27336;728458;8269;142684;7626;10046;340578;203447;63932;441509;4515;56001;4108;100130613;158798;2564;1193;79868;728075;11043;5354;56156;1260;1821;3054;84631;203562;102723631;170261;340596;441525;554;29944;2539;1478;7739;8260;100131755;57481;139170;1287;4204;65991;6170;10813;79710;26280;2316;11219;728062;6173;51209;23630;55558;2000;645188;51438;1736;255313;3654;1852;3897;727940;10857;541466;139741;56157;2182;84707;1069;154796;51309;80712;1485;159090;1774;2258;728343;9823;55285;643311;4107;286499;203523;1831;54967;340542;89885;94121;286410;2491;84187;633;83550;4110;644353;3598;55916;340595;6594;2157;50814;9643;57187;139067;4104;203427;139728;100996648;10479;9016;55026;100528062;10178;4105;100507170;2332;6845;84968;4068;51114;64663;9142;246100;115201;100533997;79576;139212;6535;393;91851;27286;1038;158800;7224;55796;10761;100132963;1288;215;8471;90167;292;7737;55879;7319;6134;1678;401612;5063;116442;84443;29935;158983;10009;2747;2652;54885;340543;10495;27018;100129239;2239;2334;441518;26071;2664;59353;5956;728712;55922;28985;79184;441521;728049;728090;8933;10735;158521;3581;9949;4694;84528;282808;8263;9130;492;100129520;728082;90843;7411;347454;29071;9947;10134;79057;6906;340547;30014;30848;680;93380;159091;9338;8266;65109;64860;8776;494118;4675;51566;56271;2892;55559;85012;57529;114928;8277;5365;63035;4354;286436;55086;10838;139221;139735;83692;3251;10251;139716;158931;27035;1641;100329135;7105;2717;84295;9459;5973;4109;139065;474384;6748;139760;347487;51270;4103;139378;186;139231;2719;3597;9131;9248;7547;474381;402415;11254;90161;64102;728042;56849;2273;728036;64648;54440;140597;4952;5631;83740;3188;100130086;286527;347468;347475,379
1,-1,X,91754117,91797605,43488,27328,1
1,1,X,92846589,111773320,18926731,56001;644353;9949;392509;55916;282808;79868;340595;11043;5354;56156;55998;1821;9643;90843;6906;340547;55859;100996648;203562;100528062;54830;9338;9075;64860;4675;51566;1478;56271;695;84460;56000;100131755;57526;85012;1287;57529;114928;115201;51186;1730;286436;55086;139212;139221;79710;26280;79921;6173;51209;23630;80823;2986;91851;27286;79979;158931;9737;27035;1641;100329135;7105;2717;1288;11013;7224;5716;54470;54457;8471;56157;139231;2182;401612;1678;79589;402415;92129;84707;5063;51309;84443;29935;158983;827;64102;80712;54885;340543;728343;56849;27018;100529097;9823;55285;286499;140597;5631;1831;142684;3188;59353;340542;94121;2491;84187;203447;286527;441509,109
-1,1,X,92879337,100099708,7220371,4675;27286;286499;64102;1730;1478;27035;7105;94121;57526;29935,11
1,-1,X,93345492,93524330,178838,,0
1,-1,X,93622826,94376002,753176,,0
1,1,X,93717928,155231300,61513372,392509;23157;55998;541578;2158;55609;2556;23439;494119;8517;55859;331;3423;54830;4168;6901;5358;92002;474383;57595;51442;266740;9075;102723737;389895;84460;695;56000;644538;79649;51213;57526;100272147;728269;51186;3149;26576;474382;1730;3547;102723680;3358;8273;728695;57826;79921;83844;114824;203413;80823;2986;8862;23641;7512;79979;158763;9737;55217;8270;537;3421;11013;8450;6658;5716;4101;54457;91966;139804;441519;4100;54470;959;57631;2010;27316;54521;4534;79589;51634;728096;101928917;92129;653282;728072;9363;3920;100506164;827;84548;90293;100529097;55511;100133053;203547;139135;79836;60343;139081;51765;203522;139818;56180;27336;728458;8269;142684;7626;10046;340578;203447;63932;441509;4515;56001;4108;100130613;158798;2564;1193;79868;728075;11043;5354;56156;1260;1821;3054;84631;203562;102723631;170261;340596;441525;554;29944;2539;1478;7739;8260;100131755;57481;139170;1287;4204;65991;6170;10813;79710;26280;2316;11219;728062;6173;51209;23630;55558;2000;645188;51438;1736;255313;3654;1852;3897;727940;10857;541466;139741;56157;2182;84707;1069;154796;51309;80712;1485;159090;1774;2258;728343;9823;55285;643311;4107;203523;1831;54967;340542;89885;94121;286410;2491;84187;633;83550;4110;644353;3598;55916;340595;6594;2157;50814;9643;57187;139067;4104;203427;139728;100996648;10479;9016;55026;100528062;10178;4105;100507170;2332;6845;84968;4068;51114;64663;9142;246100;115201;100533997;79576;139212;6535;393;91851;27286;1038;158800;7224;55796;10761;100132963;1288;215;8471;90167;292;7737;55879;7319;6134;1678;401612;5063;116442;84443;29935;158983;10009;2747;2652;54885;340543;10495;27018;100129239;2239;2334;441518;26071;2664;59353;5956;728712;55922;28985;79184;441521;728049;728090;8933;10735;158521;3581;9949;4694;84528;282808;8263;9130;492;100129520;728082;90843;7411;347454;29071;9947;10134;79057;6906;340547;30014;30848;680;93380;159091;9338;8266;65109;64860;8776;494118;51566;56271;2892;55559;85012;57529;114928;8277;5365;63035;4354;286436;55086;10838;139221;139735;83692;3251;10251;139716;158931;27035;1641;100329135;7105;2717;84295;9459;5973;4109;139065;474384;6748;139760;347487;51270;4103;139378;186;139231;2719;3597;9131;9248;7547;474381;402415;11254;90161;64102;728042;56849;2273;728036;64648;54440;140597;4952;5631;83740;3188;100130086;286527;347468;347475,376
-1,1,X,94043221,155246585,61203364,392509;23157;55998;541578;2158;55609;2556;23439;494119;8517;55859;331;3423;54830;4168;6901;5358;92002;474383;57595;51442;266740;9075;102723737;389895;84460;695;56000;644538;79649;51213;57526;100272147;728269;51186;3149;26576;474382;1730;3547;102723680;3358;8273;728695;57826;79921;83844;114824;203413;80823;2986;8862;23641;7512;79979;158763;9737;55217;8270;537;3421;11013;8450;6658;5716;4101;54457;91966;139804;441519;4100;54470;959;57631;2010;27316;54521;4534;79589;51634;728096;101928917;92129;653282;728072;9363;3920;100506164;827;84548;90293;100529097;55511;100133053;203547;139135;79836;60343;139081;51765;203522;139818;56180;27336;728458;8269;142684;7626;10046;340578;203447;63932;441509;4515;56001;4108;100130613;158798;2564;1193;79868;728075;11043;5354;56156;1260;1821;3054;84631;203562;102723631;170261;340596;441525;554;29944;2539;1478;7739;8260;100131755;57481;139170;1287;4204;65991;6170;10813;79710;26280;2316;11219;728062;6173;51209;23630;55558;2000;645188;51438;1736;255313;3654;1852;3897;727940;10857;541466;139741;56157;2182;84707;1069;154796;51309;80712;1485;159090;1774;2258;728343;9823;55285;643311;4107;203523;1831;54967;340542;89885;94121;286410;2491;84187;633;83550;4110;644353;3598;55916;340595;6594;2157;50814;9643;57187;139067;4104;203427;139728;100996648;10479;9016;55026;100528062;10178;4105;100507170;2332;6845;84968;4068;51114;64663;9142;246100;115201;100533997;79576;139212;6535;393;91851;27286;1038;158800;7224;55796;10761;100132963;1288;215;8471;90167;292;7737;55879;7319;6134;1678;401612;5063;116442;84443;29935;158983;10009;2747;2652;54885;340543;10495;27018;100129239;2239;2334;441518;26071;2664;59353;5956;728712;55922;28985;79184;441521;728049;728090;8933;10735;158521;3581;9949;4694;84528;282808;8263;9130;492;100129520;728082;90843;7411;347454;29071;9947;10134;79057;6906;340547;30014;30848;680;93380;159091;9338;8266;65109;64860;8776;494118;51566;56271;2892;55559;85012;57529;114928;8277;5365;63035;4354;286436;55086;10838;139221;139735;83692;3251;10251;139716;158931;27035;1641;100329135;7105;2717;84295;9459;5973;4109;139065;474384;6748;139760;347487;51270;4103;139378;186;139231;2719;3597;9131;9248;7547;474381;402415;11254;90161;64102;728042;56849;2273;728036;64648;54440;140597;4952;5631;83740;3188;100130086;286527;347468;347475,376
1,-1,X,94086549,94681639,595090,,0
1,-1,X,94277650,94388722,111072,,0
1,-1,X,94315189,94375943,60754,,0
1,-1,X,94315189,94375943,60754,,0
1,-1,X,94315189,94375943,60754,,0
1,-1,X,94348475,94388722,40247,,0
1,-1,X,94348475,94388722,40247,,0
1,-1,X,94348475,94388722,40247,,0
1,-1,X,94348475,94388722,40247,,0
1,-1,X,94348475,94388722,40247,,0
1,-1,X,94348475,94388722,40247,,0
1,-1,X,94348475,94388722,40247,,0
1,-1,X,94348475,94388722,40247,,0
1,-1,X,94348475,94388722,40247,,0
1,-1,X,94348475,94388722,40247,,0
1,-1,X,94348475,94388722,40247,,0
1,-1,X,94348475,94388722,40247,,0
1,-1,X,94348475,94388722,40247,,0
1,-1,X,94348475,94388722,40247,,0
1,-1,X,94348475,94388722,40247,,0
1,-1,X,94348475,94388722,40247,,0
1,-1,X,94348475,94388722,40247,,0
1,-1,X,94348475,94388722,40247,,0
1,-1,X,94348475,94388722,40247,,0
-1,-1,X,94416437,94462590,46153,,0
-1,-1,X,94754981,95056650,301669,,0
1,-1,X,94860137,94911489,51352,,0
1,-1,X,94988206,95077344,89138,,0
-1,1,X,95078035,104202418,9124383,56001;644353;392509;282808;5354;1821;55998;9643;90843;55859;100996648;203562;100528062;9338;64860;51566;1478;56271;695;84460;56000;100131755;57526;85012;114928;51186;1730;286436;26280;79921;6173;51209;80823;27286;79979;158931;9737;27035;7105;2717;11013;54470;54457;139231;401612;1678;402415;84707;51309;29935;158983;64102;80712;340543;728343;56849;9823;100529097;27018;140597;142684;3188;59353;94121;340542;2491;286527;441509,68
1,1,X,95101284,155232907,60131623,392509;23157;55998;541578;2158;55609;2556;23439;494119;8517;55859;331;3423;54830;4168;6901;5358;92002;474383;57595;51442;266740;9075;102723737;389895;84460;695;56000;644538;79649;51213;57526;100272147;728269;51186;3149;26576;474382;1730;3547;102723680;3358;8273;728695;57826;79921;83844;114824;203413;80823;2986;8862;23641;7512;79979;158763;9737;55217;8270;537;3421;11013;8450;6658;5716;4101;54457;91966;139804;441519;4100;54470;959;57631;2010;27316;54521;4534;79589;51634;728096;101928917;92129;653282;728072;9363;3920;100506164;827;84548;90293;100529097;55511;100133053;203547;139135;79836;60343;139081;51765;203522;139818;56180;27336;728458;8269;142684;7626;10046;340578;203447;63932;441509;4515;56001;4108;100130613;158798;2564;1193;79868;728075;11043;5354;56156;1260;1821;3054;84631;203562;102723631;170261;340596;441525;554;29944;2539;1478;7739;8260;100131755;57481;139170;1287;4204;65991;6170;10813;79710;26280;2316;11219;728062;6173;51209;23630;55558;2000;645188;51438;1736;255313;3654;1852;3897;727940;10857;541466;139741;56157;2182;84707;1069;154796;51309;80712;1485;159090;1774;2258;728343;9823;55285;643311;4107;203523;1831;54967;340542;89885;94121;286410;2491;84187;633;83550;4110;644353;3598;55916;340595;6594;2157;50814;9643;57187;139067;4104;203427;139728;100996648;10479;9016;55026;100528062;10178;4105;100507170;2332;6845;84968;4068;51114;64663;9142;246100;115201;100533997;79576;139212;6535;393;91851;27286;1038;158800;7224;55796;10761;100132963;1288;215;8471;90167;292;7737;55879;7319;6134;1678;401612;5063;116442;84443;29935;158983;10009;2747;2652;54885;340543;10495;27018;100129239;2239;2334;441518;26071;2664;59353;5956;728712;55922;28985;79184;441521;728049;728090;8933;10735;158521;3581;9949;4694;84528;282808;8263;9130;492;100129520;728082;90843;7411;347454;29071;9947;10134;79057;6906;340547;30014;30848;680;93380;159091;9338;8266;65109;64860;8776;494118;51566;56271;2892;55559;85012;57529;114928;8277;5365;63035;4354;286436;55086;10838;139221;139735;83692;3251;10251;139716;158931;27035;1641;100329135;7105;2717;84295;9459;5973;4109;139065;474384;6748;139760;347487;51270;4103;139378;186;139231;2719;3597;9131;9248;7547;474381;402415;11254;90161;64102;728042;56849;2273;728036;64648;54440;140597;4952;5631;83740;3188;100130086;286527;347468;347475,376
1,1,X,95498487,129063677,33565190,644353;392509;55916;3598;340595;6594;23157;55998;9643;23439;57187;203427;55859;100996648;331;55026;100528062;54830;5358;100507170;10178;9075;4068;51114;695;84460;56000;51213;57526;115201;51186;79576;1730;139212;3358;79921;203413;80823;2986;91851;8862;27286;79979;7512;9737;158800;1288;11013;7224;8450;5716;139804;54470;54457;8471;292;57631;7737;7319;54521;401612;1678;79589;653282;728072;92129;728096;5063;3920;84443;29935;158983;827;10009;2747;90293;54885;340543;27018;100529097;79836;139818;142684;59353;55922;28985;340578;203447;728049;63932;441509;728090;10735;56001;9949;4694;158798;282808;79868;84528;728075;100130613;11043;5354;56156;1821;100129520;728082;90843;347454;29071;6906;340547;203562;170261;340596;9338;65109;64860;51566;1478;56271;2892;100131755;57481;139170;85012;1287;57529;114928;6170;10813;286436;55086;139221;79710;26280;728062;6173;51209;23630;158931;27035;1641;100329135;7105;255313;2717;727940;10857;139741;56157;139231;186;2182;3597;402415;84707;154796;51309;11254;64102;80712;728042;728343;56849;9823;55285;643311;728036;54440;140597;5631;1831;4952;3188;340542;94121;2491;84187;286527,181
-1,-1,X,95729423,95845434,116011,,0
-1,-1,X,96774546,96823322,48776,1730,1
1,-1,X,96774576,96823352,48776,1730,1
-1,1,X,97624055,99779618,2155563,57526,1
-1,1,X,98266555,99564962,1298407,57526,1
-1,1,X,98495811,155233731,56737920,392509;23157;55998;541578;2158;55609;2556;23439;494119;8517;55859;331;3423;54830;4168;6901;5358;92002;474383;57595;51442;266740;9075;102723737;389895;84460;695;56000;644538;79649;51213;57526;100272147;728269;51186;3149;26576;474382;3547;102723680;3358;8273;728695;57826;79921;83844;114824;203413;80823;2986;8862;23641;7512;79979;158763;9737;55217;8270;537;3421;11013;8450;6658;5716;4101;54457;91966;139804;441519;4100;54470;959;57631;2010;27316;54521;4534;79589;51634;728096;101928917;92129;653282;728072;9363;3920;100506164;827;84548;90293;100529097;55511;100133053;203547;139135;79836;60343;139081;51765;203522;139818;56180;27336;728458;8269;142684;7626;10046;340578;203447;63932;441509;4515;56001;4108;100130613;158798;2564;1193;79868;728075;11043;5354;56156;1260;1821;3054;84631;203562;102723631;170261;340596;441525;554;29944;2539;1478;7739;8260;100131755;57481;139170;1287;4204;65991;6170;10813;79710;26280;2316;11219;728062;6173;51209;23630;55558;2000;645188;51438;1736;255313;3654;1852;3897;727940;10857;541466;139741;56157;2182;84707;1069;154796;51309;80712;1485;159090;1774;2258;728343;9823;55285;643311;4107;203523;1831;54967;340542;89885;94121;286410;2491;84187;633;83550;4110;644353;3598;55916;340595;6594;2157;50814;9643;57187;139067;4104;203427;139728;100996648;10479;9016;55026;100528062;10178;4105;100507170;2332;6845;84968;4068;51114;64663;9142;246100;115201;100533997;79576;139212;6535;393;91851;27286;1038;158800;7224;55796;10761;100132963;1288;215;8471;90167;292;7737;55879;7319;6134;1678;401612;5063;116442;84443;2652;158983;10009;2747;54885;340543;10495;27018;100129239;2239;2334;441518;26071;2664;59353;5956;728712;55922;28985;79184;441521;728049;728090;8933;10735;158521;3581;9949;4694;84528;282808;8263;9130;492;100129520;728082;90843;7411;347454;29071;9947;10134;79057;6906;340547;30014;30848;680;93380;159091;9338;8266;65109;64860;8776;494118;51566;56271;2892;55559;85012;57529;114928;8277;5365;63035;4354;286436;55086;10838;139221;139735;83692;3251;10251;139716;158931;27035;1641;100329135;7105;2717;84295;9459;5973;4109;139065;474384;6748;139760;347487;51270;4103;139378;186;139231;2719;3597;9131;9248;7547;474381;402415;11254;90161;64102;728042;56849;2273;728036;64648;54440;140597;4952;5631;83740;3188;100130086;286527;347468;347475,374
1,1,X,99611312,103506684,3895372,56001;644353;392509;282808;5354;1821;55998;9643;90843;55859;100996648;203562;100528062;9338;64860;51566;1478;56271;695;84460;56000;100131755;57526;85012;114928;51186;286436;79921;6173;51209;80823;27286;79979;158931;9737;27035;7105;2717;11013;54470;54457;139231;401612;1678;402415;84707;51309;158983;64102;80712;340543;728343;56849;9823;100529097;27018;140597;142684;3188;59353;94121;340542;2491;286527;441509,65
1,1,X,99852684,110894344,11041660,56001;644353;9949;392509;55916;282808;11043;5354;56156;55998;1821;9643;90843;6906;340547;55859;100996648;203562;100528062;54830;9338;9075;64860;51566;1478;56271;695;84460;56000;100131755;85012;1287;57529;114928;115201;51186;286436;55086;139212;139221;79710;26280;79921;6173;51209;23630;80823;2986;91851;27286;79979;158931;9737;27035;1641;7105;2717;1288;11013;5716;54470;54457;8471;56157;139231;2182;401612;1678;79589;402415;92129;84707;5063;51309;84443;827;158983;64102;80712;54885;340543;728343;56849;27018;100529097;9823;55285;140597;5631;1831;142684;3188;59353;340542;94121;2491;84187;203447;286527;441509,100
-1,1,X,100598538,100615055,16517,695;1678,2
-1,1,X,101452257,155232907,53780650,23157;541578;2158;55609;2556;23439;494119;8517;55859;331;3423;54830;4168;6901;5358;92002;474383;57595;51442;266740;9075;102723737;389895;56000;644538;79649;51213;100272147;728269;51186;3149;26576;474382;3547;102723680;3358;8273;728695;57826;79921;83844;114824;203413;80823;2986;8862;23641;7512;158763;9737;55217;8270;537;3421;11013;8450;5716;6658;4101;139804;91966;959;441519;4100;57631;2010;27316;54521;4534;79589;51634;728096;101928917;92129;653282;728072;9363;3920;100506164;827;84548;90293;55511;100133053;203547;139135;79836;60343;139081;51765;203522;139818;56180;27336;728458;8269;142684;7626;10046;340578;203447;63932;441509;4515;56001;4108;100130613;158798;2564;1193;79868;728075;11043;5354;56156;1260;3054;84631;203562;102723631;170261;340596;441525;554;29944;2539;7739;8260;57481;139170;1287;4204;65991;6170;10813;79710;26280;2316;11219;728062;51209;23630;55558;2000;645188;51438;1736;255313;3654;1852;3897;727940;10857;541466;139741;56157;2182;84707;1069;154796;80712;1485;159090;1774;2258;728343;55285;643311;4107;203523;1831;54967;89885;286410;84187;633;83550;4110;644353;3598;55916;340595;6594;2157;50814;9643;57187;139067;4104;203427;139728;100996648;10479;9016;55026;100528062;10178;4105;100507170;2332;6845;84968;4068;51114;64663;9142;246100;115201;100533997;79576;139212;6535;393;91851;1038;158800;7224;55796;10761;100132963;1288;215;8471;90167;292;7737;55879;7319;6134;401612;5063;116442;84443;2652;158983;10009;2747;340543;54885;10495;27018;100129239;2239;2334;441518;26071;2664;5956;728712;55922;28985;79184;441521;728049;728090;8933;10735;158521;3581;9949;4694;84528;282808;8263;9130;492;100129520;728082;90843;7411;347454;29071;9947;10134;79057;6906;340547;30014;30848;680;93380;159091;9338;8266;65109;64860;8776;494118;56271;2892;55559;85012;57529;114928;8277;5365;63035;4354;286436;55086;10838;139221;139735;83692;3251;10251;139716;1641;100329135;84295;9459;5973;4109;139065;474384;6748;139760;347487;51270;4103;139378;186;139231;2719;3597;9131;9248;7547;474381;11254;90161;728042;56849;2273;728036;64648;54440;4952;5631;83740;100130086;286527;347468;347475,344
1,-1,X,101596705,101693437,96732,728343,1
1,-1,X,101596705,101693437,96732,728343,1
1,1,X,102605732,103288063,682331,158983;203562;142684;27018;9338;5354;9643;79921;85012;51209;441509;286527;51186,13
1,1,X,102659333,103167860,508527,203562;142684;85012;5354;9643;79921;9338;51209;441509,9
1,1,X,102857802,103087615,229813,9643;203562;51209;441509;9338;85012;5354,7
1,1,X,102857802,103135921,278119,9643;203562;51209;441509;9338;85012;5354,7
1,1,X,103027027,103303380,276353,158983;286436;51209;286527;5354,5
1,1,X,103158718,111556067,8397349,644353;9949;55916;1641;79868;100329135;340595;11043;56156;1288;7224;5716;8471;6906;340547;56157;139231;2182;401612;79589;54830;92129;5063;9075;84443;827;158983;80712;54885;91851;55285;1287;57529;115201;5631;286436;55086;139221;79710;139212;1831;26280;84187;203447;286527;23630;2986,47
1,-1,X,103220412,103223099,2687,286527,1
1,-1,X,103220412,103269195,48783,158983;286527,2
1,-1,X,103220412,103269195,48783,158983;286527,2
-1,1,X,105371166,155232907,49861741,23157;541578;2158;55609;2556;23439;494119;8517;331;3423;474383;54830;4168;6901;5358;92002;51442;57595;266740;9075;102723737;389895;644538;51213;79649;100272147;728269;3149;26576;474382;3547;102723680;3358;8273;728695;57826;83844;114824;203413;2986;8862;23641;7512;158763;55217;8270;537;3421;8450;5716;139804;6658;4101;959;91966;441519;4100;57631;2010;27316;54521;4534;79589;51634;653282;728072;92129;728096;101928917;9363;3920;100506164;827;84548;90293;55511;100133053;203547;139135;79836;139081;203522;51765;60343;139818;56180;27336;728458;8269;7626;10046;340578;63932;4515;158798;100130613;4108;79868;1193;728075;2564;11043;56156;1260;3054;84631;102723631;170261;340596;441525;554;29944;2539;7739;8260;57481;139170;1287;4204;65991;6170;10813;79710;2316;11219;728062;23630;55558;2000;645188;51438;1736;255313;3654;1852;3897;727940;10857;541466;139741;2182;1069;154796;1485;159090;1774;2258;55285;643311;4107;203523;1831;54967;89885;286410;84187;83550;633;4110;55916;3598;340595;6594;2157;50814;57187;139067;4104;203427;139728;10479;9016;55026;100507170;10178;4105;2332;6845;84968;4068;51114;64663;9142;246100;115201;100533997;79576;139212;6535;393;91851;1038;158800;1288;7224;55796;10761;100132963;215;8471;90167;292;7737;55879;7319;6134;5063;116442;84443;2652;10009;2747;54885;10495;100129239;2239;2334;441518;26071;5956;728712;2664;55922;28985;79184;441521;728049;728090;8933;10735;158521;3581;9949;4694;84528;8263;492;9130;100129520;728082;7411;347454;29071;9947;10134;79057;340547;30014;680;30848;93380;159091;8266;65109;8776;494118;2892;55559;57529;5365;8277;63035;4354;55086;10838;139221;139735;83692;3251;10251;139716;1641;100329135;84295;9459;139065;4109;5973;474384;6748;139760;347487;51270;4103;139378;186;9131;3597;2719;7547;9248;474381;11254;90161;728042;2273;728036;64648;54440;5631;4952;83740;100130086;347468;347475,305
-1,1,X,105694656,155224707,49530051,23157;541578;2158;55609;2556;23439;494119;8517;331;3423;474383;54830;4168;6901;5358;92002;51442;57595;266740;9075;102723737;389895;644538;51213;79649;100272147;728269;3149;26576;474382;3547;102723680;3358;8273;728695;57826;83844;114824;203413;2986;8862;23641;7512;158763;55217;8270;537;3421;8450;5716;139804;6658;4101;959;91966;441519;4100;57631;2010;27316;54521;4534;79589;51634;653282;728072;92129;728096;101928917;9363;3920;100506164;827;84548;90293;55511;100133053;203547;139135;79836;139081;203522;51765;60343;139818;56180;27336;728458;8269;7626;10046;340578;63932;4515;158798;100130613;4108;79868;1193;728075;2564;11043;56156;1260;3054;84631;102723631;170261;340596;441525;554;29944;2539;7739;8260;57481;139170;1287;4204;65991;6170;10813;79710;2316;11219;728062;23630;55558;2000;645188;51438;1736;255313;3654;1852;3897;727940;10857;541466;139741;2182;1069;154796;1485;159090;1774;2258;55285;643311;4107;203523;1831;54967;89885;286410;84187;83550;633;4110;55916;3598;340595;6594;2157;50814;57187;139067;4104;203427;139728;10479;9016;55026;100507170;10178;4105;2332;6845;84968;4068;51114;64663;9142;246100;115201;100533997;79576;139212;6535;393;91851;1038;158800;1288;7224;55796;10761;100132963;215;8471;90167;292;7737;55879;7319;6134;5063;116442;84443;2652;10009;2747;54885;10495;100129239;2239;2334;441518;26071;5956;728712;2664;55922;28985;79184;441521;728049;728090;8933;10735;158521;9949;4694;84528;8263;492;9130;100129520;728082;7411;347454;29071;9947;10134;79057;340547;30014;680;30848;93380;159091;8266;65109;8776;494118;2892;55559;57529;5365;8277;63035;4354;55086;10838;139735;83692;3251;10251;139716;1641;100329135;84295;9459;139065;4109;5973;474384;6748;139760;347487;51270;4103;139378;186;9131;3597;2719;7547;9248;474381;11254;90161;728042;2273;728036;64648;54440;5631;4952;83740;100130086;347468;347475,303
-1,1,X,105708840,155232907,49524067,23157;541578;2158;55609;2556;23439;494119;8517;331;3423;474383;54830;4168;6901;5358;92002;51442;57595;266740;9075;102723737;389895;644538;51213;79649;100272147;728269;3149;26576;474382;3547;102723680;3358;8273;728695;57826;83844;114824;203413;2986;8862;23641;7512;158763;55217;8270;537;3421;8450;5716;139804;6658;4101;959;91966;441519;4100;57631;2010;27316;54521;4534;79589;51634;653282;728072;92129;728096;101928917;9363;3920;100506164;827;84548;90293;55511;100133053;203547;139135;79836;139081;203522;51765;60343;139818;56180;27336;728458;8269;7626;10046;340578;63932;4515;158798;100130613;4108;79868;1193;728075;2564;11043;56156;1260;3054;84631;102723631;170261;340596;441525;554;29944;2539;7739;8260;57481;139170;1287;4204;65991;6170;10813;79710;2316;11219;728062;23630;55558;2000;645188;51438;1736;255313;3654;1852;3897;727940;10857;541466;139741;2182;1069;154796;1485;159090;1774;2258;55285;643311;4107;203523;1831;54967;89885;286410;84187;83550;633;4110;55916;3598;340595;6594;2157;50814;57187;139067;4104;203427;139728;10479;9016;55026;100507170;10178;4105;2332;6845;84968;4068;51114;64663;9142;246100;115201;100533997;79576;139212;6535;393;91851;1038;158800;1288;7224;55796;10761;100132963;215;8471;90167;292;7737;55879;7319;6134;5063;116442;84443;2652;10009;2747;54885;10495;100129239;2239;2334;441518;26071;5956;728712;2664;55922;28985;79184;441521;728049;728090;8933;10735;158521;3581;9949;4694;84528;8263;492;9130;100129520;728082;7411;347454;29071;9947;10134;79057;340547;30014;680;30848;93380;159091;8266;65109;8776;494118;2892;55559;57529;5365;8277;63035;4354;55086;10838;139735;83692;3251;10251;139716;1641;100329135;84295;9459;139065;4109;5973;474384;6748;139760;347487;51270;4103;139378;186;9131;3597;2719;7547;9248;474381;11254;90161;728042;2273;728036;64648;54440;5631;4952;83740;100130086;347468;347475,304
-1,1,X,105965526,155233731,49268205,23157;541578;2158;55609;2556;23439;494119;8517;331;3423;474383;54830;4168;6901;5358;92002;51442;57595;266740;9075;102723737;389895;644538;51213;79649;100272147;728269;3149;26576;474382;3547;102723680;3358;8273;728695;57826;83844;114824;203413;2986;8862;23641;7512;158763;55217;8270;537;3421;8450;5716;139804;6658;4101;959;91966;441519;4100;57631;2010;27316;54521;4534;79589;51634;653282;728072;92129;728096;101928917;9363;3920;100506164;827;84548;90293;55511;100133053;203547;139135;79836;139081;203522;51765;60343;139818;56180;27336;728458;8269;7626;10046;340578;63932;4515;158798;100130613;4108;79868;1193;728075;2564;11043;56156;1260;3054;84631;102723631;170261;340596;441525;554;29944;2539;7739;8260;57481;139170;1287;4204;65991;6170;10813;79710;2316;11219;728062;23630;55558;2000;645188;51438;1736;255313;3654;1852;3897;727940;10857;541466;139741;2182;1069;154796;1485;159090;1774;2258;55285;643311;4107;203523;1831;54967;89885;286410;84187;83550;633;4110;55916;3598;340595;6594;2157;50814;57187;139067;4104;203427;139728;10479;9016;55026;100507170;10178;4105;2332;6845;84968;4068;51114;64663;9142;246100;115201;100533997;79576;139212;6535;393;91851;1038;158800;1288;7224;55796;10761;100132963;215;8471;90167;292;7737;55879;7319;6134;5063;116442;84443;2652;10009;2747;54885;10495;100129239;2239;2334;441518;26071;5956;728712;2664;55922;28985;79184;441521;728049;728090;8933;10735;158521;3581;9949;4694;84528;8263;492;9130;100129520;728082;7411;347454;29071;9947;10134;79057;340547;30014;680;30848;93380;159091;8266;65109;8776;494118;2892;55559;57529;5365;8277;63035;4354;10838;139735;83692;3251;10251;139716;1641;100329135;84295;9459;139065;4109;5973;474384;6748;139760;347487;51270;4103;139378;186;9131;3597;2719;7547;9248;474381;11254;90161;728042;2273;728036;64648;54440;5631;4952;83740;100130086;347468;347475,303
-1,1,X,107370001,110989043,3619042,9949;55916;1641;79868;1288;1287;57529;115201;8471;2182;84187;5063;2986;23630;91851;827,16
-1,1,X,110293613,155251871,44958258,23157;541578;2158;55609;2556;23439;494119;8517;331;3423;4168;6901;474383;5358;92002;57595;51442;266740;102723737;389895;644538;51213;79649;100272147;728269;3149;26576;474382;3547;102723680;3358;8273;728695;57826;83844;114824;203413;8862;23641;7512;158763;55217;8270;537;3421;8450;6658;139804;4101;959;91966;441519;4100;57631;2010;27316;54521;4534;51634;653282;728072;728096;101928917;9363;3920;100506164;827;84548;90293;55511;100133053;203547;139135;79836;139081;203522;51765;60343;139818;56180;27336;728458;8269;7626;10046;340578;63932;4515;158798;100130613;4108;79868;728075;2564;1193;1260;3054;84631;102723631;170261;340596;441525;554;29944;2539;7739;8260;57481;139170;4204;65991;6170;10813;2316;11219;728062;55558;2000;645188;51438;1736;255313;3654;1852;3897;727940;10857;541466;139741;1069;154796;1485;159090;1774;2258;643311;4107;203523;54967;89885;286410;633;83550;4110;3598;340595;6594;2157;50814;57187;139067;4104;203427;139728;10479;9016;55026;100507170;10178;4105;2332;6845;84968;4068;51114;64663;9142;246100;100533997;79576;6535;393;1038;158800;7224;55796;10761;100132963;215;90167;292;7737;55879;7319;6134;5063;116442;2652;10009;2747;10495;100129239;2239;2334;441518;26071;5956;728712;2664;55922;28985;79184;441521;728090;728049;8933;10735;158521;3581;4694;84528;8263;492;9130;100129520;728082;7411;347454;29071;9947;10134;79057;30014;680;30848;93380;159091;8266;65109;8776;494118;2892;55559;5365;8277;63035;4354;10838;139735;83692;3251;10251;139716;1641;100329135;84295;9459;139065;4109;5973;474384;6748;139760;347487;51270;4103;139378;186;9131;3597;2719;7547;9248;474381;11254;90161;728042;2273;728036;64648;54440;4952;83740;100130086;347468;347475,276
1,1,X,110561548,110591406,29858,1641,1
1,1,X,110988950,153783638,42794688,4110;3598;340595;6594;23157;50814;541578;2158;55609;2556;23439;57187;139067;494119;4104;203427;139728;8517;10479;9016;331;55026;3423;4168;6901;5358;100507170;10178;51442;4105;266740;2332;92002;102723737;389895;57595;84968;4068;51114;64663;9142;644538;51213;79649;728269;100533997;3149;26576;79576;3547;102723680;3358;8273;728695;57826;83844;114824;6535;393;203413;8862;23641;7512;158763;1038;8270;537;158800;3421;7224;55796;8450;10761;6658;139804;4101;215;959;90167;441519;91966;4100;292;57631;7737;7319;55879;2010;27316;54521;4534;51634;6134;653282;728072;728096;101928917;9363;3920;100506164;2652;10009;2747;84548;90293;10495;55511;100133053;100129239;2239;2334;203547;441518;79836;139135;139081;203522;51765;60343;139818;56180;27336;728458;8269;26071;7626;10046;728712;5956;55922;2664;28985;340578;441521;728090;728049;63932;8933;10735;158521;4694;158798;84528;100130613;79868;4108;728075;2564;492;1260;9130;100129520;728082;3054;347454;29071;9947;10134;79057;84631;30014;102723631;170261;340596;680;441525;554;93380;159091;8266;65109;8776;29944;494118;2539;2892;7739;8260;57481;139170;55559;4204;5365;8277;63035;6170;10813;10838;139735;2316;83692;3251;11219;728062;55558;2000;645188;51438;255313;100329135;3654;84295;9459;139065;4109;1852;5973;3897;6748;139760;727940;347487;10857;51270;139741;541466;139378;4103;186;9131;3597;2719;7547;9248;1069;154796;11254;90161;728042;159090;1774;2258;2273;643311;728036;64648;4107;54440;4952;203523;54967;89885;286410;100130086;633;83550;347468;347475,248
-1,1,X,112474054,155233731,42759677,23157;541578;2158;55609;2556;23439;494119;8517;331;3423;4168;6901;474383;5358;92002;57595;51442;266740;102723737;389895;644538;51213;79649;100272147;728269;3149;26576;474382;3547;102723680;3358;8273;728695;57826;83844;114824;203413;8862;23641;7512;158763;55217;8270;537;3421;8450;6658;139804;4101;959;91966;441519;4100;57631;2010;27316;54521;4534;51634;653282;728072;728096;101928917;9363;3920;100506164;84548;90293;55511;100133053;203547;139135;79836;139081;203522;51765;60343;139818;56180;27336;728458;8269;7626;10046;340578;63932;4515;158798;100130613;4108;2564;728075;1193;1260;3054;84631;102723631;170261;441525;554;29944;2539;7739;8260;57481;139170;4204;65991;6170;10813;2316;11219;728062;55558;2000;645188;51438;1736;255313;3654;1852;3897;727940;10857;541466;139741;1069;1485;159090;1774;2258;643311;4107;203523;54967;89885;286410;633;83550;4110;3598;6594;2157;50814;57187;139067;4104;203427;139728;10479;9016;55026;100507170;10178;4105;2332;6845;84968;4068;51114;64663;9142;246100;100533997;79576;6535;393;1038;158800;55796;10761;100132963;215;90167;292;7737;55879;7319;6134;116442;2652;10009;2747;10495;100129239;2239;2334;441518;26071;5956;728712;2664;55922;28985;79184;441521;728090;728049;8933;10735;158521;3581;4694;84528;8263;492;9130;100129520;728082;7411;347454;29071;9947;10134;79057;30014;680;30848;93380;159091;8266;65109;8776;494118;2892;55559;5365;8277;63035;4354;10838;139735;83692;3251;10251;139716;84295;9459;139065;4109;5973;474384;6748;139760;347487;51270;4103;139378;186;9131;3597;2719;7547;9248;474381;11254;90161;728042;2273;728036;64648;54440;4952;83740;100130086;347468;347475,267
-1,-1,X,112828750,113202825,374075,,0
1,-1,X,112841647,112968325,126678,,0
1,-1,X,113202825,113306088,103263,,0
-1,1,X,113767592,155251871,41484279,23157;541578;2158;55609;2556;23439;494119;8517;331;3423;4168;6901;474383;5358;92002;57595;51442;266740;102723737;389895;644538;51213;79649;100272147;728269;3149;26576;474382;3547;102723680;3358;8273;728695;57826;83844;114824;203413;8862;23641;7512;158763;55217;8270;537;3421;8450;6658;139804;4101;959;91966;441519;4100;57631;2010;27316;54521;4534;51634;653282;728072;728096;101928917;9363;3920;100506164;84548;90293;55511;100133053;203547;139135;79836;139081;203522;51765;60343;139818;56180;27336;728458;8269;7626;10046;340578;63932;4515;158798;100130613;4108;2564;728075;1193;1260;3054;84631;102723631;170261;441525;554;29944;2539;7739;8260;57481;139170;4204;65991;6170;10813;2316;11219;728062;55558;2000;645188;51438;1736;255313;3654;1852;3897;727940;10857;541466;139741;1069;1485;159090;1774;2258;643311;4107;203523;54967;89885;286410;633;83550;4110;3598;6594;2157;50814;57187;139067;4104;203427;139728;10479;9016;55026;100507170;10178;4105;2332;6845;84968;4068;51114;64663;9142;246100;100533997;79576;6535;393;1038;158800;55796;10761;100132963;215;90167;292;7737;55879;7319;6134;116442;2652;10009;2747;10495;100129239;2239;2334;441518;26071;5956;728712;2664;55922;28985;79184;441521;728090;728049;8933;10735;158521;3581;4694;84528;8263;492;9130;100129520;728082;7411;347454;29071;9947;10134;79057;30014;680;30848;93380;159091;8266;65109;8776;494118;2892;55559;5365;8277;63035;4354;10838;139735;83692;3251;10251;139716;84295;9459;139065;4109;5973;474384;6748;139760;347487;51270;4103;139378;186;9131;3597;2719;7547;9248;474381;11254;90161;728042;2273;728036;64648;54440;4952;83740;100130086;347468;347475,267
1,-1,X,114218436,114395542,177106,57631;3598,2
1,-1,X,114218436,114395542,177106,57631;3598,2
1,-1,X,114218436,114395542,177106,57631;3598,2
1,-1,X,114239463,114401048,161585,57631;3598,2
1,-1,X,115944547,116047048,102501,,0
1,-1,X,115944547,116047048,102501,,0
1,-1,X,115944547,116047048,102501,,0
1,-1,X,115944547,116047048,102501,,0
1,-1,X,115944547,116047048,102501,,0
1,-1,X,115944547,116047048,102501,,0
1,-1,X,115944547,116047048,102501,,0
-1,-1,X,116105972,116162380,56408,,0
-1,-1,X,116141925,116195097,53172,,0
-1,-1,X,116338320,116394255,55935,,0
1,1,X,116394255,139283477,22889222,10735;4694;158798;84528;100130613;728075;6594;23157;100129520;2158;728082;55609;23439;57187;347454;29071;203427;347475;102723631;10479;170261;9016;331;55026;680;4168;93380;100507170;10178;51442;159091;65109;102723737;389895;4068;51114;2892;644538;79649;57481;139170;79576;63035;6170;10813;3547;102723680;3251;57826;83844;728062;8862;7512;158763;2000;255313;158800;84295;55796;10761;8450;9459;959;90167;441519;139760;727940;292;347487;10857;7737;51270;7319;139741;541466;139378;27316;54521;9131;51634;3597;2719;7547;653282;728072;728096;728049;9363;3920;10009;2747;90161;347468;90293;728042;159090;2258;10495;55511;2273;2239;643311;728036;441518;79836;203522;51765;139818;56180;27336;54440;4952;203523;26071;7626;54967;55922;286410;28985;340578;83550;441521;728090;63932;8933,125
-1,-1,X,116409787,116466743,56956,,0
-1,1,X,116621104,155233731,38612627,23157;541578;2158;55609;2556;23439;494119;8517;331;3423;4168;6901;474383;92002;57595;51442;266740;102723737;389895;644538;79649;100272147;728269;3149;26576;474382;3547;102723680;8273;728695;57826;83844;114824;8862;23641;7512;158763;55217;8270;537;3421;8450;6658;4101;959;91966;441519;4100;2010;27316;54521;4534;51634;653282;728072;728096;101928917;9363;3920;100506164;84548;90293;55511;100133053;203547;139135;79836;139081;203522;51765;60343;139818;56180;27336;728458;8269;7626;10046;340578;63932;4515;158798;100130613;4108;2564;728075;1193;1260;3054;84631;102723631;170261;441525;554;29944;2539;7739;8260;57481;139170;4204;65991;6170;10813;2316;11219;728062;55558;2000;645188;51438;1736;255313;3654;1852;3897;727940;10857;541466;139741;1069;1485;159090;1774;2258;643311;4107;203523;54967;89885;286410;633;83550;4110;6594;2157;50814;57187;139067;4104;203427;139728;10479;9016;55026;100507170;10178;4105;2332;6845;84968;4068;51114;64663;9142;246100;100533997;79576;6535;393;1038;158800;55796;10761;100132963;215;90167;292;7737;55879;7319;6134;116442;2652;10009;2747;10495;100129239;2239;2334;441518;26071;5956;728712;2664;55922;28985;79184;441521;728090;728049;8933;10735;158521;3581;4694;84528;8263;492;9130;100129520;728082;7411;347454;29071;9947;10134;79057;30014;680;30848;93380;159091;8266;65109;8776;494118;2892;55559;5365;8277;63035;4354;10838;139735;83692;3251;10251;139716;84295;9459;139065;4109;5973;474384;6748;139760;347487;51270;4103;139378;9131;3597;2719;7547;9248;474381;90161;728042;2273;728036;64648;54440;4952;83740;100130086;347468;347475,258
1,-1,X,117856805,118042000,185195,170261;3597,2
-1,1,X,117990537,155233731,37243194,4110;6594;23157;2157;50814;541578;2158;55609;2556;23439;57187;139067;494119;4104;203427;139728;8517;10479;9016;331;55026;3423;4168;6901;474383;100507170;10178;51442;4105;266740;2332;92002;102723737;389895;57595;6845;84968;4068;51114;64663;9142;246100;644538;79649;100272147;728269;100533997;3149;26576;79576;474382;3547;102723680;8273;728695;57826;83844;114824;6535;393;8862;23641;7512;158763;1038;55217;8270;537;158800;3421;55796;10761;8450;100132963;6658;4101;215;959;90167;441519;91966;4100;292;7737;55879;7319;2010;27316;4534;51634;6134;653282;728072;728096;101928917;9363;116442;3920;100506164;2652;10009;2747;84548;10495;55511;100133053;100129239;2239;2334;203547;441518;79836;139135;139081;203522;51765;60343;27336;56180;728458;8269;26071;7626;10046;728712;5956;55922;2664;28985;340578;79184;441521;728090;728049;63932;4515;8933;10735;158521;3581;4694;158798;84528;100130613;4108;728075;2564;8263;492;1260;9130;1193;100129520;728082;3054;7411;347454;29071;9947;10134;79057;84631;30014;102723631;680;441525;554;30848;93380;159091;8266;65109;8776;29944;494118;2539;2892;7739;8260;57481;139170;55559;4204;65991;5365;8277;63035;6170;4354;10813;10838;139735;2316;83692;3251;11219;728062;10251;55558;139716;2000;645188;51438;1736;255313;3654;84295;9459;139065;4109;1852;5973;3897;474384;6748;139760;727940;347487;10857;51270;139741;541466;139378;4103;9131;2719;7547;9248;474381;1069;90161;1485;728042;159090;1774;2258;2273;643311;728036;64648;4107;54440;4952;203523;83740;54967;89885;286410;100130086;633;83550;347468;347475,253
-1,1,X,118431633,155233731,36802098,4110;6594;23157;2157;50814;541578;2158;55609;2556;23439;57187;139067;494119;4104;203427;139728;8517;10479;9016;331;55026;3423;4168;6901;474383;100507170;10178;51442;4105;266740;2332;92002;102723737;389895;57595;6845;84968;4068;51114;64663;9142;246100;644538;79649;100272147;728269;100533997;3149;26576;79576;474382;3547;102723680;8273;728695;57826;83844;114824;6535;393;8862;23641;7512;158763;1038;55217;8270;537;158800;3421;55796;10761;8450;100132963;6658;4101;215;959;90167;441519;91966;4100;292;7737;55879;7319;2010;27316;4534;51634;6134;653282;728072;728096;101928917;9363;116442;3920;100506164;2652;10009;2747;84548;10495;55511;100133053;100129239;2239;2334;203547;441518;139135;139081;203522;51765;60343;27336;56180;728458;8269;26071;7626;10046;728712;5956;55922;2664;28985;340578;79184;441521;728090;728049;63932;4515;8933;10735;158521;3581;4694;158798;84528;100130613;4108;728075;2564;8263;492;1260;9130;1193;100129520;728082;3054;7411;347454;29071;9947;10134;79057;84631;30014;102723631;680;441525;554;30848;93380;159091;8266;65109;8776;29944;494118;2539;2892;7739;8260;139170;55559;4204;65991;5365;8277;63035;6170;4354;10813;10838;139735;2316;83692;3251;11219;728062;10251;55558;139716;2000;645188;51438;1736;255313;3654;84295;9459;139065;4109;1852;5973;3897;474384;6748;139760;727940;347487;51270;541466;139741;4103;139378;9131;2719;7547;9248;474381;1069;90161;1485;728042;159090;1774;2258;2273;643311;728036;64648;4107;54440;4952;203523;83740;54967;89885;286410;100130086;633;83550;347468;347475,250
-1,-1,X,120968146,121033911,65765,,0
-1,-1,X,121480340,121526377,46037,,0
1,1,X,122607629,122727785,120156,2892,1
-1,1,X,122927376,155251871,32324495,4110;6594;2157;50814;541578;2158;55609;2556;139067;4104;494119;139728;8517;10479;9016;331;3423;4168;6901;474383;10178;4105;51442;92002;266740;2332;57595;102723737;389895;6845;84968;4068;51114;64663;9142;246100;644538;79649;100272147;728269;100533997;3149;26576;474382;3547;102723680;8273;728695;57826;83844;114824;6535;393;8862;23641;7512;158763;1038;55217;8270;537;3421;55796;10761;100132963;6658;4101;215;959;90167;441519;91966;4100;55879;2010;27316;4534;51634;6134;101928917;9363;116442;100506164;2652;84548;10495;55511;100133053;100129239;2239;2334;203547;441518;139135;139081;203522;51765;60343;27336;56180;728458;8269;26071;7626;10046;728712;5956;2664;340578;79184;441521;4515;8933;10735;158521;3581;4108;100130613;2564;8263;1193;492;1260;9130;100129520;3054;7411;9947;10134;79057;84631;30014;102723631;680;441525;554;30848;93380;159091;8266;8776;29944;494118;2539;7739;8260;139170;55559;4204;65991;5365;8277;63035;4354;10813;10838;139735;2316;83692;3251;11219;10251;55558;139716;2000;645188;51438;1736;3654;84295;9459;139065;4109;1852;5973;3897;474384;6748;139760;347487;51270;541466;139741;4103;139378;9131;2719;7547;9248;474381;1069;90161;1485;159090;1774;2258;2273;64648;4107;54440;4952;203523;83740;54967;89885;286410;100130086;633;83550;347468;347475,211
1,1,X,122992947,127851125,4858178,10735;4068;139741;100130613;331;100129520;340578;139170;10178,9
-1,-1,X,124807304,124875430,68126,,0
-1,-1,X,125101992,125287185,185193,,0
-1,-1,X,125191679,125301888,110209,340578,1
-1,-1,X,125191679,125301888,110209,340578,1
1,-1,X,125325276,125360226,34950,,0
-1,-1,X,126152297,126345993,193696,,0
-1,-1,X,126223902,126583848,359946,,0
1,1,X,126307810,131646710,5338900,7512;158763;51114;2000;10495;6594;55796;55609;139760;90167;51765;63035;54440;139741;10813;4952;3547;9016;9131;51634;57826;347468;9363;8862,24
-1,-1,X,126550521,126707466,156945,,0
-1,-1,X,126640473,126707466,66993,,0
-1,1,X,126773628,155233731,28460103,4110;6594;2157;50814;541578;2158;55609;2556;139067;4104;494119;139728;8517;10479;9016;3423;4168;6901;474383;92002;4105;51442;57595;266740;2332;6845;102723737;389895;84968;51114;64663;9142;246100;644538;79649;100272147;728269;100533997;3149;26576;474382;3547;102723680;8273;728695;57826;83844;114824;6535;393;23641;8862;7512;158763;1038;55217;8270;537;3421;55796;10761;100132963;6658;4101;215;959;90167;441519;91966;4100;55879;2010;27316;4534;51634;6134;101928917;9363;116442;100506164;2652;84548;10495;55511;100133053;100129239;2239;2334;203547;441518;139135;139081;203522;51765;60343;27336;56180;728458;8269;26071;7626;10046;728712;5956;2664;79184;441521;4515;8933;158521;3581;4108;2564;8263;1193;492;1260;9130;3054;7411;9947;10134;79057;84631;30014;102723631;680;441525;554;30848;93380;159091;8266;8776;29944;494118;2539;7739;8260;55559;4204;65991;5365;8277;63035;4354;10813;10838;139735;2316;83692;3251;11219;10251;55558;139716;2000;645188;51438;1736;3654;84295;9459;139065;4109;1852;5973;3897;474384;6748;139760;347487;51270;541466;139741;4103;139378;9131;2719;7547;9248;474381;1069;90161;1485;159090;1774;2258;2273;64648;4107;54440;4952;203523;83740;54967;89885;286410;100130086;633;83550;347468;347475,203
-1,-1,X,127330420,127572796,242376,,0
-1,1,X,127607213,155232894,27625681,4110;6594;2157;50814;541578;2158;55609;2556;139067;4104;494119;139728;8517;10479;9016;3423;4168;6901;474383;92002;4105;51442;57595;266740;2332;6845;102723737;389895;84968;51114;64663;9142;246100;644538;79649;100272147;728269;100533997;3149;26576;474382;3547;102723680;8273;728695;57826;83844;114824;6535;393;23641;8862;7512;158763;1038;55217;8270;537;3421;55796;10761;100132963;6658;4101;215;959;90167;441519;91966;4100;55879;2010;27316;4534;51634;6134;101928917;9363;116442;100506164;2652;84548;10495;55511;100133053;100129239;2239;2334;203547;441518;139135;139081;203522;51765;60343;27336;56180;728458;8269;26071;7626;10046;728712;5956;2664;79184;441521;4515;8933;158521;3581;4108;2564;8263;1193;492;1260;9130;3054;7411;9947;10134;79057;84631;30014;102723631;680;441525;554;30848;93380;159091;8266;8776;29944;494118;2539;7739;8260;55559;4204;65991;5365;8277;63035;4354;10813;10838;139735;2316;83692;3251;11219;10251;55558;139716;2000;645188;51438;1736;3654;84295;9459;139065;4109;1852;5973;3897;474384;6748;139760;347487;51270;541466;4103;139378;9131;2719;7547;9248;474381;1069;90161;1485;159090;1774;2258;2273;64648;4107;54440;4952;203523;83740;54967;89885;286410;100130086;633;83550;347468;347475,202
1,-1,X,127913672,127993055,79383,,0
1,-1,X,128674689,128674924,235,4952,1
1,-1,X,130769212,130813232,44020,,0
1,-1,X,130769212,130813232,44020,,0
1,-1,X,130918053,130969915,51862,,0
-1,1,X,132821337,133224500,403163,2719,1
-1,1,X,133081342,135086194,2004852,159090;644538;55511;84295;10761;441518;441519;203522;56180;541466;203523;102723631;10479;26071;54967;2719;7626;102723680;93380;3251;8933;159091;441521;102723737;347475,25
1,1,X,133944147,155233731,21289584,4110;2157;50814;541578;2158;2556;139067;4104;494119;139728;8517;10479;3423;4168;6901;474383;92002;4105;51442;57595;266740;2332;6845;102723737;389895;84968;64663;9142;246100;644538;79649;100272147;728269;100533997;3149;26576;474382;102723680;8273;728695;6535;114824;393;23641;1038;55217;8270;537;3421;100132963;6658;4101;215;959;91966;441519;4100;55879;2010;27316;4534;6134;101928917;116442;100506164;2652;84548;55511;100133053;100129239;2334;203547;441518;139135;139081;203522;60343;27336;56180;728458;8269;26071;7626;10046;728712;5956;2664;79184;441521;4515;8933;158521;3581;4108;2564;8263;1193;492;1260;9130;3054;7411;9947;10134;79057;84631;30014;102723631;680;441525;554;30848;93380;159091;8266;8776;29944;494118;2539;7739;8260;55559;4204;65991;5365;8277;4354;10838;139735;2316;83692;11219;10251;55558;139716;645188;51438;1736;3654;9459;139065;4109;1852;5973;3897;474384;6748;347487;541466;4103;139378;7547;474381;9248;1069;1485;1774;2258;2273;64648;4107;203523;83740;54967;89885;286410;100130086;633;83550,169
-1,1,X,134114063,155233731,21119668,4110;2157;50814;541578;2158;2556;139067;4104;494119;139728;8517;10479;3423;4168;6901;474383;92002;4105;51442;57595;266740;2332;6845;102723737;389895;84968;64663;9142;246100;644538;79649;100272147;728269;100533997;3149;26576;474382;102723680;8273;728695;6535;114824;393;23641;1038;55217;8270;537;3421;100132963;6658;4101;215;959;91966;441519;4100;55879;2010;27316;4534;6134;101928917;116442;100506164;2652;84548;55511;100133053;100129239;2334;203547;441518;139135;139081;203522;60343;27336;728458;8269;26071;7626;10046;728712;5956;2664;79184;441521;4515;8933;158521;3581;4108;2564;8263;1193;492;1260;9130;3054;7411;9947;10134;79057;84631;30014;102723631;680;441525;554;30848;93380;8266;8776;29944;494118;2539;7739;8260;55559;4204;65991;5365;8277;4354;10838;139735;2316;83692;11219;10251;55558;139716;645188;51438;1736;3654;9459;139065;4109;1852;5973;3897;474384;6748;347487;541466;4103;139378;7547;474381;9248;1069;1485;1774;2258;2273;64648;4107;203523;83740;54967;89885;286410;100130086;633;83550,167
1,-1,X,134215720,134372869,157149,54967,1
1,-1,X,134293036,134330110,37074,54967,1
1,-1,X,134427695,134613879,186184,7626;203523,2
1,-1,X,134674526,134725220,50694,203522,1
1,-1,X,134725220,134910134,184914,441521;541466;441519,3
-1,1,X,136201142,155232907,19031765,4110;2157;50814;541578;2158;2556;139067;4104;494119;139728;8517;3423;4168;6901;474383;92002;4105;57595;266740;2332;6845;389895;84968;64663;9142;246100;100272147;728269;100533997;3149;26576;474382;8273;728695;6535;114824;393;23641;1038;55217;8270;537;3421;100132963;6658;4101;215;91966;4100;55879;2010;4534;6134;101928917;116442;100506164;2652;84548;100133053;100129239;2334;203547;139135;139081;60343;728458;8269;10046;728712;5956;2664;79184;4515;158521;3581;4108;2564;8263;1193;492;1260;9130;3054;7411;9947;10134;79057;84631;30014;30848;441525;554;8266;8776;29944;494118;2539;7739;8260;55559;4204;65991;5365;8277;4354;10838;139735;2316;83692;11219;10251;55558;139716;645188;51438;1736;3654;5973;139065;4109;1852;3897;474384;6748;347487;4103;7547;474381;9248;1069;1485;1774;2258;64648;4107;83740;89885;286410;100130086;633,140
1,-1,X,136260894,136371994,111100,,0
-1,1,X,138415183,155208354,16793171,4110;2157;50814;541578;2158;2556;139067;4104;494119;139728;8517;3423;4168;6901;474383;92002;4105;57595;266740;2332;6845;389895;84968;64663;9142;246100;100272147;728269;100533997;3149;26576;474382;8273;728695;6535;114824;393;23641;1038;55217;8270;537;3421;100132963;6658;4101;215;91966;4100;55879;2010;4534;6134;101928917;116442;100506164;2652;84548;100133053;100129239;2334;203547;139135;139081;60343;728458;8269;10046;728712;5956;2664;79184;4515;158521;4108;2564;8263;1193;492;1260;9130;3054;7411;9947;10134;79057;84631;30014;30848;441525;554;8266;8776;29944;494118;2539;7739;8260;55559;4204;65991;5365;8277;4354;10838;139735;2316;83692;11219;10251;55558;139716;645188;51438;1736;3654;5973;139065;4109;1852;3897;474384;6748;347487;4103;474381;9248;1069;1485;1774;64648;4107;83740;89885;286410;100130086;633,137
-1,1,X,138613087,155232894,16619807,4110;2157;50814;541578;2158;2556;139067;4104;494119;139728;8517;3423;4168;6901;474383;92002;4105;57595;266740;2332;6845;389895;84968;64663;9142;246100;100272147;728269;100533997;3149;26576;474382;8273;728695;6535;114824;393;23641;1038;55217;8270;537;3421;100132963;6658;4101;215;91966;4100;55879;2010;4534;6134;101928917;116442;100506164;2652;84548;100133053;100129239;2334;203547;139135;139081;60343;728458;8269;10046;728712;5956;2664;79184;4515;158521;3581;4108;2564;8263;1193;492;1260;9130;3054;7411;9947;10134;79057;84631;30014;30848;441525;554;8266;8776;29944;494118;2539;7739;8260;55559;4204;65991;5365;8277;4354;10838;139735;2316;83692;11219;10251;55558;139716;645188;51438;1736;3654;5973;139065;4109;1852;3897;474384;6748;347487;4103;474381;9248;1069;1485;1774;64648;4107;83740;89885;286410;100130086;633,138
1,1,X,139865555,154785891,14920336,4110;2157;50814;541578;2556;139067;4104;494119;139728;8517;3423;6901;474383;92002;4105;57595;266740;2332;84968;64663;9142;246100;100272147;728269;100533997;3149;26576;474382;8273;728695;6535;114824;393;23641;1038;55217;8270;537;3421;100132963;4101;215;91966;4100;55879;2010;4534;6134;101928917;116442;100506164;2652;84548;100133053;100129239;2334;203547;139135;139081;60343;728458;8269;10046;728712;5956;2664;79184;4515;158521;4108;2564;8263;1193;492;1260;9130;3054;7411;9947;10134;79057;84631;30014;30848;441525;554;8266;8776;29944;494118;2539;7739;8260;55559;4204;65991;5365;8277;4354;10838;139735;2316;83692;11219;55558;139716;645188;51438;1736;3654;5973;139065;4109;1852;3897;474384;6748;4103;474381;9248;1069;1485;1774;64648;4107;83740;89885;100130086;633,129
-1,-1,X,139973117,140020798,47681,,0
-1,-1,X,140084056,140649779,565723,728695;64663;23641,3
1,-1,X,140296053,140591220,295167,64663,1
-1,-1,X,140353121,140559832,206711,,0
-1,-1,X,140353121,140559832,206711,,0
-1,-1,X,140353121,140649779,296658,,0
-1,-1,X,140353121,140649779,296658,,0
-1,-1,X,140353121,140649779,296658,,0
-1,-1,X,140353121,140764153,411032,728712;30014;645188,3
-1,-1,X,140353121,140764153,411032,728712;30014;645188,3
-1,-1,X,140308067,140988326,680259,139081;30014;64663;64648;645188;728712,6
1,-1,X,140352891,140557758,204867,,0
-1,-1,X,140353091,140557617,204526,,0
1,-1,X,140353091,140557617,204526,,0
-1,1,X,140738414,155251871,14513457,158521;3581;4110;4108;2564;8263;1193;492;1260;2157;50814;541578;9130;2556;139067;4104;494119;3054;7411;9947;10134;139728;79057;84631;8517;30848;441525;3423;554;6901;474383;92002;4105;57595;8266;266740;2332;6845;8776;29944;84968;494118;2539;9142;246100;7739;8260;55559;4204;100272147;728269;100533997;65991;3149;5365;26576;8277;4354;474382;10838;139735;2316;8273;83692;6535;114824;393;11219;10251;55558;139716;1736;51438;55217;8270;3654;537;3421;100132963;5973;139065;4109;1852;3897;4101;215;91966;474384;6748;4100;55879;4103;2010;4534;6134;474381;9248;101928917;1069;116442;100506164;2652;84548;1485;1774;100133053;100129239;2334;203547;139135;64648;139081;60343;4107;728458;8269;83740;89885;10046;5956;2664;100130086;633;79184;4515,125
-1,1,X,141689794,147944759,6254965,494118;84631;158521;9142;441525;100133053;100129239;139065;2334;139067;2332;494119,12
-1,1,X,142641674,155232894,12591220,158521;3581;4110;4108;2564;8263;1193;492;1260;2157;50814;541578;9130;2556;3054;4104;494119;7411;10134;79057;139728;84631;8517;30848;3423;554;6901;474383;92002;4105;57595;8266;266740;2332;6845;8776;29944;84968;494118;2539;9142;246100;7739;8260;55559;4204;100272147;728269;100533997;65991;3149;5365;26576;8277;4354;474382;10838;139735;2316;8273;83692;6535;114824;393;11219;10251;55558;139716;1736;55217;8270;3654;537;3421;100132963;5973;139065;4109;1852;3897;4101;215;91966;474384;6748;4100;55879;4103;2010;4534;6134;474381;9248;101928917;1069;116442;100506164;2652;84548;1485;1774;100133053;100129239;2334;203547;139135;60343;4107;728458;8269;83740;89885;10046;5956;2664;100130086;633;79184;4515,119
1,1,X,142899598,155260560,12360962,158521;3581;4110;4108;2564;8263;1193;492;1260;2157;50814;541578;9130;2556;3054;4104;7411;10134;79057;139728;84631;8517;30848;3423;554;6901;474383;92002;4105;57595;8266;266740;2332;6845;8776;29944;84968;494118;2539;9142;246100;7739;8260;55559;4204;100272147;728269;100533997;65991;3149;5365;26576;8277;4354;474382;10838;139735;2316;8273;83692;6535;114824;393;11219;10251;55558;139716;1736;55217;8270;3654;537;3421;100132963;5973;4109;1852;3897;4101;215;91966;474384;6748;4100;55879;4103;2010;4534;6134;474381;9248;101928917;1069;116442;100506164;2652;84548;1485;1774;100129239;100133053;2334;203547;139135;60343;4107;728458;8269;83740;89885;10046;5956;2664;100130086;633;79184;4515,117
1,-1,X,143366681,143570340,203659,,0
1,-1,X,143378614,143615265,236651,,0
1,-1,X,143436117,143485415,49298,,0
1,-1,X,143756944,143843203,86259,,0
-1,-1,X,144342100,144478571,136471,,0
1,-1,X,146050508,146122279,71771,,0
-1,1,X,146232592,155233731,9001139,158521;3581;4110;4108;2564;8263;1193;492;1260;2157;50814;541578;9130;2556;3054;4104;7411;10134;79057;139728;8517;30848;3423;554;6901;474383;92002;4105;57595;8266;266740;2332;6845;8776;29944;84968;2539;246100;7739;8260;55559;4204;100272147;728269;100533997;65991;3149;5365;26576;8277;4354;474382;10838;139735;2316;8273;83692;6535;114824;393;11219;10251;55558;139716;1736;55217;8270;3654;537;3421;100132963;5973;4109;1852;3897;4101;215;91966;474384;6748;4100;55879;4103;2010;4534;6134;474381;9248;101928917;1069;116442;100506164;2652;84548;1485;1774;2334;203547;139135;60343;4107;728458;8269;83740;89885;10046;5956;2664;100130086;633;79184;4515,112
1,1,X,146715565,154664396,7948831,158521;4110;4108;2564;8263;1193;492;1260;2157;50814;541578;9130;2556;3054;4104;7411;10134;79057;139728;8517;30848;3423;554;6901;474383;92002;4105;57595;8266;266740;2332;8776;29944;84968;2539;246100;7739;8260;55559;4204;100272147;728269;100533997;65991;3149;5365;26576;8277;4354;474382;10838;139735;2316;8273;83692;6535;114824;393;11219;55558;139716;1736;8270;3654;537;3421;100132963;5973;4109;1852;3897;4101;215;91966;6748;4100;55879;4103;2010;4534;6134;474381;9248;101928917;1069;116442;100506164;2652;84548;1485;1774;2334;203547;139135;60343;4107;728458;8269;89885;10046;5956;2664;100130086;633;79184;4515,106
1,1,X,146715565,154664396,7948831,158521;4110;4108;2564;8263;1193;492;1260;2157;50814;541578;9130;2556;3054;4104;7411;10134;79057;139728;8517;30848;3423;554;6901;474383;92002;4105;57595;8266;266740;2332;8776;29944;84968;2539;246100;7739;8260;55559;4204;100272147;728269;100533997;65991;3149;5365;26576;8277;4354;474382;10838;139735;2316;8273;83692;6535;114824;393;11219;55558;139716;1736;8270;3654;537;3421;100132963;5973;4109;1852;3897;4101;215;91966;6748;4100;55879;4103;2010;4534;6134;474381;9248;101928917;1069;116442;100506164;2652;84548;1485;1774;2334;203547;139135;60343;4107;728458;8269;89885;10046;5956;2664;100130086;633;79184;4515,106
-1,1,X,146750503,147319132,568629,2332;158521,2
-1,1,X,146989853,146993413,3560,,0
-1,1,X,147573612,147620560,46948,2334,1
-1,1,X,148555685,148587685,32000,3423,1
-1,-1,X,148644765,148651627,6862,,0
-1,-1,X,148644765,148651627,6862,,0
1,-1,X,148684071,148734910,50839,84548,1
1,-1,X,148705057,148830445,125388,84548;4110,2
1,-1,X,148878834,149084873,206039,4107,1
1,1,X,148956425,154664314,5707889,2564;8263;1193;492;1260;2157;50814;541578;9130;2556;3054;4104;7411;10134;79057;139728;8517;30848;554;6901;474383;92002;4105;57595;8266;266740;8776;29944;84968;2539;246100;7739;8260;55559;4204;100272147;100533997;65991;3149;5365;26576;8277;4354;474382;10838;139735;2316;8273;83692;6535;114824;393;11219;55558;139716;1736;8270;3654;537;3421;100132963;5973;4109;1852;3897;4101;215;6748;4100;55879;4103;2010;4534;6134;474381;9248;1069;116442;2652;1485;1774;203547;139135;60343;4107;728458;8269;89885;10046;5956;2664;633;79184;4515,94
1,-1,X,149436538,149504964,68426,,0
-1,1,X,150253008,155233731,4980723,3581;2564;8263;1193;492;1260;2157;50814;9130;2556;3054;4104;7411;10134;79057;139728;8517;30848;554;6901;474383;92002;4105;57595;8266;266740;6845;29944;84968;2539;246100;7739;8260;55559;4204;100272147;100533997;65991;5365;8277;26576;4354;474382;10838;139735;2316;8273;6535;114824;393;11219;10251;55558;139716;1736;55217;8270;3654;537;3421;100132963;5973;4109;1852;3897;4101;215;474384;6748;4100;55879;4103;2010;474381;6134;9248;1069;116442;2652;1485;1774;203547;139135;60343;728458;8269;83740;89885;5956;2664;633;79184;4515,93
1,1,X,150328134,151314272,986138,4103;2564;89885;1260;9248;4109;203547;139135;4104;100533997;79057,11
-1,1,X,150919335,154751965,3832630,2564;8263;1193;492;9130;2157;50814;2556;3054;4104;7411;10134;139728;8517;30848;554;6901;474383;92002;4105;57595;8266;266740;29944;84968;2539;246100;7739;8260;55559;4204;100272147;100533997;65991;5365;8277;26576;4354;474382;10838;139735;2316;8273;6535;114824;393;11219;55558;139716;1736;55217;8270;3654;537;3421;100132963;5973;4109;1852;3897;4101;215;474384;6748;4100;55879;4103;2010;474381;6134;1069;116442;2652;1485;1774;60343;728458;8269;83740;5956;2664;633;79184;4515,84
1,1,X,151201777,154741703,3539926,8263;1193;492;9130;2157;50814;2556;3054;4104;7411;10134;139728;8517;30848;554;6901;474383;92002;4105;57595;8266;266740;29944;84968;2539;246100;7739;8260;55559;4204;100272147;100533997;65991;5365;8277;26576;4354;474382;10838;139735;2316;8273;6535;114824;393;11219;55558;139716;1736;55217;8270;3654;537;3421;100132963;5973;4109;1852;3897;4101;215;474384;6748;4100;55879;2010;474381;6134;1069;116442;2652;1485;1774;60343;728458;8269;83740;5956;2664;633;79184;4515,82
-1,1,X,151311551,155233731,3922180,3581;8263;1193;492;9130;2157;50814;2556;3054;7411;10134;139728;8517;30848;554;6901;474383;92002;4105;57595;8266;266740;6845;29944;84968;2539;246100;7739;8260;55559;4204;100272147;65991;5365;8277;26576;4354;474382;10838;139735;2316;8273;6535;114824;393;11219;10251;55558;139716;1736;55217;8270;3654;537;3421;100132963;5973;1852;3897;4101;215;474384;6748;4100;55879;2010;474381;6134;1069;116442;2652;1485;1774;60343;728458;8269;83740;5956;2664;633;79184;4515,82
-1,1,X,151539534,151734489,194955,2556,1
-1,1,X,151963528,155233731,3270203,3581;8263;1193;492;9130;2157;50814;3054;7411;10134;139728;8517;30848;554;6901;474383;92002;57595;8266;6845;29944;84968;2539;246100;7739;8260;55559;4204;100272147;65991;5365;8277;26576;4354;474382;10838;139735;2316;8273;6535;114824;393;11219;10251;55558;139716;1736;55217;8270;3654;537;3421;100132963;5973;1852;3897;215;474384;6748;4100;2010;474381;6134;1069;116442;2652;1485;1774;60343;728458;8269;83740;5956;2664;633;79184;4515,77
1,1,X,152228560,154930047,2701487,8263;1193;492;9130;2157;3054;7411;10134;139728;8517;30848;554;6901;474383;92002;57595;8266;29944;84968;2539;246100;8260;55559;4204;100272147;65991;5365;8277;26576;4354;474382;10838;139735;2316;8273;6535;11219;393;10251;55558;139716;1736;55217;8270;3654;537;3421;5973;100132963;1852;3897;215;474384;6748;4100;2010;474381;6134;116442;2652;1485;1774;60343;728458;8269;83740;5956;2664;633;79184;4515,71
1,1,X,152465185,155232907,2767722,3581;8263;1193;492;9130;2157;3054;7411;10134;139728;8517;30848;554;6901;474383;92002;57595;8266;6845;2539;246100;8260;55559;4204;100272147;65991;5365;8277;26576;4354;474382;10838;139735;2316;8273;6535;11219;393;10251;55558;139716;1736;55217;8270;3654;537;3421;5973;100132963;1852;3897;215;474384;6748;4100;2010;474381;6134;116442;2652;1485;1774;60343;728458;8269;83740;5956;2664;633;79184;4515,71
1,1,X,152568327,153832724,1264397,55558;8270;492;3654;537;9130;3421;5973;1852;3897;215;3054;6748;10134;139728;2010;8517;6134;554;6901;92002;57595;8266;2652;2539;1774;246100;8260;55559;4204;60343;5365;8277;26576;728458;10838;8269;5956;2664;139735;2316;8273;6535;633;11219;393,46
1,1,X,152716809,153496099,779290,492;3654;8260;3421;5973;1852;55559;3897;4204;3054;215;6748;10134;5365;139728;26576;728458;8269;5956;554;6535;92002;57595;633;393;2652,26
1,1,X,152864376,154751965,1887589,55558;139716;1736;8263;1193;55217;8270;3654;9130;537;2157;3421;5973;100132963;1852;3897;3054;215;6748;7411;474384;10134;139728;2010;8517;30848;6134;554;474381;6901;474383;92002;57595;8266;116442;2652;2539;1485;1774;246100;8260;4204;100272147;60343;65991;5365;8277;26576;4354;728458;474382;8269;83740;5956;2664;2316;8273;6535;393;79184;4515,61
1,1,X,152886474,153368990,482516,3654;8260;3421;5973;1852;3897;4204;3054;215;6748;10134;5365;139728;26576;8269;554;6535;57595;393,19
1,1,X,152899437,153624564,725127,3654;8260;3421;5973;1852;3897;4204;3054;215;6748;10134;5365;139728;8277;26576;728458;2010;8269;5956;2316;554;6535;57595;393;2652,25
1,1,X,152932487,153333945,401458,8260;3654;3421;5973;3897;4204;3054;215;6748;5365;10134;139728;26576;8269;554;6535;57595;393,18
1,-1,X,152955274,152955898,624,6535,1
1,-1,X,152955274,152956990,1716,6535,1
1,1,X,152964386,153333945,369559,8260;3654;3421;5973;3897;4204;3054;215;6748;5365;10134;26576;8269;554;393;57595,16
1,1,X,152970475,153524157,553682,3654;8260;3421;5973;3897;4204;3054;215;6748;10134;8277;5365;26576;728458;8269;5956;554;393;57595;2652,20
1,1,X,153068282,153523170,454888,728458;8269;5956;8260;3654;554;5973;393;57595;3897;4204;3054;2652,13
1,1,X,153079349,153333945,254596,8269;8260;3654;554;5973;393;57595;3897;4204;3054,10
1,1,X,153079349,153611431,532082,8260;3654;5973;3897;4204;3054;8277;728458;2010;8269;5956;2316;554;393;57595;2652,16
1,1,X,153097608,153681801,584193,1774;3654;9130;537;8260;5973;3897;4204;3054;8277;728458;2010;8269;5956;2664;6134;554;2316;6901;393;2652,21
1,1,X,153120607,153333945,213338,8269;8260;3654;554;5973;393;3897;4204;3054,9
1,1,X,153126904,153333945,207041,8269;8260;3654;554;5973;393;3897;4204;3054,9
-1,1,X,153126942,153143271,16329,3897,1
1,-1,X,153169608,153170664,1056,554,1
1,1,X,153253477,153438781,185304,4204;5956;3654,3
-1,1,X,153269534,153321371,51837,4204;3654,2
-1,1,X,153287517,153310135,22618,4204,1
-1,1,X,153287517,153330916,43399,4204,1
-1,1,X,153290315,153294658,4343,4204,1
-1,1,X,153296301,153300368,4067,4204,1
1,1,X,153333946,153541192,207246,728458;4204;5956;8277;2652,5
1,1,X,153333946,153623000,289054,8277;728458;2010;4204;5956;2316;2652,7
1,1,X,153333946,153783638,449692,55558;2539;1774;8270;9130;537;4204;60343;8277;728458;2010;8517;5956;2664;6134;2316;8273;6901;8266;2652,20
1,-1,X,153420154,153560505,140351,5956;728458;8277;2652,4
1,1,X,153576890,153998328,421438,55558;139716;2539;1485;1736;1774;246100;8270;9130;537;60343;2010;8517;2664;30848;6134;2316;8273;6901;8266,20
1,-1,X,153787710,153964873,177163,139716;1485;8517;246100;30848,5
-1,1,X,153908131,155232894,1324763,139716;3581;1736;8263;1193;55217;2157;100132963;474384;7411;100272147;65991;4354;474382;83740;474381;474383;10251;79184;6845;116442;4515,22
1,-1,X,154078083,154115785,37702,8263;474382;2157,3
1,1,X,154117578,154553189,435611,7411;1193;2157;79184;100272147;116442;65991;4515,8
-1,1,X,154120620,154565718,445098,7411;1193;2157;79184;100272147;116442;65991;4515,8
-1,1,X,154250433,154317840,67407,79184;100272147;65991;4515;2157,5
1,-1,X,154556681,154577793,21112,1193,1
1,-1,X,154556681,154577793,21112,1193,1
1,-1,X,154556681,154577793,21112,1193,1
1,-1,X,154672335,154679310,6975,,0
1,-1,X,154672335,154722370,50035,83740;474384;55217,3
1,-1,X,154672335,154722370,50035,83740;474384;55217,3
1,-1,X,154722370,154776718,54348,55217,1
1,-1,X,154736503,154842445,105942,55217;10251,2
1,-1,X,154739403,154776718,37315,55217,1
-1,1,X,154762193,155232894,470701,6845;10251;3581;55217,4
-1,1,X,154929220,155251871,322651,6845;3581;10251,3
-1,-1,X,154933719,155224707,290988,6845;10251,2
-1,-1,X,154933719,155224707,290988,6845;10251,2
-1,-1,X,154933719,155224707,290988,6845;10251,2
-1,-1,X,154933719,155246585,312866,6845;3581;10251,3
-1,-1,X,154933719,155246585,312866,6845;3581;10251,3
-1,-1,X,154933719,155246585,312866,6845;3581;10251,3
-1,-1,X,154974667,155208354,233687,6845;10251,2
-1,-1,X,154974696,155226057,251361,6845;10251,2
-1,-1,X,155014787,155036311,21524,,0
-1,-1,X,155014787,155036311,21524,,0
-1,-1,X,155014787,155036311,21524,,0
-1,-1,X,155029751,155232907,203156,6845;3581,2
1,-1,X,155118767,155250178,131411,6845;3581,2
-1,-1,X,155181535,155251871,70336,3581,1
-1,-1,X,155181535,155251871,70336,3581,1
-1,-1,X,155201393,155233992,32599,3581,1
1,-1,X,155228918,155240563,11645,3581,1
-1,-1,X,155231256,155251871,20615,3581,1
-1,-1,X,155231256,155251871,20615,3581,1
1,-1,X,155236606,155246585,9979,3581,1
1,-1,X,155236606,155250178,13572,3581,1
-1,-1,X,155236606,155255792,19186,3581,1
1,-1,X,155236606,155255792,19186,3581,1
1,-1,X,155236606,155255792,19186,3581,1
-1,1,Y,10001,1292026,1282025,28227;6473;8225;55344;64109,5
-1,1,Y,10679,15251375,15240696,728403;4267;207063;293;286530;9189;100289087;266;6473;90665;83259;1438;90655;3563;6192;7258;28227;8287;728395;8653;64591;728137;438;64109;7544;6736;8227;8225;55344;8623,30
-1,1,Y,10679,59354877,59344198,1617;6845;286530;378948;83259;7258;159163;8287;9426;86614;57055;8227;8284;207063;100289087;378950;5940;442867;100533178;10251;28227;7404;728395;57135;378951;9081;438;9084;378949;9086;203611;9085;353515;728403;4267;442868;293;9189;3581;140032;57054;90665;90655;3563;6192;8653;353513;64591;728137;22829;159119;7544;6736;8225;9082;8623;442862;9087;266;6473;1438;9083;64109;55344;253175,65
-1,1,Y,10701,1292026,1281325,28227;6473;8225;55344;64109,5
-1,1,Y,10701,20063386,20052685,728403;4267;293;286530;9189;90665;83259;90655;3563;6192;7258;8287;8653;353513;64591;728137;22829;7544;6736;8227;8225;9082;8623;207063;100289087;9087;266;6473;1438;28227;7404;728395;438;64109;9084;55344;203611,37
-1,1,Y,10701,59335913,59325212,1617;6845;286530;378948;83259;7258;159163;8287;9426;86614;57055;8227;8284;207063;100289087;378950;5940;442867;100533178;10251;28227;7404;728395;57135;378951;9081;438;9084;378949;9086;203611;9085;353515;728403;4267;442868;293;9189;3581;140032;57054;90665;90655;3563;6192;8653;353513;64591;728137;22829;159119;7544;6736;8225;9082;8623;442862;9087;266;6473;1438;9083;64109;55344;253175,65
-1,1,Y,10701,59335913,59325212,1617;6845;286530;378948;83259;7258;159163;8287;9426;86614;57055;8227;8284;207063;100289087;378950;5940;442867;100533178;10251;28227;7404;728395;57135;378951;9081;438;9084;378949;9086;203611;9085;353515;728403;4267;442868;293;9189;3581;140032;57054;90665;90655;3563;6192;8653;353513;64591;728137;22829;159119;7544;6736;8225;9082;8623;442862;9087;266;6473;1438;9083;64109;55344;253175,65
1,1,Y,10863,2620854,2609991,28227;207063;4267;293;286530;9189;438;64109;6473;8227;8225;55344;1438;3563;8623,15
1,1,Y,10863,2620854,2609991,28227;207063;4267;293;286530;9189;438;64109;6473;8227;8225;55344;1438;3563;8623,15
1,1,Y,10863,6115322,6104459,4267;207063;293;286530;9189;6473;83259;1438;90655;3563;6192;28227;64591;438;64109;7544;6736;8227;8225;55344;8623,21
1,1,Y,10863,6115322,6104459,4267;207063;293;286530;9189;6473;83259;1438;90655;3563;6192;28227;64591;438;64109;7544;6736;8227;8225;55344;8623,21
1,1,Y,10863,19571769,19560906,728403;4267;293;286530;9189;90665;83259;90655;3563;6192;7258;8287;8653;353513;64591;728137;22829;7544;6736;8227;8225;8623;207063;100289087;9087;266;6473;1438;28227;7404;728395;438;64109;9084;55344,35
1,1,Y,10863,59363566,59352703,1617;6845;286530;378948;83259;7258;159163;8287;9426;86614;57055;8227;8284;207063;100289087;378950;5940;442867;100533178;10251;28227;7404;728395;57135;378951;9081;438;9084;378949;9086;203611;9085;353515;728403;4267;442868;293;9189;3581;140032;57054;90665;90655;3563;6192;8653;353513;64591;728137;22829;159119;7544;6736;8225;9082;8623;442862;9087;266;6473;1438;9083;64109;55344;253175,65
1,1,Y,10863,59363566,59352703,1617;6845;286530;378948;83259;7258;159163;8287;9426;86614;57055;8227;8284;207063;100289087;378950;5940;442867;100533178;10251;28227;7404;728395;57135;378951;9081;438;9084;378949;9086;203611;9085;353515;728403;4267;442868;293;9189;3581;140032;57054;90665;90655;3563;6192;8653;353513;64591;728137;22829;159119;7544;6736;8225;9082;8623;442862;9087;266;6473;1438;9083;64109;55344;253175,65
-1,-1,Y,20297,39498,19201,,0
1,-1,Y,20297,39498,19201,,0
1,-1,Y,20297,39498,19201,,0
-1,-1,Y,20297,39498,19201,,0
1,-1,Y,20297,39498,19201,,0
1,-1,Y,20297,39498,19201,,0
-1,-1,Y,20297,39498,19201,,0
1,-1,Y,20297,39498,19201,,0
-1,-1,Y,20297,39498,19201,,0
1,-1,Y,20297,39498,19201,,0
-1,-1,Y,20297,39498,19201,,0
-1,-1,Y,20297,39498,19201,,0
-1,-1,Y,20297,39498,19201,,0
-1,-1,Y,20297,39498,19201,,0
-1,-1,Y,20297,39498,19201,,0
-1,-1,Y,20297,39498,19201,,0
1,-1,Y,20297,39498,19201,,0
1,-1,Y,20297,39498,19201,,0
-1,-1,Y,20297,39498,19201,,0
-1,-1,Y,20297,39498,19201,,0
1,-1,Y,20297,39498,19201,,0
-1,-1,Y,20297,39498,19201,,0
1,-1,Y,20297,100002,79705,,0
-1,1,Y,20297,593638,573341,55344;6473;28227;8225,4
-1,1,Y,20297,2640984,2620687,28227;207063;4267;293;286530;9189;438;64109;6473;8227;8225;55344;1438;3563;8623,15
-1,1,Y,20297,59356174,59335877,1617;6845;286530;378948;83259;7258;159163;8287;9426;86614;57055;8227;8284;207063;100289087;378950;5940;442867;100533178;10251;28227;7404;728395;57135;378951;9081;438;9084;378949;9086;203611;9085;353515;728403;4267;442868;293;9189;3581;140032;57054;90665;90655;3563;6192;8653;353513;64591;728137;22829;159119;7544;6736;8225;9082;8623;442862;9087;266;6473;1438;9083;64109;55344;253175,65
-1,-1,Y,21267,39498,18231,,0
1,1,Y,114504,59349650,59235146,1617;6845;286530;378948;83259;7258;159163;8287;9426;86614;57055;8227;8284;207063;100289087;378950;5940;442867;100533178;10251;28227;7404;728395;57135;378951;9081;438;9084;378949;9086;203611;9085;353515;728403;4267;442868;293;9189;3581;140032;57054;90665;90655;3563;6192;8653;353513;64591;728137;22829;159119;7544;6736;8225;9082;8623;442862;9087;266;6473;1438;9083;64109;55344;253175,65
1,-1,Y,126426,647169,520743,55344;6473;28227;8225,4
-1,1,Y,168546,1605584,1437038,28227;293;286530;64109;6473;8225;55344;1438;3563;8623,10
-1,1,Y,168546,2058729,1890183,28227;293;286530;438;64109;6473;8227;8225;55344;1438;3563;8623,12
-1,1,Y,168546,28451874,28283328,353515;728403;1617;4267;442868;293;286530;9189;140032;378948;57054;90665;83259;90655;3563;6192;7258;159163;8287;8653;353513;64591;728137;22829;159119;9426;7544;6736;86614;57055;8227;8225;9082;253175;8623;442862;8284;207063;100289087;9087;378950;266;6473;1438;5940;442867;100533178;28227;7404;728395;57135;378951;9081;438;64109;9084;9083;378949;9086;55344;203611;9085,62
-1,1,Y,286952,623541,336589,28227;6473,2
-1,1,Y,288874,59327713,59038839,353515;728403;1617;4267;442868;293;6845;286530;9189;140032;378948;57054;90665;83259;90655;3563;6192;7258;159163;8287;8653;353513;64591;728137;22829;159119;9426;7544;6736;86614;57055;8227;9082;253175;8623;442862;8284;207063;100289087;9087;378950;266;6473;1438;5940;442867;100533178;10251;28227;7404;728395;57135;378951;9081;438;64109;9084;9083;378949;9086;203611;9085,62
-1,1,Y,469455,540957,71502,6473,1
1,1,Y,474597,59095986,58621389,353515;728403;1617;4267;442868;293;286530;9189;140032;378948;57054;90665;83259;90655;3563;6192;7258;159163;8287;8653;353513;64591;728137;22829;159119;9426;7544;6736;86614;57055;8227;9082;8623;9085;442862;8284;207063;100289087;9087;378950;266;6473;1438;5940;442867;100533178;7404;728395;57135;378951;9081;438;64109;9084;9083;378949;9086;203611;253175,59
-1,1,Y,478512,574896,96384,6473,1
-1,-1,Y,647169,1188257,541088,,0
-1,-1,Y,731071,769170,38099,,0
-1,-1,Y,731071,769170,38099,,0
1,-1,Y,827633,1464209,636576,293;1438;3563;64109,4
1,-1,Y,859049,1202522,343473,,0
1,-1,Y,859049,1202522,343473,,0
1,-1,Y,965836,1297283,331447,64109,1
1,-1,Y,1060841,1533754,472913,8623;293;1438;286530;3563;64109,6
-1,1,Y,1167123,59030571,57863448,353515;728403;1617;4267;442868;293;286530;9189;140032;378948;57054;90665;83259;90655;3563;6192;7258;159163;8287;8653;353513;64591;728137;22829;159119;9426;7544;6736;86614;57055;8227;9082;8623;9085;442862;8284;207063;100289087;9087;378950;266;1438;5940;442867;100533178;7404;728395;57135;378951;9081;438;64109;9084;9083;378949;9086;203611;253175,58
1,-1,Y,1173372,1271581,98209,64109,1
1,-1,Y,1743480,1892205,148725,,0
1,-1,Y,2211474,2311399,99925,207063,1
-1,1,Y,2650141,28799937,26149796,353515;728403;1617;442868;140032;378948;57054;90665;83259;90655;6192;7258;159163;8287;8653;353513;64591;728137;22829;159119;9426;7544;6736;86614;57055;9082;9085;442862;8284;100289087;9087;378950;266;5940;442867;100533178;7404;728395;57135;378951;9081;9083;9084;378949;9086;203611;253175,47
1,1,Y,2650313,19566674,16916361,728403;100289087;9087;266;90665;83259;90655;6192;7258;7404;8287;728395;8653;353513;64591;728137;22829;9084;7544;6736,20
1,1,Y,2650559,59032389,56381830,353515;728403;1617;442868;140032;378948;57054;90665;83259;90655;6192;7258;159163;8287;8653;353513;64591;728137;22829;159119;9426;7544;6736;86614;57055;9082;9085;442862;8284;100289087;9087;378950;266;5940;442867;100533178;7404;728395;57135;378951;9081;9083;9084;378949;9086;203611;253175,47
1,1,Y,2653804,2894892,241088,7544;6736;6192,3
-1,1,Y,2654637,28722108,26067471,353515;728403;1617;442868;140032;378948;57054;90665;83259;90655;6192;7258;159163;8287;8653;353513;64591;728137;22829;159119;9426;7544;6736;86614;57055;9082;9085;442862;8284;100289087;9087;378950;266;5940;442867;100533178;7404;728395;57135;378951;9081;9083;9084;378949;9086;203611;253175,47
-1,1,Y,2654852,59031480,56376628,353515;728403;1617;442868;140032;378948;57054;90665;83259;90655;6192;7258;159163;8287;8653;353513;64591;728137;22829;159119;9426;7544;6736;86614;57055;9082;9085;442862;8284;100289087;9087;378950;266;5940;442867;100533178;7404;728395;57135;378951;9081;9083;9084;378949;9086;203611;253175,47
1,1,Y,2654852,59031480,56376628,353515;728403;1617;442868;140032;378948;57054;90665;83259;90655;6192;7258;159163;8287;8653;353513;64591;728137;22829;159119;9426;7544;6736;86614;57055;9082;9085;442862;8284;100289087;9087;378950;266;5940;442867;100533178;7404;728395;57135;378951;9081;9083;9084;378949;9086;203611;253175,47
1,1,Y,2654852,59031480,56376628,353515;728403;1617;442868;140032;378948;57054;90665;83259;90655;6192;7258;159163;8287;8653;353513;64591;728137;22829;159119;9426;7544;6736;86614;57055;9082;9085;442862;8284;100289087;9087;378950;266;5940;442867;100533178;7404;728395;57135;378951;9081;9083;9084;378949;9086;203611;253175,47
1,1,Y,2723745,26435098,23711353,353515;728403;1617;140032;378948;90665;83259;90655;6192;7258;159163;8287;8653;353513;64591;728137;22829;159119;9426;7544;86614;57055;9082;442862;8284;100289087;9087;378950;266;5940;100533178;7404;728395;378951;9081;9083;9084;378949;9086;203611;253175,41
1,1,Y,2934029,6094557,3160528,83259;90655,2
1,1,Y,2934029,6094557,3160528,83259;90655,2
1,1,Y,6123482,20597870,14474388,353515;728403;100289087;9087;266;90665;7258;7404;728395;8287;8653;353513;728137;22829;9426;9084;9082;203611,18
-1,1,Y,6138322,28609908,22471586,353515;728403;1617;442868;140032;378948;57054;90665;7258;159163;8287;8653;353513;728137;22829;159119;9426;86614;57055;9082;9085;442862;8284;100289087;9087;378950;266;5940;442867;100533178;7404;728395;57135;378951;9081;9083;9084;378949;9086;203611;253175,41
1,-1,Y,7153362,7640496,487134,,0
1,-1,Y,7450517,7500739,50222,,0
1,-1,Y,7450517,7500739,50222,,0
1,-1,Y,9484809,9631997,147188,,0
1,-1,Y,10005572,13197765,3192193,,0
-1,1,Y,13134518,59336737,46202219,353515;1617;442868;6845;3581;140032;378948;57054;159163;8287;8653;353513;22829;159119;9426;86614;57055;9082;9085;442862;8284;9087;378950;5940;442867;100533178;10251;7404;57135;378951;9081;9083;9084;378949;9086;203611;253175,37
1,-1,Y,13272343,13871154,598811,,0
1,-1,Y,13622055,13849453,227398,,0
1,-1,Y,13675923,13745434,69511,,0
1,-1,Y,13675923,13745434,69511,,0
1,-1,Y,13675923,13848141,172218,,0
1,-1,Y,13704922,13745434,40512,,0
1,-1,Y,13704922,13745434,40512,,0
1,-1,Y,13704922,13745434,40512,,0
1,-1,Y,13704922,13745434,40512,,0
1,-1,Y,13704922,13820061,115139,,0
1,-1,Y,13704922,13820061,115139,,0
1,-1,Y,13723022,13745434,22412,,0
1,-1,Y,13723022,13745434,22412,,0
1,-1,Y,13723022,13745434,22412,,0
-1,1,Y,13870873,59335913,45465040,353515;1617;442868;6845;3581;140032;378948;57054;159163;8287;8653;353513;22829;159119;9426;86614;57055;9082;9085;442862;8284;9087;378950;5940;442867;100533178;10251;7404;57135;378951;9081;9083;9084;378949;9086;203611;253175,37
-1,1,Y,13871147,59336737,45465590,353515;1617;442868;6845;3581;140032;378948;57054;159163;8287;8653;353513;22829;159119;9426;86614;57055;9082;9085;442862;8284;9087;378950;5940;442867;100533178;10251;7404;57135;378951;9081;9083;9084;378949;9086;203611;253175,37
1,-1,Y,13992304,14389646,397342,,0
1,-1,Y,14022441,14489087,466646,,0
-1,1,Y,14521194,28307254,13786060,353515;1617;442868;140032;378948;57054;159163;8287;8653;353513;22829;159119;9426;86614;57055;9082;9085;442862;8284;9087;378950;5940;442867;100533178;7404;57135;378951;9081;9083;9084;378949;9086;203611;253175,34
1,1,Y,14814859,28799937,13985078,353515;1617;442868;140032;378948;57054;159163;8287;8653;353513;22829;159119;9426;86614;57055;9082;253175;442862;8284;9087;378950;5940;442867;100533178;7404;57135;378951;9081;9083;9084;378949;9086;203611;9085,34
-1,1,Y,14844481,16824498,1980017,9084;7404;8287;8653;22829;9087;353513,7
-1,1,Y,15077631,59358798,44281167,353515;1617;442868;6845;3581;140032;378948;57054;159163;353513;22829;159119;9426;86614;57055;9082;9085;442862;8284;9087;378950;5940;442867;100533178;10251;7404;57135;378951;9081;9083;9084;378949;9086;203611;253175,35
-1,1,Y,15415024,59349591,43934567,353515;1617;442868;6845;3581;140032;378948;57054;159163;353513;22829;159119;9426;86614;57055;9082;253175;442862;8284;9087;378950;5940;442867;100533178;10251;7404;57135;378951;9081;9083;9084;378949;9086;203611;9085,35
1,-1,Y,15704763,16059952,355189,9087,1
1,-1,Y,15744612,16023278,278666,9087,1
1,-1,Y,15991426,16166538,175112,9084,1
1,1,Y,16020740,24504676,8483936,353515;442862;8284;378950;140032;378948;5940;100533178;159163;353513;22829;159119;9426;9084;86614;378949;9086;9082;203611,19
1,-1,Y,16077897,16166538,88641,9084,1
1,-1,Y,16099893,16104120,4227,,0
1,-1,Y,16099893,16393891,293998,353513,1
1,-1,Y,16162322,16188682,26360,353513,1
-1,1,Y,16174765,59335913,43161148,353515;1617;442862;8284;442868;6845;378950;3581;140032;378948;57054;5940;442867;100533178;159163;10251;57135;378951;22829;159119;9081;9426;9083;86614;57055;378949;9086;9082;253175;203611;9085,31
-1,1,Y,16188682,59311360,43122678,353515;1617;442862;8284;442868;6845;378950;140032;378948;57054;5940;442867;100533178;159163;10251;57135;378951;22829;159119;9081;9426;9083;86614;57055;378949;9086;9082;253175;203611;9085,30
1,-1,Y,17112219,17636880,524661,,0
1,-1,Y,17116826,17630471,513645,,0
1,-1,Y,17271029,17284349,13320,,0
-1,1,Y,17743696,59357161,41613465,353515;1617;442862;8284;442868;6845;378950;3581;140032;378948;57054;5940;442867;100533178;159163;10251;57135;378951;9081;159119;9083;9426;86614;57055;378949;9086;9082;253175;203611;9085,30
1,-1,Y,18274705,18555560,280855,,0
-1,1,Y,18423451,59336737,40913286,353515;1617;442862;8284;442868;6845;378950;3581;140032;378948;57054;5940;442867;100533178;159163;10251;57135;378951;9081;159119;9083;9426;86614;57055;378949;9086;9082;253175;203611;9085,30
1,-1,Y,19363636,21311821,1948185,353515;86614;203611;9082;159119;9426,6
1,-1,Y,19419098,21251249,1832151,353515;86614;203611;9082;159119;9426,6
-1,1,Y,19758763,28311693,8552930,353515;1617;442862;8284;442868;378950;140032;378948;57054;5940;442867;100533178;159163;57135;378951;9081;159119;9083;9426;86614;57055;378949;9086;9082;253175;203611;9085,27
-1,-1,Y,19948055,20229152,281097,203611;9426,2
-1,-1,Y,19950655,20231722,281067,203611;9426,2
1,-1,Y,20626494,20700103,73609,,0
-1,1,Y,20707618,59335913,38628295,1617;442862;8284;442868;6845;378950;3581;140032;378948;57054;442867;5940;100533178;159163;10251;57135;378951;9081;159119;9083;86614;57055;378949;9086;253175;9085,26
-1,1,Y,20805226,59336998,38531772,1617;442862;8284;442868;6845;378950;3581;140032;378948;57054;442867;5940;100533178;159163;10251;57135;378951;9081;159119;9083;57055;378949;9086;253175;9085,25
1,-1,Y,20944017,21017616,73599,,0
1,-1,Y,20961386,21026254,64868,,0
1,-1,Y,21053353,21412851,359498,,0
-1,1,Y,21053353,59354877,38301524,1617;442862;8284;442868;6845;378950;3581;140032;378948;57054;442867;5940;100533178;159163;10251;57135;378951;9081;9083;57055;378949;9086;253175;9085,24
1,-1,Y,22529253,22559512,30259,,0
1,-1,Y,23654028,24201753,547725,378949;5940;378948;378950,4
-1,-1,Y,23657252,23710797,53545,5940;378948,2
1,-1,Y,23657252,23710797,53545,5940;378948,2
1,-1,Y,23657252,23710797,53545,5940;378948,2
1,-1,Y,23657252,23710797,53545,5940;378948,2
1,-1,Y,23659141,23710797,51656,5940;378948,2
1,-1,Y,23663589,23699532,35943,5940;378948,2
1,-1,Y,23663589,23699532,35943,5940;378948,2
1,-1,Y,23663717,23699532,35815,5940;378948,2
-1,-1,Y,24044065,24884056,839991,159163;442862;378951;9081;378950,5
-1,-1,Y,24026594,24068956,42362,378949;378950,2
1,-1,Y,24026594,24068956,42362,378949;378950,2
1,-1,Y,24026594,24068956,42362,378949;378950,2
1,-1,Y,24026594,24068956,42362,378949;378950,2
1,-1,Y,24037845,24068956,31111,378949;378950,2
1,-1,Y,24037845,24068956,31111,378949;378950,2
1,-1,Y,24037904,24069015,31111,378949;378950,2
1,-1,Y,24073913,25516121,1442208,159163;57055;442862;1617;378951;9081;9083,7
-1,1,Y,24073794,59336737,35262943,442862;1617;442868;6845;3581;57054;442867;159163;10251;57135;378951;9081;9083;57055;253175;9085,16
1,-1,Y,24073920,24238124,164204,442862,1
-1,1,Y,24073920,24640516,566596,159163;378951;442862;9081,4
-1,1,Y,24073920,28279159,4205239,159163;442862;1617;57135;442868;9085;378951;9081;9083;57055;57054;442867;253175,13
1,-1,Y,24073920,28279159,4205239,159163;442862;1617;57135;442868;9085;378951;9081;9083;57055;57054;442867;253175,13
-1,-1,Y,24082686,24884056,801370,159163;378951;442862;9081,4
-1,-1,Y,24092746,24884056,791310,159163;378951;442862;9081,4
-1,-1,Y,24092746,24884056,791310,159163;378951;442862;9081,4
-1,-1,Y,24092746,24884056,791310,159163;378951;442862;9081,4
-1,-1,Y,24092746,24884056,791310,159163;378951;442862;9081,4
-1,-1,Y,24092746,24928129,835383,159163;378951;442862;9081,4
-1,-1,Y,24100109,24238124,138015,442862,1
1,-1,Y,24100109,24238124,138015,442862,1
-1,-1,Y,24105967,24884056,778089,159163;378951;442862;9081,4
-1,1,Y,24108372,59358798,35250426,442862;1617;442868;6845;3581;57054;442867;159163;10251;57135;378951;9081;9083;57055;253175;9085,16
1,-1,Y,24121709,24238124,116415,442862,1
1,-1,Y,24121709,24238124,116415,442862,1
1,-1,Y,24138858,24238124,99266,442862,1
-1,-1,Y,24239391,24639309,399918,159163;378951;442862;9081,4
1,-1,Y,24245628,24310366,64738,,0
1,-1,Y,24315060,24332210,17150,159163,1
1,-1,Y,24355423,24468107,112684,,0
-1,-1,Y,24371278,24504817,133539,,0
1,-1,Y,24371478,24504676,133198,,0
1,-1,Y,24371478,24504676,133198,,0
1,-1,Y,24371478,24504676,133198,,0
1,-1,Y,24546458,24563613,17155,378951,1
1,-1,Y,24568307,24636946,68639,9081,1
1,-1,Y,24636917,25507194,870277,57055;1617;9081;9083,4
1,-1,Y,24639250,25290695,651445,1617;9081;9083,3
1,-1,Y,24639250,25504031,864781,57055;1617;9081;9083,4
1,-1,Y,24639250,25602807,963557,57055;1617;9081;9083,4
-1,-1,Y,24639250,28362288,3723038,253175;1617;57135;442868;9081;9083;57055;57054;442867;9085,10
-1,-1,Y,24640516,25504031,863515,57055;1617;9081;9083,4
1,-1,Y,24640516,25504031,863515,57055;1617;9081;9083,4
-1,-1,Y,24640516,25504031,863515,57055;1617;9081;9083,4
1,-1,Y,24640516,25504031,863515,57055;1617;9081;9083,4
1,-1,Y,24640516,25504031,863515,57055;1617;9081;9083,4
1,-1,Y,24640516,25554346,913830,57055;1617;9081;9083,4
1,-1,Y,24640516,26282422,1641906,57055;1617;9081;9083;253175,5
1,-1,Y,24640516,26282422,1641906,57055;1617;9081;9083;253175,5
1,-1,Y,24640516,26282422,1641906,57055;1617;9081;9083;253175,5
1,-1,Y,24640516,26282422,1641906,57055;1617;9081;9083;253175,5
1,-1,Y,24640516,28469464,3828948,253175;1617;57135;442868;9081;9083;57055;57054;442867;9085,10
1,-1,Y,24640516,59363566,34723050,10251;253175;1617;57135;442868;6845;9081;9083;3581;57055;57054;442867;9085,13
1,-1,Y,24648785,25290695,641910,1617;9081;9083,3
1,-1,Y,24648785,25504031,855246,57055;1617;9081;9083,4
1,-1,Y,24648785,25504031,855246,57055;1617;9081;9083,4
1,-1,Y,24648785,25504031,855246,57055;1617;9081;9083,4
1,-1,Y,24648785,25543954,895169,57055;1617;9081;9083,4
1,-1,Y,24648785,25602807,954022,57055;1617;9081;9083,4
1,-1,Y,24648785,25602807,954022,57055;1617;9081;9083,4
1,-1,Y,24648785,26276087,1627302,57055;1617;9081;9083;253175,5
1,-1,Y,24648785,26276087,1627302,57055;1617;9081;9083;253175,5
1,-1,Y,24648785,26282422,1633637,57055;1617;9081;9083;253175,5
1,-1,Y,24648785,26282422,1633637,57055;1617;9081;9083;253175,5
1,-1,Y,24648785,26420387,1771602,57055;1617;9081;9083;253175,5
1,-1,Y,24648785,27593899,2945114,1617;57135;442868;9081;9083;57055;57054;442867;253175,9
1,-1,Y,24648785,28455771,3806986,253175;1617;57135;442868;9081;9083;57055;57054;442867;9085,10
1,-1,Y,24648785,25290695,641910,1617;9081;9083,3
1,-1,Y,24648785,25290695,641910,1617;9081;9083,3
1,-1,Y,24648785,59363566,34714781,10251;253175;1617;57135;442868;6845;9081;9083;3581;57055;57054;442867;9085,13
1,-1,Y,24650933,25602807,951874,57055;1617;9081;9083,4
-1,-1,Y,24811900,25504031,692131,57055;1617;9083,3
-1,-1,Y,24873007,25203027,330020,9083,1
-1,-1,Y,24873007,25206309,333302,9083,1
-1,-1,Y,24873007,25288251,415244,1617;9083,2
-1,-1,Y,24873007,25496928,623921,57055;1617;9083,3
1,-1,Y,24873007,25502911,629904,57055;1617;9083,3
-1,-1,Y,24873007,25504031,631024,57055;1617;9083,3
-1,-1,Y,24873007,25504031,631024,57055;1617;9083,3
1,-1,Y,24873007,25504031,631024,57055;1617;9083,3
-1,-1,Y,24873007,25504031,631024,57055;1617;9083,3
-1,-1,Y,24873007,25504031,631024,57055;1617;9083,3
-1,-1,Y,24873007,25504031,631024,57055;1617;9083,3
-1,-1,Y,24873007,25504031,631024,57055;1617;9083,3
-1,-1,Y,24873007,25504031,631024,57055;1617;9083,3
-1,-1,Y,24873007,25504031,631024,57055;1617;9083,3
-1,-1,Y,24873007,25504031,631024,57055;1617;9083,3
1,-1,Y,24873007,25504031,631024,57055;1617;9083,3
-1,-1,Y,24873007,25504031,631024,57055;1617;9083,3
-1,-1,Y,24873007,25504031,631024,57055;1617;9083,3
-1,-1,Y,24873007,25504031,631024,57055;1617;9083,3
-1,-1,Y,24873007,25504031,631024,57055;1617;9083,3
-1,-1,Y,24873007,25504031,631024,57055;1617;9083,3
-1,-1,Y,24873007,25504031,631024,57055;1617;9083,3
-1,-1,Y,24873007,25504031,631024,57055;1617;9083,3
-1,-1,Y,24873007,25504031,631024,57055;1617;9083,3
-1,-1,Y,24873007,25286966,413959,1617;9083,2
1,-1,Y,24873007,59363566,34490559,10251;1617;57135;442868;9085;6845;9083;3581;57055;57054;442867;253175,12
-1,-1,Y,24873007,59363566,34490559,10251;1617;57135;442868;9085;6845;9083;3581;57055;57054;442867;253175,12
-1,-1,Y,24873007,59363566,34490559,10251;1617;57135;442868;9085;6845;9083;3581;57055;57054;442867;253175,12
-1,-1,Y,24873007,59363566,34490559,10251;1617;57135;442868;9085;6845;9083;3581;57055;57054;442867;253175,12
-1,1,Y,24873150,27895495,3022345,1617;57135;442868;9085;9083;57055;57054;442867;253175,9
-1,1,Y,24873150,27895495,3022345,1617;57135;442868;9085;9083;57055;57054;442867;253175,9
-1,1,Y,24873150,27895495,3022345,1617;57135;442868;9085;9083;57055;57054;442867;253175,9
1,-1,Y,24895192,25504031,608839,57055;1617;9083,3
1,-1,Y,24895192,25577351,682159,57055;1617;9083,3
1,-1,Y,24895192,26273887,1378695,57055;1617;9083;253175,4
1,-1,Y,24895192,26298568,1403376,57055;1617;9083;253175,4
1,-1,Y,24895192,26420387,1525195,57055;1617;9083;253175,4
1,-1,Y,24895192,28455771,3560579,1617;57135;442868;9085;9083;57055;57054;442867;253175,9
1,-1,Y,24901458,25504031,602573,57055;1617;9083,3
1,-1,Y,24901458,25504031,602573,57055;1617;9083,3
1,-1,Y,24901458,25577351,675893,57055;1617;9083,3
1,-1,Y,24901458,25597267,695809,57055;1617;9083,3
1,-1,Y,24901458,26282422,1380964,57055;1617;9083;253175,4
1,-1,Y,24901458,28455771,3554313,1617;57135;442868;9085;9083;57055;57054;442867;253175,9
1,-1,Y,24901458,28455771,3554313,1617;57135;442868;9085;9083;57055;57054;442867;253175,9
1,-1,Y,24895251,59032329,34137078,1617;57135;442868;9085;9083;57055;57054;442867;253175,9
1,-1,Y,24908983,25507194,598211,57055;1617;9083,3
1,-1,Y,24908983,26276087,1367104,57055;1617;9083;253175,4
1,-1,Y,24942529,25554346,611817,57055;1617;9083,3
1,-1,Y,24942529,25602807,660278,57055;1617;9083,3
1,-1,Y,24942529,28455771,3513242,1617;57135;442868;9085;9083;57055;57054;442867;253175,9
1,-1,Y,24947707,25504031,556324,57055;1617;9083,3
1,-1,Y,24947707,26298568,1350861,57055;1617;9083;253175,4
1,-1,Y,24956669,25504031,547362,57055;1617;9083,3
1,-1,Y,24956669,25504031,547362,57055;1617;9083,3
1,-1,Y,24956669,25543954,587285,57055;1617;9083,3
1,-1,Y,24956669,25543954,587285,57055;1617;9083,3
1,-1,Y,24958833,25543954,585121,57055;1617;9083,3
1,-1,Y,24958833,25602807,643974,57055;1617;9083,3
1,-1,Y,24958833,26276087,1317254,57055;1617;9083;253175,4
1,-1,Y,24958833,26276087,1317254,57055;1617;9083;253175,4
1,-1,Y,24958833,59363566,34404733,10251;1617;57135;442868;9085;6845;9083;3581;57055;57054;442867;253175,12
1,-1,Y,25037661,26282422,1244761,57055;1617;9083;253175,4
1,-1,Y,25081036,25602807,521771,57055;1617;9083,3
1,-1,Y,25081036,26276087,1195051,57055;1617;9083;253175,4
1,-1,Y,25081036,26276087,1195051,57055;1617;9083;253175,4
-1,-1,Y,25208967,25496928,287961,57055;1617,2
-1,-1,Y,25208967,25496928,287961,57055;1617,2
-1,-1,Y,25208967,25496928,287961,57055;1617,2
-1,-1,Y,25208967,25504031,295064,57055;1617,2
-1,-1,Y,25208967,25504031,295064,57055;1617,2
-1,-1,Y,25208967,25504031,295064,57055;1617,2
-1,-1,Y,25208967,25504031,295064,57055;1617,2
-1,-1,Y,25208967,25504031,295064,57055;1617,2
-1,-1,Y,25208967,25504031,295064,57055;1617,2
-1,-1,Y,25208967,25507194,298227,57055;1617,2
-1,-1,Y,25208967,25507194,298227,57055;1617,2
-1,-1,Y,25208967,25507194,298227,57055;1617,2
-1,-1,Y,25208967,25507194,298227,57055;1617,2
-1,-1,Y,25208967,25507194,298227,57055;1617,2
-1,-1,Y,25208967,25507194,298227,57055;1617,2
-1,-1,Y,25208967,25507194,298227,57055;1617,2
-1,-1,Y,25208967,25507194,298227,57055;1617,2
-1,-1,Y,25208967,25507194,298227,57055;1617,2
-1,-1,Y,25208967,25507194,298227,57055;1617,2
-1,-1,Y,25208967,25507194,298227,57055;1617,2
-1,-1,Y,25208967,25507194,298227,57055;1617,2
-1,-1,Y,25208967,25507194,298227,57055;1617,2
-1,-1,Y,25208967,25507194,298227,57055;1617,2
-1,-1,Y,25208967,25507194,298227,57055;1617,2
-1,-1,Y,25208967,25507194,298227,57055;1617,2
-1,-1,Y,25208967,25507194,298227,57055;1617,2
-1,-1,Y,25208967,25507194,298227,57055;1617,2
-1,-1,Y,25208967,25507194,298227,57055;1617,2
-1,-1,Y,25208967,25507194,298227,57055;1617,2
-1,-1,Y,25208967,25507194,298227,57055;1617,2
-1,-1,Y,25208967,25510310,301343,57055;1617,2
-1,-1,Y,25208967,25510310,301343,57055;1617,2
-1,-1,Y,25208967,25510310,301343,57055;1617,2
-1,-1,Y,25208967,25510310,301343,57055;1617,2
-1,-1,Y,25208967,25510310,301343,57055;1617,2
-1,-1,Y,25208967,25510310,301343,57055;1617,2
-1,-1,Y,25208967,25510310,301343,57055;1617,2
-1,-1,Y,25208967,25510310,301343,57055;1617,2
1,-1,Y,25208967,25723051,514084,57055;1617,2
-1,-1,Y,25206309,59363566,34157257,10251;1617;57135;442868;9085;6845;3581;57055;57054;442867;253175,11
-1,-1,Y,25208967,59363566,34154599,10251;1617;57135;442868;9085;6845;3581;57055;57054;442867;253175,11
-1,-1,Y,25208967,59363566,34154599,10251;1617;57135;442868;9085;6845;3581;57055;57054;442867;253175,11
-1,-1,Y,25270777,25496928,226151,57055;1617,2
-1,-1,Y,25270777,25507194,236417,57055;1617,2
-1,-1,Y,25270777,25510310,239533,57055;1617,2
-1,-1,Y,25273111,25507194,234083,57055;1617,2
-1,-1,Y,25273111,25507194,234083,57055;1617,2
-1,-1,Y,25273111,25510310,237199,57055;1617,2
-1,-1,Y,25273883,27028530,1754647,57055;1617;57054;57135;442867;253175,6
-1,-1,Y,25278883,27028530,1749647,57055;1617;57054;57135;442867;253175,6
1,-1,Y,25315779,26276087,960308,57055;1617;253175,3
1,-1,Y,25340039,26276087,936048,57055;1617;253175,3
1,-1,Y,25342141,26298568,956427,57055;1617;253175,3
1,-1,Y,25376473,26276087,899614,57055;253175,2
1,-1,Y,25410388,26276087,865699,57055;253175,2
1,-1,Y,25410388,26298568,888180,57055;253175,2
1,-1,Y,25410388,26307414,897026,57055;253175,2
1,-1,Y,25410388,26276087,865699,57055;253175,2
1,-1,Y,25410388,26307414,897026,57055;253175,2
-1,-1,Y,25606503,25847864,241361,,0
-1,-1,Y,25606503,25847864,241361,,0
-1,-1,Y,25606503,25847864,241361,,0
1,-1,Y,25617277,26276087,658810,253175,1
1,-1,Y,25617277,26276087,658810,253175,1
1,-1,Y,25617277,26282422,665145,253175,1
1,-1,Y,25617277,26282422,665145,253175,1
1,-1,Y,25617277,26298568,681291,253175,1
1,-1,Y,25617277,26319203,701926,253175,1
1,-1,Y,25617277,26928360,1311083,442867;57054;253175,3
1,-1,Y,25617277,28342367,2725090,253175;57054;57135;442868;442867;9085,6
-1,-1,Y,25620538,25847864,227326,,0
-1,-1,Y,25620538,25847864,227326,,0
-1,-1,Y,25620538,25847864,227326,,0
-1,-1,Y,25620538,25847864,227326,,0
1,-1,Y,25620538,26276087,655549,253175,1
1,-1,Y,25620538,26282422,661884,253175,1
1,-1,Y,25620538,26282422,661884,253175,1
1,-1,Y,25620538,26298568,678030,253175,1
-1,-1,Y,25620538,27427269,1806731,57054;57135;442868;442867;253175,5
1,-1,Y,25620538,27593899,1973361,57054;57135;442868;442867;253175,5
1,-1,Y,25620538,27593899,1973361,57054;57135;442868;442867;253175,5
-1,-1,Y,25620538,28342367,2721829,253175;57054;57135;442868;442867;9085,6
1,-1,Y,25620538,28455771,2835233,253175;57054;57135;442868;442867;9085,6
1,-1,Y,25620538,26298568,678030,253175,1
1,-1,Y,25628928,26298568,669640,253175,1
1,-1,Y,25655654,26303185,647531,253175,1
-1,-1,Y,25720771,26189897,469126,,0
-1,-1,Y,25847805,26139515,291710,,0
-1,-1,Y,25847805,26139515,291710,,0
1,-1,Y,25847805,26357153,509348,253175,1
-1,-1,Y,25850195,26139515,289320,,0
-1,-1,Y,25850195,26139515,289320,,0
-1,-1,Y,25850195,26139515,289320,,0
1,-1,Y,25850195,28112172,2261977,253175;57054;57135;442868;442867;9085,6
-1,-1,Y,25857684,26139515,281831,,0
-1,-1,Y,25857684,26139515,281831,,0
-1,-1,Y,25857684,26139515,281831,,0
-1,-1,Y,25857684,26139515,281831,,0
-1,-1,Y,25857684,26139515,281831,,0
-1,-1,Y,25857684,26139515,281831,,0
-1,-1,Y,25857684,26139515,281831,,0
-1,-1,Y,25857684,26139515,281831,,0
-1,-1,Y,25857684,26139515,281831,,0
-1,-1,Y,25857684,26139515,281831,,0
-1,-1,Y,25857684,26139515,281831,,0
-1,-1,Y,25857684,26176817,319133,,0
-1,-1,Y,25857684,26189897,332213,,0
-1,-1,Y,25857684,26282422,424738,253175,1
-1,-1,Y,25873834,26139515,265681,,0
-1,-1,Y,25873834,26139515,265681,,0
-1,-1,Y,25873834,26139515,265681,,0
-1,-1,Y,25873834,26139515,265681,,0
-1,-1,Y,25873834,26139515,265681,,0
-1,-1,Y,25873834,26139515,265681,,0
-1,-1,Y,25873834,26139515,265681,,0
-1,-1,Y,25873834,26139515,265681,,0
-1,-1,Y,25873834,26139515,265681,,0
-1,-1,Y,25873834,26139515,265681,,0
-1,-1,Y,25873834,26139515,265681,,0
-1,-1,Y,25873834,26139515,265681,,0
-1,-1,Y,25873834,26139515,265681,,0
-1,-1,Y,25873834,26139515,265681,,0
-1,-1,Y,25873834,26139515,265681,,0
-1,-1,Y,25873834,26139515,265681,,0
-1,-1,Y,25873834,26139515,265681,,0
-1,-1,Y,25873834,26139515,265681,,0
-1,-1,Y,25873834,26139515,265681,,0
-1,-1,Y,25873834,26139515,265681,,0
-1,-1,Y,25873834,26139515,265681,,0
-1,-1,Y,25873834,26139515,265681,,0
-1,-1,Y,25873834,26139515,265681,,0
-1,-1,Y,25873834,26139515,265681,,0
-1,-1,Y,25873834,26139515,265681,,0
-1,-1,Y,25873834,26139515,265681,,0
-1,-1,Y,25873834,26139515,265681,,0
-1,-1,Y,25873834,26139515,265681,,0
-1,-1,Y,25873834,26139515,265681,,0
-1,-1,Y,25873834,26139515,265681,,0
-1,-1,Y,25873834,26139515,265681,,0
-1,-1,Y,25873834,26139515,265681,,0
-1,-1,Y,25873834,26139515,265681,,0
-1,-1,Y,25873834,26139515,265681,,0
-1,-1,Y,25873834,26139515,265681,,0
-1,-1,Y,25873834,26139515,265681,,0
-1,-1,Y,25873834,26139515,265681,,0
-1,-1,Y,25873834,26139515,265681,,0
-1,-1,Y,25873834,26139515,265681,,0
-1,-1,Y,25873834,26139515,265681,,0
-1,-1,Y,25873834,26139515,265681,,0
-1,-1,Y,25873834,26139515,265681,,0
-1,-1,Y,25873834,26139515,265681,,0
-1,-1,Y,25873834,26139515,265681,,0
-1,-1,Y,25873834,26139515,265681,,0
-1,-1,Y,25873834,26189897,316063,,0
-1,-1,Y,25873834,26191446,317612,253175,1
-1,-1,Y,25873834,26282422,408588,253175,1
-1,-1,Y,25876504,26139515,263011,,0
-1,-1,Y,25876504,26139515,263011,,0
1,-1,Y,26458730,27449144,990414,57135;442868;442867;57054,4
1,-1,Y,26465961,27444389,978428,57135;442868;442867;57054,4
1,-1,Y,26465961,27496483,1030522,57135;442868;442867;57054,4
1,-1,Y,26473026,27422045,949019,57135;442868;442867;57054,4
1,-1,Y,26473026,27444389,971363,57135;442868;442867;57054,4
1,-1,Y,26473026,27699439,1226413,57135;442868;442867;57054,4
1,-1,Y,26473026,28455771,1982745,57054;57135;442868;442867;9085,5
1,-1,Y,26493944,27444389,950445,57135;442868;442867;57054,4
1,-1,Y,26493944,28455771,1961827,57054;57135;442868;442867;9085,5
1,-1,Y,26502929,27444389,941460,57135;442868;442867;57054,4
1,-1,Y,26502929,27455478,952549,57135;442868;442867;57054,4
1,-1,Y,26502929,27455478,952549,57135;442868;442867;57054,4
1,-1,Y,26509175,27449144,939969,57135;442868;442867;57054,4
1,-1,Y,26513288,27427269,913981,57135;442868;442867;57054,4
1,-1,Y,26513288,27427269,913981,57135;442868;442867;57054,4
1,-1,Y,26513288,27449144,935856,57135;442868;442867;57054,4
1,-1,Y,26513288,27449144,935856,57135;442868;442867;57054,4
1,-1,Y,26513288,27449144,935856,57135;442868;442867;57054,4
1,-1,Y,26513288,27449144,935856,57135;442868;442867;57054,4
-1,-1,Y,26518043,26943549,425506,442867;57054,2
-1,-1,Y,26518043,27444389,926346,57135;442868;442867;57054,4
-1,-1,Y,26518043,27444389,926346,57135;442868;442867;57054,4
1,-1,Y,26518043,27449144,931101,57135;442868;442867;57054,4
-1,-1,Y,26528959,26840055,311096,442867,1
-1,-1,Y,26528959,27427269,898310,57135;442868;442867;57054,4
-1,-1,Y,26528959,27427269,898310,57135;442868;442867;57054,4
-1,-1,Y,26528959,27427269,898310,57135;442868;442867;57054,4
-1,-1,Y,26528959,27433474,904515,57135;442868;442867;57054,4
-1,-1,Y,26528959,27433474,904515,57135;442868;442867;57054,4
-1,-1,Y,26528959,27433474,904515,57135;442868;442867;57054,4
-1,-1,Y,26528959,27433474,904515,57135;442868;442867;57054,4
1,-1,Y,26528959,27433474,904515,57135;442868;442867;57054,4
-1,-1,Y,26528959,27433474,904515,57135;442868;442867;57054,4
-1,-1,Y,26528959,27433474,904515,57135;442868;442867;57054,4
1,-1,Y,26528959,27433474,904515,57135;442868;442867;57054,4
-1,-1,Y,26528959,27433474,904515,57135;442868;442867;57054,4
-1,-1,Y,26528959,27433474,904515,57135;442868;442867;57054,4
-1,-1,Y,26528959,27433474,904515,57135;442868;442867;57054,4
1,-1,Y,26528959,27433474,904515,57135;442868;442867;57054,4
-1,-1,Y,26528959,27433474,904515,57135;442868;442867;57054,4
-1,-1,Y,26528959,27444389,915430,57135;442868;442867;57054,4
1,-1,Y,26528959,27455478,926519,57135;442868;442867;57054,4
-1,-1,Y,26535221,26920686,385465,442867;57054,2
1,-1,Y,26535221,27419680,884459,57135;442868;442867;57054,4
1,-1,Y,26535221,27422045,886824,57135;442868;442867;57054,4
1,-1,Y,26535221,27427269,892048,57135;442868;442867;57054,4
-1,-1,Y,26535221,27427269,892048,57135;442868;442867;57054,4
1,-1,Y,26535221,27427269,892048,57135;442868;442867;57054,4
1,-1,Y,26535221,27427269,892048,57135;442868;442867;57054,4
-1,-1,Y,26535221,27427269,892048,57135;442868;442867;57054,4
-1,-1,Y,26535221,27427269,892048,57135;442868;442867;57054,4
1,-1,Y,26535221,27427269,892048,57135;442868;442867;57054,4
-1,-1,Y,26535221,27427269,892048,57135;442868;442867;57054,4
-1,-1,Y,26535221,27427269,892048,57135;442868;442867;57054,4
-1,-1,Y,26535221,27427269,892048,57135;442868;442867;57054,4
1,-1,Y,26535221,27433474,898253,57135;442868;442867;57054,4
1,-1,Y,26535221,27593899,1058678,57135;442868;442867;57054,4
1,-1,Y,26551784,27386140,834356,57135;442868;442867;57054,4
1,-1,Y,26551784,27427269,875485,57135;442868;442867;57054,4
1,-1,Y,26551784,27444389,892605,57135;442868;442867;57054,4
1,-1,Y,26561760,27400648,838888,57135;442868;442867;57054,4
1,-1,Y,26561760,27449144,887384,57135;442868;442867;57054,4
1,-1,Y,26576268,27247605,671337,57135;442868;442867;57054,4
1,-1,Y,26576268,27371986,795718,57135;442868;442867;57054,4
1,-1,Y,26576268,27386140,809872,57135;442868;442867;57054,4
1,-1,Y,26576268,27386140,809872,57135;442868;442867;57054,4
1,-1,Y,26576268,27386140,809872,57135;442868;442867;57054,4
1,-1,Y,26576268,27386140,809872,57135;442868;442867;57054,4
1,-1,Y,26576268,27400648,824380,57135;442868;442867;57054,4
1,-1,Y,26576268,27427269,851001,57135;442868;442867;57054,4
1,-1,Y,26576268,27444389,868121,57135;442868;442867;57054,4
1,-1,Y,26576268,27449144,872876,57135;442868;442867;57054,4
1,-1,Y,26576268,27449144,872876,57135;442868;442867;57054,4
1,-1,Y,26578698,27383710,805012,57135;442868;442867;57054,4
1,-1,Y,26581462,27427269,845807,57135;442868;442867;57054,4
1,-1,Y,26590418,27386140,795722,57135;442868;442867;57054,4
1,-1,Y,26590418,27400648,810230,57135;442868;442867;57054,4
1,-1,Y,26714783,27380942,666159,57135;442868;442867;57054,4
1,-1,Y,26714783,27386140,671357,57135;442868;442867;57054,4
1,-1,Y,26714783,27449144,734361,57135;442868;442867;57054,4
-1,-1,Y,26842712,27112587,269875,57135;57054,2
-1,-1,Y,26842712,27112587,269875,57135;57054,2
-1,-1,Y,26842712,27112587,269875,57135;57054,2
-1,-1,Y,26842712,27112587,269875,57135;57054,2
-1,-1,Y,26842712,27112587,269875,57135;57054,2
-1,-1,Y,26842712,27112587,269875,57135;57054,2
-1,-1,Y,26842712,27112587,269875,57135;57054,2
-1,-1,Y,26842712,27112587,269875,57135;57054,2
-1,-1,Y,26842712,27119690,276978,57135;57054,2
-1,-1,Y,26842712,27119690,276978,57135;57054,2
-1,-1,Y,26842712,27119690,276978,57135;57054,2
-1,-1,Y,26842712,27119690,276978,57135;57054,2
-1,-1,Y,26842712,27119690,276978,57135;57054,2
-1,-1,Y,26842712,27119690,276978,57135;57054,2
-1,-1,Y,26842712,27119690,276978,57135;57054,2
-1,-1,Y,26842712,27119690,276978,57135;57054,2
-1,-1,Y,26842712,27119690,276978,57135;57054,2
-1,-1,Y,26842712,27119690,276978,57135;57054,2
-1,-1,Y,26842712,27119690,276978,57135;57054,2
-1,-1,Y,26842712,27119690,276978,57135;57054,2
-1,-1,Y,26842712,27119690,276978,57135;57054,2
-1,-1,Y,26842712,27119690,276978,57135;57054,2
-1,-1,Y,26842712,27119690,276978,57135;57054,2
-1,-1,Y,26842712,27119690,276978,57135;57054,2
-1,-1,Y,26842712,27119690,276978,57135;57054,2
-1,-1,Y,26842712,27119690,276978,57135;57054,2
-1,-1,Y,26842712,27119690,276978,57135;57054,2
-1,-1,Y,26842712,27119690,276978,57135;57054,2
-1,-1,Y,26842712,27119690,276978,57135;57054,2
-1,-1,Y,26842712,27119690,276978,57135;57054,2
-1,-1,Y,26842712,27119690,276978,57135;57054,2
-1,-1,Y,26842712,27119690,276978,57135;57054,2
-1,-1,Y,26842712,27119690,276978,57135;57054,2
-1,-1,Y,26842712,27119690,276978,57135;57054,2
-1,-1,Y,26842712,27119690,276978,57135;57054,2
-1,-1,Y,26842712,27119690,276978,57135;57054,2
-1,-1,Y,26842712,27119690,276978,57135;57054,2
-1,-1,Y,26842712,27119690,276978,57135;57054,2
-1,-1,Y,26842712,27119690,276978,57135;57054,2
-1,-1,Y,26842712,27119690,276978,57135;57054,2
-1,-1,Y,26842712,27119690,276978,57135;57054,2
-1,-1,Y,26842712,27119690,276978,57135;57054,2
-1,-1,Y,26842712,27119690,276978,57135;57054,2
-1,-1,Y,26842712,27119690,276978,57135;57054,2
-1,-1,Y,26842712,27119690,276978,57135;57054,2
-1,-1,Y,26842712,27119690,276978,57135;57054,2
-1,-1,Y,26842712,27173910,331198,57135;57054,2
1,-1,Y,26868357,27422045,553688,57135;442868;57054,3
-1,-1,Y,26910196,27112587,202391,57135;57054,2
-1,-1,Y,27000949,27433474,432525,57135;442868,2
1,-1,Y,27028442,28455771,1427329,57135;442868;9085,3
-1,-1,Y,27041717,27444389,402672,57135;442868,2
-1,-1,Y,27122348,27433474,311126,442868,1
1,-1,Y,27606702,28342367,735665,9085,1
1,-1,Y,27606702,28455771,849069,9085,1
1,-1,Y,27643237,28455771,812534,9085,1
1,-1,Y,27655024,28455771,800747,9085,1
1,-1,Y,27655024,28455771,800747,9085,1
1,-1,Y,27655024,28455771,800747,9085,1
1,-1,Y,27659235,28455771,796536,9085,1
1,-1,Y,27663870,28342367,678497,9085,1
1,-1,Y,27663870,28455771,791901,9085,1
1,-1,Y,27663870,28455771,791901,9085,1
1,-1,Y,27663870,28455771,791901,9085,1
1,-1,Y,27663870,28455771,791901,9085,1
1,-1,Y,27663870,28455771,791901,9085,1
1,-1,Y,27663870,28455771,791901,9085,1
1,-1,Y,27663870,28455771,791901,9085,1
1,-1,Y,27663870,28455771,791901,9085,1
1,-1,Y,27663870,28455771,791901,9085,1
1,-1,Y,27663870,28455771,791901,9085,1
1,-1,Y,27663870,28455771,791901,9085,1
1,-1,Y,27663870,28455771,791901,9085,1
1,-1,Y,27663870,28455771,791901,9085,1
1,-1,Y,27663870,28455771,791901,9085,1
1,-1,Y,27663870,28455771,791901,9085,1
1,-1,Y,27663870,28455771,791901,9085,1
1,-1,Y,27663870,28455771,791901,9085,1
1,-1,Y,27663870,28455771,791901,9085,1
1,-1,Y,27663870,28455771,791901,9085,1
1,-1,Y,27663870,28455771,791901,9085,1
1,-1,Y,27663870,28455771,791901,9085,1
1,-1,Y,27663870,28455771,791901,9085,1
1,-1,Y,27663870,28727756,1063886,9085,1
1,-1,Y,27663870,28727756,1063886,9085,1
1,-1,Y,27663870,28727756,1063886,9085,1
1,-1,Y,27672705,28291566,618861,9085,1
1,-1,Y,27672705,28342367,669662,9085,1
1,-1,Y,27672705,28342367,669662,9085,1
1,-1,Y,27672705,28345628,672923,9085,1
1,-1,Y,27672705,28455771,783066,9085,1
1,-1,Y,27672705,28455771,783066,9085,1
1,-1,Y,27672705,28455771,783066,9085,1
1,-1,Y,27672705,28455771,783066,9085,1
1,-1,Y,27672705,28455771,783066,9085,1
1,-1,Y,27672705,28609908,937203,9085,1
-1,-1,Y,27680011,27992745,312734,9085,1
-1,-1,Y,27680011,28088551,408540,9085,1
-1,-1,Y,27680011,28342367,662356,9085,1
1,-1,Y,27680011,28342367,662356,9085,1
1,-1,Y,27680011,28455771,775760,9085,1
1,-1,Y,27680011,28455771,775760,9085,1
1,-1,Y,27680011,28455771,775760,9085,1
1,-1,Y,27680011,28455771,775760,9085,1
1,-1,Y,27680011,28455771,775760,9085,1
1,-1,Y,27686344,28455771,769427,9085,1
1,-1,Y,27686344,28455771,769427,9085,1
-1,-1,Y,27772528,28088551,316023,,0
-1,-1,Y,27772528,28088551,316023,,0
-1,-1,Y,27772528,28088551,316023,,0
-1,-1,Y,27792217,27992745,200528,,0
-1,-1,Y,27792217,27992745,200528,,0
-1,-1,Y,27792217,27992745,200528,,0
-1,-1,Y,27792217,27992745,200528,,0
-1,-1,Y,27792217,27992745,200528,,0
-1,-1,Y,27792217,27992745,200528,,0
-1,-1,Y,27792217,27992745,200528,,0
-1,-1,Y,27792217,27992745,200528,,0
-1,-1,Y,27792217,27992745,200528,,0
-1,-1,Y,27792217,28088551,296334,,0
-1,-1,Y,27792217,28088551,296334,,0
-1,-1,Y,27792217,28088551,296334,,0
-1,-1,Y,27792217,28088551,296334,,0
-1,-1,Y,27792217,28088551,296334,,0
-1,-1,Y,27792217,28088551,296334,,0
-1,-1,Y,27792217,28088551,296334,,0
-1,-1,Y,27792217,28088551,296334,,0
-1,-1,Y,27792217,28088551,296334,,0
-1,-1,Y,27792217,28088551,296334,,0
-1,-1,Y,27792217,28088551,296334,,0
-1,-1,Y,27792217,28088551,296334,,0
-1,-1,Y,27792217,28088551,296334,,0
-1,-1,Y,27792217,28088551,296334,,0
-1,-1,Y,27792217,28088551,296334,,0
-1,-1,Y,27792217,28088551,296334,,0
-1,-1,Y,27792217,28088551,296334,,0
-1,-1,Y,27792217,28088551,296334,,0
-1,-1,Y,27792217,28088551,296334,,0
-1,-1,Y,27792217,28088551,296334,,0
-1,-1,Y,27792217,28088551,296334,,0
-1,-1,Y,27792217,28088551,296334,,0
-1,-1,Y,27792217,28088551,296334,,0
-1,-1,Y,27792217,28088551,296334,,0
-1,-1,Y,27792217,28088551,296334,,0
-1,-1,Y,27792217,28088551,296334,,0
-1,-1,Y,27792217,28088551,296334,,0
-1,-1,Y,27792217,28088551,296334,,0
-1,-1,Y,27792217,28088551,296334,,0
-1,-1,Y,27792217,28088551,296334,,0
-1,-1,Y,27792217,28088551,296334,,0
-1,-1,Y,27792217,28088551,296334,,0
-1,-1,Y,27792217,28088551,296334,,0
-1,-1,Y,27792217,28088551,296334,,0
-1,-1,Y,27792217,28104707,312490,,0
-1,-1,Y,27792217,28104707,312490,,0
-1,-1,Y,27792217,28104707,312490,,0
-1,-1,Y,27792217,28104707,312490,,0
-1,-1,Y,27792217,28112172,319955,,0
-1,-1,Y,27792217,28112172,319955,,0
-1,-1,Y,27809091,28088551,279460,,0
-1,-1,Y,27809091,28088551,279460,,0
-1,-1,Y,27809091,28088551,279460,,0
-1,-1,Y,27809091,28112172,303081,,0
-1,-1,Y,27809091,28114563,305472,,0
-1,-1,Y,27822921,28088551,265630,,0
-1,-1,Y,27822921,28088551,265630,,0
-1,-1,Y,27822921,28088551,265630,,0
-1,-1,Y,27822921,28088551,265630,,0
-1,-1,Y,27822921,28088551,265630,,0
-1,-1,Y,27822921,28104707,281786,,0
-1,-1,Y,27822921,28114563,291642,,0
-1,-1,Y,27822921,28114563,291642,,0
-1,-1,Y,28114504,28342367,227863,,0
-1,-1,Y,28114504,28342367,227863,,0
-1,-1,Y,28114504,28342367,227863,,0
-1,-1,Y,28114504,28345628,231124,,0
-1,-1,Y,28114504,28345628,231124,,0
1,-1,Y,28321432,59079469,30758037,,0
1,-1,Y,28393720,59028689,30634969,,0
-1,-1,Y,28536083,59354877,30818794,10251;6845;3581,3
1,-1,Y,28548467,58968344,30419877,,0
1,-1,Y,28555864,59077471,30521607,,0
1,-1,Y,28555864,59079469,30523605,,0
1,-1,Y,28609908,59077471,30467563,,0
1,-1,Y,28609908,59079469,30469561,,0
1,-1,Y,28609908,59079469,30469561,,0
1,-1,Y,28629836,58968344,30338508,,0
1,-1,Y,28629836,58968344,30338508,,0
1,-1,Y,28629836,59032329,30402493,,0
1,-1,Y,28629836,59077471,30447635,,0
1,-1,Y,28629836,59079469,30449633,,0
1,-1,Y,28629836,59088015,30458179,,0
1,-1,Y,28629836,59088015,30458179,,0
1,-1,Y,28629836,59088015,30458179,,0
1,-1,Y,28673402,58968344,30294942,,0
1,-1,Y,28673402,58968344,30294942,,0
1,-1,Y,28673402,58968344,30294942,,0
1,-1,Y,28673402,58968344,30294942,,0
1,-1,Y,28673402,58968344,30294942,,0
1,-1,Y,28673402,59019002,30345600,,0
1,-1,Y,28673402,59028689,30355287,,0
1,-1,Y,28673402,59028689,30355287,,0
1,-1,Y,28673402,59032329,30358927,,0
1,-1,Y,28673402,59077471,30404069,,0
1,-1,Y,28673402,59079469,30406067,,0
1,-1,Y,28673402,59079469,30406067,,0
1,-1,Y,28673402,59079469,30406067,,0
1,-1,Y,28673402,59079469,30406067,,0
1,-1,Y,28673402,59079469,30406067,,0
1,-1,Y,28673402,59088015,30414613,,0
1,-1,Y,28673402,59088015,30414613,,0
1,-1,Y,28673402,59088015,30414613,,0
1,-1,Y,28689355,58968344,30278989,,0
1,-1,Y,28689355,59088015,30398660,,0
1,-1,Y,28703883,59032329,30328446,,0
1,-1,Y,28703883,59077471,30373588,,0
1,-1,Y,28703883,59077471,30373588,,0
1,-1,Y,28703883,59077471,30373588,,0
1,-1,Y,28703883,59079469,30375586,,0
1,-1,Y,28703883,59079469,30375586,,0
1,-1,Y,28703883,59079469,30375586,,0
1,-1,Y,28703883,59088015,30384132,,0
1,-1,Y,28703883,59088015,30384132,,0
1,-1,Y,28703883,59088015,30384132,,0
-1,-1,Y,28768132,58968344,30200212,,0
1,-1,Y,28776663,59001403,30224740,,0
1,-1,Y,28776663,59032329,30255666,,0
1,-1,Y,28776663,59077471,30300808,,0
-1,-1,Y,28784029,59178329,30394300,10251,1
1,-1,Y,58969260,58995640,26380,,0
1,-1,Y,58983344,58995640,12296,,0
1,-1,Y,58983344,58995640,12296,,0
-1,-1,Y,58983344,59358798,375454,10251;6845;3581,3
-1,-1,Y,59002344,59031421,29077,,0
1,-1,Y,59002344,59031480,29136,,0
1,-1,Y,59002344,59031480,29136,,0
-1,-1,Y,59028692,59349591,320899,10251;6845;3581,3
1,1,Y,59077471,59329063,251592,10251;6845,2
1,1,Y,59077471,59349650,272179,10251;6845;3581,3
-1,-1,Y,59033287,59363566,330279,10251;6845;3581,3
-1,-1,Y,59036725,59327713,290988,10251;6845,2
-1,-1,Y,59036725,59327713,290988,10251;6845,2
-1,-1,Y,59036725,59327713,290988,10251;6845,2
-1,-1,Y,59036725,59349591,312866,10251;6845;3581,3
1,-1,Y,59036725,59358798,322073,10251;6845;3581,3
-1,-1,Y,59049836,59354877,305041,10251;6845;3581,3
-1,-1,Y,59049836,59354877,305041,10251;6845;3581,3
-1,-1,Y,59049836,59354877,305041,10251;6845;3581,3
-1,-1,Y,59077673,59335913,258240,10251;6845;3581,3
-1,-1,Y,59117793,59139317,21524,,0
-1,-1,Y,59138674,59313102,174428,6845,1
-1,-1,Y,59138674,59354877,216203,3581;6845,2
-1,-1,Y,59138674,59354877,216203,3581;6845,2
-1,-1,Y,59304399,59336998,32599,3581,1
1,-1,Y,59331924,59343569,11645,3581,1
