gain_loss,pathogenicity,chr,start,end,size
-1,1,1,14874,7527302,7512428
-1,1,1,14874,8845386,8830512
1,1,1,19225,4401691,4382466
-1,-1,1,228697,649718,421021
-1,-1,1,348740,640954,292214
-1,-1,1,421308,678822,257514
-1,-1,1,421308,678822,257514
-1,1,1,564424,3582058,3017634
-1,-1,1,564435,649748,85313
-1,1,1,697794,2567838,1870044
-1,1,1,714078,4958499,4244421
-1,1,1,714144,2867436,2153292
-1,1,1,757093,2394455,1637362
-1,1,1,757093,2499074,1741981
-1,1,1,757093,2567832,1810739
-1,1,1,757093,2892687,2135594
-1,1,1,757093,3354772,2597679
-1,1,1,757093,3486455,2729362
-1,1,1,757093,4285145,3528052
-1,1,1,757093,5160050,4402957
-1,1,1,757093,5299703,4542610
-1,1,1,757093,5540323,4783230
-1,1,1,757093,7060898,6303805
-1,1,1,779727,2558913,1779186
-1,1,1,779727,2558913,1779186
-1,1,1,779727,4458182,3678455
-1,1,1,779727,6976647,6196920
-1,1,1,779727,7930605,7150878
-1,1,1,779727,8231974,7452247
-1,1,1,779727,12530188,11750461
1,-1,1,779733,846621,66888
-1,1,1,779733,2352355,1572622
-1,1,1,779733,3070473,2290740
-1,1,1,779733,3404441,2624708
1,1,1,779733,5887252,5107519
-1,1,1,779733,6537534,5757801
1,-1,1,794625,846707,52082
1,-1,1,803989,866414,62425
-1,1,1,809759,5033321,4223562
-1,1,1,834101,7871366,7037265
-1,1,1,837491,9616363,8778872
1,-1,1,839450,867543,28093
-1,-1,1,839450,913631,74181
-1,1,1,846680,2879954,2033274
-1,1,1,846680,3404423,2557743
1,1,1,846680,3531051,2684371
1,1,1,846680,3531051,2684371
-1,1,1,846680,4087427,3240747
-1,1,1,846680,9389984,8543304
-1,1,1,849466,1549149,699683
-1,1,1,849466,2330338,1480872
-1,1,1,849466,2397177,1547711
-1,1,1,849466,2554275,1704809
-1,1,1,849466,2607016,1757550
-1,1,1,849466,2748837,1899371
-1,1,1,849466,3222027,2372561
1,1,1,849466,3396845,2547379
-1,1,1,849466,3503606,2654140
-1,1,1,849466,4048535,3199069
-1,1,1,849466,4099471,3250005
-1,1,1,849466,5318552,4469086
-1,1,1,849466,5352492,4503026
-1,1,1,849466,5707515,4858049
-1,1,1,849466,6374209,5524743
-1,1,1,849466,6505278,5655812
-1,1,1,849466,6566086,5716620
-1,1,1,849466,7300178,6450712
-1,1,1,849466,7637060,6787594
-1,1,1,849466,8901938,8052472
-1,1,1,849466,9627180,8777714
-1,1,1,849466,9683808,8834342
1,1,1,849467,249224684,248375217
1,1,1,849467,249224684,248375217
1,-1,1,852863,1008286,155423
1,-1,1,852863,1008286,155423
-1,1,1,885378,5396112,4510734
-1,1,1,885378,6635005,5749627
1,-1,1,889745,897726,7981
1,-1,1,890945,1008286,117341
1,-1,1,913631,1008286,94655
1,-1,1,913631,1008286,94655
1,-1,1,913631,1008286,94655
1,-1,1,931484,1008286,76802
-1,1,1,948461,1654038,705577
-1,1,1,957474,4725355,3767881
1,-1,1,964697,1008286,43589
1,-1,1,964697,1008286,43589
1,-1,1,964697,1008286,43589
1,-1,1,964697,1008286,43589
1,-1,1,964697,1008286,43589
-1,1,1,1008286,2723403,1715117
-1,1,1,1054016,4239140,3185124
-1,-1,1,1078536,1158683,80147
1,-1,1,1226242,1268865,42623
1,-1,1,1241799,1268865,27066
1,-1,1,1387704,1425677,37973
-1,-1,1,1400189,1425677,25488
-1,-1,1,1400189,1425677,25488
-1,-1,1,1400189,1425677,25488
-1,-1,1,1400189,1425677,25488
1,-1,1,1403417,1462949,59532
-1,1,1,1415800,5007235,3591435
-1,-1,1,1417977,1451373,33396
-1,1,1,1538143,2140271,602128
1,-1,1,2495137,2620704,125567
-1,-1,1,2582760,2633368,50608
-1,-1,1,2582760,2633368,50608
1,-1,1,2582760,2633368,50608
1,-1,1,2590844,2605254,14410
1,-1,1,2590844,2605254,14410
1,-1,1,2590844,2605254,14410
1,-1,1,2590844,2605254,14410
1,-1,1,2590844,2605254,14410
1,-1,1,2609223,2631378,22155
1,-1,1,2736695,2922757,186062
-1,1,1,2749920,22564787,19814867
-1,1,1,2785042,7392629,4607587
-1,1,1,2793822,7510850,4717028
-1,1,1,2817420,10670878,7853458
-1,1,1,2822585,5396176,2573591
1,1,1,3628652,4087427,458775
1,1,1,3628652,4087427,458775
-1,1,1,3657629,9018919,5361290
-1,1,1,4558588,13187457,8628869
-1,1,1,4958499,12971757,8013258
-1,1,1,5270319,8576813,3306494
-1,1,1,5423886,18686796,13262910
-1,1,1,6363701,16125588,9761887
1,1,1,6614945,16382506,9767561
1,1,1,7301946,11143298,3841352
-1,1,1,8343754,12530188,4186434
1,1,1,8990090,16518045,7527955
-1,1,1,9124551,12726755,3602204
-1,1,1,9488597,16142286,6653689
-1,1,1,10324455,16107335,5782880
-1,1,1,10448139,16107331,5659192
1,-1,1,10697093,10753078,55985
1,-1,1,10697093,10804053,106960
1,-1,1,10753078,10804053,50975
1,-1,1,12353332,13178669,825337
1,-1,1,12726725,13385572,658847
1,-1,1,12726725,13385572,658847
-1,1,1,12784752,16361283,3576531
-1,-1,1,12839441,13142569,303128
-1,-1,1,12839474,13158536,319062
1,-1,1,12839474,13699359,859885
1,-1,1,12839474,13737920,898446
1,-1,1,12839474,13737920,898446
1,-1,1,12839474,13737920,898446
1,-1,1,12839474,13737920,898446
1,-1,1,12839474,13737920,898446
1,-1,1,12839474,13737920,898446
1,-1,1,12839474,13737920,898446
1,-1,1,12839474,13737920,898446
1,-1,1,12839474,13737920,898446
1,-1,1,12839474,13737920,898446
1,-1,1,12839474,13737920,898446
1,-1,1,12839474,13737920,898446
1,-1,1,12839474,13737920,898446
1,-1,1,12839474,13737920,898446
1,-1,1,12839474,13737920,898446
1,-1,1,12839474,13737920,898446
1,-1,1,12839474,13737920,898446
1,-1,1,12839474,13737920,898446
1,-1,1,12839474,13757756,918282
1,-1,1,12839474,13757756,918282
1,-1,1,12839474,13757756,918282
1,-1,1,12839474,13757756,918282
1,-1,1,12839474,13757756,918282
1,-1,1,12839474,13757756,918282
1,-1,1,12839474,13757756,918282
1,-1,1,12839474,13775144,935670
1,-1,1,12839474,13775144,935670
1,-1,1,12839474,13775144,935670
1,-1,1,12839474,13775144,935670
-1,-1,1,12850038,13158536,308498
-1,-1,1,12850038,13448280,598242
-1,-1,1,12850038,13448280,598242
-1,-1,1,12850038,13448280,598242
1,-1,1,12850038,13757756,907718
1,-1,1,12850038,13757756,907718
1,-1,1,12850038,13757756,907718
1,-1,1,12850038,13757756,907718
1,-1,1,12850038,13757756,907718
-1,-1,1,12860810,12918815,58005
-1,-1,1,12860810,12918815,58005
1,-1,1,12866505,13757756,891251
-1,1,1,13178371,19961858,6783487
-1,-1,1,13203161,13737920,534759
-1,1,1,16008307,19988832,3980525
1,-1,1,16350393,16358989,8596
1,-1,1,16350393,16358989,8596
1,-1,1,16350393,16358989,8596
1,-1,1,16350393,16358989,8596
1,-1,1,16350393,16358989,8596
1,-1,1,16350393,16381893,31500
1,-1,1,16358989,16381893,22904
1,-1,1,16358989,16384554,25565
-1,-1,1,16364253,16376855,12602
1,-1,1,16372151,16381893,9742
1,-1,1,16372151,16381893,9742
1,-1,1,16372151,16381893,9742
1,-1,1,16372151,16381893,9742
1,-1,1,16372151,16384554,12403
-1,-1,1,16372151,16384554,12403
1,-1,1,16372151,16384554,12403
1,-1,1,16372151,16384554,12403
1,-1,1,16372151,16384554,12403
1,-1,1,16372151,16390104,17953
1,-1,1,16372151,16390104,17953
1,-1,1,16372151,16390104,17953
1,-1,1,16714294,17284789,570495
1,-1,1,16785307,17363575,578268
-1,-1,1,16814372,17104536,290164
1,-1,1,16814372,17104536,290164
-1,-1,1,16849629,17284789,435160
-1,-1,1,16926777,17048762,121985
1,-1,1,16941653,17231817,290164
-1,-1,1,16948127,17231817,283690
-1,-1,1,16963573,17053916,90343
1,-1,1,17051209,17231787,180578
-1,-1,1,17088427,17106477,18050
-1,1,1,20067124,22537862,2470738
1,-1,1,23106615,23241148,134533
1,1,1,24707696,41886350,17178654
-1,-1,1,25609479,25648287,38808
1,-1,1,25611203,25688876,77673
1,-1,1,25611203,25688876,77673
1,-1,1,25611203,25688876,77673
1,-1,1,25702769,25913028,210259
-1,1,1,28751378,33588455,4837077
1,-1,1,28904254,28907123,2869
-1,1,1,29600988,31598923,1997935
-1,-1,1,30589668,31169396,579728
-1,1,1,34830287,36945093,2114806
-1,1,1,41300076,43588742,2288666
-1,1,1,42914303,45001279,2086976
-1,-1,1,44979717,45001279,21562
1,-1,1,46335187,46546272,211085
-1,-1,1,49929425,49988076,58651
-1,-1,1,49929425,49988076,58651
-1,-1,1,49929425,49988076,58651
-1,-1,1,49929425,49988076,58651
-1,-1,1,49959425,50049480,90055
-1,1,1,51729573,55164001,3434428
-1,1,1,54092945,64714537,10621592
-1,1,1,55791287,63405767,7614480
-1,1,1,59285277,69572791,10287514
-1,1,1,59285277,86564294,27279017
-1,1,1,60226528,72043735,11817207
-1,1,1,60226528,72043735,11817207
-1,1,1,61351024,79583933,18232909
1,-1,1,61693951,62199657,505706
1,1,1,61785602,67430956,5645354
-1,1,1,63252828,77402595,14149767
-1,-1,1,64151170,64176502,25332
-1,1,1,64321264,88153669,23832405
1,1,1,64538290,75984117,11445827
1,1,1,64538290,75984117,11445827
1,-1,1,65881068,65939484,58416
1,-1,1,65939484,66007500,68016
-1,1,1,67330808,77589066,10258258
1,-1,1,69789895,69938097,148202
-1,1,1,72044544,92505091,20460547
-1,-1,1,72124095,72241965,117870
1,-1,1,76718950,77039352,320402
-1,1,1,76884987,89094147,12209160
-1,-1,1,79541360,79612216,70856
-1,-1,1,81087249,82506486,1419237
1,-1,1,81436507,81923572,487065
1,1,1,83923008,104816539,20893531
-1,1,1,92956486,93972848,1016362
1,1,1,93837992,121343783,27505791
-1,-1,1,97665736,98343102,677366
-1,1,1,97737905,109435760,11697855
-1,1,1,97737948,104321746,6583798
-1,-1,1,102656654,102849723,193069
-1,-1,1,102656654,102849723,193069
-1,-1,1,102656654,102849723,193069
-1,-1,1,102656654,102849723,193069
-1,1,1,103657255,112451259,8794004
-1,-1,1,103746487,104297301,550814
-1,-1,1,104092317,104642037,549720
1,-1,1,104107559,104163781,56222
1,-1,1,104124935,104297301,172366
1,-1,1,104124935,104297301,172366
1,-1,1,104124935,104297301,172366
1,-1,1,104161001,104211027,50026
-1,1,1,104185489,104284282,98793
1,1,1,104868106,120471049,15602943
-1,-1,1,105426437,105828217,401780
-1,1,1,106010914,112733248,6722334
-1,-1,1,106042587,106258450,215863
-1,-1,1,106042587,106258450,215863
-1,-1,1,106042587,106258450,215863
-1,-1,1,106060371,106258498,198127
-1,-1,1,106060371,106258498,198127
1,-1,1,106686815,106769435,82620
1,1,1,107921992,142552733,34630741
1,-1,1,108789087,108968534,179447
1,-1,1,108789087,108968534,179447
1,-1,1,108789087,108968534,179447
1,-1,1,108811026,108941110,130084
1,-1,1,108811026,108968534,157508
1,-1,1,108811026,108968534,157508
1,1,1,114507501,120494232,5986731
1,1,1,114792300,121349803,6557503
1,-1,1,120556740,120635392,78652
1,-1,1,120556740,120635392,78652
1,-1,1,120556740,120635392,78652
1,-1,1,120569414,120635392,65978
1,-1,1,120672583,142552733,21880150
1,-1,1,120767793,120921239,153446
-1,-1,1,120854455,120935334,80879
1,-1,1,121158554,121349803,191249
1,-1,1,121184268,121349803,165535
-1,-1,1,142594227,142642753,48526
-1,-1,1,142594227,142642753,48526
1,-1,1,142604414,142642753,38339
-1,-1,1,142604414,142642753,38339
-1,-1,1,142604414,142642753,38339
-1,-1,1,142604414,142642753,38339
-1,-1,1,142604414,142642753,38339
-1,-1,1,142604414,142642753,38339
-1,-1,1,142604414,142642753,38339
1,1,1,142618650,148535229,5916579
1,-1,1,142663112,142791662,128550
1,-1,1,142728921,142907112,178191
1,-1,1,143134063,143284670,150607
1,-1,1,143391916,143457097,65181
1,-1,1,143400885,143504612,103727
1,-1,1,143428345,143532171,103826
1,-1,1,143441231,143518139,76908
1,-1,1,143441231,143532171,90940
1,-1,1,143457097,143532171,75074
1,-1,1,143457097,143532171,75074
-1,-1,1,143482388,143540851,58463
1,-1,1,143504612,143540851,36239
1,1,1,143544035,149754161,6210126
-1,-1,1,143646652,143908838,262186
-1,-1,1,143652719,143771002,118283
1,-1,1,143673098,144389627,716529
1,-1,1,143719563,144860341,1140778
1,1,1,143753740,151399970,7646230
1,-1,1,144009907,144090824,80917
1,-1,1,144009907,144090824,80917
-1,1,1,144368497,148636756,4268259
-1,1,1,144371838,148832359,4460521
1,-1,1,144451745,144524956,73211
1,-1,1,144451745,144524956,73211
1,-1,1,144451745,144524956,73211
-1,-1,1,144451745,144524956,73211
1,-1,1,144607254,144616674,9420
1,-1,1,144619884,144828763,208879
1,-1,1,144619884,144828763,208879
1,-1,1,144619884,144828763,208879
1,-1,1,144674799,144828763,153964
1,1,1,144833672,148870387,4036715
-1,1,1,144880315,148832359,3952044
-1,-1,1,144955198,145079786,124588
-1,1,1,144955198,145831720,876522
1,-1,1,145112506,145291030,178524
1,-1,1,145112506,145368848,256342
1,-1,1,145112506,145368848,256342
1,-1,1,145112506,145368848,256342
1,-1,1,145112506,145368848,256342
1,-1,1,145112506,145368848,256342
1,-1,1,145112506,145368848,256342
1,1,1,145112506,145735326,622820
1,-1,1,145194054,145361282,167228
1,1,1,145224606,145735326,510720
1,1,1,145271815,145746912,475097
1,1,1,145271815,148254822,2983007
1,1,1,145283118,145735326,452208
-1,1,1,145311043,147915048,2604005
1,-1,1,145368848,145421552,52704
-1,1,1,145376675,147860552,2483877
-1,1,1,145376675,147860552,2483877
-1,1,1,145387023,145792051,405028
-1,1,1,145387023,145803834,416811
-1,1,1,145387945,145735326,347381
-1,1,1,145387945,145735326,347381
1,1,1,145387945,145735326,347381
-1,1,1,145387945,145735326,347381
-1,1,1,145388004,146535353,1147349
1,-1,1,145388355,145430633,42278
-1,1,1,145388355,149418924,4030569
-1,1,1,145388369,145899418,511049
1,-1,1,145415156,145799615,384459
-1,1,1,145415156,147824212,2409056
-1,1,1,145415156,149433207,4018051
-1,1,1,145415190,146053471,638281
1,1,1,145415190,148809863,3394673
-1,1,1,145415190,148809863,3394673
-1,1,1,145415190,148809863,3394673
-1,1,1,145425395,145799602,374207
-1,1,1,145425395,145799602,374207
-1,1,1,145425395,145799602,374207
1,-1,1,145425395,145799602,374207
-1,1,1,145425395,145799602,374207
-1,1,1,145425395,145799602,374207
1,-1,1,145425395,146507577,1082182
1,1,1,145425395,148867610,3442215
1,1,1,145425395,149091187,3665792
1,1,1,145425395,149699420,4274025
-1,-1,1,145610469,145922633,312164
1,-1,1,145611279,145735326,124047
1,-1,1,145611279,145735326,124047
1,-1,1,145611279,145735326,124047
1,-1,1,145611279,145735326,124047
1,-1,1,145620108,145735326,115218
1,-1,1,145620108,145935640,315532
1,-1,1,145620108,145935640,315532
1,-1,1,145626237,145735326,109089
1,-1,1,145626237,145831720,205483
-1,1,1,145626237,147828089,2201852
-1,1,1,145626237,147828089,2201852
-1,1,1,145626237,147828089,2201852
-1,1,1,145626237,147828089,2201852
-1,1,1,145626237,147828089,2201852
-1,1,1,145626237,147828089,2201852
-1,1,1,145626237,147828089,2201852
-1,1,1,145626237,147828089,2201852
-1,1,1,145626237,147828089,2201852
-1,1,1,145626237,147828089,2201852
-1,1,1,145626237,149244468,3618231
-1,1,1,145626237,149244468,3618231
-1,1,1,145626237,149453964,3827727
-1,1,1,145655992,147828089,2172097
-1,1,1,145655992,147909094,2253102
-1,1,1,145655992,147909094,2253102
-1,1,1,145655992,147909094,2253102
-1,1,1,145655992,147909094,2253102
-1,1,1,145655992,148545520,2889528
-1,1,1,145655992,149232481,3576489
-1,1,1,145723321,147828089,2104768
1,1,1,145743623,147824031,2080408
1,1,1,145743623,147872253,2128630
1,1,1,145743623,147907013,2163390
-1,1,1,145747242,149155026,3407784
1,1,1,145751815,148000664,2248849
1,1,1,145764499,249233096,103468597
-1,1,1,145765829,147834136,2068307
-1,1,1,145765829,147872253,2106424
-1,1,1,145765829,147872253,2106424
-1,1,1,145765829,147872253,2106424
1,1,1,145788863,148809863,3021000
1,1,1,145788863,148809863,3021000
1,1,1,145791974,147759730,1967756
-1,1,1,145791974,147848380,2056406
1,1,1,145799556,147824212,2024656
1,1,1,145799556,147824212,2024656
1,1,1,145799556,148867640,3068084
-1,1,1,145804679,147828089,2023410
1,1,1,145804738,148832322,3027584
1,1,1,145804738,148832322,3027584
1,1,1,145883452,147872253,1988801
-1,1,1,145885645,147947839,2062194
-1,1,1,145886339,147897962,2011623
-1,1,1,145888925,147926347,2037422
-1,1,1,145888925,147926347,2037422
-1,1,1,145888925,148020200,2131275
-1,1,1,145895746,147856007,1960261
-1,1,1,145895746,147897962,2002216
1,1,1,145895747,147831170,1935423
1,1,1,145899339,148782879,2883540
1,1,1,145899359,147887713,1988354
1,1,1,145932454,147819294,1886840
-1,1,1,145932455,147385641,1453186
1,1,1,145987156,147909094,1921938
1,1,1,145987156,147909094,1921938
1,1,1,145987156,147909094,1921938
1,1,1,145987156,147909094,1921938
1,1,1,145987156,148545520,2558364
1,1,1,145987156,148545520,2558364
-1,1,1,145987156,148545520,2558364
-1,1,1,145987156,148545520,2558364
-1,1,1,145987156,148545520,2558364
-1,1,1,145987156,148545520,2558364
1,1,1,146016526,147830830,1814304
-1,1,1,146023923,147929323,1905400
1,1,1,146034513,148832322,2797809
1,1,1,146038914,147838700,1799786
1,1,1,146043713,147819294,1775581
-1,1,1,146043713,147844758,1801045
-1,1,1,146043713,147897962,1854249
-1,1,1,146043713,147897962,1854249
-1,1,1,146043713,147897962,1854249
-1,1,1,146043713,147897962,1854249
-1,1,1,146043713,147897962,1854249
-1,1,1,146043713,147929323,1885610
-1,1,1,146053394,249233096,103179702
-1,1,1,146053414,147828089,1774675
-1,1,1,146053414,147828089,1774675
-1,1,1,146053414,147828089,1774675
-1,1,1,146053414,147860552,1807138
1,1,1,146053414,148535229,2481815
1,1,1,146053414,148535229,2481815
-1,1,1,146053453,147834136,1780683
1,1,1,146053453,147872253,1818800
-1,1,1,146053453,147872253,1818800
1,1,1,146053453,147907013,1853560
1,1,1,146053453,147907013,1853560
1,1,1,146053453,147907013,1853560
1,1,1,146096700,147819294,1722594
-1,1,1,146096701,147898062,1801361
1,1,1,146101790,147830830,1729040
-1,1,1,146101790,147830830,1729040
-1,1,1,146101790,147897962,1796172
-1,1,1,146101790,148020200,1918410
-1,1,1,146105170,147830830,1725660
1,1,1,146105170,147830830,1725660
-1,1,1,146105170,147830830,1725660
-1,1,1,146105170,147897962,1792792
-1,1,1,146105170,147897962,1792792
-1,1,1,146105170,147897962,1792792
-1,1,1,146105170,147897962,1792792
-1,1,1,146105170,147929323,1824153
-1,1,1,146105170,147929323,1824153
-1,1,1,146105170,148016122,1910952
-1,1,1,146105170,148016122,1910952
-1,1,1,146105170,148016122,1910952
-1,1,1,146105170,148020200,1915030
-1,1,1,146105170,148513854,2408684
1,1,1,146106723,147830830,1724107
-1,1,1,146127815,147844758,1716943
-1,1,1,146143189,147721869,1578680
-1,1,1,146143189,147909094,1765905
1,1,1,146143189,147909094,1765905
-1,1,1,146143189,147909094,1765905
-1,1,1,146143189,147909094,1765905
-1,1,1,146143189,147909094,1765905
1,1,1,146143189,147909094,1765905
-1,1,1,146143189,147909094,1765905
-1,1,1,146143189,147909094,1765905
-1,1,1,146143189,147909094,1765905
-1,1,1,146143189,147909094,1765905
-1,1,1,146143189,147909094,1765905
1,1,1,146143189,147909094,1765905
1,1,1,146143189,148545520,2402331
1,1,1,146143189,148545520,2402331
1,1,1,146143189,148545520,2402331
1,1,1,146143189,148545520,2402331
-1,1,1,146143189,149232481,3089292
-1,1,1,146143189,149232481,3089292
-1,1,1,146145424,147929323,1783899
1,1,1,146470888,147830903,1360015
-1,1,1,146474216,147828089,1353873
1,1,1,146488131,147052016,563885
1,1,1,146496382,147409820,913438
1,1,1,146496425,147048600,552175
1,1,1,146496425,147929323,1432898
1,1,1,146498198,147926347,1428149
1,1,1,146500972,147824207,1323235
1,1,1,146500972,147828089,1327117
-1,1,1,146500972,147828089,1327117
-1,1,1,146500972,147828089,1327117
-1,1,1,146500972,147828089,1327117
1,1,1,146500972,147828089,1327117
-1,1,1,146500972,147828089,1327117
-1,1,1,146500972,147828089,1327117
-1,1,1,146500972,147828089,1327117
1,1,1,146500972,147828089,1327117
-1,1,1,146500972,147828089,1327117
1,1,1,146500972,147828089,1327117
1,1,1,146500972,147828089,1327117
-1,1,1,146500972,147828089,1327117
1,1,1,146500972,147828089,1327117
1,1,1,146500972,148535229,2034257
1,1,1,146500972,148535229,2034257
1,1,1,146500972,148535229,2034257
1,1,1,146500972,148535229,2034257
1,1,1,146500972,148535229,2034257
1,1,1,146500972,148535229,2034257
1,1,1,146500972,148535229,2034257
1,1,1,146500972,148535229,2034257
1,1,1,146500972,148535229,2034257
1,1,1,146500972,148535229,2034257
1,1,1,146500972,149433185,2932213
1,1,1,146507518,147441040,933522
1,1,1,146507518,147824207,1316689
1,1,1,146507518,147824207,1316689
1,1,1,146507518,147824207,1316689
-1,1,1,146507518,147909094,1401576
-1,1,1,146507649,147381479,873830
1,1,1,146507649,147824212,1316563
-1,1,1,146507649,148545664,2038015
-1,1,1,146507649,148545664,2038015
-1,1,1,146507649,149433207,2925558
-1,1,1,146507711,147417736,910025
1,1,1,146526310,147828089,1301779
1,1,1,146526310,147828089,1301779
1,1,1,146526310,148535229,2008919
1,1,1,146526310,148535229,2008919
1,1,1,146526310,148535229,2008919
-1,1,1,146535353,147857078,1321725
-1,1,1,146535353,147857078,1321725
-1,1,1,146535353,147857078,1321725
-1,1,1,146535353,147857078,1321725
-1,1,1,146535353,147857078,1321725
1,1,1,146535353,147867734,1332381
1,1,1,146535353,147877162,1341809
1,1,1,146535353,147900955,1365602
-1,1,1,146542843,147828089,1285246
-1,1,1,146564743,147735011,1170268
1,1,1,146571304,148545520,1974216
1,1,1,146628101,147824212,1196111
1,1,1,146807433,147381411,573978
-1,-1,1,146849965,146927600,77635
1,-1,1,147228667,147248718,20051
1,-1,1,147394188,147424808,30620
1,1,1,147411534,149699420,2287886
-1,-1,1,147505013,148209425,704412
1,-1,1,147599068,147599100,32
1,-1,1,147599068,147857078,258010
1,-1,1,147734952,147909430,174478
-1,-1,1,147735759,147824148,88389
1,-1,1,147824212,149817768,1993556
1,-1,1,147828088,149039684,1211596
1,-1,1,147828088,149736090,1908002
1,-1,1,147860611,149817768,1957157
1,-1,1,147897667,147909430,11763
1,-1,1,147909430,147962225,52795
1,-1,1,147962225,149418924,1456699
1,-1,1,148004766,149754410,1749644
1,-1,1,148247978,148345159,97181
1,-1,1,148256138,148327665,71527
1,-1,1,148256138,148345159,89021
-1,-1,1,148545476,149232481,687005
1,-1,1,148552009,148782879,230870
1,-1,1,148574680,148757827,183147
1,-1,1,148591245,148757827,166582
1,-1,1,148591245,148757827,166582
1,-1,1,148591245,148757827,166582
1,-1,1,148591245,148757827,166582
1,-1,1,148591245,148757827,166582
1,-1,1,148591245,148757827,166582
1,-1,1,148591245,148757827,166582
1,-1,1,148591245,148757827,166582
1,-1,1,148591245,148757827,166582
1,-1,1,148591245,148771600,180355
1,-1,1,148591245,148771600,180355
1,-1,1,148817029,149519295,702266
1,-1,1,148817029,149519295,702266
1,-1,1,148817029,149519295,702266
1,-1,1,148817029,149817768,1000739
1,-1,1,148817029,149817768,1000739
1,-1,1,148817029,149817768,1000739
1,-1,1,148832327,149576317,743990
-1,-1,1,148867551,149699420,831869
-1,-1,1,148867551,149699420,831869
-1,-1,1,148867551,149699420,831869
-1,-1,1,148867551,149699420,831869
-1,-1,1,148867551,149699420,831869
-1,-1,1,148867551,149699420,831869
-1,-1,1,148867551,149699420,831869
-1,-1,1,148867551,149699420,831869
-1,-1,1,148867551,149699420,831869
1,-1,1,148867581,149699396,831815
1,-1,1,148867634,149817768,950134
1,-1,1,148881775,149519295,637520
1,-1,1,148881775,149519295,637520
1,-1,1,148881775,149817768,935993
1,-1,1,148894796,149519295,624499
1,-1,1,148894796,149519295,624499
1,-1,1,148894796,149754161,859365
-1,-1,1,148936623,149433207,496584
-1,-1,1,148936623,149699396,762773
-1,-1,1,148936623,149699396,762773
1,-1,1,148936682,149817768,881086
-1,-1,1,148940709,149763756,823047
-1,-1,1,149039684,149244504,204820
-1,-1,1,149039684,149244504,204820
-1,-1,1,149039684,149244504,204820
-1,-1,1,149039684,149244504,204820
-1,-1,1,149039684,149244504,204820
-1,-1,1,149039684,149244504,204820
-1,-1,1,149039684,149244504,204820
-1,-1,1,149039684,149244504,204820
-1,-1,1,149039684,149244504,204820
-1,-1,1,149039684,149244504,204820
-1,-1,1,149039684,149244504,204820
-1,-1,1,149039684,149244504,204820
-1,-1,1,149039684,149244504,204820
-1,-1,1,149039684,149244504,204820
-1,-1,1,149039684,149244504,204820
-1,-1,1,149039684,149244504,204820
-1,-1,1,149039684,149244504,204820
-1,-1,1,149039684,149244504,204820
-1,-1,1,149039684,149244504,204820
-1,-1,1,149039684,149244504,204820
-1,-1,1,149039684,149254178,214494
-1,-1,1,149039684,149433215,393531
-1,-1,1,149039684,149433215,393531
-1,-1,1,149015233,149519295,504062
-1,-1,1,149015233,149519295,504062
-1,-1,1,149015233,149519295,504062
-1,-1,1,149015233,149519295,504062
-1,-1,1,149015233,149519295,504062
-1,-1,1,149015233,149519295,504062
-1,-1,1,149015233,149519295,504062
-1,-1,1,149041023,149244504,203481
-1,-1,1,149041023,149244504,203481
-1,-1,1,149041023,149254178,213155
-1,-1,1,149137673,149433215,295542
-1,-1,1,149041013,149232481,191468
-1,-1,1,149041013,149232481,191468
1,-1,1,149041013,149232481,191468
1,-1,1,149041013,149232481,191468
-1,-1,1,149041013,149275124,234111
-1,-1,1,149041013,149699420,658407
-1,-1,1,149041013,149699420,658407
-1,-1,1,149041013,149699420,658407
-1,-1,1,149041013,149699420,658407
-1,-1,1,149041013,149699420,658407
-1,-1,1,149041013,149699420,658407
-1,-1,1,149041013,149699420,658407
-1,-1,1,149041013,149699420,658407
-1,-1,1,149041013,149699420,658407
-1,-1,1,149041013,149699420,658407
-1,-1,1,149041013,149699420,658407
-1,-1,1,149041013,149768855,727842
-1,-1,1,149041023,149699396,658373
-1,-1,1,149041023,149768869,727846
-1,-1,1,149041042,149192074,151032
-1,-1,1,149041042,149275102,234060
-1,-1,1,149091130,149699420,608290
1,-1,1,149137529,149224014,86485
-1,-1,1,149137732,149519295,381563
-1,-1,1,149137732,149519295,381563
-1,-1,1,149137732,149519295,381563
-1,-1,1,149137732,149519295,381563
-1,-1,1,149155041,149699396,544355
-1,-1,1,149155041,149699396,544355
-1,-1,1,149754410,149763756,9346
1,1,1,149825831,180236332,30410501
1,-1,1,151333124,151399960,66836
-1,-1,1,152499180,152702192,203012
-1,-1,1,152538937,152586281,47344
-1,-1,1,152538937,152586281,47344
1,-1,1,152647750,152659287,11537
1,-1,1,152647750,152670818,23068
1,-1,1,153613593,153724866,111273
1,1,1,154012994,157048591,3035597
1,1,1,154538977,157593874,3054897
1,-1,1,155181714,155207954,26240
1,-1,1,155181714,155207954,26240
1,-1,1,155181714,155207954,26240
1,-1,1,155181714,155207954,26240
1,-1,1,155184360,155207954,23594
1,-1,1,155184360,155207954,23594
1,-1,1,155184360,155207954,23594
1,-1,1,155184360,155207954,23594
-1,-1,1,156262460,156269217,6757
1,-1,1,157230055,157351515,121460
-1,-1,1,160029416,160105986,76570
-1,-1,1,160029416,160105986,76570
1,-1,1,160029416,160105986,76570
1,-1,1,160029416,160105986,76570
-1,-1,1,160029416,160105986,76570
-1,-1,1,160029416,160105986,76570
1,-1,1,160029416,160187302,157886
-1,-1,1,161501808,161537484,35676
1,-1,1,161559766,161618874,59108
-1,1,1,161676893,184071723,22394830
-1,1,1,163352313,175846158,12493845
-1,1,1,169187474,178044969,8857495
-1,1,1,169873155,181823980,11950825
-1,1,1,170005209,187524280,17519071
-1,1,1,170898861,191034539,20135678
1,1,1,171009116,186845089,15835973
-1,1,1,171990029,195086758,23096729
-1,-1,1,174468168,174656796,188628
1,-1,1,175437001,175704743,267742
1,-1,1,175437001,175704743,267742
1,-1,1,175437001,175704743,267742
-1,1,1,176565098,196270818,19705720
-1,-1,1,176712791,176781116,68325
-1,1,1,179011314,199022759,20011445
-1,1,1,179073386,200192265,21118879
-1,1,1,179413479,201764737,22351258
-1,1,1,179564752,183850820,4286068
1,-1,1,183861204,184091272,230068
-1,1,1,184857562,186591462,1733900
-1,-1,1,187644027,187745698,101671
1,-1,1,187956640,189056310,1099670
-1,-1,1,188205949,188574502,368553
1,-1,1,188736609,188849004,112395
-1,1,1,189003614,199584994,10581380
1,-1,1,189093350,189957275,863925
1,-1,1,189129332,189924389,795057
-1,-1,1,189331211,189542589,211378
-1,-1,1,189331211,189542589,211378
-1,-1,1,189331211,189542589,211378
-1,-1,1,189331211,189542589,211378
-1,-1,1,189331211,189542589,211378
-1,-1,1,189331211,189542589,211378
-1,-1,1,189331211,189542589,211378
-1,-1,1,189331211,189542589,211378
-1,-1,1,189331211,189542589,211378
-1,-1,1,189331211,189542589,211378
-1,-1,1,189331211,189542589,211378
-1,-1,1,189331211,189542589,211378
-1,-1,1,189331211,189542589,211378
-1,-1,1,189331211,189542589,211378
-1,-1,1,189331211,189542589,211378
-1,-1,1,189331211,189542589,211378
-1,-1,1,189331211,189542589,211378
-1,-1,1,189331211,189542589,211378
-1,-1,1,189331211,189542589,211378
-1,-1,1,189331252,189512888,181636
-1,-1,1,189331252,189512888,181636
-1,-1,1,189331252,189512888,181636
-1,-1,1,189331252,189512888,181636
-1,-1,1,189331252,189512888,181636
-1,-1,1,189396085,189512829,116744
-1,-1,1,189396085,189512829,116744
-1,-1,1,189430102,189562215,132113
-1,-1,1,189430102,189562274,132172
1,-1,1,190484823,191590282,1105459
-1,-1,1,190990954,191197531,206577
-1,-1,1,191689637,191826625,136988
1,-1,1,193983247,194067135,83888
1,-1,1,194779033,195627237,848204
-1,-1,1,195262138,195348432,86294
-1,1,1,195483439,197865624,2382185
1,1,1,195483439,249213000,53729561
1,-1,1,196011881,196208885,197004
-1,-1,1,196738927,196799273,60346
1,-1,1,196738927,196799273,60346
-1,-1,1,196738927,196898635,159708
-1,-1,1,196746064,196797163,51099
-1,-1,1,196746064,196797163,51099
-1,-1,1,196746064,196797163,51099
-1,-1,1,196746064,196797163,51099
-1,-1,1,196746064,196797163,51099
-1,-1,1,196746064,196797163,51099
-1,-1,1,196746064,196797163,51099
-1,-1,1,196746064,196797163,51099
-1,-1,1,196746064,196797163,51099
-1,-1,1,196746064,196797163,51099
-1,-1,1,196746064,196797163,51099
-1,-1,1,196746064,196797163,51099
-1,-1,1,196746064,196797163,51099
-1,-1,1,196746064,196797163,51099
-1,-1,1,196746064,196797163,51099
1,-1,1,196746064,196797163,51099
-1,-1,1,196746064,196797163,51099
-1,-1,1,196746064,196797163,51099
-1,-1,1,196746064,196797163,51099
-1,-1,1,196746064,196797163,51099
-1,-1,1,196746064,196797163,51099
-1,-1,1,196746064,196797163,51099
-1,-1,1,196746064,196797163,51099
-1,-1,1,196746064,196797163,51099
-1,-1,1,196746064,196797163,51099
-1,-1,1,196746064,196883398,137334
-1,-1,1,196746064,196883398,137334
-1,-1,1,196746064,196883398,137334
-1,-1,1,196746064,196883398,137334
-1,-1,1,196746064,196883398,137334
-1,-1,1,196746064,196883398,137334
-1,-1,1,196746064,196883398,137334
-1,-1,1,196746064,196883398,137334
-1,-1,1,196788212,196883398,95186
-1,-1,1,196788212,196883398,95186
-1,-1,1,196788212,196883398,95186
-1,-1,1,196788212,196883398,95186
1,-1,1,196797104,196883398,86294
-1,-1,1,196799273,196891639,92366
-1,-1,1,196825165,196891639,66474
-1,1,1,200113731,203081206,2967475
-1,1,1,200113731,203081206,2967475
1,1,1,204734042,225596400,20862358
1,-1,1,206075579,206154280,78701
1,-1,1,206075579,206154280,78701
1,-1,1,206075579,206154280,78701
1,-1,1,206075579,206154280,78701
1,1,1,207519987,249224684,41704697
-1,1,1,207756872,210332526,2575654
-1,1,1,208236806,212081154,3844348
1,-1,1,208786440,208980535,194095
-1,1,1,209742722,210774573,1031851
1,1,1,210136970,249212668,39075698
1,1,1,214697099,249224684,34527585
-1,1,1,215380103,222177410,6797307
-1,1,1,215380103,222177410,6797307
-1,-1,1,215452796,215526068,73272
-1,1,1,217699328,218689648,990320
1,-1,1,218693490,218776969,83479
-1,1,1,220846877,223871214,3024337
-1,1,1,223521035,228744033,5222998
1,1,1,224002849,249212668,25209819
1,-1,1,224079085,224180364,101279
1,1,1,224105294,249224684,25119390
1,1,1,224210564,249212668,25002104
1,1,1,225049987,249233096,24183109
-1,1,1,225569874,230554547,4984673
1,1,1,225626182,249060210,23434028
-1,1,1,226372825,233008234,6635409
1,-1,1,229122568,229295677,173109
1,1,1,229158656,249212668,20054012
1,1,1,231670870,249213000,17542130
1,-1,1,231710352,231813921,103569
1,-1,1,231710352,231813921,103569
1,-1,1,231715133,231813921,98788
-1,1,1,232226609,241010904,8784295
-1,1,1,232646424,242656339,10009915
-1,1,1,234605553,240932205,6326652
-1,1,1,235374095,249224684,13850589
1,1,1,235551307,237433932,1882625
-1,1,1,235797384,249224684,13427300
1,1,1,236515525,249224684,12709159
-1,1,1,236719382,249212668,12493286
-1,1,1,237233879,249206548,11972669
-1,1,1,237806581,249212668,11406087
-1,1,1,238196875,249218733,11021858
-1,1,1,238356180,249224684,10868504
1,1,1,238514419,238865550,351131
-1,1,1,238514421,249212668,10698247
1,-1,1,238676252,238753428,77176
-1,1,1,238917049,249212666,10295617
-1,1,1,239451325,242621355,3170030
1,1,1,239781260,249224684,9443424
-1,1,1,240620284,247690417,7070133
-1,1,1,240628422,249212668,8584246
-1,1,1,241094652,246670839,5576187
-1,1,1,241601964,249224684,7622720
1,1,1,241788417,245617084,3828667
-1,1,1,242208581,249224684,7016103
1,1,1,242656460,249213000,6556540
1,1,1,243095878,249158835,6062957
-1,1,1,243393248,243774475,381227
-1,1,1,243427494,244831765,1404271
-1,1,1,243477620,249233096,5755476
-1,1,1,243681404,244812435,1131031
1,-1,1,243684045,243694734,10689
1,-1,1,243684045,243694734,10689
1,-1,1,243684045,243694734,10689
1,-1,1,243684045,243694734,10689
1,-1,1,243684045,243694734,10689
-1,1,1,243949931,244033798,83867
-1,1,1,244385524,246707775,2322251
-1,1,1,244517415,246324760,1807345
-1,1,1,244745425,249212668,4467243
1,-1,1,245151901,245665521,513620
1,1,1,245476117,249212668,3736551
1,1,1,245665463,249233096,3567633
1,-1,1,245747724,246655416,907692
-1,-1,1,246501633,246579174,77541
-1,-1,1,247200511,247264759,64248
1,-1,1,247695693,248060419,364726
1,-1,1,247776410,248256864,480454
1,-1,1,247776537,248684891,908354
1,-1,1,247834885,248480750,645865
1,-1,1,247846231,248256998,410767
1,-1,1,247846231,248256998,410767
1,-1,1,247846231,248256998,410767
1,-1,1,247846231,248256998,410767
1,-1,1,247846231,248256998,410767
1,-1,1,247846231,248684891,838660
1,-1,1,247846231,248785598,939367
1,-1,1,247846233,248256864,410631
1,-1,1,247846233,248256864,410631
1,-1,1,247879926,248278070,398144
1,-1,1,247879926,248278070,398144
1,-1,1,247962269,248260734,298465
1,-1,1,247962269,248260734,298465
1,-1,1,247962269,248684909,722640
1,-1,1,248033647,248034322,675
1,-1,1,248093829,248785562,691733
-1,-1,1,248158939,248205955,47016
-1,-1,1,248291569,248339940,48371
1,-1,1,248291569,248339940,48371
-1,-1,1,248291569,248339940,48371
-1,-1,1,248301479,248480750,179271
1,-1,1,248339970,248569417,229447
-1,-1,1,248339973,248563858,223885
1,-1,1,248414258,249081340,667082
1,-1,1,248563799,248861875,298076
-1,-1,1,248727929,248785533,57604
-1,-1,1,248727929,248792227,64298
-1,-1,1,248756245,248792227,35982
-1,-1,1,248756245,248792227,35982
1,-1,1,248862205,248901720,39515
1,-1,1,248862205,248901720,39515
1,-1,1,248862205,248901720,39515
1,-1,1,248862205,249113356,251151
1,-1,1,249098884,249189747,90863
1,-1,1,249104658,249139858,35200
-1,1,2,12770,2752444,2739674
1,1,2,12770,20081474,20068704
1,1,2,12770,25262563,25249793
1,1,2,12770,33936576,33923806
1,1,2,12771,242783384,242770613
1,1,2,12771,242783384,242770613
-1,1,2,17019,2309039,2292020
1,1,2,17019,20200817,20183798
1,1,2,17019,26541714,26524695
1,-1,2,24400,57011,32611
1,1,2,24400,813454,789054
1,-1,2,30341,84728,54387
1,-1,2,30341,84728,54387
-1,1,2,30341,1973174,1942833
-1,1,2,30341,2659911,2629570
-1,1,2,30341,3452903,3422562
1,1,2,30341,4689989,4659648
1,1,2,30341,4979949,4949608
1,1,2,30341,28642531,28612190
-1,1,2,39193,1546506,1507313
-1,-1,2,84669,206271,121602
-1,-1,2,84669,206271,121602
-1,-1,2,84669,206271,121602
-1,1,2,131730,2717289,2585559
-1,-1,2,134623,172636,38013
1,-1,2,153031,252990,99959
1,-1,2,153031,252990,99959
1,1,2,236816,46210371,45973555
1,-1,2,331045,844989,513944
1,-1,2,330817,938774,607957
1,-1,2,383231,721431,338200
1,-1,2,622175,1106638,484463
1,-1,2,844940,1106638,261698
1,-1,2,883836,1495173,611337
1,-1,2,1442042,1507882,65840
1,1,2,1668387,23887012,22218625
1,-1,2,1788489,2309039,520550
1,-1,2,4881726,5058788,177062
1,-1,2,7635254,88005418,80370164
1,1,2,10930789,14557258,3626469
1,-1,2,12939430,13523912,584482
1,-1,2,13207008,13337147,130139
1,-1,2,13207037,13278805,71768
-1,-1,2,13278775,13417994,139219
-1,1,2,13804435,16409693,2605258
1,-1,2,14147182,14590377,443195
1,-1,2,14182010,14278837,96827
-1,1,2,14617464,16467586,1850122
-1,1,2,16904863,21823606,4918743
-1,1,2,22802524,28748053,5945529
1,1,2,22922551,33992077,11069526
1,1,2,28069882,43543420,15473538
-1,-1,2,29801273,30164069,362796
-1,-1,2,29801273,30164069,362796
-1,-1,2,29801273,30164069,362796
-1,-1,2,29801273,30164069,362796
-1,-1,2,29801273,30164069,362796
-1,-1,2,29801273,30164069,362796
-1,-1,2,29801273,30164069,362796
-1,-1,2,29801273,30164069,362796
-1,-1,2,29801273,30164069,362796
-1,-1,2,29801273,30164069,362796
-1,-1,2,29801273,30164069,362796
1,-1,2,32514528,33249136,734608
1,-1,2,32610082,33285390,675308
1,-1,2,32663325,33275463,612138
1,-1,2,32663325,33294774,631449
1,-1,2,32663325,33294774,631449
1,-1,2,32663325,33294774,631449
1,-1,2,32677683,33257379,579696
1,-1,2,32677714,33257514,579800
1,-1,2,32677714,33257514,579800
1,-1,2,32677714,33257514,579800
1,-1,2,32677714,33257514,579800
1,-1,2,32677714,33257514,579800
1,-1,2,32677714,33257514,579800
1,-1,2,32677714,33294723,617009
1,-1,2,32677714,33294723,617009
1,-1,2,32787199,32968519,181320
1,-1,2,32787199,33121586,334387
-1,-1,2,34702930,34915000,212070
-1,-1,2,35524142,35620511,96369
1,-1,2,35576002,35769464,193462
-1,-1,2,35576002,35821806,245804
-1,-1,2,35822006,36077697,255691
-1,-1,2,35822006,36077697,255691
-1,-1,2,35822006,36077697,255691
-1,-1,2,35822006,36077697,255691
-1,-1,2,35822006,36077697,255691
-1,-1,2,35822006,36077697,255691
-1,-1,2,35822006,36077697,255691
-1,-1,2,35822006,36077697,255691
-1,-1,2,35821806,35956621,134815
-1,-1,2,35821806,36061904,240098
-1,1,2,37227700,42181826,4954126
-1,-1,2,37967394,38115263,147869
-1,-1,2,39324297,39328794,4497
1,-1,2,39412970,39605266,192296
1,-1,2,44065338,44079721,14383
-1,-1,2,44231393,44276924,45531
-1,-1,2,44510781,44525874,15093
-1,1,2,44531130,44552898,21768
-1,1,2,44534506,44543435,8929
-1,1,2,44914980,45172628,257648
-1,-1,2,45095754,45171902,76148
1,-1,2,45168836,45169314,478
1,-1,2,45168836,45169885,1049
1,-1,2,45171843,45172394,551
1,-1,2,45171857,45172394,537
1,-1,2,45172206,45172394,188
1,-1,2,46800828,46959977,159149
-1,1,2,47033357,50792676,3759319
-1,1,2,47280431,47714665,434234
-1,1,2,47361260,54934153,7572893
-1,1,2,47414693,47636335,221642
-1,1,2,47598133,47684221,86088
1,1,2,47847527,86929845,39082318
-1,1,2,47890992,48012867,121875
-1,1,2,48861903,48988580,126677
-1,1,2,49156753,51066637,1909884
-1,1,2,50138070,52689474,2551404
-1,1,2,50280210,51109690,829480
1,-1,2,50281917,50282100,183
-1,1,2,50512908,50957337,444429
-1,1,2,50680795,50892906,212111
-1,1,2,50680795,50892906,212111
-1,1,2,50680795,50937503,256708
-1,1,2,50707763,50793781,86018
-1,1,2,50725729,50937503,211774
-1,1,2,50802121,50937503,135382
-1,1,2,50804279,51027599,223320
-1,1,2,50811167,50870064,58897
-1,1,2,50813343,50948464,135121
-1,1,2,50814676,50957455,142779
-1,1,2,50818355,51158300,339945
-1,1,2,50826550,50925896,99346
-1,1,2,50838594,51119793,281199
1,-1,2,50847100,50847341,241
-1,1,2,50847100,50982172,135072
-1,1,2,50847100,51556715,709615
-1,1,2,50850691,50982113,131422
-1,1,2,50851432,51492867,641435
-1,1,2,50886432,243102476,192216044
-1,1,2,50905757,51249333,343576
-1,1,2,50909765,51335129,425364
-1,1,2,50959192,51402934,443742
-1,1,2,50962008,51260667,298659
-1,1,2,50964034,51227294,263260
-1,1,2,50964034,51915187,951153
1,-1,2,50970662,51008023,37361
-1,1,2,50978466,51528474,550008
-1,1,2,50978466,51528474,550008
-1,1,2,50982113,51226229,244116
-1,1,2,51032041,51189570,157529
-1,1,2,51037104,51446873,409769
-1,-1,2,51049645,51066578,16933
-1,-1,2,51049645,51122091,72446
-1,1,2,51054373,51180620,126247
-1,1,2,51066578,51260667,194089
-1,1,2,51078335,51562416,484081
-1,1,2,51083410,51226229,142819
-1,1,2,51083410,51226229,142819
-1,1,2,51083410,51314371,230961
-1,1,2,51088055,51257067,169012
-1,1,2,51088055,51257067,169012
-1,1,2,51107486,51375539,268053
-1,1,2,51113043,51257100,144057
-1,1,2,51142849,51226229,83380
-1,1,2,51142849,51510961,368112
-1,1,2,51146817,51854353,707536
-1,1,2,51172123,51251498,79375
-1,1,2,51180561,51358881,178320
-1,1,2,51191164,51354468,163304
-1,1,2,51193626,51382813,189187
-1,1,2,51205897,51279290,73393
-1,1,2,51225621,51304763,79142
-1,1,2,51225621,51337449,111828
-1,1,2,51226170,51314430,88260
-1,1,2,51226170,51314430,88260
-1,1,2,51226170,51382872,156702
-1,1,2,51226170,51556715,330545
-1,1,2,51226170,51556715,330545
-1,1,2,51229995,51363342,133347
-1,1,2,51234059,51263065,29006
-1,1,2,51237000,51382813,145813
-1,1,2,51238789,51309967,71178
1,-1,2,51259160,51259694,534
-1,-1,2,51314371,51467462,153091
-1,-1,2,52706226,52781440,75214
-1,-1,2,52750773,52781440,30667
1,-1,2,52750774,52781440,30666
-1,-1,2,52750774,52781440,30666
-1,-1,2,52844384,52885500,41116
-1,-1,2,52952780,53056631,103851
-1,1,2,58259051,63838944,5579893
1,1,2,58506654,83814086,25307432
-1,1,2,58837279,63720819,4883540
-1,-1,2,61113419,61149619,36200
-1,-1,2,61113419,61149619,36200
-1,-1,2,61113419,61149619,36200
-1,-1,2,61113419,61149619,36200
-1,1,2,61198769,61319645,120876
1,1,2,62245236,86978895,24733659
-1,1,2,63234780,67908846,4674066
-1,1,2,63669709,66333670,2663961
-1,-1,2,68846932,68881993,35061
1,-1,2,70704251,70760447,56196
-1,1,2,74365484,89129064,14763580
1,-1,2,75160356,75196822,36466
1,1,2,77252342,91619262,14366920
-1,-1,2,81721756,81899151,177395
1,-1,2,82220038,82293622,73584
1,-1,2,82220038,82293622,73584
-1,-1,2,82600210,82923012,322802
-1,-1,2,83291704,83775616,483912
1,-1,2,83675238,84251319,576081
1,-1,2,83804793,84054882,250089
-1,1,2,85241809,89126132,3884323
1,-1,2,87190529,88106063,915534
1,-1,2,87258795,88037771,778976
1,-1,2,87258795,88037771,778976
1,-1,2,87258795,88037771,778976
1,-1,2,87258795,88037771,778976
1,-1,2,87258795,88037771,778976
1,-1,2,87258795,88037771,778976
1,-1,2,87295705,88037771,742066
1,-1,2,87295705,88037771,742066
1,-1,2,87304078,88037771,733693
1,-1,2,87304078,88037771,733693
1,-1,2,87304078,88037771,733693
1,-1,2,87304078,88037771,733693
1,-1,2,87304078,88037771,733693
1,-1,2,87304078,88037771,733693
1,-1,2,87304078,88037771,733693
1,-1,2,87304078,88037771,733693
1,-1,2,87304078,88037771,733693
1,-1,2,87304078,88037771,733693
1,-1,2,87304078,88037771,733693
1,-1,2,87304078,88037771,733693
1,-1,2,87304078,88037771,733693
1,-1,2,87304078,88037771,733693
1,-1,2,87304078,88037771,733693
1,-1,2,87304078,88037771,733693
1,-1,2,87304078,88037771,733693
1,-1,2,87304078,88037771,733693
1,-1,2,87304078,88037771,733693
1,-1,2,87304078,88037771,733693
1,-1,2,87304078,88037771,733693
1,-1,2,87304078,88037771,733693
1,-1,2,87304078,88037771,733693
1,-1,2,87304078,88037771,733693
1,-1,2,87304078,88037771,733693
1,-1,2,87304078,88037771,733693
1,-1,2,87304078,88037771,733693
1,-1,2,87304078,88037771,733693
1,-1,2,87304078,88037771,733693
1,-1,2,87304078,88037771,733693
1,-1,2,87304078,88037771,733693
1,-1,2,87304078,88037771,733693
1,-1,2,87304078,88037771,733693
1,-1,2,87304078,88037771,733693
1,-1,2,87325301,88005418,680117
1,-1,2,87325327,88005429,680102
-1,-1,2,87325327,88005429,680102
1,-1,2,87325390,88037771,712381
1,-1,2,87325390,88037771,712381
1,-1,2,87325390,88037771,712381
1,-1,2,87325390,88037771,712381
1,-1,2,87325390,88037771,712381
1,-1,2,87325390,88037771,712381
1,-1,2,87325390,88037771,712381
1,-1,2,87325390,88037771,712381
1,-1,2,87325390,88037771,712381
1,-1,2,87325390,88037771,712381
1,-1,2,87325390,88037771,712381
1,-1,2,87325390,88037771,712381
1,-1,2,87325390,88037771,712381
1,-1,2,87325390,88037771,712381
1,-1,2,87325390,88037771,712381
1,-1,2,87325390,88037771,712381
1,-1,2,87325390,88037771,712381
1,-1,2,87325390,88037771,712381
1,-1,2,87325390,88037771,712381
1,-1,2,87325390,88037771,712381
1,-1,2,87325390,88037771,712381
1,-1,2,87325390,88037771,712381
1,-1,2,87325390,88037771,712381
1,-1,2,87325390,88037771,712381
1,-1,2,87325390,88037771,712381
1,-1,2,87325390,88037771,712381
1,-1,2,87325390,88037771,712381
1,-1,2,87325390,88037771,712381
1,-1,2,87325390,88037771,712381
1,-1,2,87325390,88037771,712381
1,-1,2,87325390,88037771,712381
1,-1,2,87325390,88037771,712381
1,-1,2,87325390,88037771,712381
1,-1,2,87325390,88037771,712381
1,-1,2,87325390,88037771,712381
1,-1,2,87325390,88037771,712381
1,-1,2,87325390,88037771,712381
1,-1,2,87325390,88037771,712381
1,-1,2,87325390,88037771,712381
1,-1,2,87325390,88037771,712381
1,-1,2,87325390,88037771,712381
1,-1,2,87325390,88037771,712381
1,-1,2,87325390,88037771,712381
1,-1,2,87325390,88037771,712381
1,-1,2,87325390,88037771,712381
1,-1,2,87325390,88037771,712381
1,-1,2,87325390,88037771,712381
1,-1,2,87325390,88057969,732579
1,-1,2,87325390,88057969,732579
1,-1,2,87325390,88057969,732579
1,-1,2,87325390,88057969,732579
1,-1,2,87325390,88057969,732579
1,-1,2,87325390,88057969,732579
1,-1,2,87376073,88005429,629356
-1,-1,2,87376077,87954920,578843
1,-1,2,87376077,87954920,578843
1,-1,2,87376077,88005418,629341
1,-1,2,87376077,88005418,629341
-1,-1,2,87376077,88005418,629341
-1,-1,2,87376077,88005418,629341
-1,-1,2,87376077,88005418,629341
-1,-1,2,87376077,88005418,629341
-1,-1,2,87376077,88005418,629341
-1,-1,2,87376077,88005418,629341
-1,-1,2,87376077,88005418,629341
1,-1,2,87376077,88260796,884719
1,-1,2,87376077,88260796,884719
1,-1,2,87376132,88037771,661639
-1,-1,2,89137662,89523818,386156
-1,-1,2,89137592,89329992,192400
-1,-1,2,89241017,89259510,18493
-1,-1,2,89244273,89259510,15237
-1,-1,2,89259571,90251481,991910
-1,-1,2,89259571,90293011,1033440
1,-1,2,89259571,91899595,2640024
1,-1,2,89259571,91899595,2640024
1,-1,2,89259571,91899595,2640024
1,-1,2,89259571,92129460,2869889
1,-1,2,89259571,95344251,6084680
1,-1,2,89275287,91815679,2540392
1,-1,2,89288236,91815679,2527443
-1,-1,2,89297771,90251481,953710
-1,-1,2,89297771,90293011,995240
1,-1,2,89297771,90293011,995240
-1,-1,2,89297771,90293011,995240
-1,-1,2,89297771,90293011,995240
1,-1,2,89297771,90293011,995240
1,-1,2,89297771,91759386,2461615
1,-1,2,89297771,91759386,2461615
1,-1,2,89297771,91759386,2461615
1,-1,2,89297771,91759386,2461615
1,-1,2,89297771,91759386,2461615
1,-1,2,89297771,91759386,2461615
1,-1,2,89297771,91759386,2461615
1,-1,2,89297771,91899595,2601824
1,-1,2,89323386,90263882,940496
1,-1,2,89323386,91815679,2492293
1,-1,2,89330069,91759386,2429317
1,-1,2,89330069,91759386,2429317
1,-1,2,89330069,91759386,2429317
-1,-1,2,89332506,90263882,931376
-1,-1,2,89332506,90263882,931376
-1,-1,2,89439468,90251481,812013
-1,-1,2,89482269,90251823,769554
1,-1,2,89500023,89527568,27545
1,-1,2,89523818,90233909,710091
1,-1,2,89523818,90293011,769193
1,-1,2,89523818,90293011,769193
1,-1,2,89523818,90293011,769193
1,-1,2,89523818,90293011,769193
1,-1,2,89523818,90293011,769193
1,-1,2,89523818,90293011,769193
1,-1,2,89523818,91759386,2235568
1,-1,2,89523818,91759386,2235568
1,-1,2,89523818,91759386,2235568
1,-1,2,89523818,91759386,2235568
-1,-1,2,89538784,90234028,695244
-1,-1,2,89538845,90258291,719446
1,-1,2,89538934,90293011,754077
1,-1,2,89538934,90293011,754077
1,-1,2,89538934,90293011,754077
1,-1,2,89538934,91619163,2080229
1,-1,2,89538934,91764207,2225273
1,-1,2,89538934,91899595,2360661
1,-1,2,89596684,90293011,696327
-1,-1,2,89601879,90293011,691132
-1,-1,2,89967669,90293011,325342
-1,-1,2,89975495,90258291,282796
1,-1,2,90233968,91693328,1459360
1,-1,2,90233968,91693328,1459360
1,-1,2,90233968,91693328,1459360
1,-1,2,90233968,91693328,1459360
1,-1,2,90233968,91693328,1459360
1,-1,2,90233968,91693328,1459360
1,-1,2,90233968,91759386,1525418
1,-1,2,90233968,91759386,1525418
1,-1,2,90233968,91759386,1525418
1,-1,2,90233968,91759386,1525418
1,-1,2,90233968,91759386,1525418
1,-1,2,90233968,91759386,1525418
1,-1,2,90233968,91759386,1525418
1,-1,2,90233968,91759386,1525418
1,-1,2,90233968,91759386,1525418
1,-1,2,90233968,91759386,1525418
1,-1,2,90233968,91759386,1525418
1,-1,2,90233968,91759386,1525418
1,-1,2,90233968,91759386,1525418
1,-1,2,90233968,91759386,1525418
1,-1,2,90233968,91759386,1525418
1,-1,2,90233968,91759386,1525418
1,-1,2,90233968,91759386,1525418
1,-1,2,90233968,91759386,1525418
1,-1,2,90251540,91759386,1507846
1,-1,2,90251540,91759386,1507846
1,-1,2,90251540,91759386,1507846
1,-1,2,90251540,91919048,1667508
-1,-1,2,91670321,91812508,142187
1,-1,2,91963942,92129716,165774
1,1,2,95327499,111370025,16042526
1,1,2,95344257,111359986,16015729
1,1,2,95529039,108518266,12989227
1,1,2,95691600,100587394,4895794
1,-1,2,96012844,96076672,63828
1,-1,2,96340729,96718023,377294
1,-1,2,96475033,96671972,196939
-1,1,2,96545350,97695409,1150059
1,-1,2,96583702,96671972,88270
1,-1,2,96635171,96671972,36801
1,-1,2,96671972,96705053,33081
-1,1,2,96739308,97728447,989139
-1,1,2,96739308,98108185,1368877
1,-1,2,97695402,98260508,565106
1,-1,2,97695402,98260508,565106
1,-1,2,97695402,98260508,565106
1,-1,2,97695402,98263440,568038
1,-1,2,97714365,98263440,549075
1,-1,2,97750013,97757978,7965
1,-1,2,98262523,98274890,12367
1,-1,2,98263858,98274890,11032
1,-1,2,99858723,99914955,56232
1,-1,2,99858723,99914955,56232
1,-1,2,99858723,99914955,56232
-1,-1,2,99858723,99914955,56232
1,-1,2,99858723,99914955,56232
-1,1,2,101850532,106295614,4445082
1,1,2,102327287,111548995,9221708
1,-1,2,105855491,106768556,913065
1,-1,2,106929257,107152986,223729
1,-1,2,108439150,108441524,2374
1,-1,2,108439150,108476528,37378
1,-1,2,108518300,109089233,570933
-1,-1,2,110381297,110964737,583440
1,-1,2,110683944,111202718,518774
1,-1,2,110683944,111202718,518774
1,-1,2,110683944,111202718,518774
1,-1,2,110683944,111204317,520373
1,-1,2,110683944,111204317,520373
1,-1,2,110683944,111204317,520373
1,-1,2,110695259,111191379,496120
1,-1,2,110695259,111202718,507459
1,-1,2,110717480,111118115,400635
-1,-1,2,110732632,110964737,232105
1,-1,2,110732649,110964775,232126
1,-1,2,110732649,110964775,232126
1,-1,2,110732649,110964775,232126
1,-1,2,110732707,111204317,471610
1,-1,2,110783036,110964878,181842
1,-1,2,110783236,110964737,181501
-1,-1,2,110783236,110964737,181501
1,-1,2,110783251,111079065,295814
1,-1,2,110783251,111079065,295814
-1,-1,2,110783258,111334482,551224
-1,1,2,110824257,110983418,159161
1,-1,2,110833640,110966643,133003
-1,-1,2,110833640,110966643,133003
1,-1,2,110833640,110966643,133003
1,-1,2,110833640,111015446,181806
1,-1,2,110862474,110964775,102301
1,-1,2,110862474,110964775,102301
-1,-1,2,110862474,110964775,102301
1,-1,2,110862474,110964775,102301
-1,-1,2,110862474,110964775,102301
1,-1,2,110862474,110964775,102301
-1,-1,2,110862474,110964775,102301
1,-1,2,110862474,110964775,102301
1,-1,2,110862474,110964775,102301
1,1,2,110862474,110964775,102301
1,-1,2,110862474,110964775,102301
1,-1,2,110862474,110964775,102301
1,-1,2,110862474,110964775,102301
-1,-1,2,110862474,111079065,216591
-1,-1,2,110862474,111128847,266373
-1,-1,2,110862477,110959127,96650
1,-1,2,110862477,110959127,96650
-1,1,2,110862477,110964737,102260
-1,1,2,110862477,110964737,102260
-1,1,2,110862477,110964737,102260
1,-1,2,110862477,110964737,102260
1,-1,2,110862477,110964737,102260
-1,-1,2,110862477,110964737,102260
1,-1,2,110862477,110964737,102260
1,-1,2,110862477,110964737,102260
-1,-1,2,110862477,110964737,102260
1,-1,2,110862477,110964737,102260
1,-1,2,110862477,110964737,102260
1,-1,2,110862477,110964737,102260
1,-1,2,110862477,110964737,102260
1,-1,2,110862477,110964737,102260
1,-1,2,110862477,110964737,102260
1,-1,2,110862477,110964737,102260
1,-1,2,110862477,110964737,102260
-1,-1,2,110862477,110966643,104166
-1,-1,2,110862477,110966643,104166
-1,-1,2,110862477,110966643,104166
-1,-1,2,110862477,110966643,104166
-1,-1,2,110862477,110966643,104166
-1,-1,2,110862477,110966643,104166
-1,-1,2,110862477,110966643,104166
-1,-1,2,110862477,111079057,216580
1,-1,2,110862477,111128847,266370
1,-1,2,110862477,111128847,266370
1,-1,2,110862477,111128847,266370
1,-1,2,110862477,111128847,266370
1,-1,2,110862477,111128847,266370
1,-1,2,110862477,111128847,266370
-1,-1,2,110862477,111368891,506414
-1,-1,2,110873467,110966643,93176
-1,-1,2,110873467,110966643,93176
-1,-1,2,110873467,110966643,93176
-1,-1,2,110873992,110966643,92651
-1,-1,2,110873992,110966643,92651
-1,-1,2,110873992,110966643,92651
1,-1,2,110880671,110964775,84104
1,-1,2,110881237,110964737,83500
-1,-1,2,110901393,110980401,79008
-1,-1,2,110901479,110980487,79008
1,1,2,111335143,116733317,5398174
-1,1,2,111397715,113111856,1714141
-1,1,2,111406072,113111856,1705784
1,-1,2,112046584,112592176,545592
1,-1,2,112046584,112592176,545592
1,-1,2,112046584,112592176,545592
1,-1,2,112046584,112592176,545592
1,-1,2,112046584,112592176,545592
1,-1,2,112046584,112592176,545592
1,-1,2,112046584,112592176,545592
1,-1,2,112046584,112592176,545592
1,-1,2,112046584,112592176,545592
1,-1,2,112046584,112592176,545592
1,-1,2,112046584,112592176,545592
1,-1,2,112046584,112592176,545592
1,-1,2,112046584,112592176,545592
1,-1,2,112046584,112592176,545592
1,-1,2,112046584,112592176,545592
1,-1,2,112046584,112592176,545592
-1,-1,2,113735617,113891118,155501
-1,1,2,114056441,123673800,9617359
-1,1,2,115758140,126444478,10686338
-1,1,2,116059643,129828703,13769060
-1,1,2,116754600,123897370,7142770
-1,-1,2,117519462,117736809,217347
1,-1,2,117803207,117913104,109897
-1,1,2,119445405,122379390,2933985
-1,1,2,120571363,141627287,21055924
-1,1,2,123927565,129217649,5290084
-1,1,2,124203338,141350107,17146769
-1,1,2,128490257,138210164,9719907
1,-1,2,130582258,131151349,569091
1,-1,2,130634874,130877782,242908
1,-1,2,130694002,131198154,504152
1,-1,2,130786789,131172028,385239
1,-1,2,130786789,131223148,436359
1,-1,2,130834577,131223148,388571
1,-1,2,130877782,131132074,254292
-1,-1,2,130928976,131147956,218980
-1,-1,2,130928976,131147956,218980
1,-1,2,131442815,131524418,81603
1,-1,2,131858430,131907307,48877
1,-1,2,132068071,132266527,198456
1,-1,2,132238316,132290940,52624
1,-1,2,132287932,132508293,220361
1,-1,2,132287932,132558490,270558
1,-1,2,132290940,132508293,217353
1,-1,2,132290940,132508293,217353
1,-1,2,132290940,132508293,217353
1,-1,2,132290940,132508293,217353
1,-1,2,132290940,132508293,217353
1,-1,2,132290940,132508293,217353
1,-1,2,132290940,132508293,217353
1,-1,2,132290940,132508293,217353
1,-1,2,132290940,132508293,217353
1,-1,2,132290940,132508293,217353
1,-1,2,132290940,132508293,217353
1,-1,2,132290940,132508293,217353
1,-1,2,132290940,132508293,217353
1,-1,2,132290940,132508293,217353
1,-1,2,132290940,132508293,217353
1,-1,2,132290940,132508293,217353
1,-1,2,132290940,132508293,217353
1,-1,2,132290940,132508293,217353
1,-1,2,132290940,132515623,224683
1,-1,2,132719325,132805998,86673
1,-1,2,132862067,133327977,465910
-1,1,2,134733319,142089790,7356471
1,1,2,136803050,143602728,6799678
-1,1,2,137694928,147439378,9744450
-1,-1,2,140358784,140544934,186150
-1,1,2,144051648,148471399,4419751
1,1,2,144657717,159178136,14520419
-1,1,2,144796786,145564689,767903
-1,1,2,144970681,145425713,455032
-1,1,2,145192266,146949061,1756795
-1,1,2,145192266,146949061,1756795
-1,-1,2,145275158,145275207,49
-1,1,2,146228621,150439084,4210463
-1,1,2,146803587,149568729,2765142
-1,1,2,146913477,151531586,4618109
-1,1,2,147063452,154796058,7732606
1,1,2,147081759,157075637,9993878
-1,1,2,148490468,148913835,423367
-1,1,2,148728326,148851964,123638
-1,1,2,148728409,149130479,402070
-1,1,2,148743880,148955720,211840
-1,1,2,148787060,149106568,319508
-1,1,2,148842506,152370040,3527534
-1,1,2,148893782,149041073,147291
-1,1,2,148894900,148979973,85073
-1,1,2,148897424,148979973,82549
-1,1,2,148957572,149100105,142533
-1,1,2,149198443,149948302,749859
1,1,2,149201266,149239392,38126
-1,-1,2,150714201,150785122,70921
-1,1,2,152478196,159367077,6888881
-1,1,2,152788858,160276245,7487387
-1,1,2,154466227,159041637,4575410
-1,1,2,154808441,159661860,4853419
1,1,2,155150555,176854100,21703545
-1,1,2,155946236,165690342,9744106
1,-1,2,155981259,156724644,743385
-1,1,2,157970774,169270675,11299901
-1,1,2,161773795,165310258,3536463
1,1,2,163168812,167567296,4398484
-1,1,2,164366067,169069454,4703387
-1,1,2,164544321,170254661,5710340
-1,1,2,165663529,166239664,576135
1,1,2,165777072,168392949,2615877
-1,1,2,166032047,168283204,2251157
-1,1,2,166079508,167521122,1441614
-1,1,2,166094935,166971492,876557
-1,1,2,166374955,169671203,3296248
-1,1,2,166602662,167462305,859643
-1,1,2,166744822,167042321,297499
-1,1,2,166842607,167300045,457438
-1,1,2,167300067,175350537,8050470
1,1,2,169829974,215521436,45691462
-1,1,2,172285743,190044294,17758551
-1,1,2,172369557,178718807,6349250
-1,1,2,174002600,181269396,7266796
-1,1,2,174578566,176332190,1753624
-1,1,2,175101179,182053573,6952394
-1,1,2,175499230,189865690,14366460
-1,1,2,176940017,177020985,80968
-1,1,2,176951491,194066696,17115205
1,-1,2,176989222,176989646,424
-1,1,2,177052046,182008082,4956036
-1,1,2,178692457,195990053,17297596
1,1,2,181378520,225167565,43789045
-1,1,2,181807629,188237115,6429486
-1,1,2,182623428,192880118,10256690
1,-1,2,183059730,183500040,440310
1,-1,2,184973933,185090910,116977
1,-1,2,184973933,185090910,116977
-1,1,2,186892199,201924095,15031896
-1,-1,2,187080149,187173729,93580
-1,-1,2,187976139,188113321,137182
-1,-1,2,189200405,189368467,168062
-1,-1,2,189248503,189354495,105992
-1,-1,2,189354436,189462552,108116
-1,1,2,189812229,190554339,742110
1,1,2,190300875,242783384,52482509
-1,1,2,190693680,190718652,24972
-1,1,2,193803552,216569775,22766223
-1,-1,2,194384503,194718630,334127
-1,1,2,194581315,201752422,7171107
-1,-1,2,195062547,195217271,154724
-1,1,2,196525318,204834211,8308893
-1,1,2,197990184,200606471,2616287
-1,1,2,199360964,200290254,929290
-1,1,2,199632071,203218563,3586492
-1,1,2,200165950,200205229,39279
-1,1,2,200801996,210896648,10094652
-1,1,2,200811217,210849919,10038702
-1,1,2,201211431,202021140,809709
-1,1,2,203309853,203496210,186357
-1,1,2,203412125,203441031,28906
-1,1,2,203496151,205794583,2298432
-1,1,2,205771566,210896173,5124607
-1,1,2,207923610,212110328,4186718
1,1,2,211444400,243059659,31615259
-1,-1,2,212360252,212412705,52453
1,1,2,213518431,242783384,29264953
1,1,2,217131569,217647069,515500
1,1,2,218966482,243059659,24093177
1,1,2,219966808,237815985,17849177
1,1,2,222077224,239394441,17317217
-1,1,2,222528222,225290900,2762678
1,1,2,228878865,235885068,7006203
1,1,2,229588295,242344282,12755987
1,1,2,230302785,234229532,3926747
-1,-1,2,230549473,230582451,32978
1,-1,2,231250430,231378240,127810
-1,1,2,232634989,243059659,10424670
-1,1,2,232634989,243059659,10424670
-1,1,2,232756751,233517015,760264
-1,1,2,232756751,233517015,760264
1,-1,2,233240916,233407378,166462
1,-1,2,233396286,233409433,13147
-1,1,2,233784243,243040217,9255974
-1,1,2,233891213,243059659,9168446
-1,1,2,234495262,242783384,8288122
-1,1,2,234495262,242783384,8288122
-1,-1,2,234651441,234652419,978
-1,1,2,234967401,240365384,5397983
-1,1,2,235068297,242783384,7715087
-1,1,2,235539337,242783384,7244047
-1,1,2,235744424,243007359,7262935
-1,1,2,235937073,243008259,7071186
1,-1,2,236115385,236420380,304995
-1,1,2,236285213,242783384,6498171
-1,1,2,236512248,242710466,6198218
-1,1,2,236577291,242783384,6206093
-1,1,2,236665742,240365384,3699642
-1,1,2,236755560,242783384,6027824
-1,1,2,236911223,242783384,5872161
-1,1,2,237322365,243059659,5737294
-1,1,2,237545100,242783384,5238284
-1,1,2,237684405,243059659,5375254
-1,1,2,237816758,242783384,4966626
-1,1,2,237875406,243007359,5131953
-1,1,2,237938270,242783384,4845114
-1,1,2,237943119,243007359,5064240
-1,1,2,238072533,242783384,4710851
-1,1,2,238140847,243007359,4866512
1,-1,2,238475200,238475304,104
1,-1,2,238475200,238475304,104
-1,1,2,238811512,243059659,4248147
1,1,2,239665010,242710466,3045456
1,1,2,239665010,242710466,3045456
-1,1,2,239742160,243059659,3317499
-1,1,2,239748306,242783384,3035078
-1,1,2,239966964,240600276,633312
-1,1,2,240161377,242783384,2622007
-1,1,2,240429036,242783384,2354348
1,-1,2,240981290,240987642,6352
-1,1,2,241006623,243059659,2053036
-1,1,2,241110554,243007359,1896805
1,-1,2,241556949,241578483,21534
1,-1,2,241556949,241578483,21534
1,-1,2,241617726,241626027,8301
1,-1,2,241617726,241626027,8301
1,-1,2,241617726,241716779,99053
1,-1,2,241627284,241709290,82006
1,-1,2,241627284,241709290,82006
1,-1,2,241627284,241709290,82006
1,-1,2,241627284,241709290,82006
1,-1,2,241916309,241919234,2925
1,-1,2,241916309,241919234,2925
-1,-1,2,242710413,242938241,227828
1,-1,2,242736860,242768426,31566
-1,-1,2,242742931,242768426,25495
-1,-1,2,242798552,242969874,171322
-1,-1,2,242843643,243028424,184781
-1,-1,2,242846810,243007457,160647
-1,-1,2,242852514,243102476,249962
-1,-1,2,242852514,243102476,249962
-1,-1,2,242852514,243102476,249962
-1,-1,2,242852566,243007359,154793
-1,-1,2,242852595,243052335,199740
-1,-1,2,242856588,242948040,91452
-1,-1,2,242856588,243007359,150771
-1,-1,2,242856588,243007359,150771
-1,-1,2,242856588,243007359,150771
-1,-1,2,242856588,243007359,150771
-1,-1,2,242856588,243007359,150771
-1,-1,2,242856588,243007359,150771
-1,-1,2,242856588,243007359,150771
-1,-1,2,242856588,243007359,150771
-1,-1,2,242856588,243007359,150771
-1,-1,2,242856588,243007359,150771
-1,-1,2,242856588,243007359,150771
-1,-1,2,242856588,243007359,150771
-1,-1,2,242856588,243007359,150771
-1,-1,2,242856588,243007359,150771
-1,-1,2,242856588,243007359,150771
-1,-1,2,242856588,243007359,150771
-1,-1,2,242856588,243007359,150771
1,-1,2,242856588,243007359,150771
-1,-1,2,242856588,243007359,150771
-1,-1,2,242856588,243008259,151671
-1,-1,2,242856588,243059659,203071
-1,-1,2,242856599,242947990,91391
-1,-1,2,242856599,242947990,91391
1,-1,2,242856599,242958350,101751
-1,-1,2,242856599,242958350,101751
1,-1,2,242856599,242984824,128225
-1,-1,2,242856599,243007457,150858
-1,-1,2,242856599,243007457,150858
-1,-1,2,242856599,243007457,150858
-1,-1,2,242856599,243007457,150858
-1,-1,2,242856599,243007457,150858
-1,-1,2,242856599,243007457,150858
-1,-1,2,242856599,243007457,150858
-1,-1,2,242856599,243007457,150858
-1,-1,2,242856599,243007457,150858
-1,-1,2,242856599,243007457,150858
-1,-1,2,242856599,243007457,150858
-1,-1,2,242856599,243007457,150858
-1,-1,2,242856599,243007457,150858
-1,-1,2,242856599,243007457,150858
-1,-1,2,242856599,243007457,150858
-1,-1,2,242856599,243007457,150858
-1,-1,2,242856599,243007457,150858
-1,-1,2,242856599,243007457,150858
-1,-1,2,242856599,243007457,150858
-1,-1,2,242856599,243007457,150858
-1,-1,2,242856599,243007457,150858
-1,-1,2,242856599,243007457,150858
-1,-1,2,242856599,243007457,150858
-1,-1,2,242856599,243007457,150858
-1,-1,2,242856599,243007457,150858
-1,-1,2,242856599,243007457,150858
-1,-1,2,242856599,243007457,150858
-1,-1,2,242856599,243007457,150858
-1,-1,2,242856599,243007457,150858
-1,-1,2,242856599,243007457,150858
-1,-1,2,242856599,243007457,150858
-1,-1,2,242856599,243007457,150858
-1,-1,2,242856599,243007457,150858
-1,-1,2,242856599,243059659,203060
-1,-1,2,242856599,243059659,203060
-1,-1,2,242856599,243059659,203060
-1,-1,2,242856599,243059659,203060
-1,-1,2,242856599,243059659,203060
-1,-1,2,242856599,243059659,203060
-1,-1,2,242856599,243059659,203060
-1,-1,2,242856599,243059659,203060
-1,-1,2,242856599,243059659,203060
-1,-1,2,242856599,243059659,203060
-1,-1,2,242856599,243059659,203060
-1,-1,2,242856599,243059659,203060
-1,-1,2,242856599,243059659,203060
-1,-1,2,242856599,243059659,203060
-1,-1,2,242856599,243059659,203060
-1,-1,2,242856599,243059659,203060
-1,-1,2,242856599,243059659,203060
-1,-1,2,242856599,243059659,203060
-1,-1,2,242856599,243059659,203060
-1,-1,2,242856599,243059659,203060
-1,-1,2,242856599,243059659,203060
-1,-1,2,242856599,243059659,203060
-1,-1,2,242856599,243059659,203060
-1,-1,2,242856599,243059659,203060
-1,-1,2,242856599,243059659,203060
-1,-1,2,242856599,243059659,203060
-1,-1,2,242856599,243059659,203060
-1,-1,2,242856599,243059659,203060
-1,-1,2,242856599,243059659,203060
-1,-1,2,242856599,243059659,203060
-1,-1,2,242856599,243059659,203060
-1,-1,2,242856599,243059659,203060
-1,-1,2,242856599,243059659,203060
-1,-1,2,242856599,243059659,203060
-1,-1,2,242856599,243059659,203060
-1,-1,2,242856599,243059659,203060
-1,-1,2,242856599,243059659,203060
-1,-1,2,242856599,243059659,203060
-1,-1,2,242856599,243059659,203060
-1,-1,2,242856599,243059659,203060
-1,-1,2,242856599,243059659,203060
-1,-1,2,242856599,243059659,203060
-1,-1,2,242856599,243059659,203060
-1,-1,2,242856599,243059659,203060
-1,-1,2,242856599,243059659,203060
-1,-1,2,242856599,243059659,203060
-1,-1,2,242856599,243059659,203060
-1,-1,2,242856599,243059659,203060
-1,-1,2,242856599,243059659,203060
-1,-1,2,242856599,243059659,203060
-1,-1,2,242856599,243059659,203060
-1,-1,2,242856599,243059659,203060
-1,-1,2,242856599,243059659,203060
-1,-1,2,242856599,243059659,203060
-1,-1,2,242856599,243059659,203060
-1,-1,2,242856599,243059659,203060
-1,-1,2,242856617,243028424,171807
-1,-1,2,242856617,243028424,171807
1,-1,2,242866025,242958350,92325
-1,-1,2,242873063,243028424,155361
1,-1,2,242880065,242953640,73575
1,-1,2,242886373,242958350,71977
1,-1,2,242886373,242958350,71977
-1,-1,2,242889825,242948040,58215
-1,-1,2,242889826,242947990,58164
-1,-1,2,242889826,242947990,58164
-1,-1,2,242889826,242947990,58164
-1,-1,2,242889826,242947990,58164
1,-1,2,242889855,242910505,20650
-1,-1,2,242920197,242947990,27793
-1,-1,2,242920197,242947990,27793
-1,-1,2,242920197,242947990,27793
-1,-1,2,242920197,242947990,27793
-1,-1,2,242920197,242947990,27793
-1,-1,2,242920197,242947990,27793
-1,-1,2,242920197,242947990,27793
-1,-1,2,242920197,242947990,27793
-1,-1,2,242920197,242947990,27793
-1,-1,2,242920197,242947990,27793
-1,-1,2,242920197,242947990,27793
1,-1,2,242920197,242953640,33443
-1,-1,2,242924058,242948040,23982
-1,-1,2,242924058,242948040,23982
-1,-1,2,242924058,242948040,23982
-1,-1,2,242924082,242947990,23908
-1,-1,2,242924082,242947990,23908
1,-1,2,242924082,242953640,29558
-1,-1,2,242927148,242947990,20842
-1,-1,2,242930600,242948040,17440
-1,-1,2,242930600,242948040,17440
-1,-1,2,242930600,242948040,17440
-1,-1,2,242930600,242948040,17440
-1,-1,2,242930600,242948040,17440
-1,-1,2,242930600,242948040,17440
-1,-1,2,242930600,242948040,17440
-1,-1,2,242930600,243007359,76759
-1,-1,2,242930600,243007359,76759
1,-1,2,242930600,243007359,76759
-1,-1,2,242930600,243007359,76759
-1,-1,2,242930600,243007359,76759
-1,-1,2,242930600,243007359,76759
-1,-1,2,242930600,243007359,76759
-1,-1,2,242930600,243007359,76759
-1,-1,2,242930600,243007359,76759
-1,-1,2,242930600,243007359,76759
-1,-1,2,242930600,243007359,76759
-1,-1,2,242930600,243007359,76759
-1,-1,2,242930600,243007359,76759
-1,-1,2,242930600,243007359,76759
1,-1,2,242930600,243007359,76759
-1,-1,2,242930600,243007359,76759
-1,-1,2,242930600,243007359,76759
-1,-1,2,242930600,243007359,76759
-1,-1,2,242930600,243007359,76759
-1,-1,2,242930600,243007359,76759
-1,-1,2,242930600,243007359,76759
-1,-1,2,242930600,243007359,76759
-1,-1,2,242930600,243007359,76759
1,-1,2,242930600,243007359,76759
-1,-1,2,242930600,243007359,76759
1,-1,2,242930600,243007359,76759
1,-1,2,242930600,243007359,76759
-1,-1,2,242930600,243007359,76759
-1,-1,2,242930600,243007359,76759
1,-1,2,242930600,243007359,76759
-1,-1,2,242930600,243007359,76759
1,-1,2,242930600,243007359,76759
-1,-1,2,242930600,243007359,76759
-1,-1,2,242930600,243007359,76759
-1,-1,2,242930600,243007359,76759
-1,-1,2,242930600,243007359,76759
-1,-1,2,242930600,243007359,76759
-1,-1,2,242930600,243007359,76759
-1,-1,2,242930600,243007359,76759
-1,-1,2,242930600,243007359,76759
1,-1,2,242930600,243007359,76759
1,-1,2,242930600,243007359,76759
-1,-1,2,242930600,243007359,76759
-1,-1,2,242930600,243007359,76759
-1,-1,2,242930600,243007359,76759
-1,-1,2,242930600,243007359,76759
1,-1,2,242930600,243007359,76759
-1,-1,2,242930600,243007359,76759
-1,-1,2,242930600,243007359,76759
-1,-1,2,242930600,243007359,76759
1,-1,2,242930600,243007359,76759
-1,-1,2,242930600,243007359,76759
-1,-1,2,242930600,243007359,76759
-1,-1,2,242930600,243007359,76759
-1,-1,2,242930600,243007359,76759
1,-1,2,242930600,243007359,76759
-1,-1,2,242930600,243007359,76759
-1,-1,2,242930600,243007359,76759
-1,-1,2,242930600,243007359,76759
-1,-1,2,242930600,243007359,76759
-1,-1,2,242930600,243007359,76759
-1,-1,2,242930600,243007359,76759
1,-1,2,242930600,243007359,76759
-1,-1,2,242930600,243007359,76759
1,-1,2,242930600,243007359,76759
-1,-1,2,242930600,243007359,76759
-1,-1,2,242930600,243007359,76759
-1,-1,2,242930600,243007359,76759
1,-1,2,242930600,243007359,76759
-1,-1,2,242930600,243007359,76759
-1,-1,2,242930600,243007359,76759
-1,-1,2,242930600,243007359,76759
1,-1,2,242930600,243007359,76759
-1,-1,2,242930600,243007359,76759
1,-1,2,242930600,243007359,76759
1,-1,2,242930600,243007359,76759
1,-1,2,242930600,243007359,76759
-1,-1,2,242930600,243007359,76759
1,-1,2,242930600,243007359,76759
-1,-1,2,242930600,243007359,76759
-1,-1,2,242930600,243007359,76759
-1,-1,2,242930600,243007359,76759
-1,-1,2,242930600,243007359,76759
-1,-1,2,242930600,243059659,129059
-1,-1,2,242930600,243059659,129059
-1,-1,2,242930600,243059659,129059
-1,-1,2,242930600,243059659,129059
-1,-1,2,242953547,243007359,53812
1,-1,2,242953581,243007457,53876
-1,-1,2,242953581,243007457,53876
-1,-1,2,242953581,243059659,106078
-1,-1,2,242953581,243059659,106078
-1,-1,2,242953581,243059659,106078
-1,-1,2,242953581,243059659,106078
-1,-1,2,242953581,243059659,106078
-1,-1,2,242953581,243059659,106078
-1,-1,2,242953581,243059659,106078
-1,-1,2,242953581,243059659,106078
-1,-1,2,242958497,242980267,21770
-1,-1,2,242969815,243007457,37642
-1,-1,2,242969815,243007457,37642
-1,-1,2,242997679,243015119,17440
-1,-1,2,242997679,243015119,17440
-1,-1,2,242997679,243015119,17440
-1,-1,2,242997679,243015119,17440
-1,-1,2,242997679,243015119,17440
-1,-1,2,242997679,243015119,17440
-1,-1,2,242997679,243015119,17440
-1,-1,2,242997679,243015119,17440
-1,-1,2,242997679,243015119,17440
-1,-1,2,242997679,243015119,17440
-1,-1,2,242997679,243015119,17440
-1,-1,2,242997679,243015119,17440
-1,-1,2,242997679,243015119,17440
-1,-1,2,242997679,243015119,17440
1,-1,2,243088755,243175692,86937
-1,1,3,61891,7456866,7394975
-1,1,3,61891,7865381,7803490
-1,1,3,61891,8600971,8539080
-1,1,3,61891,8777555,8715664
-1,1,3,61891,9403721,9341830
-1,1,3,61891,11263288,11201397
-1,1,3,61891,12575409,12513518
1,1,3,61891,24432821,24370930
1,1,3,61891,33958201,33896310
1,1,3,61891,36710181,36648290
1,1,3,61891,37459464,37397573
1,1,3,61892,197851986,197790094
1,1,3,61892,197851986,197790094
-1,1,3,73707,2362770,2289063
-1,1,3,73914,5832807,5758893
-1,1,3,73914,6107686,6033772
-1,1,3,73914,7098404,7024490
-1,1,3,73914,9107971,9034057
-1,1,3,73914,9511190,9437276
-1,1,3,73914,9616678,9542764
-1,1,3,73914,10364808,10290894
-1,1,3,73914,10672995,10599081
-1,1,3,73914,11421309,11347395
-1,1,3,73914,12722982,12649068
1,1,3,73914,13655318,13581404
1,1,3,73914,20375879,20301965
1,1,3,73914,30105699,30031785
1,1,3,93949,910076,816127
-1,1,3,93949,4562686,4468737
-1,1,3,93949,4869174,4775225
-1,1,3,93949,5179947,5085998
1,1,3,93949,6007771,5913822
-1,1,3,93949,6319291,6225342
-1,1,3,93949,9491994,9398045
1,-1,3,94430,159779,65349
-1,1,3,94430,8412059,8317629
1,1,3,94991,41423012,41328021
1,-1,3,127520,337899,210379
1,-1,3,232496,255379,22883
1,-1,3,232496,255379,22883
1,-1,3,270649,283052,12403
1,-1,3,571267,1347588,776321
1,-1,3,571267,1347588,776321
1,-1,3,666257,1133628,467371
1,-1,3,726645,800324,73679
-1,1,3,730581,11092828,10362247
1,-1,3,857141,1427460,570319
1,-1,3,1120841,1301800,180959
1,-1,3,1167732,1237717,69985
1,-1,3,1603622,1706230,102608
1,-1,3,1603622,1706230,102608
1,-1,3,1603622,1706230,102608
-1,-1,3,1797444,2026210,228766
-1,-1,3,1822272,1980753,158481
1,-1,3,1840279,1922459,82180
1,-1,3,1840308,1922488,82180
-1,-1,3,1922459,1962679,40220
1,-1,3,2294910,2579174,284264
-1,-1,3,2516991,2581838,64847
-1,-1,3,2530787,2579174,48387
1,-1,3,2644609,2796570,151961
1,-1,3,2718482,2740059,21577
-1,1,3,2930451,5953602,3023151
-1,1,3,2933269,5953309,3020040
-1,-1,3,2939700,2972075,32375
-1,1,3,2962570,5902795,2940225
-1,-1,3,3036600,3065980,29380
-1,-1,3,4002209,4231172,228963
-1,-1,3,4053328,4324235,270907
-1,-1,3,4094267,4231359,137092
-1,-1,3,4191029,4324235,133206
-1,1,3,4513392,4573345,59953
-1,-1,3,6319232,6852338,533106
-1,1,3,6842555,10153209,3310654
1,1,3,7397797,14401942,7004145
-1,-1,3,7876256,8017421,141165
-1,-1,3,7989510,8080414,90904
-1,1,3,8361812,9437652,1075840
-1,1,3,9436558,11732086,2295528
-1,1,3,9666380,10028247,361867
-1,1,3,9917593,10614361,696768
-1,1,3,9937745,10262646,324901
-1,1,3,10035404,11771570,1736166
1,-1,3,12684054,12775771,91717
1,-1,3,12684054,12775771,91717
1,1,3,14402247,21697626,7295379
-1,-1,3,20665501,20764881,99380
1,-1,3,21805856,22229796,423940
1,-1,3,22120611,22197035,76424
-1,-1,3,22120611,22255029,134418
1,-1,3,23709628,23825386,115758
-1,-1,3,26060682,26237778,177096
-1,-1,3,26060682,26279585,218903
-1,1,3,29255443,35022806,5767363
-1,-1,3,30676131,30680105,3974
1,1,3,33769898,40703942,6934044
1,-1,3,35807767,35926519,118752
-1,1,3,36870006,37048718,178712
1,-1,3,36976785,37099615,122830
1,-1,3,38598251,38598631,380
1,-1,3,38598462,38598576,114
1,-1,3,38598462,38598631,169
1,1,3,45921375,50787353,4865978
1,1,3,45921375,50787353,4865978
-1,1,3,46768104,47009805,241701
1,-1,3,49723098,49728537,5439
1,-1,3,49723098,49728537,5439
1,-1,3,49723098,49728537,5439
1,1,3,50856276,51245158,388882
1,1,3,50856276,51245158,388882
1,-1,3,55745130,55817929,72799
-1,1,3,57174452,90309110,33134658
-1,1,3,57416265,64870197,7453932
-1,-1,3,60088353,60240457,152104
-1,-1,3,60088353,60240457,152104
-1,-1,3,60088353,60240457,152104
-1,-1,3,60877562,61231290,353728
1,-1,3,62899672,63184850,285178
-1,-1,3,65170204,65213448,43244
1,-1,3,66631012,66668048,37036
-1,1,3,67441430,73463152,6021722
-1,1,3,68884687,74992574,6107887
-1,1,3,69964029,70538306,574277
-1,1,3,70433832,77012164,6578332
-1,1,3,70992771,71911040,918269
-1,1,3,71008556,71049017,40461
-1,1,3,71366497,74373822,3007325
-1,1,3,73874022,90502849,16628827
-1,1,3,74698533,89544831,14846298
-1,-1,3,75028665,75164716,136051
1,-1,3,75571154,75703905,132751
-1,-1,3,75571154,75793273,222119
1,-1,3,75703905,75791565,87660
1,-1,3,75703905,75863200,159295
1,-1,3,75718528,75791565,73037
1,-1,3,75718528,75791565,73037
1,-1,3,76049526,76918058,868532
-1,-1,3,78531547,78621122,89575
1,-1,3,79562574,79599463,36889
1,-1,3,80416729,81052857,636128
1,-1,3,80488971,80750263,261292
1,-1,3,80488971,80750263,261292
-1,-1,3,80791314,81455867,664553
1,-1,3,81388075,81493667,105592
-1,-1,3,82165558,82248585,83027
1,-1,3,83385374,83567654,182280
-1,-1,3,85457457,85615568,158111
-1,-1,3,85570266,85615568,45302
1,-1,3,89854127,90254003,399876
1,1,3,93519464,145413168,51893704
-1,1,3,93538467,116605903,23067436
-1,1,3,97514213,115382196,17867983
1,-1,3,100360692,100444050,83358
1,-1,3,100360692,100444050,83358
1,-1,3,100360692,100444050,83358
1,-1,3,100360692,100444050,83358
1,-1,3,100360692,100444050,83358
1,-1,3,100360692,100444050,83358
1,-1,3,100360692,100444050,83358
1,-1,3,100360692,100444050,83358
1,-1,3,100360692,100444050,83358
1,-1,3,100360692,100444050,83358
1,-1,3,100360692,100444050,83358
1,-1,3,100360692,100444050,83358
1,-1,3,100360692,100444050,83358
1,-1,3,100360692,100444050,83358
1,-1,3,100360692,100444050,83358
1,-1,3,100360692,100444050,83358
1,-1,3,100360692,100444050,83358
1,-1,3,100360692,100444050,83358
1,-1,3,100360692,100444050,83358
-1,1,3,101177841,116229099,15051258
1,-1,3,102200139,102285212,85073
1,1,3,103145726,197837049,94691323
-1,-1,3,104077800,104264937,187137
-1,1,3,105094834,117441953,12347119
-1,-1,3,105141696,105404293,262597
-1,1,3,106170339,108984343,2814004
-1,-1,3,110196839,110578711,381872
-1,1,3,112152634,115507896,3355262
-1,1,3,112144081,115514432,3370351
-1,1,3,112144081,115514432,3370351
-1,1,3,112183941,115492958,3309017
-1,1,3,112239400,119749869,7510469
-1,1,3,112339824,128452977,16113153
-1,1,3,112590339,116461450,3871111
-1,1,3,113841409,124251221,10409812
-1,1,3,114737921,122232245,7494324
-1,-1,3,116973963,117563805,589842
-1,1,3,118392745,126259573,7866828
1,-1,3,118752388,118800220,47832
1,-1,3,118778681,118800220,21539
1,-1,3,118778681,118800220,21539
-1,1,3,121643994,126501092,4857098
-1,1,3,129536086,141143997,11607911
-1,1,3,129536086,143100466,13564380
-1,1,3,130120109,138723861,8603752
-1,1,3,132435822,144503585,12067763
-1,1,3,133976022,149447325,15471303
-1,1,3,134052395,141420300,7367905
-1,1,3,137650842,144187581,6536739
-1,1,3,137709965,143337628,5627663
1,-1,3,137848838,137882743,33905
1,1,3,138347957,139773898,1425941
1,-1,3,141810106,141904777,94671
1,-1,3,141831928,142053109,221181
1,-1,3,141831928,142053109,221181
1,-1,3,141831928,142053109,221181
1,-1,3,141831928,142053109,221181
1,-1,3,141831928,142053109,221181
1,-1,3,141831928,142053109,221181
1,-1,3,141831928,142053109,221181
1,-1,3,141831928,142053109,221181
1,-1,3,141831928,142053109,221181
1,-1,3,141867689,142051761,184072
1,-1,3,141867689,142051761,184072
1,-1,3,141867689,142051761,184072
1,-1,3,141867689,142051761,184072
1,-1,3,141867689,142051761,184072
1,-1,3,141867689,142051761,184072
-1,-1,3,143862793,143989329,126536
-1,1,3,147180945,168415875,21234930
-1,1,3,148425748,153220169,4794421
1,1,3,151818301,197845254,46026953
1,1,3,152356847,197851986,45495139
1,-1,3,155106491,155208591,102100
1,1,3,155836230,197851986,42015756
1,1,3,156039667,197840323,41800656
1,1,3,157128738,181637333,24508595
1,1,3,158980631,197766890,38786259
-1,-1,3,161435356,161520563,85207
-1,-1,3,161435356,161520563,85207
-1,1,3,161925999,164272614,2346615
-1,-1,3,162095816,162391365,295549
-1,-1,3,162540988,162768909,227921
-1,-1,3,162540988,162768909,227921
-1,-1,3,162540988,162768909,227921
-1,-1,3,162540988,162768909,227921
-1,-1,3,162540988,162768909,227921
-1,-1,3,162540988,162768909,227921
-1,-1,3,162540988,162768909,227921
-1,-1,3,162540988,162768909,227921
-1,-1,3,162540988,162768909,227921
-1,-1,3,162540988,162768909,227921
-1,-1,3,162540988,162768909,227921
-1,-1,3,162540988,162768909,227921
-1,-1,3,162540988,162768909,227921
-1,-1,3,162540988,162768909,227921
-1,-1,3,162540988,162768909,227921
-1,-1,3,162540988,162768909,227921
-1,-1,3,162540988,162768909,227921
-1,-1,3,162540988,162768909,227921
-1,-1,3,162540988,162768909,227921
-1,-1,3,162540988,162768909,227921
-1,-1,3,162540988,162768909,227921
-1,-1,3,162540988,162768909,227921
-1,-1,3,162540988,162768909,227921
-1,-1,3,162540988,162768909,227921
-1,-1,3,162540988,162768909,227921
-1,-1,3,162540988,162768909,227921
-1,-1,3,162540988,162768909,227921
-1,-1,3,162540988,162768909,227921
-1,-1,3,162540988,162768909,227921
-1,-1,3,162540988,162768909,227921
-1,-1,3,162540988,162768909,227921
-1,-1,3,162540988,162768909,227921
-1,-1,3,162540988,162768909,227921
-1,-1,3,162540988,162768909,227921
-1,-1,3,162540988,162768909,227921
-1,-1,3,162540988,162768909,227921
-1,-1,3,162540988,162768909,227921
-1,-1,3,162540988,162768909,227921
-1,-1,3,162540988,162768909,227921
-1,-1,3,162540988,162768909,227921
-1,-1,3,162540988,162768909,227921
-1,-1,3,162540988,162768909,227921
-1,-1,3,162540988,162768909,227921
-1,-1,3,162540988,162768909,227921
-1,-1,3,162540988,162768909,227921
-1,-1,3,162540988,162768909,227921
-1,-1,3,162540988,162768909,227921
-1,-1,3,162540988,162768909,227921
-1,-1,3,162540988,162768909,227921
-1,-1,3,162540988,162768909,227921
-1,-1,3,162540988,162768909,227921
-1,-1,3,162540988,162768909,227921
-1,-1,3,162540988,162768909,227921
-1,-1,3,162540988,162768909,227921
-1,-1,3,162540988,162768909,227921
-1,-1,3,162540988,162768909,227921
-1,-1,3,162540988,162768909,227921
-1,-1,3,162540988,162768909,227921
-1,-1,3,162540988,162768909,227921
-1,-1,3,162540988,162768909,227921
-1,-1,3,162540988,162768909,227921
-1,-1,3,162540988,162768909,227921
-1,-1,3,162540988,162768909,227921
-1,-1,3,162540988,162768909,227921
-1,-1,3,162540988,162768909,227921
-1,-1,3,162540988,162768909,227921
-1,-1,3,162540988,162768909,227921
-1,-1,3,162540988,162768909,227921
-1,-1,3,162540988,162768909,227921
-1,-1,3,162540988,162768909,227921
-1,-1,3,162540988,162768909,227921
-1,-1,3,162540988,162768909,227921
-1,-1,3,162540988,162768909,227921
-1,-1,3,162540988,162768909,227921
-1,-1,3,162540988,162768909,227921
-1,-1,3,162540988,162768909,227921
-1,-1,3,162540988,162768909,227921
-1,-1,3,162540988,162768909,227921
-1,-1,3,162540988,162768909,227921
-1,-1,3,162540988,162768909,227921
-1,-1,3,162540988,162768909,227921
-1,-1,3,162540988,162768909,227921
-1,-1,3,162540988,162768909,227921
-1,-1,3,162540988,162768909,227921
-1,-1,3,162540988,162768909,227921
-1,-1,3,162540988,162787987,246999
-1,-1,3,162540988,162787987,246999
-1,-1,3,162540988,162787987,246999
-1,-1,3,162540988,162787987,246999
-1,-1,3,162540988,162787987,246999
-1,-1,3,162540988,162787987,246999
-1,-1,3,162540988,162787987,246999
-1,-1,3,162540988,162787987,246999
-1,-1,3,162540988,162787987,246999
-1,-1,3,162540988,162787987,246999
-1,-1,3,162540988,162787987,246999
-1,-1,3,162540988,162787987,246999
-1,-1,3,162540988,162787987,246999
-1,-1,3,162540988,162787987,246999
-1,-1,3,162540988,162787987,246999
-1,-1,3,162540988,162787987,246999
-1,-1,3,162540988,162787987,246999
-1,-1,3,162540988,162787987,246999
-1,-1,3,162540988,162787987,246999
-1,-1,3,162540988,162787987,246999
-1,-1,3,162540988,162787987,246999
-1,-1,3,162540988,162787987,246999
-1,-1,3,162540988,162787987,246999
-1,-1,3,162540988,162787987,246999
-1,-1,3,162540988,162787987,246999
-1,-1,3,162540988,162787987,246999
-1,-1,3,162540988,162787987,246999
-1,-1,3,162540988,162787987,246999
-1,-1,3,162540988,162787987,246999
-1,-1,3,162540988,162787987,246999
-1,-1,3,162540988,162787987,246999
-1,-1,3,162540988,162787987,246999
-1,-1,3,162540988,162787987,246999
-1,-1,3,162540988,162787987,246999
-1,-1,3,162540988,162787987,246999
-1,-1,3,162540988,162787987,246999
-1,-1,3,162540988,162787987,246999
-1,-1,3,162540988,162787987,246999
-1,-1,3,162540988,162787987,246999
-1,-1,3,162540988,162787987,246999
-1,-1,3,162540988,162787987,246999
-1,-1,3,162540988,162787987,246999
-1,-1,3,162540988,162787987,246999
-1,-1,3,162540988,162787987,246999
-1,-1,3,162540988,162787987,246999
-1,-1,3,162540988,162787987,246999
-1,-1,3,162540988,162787987,246999
-1,-1,3,162540988,162787987,246999
-1,-1,3,162540988,162787987,246999
-1,-1,3,162540988,162787987,246999
-1,-1,3,162540988,162787987,246999
-1,-1,3,162540988,162787987,246999
-1,-1,3,162540988,162787987,246999
-1,-1,3,162540988,162787987,246999
-1,-1,3,162540988,162787987,246999
-1,-1,3,162540988,162787987,246999
-1,-1,3,162540988,162787987,246999
-1,-1,3,162540988,162787987,246999
-1,-1,3,162540988,162787987,246999
-1,-1,3,162540988,162787987,246999
-1,-1,3,162540988,162787987,246999
-1,-1,3,162540988,162787987,246999
-1,-1,3,162540988,162787987,246999
-1,-1,3,162540988,162787987,246999
-1,-1,3,162540988,162787987,246999
-1,-1,3,162540988,162787987,246999
-1,-1,3,162540988,162787987,246999
-1,-1,3,162540988,162787987,246999
-1,-1,3,162540988,162787987,246999
-1,-1,3,162540988,162787987,246999
-1,-1,3,162540988,162787987,246999
-1,-1,3,162540988,162787987,246999
-1,-1,3,162540988,162787987,246999
-1,-1,3,162540988,162787987,246999
-1,-1,3,162540988,162787987,246999
-1,-1,3,162540988,162787987,246999
-1,-1,3,162540988,162787987,246999
-1,-1,3,162540988,162787987,246999
-1,-1,3,162540988,162787987,246999
-1,-1,3,162540988,162787987,246999
-1,-1,3,162540988,162787987,246999
-1,-1,3,162540988,162787987,246999
-1,-1,3,162540988,162787987,246999
-1,-1,3,162540988,162787987,246999
-1,-1,3,162540988,162787987,246999
-1,-1,3,162540988,162787987,246999
-1,-1,3,162540988,162787987,246999
-1,-1,3,162540988,162787987,246999
-1,-1,3,162540988,162787987,246999
-1,-1,3,162540988,162787987,246999
-1,-1,3,162540988,162787987,246999
-1,-1,3,162540988,162787987,246999
-1,-1,3,162540988,162787987,246999
-1,-1,3,162540988,162787987,246999
-1,-1,3,162540988,162787987,246999
-1,-1,3,162540988,162787987,246999
-1,-1,3,162540988,162787987,246999
-1,-1,3,162540988,162787987,246999
-1,-1,3,162540988,162787987,246999
-1,-1,3,162540988,162787987,246999
-1,-1,3,162540988,162787987,246999
-1,-1,3,162540988,162787987,246999
-1,-1,3,162540988,162787987,246999
-1,-1,3,162540988,162787987,246999
-1,-1,3,162540988,162787987,246999
-1,-1,3,162540988,162787987,246999
-1,-1,3,162540988,162787987,246999
-1,-1,3,162540988,162787987,246999
-1,-1,3,162540988,162787987,246999
-1,-1,3,162540988,162787987,246999
-1,-1,3,162540988,162787987,246999
-1,-1,3,162540988,162787987,246999
-1,-1,3,162540988,162787987,246999
-1,-1,3,162540988,162787987,246999
-1,-1,3,162540988,162787987,246999
-1,-1,3,162540988,162787987,246999
-1,-1,3,162504792,162619112,114320
-1,-1,3,162504792,162619112,114320
1,-1,3,162514564,162584576,70012
-1,-1,3,162514564,162619112,104548
-1,-1,3,162514564,162619112,104548
-1,-1,3,162514564,162619112,104548
-1,-1,3,162514564,162619112,104548
-1,-1,3,162514564,162619112,104548
-1,-1,3,162514564,162619112,104548
-1,-1,3,162540838,162619112,78274
-1,-1,3,162540838,162619112,78274
-1,-1,3,162540838,162619112,78274
-1,-1,3,162540838,162619112,78274
-1,-1,3,162584576,162619112,34536
-1,-1,3,162584576,162619112,34536
-1,-1,3,162805350,162895756,90406
-1,-1,3,162861016,162945167,84151
-1,-1,3,162861016,162945167,84151
-1,-1,3,162983135,163551976,568841
1,-1,3,164004587,164335127,330540
1,1,3,164876399,179847956,14971557
1,-1,3,165772419,166613286,840867
1,1,3,165854997,197851986,31996989
-1,-1,3,165917468,166019876,102408
-1,1,3,167336627,167406415,69788
1,1,3,167885356,197837049,29951693
-1,-1,3,172229388,172241275,11887
-1,1,3,173830320,182170131,8339811
1,1,3,175886313,197845254,21958941
1,1,3,176157699,197845254,21687555
1,1,3,177246493,197837049,20590556
1,-1,3,179666123,179899347,233224
-1,1,3,180856452,192229812,11373360
-1,1,3,180939665,182170131,1230466
1,-1,3,181362779,181469511,106732
-1,1,3,181407035,181511904,104869
1,-1,3,181429948,181430953,1005
1,1,3,181911498,197851986,15940488
-1,1,3,183178932,186838042,3659110
1,-1,3,183960109,184107620,147511
1,1,3,184561415,187178796,2617381
-1,1,3,184869065,185276194,407129
-1,1,3,185224059,185695671,471612
-1,1,3,185419048,186575415,1156367
-1,1,3,185599934,196462295,10862361
-1,1,3,186482937,194130145,7647208
1,-1,3,189383139,189397549,14410
1,-1,3,191261671,191479946,218275
1,1,3,192470726,197845254,5374528
1,1,3,193422394,197851986,4429592
1,1,3,194013986,197837069,3823083
-1,1,3,194059263,197420612,3361349
1,-1,3,195263979,195459589,195610
1,-1,3,195263979,195459589,195610
1,-1,3,195263987,195463502,199515
1,-1,3,195358277,195425875,67598
1,-1,3,195358277,195425875,67598
1,-1,3,195358277,195425875,67598
1,-1,3,195358277,195425875,67598
1,-1,3,195358277,195425875,67598
1,-1,3,195358277,195425875,67598
1,-1,3,195358277,195425875,67598
1,-1,3,195358277,195425875,67598
1,-1,3,195358277,195425875,67598
1,-1,3,195358277,195425875,67598
1,-1,3,195358277,195425875,67598
1,-1,3,195358277,195425875,67598
1,-1,3,195358277,195425875,67598
1,-1,3,195358277,195425875,67598
1,-1,3,195358277,195425875,67598
1,-1,3,195358277,195425875,67598
1,-1,3,195358277,195425875,67598
1,-1,3,195358277,195425875,67598
1,-1,3,195358277,195425875,67598
1,-1,3,195358277,195425875,67598
1,-1,3,195358277,195425875,67598
1,-1,3,195358277,195425875,67598
1,-1,3,195358277,195425875,67598
1,-1,3,195358277,195425875,67598
1,-1,3,195358277,195425875,67598
1,-1,3,195358277,195425875,67598
1,-1,3,195358277,195425875,67598
1,-1,3,195358277,195425875,67598
1,-1,3,195358277,195425875,67598
1,-1,3,195358277,195425875,67598
1,-1,3,195358277,195425875,67598
1,-1,3,195358277,195425875,67598
1,-1,3,195358277,195425875,67598
1,-1,3,195358277,195425875,67598
1,-1,3,195358277,195425875,67598
1,-1,3,195358277,195425875,67598
1,-1,3,195358277,195425875,67598
1,-1,3,195358277,195425875,67598
1,-1,3,195358277,195425875,67598
1,-1,3,195358277,195425875,67598
1,-1,3,195358277,195565159,206882
1,-1,3,195358322,195425875,67553
1,-1,3,195358322,195425875,67553
-1,-1,3,195358322,195425875,67553
1,-1,3,195381420,195425875,44455
1,-1,3,195419197,195438493,19296
1,-1,3,195419197,195438493,19296
-1,-1,3,195419197,195438493,19296
1,1,3,195438669,197837049,2398380
1,1,3,195456034,197851986,2395952
1,1,3,195456034,197851986,2395952
1,-1,3,195456487,195459589,3102
1,-1,3,195460400,195463502,3102
1,-1,3,195565159,195645536,80377
1,-1,3,195623819,195664132,40313
-1,1,3,195682582,197324783,1642201
-1,1,3,195690227,197356334,1666107
-1,1,3,195690227,197356334,1666107
-1,1,3,195701162,197324783,1623621
-1,1,3,195740402,197324567,1584165
-1,1,3,195703615,197356334,1652719
-1,1,3,195725290,197344176,1618886
-1,1,3,195725290,197344176,1618886
-1,1,3,195725290,197356334,1631044
-1,1,3,195740357,197324783,1584426
-1,1,3,195740357,197339270,1598913
-1,1,3,195740402,197317103,1576701
-1,1,3,195740402,197317103,1576701
1,1,3,195780280,196264407,484127
-1,1,3,195780280,197299752,1519472
1,-1,3,196451599,196481486,29887
1,-1,3,196825864,197385366,559502
1,-1,3,197031290,197146196,114906
1,-1,3,197031290,197385366,354076
1,-1,3,197259235,197385366,126131
1,-1,3,197259235,197385366,126131
1,-1,3,197513379,197603336,89957
1,-1,3,197589515,197748514,158999
1,-1,3,197589515,197837069,247554
1,-1,3,197668799,197837049,168250
1,-1,3,197717518,197837049,119531
1,-1,3,197729964,197837049,107085
1,-1,3,197751553,197837049,85496
1,-1,3,197751553,197837049,85496
1,-1,3,197821738,197895169,73431
1,-1,3,197821738,197895169,73431
1,-1,3,197863435,197912281,48846
1,-1,3,197863435,197946533,83098
1,-1,4,12440,59911,47471
1,-1,4,12440,64577,52137
1,-1,4,12440,64577,52137
1,-1,4,12440,64577,52137
1,-1,4,12440,68159,55719
1,-1,4,12440,68159,55719
1,-1,4,12440,117871,105431
1,-1,4,12440,117871,105431
1,1,4,12440,190904441,190892001
-1,-1,4,29214,68159,38945
1,-1,4,29214,68159,38945
-1,-1,4,29214,68159,38945
-1,-1,4,29214,68159,38945
-1,-1,4,29214,68159,38945
-1,1,4,29214,1925508,1896294
-1,1,4,33574,2356516,2322942
-1,1,4,33574,4534781,4501207
1,1,4,33574,6632513,6598939
-1,-1,4,36424,68211,31787
-1,1,4,36424,1957819,1921395
-1,1,4,36424,3267258,3230834
-1,1,4,36424,3883057,3846633
-1,1,4,36424,3975771,3939347
1,1,4,36424,4098729,4062305
-1,1,4,36424,7361544,7325120
-1,1,4,36424,9371067,9334643
1,1,4,36424,47493612,47457188
-1,-1,4,37126,75706,38580
-1,-1,4,37336,59292,21956
-1,-1,4,37336,59292,21956
-1,-1,4,37336,64632,27296
-1,-1,4,37336,64632,27296
-1,-1,4,37336,64632,27296
-1,-1,4,37336,64632,27296
-1,-1,4,37336,64632,27296
-1,-1,4,37336,64632,27296
-1,-1,4,37336,64632,27296
-1,-1,4,37336,64632,27296
-1,-1,4,37336,64632,27296
-1,-1,4,37336,64632,27296
-1,-1,4,37336,64632,27296
-1,-1,4,37336,66316,28980
-1,-1,4,37336,66316,28980
-1,-1,4,37336,66316,28980
-1,-1,4,37336,66316,28980
-1,-1,4,37336,66316,28980
-1,-1,4,37336,66316,28980
-1,-1,4,37336,66316,28980
-1,-1,4,37336,66316,28980
-1,-1,4,37336,66316,28980
-1,-1,4,37336,66316,28980
-1,-1,4,37336,66316,28980
-1,-1,4,37336,66316,28980
-1,-1,4,37336,66316,28980
-1,-1,4,37336,66316,28980
-1,-1,4,37336,66316,28980
-1,-1,4,37336,66316,28980
-1,-1,4,37336,66316,28980
-1,-1,4,37336,66316,28980
-1,-1,4,37336,66316,28980
-1,-1,4,37336,66316,28980
-1,-1,4,37336,66316,28980
-1,-1,4,37336,66316,28980
-1,-1,4,37336,66316,28980
-1,-1,4,37336,66316,28980
-1,-1,4,37336,66316,28980
-1,-1,4,37336,66316,28980
-1,-1,4,37336,66316,28980
-1,-1,4,37336,66316,28980
-1,-1,4,37336,66316,28980
-1,-1,4,37336,66316,28980
-1,-1,4,37336,66316,28980
-1,-1,4,37336,66316,28980
-1,-1,4,37336,66316,28980
-1,-1,4,37336,66316,28980
-1,-1,4,37336,66316,28980
-1,-1,4,37336,66316,28980
-1,-1,4,37336,66316,28980
-1,-1,4,37336,66316,28980
-1,-1,4,37336,66316,28980
-1,-1,4,37336,66316,28980
-1,-1,4,37336,66316,28980
-1,-1,4,37336,66316,28980
-1,-1,4,37336,66316,28980
-1,-1,4,37336,66316,28980
-1,-1,4,37336,66316,28980
-1,-1,4,37336,66316,28980
-1,-1,4,37336,66316,28980
-1,-1,4,37336,66316,28980
-1,-1,4,37336,66316,28980
-1,-1,4,37336,66316,28980
-1,-1,4,37336,66316,28980
-1,-1,4,37336,66316,28980
-1,-1,4,37336,66316,28980
-1,-1,4,37336,66316,28980
-1,-1,4,37336,66316,28980
-1,-1,4,37336,66316,28980
-1,-1,4,37336,66316,28980
-1,-1,4,37336,66316,28980
-1,-1,4,37336,66316,28980
-1,-1,4,37336,66316,28980
-1,-1,4,37336,66316,28980
-1,-1,4,37336,66316,28980
-1,-1,4,37336,66316,28980
-1,-1,4,37336,66316,28980
-1,-1,4,37336,66316,28980
-1,-1,4,37336,72379,35043
-1,-1,4,37336,72379,35043
1,-1,4,37336,127278,89942
-1,1,4,37336,3776839,3739503
-1,1,4,37336,9370984,9333648
-1,1,4,37336,15870679,15833343
-1,-1,4,45889,64632,18743
-1,-1,4,45889,66316,20427
-1,-1,4,45889,66316,20427
-1,-1,4,45912,68185,22273
-1,-1,4,48633,66316,17683
-1,-1,4,48633,66316,17683
1,-1,4,51413,113583,62170
1,-1,4,51413,113583,62170
-1,1,4,51413,1399150,1347737
1,1,4,51413,17799819,17748406
1,-1,4,64577,117871,53294
1,-1,4,66257,127278,61021
-1,1,4,68345,1999185,1930840
-1,1,4,68345,2126308,2057963
-1,1,4,68345,2155022,2086677
-1,1,4,68345,2502977,2434632
-1,1,4,68345,3891984,3823639
-1,1,4,68345,4044985,3976640
-1,1,4,68345,5319773,5251428
-1,1,4,68345,6056753,5988408
-1,1,4,68345,8731855,8663510
1,1,4,68345,8731855,8663510
-1,1,4,68345,10336032,10267687
-1,1,4,68345,13770107,13701762
-1,1,4,68345,14614077,14545732
-1,1,4,68345,15197147,15128802
-1,1,4,68345,15973383,15905038
-1,1,4,68345,20387231,20318886
-1,1,4,68345,20533787,20465442
1,1,4,68345,49089361,49021016
1,1,4,68345,49093788,49025443
1,1,4,68345,66440622,66372277
1,1,4,68346,190957473,190889127
1,1,4,68346,190957473,190889127
-1,1,4,71552,15302739,15231187
1,-1,4,72320,117920,45600
1,-1,4,72320,127278,54958
1,-1,4,72320,127278,54958
1,-1,4,72320,127278,54958
1,-1,4,72320,127278,54958
1,-1,4,72320,127278,54958
1,-1,4,72320,127278,54958
1,-1,4,72320,139860,67540
1,-1,4,72320,156164,83844
1,-1,4,72447,113583,41136
1,-1,4,72447,113583,41136
1,-1,4,72447,113583,41136
1,-1,4,72447,113583,41136
1,-1,4,72447,113583,41136
1,-1,4,72447,113583,41136
1,-1,4,72447,113583,41136
1,-1,4,72447,113583,41136
1,-1,4,72447,113583,41136
1,-1,4,72447,160647,88200
1,-1,4,72447,160647,88200
1,-1,4,72447,160647,88200
1,-1,4,72447,160647,88200
-1,1,4,72447,2110334,2037887
-1,1,4,72447,2691306,2618859
-1,1,4,72447,3563382,3490935
-1,1,4,72447,3725774,3653327
-1,1,4,72447,4360445,4287998
-1,1,4,72447,4360445,4287998
-1,1,4,72447,4889835,4817388
-1,1,4,72447,5346537,5274090
-1,1,4,72447,6245152,6172705
-1,1,4,72447,10252290,10179843
-1,1,4,72447,12900236,12827789
-1,1,4,72447,15659658,15587211
-1,1,4,72447,17279636,17207189
1,1,4,72447,21024037,20951590
1,1,4,72447,39478764,39406317
1,1,4,72447,39478764,39406317
1,-1,4,78470,117871,39401
1,-1,4,78470,117871,39401
-1,1,4,78470,3364946,3286476
-1,1,4,78470,10337237,10258767
1,1,4,78470,15627196,15548726
-1,-1,4,102091,143143,41052
1,-1,4,129753,221449,91696
-1,1,4,129753,9371067,9241314
1,-1,4,160648,174508,13860
-1,-1,4,160648,185308,24660
-1,-1,4,160648,185308,24660
-1,-1,4,160648,185425,24777
-1,-1,4,160648,185425,24777
-1,-1,4,160648,185425,24777
-1,-1,4,160648,185425,24777
-1,-1,4,160648,185425,24777
-1,-1,4,160648,185425,24777
1,-1,4,952406,1020417,68011
1,-1,4,952406,1020417,68011
1,-1,4,952406,1020417,68011
1,-1,4,952406,1020417,68011
1,-1,4,952406,1020417,68011
1,-1,4,952406,1020417,68011
1,-1,4,952406,1020417,68011
1,-1,4,952406,1020417,68011
1,-1,4,952406,1020417,68011
1,-1,4,952406,1020417,68011
1,-1,4,952406,1020417,68011
1,-1,4,952406,1020417,68011
1,-1,4,952406,1020417,68011
1,-1,4,952406,1020417,68011
1,-1,4,952406,1020417,68011
1,-1,4,952406,1020417,68011
1,-1,4,952406,1020417,68011
1,-1,4,952465,1020417,67952
1,-1,4,968925,1020417,51492
1,-1,4,968925,1020417,51492
1,-1,4,968925,1020476,51551
-1,1,4,1228528,2862002,1633474
1,-1,4,1389570,1496153,106583
1,-1,4,1389570,1496153,106583
-1,1,4,1966266,5913899,3947633
-1,-1,4,1986918,1988906,1988
1,-1,4,3444416,3475134,30718
1,-1,4,3444416,3475134,30718
1,-1,4,3444416,3487232,42816
1,-1,4,3903555,4029211,125656
-1,-1,4,4029241,4209171,179930
1,-1,4,4166772,4190047,23275
1,-1,4,4166772,4249253,82481
1,-1,4,4166772,4249253,82481
1,-1,4,4190047,4249253,59206
-1,1,4,4428130,17462172,13034042
1,-1,4,10121950,10403654,281704
1,-1,4,10121950,10403654,281704
1,-1,4,13000279,13071530,71251
1,-1,4,15613881,15659599,45718
1,-1,4,15613881,15659599,45718
1,-1,4,15613881,15659599,45718
1,-1,4,15613881,15659599,45718
1,-1,4,15613881,15683370,69489
-1,1,4,16926645,32114698,15188053
-1,1,4,23863623,27687168,3823545
1,-1,4,33520754,33717980,197226
-1,-1,4,34367737,34527822,160085
-1,-1,4,35542014,35604731,62717
1,-1,4,39223728,39493230,269502
1,1,4,40498493,49581867,9083374
1,-1,4,49163546,49202553,39007
1,-1,4,49163546,49215538,51992
1,-1,4,49163546,49215538,51992
1,-1,4,49163546,49237502,73956
1,-1,4,49163546,49237502,73956
1,-1,4,49163546,49501695,338149
1,-1,4,49163546,49501695,338149
1,-1,4,49163546,49501695,338149
1,-1,4,49163546,49501695,338149
1,-1,4,49163546,49501695,338149
1,-1,4,49237502,49333282,95780
1,-1,4,49237502,49333282,95780
1,-1,4,49237502,49333282,95780
1,-1,4,49237502,49333282,95780
1,-1,4,49260988,49538325,277337
1,-1,4,49260988,49538325,277337
1,-1,4,49260988,49538325,277337
1,-1,4,49260988,49538325,277337
1,-1,4,49260988,49538325,277337
-1,-1,4,49261077,49538398,277321
-1,1,4,55587786,55614038,26252
1,-1,4,57915534,58084629,169095
-1,1,4,59167245,101910659,42743414
1,-1,4,63025655,63568620,542965
1,-1,4,63737871,64116915,379044
-1,1,4,66017575,76772947,10755372
1,-1,4,69276372,69592846,316474
1,-1,4,69375169,69433921,58752
-1,-1,4,69375169,69433921,58752
1,-1,4,69375169,69462125,86956
-1,-1,4,69375169,69462125,86956
1,-1,4,69375169,69462125,86956
-1,-1,4,69375169,69462125,86956
-1,-1,4,69375169,69462125,86956
-1,-1,4,69375169,69462125,86956
-1,-1,4,69375169,69483248,108079
1,-1,4,69375169,69483248,108079
-1,-1,4,69375169,69483248,108079
1,-1,4,69375169,69483248,108079
-1,-1,4,69375170,69483248,108078
1,-1,4,69375170,69483248,108078
1,-1,4,69375170,69483248,108078
1,-1,4,69392575,69462125,69550
1,-1,4,69402791,70476029,1073238
1,1,4,69551806,96215607,26663801
1,1,4,69767879,71485990,1718111
1,-1,4,70125131,70182147,57016
1,-1,4,70153895,70203219,49324
1,-1,4,70153895,70230130,76235
1,1,4,73127975,86923300,13795325
1,-1,4,73819067,74044813,225746
-1,1,4,74718441,77413508,2695067
1,1,4,76722296,79926959,3204663
-1,1,4,80707668,86753960,6046292
-1,1,4,80965103,87869469,6904366
-1,1,4,81348177,101776598,20428421
-1,-1,4,81693246,81800931,107685
-1,1,4,81800931,95730598,13929667
-1,1,4,82283358,90341831,8058473
-1,1,4,85250704,88600356,3349652
-1,1,4,85250704,94575625,9324921
1,1,4,85498672,86998700,1500028
-1,1,4,85805268,103678797,17873529
-1,1,4,85839771,93071150,7231379
-1,1,4,86370518,94894345,8523827
-1,1,4,86893239,87952527,1059288
-1,1,4,88265488,94575586,6310098
-1,-1,4,91342219,91842807,500588
1,-1,4,91753638,92240582,486944
-1,1,4,92201567,103043808,10842241
1,-1,4,92240523,93434401,1193878
1,1,4,93071152,190957473,97886321
-1,1,4,93531564,102443148,8911584
-1,1,4,93978239,94073948,95709
1,-1,4,98632408,98757752,125344
1,-1,4,98632408,98757752,125344
1,1,4,109199664,189752726,80553062
-1,-1,4,116321349,116913753,592404
-1,-1,4,116731797,117041205,309408
-1,-1,4,116913694,117097417,183723
-1,1,4,118273037,134486822,16213785
-1,1,4,119281458,121845311,2563853
-1,1,4,126039775,133694234,7654459
1,1,4,126354098,186683041,60328943
1,-1,4,129778026,129905056,127030
1,-1,4,129785683,129857992,72309
1,-1,4,131966420,132330721,364301
1,-1,4,131966420,132330721,364301
-1,-1,4,132288191,132451729,163538
-1,-1,4,132755488,133091760,336272
1,1,4,132906408,190828225,57921817
-1,-1,4,134943036,135180310,237274
-1,-1,4,134943236,135180169,236933
1,1,4,135856771,190957473,55100702
-1,-1,4,138104885,138181367,76482
-1,-1,4,138727743,139163316,435573
1,1,4,139431686,190828225,51396539
1,-1,4,143086405,143195842,109437
-1,1,4,144509997,149435179,4925182
-1,1,4,144659362,146791626,2132264
1,-1,4,144782893,145301546,518653
1,1,4,145963820,190828225,44864405
-1,1,4,149277637,149669181,391544
-1,-1,4,150070565,150173256,102691
-1,1,4,153203431,162912359,9708928
1,1,4,153890440,190957473,37067033
-1,1,4,156084134,171880704,15796570
1,1,4,156465633,190957473,34491840
1,1,4,159309080,167766877,8457797
1,1,4,161678851,191012562,29333711
-1,1,4,162205710,182329883,20124173
1,-1,4,165876480,165879671,3191
1,-1,4,165876480,165879671,3191
1,-1,4,165876480,165879671,3191
1,-1,4,165876480,165879671,3191
1,-1,4,165876480,165879671,3191
1,-1,4,165876480,165879671,3191
1,-1,4,165876480,165879671,3191
1,-1,4,165876480,165879671,3191
1,-1,4,165876480,165879671,3191
1,-1,4,165876480,165879671,3191
1,-1,4,165876480,165879671,3191
1,-1,4,165876480,165879671,3191
1,-1,4,165876480,165879671,3191
1,-1,4,165876480,165879671,3191
1,-1,4,165876480,165879671,3191
1,-1,4,165876480,165879671,3191
1,-1,4,165876480,165879671,3191
1,-1,4,165876480,165879671,3191
1,-1,4,165876480,165879671,3191
1,-1,4,165876480,165879671,3191
1,-1,4,165876480,165879671,3191
1,-1,4,165876480,165889702,13222
1,-1,4,165876480,165889702,13222
1,-1,4,165876480,165889702,13222
1,-1,4,165879671,166171638,291967
-1,1,4,166202188,190939340,24737152
1,1,4,166436844,190957473,24520629
1,1,4,166735148,190957473,24222325
-1,1,4,167238739,190828225,23589486
-1,1,4,167413365,190957473,23544108
-1,1,4,167551358,180742113,13190755
-1,1,4,168294867,190957473,22662606
1,-1,4,168321293,168477137,155844
-1,-1,4,168681147,168831927,150780
-1,-1,4,168831927,168977531,145604
-1,-1,4,168831927,168977531,145604
-1,-1,4,168831927,168977531,145604
-1,-1,4,168831927,168977531,145604
1,1,4,169040468,190828225,21787757
1,1,4,169242739,190512479,21269740
-1,1,4,169891551,187857892,17966341
-1,1,4,170794659,190939340,20144681
-1,1,4,171820275,190957473,19137198
-1,1,4,173422525,190828225,17405700
1,1,4,174655220,174742050,86830
-1,1,4,174775711,190469337,15693626
-1,1,4,174910180,190828225,15918045
-1,1,4,175071334,189180209,14108875
-1,1,4,175550289,190838582,15288293
-1,1,4,175550289,190957473,15407184
-1,1,4,175749001,190957473,15208472
1,1,4,176306103,190957473,14651370
-1,-1,4,178267221,178501048,233827
-1,1,4,178907110,190828225,11921115
-1,1,4,178935724,190828225,11892501
-1,1,4,179470626,190828225,11357599
1,1,4,180216665,190957473,10740808
1,1,4,180702769,190957473,10254704
-1,-1,4,181224542,181927559,703017
-1,1,4,181496115,190828225,9332110
-1,1,4,181547444,190790911,9243467
1,1,4,181639003,190828225,9189222
-1,1,4,182500779,187021353,4520574
-1,1,4,182500779,187021353,4520574
-1,1,4,183358244,190939340,7581096
-1,1,4,183993896,190828225,6834329
-1,1,4,185160684,190828225,5667541
1,1,4,185248234,190828225,5579991
1,1,4,185248234,190828225,5579991
-1,1,4,185253508,190713591,5460083
1,1,4,185328126,189836692,4508566
-1,1,4,185353135,190790911,5437776
-1,1,4,185381293,190957473,5576180
1,1,4,185845419,187499543,1654124
-1,1,4,186252440,190713591,4461151
1,-1,4,186638639,186659293,20654
-1,1,4,186958290,187192748,234458
-1,1,4,187108903,190722107,3613204
1,-1,4,187210595,187476383,265788
1,-1,4,187367725,187476383,108658
1,-1,4,187367725,187476383,108658
1,-1,4,187367725,187476383,108658
1,-1,4,187367725,187476383,108658
1,-1,4,187367725,187476383,108658
1,-1,4,187367725,187476383,108658
-1,1,4,187546424,190939340,3392916
1,-1,4,188105977,189786913,1680936
1,-1,4,188191879,189374480,1182601
1,-1,4,188462395,189036166,573771
1,-1,4,188462395,189036166,573771
1,-1,4,188462395,189036166,573771
1,-1,4,188462395,189036166,573771
1,-1,4,188511040,189036294,525254
1,-1,4,188511040,189036294,525254
1,-1,4,188511081,188810990,299909
1,-1,4,188511081,188810990,299909
1,-1,4,188590472,189508371,917899
1,-1,4,188590472,189508371,917899
1,-1,4,189012426,189180135,167709
1,-1,4,189180150,189644372,464222
1,-1,4,189247673,189435216,187543
-1,-1,4,189407830,189968308,560478
1,-1,4,189703193,189914227,211034
1,-1,4,189703193,189914227,211034
1,-1,4,189786628,189948946,162318
1,-1,4,189836620,190713599,876979
1,-1,4,189836633,190092994,256361
1,-1,4,189836692,190092994,256302
-1,-1,4,189897659,190469515,571856
-1,-1,4,189897659,190828225,930566
-1,1,4,189914168,190828225,914057
-1,-1,4,189968268,190713599,745331
1,-1,4,189968268,190348253,379985
-1,-1,4,190027826,190469515,441689
-1,-1,4,190032372,190828225,795853
-1,-1,4,190032372,190828225,795853
1,-1,4,190079238,190159449,80211
1,-1,4,190079238,190159449,80211
-1,-1,4,190085170,190713650,628480
-1,-1,4,190217377,190469515,252138
1,-1,4,190226013,190439714,213701
1,-1,4,190245201,190309240,64039
1,-1,4,190245201,190309240,64039
1,-1,4,190245201,190309240,64039
1,-1,4,190245201,190309240,64039
1,-1,4,190245201,190309240,64039
-1,-1,4,190348193,190747563,399370
1,-1,4,190469456,190828225,358769
-1,1,4,190509807,190957473,447666
-1,-1,4,190533611,190747613,214002
-1,1,4,190713591,190828225,114634
1,-1,4,190874457,190943374,68917
1,-1,4,190943374,191012562,69188
-1,-1,5,22149,52245,30096
1,-1,5,22149,83274,61125
1,-1,5,22149,83274,61125
1,-1,5,22149,83274,61125
1,-1,5,22149,83274,61125
1,-1,5,22149,86366,64217
-1,-1,5,22149,120415,98266
1,-1,5,22149,163401,141252
1,-1,5,22149,167219,145070
-1,1,5,22149,1429714,1407565
1,1,5,22149,1659250,1637101
1,1,5,22149,2324057,2301908
-1,1,5,22149,2965987,2943838
-1,1,5,22149,4163847,4141698
-1,1,5,22149,4260264,4238115
-1,1,5,22149,4641409,4619260
-1,1,5,22149,4833739,4811590
-1,1,5,22149,5060009,5037860
-1,1,5,22149,5102699,5080550
-1,1,5,22149,6060215,6038066
-1,1,5,22149,6112711,6090562
-1,1,5,22149,6500967,6478818
-1,1,5,22149,9958240,9936091
1,1,5,22149,10293118,10270969
-1,1,5,22149,11429370,11407221
-1,1,5,22149,11530503,11508354
-1,1,5,22149,12820111,12797962
1,1,5,22149,15851485,15829336
-1,1,5,22149,16584684,16562535
-1,1,5,22149,16930125,16907976
-1,1,5,22149,17788806,17766657
-1,1,5,22149,21217229,21195080
-1,1,5,22149,21726469,21704320
-1,1,5,22149,22775404,22753255
1,1,5,22149,23607162,23585013
-1,1,5,22149,24835567,24813418
-1,1,5,22149,25699714,25677565
-1,1,5,22149,26594000,26571851
-1,1,5,22149,27188057,27165908
-1,1,5,22149,27485726,27463577
-1,1,5,22149,27485726,27463577
-1,1,5,22149,27611270,27589121
-1,1,5,22149,27788723,27766574
1,1,5,22149,28075213,28053064
-1,1,5,22149,28429348,28407199
-1,1,5,22149,28589299,28567150
-1,1,5,22149,32248116,32225967
1,1,5,22149,33418294,33396145
-1,1,5,22149,34041196,34019047
-1,1,5,22149,35831640,35809491
1,1,5,22149,73708550,73686401
1,-1,5,50093,83274,33181
1,-1,5,50093,83274,33181
-1,1,5,50093,15678560,15628467
-1,1,5,50093,15678560,15628467
-1,1,5,50093,30112642,30062549
1,1,5,50093,46115086,46064993
1,-1,5,52186,151737,99551
1,-1,5,71904,113885,41981
1,-1,5,71904,113885,41981
1,-1,5,71904,116862,44958
1,-1,5,71904,116862,44958
1,-1,5,71904,138446,66542
1,-1,5,71913,116846,44933
1,-1,5,71913,116846,44933
1,-1,5,71913,116846,44933
1,-1,5,79146,138446,59300
1,-1,5,79146,182568,103422
-1,1,5,79146,22152284,22073138
-1,-1,5,90224,138412,48188
-1,1,5,95243,5834664,5739421
1,-1,5,100354,182681,82327
-1,1,5,113576,4175855,4062279
-1,1,5,113576,5380741,5267165
-1,1,5,113576,6244090,6130514
-1,1,5,113576,6737134,6623558
-1,1,5,113576,8876045,8762469
-1,1,5,113576,10163809,10050233
-1,1,5,113576,10729838,10616262
1,1,5,113576,14238330,14124754
-1,1,5,113576,14684471,14570895
-1,1,5,113576,15291661,15178085
-1,1,5,113576,16854340,16740764
-1,1,5,113576,17334977,17221401
1,1,5,113576,20240392,20126816
-1,1,5,113576,21786246,21672670
-1,1,5,113576,23047959,22934383
-1,1,5,113576,23147737,23034161
-1,1,5,113576,25091472,24977896
-1,1,5,113576,25948451,25834875
-1,1,5,113576,26234903,26121327
-1,1,5,113576,26948599,26835023
-1,1,5,113576,27338567,27224991
1,1,5,113576,30279389,30165813
-1,1,5,113576,33493797,33380221
-1,1,5,113576,33998394,33884818
-1,1,5,113576,34372083,34258507
1,1,5,113577,180719789,180606212
1,1,5,113577,180719789,180606212
1,1,5,149372,7883578,7734206
1,-1,5,167219,204849,37630
1,-1,5,220428,470621,250193
1,-1,5,220428,470621,250193
1,-1,5,234160,292679,58519
-1,-1,5,314910,496182,181272
1,-1,5,346277,404721,58444
1,-1,5,369870,574895,205025
1,-1,5,470562,496182,25620
1,-1,5,554274,607624,53350
1,-1,5,554274,607624,53350
1,-1,5,560768,599121,38353
1,-1,5,560768,599121,38353
1,-1,5,560768,599121,38353
1,-1,5,560768,667623,106855
-1,-1,5,574904,759228,184324
1,-1,5,629255,820616,191361
1,-1,5,629255,820616,191361
1,-1,5,629255,820616,191361
1,-1,5,629255,820616,191361
1,-1,5,629455,820475,191020
-1,-1,5,629455,820475,191020
1,-1,5,648152,820475,172323
-1,-1,5,692881,773074,80193
1,-1,5,692881,795774,102893
1,-1,5,710494,820475,109981
1,-1,5,710494,820475,109981
1,-1,5,710494,820475,109981
1,-1,5,710494,820475,109981
1,-1,5,710494,820475,109981
-1,-1,5,710494,890017,179523
-1,-1,5,710494,890017,179523
1,-1,5,710524,795774,85250
1,-1,5,759199,820446,61247
-1,-1,5,795774,821908,26134
1,-1,5,890085,1079592,189507
-1,-1,5,981535,1021681,40146
-1,-1,5,1050550,1087475,36925
1,1,5,1544400,8681553,7137153
1,-1,5,1556938,1755372,198434
1,-1,5,2749039,2753361,4322
1,-1,5,2749039,2755084,6045
1,-1,5,2749039,2755084,6045
-1,1,5,2886277,7108408,4222131
1,1,5,3159498,30585683,27426185
1,1,5,4849611,36818821,31969210
-1,1,5,4932820,18465470,13532650
1,-1,5,7422161,7449338,27177
-1,1,5,7671046,13624106,5953060
-1,1,5,7806183,31019599,23213416
-1,1,5,8824418,14246208,5421790
-1,1,5,9120813,24274030,15153217
-1,1,5,9120813,24274030,15153217
1,1,5,10212992,16770583,6557591
-1,1,5,11815205,21494542,9679337
-1,-1,5,12404457,12902472,498015
-1,-1,5,12404457,12902472,498015
-1,1,5,12572675,17966097,5393422
1,-1,5,12820052,13030604,210552
1,-1,5,13802308,14153561,351253
1,-1,5,13802308,14153561,351253
1,-1,5,13802308,14153561,351253
1,-1,5,13802308,14153561,351253
1,-1,5,13830669,14153561,322892
1,-1,5,13830669,14153561,322892
1,-1,5,13830669,14153561,322892
1,-1,5,13830669,14190872,360203
1,-1,5,13847044,14246208,399164
-1,1,5,17628741,176575720,158946979
-1,-1,5,18379231,26804015,8424784
-1,-1,5,20474748,20674100,199352
-1,-1,5,20474748,20711990,237242
1,-1,5,21288794,21377276,88482
1,-1,5,21288794,21377276,88482
1,-1,5,21288794,21377276,88482
1,-1,5,21351834,21377276,25442
-1,-1,5,21402939,21527562,124623
1,-1,5,21527621,21726410,198789
-1,-1,5,21872141,22156646,284505
1,1,5,25801684,27125454,1323770
1,1,5,31208860,32173350,964490
1,-1,5,32110734,32149723,38989
1,-1,5,32110734,32149723,38989
1,-1,5,32110734,32149723,38989
1,-1,5,32110734,32149723,38989
-1,-1,5,33120488,33282372,161884
1,1,5,35201661,61198968,25997307
-1,1,5,36916860,36960223,43363
-1,1,5,36916860,36960224,43364
-1,1,5,36926004,37242249,316245
-1,1,5,41902086,42896162,994076
-1,-1,5,42804840,43067088,262248
-1,-1,5,45858833,45880709,21876
-1,-1,5,45858833,45880709,21876
-1,-1,5,45858833,45880709,21876
1,-1,5,45935369,46055437,120068
-1,-1,5,53092696,53284566,191870
1,1,5,56243677,61021228,4777551
-1,-1,5,58962510,59388525,426015
-1,1,5,59794904,63223610,3428706
-1,1,5,59794904,63223610,3428706
-1,1,5,60180775,60428760,247985
-1,1,5,60722469,70792199,10069730
-1,-1,5,63640694,63666372,25678
-1,-1,5,68791270,70328742,1537472
-1,-1,5,68828320,69170815,342495
-1,-1,5,68828320,70647478,1819158
-1,-1,5,68828320,70647478,1819158
-1,-1,5,68849603,69170815,321212
1,-1,5,68935901,69691667,755766
-1,-1,5,68849603,69691667,842064
1,-1,5,68935901,69866583,930682
1,-1,5,68935901,69866583,930682
1,-1,5,68935901,70079377,1143476
1,-1,5,68935901,70079377,1143476
1,-1,5,68935901,70316732,1380831
1,-1,5,68935901,70316732,1380831
1,-1,5,68935901,70316732,1380831
1,-1,5,68849603,70471774,1622171
-1,-1,5,68849603,70489434,1639831
1,-1,5,68935901,70498111,1562210
1,-1,5,68935901,70498111,1562210
1,-1,5,68935901,70498111,1562210
1,-1,5,68935901,70498111,1562210
1,-1,5,68935901,70498111,1562210
1,-1,5,68935901,70498111,1562210
1,-1,5,68935901,70498111,1562210
1,-1,5,68935901,70498111,1562210
1,-1,5,68935901,70498111,1562210
1,-1,5,68935901,70498111,1562210
1,-1,5,68935901,70498111,1562210
1,-1,5,68935901,70498111,1562210
1,-1,5,68935901,70498111,1562210
1,-1,5,68935901,70498111,1562210
1,-1,5,68935901,70498111,1562210
1,-1,5,68935901,70498111,1562210
1,-1,5,68935901,70498111,1562210
1,-1,5,68935901,70498111,1562210
1,-1,5,68935901,70498111,1562210
1,-1,5,68935901,70498111,1562210
1,-1,5,68935901,70498111,1562210
1,-1,5,68935901,70498111,1562210
1,-1,5,68935901,70498111,1562210
1,-1,5,68935901,70498111,1562210
1,-1,5,68935901,70498111,1562210
1,-1,5,68935901,70498111,1562210
1,-1,5,68935901,70498111,1562210
1,-1,5,68935901,70498111,1562210
1,-1,5,68935901,70498111,1562210
1,-1,5,68935901,70498111,1562210
1,-1,5,68935901,70498111,1562210
1,-1,5,68935901,70498111,1562210
1,-1,5,68935901,70498111,1562210
1,-1,5,68935901,70498111,1562210
1,-1,5,68935901,70498111,1562210
1,-1,5,68935901,70498111,1562210
1,-1,5,68935901,70498111,1562210
1,-1,5,68935901,70498111,1562210
1,-1,5,68935901,70498111,1562210
1,-1,5,68935901,70498111,1562210
1,-1,5,68935901,70498111,1562210
1,-1,5,68935901,70498111,1562210
1,-1,5,68935901,70498111,1562210
1,-1,5,68935901,70498111,1562210
1,-1,5,68935901,70498111,1562210
1,-1,5,68935901,70498111,1562210
1,-1,5,68935901,70498111,1562210
1,-1,5,68935901,70498111,1562210
1,-1,5,68935901,70498111,1562210
1,-1,5,68935901,70498111,1562210
1,-1,5,68935901,70498111,1562210
1,-1,5,68935901,70498111,1562210
1,-1,5,68935901,70498111,1562210
1,-1,5,68935901,70498111,1562210
1,-1,5,68935901,70498111,1562210
1,-1,5,68935901,70498111,1562210
1,-1,5,68935901,70498111,1562210
1,-1,5,68935901,70498111,1562210
1,-1,5,68935901,70498111,1562210
1,-1,5,68935901,70498111,1562210
1,-1,5,68935901,70498111,1562210
1,-1,5,68935901,70498111,1562210
1,-1,5,68935901,70498111,1562210
1,-1,5,68935901,70498111,1562210
1,-1,5,68935901,70498111,1562210
1,-1,5,68935901,70498111,1562210
1,-1,5,68935901,70498111,1562210
1,-1,5,68935901,70498111,1562210
1,-1,5,68935901,70498111,1562210
1,-1,5,68935901,70498111,1562210
1,-1,5,68935901,70498111,1562210
1,-1,5,68935901,70498111,1562210
1,-1,5,68935901,70498111,1562210
1,-1,5,68935901,70498111,1562210
1,-1,5,68935901,70498111,1562210
1,-1,5,68935901,70498111,1562210
1,-1,5,68935901,70498111,1562210
1,-1,5,68935901,70498111,1562210
1,-1,5,68935901,70498111,1562210
1,-1,5,68935901,70498111,1562210
1,-1,5,68935901,70498111,1562210
1,-1,5,68849603,70613325,1763722
1,-1,5,68849603,70643196,1793593
-1,-1,5,68849603,70647478,1797875
1,-1,5,68849603,70647478,1797875
-1,-1,5,68849603,70647478,1797875
1,-1,5,68849603,70647478,1797875
-1,-1,5,68849603,70647478,1797875
1,-1,5,68849603,70647478,1797875
-1,-1,5,68849603,70647478,1797875
1,-1,5,68849603,70647478,1797875
1,-1,5,68849603,70647478,1797875
-1,-1,5,68849603,70647478,1797875
-1,-1,5,68849603,70647478,1797875
-1,-1,5,68849603,70647478,1797875
1,-1,5,68849603,70647478,1797875
1,-1,5,68849603,70647478,1797875
1,-1,5,68849603,70647478,1797875
1,-1,5,68849603,70657769,1808166
1,-1,5,68849603,70657769,1808166
1,-1,5,68849603,70657769,1808166
1,-1,5,68849603,70657769,1808166
1,-1,5,68849603,70657769,1808166
1,-1,5,68849603,70657769,1808166
1,-1,5,68849603,70657769,1808166
1,-1,5,68849603,70657769,1808166
1,-1,5,68849603,70657769,1808166
1,-1,5,68849603,70657769,1808166
-1,-1,5,68849603,70613325,1763722
-1,-1,5,68864176,70647478,1783302
1,-1,5,68864176,70647478,1783302
1,-1,5,68864176,70647478,1783302
-1,-1,5,68864176,70647478,1783302
1,-1,5,68864176,70647478,1783302
1,-1,5,68864176,70647478,1783302
1,-1,5,68864176,70657769,1793593
1,-1,5,68864176,70657769,1793593
1,-1,5,68864176,70657769,1793593
1,-1,5,68864176,70657769,1793593
1,-1,5,68864176,70657769,1793593
1,-1,5,68864176,70657769,1793593
1,-1,5,68864176,70657769,1793593
1,-1,5,68878234,70657769,1779535
1,-1,5,68878234,70657769,1779535
1,-1,5,68878234,70657769,1779535
1,-1,5,68878234,70657769,1779535
1,-1,5,68878234,70657769,1779535
1,-1,5,68878234,70657769,1779535
1,-1,5,68878234,70657769,1779535
1,-1,5,68890454,70134637,1244183
1,-1,5,68890454,70657769,1767315
1,-1,5,68890454,70657769,1767315
1,-1,5,68902781,69691667,788886
1,-1,5,68902781,69705635,802854
1,-1,5,68902781,70134637,1231856
1,-1,5,68902781,70643196,1740415
1,-1,5,68902781,70647478,1744697
1,-1,5,68902781,70647478,1744697
1,-1,5,68914355,69691667,777312
1,-1,5,68914355,69691667,777312
1,-1,5,68914355,69705635,791280
1,-1,5,68914355,69705635,791280
1,-1,5,68914355,70134637,1220282
1,-1,5,68914355,70209495,1295140
1,-1,5,68914355,70268219,1353864
-1,-1,5,68914355,70280668,1366313
1,-1,5,68914355,70316732,1402377
1,-1,5,68914355,70657769,1743414
1,-1,5,68914355,70657769,1743414
1,-1,5,68935901,70268219,1332318
-1,-1,5,68935930,70613129,1677199
-1,-1,5,68935930,70613129,1677199
-1,-1,5,68935930,70613129,1677199
-1,-1,5,68935930,70613129,1677199
1,-1,5,69079437,69866583,787146
1,-1,5,69079437,69866583,787146
1,-1,5,69079437,69866583,787146
1,-1,5,69079437,69866583,787146
1,-1,5,69079437,69866583,787146
1,-1,5,69079437,69866583,787146
1,-1,5,69079437,69866583,787146
1,-1,5,69079437,69866583,787146
1,-1,5,69079437,69866583,787146
-1,-1,5,69079437,69866583,787146
1,-1,5,69079437,69866583,787146
1,-1,5,69079437,69866583,787146
1,-1,5,69079437,69866583,787146
1,-1,5,69079437,69866583,787146
1,-1,5,69079437,69866583,787146
1,-1,5,69079437,69866583,787146
1,-1,5,69079437,69866583,787146
1,-1,5,69079437,69866583,787146
-1,-1,5,69079437,69866583,787146
-1,-1,5,69079437,69866583,787146
1,-1,5,69079437,69866583,787146
1,-1,5,69079437,69866583,787146
1,-1,5,69079437,69866583,787146
-1,-1,5,69079437,69866583,787146
1,-1,5,69079437,69866583,787146
1,-1,5,69079437,69866583,787146
1,-1,5,69079437,69866583,787146
1,-1,5,69079437,69866583,787146
1,-1,5,69079437,69866583,787146
1,-1,5,69079437,69866583,787146
-1,-1,5,69079437,69866583,787146
1,-1,5,69079437,69866583,787146
1,-1,5,69079437,69866583,787146
1,-1,5,69079437,69866583,787146
1,-1,5,69079437,69866583,787146
1,-1,5,69079437,70079377,999940
1,-1,5,69079437,70316732,1237295
1,-1,5,69079437,70316732,1237295
1,-1,5,69079437,70316732,1237295
1,-1,5,69079437,70316732,1237295
1,-1,5,69079437,70316732,1237295
1,-1,5,69079437,70316732,1237295
1,-1,5,69079437,70316732,1237295
1,-1,5,69079437,70316732,1237295
1,-1,5,69079437,70316732,1237295
1,-1,5,69079437,70316732,1237295
1,-1,5,69079437,70316732,1237295
1,-1,5,69079437,70316732,1237295
1,-1,5,69079437,70316732,1237295
1,-1,5,69079437,70316732,1237295
1,-1,5,69079437,70316732,1237295
1,-1,5,69079437,70498111,1418674
1,-1,5,69079437,70498111,1418674
1,-1,5,69079437,70498111,1418674
1,-1,5,69079437,70498111,1418674
-1,-1,5,69079437,70498111,1418674
1,-1,5,69079437,70498111,1418674
1,-1,5,69079437,70498111,1418674
1,-1,5,69079437,70498111,1418674
1,-1,5,68975303,70046728,1071425
1,-1,5,68975303,70134637,1159334
-1,-1,5,68975303,70647478,1672175
1,-1,5,68975303,70657769,1682466
1,-1,5,68975303,70657769,1682466
1,-1,5,68975303,70657769,1682466
1,-1,5,68975303,70657769,1682466
1,-1,5,68975309,70489473,1514164
-1,-1,5,68975309,70613129,1637820
-1,-1,5,68975309,70613129,1637820
-1,-1,5,68975309,70613129,1637820
-1,-1,5,69204240,69515709,311469
-1,-1,5,69220692,69439654,218962
-1,-1,5,69220692,69463214,242522
-1,-1,5,69220692,69463214,242522
-1,-1,5,69220692,69463214,242522
-1,-1,5,69220692,69463214,242522
-1,-1,5,69220692,69463214,242522
-1,-1,5,69220692,69463214,242522
-1,-1,5,69220692,69483792,263100
-1,-1,5,69220692,69463228,242536
-1,-1,5,69238677,70247802,1009125
-1,-1,5,69238677,70247802,1009125
-1,-1,5,69238677,70247802,1009125
1,-1,5,69238677,70247802,1009125
-1,-1,5,69238677,70247802,1009125
-1,-1,5,69238677,70328742,1090065
-1,-1,5,69238677,70328742,1090065
1,-1,5,69238677,70328742,1090065
-1,-1,5,69238677,70386600,1147923
-1,-1,5,69238677,70386600,1147923
1,-1,5,69238677,70386600,1147923
-1,-1,5,69238677,70386600,1147923
-1,-1,5,69238677,70386600,1147923
1,-1,5,69238677,70386600,1147923
-1,-1,5,69238677,70587018,1348341
-1,-1,5,69238677,70587018,1348341
-1,-1,5,69238677,70587018,1348341
-1,-1,5,69238677,70587018,1348341
1,-1,5,69238677,70587018,1348341
-1,-1,5,69238677,70587018,1348341
-1,-1,5,69238677,70587018,1348341
-1,-1,5,69238677,70587018,1348341
-1,-1,5,69238677,70587018,1348341
-1,-1,5,69238677,70587018,1348341
-1,-1,5,69238677,70587018,1348341
-1,-1,5,69238677,70587018,1348341
-1,-1,5,69238677,70587018,1348341
-1,-1,5,69238677,70587018,1348341
-1,-1,5,69238677,70587018,1348341
-1,-1,5,69238677,70587018,1348341
-1,-1,5,69238677,70587018,1348341
-1,-1,5,69238677,70587018,1348341
-1,-1,5,69238689,69483826,245137
1,-1,5,69238689,69925315,686626
-1,-1,5,69238689,70247828,1009139
-1,-1,5,69238689,70247828,1009139
-1,-1,5,69238689,70328742,1090053
1,-1,5,69238689,70328742,1090053
-1,-1,5,69238689,70328742,1090053
-1,-1,5,69238689,70328742,1090053
-1,-1,5,69238689,70328742,1090053
-1,-1,5,69238689,70328742,1090053
-1,-1,5,69238689,70328742,1090053
1,-1,5,69238689,70328742,1090053
-1,-1,5,69238689,70328742,1090053
1,-1,5,69238689,70328742,1090053
-1,-1,5,69238689,70328742,1090053
1,-1,5,69238689,70328742,1090053
-1,-1,5,69238689,70328742,1090053
-1,-1,5,69238689,70328742,1090053
1,-1,5,69238689,70328742,1090053
1,-1,5,69238689,70386594,1147905
1,-1,5,69238689,70386594,1147905
1,-1,5,69238689,70386594,1147905
1,-1,5,69238689,70386594,1147905
-1,-1,5,69238689,70386594,1147905
1,-1,5,69238689,70386594,1147905
1,-1,5,69238689,70386594,1147905
1,-1,5,69238689,70386594,1147905
1,-1,5,69238689,70386594,1147905
1,-1,5,69238689,70386594,1147905
-1,-1,5,69238689,70386594,1147905
-1,-1,5,69238689,70587019,1348330
-1,-1,5,69238689,70587019,1348330
-1,-1,5,69238689,70587019,1348330
1,-1,5,69238689,70587019,1348330
-1,-1,5,69238689,70587019,1348330
-1,-1,5,69238689,70587019,1348330
1,-1,5,69238689,70587019,1348330
-1,-1,5,69238689,70587019,1348330
-1,-1,5,69238689,70587019,1348330
-1,-1,5,69238689,70587019,1348330
-1,-1,5,69238689,70587019,1348330
-1,-1,5,69238689,70587019,1348330
-1,-1,5,69238689,70587019,1348330
1,-1,5,69238689,70587019,1348330
1,-1,5,69238689,70587019,1348330
-1,-1,5,69238689,70587019,1348330
1,-1,5,69238689,70587019,1348330
-1,-1,5,69238689,70587019,1348330
-1,-1,5,69238689,70587019,1348330
-1,-1,5,69238689,70587019,1348330
-1,-1,5,69238689,70587019,1348330
-1,-1,5,69238689,70587019,1348330
-1,-1,5,69238689,70587019,1348330
-1,-1,5,69238689,70587019,1348330
-1,-1,5,69238689,70587019,1348330
-1,-1,5,69238689,70587019,1348330
-1,-1,5,69238689,70587019,1348330
-1,-1,5,69238689,70587019,1348330
-1,-1,5,69238689,70587019,1348330
-1,-1,5,69238689,70587019,1348330
-1,-1,5,69238689,70587019,1348330
-1,-1,5,69238689,70587019,1348330
1,-1,5,69238689,70587019,1348330
-1,-1,5,69238689,70587019,1348330
-1,-1,5,69238689,70587019,1348330
-1,-1,5,69238689,70587019,1348330
-1,-1,5,69238689,70587019,1348330
-1,-1,5,69238689,70587019,1348330
-1,-1,5,69238689,70587019,1348330
-1,-1,5,69238689,70587019,1348330
-1,-1,5,69238689,70587019,1348330
-1,-1,5,69238689,70587019,1348330
-1,-1,5,69238689,70587019,1348330
1,-1,5,69238689,70587019,1348330
1,-1,5,69483733,70316732,832999
-1,-1,5,69372450,70328742,956292
-1,-1,5,69372450,70328742,956292
-1,-1,5,69372450,70328742,956292
-1,-1,5,69372450,70328742,956292
1,-1,5,69372450,70386594,1014144
-1,-1,5,69372450,70587019,1214569
-1,-1,5,69372450,70587019,1214569
-1,-1,5,69372450,70587019,1214569
-1,-1,5,69372450,70587019,1214569
-1,-1,5,69372450,70587019,1214569
-1,-1,5,69372450,70587019,1214569
-1,-1,5,69372450,70587019,1214569
-1,-1,5,69372450,70587019,1214569
-1,-1,5,69372450,70587019,1214569
1,-1,5,69372472,70247802,875330
-1,-1,5,69372472,70247802,875330
-1,-1,5,69372472,70386600,1014128
1,-1,5,69372472,70587018,1214546
1,-1,5,69372472,70587018,1214546
1,-1,5,69426275,70134637,708362
1,-1,5,69426275,70134637,708362
1,-1,5,69426275,70134637,708362
1,-1,5,69426275,70134637,708362
-1,-1,5,69426278,70309826,883548
1,-1,5,69439595,70134637,695042
1,-1,5,69439595,70134637,695042
1,-1,5,69691608,70498111,806503
1,-1,5,69691608,70498111,806503
1,-1,5,69691608,70498111,806503
1,-1,5,69691608,70498111,806503
-1,-1,5,69555040,70046728,491688
1,-1,5,69555040,70388845,833805
-1,-1,5,69600758,70046728,445970
1,-1,5,69705592,70386571,680979
1,-1,5,69732162,70386594,654432
1,-1,5,69732162,70587019,854857
-1,-1,5,69732192,70587018,854826
-1,-1,5,69732192,70587018,854826
-1,-1,5,69732192,70587018,854826
-1,-1,5,69732192,70587018,854826
1,-1,5,69732192,70587018,854826
-1,-1,5,69732192,70587018,854826
-1,-1,5,69732192,70587018,854826
-1,-1,5,69732192,70587018,854826
-1,-1,5,69732192,70587018,854826
-1,-1,5,69732192,70587018,854826
-1,-1,5,69732192,70587018,854826
-1,-1,5,69732192,70587018,854826
-1,-1,5,69732192,70587018,854826
1,-1,5,69757941,70268219,510278
-1,-1,5,69790756,70268219,477463
-1,-1,5,69790756,70280668,489912
1,-1,5,69790756,70316732,525976
-1,-1,5,69843658,70046728,203070
-1,-1,5,69843658,70046728,203070
-1,-1,5,69843658,70280668,437010
1,-1,5,69843629,70386600,542971
-1,-1,5,69843629,70587018,743389
-1,-1,5,69843651,70587019,743368
-1,-1,5,69843651,70587019,743368
-1,-1,5,69843651,70587019,743368
-1,-1,5,69843651,70587019,743368
-1,-1,5,69843651,70587019,743368
-1,-1,5,70079318,70280668,201350
-1,-1,5,70247769,70587019,339250
-1,-1,5,70369930,70388814,18884
-1,-1,5,70369930,70657718,287788
-1,-1,5,70386570,70663068,276498
-1,-1,5,83780847,83899398,118551
-1,1,5,83899398,110770779,26871381
1,-1,5,84770220,85460511,690291
-1,1,5,85078722,89276707,4197985
-1,-1,5,85261873,85338858,76985
-1,1,5,85954428,86904060,949632
-1,1,5,86062776,91444662,5381886
-1,1,5,86254118,86777028,522910
-1,1,5,86487715,89253266,2765551
-1,1,5,86530415,88893604,2363189
1,1,5,87493549,92528869,5035320
-1,1,5,87664106,91698938,4034832
-1,1,5,87764485,90147447,2382962
-1,1,5,87999726,88137439,137713
-1,1,5,88039877,88045439,5562
-1,1,5,88062493,88104672,42179
-1,1,5,88062497,89028098,965601
-1,1,5,89670423,127412115,37741692
-1,1,5,90707525,130655256,39947731
-1,1,5,92235441,118949814,26714373
-1,1,5,92528810,112623492,20094682
-1,-1,5,96673541,96818093,144552
-1,-1,5,97051910,97077322,25412
-1,-1,5,97051910,97129673,77763
-1,-1,5,97051910,97129673,77763
-1,-1,5,97051910,97129673,77763
1,-1,5,99211169,99324697,113528
1,-1,5,100558510,100908238,349728
-1,1,5,100607918,125900735,25292817
-1,-1,5,101148890,101423754,274864
-1,-1,5,101794089,101834242,40153
-1,-1,5,104332410,104473254,140844
-1,-1,5,104473283,104583261,109978
1,-1,5,105021792,105810456,788664
1,-1,5,105392930,105522364,129434
-1,-1,5,105779167,105865777,86610
-1,1,5,105921779,112342282,6420503
-1,1,5,106337910,117361011,11023101
1,1,5,106716357,180687338,73970981
-1,1,5,107644164,125113490,17469326
-1,1,5,107920965,116150771,8229806
-1,-1,5,109626656,109941854,315198
-1,1,5,110023143,129439531,19416388
-1,1,5,110407606,122522885,12115279
-1,-1,5,110576011,110653209,77198
-1,1,5,110798714,126528730,15730016
-1,1,5,111659214,117109202,5449988
-1,1,5,112155137,113946731,1791594
-1,-1,5,113079086,113170149,91063
-1,1,5,114043258,125843436,11800178
1,-1,5,115508329,115533467,25138
-1,-1,5,115533467,115585253,51786
1,-1,5,119028921,119134844,105923
-1,-1,5,119354448,120770069,1415621
-1,-1,5,120158999,120256126,97127
-1,1,5,122442467,129980139,7537672
1,-1,5,124943170,125619664,676494
1,-1,5,124943170,125634960,691790
1,1,5,126002101,126341594,339493
1,1,5,126002101,126351612,349511
-1,1,5,126861666,135269155,8407489
-1,1,5,127770494,127822042,51548
1,-1,5,128770640,129098541,327901
1,1,5,129183487,152733106,23549619
1,1,5,130125085,157574910,27449825
-1,1,5,130962196,135150743,4188547
1,1,5,134632984,139485588,4852604
1,1,5,134632984,139485588,4852604
1,1,5,137172371,140075946,2903575
1,1,5,140469572,148910241,8440669
1,-1,5,140568025,140572033,4008
-1,-1,5,140570431,140572077,1646
1,-1,5,140581626,140589370,7744
1,-1,5,140581626,140589370,7744
1,-1,5,140581626,140593602,11976
-1,1,5,141113273,149154835,8041562
1,-1,5,142176123,142241875,65752
-1,-1,5,144027588,144238284,210696
-1,1,5,144576918,147921074,3344156
1,1,5,146540455,163262200,16721745
-1,1,5,149731885,149738613,6728
-1,1,5,151823430,165531397,13707967
1,1,5,156252523,180696806,24444283
-1,1,5,158368362,163813766,5445404
-1,1,5,161381034,161534024,152990
-1,1,5,161547032,161575610,28578
-1,1,5,161547033,161572618,25585
1,1,5,163813707,180696806,16883099
-1,1,5,164207156,172799124,8591968
1,1,5,164391372,180696806,16305434
1,-1,5,165287964,165847276,559312
1,1,5,168761759,180712302,11950543
1,1,5,171396359,180719789,9323430
1,1,5,172031248,180719789,8688541
1,-1,5,172085912,172116412,30500
1,1,5,172664775,176041619,3376844
-1,1,5,173376776,174327398,950622
-1,1,5,174151144,174169790,18646
-1,1,5,174427052,180719789,6292737
-1,1,5,174963774,180719789,5756015
-1,1,5,175416095,177436413,2020318
-1,1,5,175438045,177392885,1954840
-1,1,5,175559343,177422760,1863417
-1,1,5,175570677,177436413,1865736
1,1,5,175570677,177439550,1868873
-1,1,5,175570677,180719789,5149112
-1,1,5,175570678,177437340,1866662
-1,1,5,175601473,180100378,4498905
-1,1,5,175718841,178089700,2370859
1,1,5,175722788,177423091,1700303
-1,1,5,175944340,177136290,1191950
-1,1,5,176127129,180696806,4569677
-1,1,5,176274007,180719789,4445782
1,1,5,176390551,176879528,488977
-1,1,5,176505173,178230923,1725750
-1,1,5,176666707,176718909,52202
1,1,5,178228725,180678091,2449366
1,-1,5,178567431,178835508,268077
1,-1,5,178769471,178933407,163936
1,-1,5,178769471,178933407,163936
1,1,5,179309535,180719789,1410254
1,-1,5,180008319,180273638,265319
1,-1,5,180177527,180191645,14118
1,-1,5,180191645,180286067,94422
1,-1,5,180432453,180474868,42415
1,-1,5,180467222,180487246,20024
-1,-1,5,180552331,180567133,14802
1,-1,5,180576812,180604344,27532
1,-1,5,180724243,180751873,27630
1,-1,5,180724243,180751873,27630
1,-1,5,180765809,180875621,109812
1,-1,5,180765809,180890113,124304
-1,-1,5,180783055,180825790,42735
1,-1,5,180783055,180825790,42735
1,-1,5,180783055,180875621,92566
1,-1,5,180809804,180875621,65817
1,-1,5,180821959,180875621,53662
-1,-1,5,180835713,180904634,68921
1,-1,5,180852761,180875621,22860
-1,1,6,60523,1768235,1707712
-1,1,6,152634,5315912,5163278
-1,1,6,152634,6027780,5875146
-1,1,6,152634,6290037,6137403
1,1,6,152634,14417234,14264600
1,1,6,152634,15732394,15579760
-1,-1,6,152664,184808,32144
1,1,6,155807,17058645,16902838
-1,-1,6,156974,233750,76776
-1,1,6,156974,2030623,1873649
-1,1,6,156974,4907926,4750952
-1,1,6,156974,6417749,6260775
-1,1,6,156974,7122992,6966018
1,1,6,156974,8349511,8192537
-1,1,6,156974,13856156,13699182
1,1,6,156974,46757028,46600054
1,1,6,156975,170919482,170762507
1,1,6,156975,170919482,170762507
-1,-1,6,163083,184838,21755
1,-1,6,163083,293493,130410
1,-1,6,163083,307998,144915
1,1,6,163083,2029765,1866682
-1,1,6,163083,3459841,3296758
1,1,6,163083,9525729,9362646
1,-1,6,164360,293497,129137
1,1,6,164360,13340113,13175753
-1,1,6,170426,1622218,1451792
-1,1,6,195229,2117379,1922150
-1,-1,6,221768,339802,118034
-1,-1,6,229815,293493,63678
1,-1,6,241739,339797,98058
1,-1,6,253107,293497,40390
1,-1,6,253107,293782,40675
1,-1,6,255324,339797,84473
1,-1,6,255324,339797,84473
1,-1,6,255324,339797,84473
1,-1,6,255350,283860,28510
-1,-1,6,255380,366778,111398
1,-1,6,259318,279373,20055
1,-1,6,259318,283860,24542
1,-1,6,259318,289174,29856
-1,-1,6,259318,289174,29856
-1,-1,6,259318,289174,29856
1,-1,6,259318,289174,29856
1,-1,6,259318,289174,29856
1,-1,6,259318,289174,29856
1,-1,6,259318,289174,29856
1,-1,6,259318,289174,29856
1,-1,6,259318,289174,29856
1,-1,6,259318,289174,29856
1,-1,6,259318,289174,29856
1,-1,6,259318,289174,29856
-1,-1,6,259318,289174,29856
-1,-1,6,259318,293615,34297
-1,-1,6,259318,293615,34297
1,-1,6,259318,293615,34297
1,-1,6,259318,293615,34297
-1,-1,6,259318,293615,34297
-1,-1,6,259318,293615,34297
-1,-1,6,259318,293615,34297
1,-1,6,259318,293615,34297
1,-1,6,259318,296733,37415
1,-1,6,259318,296733,37415
1,-1,6,259318,301907,42589
-1,-1,6,259318,307998,48680
-1,-1,6,259318,307998,48680
-1,-1,6,259318,307998,48680
-1,-1,6,259318,339802,80484
-1,-1,6,259318,339802,80484
-1,-1,6,259318,339802,80484
-1,-1,6,259318,339802,80484
-1,-1,6,259318,339802,80484
-1,-1,6,259318,339802,80484
-1,-1,6,259318,339802,80484
-1,-1,6,259318,339802,80484
-1,-1,6,259318,339802,80484
1,-1,6,259318,339802,80484
-1,-1,6,259318,339802,80484
-1,-1,6,259318,339802,80484
1,-1,6,259318,339802,80484
-1,-1,6,259318,339802,80484
1,-1,6,259318,339802,80484
-1,-1,6,259318,339802,80484
-1,-1,6,259345,289144,29799
-1,-1,6,259345,293592,34247
1,-1,6,259345,296704,37359
-1,-1,6,259345,350238,90893
-1,-1,6,259345,366778,107433
-1,-1,6,259345,366778,107433
-1,-1,6,259528,293493,33965
-1,-1,6,259528,293493,33965
-1,-1,6,259528,293493,33965
-1,-1,6,259528,293493,33965
-1,-1,6,259528,293493,33965
-1,-1,6,259528,293493,33965
-1,-1,6,259528,293493,33965
1,-1,6,259528,293493,33965
-1,-1,6,259528,293493,33965
1,-1,6,259528,293493,33965
-1,-1,6,259528,293493,33965
-1,-1,6,259528,293493,33965
-1,-1,6,259528,293493,33965
-1,-1,6,259528,293493,33965
-1,-1,6,259528,293493,33965
-1,-1,6,259528,293493,33965
-1,-1,6,259528,293493,33965
-1,-1,6,259528,293493,33965
-1,-1,6,259528,293493,33965
-1,-1,6,259528,293493,33965
-1,-1,6,259528,293493,33965
1,-1,6,259528,293493,33965
-1,-1,6,259528,293493,33965
1,-1,6,259528,293493,33965
-1,-1,6,259528,293493,33965
1,-1,6,259528,293493,33965
1,-1,6,259528,293493,33965
-1,-1,6,259528,293493,33965
1,-1,6,259528,293493,33965
1,-1,6,259528,293493,33965
1,-1,6,259528,293493,33965
1,-1,6,259528,293493,33965
-1,-1,6,259528,293493,33965
1,-1,6,259528,293493,33965
1,-1,6,259528,293493,33965
-1,-1,6,259528,293493,33965
-1,-1,6,259528,293493,33965
-1,-1,6,259528,293493,33965
1,-1,6,259528,293493,33965
-1,-1,6,259528,293493,33965
1,-1,6,259528,293493,33965
-1,-1,6,259528,293493,33965
-1,-1,6,259528,293493,33965
-1,-1,6,259528,293493,33965
-1,-1,6,259528,293493,33965
-1,-1,6,259528,293493,33965
-1,-1,6,259528,293493,33965
-1,-1,6,259528,293493,33965
-1,-1,6,259528,293493,33965
1,-1,6,259528,293493,33965
1,-1,6,259528,293493,33965
1,-1,6,259528,293493,33965
-1,-1,6,259528,293493,33965
-1,-1,6,259528,293493,33965
1,-1,6,259528,293493,33965
-1,-1,6,259528,293493,33965
-1,-1,6,259528,293493,33965
-1,-1,6,259528,293493,33965
-1,-1,6,259528,293493,33965
-1,-1,6,259528,293493,33965
-1,-1,6,259528,293493,33965
1,-1,6,259528,293493,33965
-1,-1,6,259528,293493,33965
-1,-1,6,259528,293493,33965
-1,-1,6,259528,293493,33965
-1,-1,6,259528,293493,33965
1,-1,6,259528,293493,33965
1,-1,6,259528,293493,33965
1,-1,6,259528,293493,33965
1,-1,6,259528,293493,33965
-1,-1,6,259528,293493,33965
-1,-1,6,259528,293493,33965
-1,-1,6,259528,293493,33965
-1,-1,6,259528,293493,33965
-1,-1,6,259528,293493,33965
-1,-1,6,259528,293493,33965
1,-1,6,259528,293493,33965
-1,-1,6,259528,293493,33965
-1,-1,6,259528,293493,33965
1,-1,6,259528,293493,33965
1,-1,6,259528,293493,33965
1,-1,6,259528,293493,33965
1,-1,6,259528,293493,33965
-1,-1,6,259528,293493,33965
1,-1,6,259528,293493,33965
-1,-1,6,259528,293493,33965
-1,-1,6,259528,293493,33965
-1,-1,6,259528,293493,33965
1,-1,6,259528,293493,33965
-1,-1,6,259528,293493,33965
1,-1,6,259528,293493,33965
-1,-1,6,259528,293493,33965
-1,-1,6,259528,293493,33965
-1,-1,6,259528,293493,33965
-1,-1,6,259528,293493,33965
-1,-1,6,259528,293493,33965
-1,-1,6,259528,293493,33965
-1,-1,6,259528,293493,33965
-1,-1,6,259528,293493,33965
1,-1,6,259528,293493,33965
-1,-1,6,259528,293493,33965
-1,-1,6,259528,293493,33965
-1,-1,6,259528,293493,33965
-1,-1,6,259528,293493,33965
-1,-1,6,259528,293493,33965
-1,-1,6,259528,293493,33965
1,-1,6,259528,293493,33965
-1,-1,6,259528,293493,33965
-1,-1,6,259528,293493,33965
-1,-1,6,259528,293493,33965
1,-1,6,259528,293493,33965
-1,-1,6,259528,293493,33965
-1,-1,6,259528,293493,33965
-1,-1,6,259528,293493,33965
-1,-1,6,259528,293493,33965
-1,-1,6,259528,293493,33965
-1,-1,6,259528,293493,33965
-1,-1,6,259528,293493,33965
-1,-1,6,259528,293493,33965
-1,-1,6,259528,293493,33965
1,-1,6,259528,293493,33965
-1,-1,6,259528,293493,33965
-1,-1,6,259528,293493,33965
1,-1,6,259528,293493,33965
-1,-1,6,259528,293493,33965
1,-1,6,259528,293493,33965
-1,-1,6,259528,293493,33965
-1,-1,6,259528,293493,33965
1,-1,6,259528,293493,33965
-1,-1,6,259528,293493,33965
-1,-1,6,259528,293493,33965
1,-1,6,259528,293493,33965
-1,-1,6,259528,293493,33965
1,-1,6,259528,293493,33965
1,-1,6,259528,293493,33965
1,-1,6,259528,293493,33965
-1,-1,6,259528,293493,33965
-1,-1,6,259528,293493,33965
-1,-1,6,259528,293493,33965
-1,-1,6,259528,293493,33965
-1,-1,6,259528,293493,33965
-1,-1,6,259528,293493,33965
1,-1,6,259528,293493,33965
-1,-1,6,259528,293493,33965
-1,-1,6,259528,293493,33965
1,-1,6,259528,293493,33965
1,-1,6,259528,293493,33965
1,-1,6,259528,293493,33965
1,-1,6,259528,293493,33965
-1,-1,6,259528,293493,33965
1,-1,6,259528,293493,33965
-1,-1,6,259528,293493,33965
-1,-1,6,259528,293493,33965
-1,-1,6,259528,307998,48470
-1,-1,6,259528,307998,48470
-1,-1,6,259528,307998,48470
1,-1,6,259528,307998,48470
1,-1,6,259528,307998,48470
-1,-1,6,259528,307998,48470
-1,-1,6,259528,307998,48470
-1,-1,6,259528,307998,48470
-1,-1,6,259528,307998,48470
-1,-1,6,259528,307998,48470
-1,-1,6,259528,307998,48470
-1,-1,6,259528,307998,48470
-1,-1,6,259528,307998,48470
-1,-1,6,259528,307998,48470
-1,-1,6,259528,307998,48470
-1,-1,6,259528,307998,48470
-1,-1,6,259528,307998,48470
-1,-1,6,259528,307998,48470
-1,-1,6,259528,307998,48470
-1,-1,6,259528,307998,48470
-1,-1,6,259528,307998,48470
-1,-1,6,259528,307998,48470
-1,-1,6,259528,307998,48470
-1,-1,6,259528,307998,48470
-1,-1,6,259528,307998,48470
-1,-1,6,259528,307998,48470
-1,-1,6,259528,339802,80274
-1,-1,6,259528,339802,80274
-1,-1,6,259528,339802,80274
-1,-1,6,259528,339802,80274
-1,-1,6,259528,339802,80274
-1,-1,6,259528,339802,80274
-1,-1,6,259528,339802,80274
-1,-1,6,259528,339802,80274
-1,-1,6,259528,339802,80274
-1,-1,6,259528,339802,80274
-1,-1,6,259528,339802,80274
-1,-1,6,259528,339802,80274
1,-1,6,259528,339802,80274
-1,-1,6,259528,339802,80274
-1,-1,6,259528,339802,80274
-1,-1,6,259528,339802,80274
-1,-1,6,259528,339802,80274
-1,-1,6,259528,339802,80274
-1,-1,6,259528,339802,80274
-1,-1,6,259528,339802,80274
1,-1,6,259528,339802,80274
-1,-1,6,259528,339802,80274
-1,-1,6,259528,339802,80274
-1,-1,6,259528,339802,80274
-1,-1,6,259528,339802,80274
-1,-1,6,259528,339802,80274
-1,-1,6,259528,339802,80274
-1,-1,6,259528,339802,80274
-1,-1,6,259528,339802,80274
-1,-1,6,259528,339802,80274
-1,-1,6,259528,339802,80274
-1,-1,6,259528,339802,80274
-1,-1,6,259528,339802,80274
-1,-1,6,259528,339802,80274
-1,-1,6,259528,339802,80274
-1,-1,6,259528,339802,80274
-1,-1,6,259528,339802,80274
-1,-1,6,259528,339802,80274
-1,-1,6,259528,339802,80274
1,-1,6,259528,339802,80274
-1,-1,6,259528,339802,80274
-1,-1,6,259528,339802,80274
-1,-1,6,259528,339802,80274
-1,-1,6,259528,339802,80274
1,-1,6,259528,339802,80274
1,-1,6,259528,339802,80274
-1,-1,6,259528,339802,80274
1,-1,6,259528,339802,80274
-1,-1,6,259528,339802,80274
-1,-1,6,259528,339802,80274
-1,-1,6,259528,339802,80274
-1,-1,6,259528,339802,80274
1,-1,6,259528,339802,80274
-1,-1,6,259528,339802,80274
1,-1,6,259528,339802,80274
-1,-1,6,259528,339802,80274
-1,-1,6,259528,339802,80274
-1,-1,6,259528,339802,80274
-1,-1,6,259528,339802,80274
1,-1,6,259528,339802,80274
-1,-1,6,259528,339802,80274
-1,-1,6,259528,339802,80274
-1,-1,6,259528,339802,80274
-1,-1,6,259528,339802,80274
1,-1,6,259528,339802,80274
-1,-1,6,259528,339802,80274
-1,-1,6,259528,339802,80274
-1,-1,6,259528,339802,80274
-1,-1,6,259528,339802,80274
-1,-1,6,259528,339802,80274
-1,-1,6,259528,339802,80274
-1,-1,6,259528,339802,80274
-1,-1,6,259528,339802,80274
-1,-1,6,259528,339802,80274
-1,-1,6,259528,339802,80274
-1,-1,6,259528,339802,80274
-1,-1,6,259528,339802,80274
-1,-1,6,259528,339802,80274
-1,-1,6,259528,339802,80274
-1,-1,6,259528,339802,80274
-1,-1,6,259528,339802,80274
1,-1,6,259528,339802,80274
1,-1,6,259528,339802,80274
-1,-1,6,259528,339802,80274
1,-1,6,259528,339802,80274
-1,-1,6,259528,339802,80274
-1,-1,6,259528,339802,80274
-1,-1,6,259528,339802,80274
1,-1,6,259528,339802,80274
1,-1,6,259528,339802,80274
-1,-1,6,259528,339802,80274
-1,-1,6,259528,339802,80274
-1,-1,6,259528,339802,80274
1,-1,6,259528,339802,80274
-1,-1,6,259528,339802,80274
-1,-1,6,259528,339802,80274
-1,-1,6,259528,339802,80274
-1,-1,6,259528,339802,80274
-1,-1,6,259528,339802,80274
-1,-1,6,259528,339802,80274
-1,-1,6,259528,339802,80274
-1,-1,6,259528,339802,80274
-1,-1,6,259528,339802,80274
-1,-1,6,259528,339802,80274
-1,-1,6,259528,339802,80274
-1,-1,6,259528,339802,80274
-1,-1,6,259528,339802,80274
-1,-1,6,259528,339802,80274
-1,-1,6,259528,339802,80274
-1,-1,6,259528,339802,80274
-1,-1,6,259528,339802,80274
-1,-1,6,259528,339802,80274
-1,-1,6,259528,339802,80274
-1,-1,6,259528,339802,80274
-1,-1,6,259528,339802,80274
-1,-1,6,259528,339802,80274
-1,-1,6,259528,339802,80274
-1,-1,6,259528,339802,80274
-1,-1,6,259528,339802,80274
-1,-1,6,259528,339802,80274
1,-1,6,259528,339802,80274
-1,-1,6,259528,339802,80274
-1,-1,6,259528,339802,80274
-1,-1,6,259528,339802,80274
-1,-1,6,259528,339802,80274
-1,-1,6,259528,339802,80274
-1,-1,6,259528,339802,80274
-1,-1,6,259528,339802,80274
-1,-1,6,259528,339802,80274
-1,-1,6,259528,339802,80274
-1,-1,6,259528,339802,80274
-1,-1,6,259528,339802,80274
-1,-1,6,259528,339802,80274
-1,-1,6,259528,339802,80274
-1,-1,6,259528,339802,80274
-1,-1,6,259528,339802,80274
-1,-1,6,259528,339802,80274
-1,-1,6,259528,339802,80274
-1,-1,6,259528,339802,80274
-1,-1,6,259528,339802,80274
-1,-1,6,259528,339802,80274
-1,-1,6,259528,339802,80274
-1,-1,6,259528,339802,80274
-1,-1,6,259528,339802,80274
-1,-1,6,259528,339802,80274
-1,-1,6,259528,339802,80274
-1,-1,6,259528,339802,80274
-1,-1,6,259528,339802,80274
-1,-1,6,259528,339802,80274
-1,-1,6,259528,339802,80274
-1,-1,6,259528,339802,80274
-1,-1,6,259528,339802,80274
-1,-1,6,259528,339802,80274
-1,-1,6,259528,339802,80274
-1,-1,6,259528,339802,80274
-1,-1,6,259528,339802,80274
-1,-1,6,259528,339802,80274
-1,-1,6,259528,339802,80274
-1,-1,6,259528,339802,80274
-1,-1,6,259528,339802,80274
-1,-1,6,259528,339802,80274
-1,-1,6,259528,339802,80274
-1,-1,6,259528,339802,80274
-1,-1,6,259528,339802,80274
-1,-1,6,259528,339802,80274
-1,-1,6,259528,339802,80274
-1,-1,6,259528,339802,80274
-1,-1,6,259528,339802,80274
-1,-1,6,259528,339802,80274
-1,-1,6,259528,339802,80274
-1,-1,6,259528,339802,80274
1,-1,6,259528,339802,80274
-1,-1,6,259528,339802,80274
-1,-1,6,259528,339802,80274
-1,-1,6,259528,339802,80274
-1,-1,6,259528,339802,80274
-1,-1,6,259528,339802,80274
-1,-1,6,259528,339802,80274
-1,-1,6,259528,339802,80274
-1,-1,6,259528,339802,80274
1,-1,6,259528,339802,80274
-1,-1,6,259528,339802,80274
-1,-1,6,259528,339802,80274
-1,-1,6,259528,339802,80274
1,-1,6,259528,339802,80274
1,-1,6,259528,339802,80274
1,-1,6,259528,339802,80274
-1,-1,6,259528,339802,80274
1,-1,6,259528,339802,80274
1,-1,6,259528,339802,80274
1,-1,6,259528,339802,80274
-1,-1,6,259528,339802,80274
-1,-1,6,259528,339802,80274
-1,-1,6,259528,339802,80274
-1,-1,6,259528,339802,80274
1,-1,6,259528,339802,80274
-1,-1,6,259528,339802,80274
-1,-1,6,259528,339802,80274
-1,-1,6,259528,339802,80274
-1,-1,6,259528,339802,80274
-1,-1,6,259528,339802,80274
-1,-1,6,259528,339802,80274
-1,-1,6,259528,339802,80274
-1,-1,6,259528,339802,80274
-1,-1,6,259528,339802,80274
1,-1,6,259528,350265,90737
1,-1,6,259528,350265,90737
1,-1,6,259528,350265,90737
-1,-1,6,259528,350265,90737
-1,-1,6,259528,350265,90737
-1,-1,6,259528,350265,90737
-1,-1,6,259528,350265,90737
-1,-1,6,259528,350265,90737
-1,-1,6,259528,350265,90737
-1,-1,6,259528,389482,129954
-1,-1,6,259528,389482,129954
-1,-1,6,259528,389482,129954
-1,-1,6,259528,389482,129954
-1,-1,6,259528,389482,129954
-1,-1,6,259528,389482,129954
-1,-1,6,259528,389482,129954
1,-1,6,259531,284008,24477
1,-1,6,259531,289298,29767
1,-1,6,259531,289298,29767
1,-1,6,259531,289298,29767
1,-1,6,259531,289298,29767
1,-1,6,259531,289298,29767
1,-1,6,259531,289298,29767
1,-1,6,259531,289298,29767
1,-1,6,259531,289298,29767
1,-1,6,259531,289298,29767
1,-1,6,259531,289298,29767
1,-1,6,259531,289298,29767
1,-1,6,259531,289298,29767
1,-1,6,259531,289298,29767
1,-1,6,259531,289298,29767
1,-1,6,259531,289298,29767
1,-1,6,259531,289298,29767
1,-1,6,259531,289298,29767
1,-1,6,259531,289298,29767
1,-1,6,259531,289298,29767
-1,-1,6,259531,293497,33966
-1,-1,6,259531,293497,33966
-1,-1,6,259531,293497,33966
-1,-1,6,259531,293497,33966
-1,-1,6,259531,293497,33966
-1,-1,6,259531,293497,33966
-1,-1,6,259531,293497,33966
1,-1,6,259531,293497,33966
-1,-1,6,259531,293497,33966
-1,-1,6,259531,293497,33966
-1,-1,6,259531,293497,33966
-1,-1,6,259531,293497,33966
-1,-1,6,259531,293497,33966
-1,-1,6,259531,293497,33966
-1,-1,6,259531,293497,33966
-1,-1,6,259531,293497,33966
1,-1,6,259531,293497,33966
-1,-1,6,259531,293497,33966
-1,-1,6,259531,293497,33966
-1,-1,6,259531,293497,33966
-1,-1,6,259531,293497,33966
-1,-1,6,259531,293497,33966
-1,-1,6,259531,293497,33966
-1,-1,6,259531,293497,33966
-1,-1,6,259531,293497,33966
-1,-1,6,259531,293497,33966
-1,-1,6,259531,293497,33966
-1,-1,6,259531,293497,33966
1,-1,6,259531,293497,33966
-1,-1,6,259531,293497,33966
-1,-1,6,259531,293497,33966
-1,-1,6,259531,293497,33966
-1,-1,6,259531,293497,33966
-1,-1,6,259531,293497,33966
-1,-1,6,259531,293497,33966
-1,-1,6,259531,293497,33966
-1,-1,6,259531,293497,33966
1,-1,6,259531,293497,33966
-1,-1,6,259531,293497,33966
-1,-1,6,259531,293497,33966
-1,-1,6,259531,293497,33966
1,-1,6,259531,293497,33966
1,-1,6,259531,293497,33966
-1,-1,6,259531,293497,33966
-1,-1,6,259531,293497,33966
-1,-1,6,259531,293497,33966
1,-1,6,259531,293497,33966
-1,-1,6,259531,293497,33966
1,-1,6,259531,293497,33966
1,-1,6,259531,293497,33966
-1,-1,6,259531,293497,33966
-1,-1,6,259531,293497,33966
-1,-1,6,259531,293497,33966
1,-1,6,259531,293497,33966
1,-1,6,259531,293497,33966
-1,-1,6,259531,293497,33966
-1,-1,6,259531,293497,33966
-1,-1,6,259531,293497,33966
1,-1,6,259531,293497,33966
1,-1,6,259531,293497,33966
-1,-1,6,259531,293497,33966
1,-1,6,259531,293497,33966
1,-1,6,259531,293497,33966
-1,-1,6,259531,293497,33966
1,-1,6,259531,293497,33966
1,-1,6,259531,293497,33966
-1,-1,6,259531,293497,33966
1,-1,6,259531,293497,33966
1,-1,6,259531,293497,33966
1,-1,6,259531,293497,33966
1,-1,6,259531,293497,33966
-1,-1,6,259531,293497,33966
-1,-1,6,259531,293497,33966
-1,-1,6,259531,293497,33966
-1,-1,6,259531,293497,33966
1,-1,6,259531,293497,33966
-1,-1,6,259531,293497,33966
1,-1,6,259531,293497,33966
-1,-1,6,259531,293497,33966
-1,-1,6,259531,293497,33966
-1,-1,6,259531,293497,33966
-1,-1,6,259531,293497,33966
-1,-1,6,259531,293497,33966
-1,-1,6,259531,293497,33966
-1,-1,6,259531,293497,33966
-1,-1,6,259531,293497,33966
-1,-1,6,259531,293497,33966
-1,-1,6,259531,293497,33966
1,-1,6,259531,293497,33966
1,-1,6,259531,293497,33966
-1,-1,6,259531,293497,33966
1,-1,6,259531,293497,33966
-1,-1,6,259531,293497,33966
1,-1,6,259531,293497,33966
-1,-1,6,259531,293497,33966
-1,-1,6,259531,293497,33966
-1,-1,6,259531,293497,33966
-1,-1,6,259531,293497,33966
1,-1,6,259531,293497,33966
1,-1,6,259531,293497,33966
-1,-1,6,259531,293497,33966
1,-1,6,259531,293497,33966
1,-1,6,259531,293497,33966
-1,-1,6,259531,293497,33966
-1,-1,6,259531,293497,33966
-1,-1,6,259531,293497,33966
-1,-1,6,259531,293497,33966
-1,-1,6,259531,293497,33966
-1,-1,6,259531,293497,33966
-1,-1,6,259531,293497,33966
1,-1,6,259531,293497,33966
-1,-1,6,259531,293497,33966
-1,-1,6,259531,293497,33966
1,-1,6,259531,293497,33966
-1,-1,6,259531,293497,33966
1,-1,6,259531,293497,33966
1,-1,6,259531,293497,33966
-1,-1,6,259531,293497,33966
1,-1,6,259531,293497,33966
1,-1,6,259531,293497,33966
1,-1,6,259531,293497,33966
1,-1,6,259531,293497,33966
-1,-1,6,259531,293497,33966
-1,-1,6,259531,293497,33966
-1,-1,6,259531,293497,33966
-1,-1,6,259531,293497,33966
-1,-1,6,259531,293497,33966
-1,-1,6,259531,293497,33966
1,-1,6,259531,293497,33966
-1,-1,6,259531,293497,33966
1,-1,6,259531,293497,33966
1,-1,6,259531,293497,33966
1,-1,6,259531,293497,33966
-1,-1,6,259531,293497,33966
-1,-1,6,259531,293497,33966
1,-1,6,259531,293497,33966
-1,-1,6,259531,293497,33966
1,-1,6,259531,293497,33966
-1,-1,6,259531,293497,33966
-1,-1,6,259531,293497,33966
-1,-1,6,259531,293497,33966
-1,-1,6,259531,293497,33966
-1,-1,6,259531,293497,33966
1,-1,6,259531,293497,33966
1,-1,6,259531,293497,33966
-1,-1,6,259531,293497,33966
1,-1,6,259531,293497,33966
-1,-1,6,259531,293497,33966
1,-1,6,259531,293497,33966
-1,-1,6,259531,293497,33966
1,-1,6,259531,293497,33966
-1,-1,6,259531,293497,33966
-1,-1,6,259531,293497,33966
1,-1,6,259531,293497,33966
-1,-1,6,259531,293497,33966
-1,-1,6,259531,293497,33966
1,-1,6,259531,293497,33966
1,-1,6,259531,293497,33966
-1,-1,6,259531,293497,33966
-1,-1,6,259531,293497,33966
1,-1,6,259531,293497,33966
-1,-1,6,259531,293497,33966
1,-1,6,259531,293497,33966
-1,-1,6,259531,293497,33966
1,-1,6,259531,293497,33966
1,-1,6,259531,293497,33966
-1,-1,6,259531,293497,33966
-1,-1,6,259531,293497,33966
-1,-1,6,259531,293497,33966
-1,-1,6,259531,293497,33966
1,-1,6,259531,293497,33966
1,-1,6,259531,293497,33966
-1,-1,6,259531,293497,33966
-1,-1,6,259531,293497,33966
1,-1,6,259531,293497,33966
-1,-1,6,259531,293497,33966
-1,-1,6,259531,293497,33966
-1,-1,6,259531,293497,33966
-1,-1,6,259531,293497,33966
1,-1,6,259531,293497,33966
1,-1,6,259531,293782,34251
1,-1,6,259531,293782,34251
1,-1,6,259531,296523,36992
-1,-1,6,259531,296605,37074
-1,-1,6,259531,296605,37074
-1,-1,6,259531,296605,37074
-1,-1,6,259531,296605,37074
1,-1,6,259531,296605,37074
1,-1,6,259531,296605,37074
-1,-1,6,259531,296605,37074
-1,-1,6,259531,296605,37074
-1,-1,6,259531,296605,37074
-1,-1,6,259531,296605,37074
1,-1,6,259531,296605,37074
-1,-1,6,259531,296605,37074
-1,-1,6,259531,296605,37074
-1,-1,6,259531,296605,37074
-1,-1,6,259531,296605,37074
1,-1,6,259531,296605,37074
-1,-1,6,259531,296605,37074
1,-1,6,259531,296605,37074
-1,-1,6,259531,301899,42368
1,-1,6,259531,301899,42368
-1,-1,6,259531,301899,42368
-1,-1,6,259531,301899,42368
-1,-1,6,259531,301899,42368
-1,-1,6,259531,301899,42368
-1,-1,6,259531,301899,42368
-1,-1,6,259531,301899,42368
1,-1,6,259531,301899,42368
1,-1,6,259531,301899,42368
-1,-1,6,259531,301899,42368
1,-1,6,259531,301899,42368
-1,-1,6,259531,307995,48464
-1,-1,6,259531,307995,48464
1,-1,6,259531,307995,48464
1,-1,6,259531,307995,48464
-1,-1,6,259531,307995,48464
1,-1,6,259531,307995,48464
-1,-1,6,259531,307995,48464
1,-1,6,259531,307995,48464
-1,-1,6,259531,307995,48464
1,-1,6,259531,307995,48464
-1,-1,6,259531,307995,48464
-1,-1,6,259531,307995,48464
1,-1,6,259531,307995,48464
-1,-1,6,259531,307995,48464
1,-1,6,259531,307995,48464
1,-1,6,259531,307995,48464
1,-1,6,259531,307995,48464
-1,-1,6,259531,307995,48464
1,-1,6,259531,307995,48464
1,-1,6,259531,307995,48464
-1,-1,6,259531,307995,48464
-1,-1,6,259531,307995,48464
-1,-1,6,259531,307995,48464
1,-1,6,259531,307995,48464
1,-1,6,259531,307995,48464
1,-1,6,259531,307995,48464
1,-1,6,259531,339797,80266
1,-1,6,259531,339797,80266
1,-1,6,259531,339797,80266
1,-1,6,259531,339797,80266
1,-1,6,259531,339797,80266
-1,-1,6,259531,339797,80266
1,-1,6,259531,339797,80266
1,-1,6,259531,339797,80266
1,-1,6,259531,339797,80266
1,-1,6,259531,339797,80266
1,-1,6,259531,339797,80266
1,-1,6,259531,339797,80266
1,-1,6,259531,339797,80266
1,-1,6,259531,339797,80266
1,-1,6,259531,339797,80266
1,-1,6,259531,339797,80266
-1,-1,6,259531,339797,80266
1,-1,6,259531,339797,80266
1,-1,6,259531,339797,80266
1,-1,6,259531,339797,80266
1,-1,6,259531,339797,80266
1,-1,6,259531,339797,80266
1,-1,6,259531,339797,80266
1,-1,6,259531,339797,80266
1,-1,6,259531,339797,80266
-1,-1,6,259531,339797,80266
1,-1,6,259531,339797,80266
1,-1,6,259531,339797,80266
1,-1,6,259531,339797,80266
1,-1,6,259531,339797,80266
1,-1,6,259531,339797,80266
1,-1,6,259531,339797,80266
1,-1,6,259531,339797,80266
1,-1,6,259531,339797,80266
-1,-1,6,259531,339797,80266
1,-1,6,259531,339797,80266
1,-1,6,259531,339797,80266
-1,-1,6,259531,339797,80266
1,-1,6,259531,339797,80266
1,-1,6,259531,339797,80266
1,-1,6,259531,339797,80266
-1,-1,6,259531,339797,80266
1,-1,6,259531,339797,80266
-1,-1,6,259531,339797,80266
1,-1,6,259531,339797,80266
1,-1,6,259531,339797,80266
1,-1,6,259531,339797,80266
-1,-1,6,259531,339797,80266
1,-1,6,259531,339797,80266
-1,-1,6,259531,339797,80266
1,-1,6,259531,339797,80266
1,-1,6,259531,339797,80266
1,-1,6,259531,339797,80266
1,-1,6,259531,339797,80266
1,-1,6,259531,339797,80266
1,-1,6,259531,339797,80266
1,-1,6,259531,339797,80266
1,-1,6,259531,339797,80266
1,-1,6,259531,339797,80266
1,-1,6,259531,339797,80266
1,-1,6,259531,339797,80266
1,-1,6,259531,339797,80266
1,-1,6,259531,339797,80266
-1,-1,6,259531,339797,80266
1,-1,6,259531,339797,80266
1,-1,6,259531,339797,80266
-1,-1,6,259531,339797,80266
1,-1,6,259531,339797,80266
1,-1,6,259531,339797,80266
1,-1,6,259531,339797,80266
1,-1,6,259531,339797,80266
1,-1,6,259531,339797,80266
1,-1,6,259531,339797,80266
1,-1,6,259531,339797,80266
1,-1,6,259531,339797,80266
1,-1,6,259531,339797,80266
1,-1,6,259531,339797,80266
1,-1,6,259531,339797,80266
1,-1,6,259531,339797,80266
-1,-1,6,259531,339797,80266
1,-1,6,259531,339797,80266
-1,-1,6,259531,339797,80266
1,-1,6,259531,339797,80266
1,-1,6,259531,339797,80266
1,-1,6,259531,339797,80266
1,-1,6,259531,339797,80266
1,-1,6,259531,339797,80266
1,-1,6,259531,339797,80266
1,-1,6,259531,339797,80266
-1,-1,6,259531,339797,80266
-1,-1,6,259531,339797,80266
1,-1,6,259531,339797,80266
1,-1,6,259531,339797,80266
1,-1,6,259531,339797,80266
1,-1,6,259531,339797,80266
1,-1,6,259531,339797,80266
1,-1,6,259531,339797,80266
1,-1,6,259531,339797,80266
1,-1,6,259531,339797,80266
1,-1,6,259531,339797,80266
1,-1,6,259531,339797,80266
1,-1,6,259531,339797,80266
1,-1,6,259531,339797,80266
1,-1,6,259531,339797,80266
1,-1,6,259531,339797,80266
1,-1,6,259531,339797,80266
1,-1,6,259531,339797,80266
-1,-1,6,259531,339797,80266
1,-1,6,259531,339797,80266
1,-1,6,259531,339797,80266
1,-1,6,259531,339797,80266
1,-1,6,259531,339797,80266
1,-1,6,259531,339797,80266
1,-1,6,259531,339797,80266
1,-1,6,259531,339797,80266
1,-1,6,259531,339797,80266
-1,-1,6,259531,339797,80266
1,-1,6,259531,339797,80266
1,-1,6,259531,339797,80266
1,-1,6,259531,339797,80266
1,-1,6,259531,339797,80266
-1,-1,6,259531,339797,80266
1,-1,6,259531,339797,80266
1,-1,6,259531,339797,80266
1,-1,6,259531,339797,80266
1,-1,6,259531,339797,80266
-1,-1,6,259531,339797,80266
1,-1,6,259531,339797,80266
1,-1,6,259531,339797,80266
1,-1,6,259531,339797,80266
1,-1,6,259531,339797,80266
1,-1,6,259531,339797,80266
1,-1,6,259531,339797,80266
1,-1,6,259531,339797,80266
1,-1,6,259531,339797,80266
1,-1,6,259531,339797,80266
1,-1,6,259531,339797,80266
1,-1,6,259531,339797,80266
1,-1,6,259531,339797,80266
1,-1,6,259531,339797,80266
1,-1,6,259531,339797,80266
1,-1,6,259531,339797,80266
1,-1,6,259531,339797,80266
1,-1,6,259531,339797,80266
1,-1,6,259531,339797,80266
1,-1,6,259531,339797,80266
1,-1,6,259531,339797,80266
1,-1,6,259531,339797,80266
1,-1,6,259531,339797,80266
1,-1,6,259531,339797,80266
1,-1,6,259531,339797,80266
1,-1,6,259531,339797,80266
1,-1,6,259531,339797,80266
1,-1,6,259531,339797,80266
-1,-1,6,259531,339797,80266
-1,-1,6,259531,339797,80266
1,-1,6,259531,339797,80266
1,-1,6,259531,339797,80266
1,-1,6,259531,339797,80266
1,-1,6,259531,339797,80266
-1,-1,6,259531,339797,80266
-1,-1,6,259531,339797,80266
1,-1,6,259531,339797,80266
-1,-1,6,259531,339797,80266
1,-1,6,259531,339797,80266
1,-1,6,259531,339797,80266
1,-1,6,259531,339797,80266
1,-1,6,259531,339797,80266
1,-1,6,259531,339797,80266
1,-1,6,259531,339797,80266
1,-1,6,259531,339797,80266
1,-1,6,259531,339797,80266
1,-1,6,259531,339797,80266
1,-1,6,259531,339797,80266
1,-1,6,259531,339797,80266
1,-1,6,259531,339797,80266
1,-1,6,259531,339797,80266
-1,-1,6,259531,339797,80266
-1,-1,6,259531,339797,80266
1,-1,6,259531,339797,80266
1,-1,6,259531,339797,80266
1,-1,6,259531,339797,80266
-1,-1,6,259531,339797,80266
1,-1,6,259531,339797,80266
1,-1,6,259531,339797,80266
1,-1,6,259531,339797,80266
1,-1,6,259531,339797,80266
1,-1,6,259531,339797,80266
1,-1,6,259531,339797,80266
1,-1,6,259531,339797,80266
1,-1,6,259531,339797,80266
-1,-1,6,259531,339797,80266
-1,-1,6,259531,339797,80266
-1,-1,6,259531,339797,80266
-1,-1,6,259531,339797,80266
-1,-1,6,259531,339797,80266
-1,-1,6,259531,339797,80266
-1,-1,6,259531,339797,80266
1,-1,6,259531,339797,80266
-1,-1,6,259531,339797,80266
1,-1,6,259531,339797,80266
-1,-1,6,259531,339797,80266
-1,-1,6,259531,339797,80266
-1,-1,6,259531,339797,80266
-1,-1,6,259531,339797,80266
-1,-1,6,259531,339797,80266
-1,-1,6,259531,339797,80266
-1,-1,6,259531,339797,80266
1,-1,6,259531,339797,80266
-1,-1,6,259531,339797,80266
-1,-1,6,259531,339797,80266
-1,-1,6,259531,339797,80266
1,-1,6,259531,339797,80266
-1,-1,6,259531,339797,80266
-1,-1,6,259531,339797,80266
-1,-1,6,259531,339797,80266
-1,-1,6,259531,339797,80266
-1,-1,6,259531,339797,80266
1,-1,6,259531,339797,80266
-1,-1,6,259531,339797,80266
1,-1,6,259531,339797,80266
-1,-1,6,259531,339797,80266
-1,-1,6,259531,339797,80266
1,-1,6,259531,339797,80266
-1,-1,6,259531,339797,80266
-1,-1,6,259531,339797,80266
-1,-1,6,259531,339797,80266
-1,-1,6,259531,339797,80266
-1,-1,6,259531,339797,80266
-1,-1,6,259531,339797,80266
-1,-1,6,259531,339797,80266
-1,-1,6,259531,339797,80266
-1,-1,6,259531,339797,80266
-1,-1,6,259531,339797,80266
-1,-1,6,259531,339797,80266
-1,-1,6,259531,339797,80266
-1,-1,6,259531,339797,80266
-1,-1,6,259531,339797,80266
-1,-1,6,259531,339797,80266
-1,-1,6,259531,339797,80266
-1,-1,6,259531,339797,80266
-1,-1,6,259531,339797,80266
-1,-1,6,259531,339797,80266
-1,-1,6,259531,339797,80266
-1,-1,6,259531,339797,80266
-1,-1,6,259531,339797,80266
-1,-1,6,259531,339797,80266
-1,-1,6,259531,339797,80266
-1,-1,6,259531,339797,80266
1,-1,6,259531,339797,80266
-1,-1,6,259531,339797,80266
1,-1,6,259531,339797,80266
-1,-1,6,259531,339797,80266
-1,-1,6,259531,339797,80266
-1,-1,6,259531,339797,80266
-1,-1,6,259531,339797,80266
-1,-1,6,259531,339797,80266
-1,-1,6,259531,339797,80266
-1,-1,6,259531,339797,80266
-1,-1,6,259531,339797,80266
-1,-1,6,259531,339797,80266
-1,-1,6,259531,339797,80266
-1,-1,6,259531,339797,80266
-1,-1,6,259531,339797,80266
-1,-1,6,259531,339797,80266
-1,-1,6,259531,339797,80266
-1,-1,6,259531,339797,80266
-1,-1,6,259531,339797,80266
-1,-1,6,259531,339797,80266
-1,-1,6,259531,339797,80266
-1,-1,6,259531,339797,80266
-1,-1,6,259531,339797,80266
-1,-1,6,259531,339797,80266
-1,-1,6,259531,339797,80266
-1,-1,6,259531,339797,80266
-1,-1,6,259531,339797,80266
-1,-1,6,259531,339797,80266
-1,-1,6,259531,339797,80266
-1,-1,6,259531,339797,80266
-1,-1,6,259531,339797,80266
-1,-1,6,259531,339797,80266
-1,-1,6,259531,339797,80266
-1,-1,6,259531,339797,80266
-1,-1,6,259531,339797,80266
-1,-1,6,259531,339797,80266
-1,-1,6,259531,339797,80266
-1,-1,6,259531,339797,80266
-1,-1,6,259531,339797,80266
-1,-1,6,259531,339797,80266
-1,-1,6,259531,339797,80266
-1,-1,6,259531,339797,80266
-1,-1,6,259531,339797,80266
-1,-1,6,259531,339797,80266
1,-1,6,259531,339797,80266
-1,-1,6,259531,339797,80266
-1,-1,6,259531,339797,80266
-1,-1,6,259531,339797,80266
-1,-1,6,259531,339797,80266
-1,-1,6,259531,339797,80266
-1,-1,6,259531,339797,80266
-1,-1,6,259531,339797,80266
-1,-1,6,259531,339797,80266
-1,-1,6,259531,339797,80266
-1,-1,6,259531,339797,80266
-1,-1,6,259531,339797,80266
-1,-1,6,259531,339797,80266
-1,-1,6,259531,339797,80266
-1,-1,6,259531,339797,80266
-1,-1,6,259531,339797,80266
-1,-1,6,259531,339797,80266
-1,-1,6,259531,339797,80266
-1,-1,6,259531,339797,80266
-1,-1,6,259531,339797,80266
1,-1,6,259531,339797,80266
-1,-1,6,259531,339797,80266
-1,-1,6,259531,339797,80266
-1,-1,6,259531,339797,80266
-1,-1,6,259531,339797,80266
-1,-1,6,259531,339797,80266
-1,-1,6,259531,339797,80266
-1,-1,6,259531,339797,80266
-1,-1,6,259531,339797,80266
-1,-1,6,259531,339797,80266
-1,-1,6,259531,339797,80266
-1,-1,6,259531,339797,80266
1,-1,6,259531,339797,80266
1,-1,6,259531,339797,80266
-1,-1,6,259531,339797,80266
-1,-1,6,259531,339797,80266
-1,-1,6,259531,339797,80266
-1,-1,6,259531,339797,80266
-1,-1,6,259531,339797,80266
-1,-1,6,259531,339797,80266
-1,-1,6,259531,339797,80266
-1,-1,6,259531,339797,80266
-1,-1,6,259531,339797,80266
-1,-1,6,259531,339797,80266
-1,-1,6,259531,339797,80266
-1,-1,6,259531,366639,107108
1,-1,6,259531,389436,129905
1,-1,6,259531,389436,129905
1,-1,6,259531,389436,129905
1,-1,6,259531,389436,129905
1,-1,6,259531,439401,179870
-1,-1,6,259881,283860,23979
-1,-1,6,259881,289174,29293
-1,-1,6,259881,289174,29293
-1,-1,6,259881,289174,29293
1,-1,6,259881,289174,29293
-1,-1,6,259881,289174,29293
-1,-1,6,259881,289174,29293
-1,-1,6,259881,289174,29293
-1,-1,6,259881,293615,33734
-1,-1,6,259881,307998,48117
-1,-1,6,259881,339802,79921
-1,-1,6,259881,339802,79921
1,-1,6,259881,339802,79921
-1,-1,6,259911,293497,33586
-1,-1,6,259911,339797,79886
1,-1,6,259911,339797,79886
1,-1,6,265806,289298,23492
1,-1,6,265806,289298,23492
1,-1,6,265806,289298,23492
1,-1,6,265806,293497,27691
1,-1,6,265806,293497,27691
1,-1,6,265806,588274,322468
-1,-1,6,265879,350944,85065
1,-1,6,266079,339802,73723
-1,-1,6,266079,339802,73723
-1,-1,6,266079,339802,73723
1,-1,6,266079,339802,73723
1,-1,6,274686,339797,65111
1,-1,6,274686,339797,65111
1,-1,6,279208,289298,10090
1,-1,6,279208,289298,10090
1,-1,6,279208,289298,10090
1,-1,6,279208,293497,14289
-1,-1,6,279208,293497,14289
1,-1,6,279208,293497,14289
1,-1,6,279208,293497,14289
1,-1,6,279208,339797,60589
1,-1,6,279208,339797,60589
1,-1,6,279208,339797,60589
1,-1,6,279208,339797,60589
1,-1,6,279208,339797,60589
1,-1,6,279208,339797,60589
1,-1,6,279208,339797,60589
1,-1,6,279208,339797,60589
1,-1,6,279208,339797,60589
1,-1,6,279208,339797,60589
1,-1,6,279208,339797,60589
1,-1,6,279208,339797,60589
1,-1,6,279208,339797,60589
1,-1,6,279208,339797,60589
-1,-1,6,279208,339797,60589
1,-1,6,279208,339797,60589
1,-1,6,279208,339797,60589
1,-1,6,279208,339797,60589
1,-1,6,279208,339797,60589
-1,-1,6,279314,293615,14301
-1,-1,6,283968,339802,55834
-1,-1,6,283968,339802,55834
-1,-1,6,283968,339802,55834
-1,-1,6,283968,339802,55834
-1,-1,6,283968,339802,55834
1,-1,6,293438,339797,46359
-1,-1,6,293438,339797,46359
-1,-1,6,293438,339797,46359
-1,-1,6,293438,339797,46359
-1,-1,6,293438,339797,46359
-1,-1,6,293438,339797,46359
-1,-1,6,293438,339797,46359
1,-1,6,296464,366639,70175
1,-1,6,296546,339797,43251
1,-1,6,296546,339797,43251
1,-1,6,296546,339797,43251
1,-1,6,296546,339797,43251
1,-1,6,296546,339797,43251
1,-1,6,296546,339797,43251
1,-1,6,296546,339797,43251
1,-1,6,296546,339797,43251
1,-1,6,296546,339797,43251
1,-1,6,296546,339797,43251
1,-1,6,296546,339797,43251
1,-1,6,296546,339797,43251
1,-1,6,296546,339797,43251
1,-1,6,296546,339797,43251
1,-1,6,296546,339797,43251
1,-1,6,296546,339797,43251
1,-1,6,296546,339797,43251
1,-1,6,296546,339797,43251
1,-1,6,296546,339797,43251
1,-1,6,296546,339797,43251
1,-1,6,296546,339797,43251
1,-1,6,296546,339797,43251
-1,-1,6,296546,339797,43251
1,-1,6,296546,339797,43251
1,-1,6,296546,339797,43251
1,-1,6,296546,339797,43251
1,-1,6,296546,339797,43251
1,-1,6,296546,339797,43251
1,-1,6,296546,339797,43251
1,-1,6,296546,339797,43251
-1,-1,6,296546,339797,43251
1,-1,6,296546,339797,43251
1,-1,6,296546,339797,43251
-1,-1,6,296546,339797,43251
1,-1,6,296546,339797,43251
1,-1,6,296546,339797,43251
1,-1,6,296546,339797,43251
1,-1,6,296546,339797,43251
1,-1,6,296546,339797,43251
1,-1,6,296546,339797,43251
1,-1,6,296674,339802,43128
1,-1,6,296674,339802,43128
1,-1,6,296674,339802,43128
-1,-1,6,296674,339802,43128
1,-1,6,296674,339802,43128
1,1,6,302272,18375047,18072775
-1,1,6,383951,4183288,3799337
1,-1,6,490850,700078,209228
1,1,6,815829,1825305,1009476
1,-1,6,815838,1093577,277739
-1,1,6,1441421,2351608,910187
-1,1,6,1490870,2677705,1186835
1,1,6,1490872,2667350,1176478
-1,1,6,1580681,1951526,370845
-1,1,6,1580681,1951526,370845
-1,1,6,1600137,1864876,264739
-1,1,6,2109893,5962832,3852939
-1,1,6,2862874,16698019,13835145
1,1,6,3224544,30624967,27400423
-1,1,6,4069026,13268031,9199005
-1,-1,6,4269700,4465244,195544
-1,-1,6,6411122,6591542,180420
-1,1,6,10601732,13987547,3385815
-1,1,6,12924014,15975708,3051694
1,1,6,13311751,16295791,2984040
-1,1,6,13693852,24225515,10531663
1,-1,6,19479947,19570373,90426
1,-1,6,19687791,19839727,151936
-1,1,6,22519683,25226559,2706876
1,-1,6,27515954,27696583,180629
1,-1,6,27515954,27696583,180629
1,-1,6,28636972,28841640,204668
-1,-1,6,29102310,29122681,20371
1,-1,6,29102310,29152766,50456
1,-1,6,29718640,29760628,41988
1,-1,6,29718640,29760628,41988
1,-1,6,29718640,29760628,41988
1,-1,6,29718640,29760628,41988
1,-1,6,29718640,29760628,41988
1,-1,6,29718640,29760628,41988
1,-1,6,29718704,29760628,41924
1,-1,6,29718704,29760628,41924
1,-1,6,29718763,29760628,41865
-1,-1,6,29854899,29896683,41784
-1,-1,6,29854899,29902285,47386
-1,-1,6,29854899,29902285,47386
-1,-1,6,29854899,29937583,82684
-1,-1,6,31218793,31445788,226995
-1,-1,6,31255002,31481339,226337
-1,-1,6,31381759,31445681,63922
-1,-1,6,31381759,31445681,63922
-1,-1,6,31782789,31797422,14633
-1,-1,6,31785228,31797422,12194
-1,-1,6,31939770,31980751,40981
-1,-1,6,31948199,32009282,61083
-1,-1,6,31963866,32009260,45394
1,-1,6,32411987,32552134,140147
1,-1,6,32411987,32552134,140147
1,-1,6,32411987,32552134,140147
-1,-1,6,32456868,32689176,232308
-1,-1,6,32456868,32689176,232308
-1,-1,6,32456868,32748505,291637
1,-1,6,32450722,32497331,46609
1,-1,6,32450722,32521900,71178
1,-1,6,32450722,32526088,75366
1,-1,6,32450722,32526088,75366
1,-1,6,32450722,32546484,95762
1,-1,6,32450722,32552134,101412
-1,-1,6,32450722,32552134,101412
1,-1,6,32450722,32552134,101412
1,-1,6,32450722,32564808,114086
1,-1,6,32450722,32637088,186366
-1,-1,6,32457212,32521900,64688
1,-1,6,32487451,32581827,94376
1,-1,6,35489509,35538144,48635
1,-1,6,35515776,35538144,22368
-1,-1,6,38049585,38602064,552479
1,-1,6,39270073,39397337,127264
-1,1,6,42661541,46309825,3648284
-1,1,6,43636308,50947320,7311012
1,1,6,45319017,45383847,64830
-1,1,6,45508319,45526327,18008
-1,1,6,45649408,54076842,8427434
-1,-1,6,48464867,48827358,362491
-1,1,6,49313295,49430422,117127
-1,1,6,50938895,57297586,6358691
1,1,6,51061467,53724432,2662965
-1,1,6,51668220,52563298,895078
1,-1,6,52615096,52657414,42318
1,-1,6,53796341,54449718,653377
1,1,6,53796341,68859642,15063301
1,-1,6,56917608,56950558,32950
1,-1,6,57215547,57631490,415943
1,1,6,57329882,69422120,12092238
1,-1,6,57360339,57673830,313491
1,-1,6,57575430,62411810,4836380
1,-1,6,57730440,62887221,5156781
1,-1,6,57747508,61967241,4219733
1,1,6,58719923,71865108,13145185
-1,-1,6,62254225,62350858,96633
1,-1,6,62254225,62596486,342261
1,-1,6,62386147,62889604,503457
1,-1,6,62396147,62889604,493457
1,-1,6,63276588,63348841,72253
-1,1,6,65259548,84136510,18876962
-1,-1,6,67029691,67207085,177394
-1,-1,6,68237467,68416993,179526
-1,-1,6,68237467,68416993,179526
-1,-1,6,68575208,68671903,96695
1,1,6,69445541,71504096,2058555
-1,1,6,72555205,72807895,252690
1,1,6,75092523,142361637,67269114
-1,1,6,76635916,93420511,16784595
1,-1,6,78351935,78763179,411244
1,-1,6,78873966,79045459,171493
-1,-1,6,80883701,81134991,251290
1,-1,6,81572856,81699864,127008
-1,1,6,84548022,99270189,14722167
1,1,6,85779088,89113057,3333969
-1,1,6,85988428,120548687,34560259
-1,1,6,86080434,91379512,5299078
-1,1,6,86513991,93898976,7384985
-1,1,6,91397213,94516233,3119020
1,-1,6,92191627,92505173,313546
-1,1,6,92576950,104658245,12081295
1,-1,6,92707789,92836453,128664
-1,1,6,94202605,109878834,15676229
-1,-1,6,95390505,95554368,163863
-1,-1,6,95390505,95554368,163863
-1,-1,6,95390505,95554368,163863
-1,-1,6,95417615,95831595,413980
-1,-1,6,95456833,95525616,68783
-1,-1,6,95456833,95554368,97535
-1,-1,6,95478783,95554368,75585
-1,1,6,97057870,122482694,25424824
-1,1,6,97384446,110247755,12863309
-1,1,6,100502765,120809300,20306535
-1,1,6,102804377,111371082,8566705
-1,1,6,103727340,114255403,10528063
-1,-1,6,104625850,104789702,163852
-1,-1,6,104949785,105177184,227399
-1,1,6,106951594,126102365,19150771
-1,1,6,107691345,116148646,8457301
-1,1,6,107766485,110869110,3102625
1,-1,6,111185776,111216743,30967
1,-1,6,115281889,115470969,189080
1,-1,6,115281889,115470969,189080
1,-1,6,115281889,115470969,189080
1,-1,6,115281889,115470969,189080
-1,-1,6,115281889,115512479,230590
1,-1,6,115281889,115512479,230590
1,-1,6,115281889,115512479,230590
1,-1,6,115281889,115512479,230590
1,-1,6,115281889,115512479,230590
1,-1,6,115281889,115512479,230590
1,-1,6,115281889,115512479,230590
1,-1,6,115281889,115512479,230590
-1,-1,6,115281889,115512479,230590
-1,-1,6,115281889,115512479,230590
-1,-1,6,115281889,115512479,230590
-1,-1,6,115281889,115512479,230590
1,-1,6,115281889,115512479,230590
1,-1,6,115281889,115512479,230590
1,-1,6,115281889,115512479,230590
1,-1,6,115281889,115512479,230590
-1,-1,6,115281889,115512479,230590
1,-1,6,115281889,115512479,230590
-1,-1,6,115281889,115549567,267678
1,-1,6,115325676,115470969,145293
1,-1,6,115325676,115512479,186803
1,-1,6,115325676,115512479,186803
1,-1,6,115325676,115512479,186803
-1,-1,6,115325676,115512479,186803
1,-1,6,115325676,115549567,223891
1,-1,6,115325676,115607966,282290
-1,1,6,116038381,123952199,7913818
1,1,6,117928310,127021125,9092815
1,-1,6,118787404,119016237,228833
1,-1,6,118787404,119016237,228833
-1,-1,6,119712156,119992270,280114
-1,-1,6,119712186,119998618,286432
1,1,6,121332050,146247408,24915358
-1,1,6,122612641,131564463,8951822
1,1,6,124280383,156115172,31834789
-1,-1,6,127114447,127202157,87710
1,-1,6,129912803,130095047,182244
-1,1,6,133077239,143761582,10684343
1,1,6,133858409,166289033,32430624
1,1,6,135679288,155776251,20096963
-1,1,6,136341788,146648942,10307154
-1,1,6,139513020,150389231,10876211
-1,1,6,140746967,146877424,6130457
-1,1,6,142057731,145692400,3634669
1,1,6,143940111,144734319,794208
-1,1,6,144075695,152337005,8261310
1,-1,6,144328623,144328976,353
-1,1,6,148126255,151214851,3088596
-1,1,6,148433471,149971120,1537649
-1,1,6,150702375,159974984,9272609
1,1,6,151214792,170892243,19677451
1,1,6,152697473,170921089,18223616
1,1,6,152697473,170921089,18223616
-1,1,6,153114537,170919482,17804945
-1,1,6,153647248,158255989,4608741
-1,1,6,154860789,171023595,16162806
-1,1,6,155525920,159889169,4363249
-1,1,6,155699183,163554531,7855348
-1,1,6,156674766,157870814,1196048
-1,1,6,157286551,157414586,128035
-1,1,6,157431664,158489904,1058240
-1,1,6,157473931,157870049,396118
-1,1,6,160336422,171023595,10687173
1,-1,6,160554084,160579554,25470
-1,1,6,160905842,170921099,10015257
-1,1,6,161320930,170919482,9598552
1,-1,6,161653240,161769727,116487
-1,-1,6,162113360,162351639,238279
-1,1,6,162381975,170919482,8537507
-1,-1,6,162514945,162748288,233343
-1,-1,6,162514945,162748288,233343
-1,-1,6,162514945,162748288,233343
-1,-1,6,162541352,162777193,235841
-1,-1,6,162576235,162777193,200958
-1,-1,6,162605894,162694798,88904
-1,-1,6,162654063,162870548,216485
-1,1,6,162638345,162754162,115817
-1,-1,6,162654091,162748288,94197
-1,-1,6,162685340,163000261,314921
-1,-1,6,162685340,163000261,314921
-1,-1,6,162777185,163030972,253787
-1,-1,6,162799322,163000261,200939
-1,-1,6,162870369,162933097,62728
-1,-1,6,162870369,162933097,62728
-1,-1,6,162902283,163000261,97978
-1,-1,6,162960111,163050344,90233
-1,-1,6,163000261,163089344,89083
-1,-1,6,163129464,163516451,386987
-1,1,6,163606025,171055067,7449042
-1,-1,6,163731741,163950870,219129
-1,1,6,163731741,167090237,3358496
-1,1,6,164276935,170919482,6642547
-1,1,6,164361517,170919482,6557965
-1,1,6,165203779,170921089,5717310
-1,1,6,166110423,170919482,4809059
-1,1,6,167148528,171055067,3906539
-1,1,6,167558538,171023595,3465057
1,-1,6,168089899,168196434,106535
-1,1,6,168161046,170919482,2758436
1,-1,6,168225290,168265762,40472
-1,1,6,168297593,171023595,2726002
1,-1,6,168343841,168776932,433091
1,-1,6,168350998,169054014,703016
1,-1,6,168364298,168557878,193580
-1,1,6,168364298,170906766,2542468
1,-1,6,168364343,168557983,193640
1,-1,6,168419548,168549222,129674
1,-1,6,168419548,168549222,129674
1,-1,6,168419548,168656919,237371
1,-1,6,168419548,168656919,237371
1,-1,6,168419548,168656919,237371
1,-1,6,168419548,168656919,237371
1,-1,6,168447123,168656919,209796
1,-1,6,168619459,168860854,241395
1,-1,6,168619459,168996563,377104
-1,1,6,168827897,170919482,2091585
-1,1,6,168923404,170919482,1996078
-1,1,6,168981939,170919482,1937543
1,1,6,169131334,170919482,1788148
-1,1,6,169235041,170921089,1686048
-1,1,6,169281562,170911240,1629678
-1,1,6,170088905,170892302,803397
-1,-1,6,170342687,170566148,223461
-1,-1,6,170540592,170667507,126915
1,-1,6,170766049,170848729,82680
-1,-1,6,170808200,170841628,33428
1,-1,6,170832432,170911240,78808
1,-1,6,170937459,170983403,45944
1,-1,6,170937459,171008097,70638
1,-1,6,170937459,171025471,88012
1,-1,7,10239,229852,219613
1,-1,7,24385,65604,41219
1,-1,7,36480,80075,43595
1,-1,7,36480,80075,43595
1,-1,7,36480,102404,65924
1,-1,7,36480,227774,191294
-1,1,7,43360,3642604,3599244
1,1,7,43360,5443709,5400349
1,1,7,43360,11567351,11523991
1,1,7,43360,12098696,12055336
1,1,7,43360,14664158,14620798
1,1,7,43360,17656861,17613501
1,1,7,43360,23674928,23631568
1,1,7,43360,27236023,27192663
-1,1,7,43360,159119707,159076347
1,1,7,43361,159119707,159076346
1,1,7,43361,159119707,159076346
1,1,7,45130,7291696,7246566
1,1,7,45130,25260784,25215654
1,-1,7,46494,65558,19064
1,-1,7,54165,127214,73049
-1,-1,7,54165,214573,160408
-1,1,7,54165,764962,710797
-1,1,7,54165,3298407,3244242
1,-1,7,54185,120272,66087
1,-1,7,54185,170425,116240
1,-1,7,54185,170425,116240
-1,1,7,54185,1883220,1829035
-1,1,7,54185,3363775,3309590
1,1,7,54185,6677658,6623473
1,1,7,54185,26867253,26813068
-1,1,7,54185,159075079,159020894
1,-1,7,94063,109692,15629
1,-1,7,101528,227833,126305
1,-1,7,101528,227833,126305
-1,-1,7,120242,180597,60355
1,-1,7,127155,214573,87418
1,1,7,183556,12746636,12563080
1,-1,7,183570,229852,46282
-1,-1,7,214514,229824,15310
1,1,7,704573,29257946,28553373
1,-1,7,906574,988123,81549
1,-1,7,930542,985083,54541
1,-1,7,930542,988123,57581
1,-1,7,930542,988123,57581
1,-1,7,930542,988123,57581
1,-1,7,930542,988123,57581
1,-1,7,930542,988123,57581
1,-1,7,930542,1030366,99824
1,-1,7,935913,980013,44100
1,-1,7,935913,1062016,126103
-1,1,7,1201674,5175651,3973977
1,1,7,1737760,27246914,25509154
-1,-1,7,1958233,2032641,74408
-1,-1,7,2007359,2074962,67603
-1,-1,7,2439312,2480542,41230
-1,-1,7,3167411,3214077,46666
1,-1,7,4374018,4519767,145749
-1,-1,7,5488018,6316581,828563
1,1,7,5721840,27269930,21548090
1,-1,7,5799660,5925847,126187
-1,-1,7,5862847,5944692,81845
1,-1,7,5864792,5925847,61055
1,-1,7,6714553,6745510,30957
1,-1,7,7274148,7422178,148030
-1,-1,7,7288899,7456695,167796
-1,1,7,9023635,17395474,8371839
1,-1,7,9436795,9737394,300599
1,-1,7,9673939,9737394,63455
-1,1,7,10649696,25800180,15150484
1,1,7,11048840,52863626,41814786
-1,1,7,11162119,16518928,5356809
1,1,7,11562624,36395416,24832792
1,-1,7,12148960,12693032,544072
-1,-1,7,13156515,13302439,145924
-1,-1,7,13239521,13327079,87558
-1,1,7,14005822,18360977,4355155
-1,1,7,14944519,16964718,2020199
-1,1,7,14944519,16964718,2020199
-1,-1,7,15042234,15139429,97195
-1,1,7,15573437,24891051,9317614
-1,1,7,16161141,20647522,4486381
-1,-1,7,16364885,16441305,76420
1,-1,7,16877677,17166445,288768
1,-1,7,16921581,17378911,457330
-1,-1,7,17116777,17188633,71856
1,-1,7,17278312,17513703,235391
1,-1,7,17886672,18360918,474246
-1,1,7,19142415,19178349,35934
-1,1,7,19185335,22233331,3047996
-1,1,7,20250535,27889019,7638484
-1,1,7,20601079,32044755,11443676
-1,1,7,24344104,28879357,4535253
1,-1,7,29691278,29756786,65508
-1,1,7,32718003,41084581,8366578
-1,1,7,32911003,44576005,11665002
1,-1,7,33134559,33139024,4465
1,-1,7,33150658,33171086,20428
-1,1,7,35500386,42053399,6553013
-1,1,7,37343082,48700334,11357252
-1,1,7,38217601,45343699,7126098
-1,-1,7,38304447,38346405,41958
-1,1,7,39103000,45402695,6299695
-1,1,7,40060197,50611198,10551001
-1,1,7,40350383,47034422,6684039
-1,1,7,40573756,56174815,15601059
-1,1,7,41124364,42606116,1481752
-1,-1,7,41224437,41443498,219061
-1,-1,7,41621198,41734290,113092
1,-1,7,42226378,42239808,13430
1,-1,7,42226378,42244825,18447
1,-1,7,42226378,42244825,18447
1,-1,7,44327417,44620720,293303
-1,1,7,44611548,53767453,9155905
-1,1,7,45061454,45135918,74464
1,-1,7,52295077,52580630,285553
-1,-1,7,53472041,53583125,111084
-1,-1,7,53472041,53583125,111084
-1,-1,7,53472041,53583125,111084
-1,-1,7,53472041,53583125,111084
-1,-1,7,53472041,53583125,111084
-1,-1,7,53472041,53583125,111084
-1,-1,7,53472041,53583125,111084
-1,-1,7,53472041,53583125,111084
-1,1,7,54972516,56172165,1199649
-1,-1,7,55800753,56174888,374135
1,-1,7,55874737,56172165,297428
1,-1,7,55946528,55955695,9167
1,-1,7,56794974,61056670,4261696
1,-1,7,57230344,61056670,3826326
1,-1,7,57927493,62030701,4103208
1,-1,7,57927493,62196740,4269247
1,-1,7,61307485,62970686,1663201
1,-1,7,61839194,62704320,865126
1,-1,7,61839194,62704320,865126
1,-1,7,61843888,62779622,935734
1,-1,7,62030281,62675610,645329
1,-1,7,62030281,62675610,645329
1,-1,7,62030281,62704379,674098
1,-1,7,62030665,62985503,954838
1,-1,7,62196740,62704379,507639
1,-1,7,62196742,62196801,59
1,-1,7,62196742,62828654,631912
-1,1,7,62196742,75061986,12865244
1,1,7,62437463,75044630,12607167
-1,-1,7,62694311,62732735,38424
1,-1,7,63328472,63955286,626814
-1,1,7,63583563,71047246,7463683
-1,-1,7,64567016,65157704,590688
1,-1,7,64567016,65157704,590688
1,-1,7,64567016,65157704,590688
-1,-1,7,64567016,65157704,590688
1,-1,7,64567016,65157704,590688
-1,-1,7,64567016,65157704,590688
1,-1,7,64567016,65176347,609331
1,-1,7,64567016,65176347,609331
1,-1,7,64567016,65176347,609331
-1,-1,7,64567016,65191565,624549
1,-1,7,64567016,65191565,624549
1,-1,7,64567016,65191565,624549
-1,-1,7,64609829,64895573,285744
-1,-1,7,64609853,65012082,402229
-1,-1,7,64610473,64927761,317288
-1,-1,7,64609912,65157704,547792
-1,-1,7,64609912,65191565,581653
-1,-1,7,64679713,64927761,248048
-1,-1,7,64679713,64927761,248048
-1,-1,7,64679713,64927761,248048
-1,-1,7,64679713,64927761,248048
-1,-1,7,64665913,65157704,491791
-1,-1,7,64665913,65157704,491791
-1,-1,7,64701173,64895573,194400
1,-1,7,66767652,67130617,362965
-1,1,7,68465819,69709432,1243613
-1,1,7,69053750,69230025,176275
-1,1,7,69063905,69105486,41581
-1,1,7,69130237,69736834,606597
-1,1,7,69293697,69503431,209734
-1,1,7,69325515,69644230,318715
-1,1,7,69330737,69520566,189829
-1,1,7,69351193,70257735,906542
-1,1,7,69459746,70176827,717081
-1,1,7,69671501,69958576,287075
-1,1,7,69765424,69912439,147015
-1,1,7,70257735,71909376,1651641
-1,1,7,70926112,72806397,1880285
1,-1,7,71935722,72095795,160073
-1,-1,7,72041404,72196404,155000
1,-1,7,72196405,72286180,89775
1,1,7,72408602,74193374,1784772
-1,1,7,72456604,76007380,3550776
1,1,7,72472922,74259176,1786254
-1,1,7,72536980,74629034,2092054
1,1,7,72577021,74197846,1620825
1,1,7,72589515,74154603,1565088
1,1,7,72589515,74165401,1575886
-1,1,7,72606409,74193403,1586994
1,1,7,72606409,74193403,1586994
-1,1,7,72606409,74193403,1586994
-1,1,7,72606409,74285345,1678936
1,1,7,72606409,74300084,1693675
-1,1,7,72636006,74339014,1703008
-1,1,7,72637824,74203685,1565861
-1,1,7,72643631,74142190,1498559
-1,1,7,72644631,74144422,1499791
1,1,7,72650007,74188572,1538565
-1,1,7,72650120,74142256,1492136
1,1,7,72659674,74143240,1483566
1,1,7,72663962,74193403,1529441
1,1,7,72677173,74143140,1465967
-1,1,7,72677237,74144422,1467185
-1,1,7,72677237,74144422,1467185
-1,1,7,72677237,74144422,1467185
-1,1,7,72677237,74144422,1467185
-1,1,7,72677237,74144422,1467185
1,1,7,72677301,74143060,1465759
1,1,7,72677301,74143240,1465939
1,1,7,72685734,74142327,1456593
1,1,7,72685734,74142327,1456593
1,1,7,72685734,74142327,1456593
-1,1,7,72685734,74142327,1456593
-1,1,7,72685734,74142327,1456593
-1,1,7,72685734,74142327,1456593
1,1,7,72685763,74189674,1503911
1,1,7,72686958,74142190,1455232
-1,1,7,72691242,74142190,1450948
1,1,7,72692112,74141746,1449634
1,1,7,72692112,74154497,1462385
1,1,7,72700127,74143240,1443113
1,1,7,72700127,74146858,1446731
-1,1,7,72700414,74142327,1441913
-1,1,7,72700414,74142327,1441913
-1,1,7,72700414,74142327,1441913
-1,1,7,72700414,74142327,1441913
-1,1,7,72700414,74142327,1441913
-1,1,7,72700414,74142327,1441913
-1,1,7,72700414,74142327,1441913
-1,1,7,72700414,74142327,1441913
-1,1,7,72700414,74172913,1472499
-1,1,7,72700414,74172913,1472499
-1,1,7,72700414,74172913,1472499
-1,1,7,72700414,74172913,1472499
-1,1,7,72700414,74172913,1472499
-1,1,7,72700414,74193403,1492989
-1,1,7,72700414,74285345,1584931
-1,1,7,72700510,74142190,1441680
-1,1,7,72700524,74141494,1440970
-1,1,7,72700524,74142190,1441666
1,1,7,72700524,74142256,1441732
-1,1,7,72701018,74141493,1440475
-1,1,7,72708237,74133273,1425036
-1,1,7,72708237,74133273,1425036
-1,1,7,72708237,74133273,1425036
-1,1,7,72708237,74133273,1425036
-1,1,7,72708237,74133273,1425036
-1,1,7,72713253,74142256,1429003
-1,1,7,72713253,74143030,1429777
-1,1,7,72718123,74141746,1423623
1,-1,7,72718252,72730551,12299
-1,1,7,72718252,74133273,1415021
-1,1,7,72718252,74133273,1415021
-1,1,7,72718252,74133273,1415021
-1,1,7,72718277,73898515,1180238
-1,1,7,72718277,74141494,1423217
-1,1,7,72718277,74141603,1423326
-1,1,7,72718277,74141603,1423326
-1,1,7,72718277,74141673,1423396
-1,1,7,72718277,74141746,1423469
-1,1,7,72718277,74141746,1423469
-1,1,7,72718277,74141746,1423469
-1,1,7,72718277,74141784,1423507
-1,1,7,72718277,74142190,1423913
-1,1,7,72718277,74142190,1423913
-1,1,7,72718277,74142190,1423913
-1,1,7,72718277,74142190,1423913
-1,1,7,72718277,74142190,1423913
-1,1,7,72718277,74142190,1423913
-1,1,7,72718277,74142215,1423938
-1,1,7,72718277,74142215,1423938
-1,1,7,72718277,74142215,1423938
-1,1,7,72718277,74146858,1428581
-1,1,7,72718277,74146948,1428671
-1,1,7,72718277,74259899,1541622
-1,1,7,72718277,74287433,1569156
-1,1,7,72726578,74139390,1412812
-1,1,7,72726578,74139390,1412812
1,-1,7,72738675,72766313,27638
-1,1,7,72766312,74133327,1367015
-1,1,7,72766312,74133327,1367015
-1,1,7,72766312,74133327,1367015
1,1,7,72766312,74133327,1367015
-1,1,7,72766312,74193397,1427085
-1,1,7,72766312,74193397,1427085
-1,1,7,72766312,74339030,1572718
-1,1,7,72766312,74339030,1572718
-1,1,7,72766313,74133332,1367019
-1,1,7,72766313,74133332,1367019
-1,1,7,72766313,74133332,1367019
1,1,7,72766313,74133332,1367019
-1,1,7,72766313,74133332,1367019
1,1,7,72766313,74133332,1367019
-1,1,7,72766313,74133332,1367019
-1,1,7,72766313,74133332,1367019
-1,1,7,72766313,74133332,1367019
-1,1,7,72766313,74133332,1367019
1,1,7,72766313,74133332,1367019
-1,1,7,72766313,74133332,1367019
-1,1,7,72766313,74133332,1367019
1,1,7,72766313,74133332,1367019
-1,1,7,72766313,74133332,1367019
-1,1,7,72766313,74133332,1367019
-1,1,7,72766313,74133332,1367019
-1,1,7,72766313,74133332,1367019
-1,1,7,72766313,74339044,1572731
-1,1,7,72766313,74339044,1572731
-1,1,7,72766313,74339044,1572731
1,1,7,72766313,74481540,1715227
-1,1,7,72766313,76351578,3585265
-1,1,7,72766313,76351578,3585265
-1,1,7,73170161,73545656,375495
-1,1,7,73461982,73992743,530761
-1,1,7,73470470,73498327,27857
-1,-1,7,73630191,73633584,3393
-1,1,7,73992744,81661058,7668314
1,-1,7,75034297,75053777,19480
-1,1,7,75058408,77082896,2024488
-1,1,7,75066351,76255805,1189454
1,-1,7,75125952,75145463,19511
-1,1,7,75131839,76296318,1164479
-1,1,7,75159180,76240800,1081620
-1,-1,7,75951410,76103081,151671
1,-1,7,76027481,76665055,637574
1,-1,7,76027481,76671218,643737
1,-1,7,76030503,76543138,512635
1,-1,7,76030503,76543138,512635
1,-1,7,76030503,76583970,553467
1,-1,7,76030503,76637482,606979
1,-1,7,76030503,76637482,606979
1,-1,7,76030503,76637482,606979
1,-1,7,76030503,76671218,640715
1,-1,7,76047559,76637482,589923
1,-1,7,76047559,76671218,623659
1,-1,7,76069915,76604381,534466
1,-1,7,76069915,76623413,553498
1,-1,7,76069915,76637482,567567
1,-1,7,76069915,76671218,601303
1,-1,7,76069874,76144695,74821
-1,-1,7,76072382,76604381,531999
-1,-1,7,76136289,76604381,468092
-1,-1,7,76136289,76604381,468092
1,-1,7,76136289,76637482,501193
1,-1,7,76136289,76637482,501193
1,-1,7,76123879,76144695,20816
1,-1,7,76132879,76144695,11816
1,-1,7,76132879,76144695,11816
1,-1,7,76132879,76144695,11816
1,-1,7,76132879,76144695,11816
1,-1,7,76132879,76144695,11816
1,-1,7,76132879,76144695,11816
1,-1,7,76132879,76144695,11816
1,-1,7,76132879,76144695,11816
1,-1,7,76132879,76144695,11816
1,-1,7,76132879,76144695,11816
1,-1,7,76132879,76144695,11816
1,-1,7,76132879,76144695,11816
1,-1,7,76132879,76144695,11816
1,-1,7,76132879,76144695,11816
1,-1,7,76132879,76144695,11816
1,-1,7,76132879,76144695,11816
-1,-1,7,76139282,76558024,418742
-1,-1,7,76139282,76558024,418742
1,-1,7,76139282,76558024,418742
1,-1,7,76139286,76557072,417786
1,-1,7,76139286,76623413,484127
1,-1,7,76188343,76787353,599010
-1,-1,7,76213818,76558165,344347
1,-1,7,76214048,76623413,409365
1,-1,7,76214048,76623413,409365
1,-1,7,78072972,78118995,46023
1,-1,7,78095241,78118995,23754
1,-1,7,79337679,79393170,55491
-1,1,7,80256737,80277776,21039
-1,1,7,80256737,80280613,23876
-1,1,7,80256737,80280613,23876
-1,1,7,80256737,80280613,23876
-1,1,7,80256737,80280613,23876
-1,1,7,80256737,80280613,23876
-1,1,7,80256737,80280613,23876
-1,1,7,80256737,80280613,23876
-1,1,7,80256737,80280613,23876
-1,1,7,80256737,80280613,23876
-1,1,7,83631950,94858195,11226245
-1,-1,7,84001059,84138511,137452
1,1,7,88314811,89799946,1485135
-1,-1,7,89571253,89695823,124570
-1,-1,7,89571253,89695823,124570
-1,1,7,92388458,97197958,4809500
-1,1,7,92943158,94937906,1994748
-1,1,7,94756382,97502799,2746417
-1,1,7,96553465,96786580,233115
1,1,7,97049164,158716453,61667289
-1,1,7,98793459,101718950,2925491
1,1,7,98969247,159119707,60150460
1,-1,7,100773842,100898909,125067
-1,-1,7,100980697,101101497,120800
1,-1,7,100980697,101101497,120800
1,-1,7,100980697,101126335,145638
-1,1,7,101912320,120918695,19006375
-1,-1,7,102335320,102359654,24334
-1,1,7,107813198,123148768,15335570
-1,1,7,107830021,111587499,3757478
-1,-1,7,110814584,111105234,290650
-1,-1,7,110814584,111105234,290650
-1,-1,7,110839776,111049538,209762
-1,-1,7,111110687,111281484,170797
-1,-1,7,111227064,111333930,106866
-1,1,7,111642645,115770275,4127630
-1,-1,7,111732639,111784310,51671
-1,-1,7,113125279,113209832,84553
-1,1,7,113782532,125480435,11697903
-1,1,7,114029450,116893795,2864345
-1,1,7,114538937,117430177,2891240
1,1,7,115099069,159118507,44019438
-1,1,7,116966859,134475440,17508581
-1,-1,7,118866671,119014612,147941
-1,-1,7,118866671,119025730,159059
-1,-1,7,118866671,119025730,159059
1,-1,7,118866671,119025730,159059
-1,1,7,120435581,120482611,47030
-1,-1,7,120667938,120887300,219362
1,1,7,121503813,159128555,37624742
-1,1,7,121658176,128547780,6889604
-1,1,7,123810711,133848346,10037635
-1,-1,7,124607233,124673241,66008
1,-1,7,125178203,125697584,519381
1,-1,7,125178203,125790977,612774
1,-1,7,125178203,125790977,612774
-1,-1,7,125293124,125406088,112964
-1,1,7,127295698,139524358,12228660
1,1,7,128276078,159119707,30843629
1,1,7,130856237,159119707,28263470
1,1,7,130913523,159128556,28215033
-1,1,7,131642114,139107211,7465097
1,1,7,132122831,159119707,26996876
1,1,7,132128854,159128556,26999702
-1,1,7,133799185,159119707,25320522
-1,1,7,134351581,158384574,24032993
-1,1,7,134702438,148504492,13802054
1,1,7,136758593,159119707,22361114
1,1,7,137435946,154607292,17171346
1,1,7,137435946,154607292,17171346
1,1,7,137589621,159119707,21530086
-1,1,7,137917376,159119707,21202331
-1,1,7,140636858,159119707,18482849
1,1,7,140826207,145349314,4523107
1,1,7,140826207,145349314,4523107
-1,-1,7,142098197,142215022,116825
-1,-1,7,142098197,142276197,178000
-1,-1,7,142098197,142276197,178000
-1,-1,7,142098197,142276197,178000
-1,-1,7,142098197,142276197,178000
-1,-1,7,142098197,142276197,178000
-1,-1,7,142328008,142455543,127535
-1,-1,7,142407731,142472658,64927
-1,-1,7,142429334,142487154,57820
-1,-1,7,142446048,142460444,14396
-1,-1,7,142455572,142460250,4678
1,-1,7,142458519,142460937,2418
-1,-1,7,142458668,142460250,1582
-1,-1,7,142458766,142460250,1484
1,-1,7,142459205,142460451,1246
-1,-1,7,142460910,142486383,25473
-1,-1,7,142460910,142486383,25473
-1,1,7,142528609,159128556,16599947
-1,1,7,142528609,159128556,16599947
-1,-1,7,142829167,142836798,7631
-1,-1,7,142829167,142881336,52169
1,-1,7,143152944,143153565,621
-1,-1,7,143212259,143581871,369612
-1,-1,7,143212259,143581871,369612
-1,-1,7,143212259,143581871,369612
-1,-1,7,143212259,143581871,369612
-1,-1,7,143212259,143581871,369612
-1,-1,7,143212259,143581871,369612
-1,-1,7,143212259,143581871,369612
-1,-1,7,143212259,143581871,369612
-1,-1,7,143212259,143581871,369612
-1,-1,7,143212259,143581871,369612
-1,-1,7,143212259,143581871,369612
-1,-1,7,143212259,143581871,369612
-1,-1,7,143212259,143581871,369612
-1,-1,7,143212259,143581871,369612
-1,-1,7,143212259,143581871,369612
-1,-1,7,143212259,143581871,369612
-1,-1,7,143212259,143581871,369612
-1,-1,7,143212259,143581871,369612
-1,-1,7,143430993,144051263,620270
-1,-1,7,143425418,143426039,621
1,-1,7,143432832,143853032,420200
1,-1,7,143432832,143853032,420200
1,-1,7,143432832,143853032,420200
1,-1,7,143432832,143951990,519158
-1,-1,7,143951961,144051250,99289
-1,1,7,144947347,159128556,14181209
-1,1,7,145441216,145895268,454052
-1,-1,7,145590958,145781576,190618
-1,1,7,145744250,157314852,11570602
-1,1,7,146440190,146663300,223110
-1,1,7,146481738,159128663,12646925
-1,1,7,146841094,159119707,12278613
1,1,7,147042936,153530436,6487500
1,1,7,149261179,159075020,9813841
1,-1,7,149364045,149603148,239103
1,-1,7,149561588,149572651,11063
1,-1,7,149561588,149576899,15311
1,-1,7,149561588,149576899,15311
-1,1,7,149957386,159118566,9161180
-1,1,7,150183159,159128555,8945396
-1,1,7,150499889,159128556,8628667
1,1,7,150801364,159118566,8317202
-1,1,7,150911249,152884547,1973298
-1,-1,7,151075965,158716453,7640488
-1,1,7,151167135,159119707,7952572
1,1,7,151566053,159119707,7553654
1,1,7,152125937,159128555,7002618
-1,1,7,152504290,159118566,6614276
-1,1,7,152557661,159118566,6560905
1,-1,7,152848311,153316814,468503
1,-1,7,152848311,153316814,468503
-1,1,7,153007287,158090794,5083507
1,-1,7,153097168,153651508,554340
1,-1,7,153097168,153670331,573163
1,-1,7,153157388,153487263,329875
1,-1,7,153487263,153651273,164010
1,-1,7,153487263,153651273,164010
1,-1,7,153578546,153721491,142945
1,-1,7,153578546,153721491,142945
1,-1,7,153578546,153823030,244484
1,-1,7,153578546,153823030,244484
-1,1,7,153605584,159118566,5512982
1,-1,7,153823030,153904470,81440
-1,1,7,154731420,159118566,4387146
-1,1,7,154731420,159118566,4387146
-1,1,7,155054023,158909738,3855715
-1,1,7,155293866,159118566,3824700
-1,1,7,155367662,159128556,3760894
-1,1,7,155594374,156069411,475037
1,-1,7,155597511,155598135,624
1,-1,7,155599758,155600358,600
1,-1,7,155599758,155600358,600
1,-1,7,155599758,155600358,600
1,-1,7,155599758,155603986,4228
1,1,7,156786858,156799542,12684
-1,1,7,156821587,159128555,2306968
1,1,7,157691388,159088636,1397248
1,1,7,157691388,159088636,1397248
-1,1,7,158430855,159119707,688852
1,-1,7,158464153,158920200,456047
1,-1,7,158651009,158928217,277208
1,-1,7,158850355,158935236,84881
-1,-1,7,159046976,159058035,11059
-1,-1,7,159049815,159057993,8178
-1,-1,7,159049815,159057993,8178
-1,-1,7,159049815,159058035,8220
-1,-1,7,159049815,159058035,8220
-1,-1,7,159049815,159058035,8220
-1,-1,7,159049815,159058035,8220
-1,-1,7,159049815,159058035,8220
-1,-1,7,159049815,159058035,8220
-1,-1,7,159049815,159058035,8220
-1,-1,7,159049815,159058035,8220
-1,-1,7,159049815,159058035,8220
-1,-1,7,159089400,159125587,36187
1,-1,7,159112702,159128555,15853
-1,-1,7,159118528,159128555,10027
-1,-1,7,159118528,159128555,10027
-1,1,8,13938,6942280,6928342
1,1,8,13938,146304022,146290084
1,-1,8,16046,56814,40768
1,-1,8,16046,73860,57814
-1,-1,8,16046,73860,57814
1,-1,8,20977,94623,73646
1,-1,8,40247,56814,16567
1,-1,8,40247,128199,87952
1,-1,8,40247,145465,105218
1,-1,8,87572,121006,33434
-1,-1,8,87572,128199,40627
1,-1,8,87572,128199,40627
-1,1,8,158048,5474927,5316879
-1,1,8,158048,6004205,5846157
-1,1,8,158048,6460877,6302829
-1,1,8,158048,6944233,6786185
-1,1,8,158048,6944774,6786726
-1,1,8,158048,6981988,6823940
-1,1,8,158048,6982980,6824932
-1,1,8,158048,6999114,6841066
-1,1,8,158048,6999114,6841066
-1,1,8,158048,6999114,6841066
-1,1,8,158048,6999114,6841066
-1,1,8,158048,6999114,6841066
-1,1,8,158048,6999114,6841066
-1,1,8,158048,6999114,6841066
1,1,8,158048,7044046,6885998
-1,1,8,158048,7044046,6885998
-1,1,8,158048,9749574,9591526
1,1,8,158048,30262760,30104712
1,1,8,158048,43786723,43628675
1,1,8,158048,146295771,146137723
1,1,8,158049,146295771,146137722
1,1,8,158049,146295771,146137722
1,1,8,158049,146295771,146137722
1,1,8,158049,146295771,146137722
1,1,8,158049,146295771,146137722
1,1,8,158991,17536147,17377156
1,1,8,158991,146280828,146121837
1,-1,8,161472,402255,240783
-1,1,8,163166,6735327,6572161
-1,1,8,163682,6961161,6797479
1,1,8,163682,46938942,46775260
-1,1,8,176452,1965389,1788937
-1,1,8,176452,6920273,6743821
-1,1,8,176452,6920273,6743821
-1,1,8,176452,6920273,6743821
-1,1,8,176452,6942337,6765885
1,1,8,176452,7838959,7662507
1,1,8,176452,12556063,12379611
1,1,8,176452,12570496,12394044
1,1,8,176452,16137655,15961203
1,1,8,176452,34349408,34172956
1,1,8,176452,37879246,37702794
1,1,8,176452,146294098,146117646
1,1,8,176452,146294098,146117646
-1,1,8,190822,6735327,6544505
-1,1,8,191530,3070296,2878766
-1,1,8,191530,3189335,2997805
-1,1,8,191530,6880363,6688833
-1,1,8,191530,6880363,6688833
-1,1,8,191530,6880363,6688833
-1,1,8,191530,6880363,6688833
-1,1,8,191530,6880363,6688833
1,1,8,191530,6880363,6688833
-1,1,8,191530,6880363,6688833
-1,1,8,191530,6880363,6688833
-1,1,8,191530,6914076,6722546
-1,1,8,191530,7752586,7561056
-1,1,8,191530,10049105,9857575
-1,1,8,191530,10315994,10124464
-1,1,8,191530,10724642,10533112
1,1,8,191530,22404983,22213453
1,1,8,191530,23055911,22864381
1,1,8,191530,146280020,146088490
1,-1,8,191605,408761,217156
1,-1,8,191605,408761,217156
1,1,8,191605,6880346,6688741
-1,1,8,191605,6880346,6688741
-1,1,8,191605,6880346,6688741
1,1,8,191605,24514484,24322879
1,1,8,191605,30948590,30756985
1,1,8,191605,146280167,146088562
-1,1,8,194617,1965389,1770772
-1,1,8,194617,1965389,1770772
1,-1,8,248209,406082,157873
-1,1,8,360369,7334625,6974256
1,-1,8,401226,561272,160046
-1,-1,8,542299,561272,18973
1,-1,8,732690,8079920,7347230
1,1,8,1166068,12570914,11404846
-1,-1,8,2001733,2013802,12069
1,-1,8,2133991,2349876,215885
1,-1,8,2133991,2349876,215885
1,-1,8,2158515,2308926,150411
1,-1,8,2256252,2598857,342605
-1,1,8,2292235,27361796,25069561
-1,1,8,2292235,27361796,25069561
1,-1,8,2349876,2559272,209396
1,-1,8,2349876,2559272,209396
1,-1,8,2349876,2559272,209396
1,-1,8,2349876,2559272,209396
1,-1,8,2349876,2559272,209396
1,-1,8,2349876,2559272,209396
1,-1,8,2349876,2559272,209396
1,-1,8,2498609,2894273,395664
1,1,8,2498609,6463100,3964491
1,-1,8,3689491,6062810,2373319
-1,1,8,3791727,11384448,7592721
-1,-1,8,3988085,4069370,81285
-1,-1,8,3989887,4069370,79483
-1,-1,8,4328231,4406745,78514
-1,-1,8,4328231,4406745,78514
-1,-1,8,4336985,4414585,77600
1,-1,8,4582816,4631792,48976
-1,-1,8,4725109,4749269,24160
-1,-1,8,4725168,4749269,24101
-1,-1,8,5511047,5853505,342458
-1,-1,8,5511047,5884114,373067
-1,-1,8,6043200,6161430,118230
1,-1,8,6589680,6680133,90453
1,-1,8,6621444,6680133,58689
1,-1,8,6644159,8222024,1577865
-1,-1,8,6730517,6795070,64553
1,-1,8,6823874,8130466,1306592
1,-1,8,6880287,8079912,1199625
-1,-1,8,6880287,8079912,1199625
-1,-1,8,6880304,7752586,872282
-1,-1,8,6880304,7752586,872282
1,-1,8,6880304,8079920,1199616
1,-1,8,6880304,8079920,1199616
1,-1,8,6880304,8079920,1199616
1,-1,8,6880304,8079920,1199616
1,-1,8,6911521,8130466,1218945
1,-1,8,6911521,8130466,1218945
1,-1,8,6911521,8145238,1233717
1,-1,8,6920322,8130466,1210144
1,-1,8,6920322,8130466,1210144
1,-1,8,6920322,8130466,1210144
1,-1,8,6920322,8130466,1210144
1,-1,8,6920322,8130466,1210144
1,-1,8,6920322,8130466,1210144
1,-1,8,6920322,8130466,1210144
1,-1,8,6920322,8130466,1210144
1,-1,8,6920322,8130466,1210144
1,-1,8,6920322,8130466,1210144
1,-1,8,6920322,8130466,1210144
1,-1,8,6920322,8130466,1210144
1,-1,8,6942339,8130466,1188127
1,-1,8,6942339,8130466,1188127
1,-1,8,6942339,8130466,1188127
1,-1,8,6942339,8130466,1188127
1,-1,8,6942339,8130466,1188127
1,-1,8,6942339,8130466,1188127
1,-1,8,6942339,8130466,1188127
1,-1,8,6942339,8130466,1188127
1,-1,8,6942339,8130466,1188127
1,-1,8,6942339,8130466,1188127
1,-1,8,6942339,8130466,1188127
1,-1,8,6942339,8130466,1188127
1,-1,8,6942339,8130466,1188127
1,-1,8,6942339,8130466,1188127
1,-1,8,6942339,8130466,1188127
1,-1,8,6942339,8130466,1188127
1,-1,8,6942339,8130466,1188127
1,-1,8,6942339,8130466,1188127
1,-1,8,6942339,8130466,1188127
1,-1,8,6942339,8130466,1188127
1,-1,8,6942339,8130466,1188127
1,-1,8,6942339,8130466,1188127
1,-1,8,6942339,8130466,1188127
1,-1,8,6942339,8130466,1188127
1,-1,8,6942339,8130466,1188127
1,-1,8,6942339,8130466,1188127
1,-1,8,6942339,8130466,1188127
1,-1,8,6942339,8130466,1188127
1,-1,8,6942339,8130466,1188127
1,-1,8,6942339,8130466,1188127
1,-1,8,6942339,8130466,1188127
1,-1,8,6942339,8130466,1188127
1,-1,8,6942339,8130466,1188127
1,-1,8,6942339,8130466,1188127
1,-1,8,6942339,8130466,1188127
1,-1,8,6942339,8130466,1188127
1,-1,8,6942339,8130466,1188127
1,-1,8,6942339,8130466,1188127
1,-1,8,6942339,8130466,1188127
1,-1,8,6942339,8130466,1188127
1,-1,8,6942339,8130466,1188127
1,-1,8,6942339,8130466,1188127
1,-1,8,6942339,8130466,1188127
1,-1,8,6942339,8130466,1188127
1,-1,8,6942339,8130466,1188127
1,-1,8,6942339,8130466,1188127
1,-1,8,6942339,8130466,1188127
1,-1,8,6942339,8130466,1188127
1,-1,8,6942339,8130466,1188127
1,-1,8,6942339,8130466,1188127
1,-1,8,6942339,8130466,1188127
1,-1,8,6942339,8130466,1188127
1,-1,8,6942339,8130466,1188127
1,-1,8,6942339,8130466,1188127
1,-1,8,6942339,8130466,1188127
1,-1,8,6942339,8130466,1188127
1,-1,8,6942339,8130466,1188127
1,-1,8,6942339,8130466,1188127
1,-1,8,6942339,8130466,1188127
1,-1,8,6942339,8130466,1188127
1,-1,8,6942339,8130466,1188127
1,-1,8,6942339,8130466,1188127
1,-1,8,6942339,8130466,1188127
1,-1,8,6942339,8130466,1188127
1,-1,8,6942339,8130466,1188127
1,-1,8,6942339,8130466,1188127
1,-1,8,6942339,8130466,1188127
1,-1,8,6942339,8130466,1188127
1,-1,8,6942339,8130466,1188127
1,-1,8,6942339,8130466,1188127
1,-1,8,6942339,8130466,1188127
1,-1,8,6942339,8130466,1188127
1,-1,8,6942339,8130466,1188127
1,-1,8,6942339,8130466,1188127
1,-1,8,6942339,8130466,1188127
1,-1,8,6942339,8130466,1188127
1,-1,8,6942339,8130466,1188127
1,-1,8,6942339,8130466,1188127
1,-1,8,6942339,8130466,1188127
1,-1,8,6942339,8130466,1188127
1,-1,8,6942339,8130466,1188127
1,-1,8,6942339,8130466,1188127
1,-1,8,6942339,8130466,1188127
1,-1,8,6942339,8130466,1188127
1,-1,8,6942339,8130466,1188127
1,-1,8,6942339,8130466,1188127
1,-1,8,6942339,8130466,1188127
1,-1,8,6942339,8130466,1188127
1,-1,8,6942339,8130466,1188127
1,-1,8,6942339,8130466,1188127
1,-1,8,6942339,8130466,1188127
1,-1,8,6942339,8130466,1188127
1,-1,8,6942339,8130466,1188127
1,-1,8,6942339,8130466,1188127
1,-1,8,6942339,8130466,1188127
1,-1,8,6942339,8130466,1188127
1,-1,8,6942339,8130466,1188127
1,-1,8,6942339,8130466,1188127
1,-1,8,6942339,8130466,1188127
1,-1,8,6942339,8130466,1188127
1,-1,8,6942339,8130466,1188127
1,-1,8,6942339,8130466,1188127
1,-1,8,6942339,8130466,1188127
1,-1,8,6942339,8130466,1188127
1,-1,8,6942339,8130466,1188127
1,-1,8,6942339,8130466,1188127
1,-1,8,6942339,8130466,1188127
1,-1,8,6942339,8130466,1188127
1,-1,8,6942339,8130466,1188127
1,-1,8,6942339,8130466,1188127
1,-1,8,6942339,8130466,1188127
1,-1,8,6942339,8130466,1188127
1,-1,8,6942339,8130466,1188127
1,-1,8,6942339,8130466,1188127
1,-1,8,6942339,8130466,1188127
1,-1,8,6942339,8130466,1188127
1,-1,8,6942339,8130466,1188127
1,-1,8,6942339,8130466,1188127
1,-1,8,6942339,8130466,1188127
1,-1,8,6942339,8130466,1188127
1,-1,8,6942339,8130466,1188127
1,-1,8,6942339,8130466,1188127
1,-1,8,6942339,8130466,1188127
1,-1,8,6942339,8130466,1188127
1,-1,8,6942339,8130466,1188127
1,-1,8,6942339,8130466,1188127
1,-1,8,6942339,8130466,1188127
1,-1,8,6942339,8130466,1188127
1,-1,8,6942339,8130466,1188127
1,-1,8,6942339,8130466,1188127
1,-1,8,6942339,8130466,1188127
1,-1,8,6942339,8130466,1188127
1,-1,8,6942339,8130466,1188127
1,-1,8,6942339,8130466,1188127
1,-1,8,6942339,8130466,1188127
1,-1,8,6942339,8130466,1188127
1,-1,8,6942339,8130466,1188127
1,-1,8,6942339,8130466,1188127
1,-1,8,6942339,8130466,1188127
1,-1,8,6942339,8130466,1188127
1,-1,8,6942339,8130466,1188127
1,-1,8,6942339,8130466,1188127
1,-1,8,6942339,8130466,1188127
1,-1,8,6942339,8130466,1188127
1,-1,8,6942339,8130466,1188127
1,-1,8,6942339,8130466,1188127
1,-1,8,6942339,8130466,1188127
1,-1,8,6942339,8130466,1188127
1,-1,8,6942339,8130466,1188127
1,-1,8,6942339,8130466,1188127
1,-1,8,6942339,8130466,1188127
1,-1,8,6942339,8130466,1188127
1,-1,8,6942339,8130466,1188127
1,-1,8,6942339,8130466,1188127
1,-1,8,6942339,8130466,1188127
1,-1,8,6942339,8130466,1188127
1,-1,8,6942339,8130466,1188127
1,-1,8,6942339,8130466,1188127
1,-1,8,6942339,8130466,1188127
1,-1,8,6942339,8130466,1188127
1,-1,8,6942339,8130466,1188127
1,-1,8,6942339,8130466,1188127
1,-1,8,6942339,8130466,1188127
1,-1,8,6942339,8130466,1188127
1,-1,8,6942339,8130466,1188127
1,-1,8,6942339,8130466,1188127
1,-1,8,6942339,8130466,1188127
1,-1,8,6942339,8130466,1188127
1,-1,8,6942339,8130466,1188127
1,-1,8,6942339,8130466,1188127
1,-1,8,6942339,8145238,1202899
1,-1,8,6942339,8145238,1202899
1,-1,8,6942339,8145238,1202899
1,-1,8,6942339,8145238,1202899
1,-1,8,6942339,8145238,1202899
1,-1,8,6942339,8167155,1224816
1,-1,8,6942339,8167155,1224816
1,-1,8,6942339,8167155,1224816
1,-1,8,6942339,8167155,1224816
1,-1,8,6942339,8167155,1224816
1,1,8,6961183,12157391,5196208
1,-1,8,6961220,8145238,1184018
1,-1,8,6961220,8145238,1184018
1,-1,8,6961220,8145238,1184018
1,-1,8,6961220,8167155,1205935
1,1,8,6999219,38553064,31553845
1,-1,8,7000480,7752596,752116
1,-1,8,7000481,8054556,1054075
1,-1,8,7025440,7891743,866303
1,-1,8,7025440,7927953,902513
1,-1,8,7025440,7957093,931653
1,-1,8,7025440,7957093,931653
1,-1,8,7025440,7977100,951660
1,-1,8,7025440,7977100,951660
1,-1,8,7025440,7977100,951660
1,-1,8,7025440,7977100,951660
1,-1,8,7025440,7977100,951660
1,-1,8,7025440,8054556,1029116
1,-1,8,7025440,8079850,1054410
1,-1,8,7025440,8079850,1054410
1,-1,8,7025440,8079850,1054410
1,-1,8,7025440,8079850,1054410
1,-1,8,7025440,8079850,1054410
1,-1,8,7025440,8094715,1069275
1,-1,8,7025440,8094715,1069275
1,-1,8,7025440,8094715,1069275
1,-1,8,7025440,8094715,1069275
1,-1,8,7025440,8111100,1085660
1,-1,8,7025440,8111100,1085660
1,-1,8,7025440,8167155,1141715
-1,-1,8,7045386,8079912,1034526
1,-1,8,7045454,7916703,871249
1,-1,8,7045454,7927953,882499
1,-1,8,7045454,7957093,911639
1,-1,8,7045454,7957093,911639
1,-1,8,7045454,7957093,911639
1,-1,8,7045454,8079850,1034396
1,-1,8,7045454,8079850,1034396
-1,-1,8,7053186,7691960,638774
-1,-1,8,7053186,7691960,638774
-1,-1,8,7053186,7752586,699400
-1,-1,8,7053186,7752586,699400
-1,-1,8,7053186,7752586,699400
-1,-1,8,7053186,7752586,699400
-1,-1,8,7053186,7752586,699400
-1,-1,8,7053186,7752586,699400
-1,-1,8,7053186,7752586,699400
-1,-1,8,7053186,7752586,699400
-1,-1,8,7053186,7752586,699400
-1,-1,8,7053186,7752586,699400
-1,-1,8,7053186,7752586,699400
-1,-1,8,7053186,7752586,699400
-1,-1,8,7053186,7752586,699400
-1,-1,8,7053186,7752586,699400
-1,-1,8,7053186,7752586,699400
-1,-1,8,7053186,7752586,699400
-1,-1,8,7053186,7806229,753043
-1,-1,8,7053186,7806229,753043
-1,-1,8,7053186,7806229,753043
-1,-1,8,7053186,8079920,1026734
1,-1,8,7053186,8079920,1026734
-1,-1,8,7053186,8079920,1026734
-1,-1,8,7053186,8079920,1026734
-1,-1,8,7053186,8079920,1026734
-1,-1,8,7053186,8079920,1026734
-1,-1,8,7053186,8079920,1026734
-1,-1,8,7053186,8079920,1026734
-1,-1,8,7053186,8079920,1026734
-1,-1,8,7053186,8079920,1026734
-1,-1,8,7053186,8079920,1026734
-1,-1,8,7053186,8079920,1026734
-1,-1,8,7053186,8079920,1026734
-1,-1,8,7053186,8079920,1026734
-1,-1,8,7053186,8079920,1026734
-1,-1,8,7053186,8079920,1026734
-1,-1,8,7053186,8079920,1026734
-1,-1,8,7053186,8079920,1026734
-1,-1,8,7053186,8079920,1026734
-1,-1,8,7053186,8079920,1026734
-1,-1,8,7053186,8079920,1026734
-1,-1,8,7053186,8079920,1026734
-1,-1,8,7053186,8079920,1026734
-1,-1,8,7053186,8079920,1026734
-1,-1,8,7053186,8130689,1077503
-1,-1,8,7053186,8130689,1077503
1,1,8,7053186,11805960,4752774
-1,-1,8,7053196,7691845,638649
-1,-1,8,7053196,7752596,699400
-1,-1,8,7053196,7752596,699400
-1,-1,8,7053196,7752596,699400
-1,-1,8,7053196,7752596,699400
-1,-1,8,7053196,7752596,699400
-1,-1,8,7053196,7752596,699400
-1,-1,8,7053196,7752596,699400
-1,-1,8,7053196,7806227,753031
-1,-1,8,7053196,7806227,753031
-1,-1,8,7053196,7806227,753031
-1,-1,8,7053196,7806227,753031
-1,-1,8,7053196,7806227,753031
-1,-1,8,7053196,7806227,753031
-1,-1,8,7053196,7806227,753031
-1,-1,8,7053196,7806227,753031
-1,-1,8,7053196,7806227,753031
-1,-1,8,7053196,8079912,1026716
-1,-1,8,7053196,8079912,1026716
-1,-1,8,7053196,8079912,1026716
-1,-1,8,7053196,8079912,1026716
-1,-1,8,7053196,8079912,1026716
-1,-1,8,7053196,8079912,1026716
-1,-1,8,7053196,8079912,1026716
-1,-1,8,7053196,8079912,1026716
-1,-1,8,7053196,8079912,1026716
-1,-1,8,7053196,8079912,1026716
-1,-1,8,7053196,8079912,1026716
-1,-1,8,7053196,8130631,1077435
1,-1,8,7053207,7806163,752956
1,-1,8,7053207,7891743,838536
1,-1,8,7053207,7891743,838536
1,-1,8,7053207,7957093,903886
1,-1,8,7053207,7977100,923893
1,-1,8,7063187,7806223,743036
-1,-1,8,7074596,7927992,853396
-1,-1,8,7074596,8079912,1005316
1,-1,8,7079732,7891743,812011
1,-1,8,7079732,7916703,836971
1,-1,8,7079732,7916703,836971
1,-1,8,7079732,7916703,836971
1,-1,8,7079732,7916703,836971
1,-1,8,7079732,7916703,836971
1,-1,8,7079732,7927953,848221
1,-1,8,7079732,7957093,877361
1,-1,8,7079732,7957093,877361
1,-1,8,7079732,8054556,974824
1,-1,8,7079732,8094715,1014983
1,-1,8,7079732,8111100,1031368
-1,-1,8,7110810,7430402,319592
-1,-1,8,7088174,7891743,803569
1,-1,8,7088174,7891743,803569
1,-1,8,7088174,7916703,828529
1,-1,8,7088174,7916703,828529
1,-1,8,7088174,8111100,1022926
-1,-1,8,7110811,7881316,770505
-1,-1,8,7110811,7891794,780983
-1,-1,8,7110811,8079912,969101
-1,-1,8,7113659,7430402,316743
-1,-1,8,7113659,7430402,316743
-1,-1,8,7113659,7430402,316743
-1,-1,8,7113659,7430402,316743
-1,-1,8,7113659,7430402,316743
-1,-1,8,7113659,7430402,316743
-1,-1,8,7113659,7430402,316743
-1,-1,8,7113659,7430402,316743
-1,-1,8,7113659,7430402,316743
-1,-1,8,7113659,7430402,316743
-1,-1,8,7113659,7430402,316743
-1,-1,8,7113659,7430402,316743
-1,-1,8,7113659,7430402,316743
-1,-1,8,7113659,7430402,316743
-1,-1,8,7113659,7430402,316743
-1,-1,8,7113659,7430402,316743
-1,-1,8,7113659,7430402,316743
-1,-1,8,7113659,7430402,316743
-1,-1,8,7113659,7430402,316743
-1,-1,8,7113659,7430402,316743
-1,-1,8,7113659,7430402,316743
-1,-1,8,7113659,7430402,316743
-1,-1,8,7113659,7430402,316743
-1,-1,8,7113659,7430402,316743
-1,-1,8,7113659,7430402,316743
-1,-1,8,7113659,7430402,316743
-1,-1,8,7113659,7430402,316743
-1,-1,8,7113659,7430402,316743
-1,-1,8,7113659,7430402,316743
-1,-1,8,7113659,7430402,316743
-1,-1,8,7113659,7430402,316743
-1,-1,8,7113659,7430402,316743
-1,-1,8,7113659,7430402,316743
-1,-1,8,7113659,7430402,316743
-1,-1,8,7113659,7430402,316743
-1,-1,8,7113659,7430402,316743
-1,-1,8,7113659,7430402,316743
-1,-1,8,7113659,7430402,316743
-1,-1,8,7113659,7430402,316743
-1,-1,8,7113659,7430402,316743
-1,-1,8,7113659,7430402,316743
-1,-1,8,7113659,7430402,316743
-1,-1,8,7113659,7430402,316743
-1,-1,8,7113659,7430402,316743
-1,-1,8,7113659,7430402,316743
-1,-1,8,7113659,7430402,316743
-1,-1,8,7113659,7430402,316743
-1,-1,8,7113659,7430402,316743
-1,-1,8,7113659,7430402,316743
-1,-1,8,7113659,7430402,316743
-1,-1,8,7113659,7430402,316743
-1,-1,8,7113659,7430402,316743
-1,-1,8,7113659,7430402,316743
-1,-1,8,7113659,7430402,316743
-1,-1,8,7113659,7430402,316743
-1,-1,8,7113659,7430402,316743
-1,-1,8,7113659,7430402,316743
-1,-1,8,7113659,7430402,316743
-1,-1,8,7113659,7430402,316743
-1,-1,8,7113659,7430402,316743
-1,-1,8,7113659,7430402,316743
-1,-1,8,7113659,7430402,316743
1,-1,8,7110870,7632386,521516
-1,-1,8,7110870,7891743,780873
-1,-1,8,7110870,7891743,780873
1,-1,8,7110870,7891743,780873
1,-1,8,7110870,7891743,780873
-1,-1,8,7110870,7891743,780873
1,-1,8,7110870,7891743,780873
1,-1,8,7110870,7891743,780873
1,-1,8,7110870,7891743,780873
1,-1,8,7110870,7891743,780873
1,-1,8,7110870,7891743,780873
1,-1,8,7110870,7891743,780873
-1,-1,8,7110870,7891743,780873
1,-1,8,7110870,7891743,780873
1,-1,8,7110870,7891743,780873
-1,-1,8,7110870,7891743,780873
1,-1,8,7110870,7891743,780873
1,-1,8,7110870,7891743,780873
1,-1,8,7110870,7891743,780873
-1,-1,8,7110870,7891743,780873
1,-1,8,7110870,7891743,780873
1,-1,8,7110870,7891743,780873
1,-1,8,7110870,7891743,780873
1,-1,8,7110870,7891743,780873
1,-1,8,7110870,7891743,780873
-1,-1,8,7110870,7891743,780873
1,-1,8,7110870,7916703,805833
1,-1,8,7110870,7916703,805833
1,-1,8,7110870,7916703,805833
1,-1,8,7110870,7916703,805833
1,-1,8,7110870,7916703,805833
1,-1,8,7110870,7916703,805833
-1,-1,8,7110870,7927953,817083
1,-1,8,7110870,7927953,817083
1,-1,8,7110870,7957093,846223
1,-1,8,7110870,7977100,866230
1,-1,8,7110870,8111100,1000230
1,-1,8,7110870,8167155,1056285
1,-1,8,7113656,7151825,38169
1,-1,8,7113656,7151825,38169
-1,-1,8,7113656,7151825,38169
-1,-1,8,7113656,7151825,38169
1,-1,8,7113656,7151825,38169
-1,-1,8,7113656,7881316,767660
1,-1,8,7113656,7881316,767660
-1,-1,8,7113656,7881316,767660
1,-1,8,7113656,7881316,767660
-1,-1,8,7113656,7881316,767660
-1,-1,8,7113656,7881316,767660
-1,-1,8,7113656,7881316,767660
-1,-1,8,7113656,7881316,767660
-1,-1,8,7113656,7881316,767660
1,-1,8,7113656,7881316,767660
-1,-1,8,7113656,8046312,932656
-1,-1,8,7113656,8079912,966256
-1,-1,8,7113659,7806223,692564
1,-1,8,7113659,7806223,692564
1,-1,8,7113659,7806223,692564
-1,-1,8,7113659,7838937,725278
-1,-1,8,7113659,7838937,725278
-1,-1,8,7113661,8079920,966259
-1,-1,8,7136520,7430402,293882
-1,-1,8,7136520,7430402,293882
-1,-1,8,7136520,7430402,293882
-1,-1,8,7136520,7430402,293882
-1,-1,8,7136520,7430402,293882
-1,-1,8,7136520,7430402,293882
-1,-1,8,7144115,7430402,286287
-1,-1,8,7144115,7430402,286287
-1,-1,8,7144115,7430402,286287
-1,-1,8,7144115,7430402,286287
-1,-1,8,7144115,7430402,286287
-1,-1,8,7144115,7430402,286287
-1,-1,8,7144115,7430402,286287
-1,-1,8,7144115,7430402,286287
-1,-1,8,7144115,7430402,286287
-1,-1,8,7144115,7430402,286287
-1,-1,8,7144115,7430402,286287
-1,-1,8,7144115,7430402,286287
-1,-1,8,7144115,7430402,286287
1,-1,8,7136579,7891743,755164
-1,-1,8,7136579,7916703,780124
-1,-1,8,7158248,7403699,245451
-1,-1,8,7158248,7408264,250016
-1,-1,8,7158248,7430402,272154
-1,-1,8,7158248,7430402,272154
-1,-1,8,7158248,7430402,272154
-1,-1,8,7158248,7430402,272154
-1,-1,8,7158248,7430402,272154
-1,-1,8,7158248,7430402,272154
-1,-1,8,7158248,7430402,272154
-1,-1,8,7158248,7430402,272154
-1,-1,8,7158248,7430402,272154
1,-1,8,7151823,8079850,928027
1,-1,8,7151823,8079850,928027
1,-1,8,7151823,8079850,928027
1,-1,8,7151823,8111100,959277
1,-1,8,7151823,8111100,959277
-1,-1,8,7158253,7806223,647970
1,-1,8,7158253,7838937,680684
-1,-1,8,7169497,7403699,234202
-1,-1,8,7169497,7403699,234202
-1,-1,8,7169497,7403699,234202
-1,-1,8,7169497,7403699,234202
-1,-1,8,7169497,7403699,234202
-1,-1,8,7169497,7403699,234202
-1,-1,8,7169497,7403699,234202
-1,-1,8,7169497,7403699,234202
-1,-1,8,7169497,7403699,234202
-1,-1,8,7169497,7403699,234202
-1,-1,8,7169497,7403699,234202
-1,-1,8,7169497,7403699,234202
-1,-1,8,7169497,7408264,238767
1,-1,8,7169490,7403681,234191
1,-1,8,7169490,7403681,234191
-1,-1,8,7169490,7691960,522470
1,-1,8,7169490,7691960,522470
1,-1,8,7169490,7752586,583096
-1,-1,8,7169490,7752586,583096
-1,-1,8,7169490,7752586,583096
-1,-1,8,7169490,7752586,583096
1,-1,8,7169490,7752586,583096
-1,-1,8,7169490,7752586,583096
-1,-1,8,7169490,7752586,583096
-1,-1,8,7169490,7806229,636739
1,-1,8,7169490,7806229,636739
-1,-1,8,7169490,7806229,636739
-1,-1,8,7169490,7806229,636739
-1,-1,8,7169490,7806229,636739
1,-1,8,7169490,7806229,636739
-1,-1,8,7169490,7806229,636739
1,-1,8,7169490,7806229,636739
-1,-1,8,7169490,7806229,636739
1,-1,8,7169490,7806229,636739
-1,-1,8,7169490,7806229,636739
-1,-1,8,7169490,7806229,636739
1,-1,8,7169490,7806229,636739
-1,-1,8,7169490,7806229,636739
-1,-1,8,7169490,8079920,910430
1,-1,8,7169490,8079920,910430
1,-1,8,7169490,8079920,910430
-1,-1,8,7169490,8079920,910430
-1,-1,8,7169490,8079920,910430
-1,-1,8,7169490,8079920,910430
1,-1,8,7169490,8079920,910430
-1,-1,8,7169490,8079920,910430
1,-1,8,7169490,8079920,910430
1,-1,8,7169490,8079920,910430
-1,-1,8,7169490,8094773,925283
1,1,8,7169490,12404062,5234572
-1,1,8,7169490,12404062,5234572
-1,-1,8,7169510,7691845,522335
-1,-1,8,7169510,7691845,522335
-1,-1,8,7169510,7691845,522335
-1,-1,8,7169510,7691845,522335
-1,-1,8,7169510,7691845,522335
-1,-1,8,7169510,7691845,522335
1,-1,8,7169510,7691845,522335
-1,-1,8,7169510,7691845,522335
-1,-1,8,7169510,7691845,522335
-1,-1,8,7169510,7691845,522335
-1,-1,8,7169510,7691845,522335
-1,-1,8,7169510,7691845,522335
-1,-1,8,7169510,7691845,522335
-1,-1,8,7169510,7691845,522335
-1,-1,8,7169510,7691845,522335
-1,-1,8,7169510,7691845,522335
-1,-1,8,7169510,7691845,522335
-1,-1,8,7169510,7691845,522335
-1,-1,8,7169510,7691845,522335
-1,-1,8,7169510,7691845,522335
-1,-1,8,7169510,7691845,522335
-1,-1,8,7169510,7691845,522335
-1,-1,8,7169510,7691845,522335
-1,-1,8,7169510,7691845,522335
-1,-1,8,7169510,7691845,522335
-1,-1,8,7169510,7752596,583086
-1,-1,8,7169510,7752596,583086
-1,-1,8,7169510,7752596,583086
-1,-1,8,7169510,7752596,583086
-1,-1,8,7169510,7752596,583086
-1,-1,8,7169510,7752596,583086
-1,-1,8,7169510,7752596,583086
-1,-1,8,7169510,7752596,583086
-1,-1,8,7169510,7752596,583086
-1,-1,8,7169510,7752596,583086
-1,-1,8,7169510,7752596,583086
-1,-1,8,7169510,7752596,583086
-1,-1,8,7169510,7752596,583086
-1,-1,8,7169510,7752596,583086
-1,-1,8,7169510,7752596,583086
-1,-1,8,7169510,7752596,583086
-1,-1,8,7169510,7752596,583086
-1,-1,8,7169510,7752596,583086
1,-1,8,7169510,7752596,583086
-1,-1,8,7169510,7752596,583086
-1,-1,8,7169510,7752596,583086
1,-1,8,7169510,7752596,583086
-1,-1,8,7169510,7752596,583086
-1,-1,8,7169510,7752596,583086
-1,-1,8,7169510,7752596,583086
-1,-1,8,7169510,7752596,583086
-1,-1,8,7169510,7752596,583086
-1,-1,8,7169510,7752596,583086
-1,-1,8,7169510,7752596,583086
-1,-1,8,7169510,7752596,583086
-1,-1,8,7169510,7752596,583086
-1,-1,8,7169510,7752596,583086
-1,-1,8,7169510,7752596,583086
1,-1,8,7169510,7752596,583086
-1,-1,8,7169510,7752596,583086
-1,-1,8,7169510,7752596,583086
-1,-1,8,7169510,7752596,583086
-1,-1,8,7169510,7752596,583086
-1,-1,8,7169510,7752596,583086
-1,-1,8,7169510,7752596,583086
-1,-1,8,7169510,7752596,583086
-1,-1,8,7169510,7752596,583086
-1,-1,8,7169510,7752596,583086
-1,-1,8,7169510,7752596,583086
-1,-1,8,7169510,7752596,583086
-1,-1,8,7169510,7752596,583086
-1,-1,8,7169510,7752596,583086
1,-1,8,7169510,7752596,583086
1,-1,8,7169510,7752596,583086
-1,-1,8,7169510,7752596,583086
1,-1,8,7169510,7752596,583086
-1,-1,8,7169510,7752596,583086
-1,-1,8,7169510,7752596,583086
-1,-1,8,7169510,7752596,583086
1,-1,8,7169510,7752596,583086
-1,-1,8,7169510,7752596,583086
-1,-1,8,7169510,7752596,583086
-1,-1,8,7169510,7752596,583086
-1,-1,8,7169510,7752596,583086
-1,-1,8,7169510,7752596,583086
-1,-1,8,7169510,7752596,583086
-1,-1,8,7169510,7752596,583086
-1,-1,8,7169510,7752596,583086
-1,-1,8,7169510,7752596,583086
-1,-1,8,7169510,7752596,583086
-1,-1,8,7169510,7752596,583086
-1,-1,8,7169510,7752596,583086
-1,-1,8,7169510,7752596,583086
-1,-1,8,7169510,7752596,583086
-1,-1,8,7169510,7752596,583086
1,-1,8,7169510,7752596,583086
-1,-1,8,7169510,7752596,583086
-1,-1,8,7169510,7752596,583086
-1,-1,8,7169510,7752596,583086
1,-1,8,7169510,7752596,583086
-1,-1,8,7169510,7752596,583086
-1,-1,8,7169510,7752596,583086
-1,-1,8,7169510,7752596,583086
-1,-1,8,7169510,7752596,583086
-1,-1,8,7169510,7752596,583086
-1,-1,8,7169510,7752596,583086
-1,-1,8,7169510,7752596,583086
-1,-1,8,7169510,7806227,636717
-1,-1,8,7169510,7806227,636717
-1,-1,8,7169510,7806227,636717
-1,-1,8,7169510,7806227,636717
-1,-1,8,7169510,7806227,636717
-1,-1,8,7169510,7806227,636717
-1,-1,8,7169510,7806227,636717
-1,-1,8,7169510,7806227,636717
1,-1,8,7169510,7806227,636717
-1,-1,8,7169510,7806227,636717
-1,-1,8,7169510,7806227,636717
-1,-1,8,7169510,7806227,636717
-1,-1,8,7169510,7806227,636717
-1,-1,8,7169510,7806227,636717
-1,-1,8,7169510,7806227,636717
-1,-1,8,7169510,7806227,636717
-1,-1,8,7169510,7806227,636717
-1,-1,8,7169510,7806227,636717
-1,-1,8,7169510,7806227,636717
-1,-1,8,7169510,7806227,636717
-1,-1,8,7169510,7806227,636717
-1,-1,8,7169510,7806227,636717
-1,-1,8,7169510,7806227,636717
1,-1,8,7169510,7806227,636717
-1,-1,8,7169510,7806227,636717
-1,-1,8,7169510,7806227,636717
-1,-1,8,7169510,7806227,636717
-1,-1,8,7169510,7806227,636717
1,-1,8,7169510,7806227,636717
-1,-1,8,7169510,7806227,636717
1,-1,8,7169510,7806227,636717
-1,-1,8,7169510,7806227,636717
-1,-1,8,7169510,7806227,636717
1,-1,8,7169510,7806227,636717
-1,-1,8,7169510,7806227,636717
1,-1,8,7169510,7806227,636717
-1,-1,8,7169510,7806227,636717
-1,-1,8,7169510,7806227,636717
-1,-1,8,7169510,7806227,636717
-1,-1,8,7169510,7806227,636717
-1,-1,8,7169510,7806227,636717
-1,-1,8,7169510,7806227,636717
1,-1,8,7169510,7806227,636717
-1,-1,8,7169510,7806227,636717
-1,-1,8,7169510,7806227,636717
1,-1,8,7169510,7806227,636717
-1,-1,8,7169510,7806227,636717
-1,-1,8,7169510,7806227,636717
-1,-1,8,7169510,7806227,636717
-1,-1,8,7169510,7806227,636717
1,-1,8,7169510,7806227,636717
1,-1,8,7169510,7806227,636717
-1,-1,8,7169510,7806227,636717
-1,-1,8,7169510,7806227,636717
-1,-1,8,7169510,7806227,636717
-1,-1,8,7169510,7806227,636717
-1,-1,8,7169510,7806227,636717
-1,-1,8,7169510,7806227,636717
-1,-1,8,7169510,7806227,636717
1,-1,8,7169510,7806227,636717
-1,-1,8,7169510,7806227,636717
-1,-1,8,7169510,7806227,636717
1,-1,8,7169510,7806227,636717
1,-1,8,7169510,7806227,636717
1,-1,8,7169510,7806227,636717
-1,-1,8,7169510,7806227,636717
-1,-1,8,7169510,7806227,636717
-1,-1,8,7169510,7806227,636717
1,-1,8,7169510,7806227,636717
1,-1,8,7169510,7806227,636717
-1,-1,8,7169510,7806227,636717
1,-1,8,7169510,7806227,636717
1,-1,8,7169510,7806227,636717
-1,-1,8,7169510,7806227,636717
1,-1,8,7169510,7806227,636717
1,-1,8,7169510,7806227,636717
-1,-1,8,7169510,7806227,636717
1,-1,8,7169510,7806227,636717
1,-1,8,7169510,7806227,636717
-1,-1,8,7169510,7806227,636717
-1,-1,8,7169510,7806227,636717
1,-1,8,7169510,7806227,636717
1,-1,8,7169510,7806227,636717
-1,-1,8,7169510,7806227,636717
1,-1,8,7169510,7806227,636717
-1,-1,8,7169510,7806227,636717
-1,-1,8,7169510,7806227,636717
-1,-1,8,7169510,7806227,636717
1,-1,8,7169510,7806227,636717
-1,-1,8,7169510,7806227,636717
1,-1,8,7169510,7806227,636717
-1,-1,8,7169510,7806227,636717
1,-1,8,7169510,7806227,636717
1,-1,8,7169510,7806227,636717
-1,-1,8,7169510,7806227,636717
-1,-1,8,7169510,7806227,636717
-1,-1,8,7169510,7806227,636717
-1,-1,8,7169510,7806227,636717
-1,-1,8,7169510,7806227,636717
-1,-1,8,7169510,7806227,636717
-1,-1,8,7169510,7806227,636717
1,-1,8,7169510,7806227,636717
-1,-1,8,7169510,7881316,711806
-1,-1,8,7169510,8079912,910402
-1,-1,8,7169510,8079912,910402
-1,-1,8,7169510,8079912,910402
-1,-1,8,7169510,8079912,910402
-1,-1,8,7169510,8079912,910402
-1,-1,8,7169510,8079912,910402
-1,-1,8,7169510,8079912,910402
-1,-1,8,7169510,8079912,910402
-1,-1,8,7169510,8079912,910402
-1,-1,8,7169510,8079912,910402
-1,-1,8,7169510,8079912,910402
-1,-1,8,7169510,8079912,910402
1,-1,8,7169510,8079912,910402
-1,-1,8,7169510,8079912,910402
-1,-1,8,7169510,8079912,910402
-1,-1,8,7169510,8079912,910402
1,-1,8,7169510,8079912,910402
-1,-1,8,7169510,8079912,910402
-1,-1,8,7169510,8079912,910402
-1,-1,8,7169510,8079912,910402
-1,-1,8,7169510,8079912,910402
-1,-1,8,7169510,8079912,910402
-1,-1,8,7169510,8079912,910402
1,-1,8,7169510,8079912,910402
-1,-1,8,7169510,8079912,910402
-1,-1,8,7169510,8079912,910402
-1,-1,8,7169510,8079912,910402
-1,-1,8,7169510,8079912,910402
-1,-1,8,7169510,8079912,910402
1,-1,8,7169510,8079912,910402
-1,-1,8,7169510,8079912,910402
1,-1,8,7169510,8079912,910402
-1,-1,8,7169510,8079912,910402
-1,-1,8,7169510,8079912,910402
-1,-1,8,7169510,8079912,910402
1,-1,8,7169510,8079912,910402
1,-1,8,7169510,8079912,910402
-1,-1,8,7169510,8079912,910402
-1,-1,8,7169510,8079912,910402
-1,-1,8,7169510,8079912,910402
1,-1,8,7169510,8079912,910402
-1,-1,8,7169510,8079912,910402
-1,-1,8,7169510,8079912,910402
-1,-1,8,7169510,8079912,910402
1,-1,8,7169510,8079912,910402
1,-1,8,7169510,8079912,910402
-1,-1,8,7169510,8079912,910402
-1,-1,8,7169510,8079912,910402
-1,-1,8,7169510,8079912,910402
-1,-1,8,7169510,8079912,910402
1,-1,8,7169510,8079912,910402
1,-1,8,7169510,8079912,910402
1,-1,8,7169510,8079912,910402
1,-1,8,7169510,8079912,910402
-1,-1,8,7169510,8079912,910402
1,-1,8,7169510,8079912,910402
-1,-1,8,7169510,8079912,910402
1,-1,8,7169510,8079912,910402
-1,-1,8,7169510,8079912,910402
-1,-1,8,7169510,8079912,910402
1,-1,8,7169510,8079912,910402
-1,-1,8,7169510,8079912,910402
-1,-1,8,7169510,8079912,910402
-1,-1,8,7169510,8079912,910402
1,-1,8,7169510,8079912,910402
1,-1,8,7169510,8079912,910402
-1,-1,8,7169510,8079912,910402
1,-1,8,7169510,8079912,910402
-1,-1,8,7169510,8079912,910402
-1,-1,8,7169510,8079912,910402
1,-1,8,7169510,8079912,910402
-1,-1,8,7169510,8079912,910402
-1,-1,8,7169510,8079912,910402
-1,-1,8,7169510,8079912,910402
-1,-1,8,7169510,8079912,910402
-1,-1,8,7169510,8079912,910402
-1,-1,8,7169510,8079912,910402
-1,-1,8,7169510,8079912,910402
1,-1,8,7169510,8079912,910402
-1,-1,8,7169510,8079912,910402
1,-1,8,7169510,8079912,910402
-1,-1,8,7169510,8079912,910402
1,-1,8,7169510,8079912,910402
1,-1,8,7169510,8079912,910402
-1,-1,8,7169510,8079912,910402
-1,-1,8,7169510,8079912,910402
1,-1,8,7169510,8079912,910402
-1,-1,8,7169510,8079912,910402
1,-1,8,7169510,8079912,910402
1,-1,8,7169510,8079912,910402
1,-1,8,7169510,8079912,910402
-1,-1,8,7169510,8079912,910402
-1,-1,8,7169510,8079912,910402
1,-1,8,7169510,8079912,910402
-1,-1,8,7169510,8079912,910402
-1,-1,8,7169510,8079912,910402
1,-1,8,7169510,8079912,910402
1,-1,8,7169510,8079912,910402
1,-1,8,7169510,8079912,910402
-1,-1,8,7169510,8079912,910402
-1,-1,8,7169510,8079912,910402
-1,-1,8,7169510,8079912,910402
1,-1,8,7169510,8079912,910402
-1,-1,8,7169510,8079912,910402
1,-1,8,7169510,8130631,961121
1,-1,8,7169510,8130631,961121
1,-1,8,7169510,8130631,961121
1,-1,8,7169510,8130631,961121
1,-1,8,7169510,8130631,961121
-1,-1,8,7169520,7659644,490124
1,-1,8,7169520,7779236,609716
1,-1,8,7169520,7787415,617895
1,-1,8,7169520,8079890,910370
-1,-1,8,7169520,8079890,910370
-1,-1,8,7169520,8079891,910371
1,-1,8,7169557,8079850,910293
1,-1,8,7187746,7881316,693570
-1,-1,8,7214262,7418007,203745
-1,-1,8,7214262,7430402,216140
1,-1,8,7187795,8167155,979360
1,-1,8,7187795,8167155,979360
1,-1,8,7214322,7957093,742771
-1,-1,8,7239470,7806223,566753
1,-1,8,7239471,7403655,164184
-1,-1,8,7239471,7403655,164184
1,-1,8,7239471,7418030,178559
-1,-1,8,7239471,7691845,452374
-1,-1,8,7239471,7691845,452374
1,-1,8,7239471,7691845,452374
-1,-1,8,7239471,7752596,513125
1,-1,8,7239471,7752596,513125
-1,-1,8,7239471,7752596,513125
-1,-1,8,7239471,7752596,513125
1,-1,8,7239471,7752596,513125
-1,-1,8,7239471,7752596,513125
-1,-1,8,7239471,7752596,513125
-1,-1,8,7239471,7752596,513125
-1,-1,8,7239471,7752596,513125
-1,-1,8,7239471,7752596,513125
-1,-1,8,7239471,7752596,513125
-1,-1,8,7239471,7752596,513125
-1,-1,8,7239471,7752596,513125
-1,-1,8,7239471,7752596,513125
1,-1,8,7239471,7752596,513125
-1,-1,8,7239471,7752596,513125
-1,-1,8,7239471,7752596,513125
-1,-1,8,7239471,7752596,513125
-1,-1,8,7239471,7752596,513125
-1,-1,8,7239471,7752596,513125
-1,-1,8,7239471,7752596,513125
-1,-1,8,7239471,7752596,513125
1,-1,8,7239471,7806227,566756
-1,-1,8,7239471,7806227,566756
1,-1,8,7239471,7806227,566756
1,-1,8,7239471,7806227,566756
1,-1,8,7239471,7806227,566756
-1,-1,8,7239471,7806227,566756
-1,-1,8,7239471,7806227,566756
1,-1,8,7239471,7806227,566756
1,-1,8,7239471,7806227,566756
-1,-1,8,7239471,7806227,566756
-1,-1,8,7239471,7806227,566756
1,-1,8,7239471,7806227,566756
1,-1,8,7239471,7806227,566756
1,-1,8,7239471,7806227,566756
-1,-1,8,7239471,7806227,566756
1,-1,8,7239471,8079912,840441
1,-1,8,7239471,8079912,840441
1,-1,8,7239471,8079912,840441
-1,-1,8,7239471,8079912,840441
1,-1,8,7239471,8079912,840441
1,-1,8,7239471,8079912,840441
1,-1,8,7239471,8079912,840441
1,-1,8,7239471,8079912,840441
1,-1,8,7239471,8079912,840441
-1,-1,8,7239471,8079912,840441
1,-1,8,7239471,8079912,840441
1,-1,8,7239471,8079912,840441
1,-1,8,7239471,8079912,840441
1,-1,8,7239471,8079912,840441
1,-1,8,7239471,8079912,840441
1,-1,8,7239471,8079912,840441
1,-1,8,7239471,8079912,840441
-1,-1,8,7239471,8079912,840441
-1,-1,8,7239471,8079912,840441
1,-1,8,7239471,8079912,840441
1,-1,8,7239471,8079912,840441
1,-1,8,7239471,8079912,840441
1,-1,8,7239471,8079912,840441
-1,-1,8,7239471,8079912,840441
1,-1,8,7239471,8079912,840441
1,-1,8,7239471,8079912,840441
1,-1,8,7239471,8079912,840441
1,-1,8,7239471,8079912,840441
1,-1,8,7239471,8079912,840441
-1,-1,8,7239471,8079912,840441
1,-1,8,7239471,8079912,840441
1,-1,8,7239471,8079912,840441
1,-1,8,7239471,8079912,840441
-1,-1,8,7239471,8079912,840441
1,-1,8,7239471,8079912,840441
1,-1,8,7239471,8079912,840441
-1,-1,8,7239471,8079912,840441
1,-1,8,7239471,8079912,840441
1,-1,8,7239471,8079912,840441
-1,-1,8,7239471,8079912,840441
1,-1,8,7239471,8079912,840441
-1,-1,8,7239471,8079912,840441
1,-1,8,7239471,8079912,840441
-1,-1,8,7239471,8079912,840441
1,-1,8,7239471,8079912,840441
1,-1,8,7239471,8079912,840441
1,-1,8,7239471,8079912,840441
1,-1,8,7239471,8079912,840441
-1,-1,8,7239471,8079912,840441
-1,-1,8,7239471,8079912,840441
1,-1,8,7239471,8079912,840441
1,-1,8,7239471,8079912,840441
1,-1,8,7239471,8079912,840441
1,-1,8,7239471,8079912,840441
1,-1,8,7239471,8079912,840441
1,-1,8,7239471,8079912,840441
-1,-1,8,7239471,8079912,840441
1,-1,8,7239471,8079912,840441
1,-1,8,7239471,8130631,891160
1,-1,8,7239471,8130631,891160
1,-1,8,7239471,8130631,891160
1,-1,8,7239471,8130631,891160
1,-1,8,7239471,8222024,982553
1,-1,8,7239471,8222024,982553
-1,-1,8,7239491,7403681,164190
1,-1,8,7239491,7691960,452469
-1,-1,8,7239491,7752586,513095
-1,-1,8,7239491,7752586,513095
-1,-1,8,7239491,7752586,513095
-1,-1,8,7239491,7752586,513095
1,-1,8,7239491,7752586,513095
-1,-1,8,7239491,7752586,513095
-1,-1,8,7239491,7752586,513095
1,-1,8,7239491,7806229,566738
-1,-1,8,7239491,7806229,566738
-1,-1,8,7239491,7806229,566738
1,-1,8,7239491,7806229,566738
-1,-1,8,7239491,7806229,566738
-1,-1,8,7239491,7806229,566738
1,-1,8,7239491,7806229,566738
1,-1,8,7239491,7806229,566738
-1,-1,8,7239491,7806229,566738
-1,-1,8,7239491,7806229,566738
-1,-1,8,7239491,8079861,840370
-1,-1,8,7239491,8079920,840429
-1,-1,8,7239491,8079920,840429
1,-1,8,7239491,8079920,840429
-1,-1,8,7239491,8130689,891198
-1,-1,8,7239520,7371660,132140
-1,-1,8,7239520,8079890,840370
1,-1,8,7242978,7334654,91676
-1,-1,8,7268619,7752727,484108
1,-1,8,7268819,7752586,483767
-1,-1,8,7268819,7752586,483767
-1,-1,8,7268819,7752586,483767
1,-1,8,7268819,7752586,483767
-1,-1,8,7268819,7752586,483767
-1,-1,8,7268819,7752586,483767
-1,-1,8,7268819,7752586,483767
-1,-1,8,7268819,7752586,483767
-1,-1,8,7268819,7752586,483767
-1,-1,8,7268819,7752586,483767
-1,-1,8,7268819,7752586,483767
-1,-1,8,7268819,7752586,483767
-1,-1,8,7268819,7752586,483767
-1,-1,8,7268819,7752586,483767
1,-1,8,7268819,7752586,483767
-1,-1,8,7268819,7752586,483767
-1,-1,8,7268819,7752586,483767
-1,-1,8,7268819,7752586,483767
-1,-1,8,7268819,7752586,483767
-1,-1,8,7268819,7752586,483767
-1,-1,8,7268819,7752586,483767
-1,-1,8,7268819,7752586,483767
-1,-1,8,7268819,7752586,483767
-1,-1,8,7268819,7752586,483767
-1,-1,8,7268819,7752586,483767
1,-1,8,7268819,7752586,483767
-1,-1,8,7268819,7752586,483767
1,-1,8,7268819,7752586,483767
-1,-1,8,7268819,7752586,483767
-1,-1,8,7268819,7752586,483767
-1,-1,8,7268819,7752586,483767
-1,-1,8,7268819,7752586,483767
1,-1,8,7268819,7752586,483767
-1,-1,8,7268819,7752586,483767
1,-1,8,7268819,7752586,483767
-1,-1,8,7268819,7752586,483767
-1,-1,8,7268819,7752586,483767
-1,-1,8,7268819,7752586,483767
1,-1,8,7268819,7752586,483767
-1,-1,8,7268819,7752586,483767
-1,-1,8,7268819,7752586,483767
-1,-1,8,7268819,7752586,483767
-1,-1,8,7268819,7752586,483767
1,-1,8,7268819,7752586,483767
-1,-1,8,7268819,7752586,483767
-1,-1,8,7268819,7752586,483767
-1,-1,8,7268819,7752586,483767
-1,-1,8,7268819,7752586,483767
-1,-1,8,7268819,7752586,483767
-1,-1,8,7268819,7752586,483767
-1,-1,8,7268819,7752586,483767
-1,-1,8,7268819,7752586,483767
-1,-1,8,7268819,7752586,483767
-1,-1,8,7268819,7752586,483767
1,-1,8,7268819,7752586,483767
-1,-1,8,7268819,7752586,483767
-1,-1,8,7268819,7752586,483767
-1,-1,8,7268819,7752586,483767
1,-1,8,7268819,7752586,483767
-1,-1,8,7268819,7752586,483767
-1,-1,8,7268819,7752586,483767
1,-1,8,7268819,7752586,483767
1,-1,8,7268819,7752586,483767
-1,-1,8,7268819,7752586,483767
-1,-1,8,7268819,7752586,483767
1,-1,8,7268819,7752586,483767
-1,-1,8,7268819,7752586,483767
-1,-1,8,7268819,7752586,483767
-1,-1,8,7268819,7752586,483767
-1,-1,8,7268819,7752586,483767
-1,-1,8,7268819,7752586,483767
-1,-1,8,7268819,7752586,483767
-1,-1,8,7268819,7752586,483767
-1,-1,8,7268819,7752586,483767
-1,-1,8,7268819,7752586,483767
-1,-1,8,7268819,7752586,483767
-1,-1,8,7268819,7752586,483767
-1,-1,8,7268819,7752586,483767
1,-1,8,7268819,7752586,483767
-1,-1,8,7268819,7752586,483767
-1,-1,8,7268819,7752586,483767
-1,-1,8,7268819,7752586,483767
-1,-1,8,7268819,7752586,483767
-1,-1,8,7268819,7752586,483767
-1,-1,8,7268819,7752586,483767
-1,-1,8,7268819,7752586,483767
-1,-1,8,7268819,7752586,483767
-1,-1,8,7268819,7752586,483767
-1,-1,8,7268819,7752586,483767
-1,-1,8,7268819,7752586,483767
-1,-1,8,7268819,7752586,483767
1,-1,8,7268819,7752586,483767
-1,-1,8,7268819,7752586,483767
-1,-1,8,7268819,7752586,483767
-1,-1,8,7268819,7752586,483767
1,-1,8,7268819,7752586,483767
-1,-1,8,7268819,7752586,483767
1,-1,8,7268819,7752586,483767
-1,-1,8,7268819,7752586,483767
1,-1,8,7268819,7752586,483767
-1,-1,8,7268819,7752586,483767
-1,-1,8,7268819,7752586,483767
1,-1,8,7268819,7752586,483767
-1,-1,8,7268819,7752586,483767
-1,-1,8,7268819,7752586,483767
-1,-1,8,7268819,7752586,483767
-1,-1,8,7268819,7752586,483767
-1,-1,8,7268819,7752586,483767
-1,-1,8,7268819,7752586,483767
-1,-1,8,7268819,7752586,483767
-1,-1,8,7268819,7752586,483767
-1,-1,8,7268819,7752586,483767
1,-1,8,7268819,7752586,483767
-1,-1,8,7268819,7752586,483767
-1,-1,8,7268819,7752586,483767
-1,-1,8,7268819,7752586,483767
-1,-1,8,7268819,7752586,483767
-1,-1,8,7268819,7752586,483767
-1,-1,8,7268819,7752586,483767
-1,-1,8,7268819,7752586,483767
-1,-1,8,7268819,7752586,483767
-1,-1,8,7268819,7752586,483767
-1,-1,8,7268819,7752586,483767
-1,-1,8,7268819,7752586,483767
-1,-1,8,7268819,7752586,483767
-1,-1,8,7268819,7752586,483767
-1,-1,8,7268819,7752586,483767
1,-1,8,7268819,7752586,483767
-1,-1,8,7268819,7752586,483767
-1,-1,8,7268819,7752586,483767
-1,-1,8,7268819,7752586,483767
-1,-1,8,7268819,7752586,483767
-1,-1,8,7268819,7752586,483767
-1,-1,8,7268819,7752586,483767
-1,-1,8,7268819,7752586,483767
-1,-1,8,7268819,7752586,483767
-1,-1,8,7268819,7752586,483767
-1,-1,8,7268819,7752586,483767
-1,-1,8,7268819,7752586,483767
-1,-1,8,7268819,7752586,483767
-1,-1,8,7268819,7752586,483767
1,-1,8,7268819,7752586,483767
-1,-1,8,7268819,7752586,483767
-1,-1,8,7268819,7752586,483767
-1,-1,8,7268819,7752586,483767
-1,-1,8,7268819,7752586,483767
-1,-1,8,7268819,7752586,483767
-1,-1,8,7268819,7752586,483767
-1,-1,8,7268819,7752586,483767
-1,-1,8,7268819,7752586,483767
-1,-1,8,7268819,7752586,483767
-1,-1,8,7268819,7752586,483767
-1,-1,8,7268819,7752586,483767
-1,-1,8,7268819,7752586,483767
1,-1,8,7268819,7752586,483767
-1,-1,8,7268819,7752586,483767
-1,-1,8,7268819,7752586,483767
-1,-1,8,7268819,7752586,483767
-1,-1,8,7268819,7752586,483767
-1,-1,8,7268819,7752586,483767
-1,-1,8,7268819,7752586,483767
-1,-1,8,7268819,7752586,483767
-1,-1,8,7268819,7752586,483767
-1,-1,8,7268819,7752586,483767
-1,-1,8,7268819,7752586,483767
-1,-1,8,7268819,7752586,483767
1,-1,8,7268819,7752586,483767
-1,-1,8,7268819,7752586,483767
-1,-1,8,7268819,7752586,483767
-1,-1,8,7268819,7752586,483767
-1,-1,8,7268819,7752586,483767
-1,-1,8,7268819,7752586,483767
1,-1,8,7268819,7752586,483767
-1,-1,8,7268819,7752586,483767
-1,-1,8,7268819,7752586,483767
-1,-1,8,7268819,7752586,483767
-1,-1,8,7268819,7752586,483767
1,-1,8,7268819,7752586,483767
-1,-1,8,7268819,7752586,483767
-1,-1,8,7268819,7752586,483767
-1,-1,8,7268819,7752586,483767
-1,-1,8,7268819,7752586,483767
-1,-1,8,7268819,7752586,483767
-1,-1,8,7268819,7752586,483767
-1,-1,8,7268819,7752586,483767
-1,-1,8,7268819,7752586,483767
-1,-1,8,7268819,7752586,483767
-1,-1,8,7268819,7752586,483767
1,-1,8,7268819,7752586,483767
1,-1,8,7268819,7752586,483767
-1,-1,8,7268819,7752586,483767
-1,-1,8,7268819,7752586,483767
-1,-1,8,7268819,7752586,483767
-1,-1,8,7268819,7752586,483767
1,-1,8,7268819,7752586,483767
-1,-1,8,7268819,7752586,483767
1,-1,8,7268819,7752586,483767
-1,-1,8,7268819,7752586,483767
1,-1,8,7268819,7752586,483767
-1,-1,8,7268819,8079920,811101
-1,-1,8,7268819,8079920,811101
1,-1,8,7268819,8079920,811101
-1,-1,8,7268819,8079920,811101
-1,-1,8,7268819,8079920,811101
-1,-1,8,7268819,8079920,811101
-1,-1,8,7268819,8079920,811101
-1,-1,8,7268819,8079920,811101
-1,-1,8,7268819,8079920,811101
-1,-1,8,7268819,8079920,811101
-1,-1,8,7268819,8079920,811101
-1,-1,8,7268819,8079920,811101
-1,-1,8,7268819,8079920,811101
1,-1,8,7268819,8079920,811101
-1,-1,8,7268819,8079920,811101
-1,-1,8,7268819,8079920,811101
-1,-1,8,7268819,8079920,811101
-1,-1,8,7268819,8079920,811101
-1,-1,8,7268819,8079920,811101
-1,-1,8,7268819,8079920,811101
1,-1,8,7268819,8079920,811101
-1,-1,8,7268819,8079920,811101
-1,-1,8,7268819,8079920,811101
-1,-1,8,7268819,8079920,811101
-1,-1,8,7268819,8079920,811101
-1,-1,8,7268819,8079920,811101
-1,-1,8,7268819,8079920,811101
-1,-1,8,7268819,8079920,811101
-1,-1,8,7268819,8079920,811101
-1,-1,8,7268819,8079920,811101
-1,-1,8,7268819,8079920,811101
-1,-1,8,7268819,8079920,811101
-1,-1,8,7268819,8079920,811101
1,-1,8,7268819,8079920,811101
1,-1,8,7268819,8079920,811101
1,-1,8,7268819,8079920,811101
-1,-1,8,7268819,8079920,811101
-1,-1,8,7268819,8079920,811101
-1,-1,8,7268819,8079920,811101
1,-1,8,7268819,8079920,811101
1,-1,8,7268819,8079920,811101
-1,-1,8,7268819,8079920,811101
-1,-1,8,7268819,8079920,811101
-1,-1,8,7268819,8079920,811101
-1,-1,8,7268819,8079920,811101
-1,-1,8,7268819,8079920,811101
-1,-1,8,7268819,8079920,811101
1,-1,8,7268819,8079920,811101
-1,-1,8,7268819,8079920,811101
-1,-1,8,7268819,8079920,811101
1,-1,8,7268819,8079920,811101
-1,-1,8,7268819,8079920,811101
-1,-1,8,7268819,8079920,811101
-1,-1,8,7268819,8079920,811101
1,-1,8,7268819,8079920,811101
1,-1,8,7268819,8079920,811101
1,-1,8,7268819,8079920,811101
-1,-1,8,7268819,8079920,811101
-1,-1,8,7268819,8079920,811101
1,-1,8,7268819,8079920,811101
-1,-1,8,7268819,8079920,811101
-1,-1,8,7268819,8079920,811101
-1,-1,8,7268819,8079920,811101
-1,-1,8,7268819,8079920,811101
1,-1,8,7268819,8079920,811101
1,-1,8,7268819,8079920,811101
-1,-1,8,7268819,8079920,811101
1,-1,8,7268819,8079920,811101
1,-1,8,7268819,8079920,811101
-1,-1,8,7268819,8079920,811101
-1,-1,8,7268819,8079920,811101
-1,-1,8,7268819,8079920,811101
-1,-1,8,7268819,8079920,811101
-1,-1,8,7268819,8079920,811101
-1,-1,8,7268819,8079920,811101
-1,-1,8,7268819,8079920,811101
-1,-1,8,7268819,8079920,811101
-1,-1,8,7268819,8079920,811101
-1,-1,8,7268819,8079920,811101
-1,-1,8,7268819,8079920,811101
1,-1,8,7268819,8079920,811101
-1,-1,8,7268819,8079920,811101
-1,-1,8,7268819,8079920,811101
-1,-1,8,7268819,8079920,811101
-1,-1,8,7268819,8079920,811101
-1,-1,8,7268819,8079920,811101
1,-1,8,7268819,8079920,811101
1,-1,8,7268819,8079920,811101
-1,-1,8,7268819,8079920,811101
-1,-1,8,7268819,8079920,811101
1,-1,8,7268819,8079920,811101
-1,-1,8,7268819,8079920,811101
-1,-1,8,7268819,8079920,811101
-1,-1,8,7268819,8079920,811101
-1,-1,8,7268819,8079920,811101
1,-1,8,7268819,8079920,811101
-1,-1,8,7268819,8079920,811101
-1,-1,8,7268819,8079920,811101
-1,-1,8,7268819,8079920,811101
1,-1,8,7268819,8079920,811101
-1,-1,8,7268819,8079920,811101
-1,-1,8,7268819,8079920,811101
-1,-1,8,7268819,8079920,811101
-1,-1,8,7268819,8079920,811101
-1,-1,8,7268819,8079920,811101
-1,-1,8,7268819,8079920,811101
-1,-1,8,7268819,8079920,811101
-1,-1,8,7268819,8079920,811101
-1,-1,8,7268819,8079920,811101
1,-1,8,7268819,8079920,811101
-1,-1,8,7268819,8079920,811101
1,-1,8,7268819,8079920,811101
1,-1,8,7268819,8079920,811101
-1,-1,8,7268819,8079920,811101
-1,-1,8,7268819,8079920,811101
-1,-1,8,7268819,8079920,811101
-1,-1,8,7268819,8079920,811101
-1,-1,8,7268819,8079920,811101
-1,-1,8,7268819,8079920,811101
1,-1,8,7268819,8079920,811101
1,-1,8,7268819,8079920,811101
-1,-1,8,7268819,8079920,811101
1,-1,8,7268819,8079920,811101
-1,-1,8,7268819,8079920,811101
-1,-1,8,7268819,8079920,811101
-1,-1,8,7268819,8079920,811101
1,-1,8,7268819,8079920,811101
-1,-1,8,7268819,8079920,811101
-1,-1,8,7268819,8079920,811101
-1,-1,8,7268819,8079920,811101
-1,-1,8,7268819,8079920,811101
1,-1,8,7268819,8079920,811101
1,-1,8,7268819,8079920,811101
1,-1,8,7268819,8079920,811101
-1,-1,8,7268819,8079920,811101
1,-1,8,7268819,8079920,811101
-1,-1,8,7268819,8079920,811101
-1,-1,8,7268819,8079920,811101
-1,-1,8,7268819,8079920,811101
-1,-1,8,7268819,8287295,1018476
-1,1,8,7268819,11805960,4537141
-1,-1,8,7268825,7752596,483771
-1,-1,8,7268825,7752596,483771
1,-1,8,7268825,7806227,537402
1,-1,8,7268825,7806227,537402
1,-1,8,7268825,7806227,537402
1,-1,8,7268825,7806227,537402
1,-1,8,7268825,7806227,537402
1,-1,8,7268825,8079912,811087
1,-1,8,7268825,8079912,811087
1,-1,8,7268825,8079912,811087
1,-1,8,7268825,8079912,811087
1,-1,8,7268825,8079912,811087
1,-1,8,7268825,8079912,811087
1,-1,8,7268825,8079912,811087
1,-1,8,7268825,8079912,811087
1,-1,8,7268825,8130631,861806
1,-1,8,7268825,8222024,953199
1,-1,8,7268825,8222024,953199
-1,-1,8,7328610,7659644,331034
-1,-1,8,7328610,7664406,335796
-1,-1,8,7328610,7691930,363320
-1,-1,8,7370178,7752596,382418
-1,-1,8,7370178,7752596,382418
-1,-1,8,7370178,7752596,382418
-1,-1,8,7370178,7806227,436049
1,-1,8,7370178,8079912,709734
-1,-1,8,7370178,8079912,709734
1,-1,8,7370178,8079912,709734
-1,-1,8,7371630,7752586,380956
1,-1,8,7371630,7806229,434599
-1,-1,8,7371630,8079920,708290
-1,-1,8,7371630,8079920,708290
-1,-1,8,7371630,8079920,708290
-1,-1,8,7371630,8079920,708290
-1,-1,8,7371630,8079920,708290
-1,-1,8,7371630,8079920,708290
-1,-1,8,7371630,8079920,708290
-1,-1,8,7371630,8079920,708290
-1,-1,8,7371630,8079920,708290
-1,-1,8,7371630,8079920,708290
-1,-1,8,7371630,8079920,708290
-1,-1,8,7371630,8079920,708290
-1,-1,8,7371630,8079920,708290
1,-1,8,7371660,7691931,320271
1,-1,8,7403596,8079912,676316
-1,-1,8,7403622,7806229,402607
-1,-1,8,7403622,8079920,676298
-1,-1,8,7569294,7891802,322508
-1,-1,8,7569294,7891802,322508
-1,-1,8,7569354,7881293,311939
1,-1,8,7569354,8094774,525420
-1,-1,8,7572193,7881293,309100
-1,-1,8,7572193,7881293,309100
-1,-1,8,7572193,7881293,309100
-1,-1,8,7572193,7881293,309100
-1,-1,8,7572193,7881293,309100
-1,-1,8,7572193,7881293,309100
-1,-1,8,7572193,7881293,309100
-1,-1,8,7572193,7881293,309100
-1,-1,8,7572193,7881293,309100
-1,-1,8,7572193,7881293,309100
-1,-1,8,7572193,7881293,309100
-1,-1,8,7572193,7881293,309100
-1,-1,8,7572193,7881293,309100
-1,-1,8,7572193,7881293,309100
-1,-1,8,7572193,7881293,309100
-1,-1,8,7572193,7881293,309100
-1,-1,8,7572193,7881293,309100
-1,-1,8,7572193,7881293,309100
-1,-1,8,7572193,7881293,309100
-1,-1,8,7572193,7881293,309100
-1,-1,8,7572193,7881293,309100
-1,-1,8,7572193,7881293,309100
-1,-1,8,7572193,7881293,309100
-1,-1,8,7572193,7881293,309100
-1,-1,8,7572193,7881293,309100
-1,-1,8,7572193,7881293,309100
-1,-1,8,7572193,7881293,309100
-1,-1,8,7572193,7881293,309100
-1,-1,8,7572193,7881293,309100
-1,-1,8,7572193,7881293,309100
-1,-1,8,7572193,7881293,309100
-1,-1,8,7572193,7881293,309100
-1,-1,8,7572193,7881293,309100
-1,-1,8,7572193,7881293,309100
-1,-1,8,7572193,7881293,309100
-1,-1,8,7572193,7881293,309100
-1,-1,8,7572193,7881293,309100
-1,-1,8,7572193,7881293,309100
-1,-1,8,7572193,7881293,309100
-1,-1,8,7572193,7881293,309100
-1,-1,8,7572193,7881293,309100
-1,-1,8,7572193,7881293,309100
-1,-1,8,7572193,7881293,309100
-1,-1,8,7572193,7881293,309100
-1,-1,8,7572193,7881293,309100
-1,-1,8,7572193,7881293,309100
-1,-1,8,7572193,7881293,309100
-1,-1,8,7572193,7881293,309100
-1,-1,8,7572193,7881293,309100
-1,-1,8,7572193,7881293,309100
-1,-1,8,7572193,7881293,309100
-1,-1,8,7572193,7881293,309100
-1,-1,8,7572193,7881293,309100
-1,-1,8,7572193,7881293,309100
-1,-1,8,7572193,7881293,309100
-1,-1,8,7572193,7881293,309100
-1,-1,8,7572193,7881293,309100
-1,-1,8,7572193,7881293,309100
-1,-1,8,7572193,7881293,309100
-1,-1,8,7572193,7881293,309100
-1,-1,8,7572193,7881293,309100
-1,-1,8,7572193,7881293,309100
-1,-1,8,7572193,7881293,309100
-1,-1,8,7572193,7881293,309100
-1,-1,8,7572193,7881293,309100
-1,-1,8,7572193,7881293,309100
-1,-1,8,7572193,7881293,309100
-1,-1,8,7572193,7881293,309100
-1,-1,8,7572193,7881293,309100
-1,-1,8,7572193,7881293,309100
-1,-1,8,7572193,7881293,309100
-1,-1,8,7572193,7881293,309100
-1,-1,8,7572193,7881293,309100
-1,-1,8,7572193,7881293,309100
1,-1,8,7572193,8130525,558332
-1,-1,8,7572195,7618142,45947
-1,-1,8,7572195,7618142,45947
-1,-1,8,7572195,7618142,45947
-1,-1,8,7572195,7618142,45947
1,-1,8,7572195,7618142,45947
1,-1,8,7572195,7618142,45947
-1,-1,8,7579841,7806222,226381
-1,-1,8,7579841,7806222,226381
-1,-1,8,7579841,7806222,226381
-1,-1,8,7579841,7806222,226381
-1,-1,8,7579841,7806222,226381
-1,-1,8,7579841,7867163,287322
-1,-1,8,7579841,7881293,301452
-1,-1,8,7579841,7881293,301452
-1,-1,8,7579841,7881293,301452
-1,-1,8,7579841,7881293,301452
-1,-1,8,7579841,7881293,301452
-1,-1,8,7579841,7881293,301452
-1,-1,8,7579841,7881293,301452
-1,-1,8,7579841,7881293,301452
-1,-1,8,7579841,7881293,301452
-1,-1,8,7579841,7881293,301452
-1,-1,8,7579841,7881293,301452
-1,-1,8,7579841,7881293,301452
-1,-1,8,7579841,7881293,301452
-1,-1,8,7579841,7881293,301452
-1,-1,8,7579841,7881293,301452
-1,-1,8,7579841,7881293,301452
-1,-1,8,7579841,7881293,301452
-1,-1,8,7579841,7881293,301452
-1,-1,8,7579841,7881293,301452
-1,-1,8,7579841,7881293,301452
-1,-1,8,7579841,7881293,301452
-1,-1,8,7579841,7881293,301452
-1,-1,8,7579841,7881293,301452
-1,-1,8,7579841,7881293,301452
-1,-1,8,7579841,7881293,301452
-1,-1,8,7579841,7881293,301452
-1,-1,8,7579841,7881293,301452
-1,-1,8,7579841,7881293,301452
-1,-1,8,7579841,7881293,301452
-1,-1,8,7579841,7881293,301452
-1,-1,8,7579841,7881293,301452
-1,-1,8,7579841,7881293,301452
-1,-1,8,7579841,7881293,301452
-1,-1,8,7579841,7881293,301452
-1,-1,8,7579816,7618142,38326
1,-1,8,7579816,7618142,38326
-1,-1,8,7579816,7752596,172780
1,-1,8,7579816,7752596,172780
-1,-1,8,7595137,7806222,211085
-1,-1,8,7632386,7838942,206556
-1,-1,8,7632386,7838942,206556
-1,-1,8,7632386,7838942,206556
-1,-1,8,7632386,7838942,206556
-1,-1,8,7632386,7838942,206556
-1,-1,8,7632386,7838942,206556
-1,-1,8,7632386,7838942,206556
-1,-1,8,7632386,7838942,206556
-1,-1,8,7632386,7838942,206556
-1,-1,8,7632386,7838942,206556
-1,-1,8,7632386,7838942,206556
-1,-1,8,7632386,7838942,206556
-1,-1,8,7632386,7867163,234777
1,1,8,7691901,12039974,4348073
-1,1,8,7881293,11886164,4004871
-1,1,8,8079861,11841842,3761981
-1,1,8,8079861,12039974,3960113
1,1,8,8093066,11945856,3852790
1,1,8,8093066,11945856,3852790
1,1,8,8093066,11945856,3852790
1,1,8,8093066,11945856,3852790
1,1,8,8093066,11945856,3852790
1,1,8,8093066,11945856,3852790
1,1,8,8093169,11845219,3752050
-1,1,8,8093169,11881742,3788573
-1,1,8,8093169,11888779,3795610
-1,1,8,8093169,11895232,3802063
-1,1,8,8093169,11935465,3842296
-1,1,8,8111027,11280142,3169115
-1,1,8,8111027,11860569,3749542
-1,1,8,8111027,12467543,4356516
-1,1,8,8130630,9544529,1413899
-1,1,8,8130630,11805960,3675330
-1,1,8,8130630,11805960,3675330
-1,1,8,8130630,12241152,4110522
1,1,8,8130630,12404062,4273432
-1,1,8,8130630,12467543,4336913
-1,-1,8,8145191,8175312,30121
-1,1,8,8403353,11671979,3268626
-1,-1,8,8569504,8621658,52154
1,1,8,8621688,10921074,2299386
-1,-1,8,8952910,8982291,29381
-1,-1,8,9038508,9112322,73814
-1,-1,8,9043929,9112322,68393
-1,1,8,9313740,10871128,1557388
1,1,8,11298481,11841842,543361
1,-1,8,11391786,11419616,27830
-1,1,8,11596744,11660943,64199
-1,1,8,11608214,11683083,74869
-1,-1,8,11660943,11860171,199228
1,1,8,11708622,37073851,25365229
-1,-1,8,11758865,12467543,708678
-1,-1,8,11758865,12467543,708678
1,-1,8,11805761,12404066,598305
1,-1,8,11860379,12522676,662297
1,-1,8,11860379,12522676,662297
1,-1,8,11860379,12522676,662297
1,-1,8,11860379,12522676,662297
1,-1,8,11860379,12555985,695606
1,-1,8,11860379,12555985,695606
1,-1,8,11860379,12555985,695606
1,-1,8,11860379,12555985,695606
1,-1,8,11860379,12555985,695606
1,-1,8,11860379,12555985,695606
1,-1,8,11860379,12555985,695606
1,-1,8,11860379,12585330,724951
1,-1,8,11860379,12585330,724951
1,-1,8,11886223,12454045,567822
1,-1,8,11886223,12465238,579015
1,-1,8,11886223,12522676,636453
1,-1,8,11886223,12522676,636453
1,-1,8,11906296,12465238,558942
1,-1,8,11906296,12522676,616380
1,-1,8,11906296,12522676,616380
1,-1,8,11906296,12522676,616380
1,-1,8,11906296,12555985,649689
1,-1,8,11906296,12555985,649689
1,-1,8,11906296,12555985,649689
1,-1,8,11906296,12555985,649689
1,-1,8,11907792,12467484,559692
1,-1,8,11907792,12467484,559692
1,-1,8,11907792,12467484,559692
1,-1,8,11907792,12490843,583051
1,-1,8,11907792,12522676,614884
1,-1,8,11907792,12522676,614884
1,-1,8,11907792,12522676,614884
1,-1,8,11907792,12522676,614884
1,-1,8,11907792,12522676,614884
1,-1,8,11907792,12522676,614884
1,-1,8,11907792,12555985,648193
1,-1,8,11925007,12465238,540231
1,-1,8,11925007,12465238,540231
1,-1,8,11925007,12465238,540231
1,-1,8,11925007,12465238,540231
1,-1,8,11925007,12465238,540231
1,-1,8,11925007,12465238,540231
1,-1,8,11925007,12465238,540231
1,-1,8,11925007,12465238,540231
1,-1,8,11925007,12465238,540231
1,-1,8,11925007,12465238,540231
1,-1,8,11925007,12465238,540231
1,-1,8,11925007,12467484,542477
1,-1,8,11925007,12467484,542477
1,-1,8,11925007,12467484,542477
1,-1,8,11925007,12522676,597669
1,-1,8,11925007,12522676,597669
1,-1,8,11925007,12522676,597669
1,-1,8,11925007,12522676,597669
1,-1,8,11925007,12522676,597669
1,-1,8,11925007,12522676,597669
1,-1,8,11925007,12522676,597669
1,-1,8,11925007,12522676,597669
1,-1,8,11925007,12522676,597669
1,-1,8,11925007,12522676,597669
1,-1,8,11925007,12522676,597669
1,-1,8,11925007,12522676,597669
1,-1,8,11925007,12522676,597669
1,-1,8,11925007,12522676,597669
1,-1,8,11925007,12522676,597669
1,-1,8,11925007,12522676,597669
1,-1,8,11925007,12522676,597669
1,-1,8,11925007,12522676,597669
1,-1,8,11925007,12522676,597669
1,-1,8,11925007,12522676,597669
1,-1,8,11925007,12522676,597669
1,-1,8,11925007,12522676,597669
1,-1,8,11925007,12522676,597669
1,-1,8,11925007,12522676,597669
1,-1,8,11925007,12522676,597669
1,-1,8,11925007,12522676,597669
1,-1,8,11925007,12522676,597669
1,-1,8,11925007,12535805,610798
1,-1,8,11925007,12555985,630978
1,-1,8,11925007,12555985,630978
1,-1,8,11925007,12555985,630978
1,-1,8,11925007,12555985,630978
1,-1,8,11925007,12555985,630978
1,-1,8,11925007,12555985,630978
1,-1,8,11925007,12555985,630978
1,-1,8,11925007,12555985,630978
1,-1,8,11925007,12555985,630978
1,-1,8,11925007,12555985,630978
1,-1,8,11925007,12555985,630978
1,-1,8,11925007,12555985,630978
1,-1,8,11925007,12555985,630978
1,-1,8,11925007,12555985,630978
1,-1,8,11925007,12555985,630978
1,-1,8,11925007,12555985,630978
1,-1,8,11925007,12555985,630978
1,-1,8,11925007,12555985,630978
1,-1,8,11925007,12555985,630978
1,-1,8,11925007,12555985,630978
1,-1,8,11925007,12555985,630978
1,-1,8,11925007,12555985,630978
1,-1,8,11925007,12555985,630978
1,-1,8,11925007,12555985,630978
1,-1,8,11925007,12555985,630978
1,-1,8,11925007,12555985,630978
1,-1,8,11925007,12555985,630978
1,-1,8,11925007,12555985,630978
1,-1,8,11925007,12555985,630978
1,-1,8,11925007,12555985,630978
1,-1,8,11925007,12555985,630978
1,-1,8,11925007,12555985,630978
1,-1,8,11925007,12555985,630978
1,-1,8,11925007,12555985,630978
1,-1,8,11925007,12555985,630978
1,-1,8,11925007,12555985,630978
1,-1,8,11925007,12555985,630978
1,-1,8,11925007,12555985,630978
1,-1,8,11925007,12555985,630978
1,-1,8,11925007,12555985,630978
1,-1,8,11925007,12555985,630978
1,-1,8,11925007,12555985,630978
1,-1,8,11925007,12555985,630978
1,-1,8,11925007,12555985,630978
1,-1,8,11925007,12585330,660323
1,-1,8,11925007,12585330,660323
1,-1,8,11925007,12585330,660323
1,-1,8,11925007,12585330,660323
1,-1,8,11925007,12585330,660323
1,-1,8,11925007,12585330,660323
1,-1,8,11925007,12585330,660323
1,-1,8,11925007,12585330,660323
1,-1,8,11925007,12585330,660323
1,1,8,11935023,43824035,31889012
1,1,8,11945855,34875355,22929500
1,-1,8,11952847,12442767,489920
-1,-1,8,11952907,12282677,329770
-1,-1,8,11952907,12309456,356549
-1,-1,8,11952907,12309456,356549
-1,-1,8,11952907,12309456,356549
1,-1,8,11952907,12467484,514577
1,-1,8,11952907,12467484,514577
1,-1,8,11952907,12467484,514577
1,-1,8,11952907,12467484,514577
1,-1,8,11952907,12467484,514577
1,-1,8,11952907,12467484,514577
1,-1,8,11952907,12467484,514577
1,-1,8,11952907,12467484,514577
1,-1,8,11952907,12522676,569769
1,-1,8,11952907,12522676,569769
1,-1,8,11952907,12522676,569769
1,-1,8,11952907,12522676,569769
1,-1,8,11952907,12535805,582898
1,-1,8,11952907,12535805,582898
1,-1,8,11952907,12535805,582898
1,-1,8,11952907,12535805,582898
1,-1,8,11952907,12555985,603078
1,-1,8,11952907,12555985,603078
1,-1,8,11952907,12555985,603078
1,-1,8,11967834,12555985,588151
-1,-1,8,12039930,12467543,427613
-1,-1,8,12039930,12467543,427613
-1,-1,8,12039930,12467543,427613
-1,-1,8,12039930,12467543,427613
-1,-1,8,12039930,12467543,427613
-1,-1,8,12039930,12467543,427613
1,1,8,12039930,43528350,31488420
1,-1,8,12220281,12241123,20842
1,1,8,12240353,28483081,16242728
-1,1,8,12241093,28891463,16650370
1,1,8,12241093,43528350,31287257
1,1,8,12467484,41943221,29475737
1,1,8,12467484,41943221,29475737
1,1,8,12467484,43528350,31060866
1,1,8,12490998,16397340,3906342
1,1,8,12490999,40543052,28052053
1,1,8,12490999,146295771,133804772
1,1,8,12503632,43541986,31038354
1,1,8,12522735,36880414,24357679
1,1,8,12528482,33684786,21156304
1,1,8,12528482,39593802,27065320
1,1,8,12535865,41717221,29181356
1,1,8,12556004,35333600,22777596
1,1,8,12580132,14293267,1713135
1,1,8,12580132,43388233,30808101
1,1,8,12583259,30038037,17454778
1,1,8,12586413,40026713,27440300
1,1,8,12586413,43528350,30941937
1,1,8,12586532,39093453,26506921
1,1,8,12590039,20294393,7704354
-1,1,8,13091530,24483615,11392085
1,-1,8,13401766,13558053,156287
1,-1,8,13604086,13935111,331025
1,-1,8,13905443,13961302,55859
-1,-1,8,14572311,14615181,42870
1,-1,8,14797620,14834086,36466
-1,1,8,15093351,32246732,17153381
-1,-1,8,15403439,15409173,5734
-1,-1,8,15421661,15431325,9664
-1,-1,8,15421661,15431325,9664
-1,-1,8,15421661,15431325,9664
-1,-1,8,15952011,16021685,69674
-1,-1,8,15952011,16021685,69674
-1,-1,8,16240968,16353094,112126
-1,1,8,18830506,33476782,14646276
1,-1,8,18845845,19456780,610935
1,1,8,21149033,146295771,125146738
1,-1,8,22901199,22938085,36886
-1,1,8,23643335,27383767,3740432
1,1,8,24514488,34808438,10293950
-1,1,8,24767877,31053873,6285996
-1,1,8,25028618,31608116,6579498
-1,1,8,29219614,40089227,10869613
1,-1,8,29420806,29476272,55466
1,1,8,33845065,46938942,13093877
-1,1,8,35358115,36227536,869421
1,1,8,36437621,60531557,24093936
-1,1,8,37309453,46938942,9629489
-1,1,8,37903880,39029772,1125892
-1,1,8,37923445,40199169,2275724
1,-1,8,39237467,39309471,72004
1,-1,8,39237467,39309471,72004
-1,-1,8,39237467,39385871,148404
-1,-1,8,39237467,39385871,148404
-1,-1,8,39237467,39385871,148404
-1,-1,8,39237467,39385871,148404
-1,-1,8,39237467,39385871,148404
-1,-1,8,39237467,39385871,148404
1,-1,8,39237468,39380625,143157
-1,-1,8,39258894,39386158,127264
1,-1,8,39258894,39386158,127264
-1,-1,8,39258894,39386158,127264
1,-1,8,39258894,39386158,127264
-1,-1,8,39258894,39386158,127264
1,-1,8,39258894,39386158,127264
1,-1,8,39258894,39386158,127264
-1,-1,8,39258894,39386158,127264
1,-1,8,39258894,39386158,127264
-1,-1,8,39258924,39309619,50695
-1,-1,8,39258924,39345450,86526
-1,-1,8,39258924,39345450,86526
1,-1,8,39259089,39332501,73412
1,-1,8,39259089,39332501,73412
1,-1,8,39259089,39332501,73412
1,-1,8,39259089,39362857,103768
1,-1,8,39259089,39385871,126782
1,-1,8,39259089,39385871,126782
1,1,8,39818050,43528350,3710300
1,1,8,40690198,43388233,2698035
1,-1,8,42776939,46938942,4162003
1,-1,8,42858611,43541984,683373
1,-1,8,42933206,46938942,4005736
1,-1,8,42933206,46938942,4005736
1,-1,8,42952655,43211923,259268
1,-1,8,42952655,43388233,435578
1,-1,8,42952655,43388233,435578
1,-1,8,42958427,43388233,429806
1,-1,8,42958427,43388233,429806
1,-1,8,42958427,43388233,429806
1,-1,8,42958427,43388233,429806
1,-1,8,42970273,43529733,559460
1,-1,8,43371443,43383203,11760
-1,-1,8,43541970,47722045,4180075
-1,-1,8,43541970,47761111,4219141
-1,-1,8,43541970,47761111,4219141
1,-1,8,43541970,47954816,4412846
-1,-1,8,46942956,47574071,631115
-1,-1,8,46942956,47574071,631115
-1,-1,8,46942956,47574071,631115
-1,-1,8,46942956,47703687,760731
-1,-1,8,46942956,47703687,760731
1,1,8,46942956,70216022,23273066
1,1,8,46942956,70216022,23273066
-1,-1,8,46942962,47703693,760731
1,1,8,46942962,140297737,93354775
-1,-1,8,46953844,47703693,749849
-1,-1,8,46953844,47703693,749849
-1,-1,8,46953844,47738885,785041
-1,-1,8,46953844,47738809,784965
-1,-1,8,47458519,47738885,280366
1,-1,8,48174652,48223809,49157
-1,-1,8,48326590,48522545,195955
-1,-1,8,50360365,50558946,198581
-1,1,8,50384337,58738029,8353692
-1,-1,8,50875711,50932681,56970
1,-1,8,53823071,53942924,119853
-1,1,8,54237949,62775577,8537628
-1,1,8,54407101,58403572,3996471
-1,1,8,55677510,57697858,2020348
-1,1,8,55733917,62058861,6324944
1,1,8,56228414,65864987,9636573
1,-1,8,56725646,56879608,153962
-1,-1,8,58027779,58832685,804906
-1,1,8,60099786,62021382,1921596
-1,1,8,61431756,61605551,173795
1,1,8,61431781,67571260,6139479
-1,1,8,61728952,66029297,4300345
-1,1,8,61728952,66029297,4300345
-1,1,8,65194424,68570319,3375895
1,1,8,67083904,94517737,27433833
1,1,8,67546080,81012324,13466244
-1,1,8,69899336,72597645,2698309
-1,1,8,69899336,72597645,2698309
-1,1,8,69899336,72597645,2698309
-1,1,8,69900070,72575701,2675631
-1,1,8,69900116,72552263,2652147
-1,1,8,72099108,72340784,241676
-1,1,8,72314204,72924788,610584
1,-1,8,73596927,73635634,38707
1,-1,8,73596927,73635634,38707
1,-1,8,73596927,73635634,38707
1,-1,8,73596927,73635634,38707
-1,1,8,75197438,81685526,6488088
-1,1,8,75817543,82252186,6434643
-1,1,8,75817543,82252186,6434643
-1,1,8,76630644,78612790,1982146
-1,1,8,77751515,83516216,5764701
1,1,8,78392286,146294098,67901812
-1,1,8,79472080,84521307,5049227
1,1,8,79526312,146280020,66753708
1,-1,8,84732613,85047388,314775
1,1,8,86778228,146295771,59517543
1,1,8,86841154,146295771,59454617
1,1,8,86841228,142689874,55848646
1,1,8,87312813,138034830,50722017
1,1,8,88943380,146294098,57350718
-1,-1,8,89673491,89832250,158759
-1,-1,8,92115979,92144331,28352
-1,-1,8,92116009,92175700,59691
1,1,8,93047482,141355635,48308153
1,-1,8,94002514,94085487,82973
-1,1,8,94050403,96680010,2629607
1,1,8,95694382,146294042,50599660
1,1,8,98395101,146295771,47900670
1,1,8,98432250,146222672,47790422
1,-1,8,100221586,100222054,468
1,-1,8,100221586,100222054,468
1,-1,8,100286775,100287625,850
-1,1,8,101191636,107536895,6345259
1,1,8,101879571,146295771,44416200
-1,1,8,102183491,110139893,7956402
-1,1,8,102212054,106814326,4602272
-1,1,8,102897047,108368371,5471324
1,-1,8,103563857,103589862,26005
1,1,8,104318564,146294098,41975534
-1,1,8,107032887,120742018,13709131
1,-1,8,107307812,107670002,362190
1,-1,8,107307812,107670002,362190
-1,1,8,111137305,119897611,8760306
1,-1,8,111730471,113110025,1379554
-1,1,8,113540571,121095280,7554709
1,-1,8,114199992,114338391,138399
1,-1,8,114199992,114338391,138399
1,-1,8,114236551,114327680,91129
-1,1,8,114430289,121987545,7557256
1,1,8,114853126,146295771,31442645
-1,1,8,114945534,123633980,8688446
1,-1,8,115343313,116112199,768886
-1,1,8,115573009,123606341,8033332
-1,1,8,115656140,116918407,1262267
-1,1,8,116413559,116514256,100697
-1,1,8,116902507,118942698,2040191
-1,1,8,118421576,118892037,470461
-1,1,8,118796828,118890987,94159
1,-1,8,122910974,123398080,487106
1,1,8,123466631,129525322,6058691
1,1,8,123466631,129525322,6058691
1,1,8,125510739,146294098,20783359
1,1,8,125526331,146280020,20753689
-1,1,8,127638606,144388560,16749954
1,1,8,131127764,142238309,11110545
1,1,8,131127764,142238309,11110545
1,1,8,131651428,146294098,14642670
1,1,8,131651428,146294098,14642670
1,1,8,131682563,146280020,14597457
1,-1,8,132479568,132691028,211460
1,-1,8,132495510,132566500,70990
1,1,8,134825277,146280828,11455551
-1,-1,8,137693266,137862182,168916
1,-1,8,140323438,140399311,75873
-1,1,8,142764538,145195510,2430972
-1,1,8,143282829,145076898,1794069
-1,-1,8,144589991,144645202,55211
1,-1,8,145319810,145493555,173745
1,-1,8,145319810,145493555,173745
-1,-1,8,145319810,145893555,573745
1,-1,8,145694369,145760629,66260
-1,-1,8,146151358,146280020,128662
-1,-1,8,146151358,146280020,128662
1,-1,8,146161039,146274835,113796
-1,-1,8,146193902,146218230,24328
-1,-1,8,146197628,146222731,25103
-1,-1,8,146218173,146274890,56717
-1,-1,8,146222563,146235420,12857
-1,-1,8,146222672,146231912,9240
-1,-1,8,146222672,146231912,9240
-1,-1,8,146222672,146231912,9240
-1,-1,8,146222672,146231912,9240
-1,-1,8,146222672,146231912,9240
-1,-1,8,146222672,146231912,9240
-1,-1,8,146222672,146231912,9240
-1,-1,8,146222672,146231912,9240
-1,-1,8,146222672,146231912,9240
-1,-1,8,146222672,146231912,9240
-1,-1,8,146222672,146231912,9240
-1,-1,8,146224004,146231912,7908
-1,1,9,12934,2790382,2777448
1,1,9,12934,19777918,19764984
1,1,9,12934,65482544,65469610
1,1,9,12934,141153431,141140497
-1,1,9,12993,9904905,9891912
1,-1,9,13997,118241,104244
1,1,9,13997,70919878,70905881
1,1,9,13997,71015981,71001984
1,1,9,32396,39140211,39107815
1,1,9,62525,141006407,140943882
1,-1,9,118241,166977,48736
-1,-1,9,118241,166977,48736
-1,-1,9,118241,166977,48736
-1,-1,9,118241,166977,48736
1,-1,9,118241,166977,48736
-1,-1,9,118241,213161,94920
1,-1,9,163131,271257,108126
-1,1,9,185579,7635806,7450227
-1,1,9,204090,4681722,4477632
1,1,9,203861,378086,174225
-1,1,9,203861,4585050,4381189
-1,1,9,203861,5081516,4877655
-1,1,9,203861,5094461,4890600
-1,1,9,203861,5909152,5705291
-1,1,9,203861,8172957,7969096
-1,1,9,203861,8735462,8531601
-1,1,9,203861,11414732,11210871
-1,1,9,203861,13486759,13282898
-1,1,9,203861,14322268,14118407
-1,1,9,203861,15211277,15007416
-1,1,9,203861,16670878,16467017
-1,1,9,203861,16856907,16653046
-1,1,9,203861,16925108,16721247
-1,1,9,203861,17125893,16922032
-1,1,9,203861,17655298,17451437
1,1,9,203861,31423871,31220010
1,1,9,203861,38381639,38177778
1,1,9,203861,38787480,38583619
1,1,9,203861,38787480,38583619
1,1,9,203861,67983174,67779313
1,1,9,203861,68188391,67984530
1,1,9,203861,69002883,68799022
1,1,9,203861,69002883,68799022
1,1,9,203861,88189913,87986052
1,1,9,203861,90745359,90541498
1,1,9,203861,141020389,140816528
1,1,9,203861,141020389,140816528
1,1,9,203861,141020389,140816528
1,1,9,203862,141020389,140816527
1,1,9,203862,141020389,140816527
1,1,9,203862,141020389,140816527
1,1,9,203862,141020389,140816527
1,1,9,203862,141020389,140816527
1,1,9,203862,141020389,140816527
1,1,9,203862,141020389,140816527
1,1,9,203862,141020389,140816527
1,1,9,203862,141020389,140816527
1,1,9,203864,141020389,140816525
1,-1,9,203993,381630,177637
1,-1,9,204090,280321,76231
1,-1,9,204090,318901,114811
1,-1,9,204090,381572,177482
-1,1,9,204090,416321,212231
1,-1,9,204090,639077,434987
1,1,9,204090,4970154,4766064
-1,1,9,204090,9282864,9078774
-1,1,9,204090,13146845,12942755
-1,1,9,204090,15260598,15056508
1,1,9,204090,141018976,140814886
-1,1,9,204104,3367760,3163656
-1,1,9,204104,3755031,3550927
1,1,9,204104,5426099,5221995
-1,1,9,204104,5657733,5453629
-1,1,9,204104,5695507,5491403
-1,1,9,204104,6322471,6118367
-1,1,9,204104,7133443,6929339
-1,1,9,204104,8266492,8062388
-1,1,9,204104,10023901,9819797
-1,1,9,204104,11298187,11094083
1,1,9,204104,11610300,11406196
-1,1,9,204104,14182667,13978563
-1,1,9,204104,18882279,18678175
1,1,9,204104,27963367,27759263
1,1,9,204104,34151474,33947370
1,1,9,204104,38768291,38564187
1,1,9,204104,47212321,47008217
1,1,9,204104,47212321,47008217
1,1,9,204104,66516698,66312594
1,1,9,204104,82492731,82288627
1,1,9,204104,141053525,140849421
1,1,9,204104,141053525,140849421
1,1,9,204104,141053525,140849421
1,1,9,204104,141053525,140849421
1,-1,9,204193,295405,91212
1,-1,9,204193,381489,177296
1,-1,9,204193,381489,177296
1,-1,9,204193,381489,177296
-1,1,9,204193,1592365,1388172
-1,1,9,204193,4210335,4006142
-1,1,9,204193,6968724,6764531
-1,1,9,204193,10164955,9960762
-1,1,9,204193,10164955,9960762
-1,1,9,204193,10473327,10269134
-1,1,9,204193,10852686,10648493
-1,1,9,204193,11277770,11073577
-1,1,9,204193,11435662,11231469
-1,1,9,204193,16897578,16693385
-1,1,9,204193,18073357,17869164
1,1,9,204193,38815475,38611282
1,1,9,204193,38815475,38611282
1,1,9,204193,77230829,77026636
1,1,9,204193,141073897,140869704
1,1,9,204193,141073897,140869704
1,-1,9,207437,416351,208914
1,-1,9,211086,314969,103883
1,-1,9,211086,356079,144993
-1,1,9,211086,7444397,7233311
-1,1,9,211086,11457340,11246254
-1,1,9,213161,3497920,3284759
-1,1,9,213161,17496750,17283589
-1,1,9,214367,16307942,16093575
1,-1,9,220253,332515,112262
1,-1,9,220253,381489,161236
-1,1,9,220253,7733826,7513573
-1,1,9,220253,8866675,8646422
-1,1,9,220253,18708803,18488550
1,1,9,220253,73245647,73025394
1,1,9,220257,29424846,29204589
1,-1,9,239426,315028,75602
1,-1,9,245823,295405,49582
1,-1,9,254654,329684,75030
-1,1,9,266045,3346702,3080657
1,-1,9,271257,314969,43712
1,-1,9,304377,639010,334633
-1,1,9,322690,16401654,16078964
1,-1,9,325759,500607,174848
1,-1,9,329684,500525,170841
1,-1,9,459131,862833,403702
1,1,9,459131,24207892,23748761
-1,1,9,556625,703693,147068
1,-1,9,579739,753199,173460
-1,1,9,635338,685819,50481
-1,-1,9,1611053,1703711,92658
1,-1,9,2413996,2711186,297190
1,1,9,3591159,9361786,5770627
-1,1,9,4152060,8518353,4366293
-1,1,9,4581369,14848338,10266969
-1,-1,9,4627565,4724294,96729
1,1,9,4661872,27661570,22999698
1,-1,9,5126597,5185255,58658
-1,-1,9,5231467,5233791,2324
1,-1,9,5304531,5335597,31066
-1,-1,9,5304531,5335597,31066
-1,-1,9,5304531,5335597,31066
-1,-1,9,5304531,5335597,31066
1,-1,9,5304531,5335597,31066
-1,-1,9,5304531,5335597,31066
-1,-1,9,5304531,5335597,31066
1,1,9,5900425,30008330,24107905
1,-1,9,6558442,6838207,279765
1,-1,9,6672380,6714941,42561
1,-1,9,6672380,6906978,234598
1,1,9,7162304,37038768,29876464
-1,-1,9,7493709,7733797,240088
-1,-1,9,8039875,8157531,117656
-1,-1,9,8065133,8187842,122709
-1,-1,9,8284068,8331541,47473
-1,-1,9,8903382,9014802,111420
-1,-1,9,9400269,9486593,86324
-1,-1,9,9782827,9872073,89246
1,-1,9,10249116,10340720,91604
1,1,9,10527668,13276052,2748384
1,-1,9,11172890,12196342,1023452
-1,-1,9,11298130,11530555,232425
-1,-1,9,11573531,11713632,140101
-1,-1,9,11573531,11868524,294993
-1,-1,9,11659096,11904449,245353
-1,-1,9,11659296,11927681,268385
-1,-1,9,11659296,11927681,268385
-1,-1,9,11713632,11868524,154892
-1,-1,9,11780648,12114519,333871
1,-1,9,11780402,12074235,293833
-1,-1,9,11818286,12074236,255950
-1,-1,9,11851575,12074236,222661
-1,-1,9,11868524,11952522,83998
-1,-1,9,11868524,12007047,138523
-1,-1,9,11904249,11981564,77315
-1,-1,9,11952416,12180177,227761
-1,-1,9,11952416,12180177,227761
-1,-1,9,11927681,12007047,79366
-1,-1,9,11927681,12007047,79366
-1,-1,9,12031727,12114297,82570
1,1,9,17132123,35567051,18434928
1,1,9,17502885,18681089,1178204
1,1,9,17684434,30889762,13205328
1,1,9,18344603,68995221,50650618
1,-1,9,19096648,19096707,59
-1,1,9,19564273,28106620,8542347
-1,1,9,20951885,22447709,1495824
-1,-1,9,21201443,21206896,5453
-1,-1,9,22212553,22326165,113612
-1,-1,9,24083476,24349363,265887
-1,-1,9,25259013,25346912,87899
-1,-1,9,25259013,25346912,87899
-1,-1,9,25259013,25346912,87899
-1,-1,9,25259013,25346912,87899
-1,-1,9,25259013,25346912,87899
-1,-1,9,25259013,25346912,87899
-1,-1,9,25259013,25346912,87899
-1,-1,9,25527395,25616019,88624
-1,-1,9,26274518,26405992,131474
-1,-1,9,28191461,28320731,129270
-1,-1,9,28191461,28320731,129270
-1,-1,9,28191461,28320731,129270
-1,-1,9,28531365,28733362,201997
-1,-1,9,28531365,28733362,201997
-1,-1,9,28604406,28849041,244635
-1,-1,9,28604283,28718395,114112
-1,-1,9,28604283,28718395,114112
-1,-1,9,28604283,28718395,114112
-1,-1,9,28670178,28745046,74868
-1,-1,9,29963344,30247394,284050
-1,-1,9,30357226,30660176,302950
-1,-1,9,30424069,30520898,96829
-1,-1,9,30424069,30520898,96829
1,1,9,31426825,68330127,36903302
-1,-1,9,31567894,31642030,74136
-1,1,9,32865025,32996644,131619
1,-1,9,33165444,33259483,94039
1,-1,9,33165444,33259483,94039
1,1,9,33225728,38529810,5304082
1,1,9,33333162,71534501,38201339
-1,1,9,33572679,36782012,3209333
1,1,9,35623497,38815471,3191974
1,-1,9,38409052,43610709,5201657
1,-1,9,38422969,65482544,27059575
1,-1,9,38536895,44265200,5728305
1,-1,9,38536895,44265200,5728305
1,-1,9,38741597,44259405,5517808
1,-1,9,38741597,45667381,6925784
1,-1,9,38741597,65482544,26740947
1,-1,9,38755084,45429384,6674300
1,-1,9,38755084,46656999,7901915
-1,-1,9,38768412,39141842,373430
1,-1,9,38764616,45364733,6600117
-1,-1,9,38764616,65482544,26717928
1,-1,9,38868468,39407645,539177
1,-1,9,38789216,39407645,618429
1,-1,9,38768471,40375071,1606600
1,-1,9,38768471,42000733,3232262
1,-1,9,38768471,43606290,4837819
1,-1,9,38768471,44245546,5477075
1,-1,9,38768471,44259405,5490934
1,-1,9,38768471,44259405,5490934
1,-1,9,38768471,44259405,5490934
1,-1,9,38768471,44259405,5490934
1,-1,9,38768471,45352054,6583583
1,-1,9,38768471,45378350,6609879
1,-1,9,38768471,46656999,7888528
1,-1,9,38768471,47199215,8430744
1,-1,9,38768471,65482544,26714073
1,-1,9,38768471,65482544,26714073
1,-1,9,38768471,65482544,26714073
1,-1,9,38768471,65482544,26714073
1,-1,9,38768471,65482544,26714073
-1,-1,9,38768471,65482544,26714073
1,-1,9,38768471,65482544,26714073
1,-1,9,38768471,65482544,26714073
1,-1,9,38768471,65482544,26714073
1,-1,9,38768471,65482544,26714073
-1,-1,9,38768471,65482544,26714073
1,-1,9,38768471,65482544,26714073
1,-1,9,38768471,65482544,26714073
1,-1,9,38790887,65482544,26691657
-1,-1,9,38810497,45733296,6922799
1,-1,9,38835046,65482544,26647498
1,-1,9,38847760,47312281,8464521
-1,-1,9,38951316,39407645,456329
1,-1,9,38868527,44245546,5377019
1,-1,9,38868527,44245546,5377019
-1,-1,9,38868527,44654170,5785643
-1,-1,9,38868527,44729482,5860955
-1,-1,9,38868527,65482544,26614017
1,-1,9,38906126,44245546,5339420
-1,-1,9,38929129,44245546,5316417
-1,-1,9,38929129,45149342,6220213
-1,-1,9,38976049,39407645,431596
1,-1,9,38951376,40066335,1114959
1,-1,9,38951376,42312058,3360682
1,-1,9,38951376,44245546,5294170
1,-1,9,38951376,44265200,5313824
1,-1,9,38951376,45248958,6297582
1,-1,9,38951376,46019594,7068218
1,-1,9,38951376,65482544,26531168
1,-1,9,38951376,65482544,26531168
1,-1,9,38951376,65482544,26531168
1,-1,9,38951376,65482544,26531168
1,-1,9,38951376,65482544,26531168
1,-1,9,38951376,65482544,26531168
1,-1,9,38951376,65482544,26531168
-1,-1,9,38951376,65482544,26531168
1,-1,9,38951376,65482544,26531168
1,-1,9,39059536,65482544,26423008
1,-1,9,39059536,65482544,26423008
-1,-1,9,39059898,44729482,5669584
-1,-1,9,39059898,44729482,5669584
-1,-1,9,39083058,39317161,234103
1,-1,9,39116729,44259405,5142676
-1,-1,9,39140222,40940341,1800119
1,-1,9,39267719,65482544,26214825
-1,-1,9,39500661,40049174,548513
-1,-1,9,39500661,40140466,639805
1,-1,9,39500661,40477283,976622
1,-1,9,39500661,40771162,1270501
-1,-1,9,39500661,40771162,1270501
-1,-1,9,39500661,65482544,25981883
1,-1,9,39796990,43468813,3671823
-1,-1,9,39892100,40477283,585183
1,-1,9,40031488,40848455,816967
-1,-1,9,40226329,40771162,544833
1,-1,9,40375130,65482544,25107414
1,-1,9,40390407,43606290,3215883
-1,-1,9,40396988,40632420,235432
-1,-1,9,40396988,40661509,264521
-1,-1,9,40396988,40661509,264521
-1,-1,9,40411303,40661509,250206
1,-1,9,40422818,65482544,25059726
1,-1,9,40553281,42312058,1758777
1,-1,9,40553281,47199215,6645934
1,-1,9,40632480,65482544,24850064
-1,-1,9,40816545,41461551,645006
-1,-1,9,40816545,41591861,775316
-1,-1,9,40816545,41591861,775316
-1,-1,9,40816545,41591861,775316
1,-1,9,40816545,41591861,775316
-1,-1,9,40816545,41591861,775316
1,-1,9,40848514,41591861,743347
1,-1,9,40848514,42000733,1152219
1,-1,9,40848514,42036225,1187711
1,-1,9,40865224,41591861,726637
1,-1,9,40865224,41591861,726637
1,-1,9,40865224,41897543,1032319
1,-1,9,40991681,41897543,905862
1,-1,9,41014028,65482544,24468516
-1,-1,9,41671278,42024128,352850
-1,-1,9,41645686,42246954,601268
1,-1,9,41645686,42450701,805015
-1,-1,9,41645686,65482544,23836858
-1,-1,9,41645686,65482544,23836858
-1,-1,9,41645686,65482544,23836858
1,-1,9,41863355,47041045,5177690
1,-1,9,41863355,47199215,5335860
1,-1,9,41865572,65482544,23616972
-1,-1,9,41980488,42264205,283717
1,-1,9,42000792,65482544,23481752
1,-1,9,42000792,65482544,23481752
1,-1,9,42313138,45080228,2767090
1,-1,9,42456974,43044929,587955
1,-1,9,43320862,43997639,676777
-1,-1,9,43349394,43578724,229330
-1,-1,9,43349394,43606349,256955
-1,-1,9,43349394,43610769,261375
-1,-1,9,43349394,43659703,310309
-1,-1,9,43349394,43923120,573726
-1,-1,9,43349394,43934857,585463
-1,-1,9,43333308,44743838,1410530
1,-1,9,43386522,43686949,300427
-1,-1,9,43386522,43704940,318418
-1,-1,9,43423683,43686957,263274
-1,-1,9,43423683,43923120,499437
-1,-1,9,43411181,43997639,586458
-1,-1,9,43411181,43997639,586458
-1,-1,9,43441986,43842486,400500
-1,-1,9,43441986,43884354,442368
-1,-1,9,43468813,43842486,373673
-1,-1,9,43468813,43842486,373673
-1,-1,9,43468813,43842486,373673
-1,-1,9,43491081,43997639,506558
-1,-1,9,43590075,43842486,252411
-1,-1,9,43590075,43842486,252411
-1,-1,9,43590075,43842486,252411
-1,-1,9,43590075,43842486,252411
-1,-1,9,43590075,43842486,252411
-1,-1,9,43590075,43842486,252411
-1,-1,9,43590075,43842486,252411
-1,-1,9,43590075,43842486,252411
-1,-1,9,43590075,43842486,252411
-1,-1,9,43590075,43842486,252411
-1,-1,9,43590075,43842486,252411
-1,-1,9,43606290,43842486,236196
-1,-1,9,43606290,43842486,236196
-1,-1,9,43606290,43907711,301421
-1,-1,9,43610709,43842486,231777
-1,-1,9,43610709,43842486,231777
-1,-1,9,43610709,43842486,231777
-1,-1,9,43610709,43842486,231777
-1,-1,9,43610709,43842486,231777
-1,-1,9,43610709,43842486,231777
-1,-1,9,43610709,43842486,231777
-1,-1,9,43610709,43842486,231777
-1,-1,9,43610709,43842486,231777
-1,-1,9,43610709,43842486,231777
-1,-1,9,43610709,43842486,231777
-1,-1,9,43610709,43842486,231777
-1,-1,9,43610709,43842486,231777
-1,-1,9,43610709,43842486,231777
-1,-1,9,43610709,43842486,231777
-1,-1,9,43610709,43842486,231777
-1,-1,9,43610709,43842486,231777
-1,-1,9,43610709,43842486,231777
-1,-1,9,43610709,43842486,231777
-1,-1,9,43610709,43842486,231777
-1,-1,9,43610709,43842486,231777
-1,-1,9,43610709,43842486,231777
-1,-1,9,43610709,43842486,231777
-1,-1,9,43610709,43842486,231777
-1,-1,9,43610709,43842486,231777
-1,-1,9,43610709,43842486,231777
-1,-1,9,43610709,43842486,231777
-1,-1,9,43610709,43842486,231777
-1,-1,9,43610709,43842486,231777
-1,-1,9,43610709,43842486,231777
-1,-1,9,43610709,43842486,231777
-1,-1,9,43610709,43842486,231777
-1,-1,9,43610709,43842486,231777
-1,-1,9,43610709,43842486,231777
-1,-1,9,43610709,43842486,231777
-1,-1,9,43610709,43842486,231777
-1,-1,9,43610709,43842486,231777
-1,-1,9,43610709,43842486,231777
-1,-1,9,43610709,43842486,231777
-1,-1,9,43610709,43842486,231777
-1,-1,9,43610709,43842486,231777
-1,-1,9,43610709,43842486,231777
-1,-1,9,43610709,43842486,231777
-1,-1,9,43610709,43842486,231777
-1,-1,9,43610709,43842486,231777
-1,-1,9,43610709,43842486,231777
-1,-1,9,43610709,43842486,231777
-1,-1,9,43610709,43842486,231777
-1,-1,9,43610709,43842486,231777
-1,-1,9,43610709,43842486,231777
-1,-1,9,43610709,43842486,231777
-1,-1,9,43610709,43842486,231777
-1,-1,9,43610709,43842486,231777
-1,-1,9,43610709,43842486,231777
-1,-1,9,43610709,43842486,231777
-1,-1,9,43610709,43842486,231777
-1,-1,9,43610709,43842486,231777
-1,-1,9,43610709,43842486,231777
-1,-1,9,43610709,43842486,231777
-1,-1,9,43610709,43842486,231777
-1,-1,9,43610709,43842486,231777
-1,-1,9,43610709,43842486,231777
-1,-1,9,43610709,43842486,231777
-1,-1,9,43610709,43842486,231777
-1,-1,9,43610709,43842486,231777
-1,-1,9,43610709,43842486,231777
-1,-1,9,43610709,43842486,231777
-1,-1,9,43610709,43842486,231777
-1,-1,9,43610709,43842486,231777
-1,-1,9,43610709,43842486,231777
-1,-1,9,43610709,43884354,273645
-1,-1,9,43610709,43884354,273645
-1,-1,9,43610709,43884354,273645
-1,-1,9,43610709,43884354,273645
-1,-1,9,43610709,43884354,273645
1,-1,9,43610769,44265200,654431
1,-1,9,43610769,65482544,21871775
-1,-1,9,43632698,43921414,288716
1,-1,9,43623672,65482544,21858872
-1,-1,9,43659483,43840040,180557
1,-1,9,44228410,45248958,1020548
-1,-1,9,44259434,44870148,610714
-1,-1,9,44259464,44743838,484374
1,-1,9,44276242,44732257,456015
1,-1,9,44371689,46670223,2298534
1,-1,9,44392878,46682916,2290038
1,-1,9,44419139,45248958,829819
1,-1,9,44654229,45352054,697825
1,-1,9,44654229,45364733,710504
1,-1,9,44676637,45352054,675417
1,-1,9,44676637,45352054,675417
-1,-1,9,44729490,45469360,739870
1,-1,9,45378410,46656999,1278589
-1,-1,9,45447463,45709141,261678
1,-1,9,46133307,65482544,19349237
-1,-1,9,46446830,65482544,19035714
1,-1,9,46446830,65482544,19035714
-1,-1,9,46582126,65482544,18900418
-1,-1,9,46656999,46881479,224480
1,-1,9,46682975,65482544,18799569
1,-1,9,46682975,65482544,18799569
1,-1,9,46682975,65482544,18799569
-1,-1,9,46682975,65482544,18799569
-1,-1,9,46682975,65482544,18799569
1,-1,9,46697061,65482544,18785483
1,-1,9,46706058,65482544,18776486
-1,-1,9,46933222,65482544,18549322
-1,-1,9,47312281,65695693,18383412
-1,-1,9,47312281,65695693,18383412
-1,-1,9,47312281,65695693,18383412
-1,-1,9,47312281,65713185,18400904
-1,-1,9,47312281,65793789,18481508
1,-1,9,47312281,66084663,18772382
1,-1,9,47312281,66084663,18772382
1,-1,9,47312281,66101651,18789370
1,-1,9,47312281,66101651,18789370
1,-1,9,47312281,66130568,18818287
1,-1,9,47312281,66130568,18818287
1,-1,9,47312281,66243053,18930772
1,-1,9,47312281,66243053,18930772
1,-1,9,47312281,66243053,18930772
1,-1,9,47312281,66243053,18930772
1,-1,9,47312281,66243053,18930772
1,-1,9,47312281,66243053,18930772
1,-1,9,47312281,66243053,18930772
1,-1,9,47312281,66243053,18930772
1,-1,9,47312281,66243053,18930772
1,-1,9,47312281,66243053,18930772
1,-1,9,47312281,66243053,18930772
1,-1,9,47312281,66243053,18930772
1,-1,9,47312281,66243053,18930772
-1,-1,9,47312281,66370107,19057826
1,-1,9,47312281,68148786,20836505
1,-1,9,47312281,70871931,23559650
1,-1,9,47312281,70871931,23559650
1,-1,9,47312281,70871931,23559650
1,-1,9,47312281,70871931,23559650
1,-1,9,47312281,70871931,23559650
1,-1,9,47312281,70871931,23559650
1,-1,9,47312281,70871931,23559650
1,-1,9,65548448,66243053,694605
1,-1,9,65578641,70871931,5293290
-1,-1,9,65917469,66260109,342640
-1,-1,9,65917469,66309252,391783
1,-1,9,66914663,67799280,884617
-1,-1,9,68397616,68490444,92828
1,1,9,68420641,141053525,72632884
1,1,9,68734571,83557267,14822696
1,1,9,70966262,90761254,19794992
-1,1,9,71130848,78867779,7736931
-1,1,9,71130848,78867779,7736931
-1,1,9,71130848,86285142,15154294
1,1,9,71130848,109341774,38210926
1,1,9,72242558,114216584,41974026
-1,-1,9,80443049,80460752,17703
1,-1,9,86456737,86570533,113796
-1,1,9,88694766,94589503,5894737
1,-1,9,90503773,90538211,34438
1,-1,9,95262129,95290097,27968
-1,1,9,96732332,100175689,3443357
-1,1,9,97355862,99805480,2449618
-1,1,9,97476174,100883468,3407294
-1,1,9,97823312,111457849,13634537
1,-1,9,98239022,98239146,124
1,-1,9,98239051,98239146,95
1,-1,9,98270240,98270408,168
-1,1,9,100625192,102129138,1503946
-1,1,9,101786487,112710170,10923683
-1,1,9,101900330,117773312,15872982
-1,1,9,101900330,117773312,15872982
-1,1,9,103271401,113948226,10676825
-1,1,9,104604851,126253089,21648238
-1,1,9,106529701,115747074,9217373
-1,1,9,108484180,108503578,19398
1,-1,9,108697403,109009314,311911
-1,1,9,110292595,120728222,10435627
-1,1,9,111348809,118687200,7338391
-1,1,9,114299780,123267736,8967956
1,-1,9,115379506,115588317,208811
1,-1,9,115379506,115588317,208811
1,-1,9,115379506,115588317,208811
1,-1,9,115379506,115588317,208811
1,-1,9,115379600,115588349,208749
1,-1,9,116822389,116859863,37474
1,-1,9,116956006,117439745,483739
1,1,9,122644898,141012393,18367495
1,1,9,123835380,141073897,17238517
1,1,9,124642754,141146461,16503707
-1,-1,9,125308811,125369924,61113
1,-1,9,125308811,125390514,81703
-1,1,9,125857877,129456122,3598245
1,-1,9,127253558,127254078,520
1,-1,9,127253558,127254078,520
-1,1,9,127818144,131400225,3582081
1,1,9,128652785,141044751,12391966
-1,1,9,129079208,130851795,1772587
1,-1,9,129450463,129455590,5127
-1,1,9,130390139,132760275,2370136
1,-1,9,130616981,130636569,19588
-1,1,9,130857850,131830890,973040
-1,1,9,130912549,132540023,1627474
-1,1,9,130998626,131674346,675720
1,1,9,131830839,141073897,9243058
1,1,9,133388594,141018984,7630390
1,-1,9,133814416,133931621,117205
1,1,9,135261940,140954147,5692207
1,1,9,135862290,141008915,5146625
1,-1,9,135940490,135948528,8038
1,-1,9,135940490,135948528,8038
1,-1,9,135940490,135962157,21667
1,-1,9,135940490,135962157,21667
1,-1,9,135940490,135962157,21667
1,-1,9,135940490,135962157,21667
1,-1,9,135940490,135962157,21667
1,-1,9,135940490,135962157,21667
1,-1,9,135940490,135962157,21667
1,-1,9,135940490,135962157,21667
1,-1,9,135940490,135962157,21667
1,-1,9,135940490,135962157,21667
1,-1,9,135940490,135962360,21870
1,-1,9,135947140,135962157,15017
1,-1,9,135947140,135962157,15017
1,-1,9,135947140,135962157,15017
1,1,9,136324358,141053525,4729167
1,1,9,136783193,141053525,4270332
1,1,9,136861349,141018976,4157627
1,1,9,137247660,140468865,3221205
-1,1,9,137435549,137617713,182164
1,-1,9,138130912,138283558,152646
1,-1,9,138157660,138283558,125898
1,-1,9,138157660,138283558,125898
1,-1,9,138157660,138283558,125898
1,-1,9,138157660,138283558,125898
1,-1,9,138157660,138283558,125898
1,-1,9,138181935,138297515,115580
-1,1,9,138209358,141020389,2811031
-1,1,9,138222049,141018925,2796876
1,-1,9,138585277,138589454,4177
-1,1,9,139218428,140909058,1690630
-1,1,9,139218428,140909058,1690630
-1,1,9,139282807,141020389,1737582
-1,1,9,139299672,139503090,203418
1,-1,9,139566910,139751899,184989
1,-1,9,139739420,139744458,5038
-1,1,9,139772224,141018976,1246752
1,-1,9,139919662,139942533,22871
1,-1,9,139987081,140164480,177399
-1,1,9,140043049,141020389,977340
-1,1,9,140240417,141053535,813118
1,1,9,140286134,141008915,722781
-1,1,9,140309120,141018925,709805
-1,1,9,140407572,141053525,645953
-1,1,9,140468865,141009273,540408
-1,1,9,140444759,140730408,285649
-1,1,9,140444759,140878805,434046
-1,1,9,140533290,140716973,183683
-1,1,9,140620020,140854178,234158
-1,1,9,140637559,140638660,1101
-1,1,9,140639661,140726103,86442
-1,1,9,140652116,140669912,17796
-1,1,9,140667620,140677737,10117
-1,1,9,140705084,140711209,6125
1,-1,9,140757063,140954147,197084
1,-1,9,140757063,140954147,197084
1,-1,9,141033138,141106476,73338
1,-1,9,141033138,141106476,73338
1,-1,9,141033138,141106476,73338
1,-1,9,141033138,141138727,105589
1,-1,9,141033138,141138727,105589
1,-1,9,141033138,141138727,105589
1,-1,9,141033138,141138727,105589
1,-1,9,141033138,141138727,105589
1,-1,9,141037873,141122055,84182
1,-1,9,141044751,141090728,45977
1,-1,9,141044751,141146405,101654
1,-1,9,141061567,141106476,44909
1,-1,9,141061567,141138727,77160
1,-1,9,141073853,141102474,28621
1,-1,9,141073853,141106476,32623
1,-1,9,141073853,141106476,32623
1,-1,9,141073853,141122055,48202
1,-1,9,141073853,141122055,48202
1,-1,9,141073853,141122055,48202
1,-1,9,141073853,141146405,72552
-1,1,10,72842,5302166,5229324
1,1,10,72842,35689121,35616279
1,1,10,93297,135378918,135285621
-1,1,10,100026,1074710,974684
-1,1,10,100026,1642998,1542972
-1,1,10,100026,4761588,4661562
-1,1,10,100026,12842179,12742153
1,1,10,100026,13247916,13147890
-1,1,10,100026,19625909,19525883
1,1,10,100026,30278548,30178522
1,1,10,100026,50961640,50861614
1,1,10,100027,135427143,135327116
1,1,10,100027,135427143,135327116
1,1,10,119796,12857914,12738118
-1,1,10,136361,8850609,8714248
-1,1,10,224406,3593472,3369066
-1,1,10,224406,4627886,4403480
1,1,10,224406,11755048,11530642
-1,1,10,224406,13778564,13554158
1,1,10,224406,15415335,15190929
1,1,10,224406,26628907,26404501
1,-1,10,226083,291562,65479
1,-1,10,248464,451013,202549
1,-1,10,248464,451013,202549
1,-1,10,1985245,2134409,149164
1,-1,10,2134409,3174004,1039595
-1,-1,10,2294085,2517261,223176
1,-1,10,2695392,3124061,428669
1,-1,10,2819465,3111473,292008
1,-1,10,4646926,47531169,42884243
1,-1,10,5025476,5049453,23977
1,-1,10,6689655,6833210,143555
1,-1,10,6689655,6833210,143555
-1,1,10,7377293,9129131,1751838
-1,1,10,7470732,21876681,14405949
1,-1,10,9009111,9301368,292257
-1,-1,10,9568299,9721038,152739
1,-1,10,14991045,15014753,23708
1,-1,10,14991045,15014753,23708
1,-1,10,14991045,15014753,23708
1,-1,10,14991045,15014753,23708
1,-1,10,15611468,16818795,1207327
1,-1,10,16939938,16996953,57015
-1,-1,10,17809523,17892239,82716
1,-1,10,17809523,17962915,153392
1,-1,10,17809523,18273895,464372
1,-1,10,17841131,17891703,50572
1,-1,10,17841131,17949651,108520
-1,-1,10,19446590,19810710,364120
-1,-1,10,21195183,21199560,4377
-1,1,10,24400270,25639569,1239299
-1,1,10,27111945,30537855,3425910
1,1,10,32288848,38408609,6119761
1,-1,10,35055358,35183401,128043
1,-1,10,35061767,35157790,96023
-1,-1,10,35183401,35473340,289939
1,-1,10,37443505,37494966,51461
-1,-1,10,38240258,38356008,115750
1,1,10,42607635,69160433,26552798
1,1,10,42890649,52636819,9746170
1,1,10,43180754,75475666,32294912
1,1,10,43379742,54025077,10645335
1,1,10,43379742,54025077,10645335
1,-1,10,43600625,43600691,66
1,-1,10,43600657,43600691,34
1,1,10,43957496,55681185,11723689
1,-1,10,45247685,45331277,83592
1,-1,10,45247685,45331277,83592
1,-1,10,45247685,45331277,83592
1,-1,10,45247685,45331277,83592
1,-1,10,45247685,45331277,83592
1,-1,10,45247685,45331277,83592
1,-1,10,45247685,45331277,83592
1,-1,10,45247685,45331277,83592
1,-1,10,45247685,45331277,83592
-1,1,10,46205690,51330432,5124742
-1,1,10,46205696,51724915,5519219
1,-1,10,46224446,46321318,96872
-1,1,10,46224446,51594991,5370545
1,-1,10,46476965,47531169,1054204
1,-1,10,46491169,46550696,59527
1,-1,10,46491169,46550969,59800
-1,1,10,46491169,51594991,5103822
1,-1,10,46533414,47158684,625270
1,-1,10,46550787,47323674,772887
1,-1,10,46550787,47323674,772887
1,-1,10,46550787,47929856,1379069
1,-1,10,46550787,48055707,1504920
1,-1,10,46550803,47323674,772871
1,-1,10,46550847,47158684,607837
1,-1,10,46550847,47158684,607837
1,-1,10,46550847,47158684,607837
1,-1,10,46550847,47158684,607837
1,-1,10,46550847,47158684,607837
1,-1,10,46550847,47158684,607837
1,-1,10,46550847,47158684,607837
1,-1,10,46550847,47158684,607837
1,-1,10,46550847,47158684,607837
1,-1,10,46550847,47158684,607837
1,-1,10,46550847,47161385,610538
-1,-1,10,46550847,47531169,980322
-1,-1,10,46550847,47531169,980322
1,-1,10,46550847,47531169,980322
1,-1,10,46550847,47531169,980322
1,-1,10,46550847,47531169,980322
1,-1,10,46550847,47531169,980322
1,-1,10,46550847,47531169,980322
1,-1,10,46550847,47531169,980322
1,-1,10,46550847,47531169,980322
1,-1,10,46550847,47531169,980322
1,-1,10,46550847,47531169,980322
1,-1,10,46550847,47531169,980322
1,-1,10,46550847,47531169,980322
1,-1,10,46550847,47531169,980322
1,-1,10,46550847,47531169,980322
1,-1,10,46550847,47531169,980322
1,-1,10,46550847,47531169,980322
1,-1,10,46550847,47531169,980322
1,-1,10,46550847,47531169,980322
1,-1,10,46550847,47719896,1169049
1,-1,10,46550847,47719896,1169049
1,-1,10,46550847,47719896,1169049
1,-1,10,46550847,47719896,1169049
1,-1,10,46550847,47738628,1187781
1,-1,10,46550847,47776292,1225445
1,-1,10,46550847,47776292,1225445
-1,-1,10,46566708,47531169,964461
-1,-1,10,46609932,47033418,423486
-1,-1,10,46609932,47033418,423486
-1,-1,10,46609932,47033418,423486
-1,-1,10,46609932,47074919,464987
-1,-1,10,46609932,47074919,464987
-1,-1,10,46609932,47074919,464987
-1,-1,10,46609932,47074919,464987
-1,-1,10,46609932,47074919,464987
-1,-1,10,46609932,47074919,464987
-1,-1,10,46609932,47074919,464987
-1,-1,10,46609932,47074919,464987
1,-1,10,46609932,47323674,713742
1,-1,10,46609932,47323674,713742
1,-1,10,46609932,47323674,713742
-1,-1,10,46609932,47323674,713742
1,-1,10,46609932,47323674,713742
-1,-1,10,46609932,47323674,713742
-1,-1,10,46609932,47323674,713742
-1,-1,10,46609932,47323674,713742
-1,-1,10,46609932,47323674,713742
-1,-1,10,46609932,47323674,713742
-1,-1,10,46609932,47323674,713742
-1,-1,10,46609932,47323674,713742
-1,-1,10,46609932,47323674,713742
1,-1,10,46609932,47323674,713742
1,-1,10,46609932,47323674,713742
-1,-1,10,46609932,47323674,713742
-1,-1,10,46609932,47323674,713742
1,-1,10,46609932,48055707,1445775
1,-1,10,46609948,49262406,2652458
1,-1,10,46624421,47531169,906748
1,-1,10,46624421,47531169,906748
1,-1,10,46654643,47531169,876526
1,-1,10,46654643,47531169,876526
1,-1,10,46654643,47531169,876526
1,-1,10,46654643,47531169,876526
1,-1,10,46654643,47531169,876526
1,-1,10,46654643,47531169,876526
1,-1,10,46654643,47531169,876526
1,-1,10,46654643,47719896,1065253
1,-1,10,46654643,47719896,1065253
1,-1,10,46654643,47719896,1065253
1,-1,10,46654643,47719896,1065253
1,-1,10,46654643,47719896,1065253
1,-1,10,46654643,47719896,1065253
1,-1,10,46654643,47719896,1065253
1,-1,10,46654643,47719896,1065253
1,-1,10,46654643,47719896,1065253
1,-1,10,46654643,47719896,1065253
1,-1,10,46654643,47719896,1065253
1,-1,10,46654643,47719896,1065253
1,-1,10,46654643,47719896,1065253
1,-1,10,46654643,47719896,1065253
1,-1,10,46654643,47719896,1065253
1,-1,10,46654643,47719896,1065253
1,-1,10,46654643,47719896,1065253
1,-1,10,46654643,47719896,1065253
1,-1,10,46654643,47719896,1065253
1,-1,10,46654643,47719896,1065253
1,-1,10,46654643,47719896,1065253
1,-1,10,46654643,47719896,1065253
1,-1,10,46654643,47719896,1065253
1,-1,10,46654643,47719896,1065253
1,-1,10,46654643,47719896,1065253
1,-1,10,46654643,47719896,1065253
1,-1,10,46654643,47719896,1065253
1,-1,10,46654643,47735909,1081266
1,-1,10,46654643,47735909,1081266
1,-1,10,46654643,47735909,1081266
1,-1,10,46654643,47735909,1081266
1,-1,10,46654643,47735909,1081266
1,-1,10,46654643,47735909,1081266
1,-1,10,46654643,47735909,1081266
1,-1,10,46654643,47735909,1081266
1,-1,10,46654643,47735909,1081266
1,-1,10,46654643,47735909,1081266
1,-1,10,46654643,47735909,1081266
1,-1,10,46654643,47738628,1083985
1,-1,10,46654643,47738628,1083985
1,-1,10,46654643,47738628,1083985
1,-1,10,46654643,47759580,1104937
1,-1,10,46654643,47759580,1104937
1,-1,10,46654643,47759580,1104937
1,-1,10,46654643,47768480,1113837
1,-1,10,46654643,47776292,1121649
1,-1,10,46654643,47776292,1121649
1,-1,10,46654643,47776292,1121649
1,-1,10,46654643,47776292,1121649
1,-1,10,46654643,47776292,1121649
1,-1,10,46654643,47776292,1121649
1,-1,10,46654643,47776292,1121649
1,-1,10,46654643,47776292,1121649
1,-1,10,46654643,47776292,1121649
1,-1,10,46654643,47776292,1121649
1,-1,10,46654643,47776292,1121649
1,-1,10,46654643,47776292,1121649
1,-1,10,46654643,47776292,1121649
1,-1,10,46654643,47776292,1121649
1,-1,10,46654643,47776292,1121649
1,-1,10,46654643,47776292,1121649
1,-1,10,46654643,47776292,1121649
1,-1,10,46654643,47776292,1121649
1,-1,10,46654643,47776292,1121649
1,-1,10,46654643,47776292,1121649
1,-1,10,46654643,47776292,1121649
1,-1,10,46654643,47776292,1121649
1,-1,10,46654643,47776292,1121649
1,-1,10,46654643,47776292,1121649
1,-1,10,46654643,47776292,1121649
1,-1,10,46654643,47776292,1121649
1,-1,10,46654643,47776292,1121649
1,-1,10,46654643,47776292,1121649
1,-1,10,46654643,47776292,1121649
1,-1,10,46654643,47776292,1121649
1,-1,10,46654643,47776292,1121649
1,-1,10,46654643,47776292,1121649
1,-1,10,46654643,47776292,1121649
1,-1,10,46654643,47776292,1121649
1,-1,10,46654643,47776292,1121649
1,-1,10,46654643,47776292,1121649
1,-1,10,46654643,47776292,1121649
1,-1,10,46654643,47776292,1121649
1,-1,10,46654643,47776292,1121649
1,-1,10,46654643,47776292,1121649
1,-1,10,46654643,47776292,1121649
1,-1,10,46654643,47776292,1121649
1,-1,10,46654643,47776292,1121649
1,-1,10,46654643,47776292,1121649
1,-1,10,46654643,47776292,1121649
1,-1,10,46654643,47776292,1121649
1,-1,10,46654643,47776292,1121649
1,-1,10,46654643,47776292,1121649
1,-1,10,46654643,47776292,1121649
1,-1,10,46654643,47776292,1121649
1,-1,10,46654643,47776292,1121649
1,-1,10,46654643,47776292,1121649
1,-1,10,46654643,47776292,1121649
1,-1,10,46654643,47776292,1121649
1,-1,10,46654643,47776292,1121649
1,-1,10,46654643,47776292,1121649
1,-1,10,46654643,47776292,1121649
1,-1,10,46654643,47776292,1121649
1,-1,10,46654643,47776292,1121649
1,-1,10,46654643,47776292,1121649
1,-1,10,46654643,47776292,1121649
1,-1,10,46654643,47776292,1121649
1,-1,10,46654643,47776292,1121649
1,-1,10,46654643,47776292,1121649
1,-1,10,46654643,47776292,1121649
1,-1,10,46654643,47776292,1121649
1,-1,10,46654643,47776292,1121649
1,-1,10,46654643,47776292,1121649
1,-1,10,46654643,47776292,1121649
1,-1,10,46654643,47776292,1121649
1,-1,10,46654643,47776292,1121649
1,-1,10,46654643,47776292,1121649
1,-1,10,46654643,47776292,1121649
1,-1,10,46654643,47776292,1121649
1,-1,10,46654643,47776292,1121649
1,-1,10,46654643,47776292,1121649
1,-1,10,46654643,47897436,1242793
1,-1,10,46654643,47897436,1242793
1,-1,10,46654643,47906980,1252337
1,-1,10,46654643,47906980,1252337
1,-1,10,46654643,48055707,1401064
1,-1,10,46691612,47776292,1084680
1,-1,10,46691612,47776292,1084680
-1,-1,10,46711354,47531169,819815
1,-1,10,46712703,47531169,818466
1,-1,10,46712703,47531169,818466
1,-1,10,46712703,47531169,818466
1,-1,10,46712703,47531169,818466
1,-1,10,46712703,47531169,818466
1,-1,10,46732864,47531169,798305
1,-1,10,46732864,47531169,798305
1,-1,10,46732864,47531169,798305
1,-1,10,46732864,47531169,798305
1,-1,10,46732864,47531169,798305
1,-1,10,46732864,47531169,798305
1,-1,10,46732864,47531169,798305
1,-1,10,46732864,47531169,798305
1,-1,10,46732864,47531169,798305
1,-1,10,46732864,47531169,798305
1,-1,10,46749346,47531169,781823
1,-1,10,46749346,47531169,781823
1,-1,10,46749346,47531169,781823
1,-1,10,46749346,47531169,781823
1,-1,10,46749346,47531169,781823
1,-1,10,46749346,47531169,781823
1,-1,10,46749346,47531169,781823
1,-1,10,46749346,47531169,781823
1,-1,10,46800405,47702392,901987
1,-1,10,46814483,47531169,716686
1,-1,10,46814483,47776292,961809
1,-1,10,46814483,47776292,961809
1,-1,10,46949255,48364954,1415699
-1,-1,10,47006954,47074832,67878
-1,-1,10,47006954,47074861,67907
-1,-1,10,47006954,47074861,67907
1,-1,10,47006954,47148518,141564
-1,-1,10,47006954,47323674,316720
1,-1,10,47006954,47323674,316720
-1,-1,10,47006954,47323674,316720
-1,-1,10,47006954,47323674,316720
1,-1,10,47006954,47323674,316720
-1,-1,10,47006954,47323674,316720
-1,-1,10,47006954,47323674,316720
-1,-1,10,47006954,47323674,316720
-1,-1,10,47006954,47323674,316720
-1,-1,10,47006954,47323674,316720
-1,-1,10,47006954,47323674,316720
1,-1,10,47006954,47323674,316720
-1,-1,10,47006954,47323674,316720
1,-1,10,47006954,47323674,316720
-1,-1,10,47006954,47323674,316720
1,-1,10,47006954,47323674,316720
1,-1,10,47006954,47323674,316720
-1,-1,10,47006954,47323674,316720
-1,-1,10,47006954,47323674,316720
1,-1,10,47006954,47323674,316720
-1,-1,10,47006954,47323674,316720
1,-1,10,47006954,47323674,316720
-1,-1,10,47006954,47323674,316720
-1,-1,10,47006954,47531169,524215
-1,-1,10,47006954,47531169,524215
1,-1,10,47006954,47531169,524215
1,-1,10,47006954,47531169,524215
1,-1,10,47006954,47531169,524215
1,-1,10,47006954,47531169,524215
1,-1,10,47006954,47531169,524215
1,-1,10,47006954,47531169,524215
1,-1,10,47006954,47531169,524215
1,-1,10,47006954,47531169,524215
1,-1,10,47006954,47531169,524215
1,-1,10,47006954,47531169,524215
1,-1,10,47006954,47531169,524215
1,-1,10,47006954,47531169,524215
1,-1,10,47006954,47531169,524215
-1,-1,10,47006954,47531169,524215
-1,-1,10,47006954,47531169,524215
1,-1,10,47006954,47531169,524215
1,-1,10,47006954,47531169,524215
1,-1,10,47006954,47531169,524215
1,-1,10,47006954,47531169,524215
-1,-1,10,47006954,47531169,524215
1,-1,10,47006954,47531169,524215
1,-1,10,47006954,47531169,524215
1,-1,10,47006954,47531169,524215
-1,-1,10,47006954,47531169,524215
1,-1,10,47006954,47531169,524215
1,-1,10,47006954,47531169,524215
1,-1,10,47006954,47531169,524215
1,-1,10,47006954,47531169,524215
1,-1,10,47006954,47531169,524215
1,-1,10,47006954,47531169,524215
1,-1,10,47006954,47531169,524215
-1,-1,10,47006954,47531169,524215
1,-1,10,47006954,47531169,524215
1,-1,10,47006954,47531169,524215
1,-1,10,47006954,47531169,524215
1,-1,10,47006954,47531169,524215
-1,-1,10,47006954,47531169,524215
1,-1,10,47006954,47531169,524215
1,-1,10,47006954,47531169,524215
1,-1,10,47006954,47531169,524215
1,-1,10,47006954,47531169,524215
1,-1,10,47006954,47531169,524215
-1,-1,10,47006954,47531169,524215
1,-1,10,47006954,47531169,524215
-1,-1,10,47006954,47531169,524215
1,-1,10,47006954,47531169,524215
1,-1,10,47006954,47531169,524215
-1,-1,10,47006954,47531169,524215
1,-1,10,47006954,47531169,524215
1,-1,10,47006954,47531169,524215
1,-1,10,47006954,47531169,524215
1,-1,10,47006954,47531169,524215
-1,-1,10,47006954,47531169,524215
1,-1,10,47006954,47531169,524215
1,-1,10,47006954,47531169,524215
1,-1,10,47006954,47531169,524215
1,-1,10,47006954,47531169,524215
1,-1,10,47006954,47531169,524215
1,-1,10,47006954,47531169,524215
-1,-1,10,47006954,47531169,524215
1,-1,10,47006954,47531169,524215
1,-1,10,47006954,47702558,695604
1,-1,10,47006954,47768522,761568
1,-1,10,47006954,47768540,761586
1,-1,10,47006954,47768540,761586
-1,-1,10,47006954,47768540,761586
1,-1,10,47006954,47768540,761586
1,-1,10,47006954,47929856,922902
1,-1,10,47006954,48055707,1048753
1,-1,10,47006954,48055707,1048753
1,-1,10,47006954,48055707,1048753
1,-1,10,47006954,48055707,1048753
1,-1,10,47006954,48055707,1048753
1,-1,10,47006954,48055707,1048753
-1,-1,10,47006954,48055707,1048753
-1,-1,10,47006954,48055707,1048753
1,-1,10,47006954,48055707,1048753
1,-1,10,47006954,48055707,1048753
1,-1,10,47006954,48055707,1048753
1,-1,10,47006954,48055707,1048753
1,-1,10,47006954,48055707,1048753
1,-1,10,47006954,48055707,1048753
1,-1,10,47006954,48055707,1048753
1,-1,10,47033385,47531169,497784
1,-1,10,47033385,47531169,497784
1,-1,10,47074802,47531169,456367
1,-1,10,47074802,47531169,456367
1,-1,10,47074802,47531169,456367
1,-1,10,47074802,47531169,456367
1,-1,10,47074802,47531169,456367
1,-1,10,47074860,47531169,456309
1,-1,10,47074860,47531169,456309
1,-1,10,47229666,47776292,546626
1,-1,10,47547622,47655116,107494
1,-1,10,48664015,49299273,635258
1,-1,10,49002272,49351034,348762
1,-1,10,49002272,49351034,348762
1,-1,10,49002272,49351034,348762
1,-1,10,49002272,49351034,348762
1,-1,10,49002272,49351034,348762
1,-1,10,49002272,49351034,348762
1,-1,10,49002272,49351034,348762
1,-1,10,49002272,49351034,348762
1,-1,10,49002272,49351034,348762
1,-1,10,49002272,49372022,369750
1,-1,10,49002272,49372022,369750
1,-1,10,49002272,49372022,369750
1,-1,10,49002272,49372022,369750
1,-1,10,49002272,49372022,369750
1,-1,10,49002272,49390071,387799
1,-1,10,49002272,49390071,387799
1,-1,10,49002272,49390071,387799
1,-1,10,49002272,49390071,387799
1,-1,10,49002272,49390071,387799
1,-1,10,49002272,49390071,387799
1,-1,10,49002272,49390071,387799
1,-1,10,49002272,49390071,387799
1,-1,10,49002272,49390071,387799
1,-1,10,49002272,49390071,387799
1,-1,10,49002272,49390071,387799
1,-1,10,49002272,49390071,387799
-1,-1,10,49002272,49390071,387799
1,-1,10,49002272,49390071,387799
1,-1,10,49002272,49390071,387799
1,-1,10,49002272,49416448,414176
1,-1,10,49002272,49416448,414176
1,-1,10,49002272,49416448,414176
1,-1,10,49002272,49416448,414176
1,-1,10,49002272,49416448,414176
1,-1,10,49002272,49416448,414176
1,-1,10,49002272,49431037,428765
1,-1,10,49002272,49453774,451502
1,-1,10,49367155,49382926,15771
1,-1,10,49367155,49382926,15771
1,-1,10,49367155,49382926,15771
1,-1,10,49367155,49382926,15771
1,-1,10,49367155,49392896,25741
-1,-1,10,51058602,51089817,31215
1,-1,10,52489127,52518930,29803
1,1,10,52489127,88906961,36417834
1,-1,10,53834509,53982615,148106
-1,1,10,54810806,56486307,1675501
-1,1,10,55714219,55857931,143712
1,-1,10,56176972,56196387,19415
1,-1,10,56176972,56196387,19415
-1,-1,10,56932314,57187055,254741
1,1,10,57046937,69318200,12271263
1,-1,10,59180697,59364871,184174
-1,1,10,65162339,77055857,11893518
-1,-1,10,66985030,67121618,136588
-1,-1,10,68072732,68154487,81755
-1,-1,10,68072732,68251535,178803
-1,-1,10,68122938,68376764,253826
-1,-1,10,68154487,68359435,204948
-1,-1,10,68182308,68290259,107951
-1,-1,10,68182308,68322619,140311
-1,-1,10,68211551,68322619,111068
-1,-1,10,68237581,68443835,206254
-1,-1,10,68251565,68427784,176219
-1,-1,10,68290259,68465910,175651
-1,-1,10,68322619,68359435,36816
-1,-1,10,68322619,68465910,143291
-1,-1,10,68395508,68465910,70402
-1,-1,10,68443835,68516519,72684
-1,-1,10,68479220,68599432,120212
1,1,10,68956325,81181813,12225488
1,-1,10,75434036,75457286,23250
1,-1,10,75434036,75457286,23250
1,-1,10,75434036,75461165,27129
-1,1,10,75542067,79428995,3886928
1,-1,10,81251577,81557993,306416
-1,1,10,81449116,88983530,7534414
-1,1,10,81561459,88828018,7266559
-1,1,10,81597767,88951347,7353580
-1,1,10,81617260,88980961,7363701
1,1,10,81630468,88973570,7343102
-1,1,10,81630468,88975551,7345083
-1,1,10,81640994,88940429,7299435
-1,1,10,81641918,88828018,7186100
-1,1,10,81641918,88828018,7186100
-1,1,10,81685362,135524747,53839385
-1,1,10,81685369,88711465,7026096
-1,1,10,81892411,88722952,6830541
-1,1,10,82013260,89166455,7153195
-1,-1,10,84137675,84270008,132333
1,-1,10,84232776,84433985,201209
-1,1,10,86766571,92609514,5842943
1,-1,10,89685136,89685328,192
-1,-1,10,90236197,90341481,105284
1,-1,10,92363552,92594891,231339
-1,1,10,92667881,98970384,6302503
-1,1,10,93186527,95820286,2633759
1,1,10,93283493,135427143,42143650
-1,1,10,93908171,101809723,7901552
-1,1,10,94403676,97230894,2827218
-1,-1,10,96453830,96612764,158934
-1,-1,10,96520226,96540436,20210
-1,-1,10,100667725,100696797,29072
1,1,10,100780957,135427143,34646186
1,1,10,102360249,135436092,33075843
-1,1,10,102437474,102524276,86802
1,1,10,102937062,103478866,541804
1,1,10,102969098,103402989,433891
1,1,10,102947729,103488168,540439
1,1,10,102949227,103482524,533297
1,1,10,102949737,103432420,482683
1,1,10,102969339,103508138,538799
1,1,10,103208804,103449273,240469
-1,1,10,104030479,115410590,11380111
-1,1,10,104491930,115844864,11352934
1,1,10,104633712,135427143,30793431
1,1,10,106003533,135427143,29423610
1,-1,10,107109062,107280724,171662
1,-1,10,107109062,107280724,171662
1,-1,10,108460220,108512225,52005
1,1,10,109862345,135434178,25571833
1,1,10,109862345,135434178,25571833
1,-1,10,110670383,111523045,852662
-1,-1,10,110764724,110873097,108373
1,1,10,111428528,126441219,15012691
-1,1,10,113833852,117032437,3198585
1,1,10,118124844,135474725,17349881
1,-1,10,119302796,119306966,4170
1,1,10,120089648,120445385,355737
1,1,10,120520942,131399550,10878608
1,1,10,121467368,135427143,13959775
-1,1,10,122343861,135427143,13083282
-1,1,10,122730071,135436092,12706021
-1,1,10,123348506,135434178,12085672
-1,1,10,123678062,135434178,11756116
-1,1,10,123902691,126046582,2143891
-1,1,10,124147428,135370736,11223308
1,-1,10,124500982,124604479,103497
-1,1,10,124640723,135434113,10793390
-1,1,10,125335909,135427143,10091234
-1,1,10,125746288,135427143,9680855
1,1,10,125792404,129167091,3374687
-1,1,10,126161677,135434113,9272436
-1,1,10,126523427,135436092,8912665
-1,1,10,126710564,135434113,8723549
1,1,10,127141474,135523199,8381725
-1,1,10,127346041,135434178,8088137
-1,1,10,127346041,135434178,8088137
-1,1,10,127658004,135427143,7769139
1,-1,10,127797178,128068419,271241
-1,1,10,128419465,135434113,7014648
-1,1,10,128465436,135427143,6961707
-1,1,10,128483215,135427143,6943928
1,-1,10,128636069,128656069,20000
1,-1,10,128636069,128656069,20000
1,-1,10,128636069,128656069,20000
1,-1,10,128636069,128656069,20000
1,1,10,129007673,135427143,6419470
-1,1,10,129234249,135436092,6201843
1,-1,10,129536749,129539386,2637
-1,1,10,129647981,135436092,5788111
-1,1,10,130348177,135436092,5087915
1,1,10,130670683,135377532,4706849
-1,1,10,131225784,135436092,4210308
-1,1,10,131347522,135434178,4086656
-1,1,10,131458045,135434178,3976133
-1,1,10,132468363,135367666,2899303
1,-1,10,133255624,133728500,472876
1,-1,10,133594027,133637871,43844
-1,1,10,133991979,135434178,1442199
-1,-1,10,134590030,134599348,9318
1,-1,10,134599348,134814579,215231
1,-1,10,134704410,134754545,50135
1,-1,10,134704410,134795598,91188
1,-1,10,134748338,134843094,94756
-1,-1,10,134947783,135214016,266233
1,-1,10,135234763,135404550,169787
-1,-1,10,135234787,135372492,137705
1,-1,10,135242631,135369831,127200
1,-1,10,135242631,135369831,127200
1,-1,10,135242631,135377390,134759
1,-1,10,135242631,135377390,134759
1,-1,10,135242631,135377390,134759
1,-1,10,135242631,135377390,134759
1,-1,10,135242631,135377390,134759
1,-1,10,135242631,135377390,134759
1,-1,10,135242631,135377390,134759
1,-1,10,135242631,135377390,134759
1,-1,10,135242631,135377390,134759
1,-1,10,135242631,135377390,134759
1,-1,10,135242631,135377390,134759
1,-1,10,135242631,135377390,134759
1,-1,10,135242631,135377390,134759
1,-1,10,135242631,135377390,134759
1,-1,10,135242631,135377390,134759
1,-1,10,135242631,135377390,134759
1,-1,10,135242631,135377390,134759
1,-1,10,135242631,135377390,134759
1,-1,10,135242631,135377390,134759
-1,-1,10,135242631,135377390,134759
1,-1,10,135242631,135377390,134759
-1,-1,10,135242631,135377390,134759
-1,-1,10,135242631,135377390,134759
1,-1,10,135242631,135377390,134759
1,-1,10,135242631,135377390,134759
1,-1,10,135242631,135377390,134759
1,-1,10,135242631,135377390,134759
1,-1,10,135242631,135377390,134759
-1,-1,10,135242631,135377390,134759
1,-1,10,135242631,135377390,134759
-1,-1,10,135242631,135377390,134759
1,-1,10,135242631,135377390,134759
1,-1,10,135242631,135377390,134759
1,-1,10,135242631,135377390,134759
1,-1,10,135242631,135377390,134759
1,-1,10,135242631,135377390,134759
1,-1,10,135242631,135404550,161919
1,-1,10,135242631,135404550,161919
1,-1,10,135242631,135404550,161919
1,-1,10,135242631,135404550,161919
1,-1,10,135242631,135434113,191482
1,-1,10,135242631,135434113,191482
1,-1,10,135242631,135434113,191482
1,-1,10,135242631,135434113,191482
1,-1,10,135242631,135434113,191482
1,-1,10,135242631,135434113,191482
1,-1,10,135242631,135434113,191482
1,-1,10,135242631,135434113,191482
1,-1,10,135242631,135434113,191482
1,-1,10,135243049,135377532,134483
1,-1,10,135243049,135377532,134483
1,-1,10,135243049,135377532,134483
1,-1,10,135243049,135377532,134483
1,-1,10,135243049,135377532,134483
1,-1,10,135243049,135377532,134483
1,-1,10,135245746,135372492,126746
-1,-1,10,135245746,135377532,131786
1,-1,10,135254039,135367722,113683
-1,-1,10,135254039,135377532,123493
-1,-1,10,135254039,135377532,123493
1,-1,10,135254039,135377532,123493
1,-1,10,135254039,135377532,123493
1,-1,10,135254039,135377532,123493
1,-1,10,135254039,135377532,123493
1,-1,10,135254039,135377532,123493
-1,-1,10,135254039,135377532,123493
1,-1,10,135254039,135377532,123493
1,-1,10,135254039,135377532,123493
1,-1,10,135254039,135377532,123493
1,-1,10,135254039,135377532,123493
1,-1,10,135254039,135377532,123493
1,-1,10,135254039,135377532,123493
1,-1,10,135254039,135377532,123493
1,-1,10,135254039,135377532,123493
1,-1,10,135254039,135377532,123493
-1,-1,10,135254039,135377532,123493
1,-1,10,135254039,135377532,123493
1,-1,10,135254039,135377532,123493
1,-1,10,135254039,135377532,123493
1,-1,10,135254039,135377532,123493
1,-1,10,135254039,135377532,123493
1,-1,10,135254039,135377532,123493
1,-1,10,135254039,135377532,123493
-1,-1,10,135254039,135377532,123493
1,-1,10,135254039,135377532,123493
-1,-1,10,135254039,135377532,123493
1,-1,10,135254039,135377532,123493
1,-1,10,135254039,135377532,123493
-1,-1,10,135254039,135377532,123493
1,-1,10,135254039,135377532,123493
-1,-1,10,135254039,135377532,123493
1,-1,10,135254039,135377532,123493
-1,-1,10,135254039,135377532,123493
1,-1,10,135254039,135377532,123493
1,-1,10,135254039,135377532,123493
-1,-1,10,135254039,135377532,123493
-1,-1,10,135254039,135377532,123493
-1,-1,10,135254039,135377532,123493
1,-1,10,135254039,135377532,123493
-1,-1,10,135254039,135377532,123493
1,-1,10,135254039,135377532,123493
1,-1,10,135254039,135377532,123493
1,-1,10,135254039,135377532,123493
-1,-1,10,135254039,135377532,123493
1,-1,10,135254039,135377532,123493
1,-1,10,135254039,135377532,123493
1,-1,10,135254039,135377532,123493
1,-1,10,135254039,135377532,123493
1,-1,10,135254039,135377532,123493
1,-1,10,135254039,135377532,123493
1,-1,10,135254039,135377532,123493
1,-1,10,135254039,135377532,123493
-1,-1,10,135254039,135377532,123493
1,-1,10,135254039,135377532,123493
1,-1,10,135254039,135377532,123493
-1,-1,10,135254039,135377532,123493
1,-1,10,135254039,135377532,123493
1,-1,10,135254039,135377532,123493
1,-1,10,135254039,135377532,123493
-1,-1,10,135254039,135377532,123493
1,-1,10,135254039,135377532,123493
1,-1,10,135254039,135377532,123493
1,-1,10,135254039,135377532,123493
1,-1,10,135254039,135377532,123493
1,-1,10,135254039,135377532,123493
-1,-1,10,135254039,135377532,123493
1,-1,10,135254039,135377532,123493
-1,-1,10,135254039,135377532,123493
1,-1,10,135254039,135377532,123493
1,-1,10,135254039,135404523,150484
1,-1,10,135254039,135404523,150484
1,-1,10,135254039,135434178,180139
1,-1,10,135254039,135434178,180139
1,-1,10,135254039,135434178,180139
1,-1,10,135254039,135434178,180139
-1,-1,10,135254053,135377390,123337
1,-1,10,135254053,135434113,180060
1,-1,10,135254067,135372463,118396
-1,-1,10,135258619,135349723,91104
1,-1,10,135258676,135377502,118826
1,-1,10,135267356,135352746,85390
-1,-1,10,135270265,135377390,107125
1,-1,10,135270265,135377390,107125
1,-1,10,135270265,135377390,107125
1,-1,10,135270265,135377390,107125
1,-1,10,135270265,135377390,107125
1,-1,10,135270265,135377390,107125
1,-1,10,135270265,135377390,107125
1,-1,10,135274904,135369831,94927
-1,-1,10,135274904,135377390,102486
-1,-1,10,135274904,135377390,102486
-1,-1,10,135274904,135377390,102486
1,-1,10,135274904,135377390,102486
1,-1,10,135274904,135377390,102486
1,-1,10,135274904,135377390,102486
1,-1,10,135274904,135377390,102486
1,-1,10,135274904,135377390,102486
1,-1,10,135274904,135377390,102486
1,-1,10,135274904,135377390,102486
1,-1,10,135274904,135377390,102486
1,-1,10,135274904,135377390,102486
1,-1,10,135274904,135377390,102486
1,-1,10,135274904,135377390,102486
1,-1,10,135274904,135377390,102486
1,-1,10,135274904,135377390,102486
1,-1,10,135274904,135434113,159209
1,-1,10,135279267,135369835,90568
1,-1,10,135279267,135372492,93225
1,-1,10,135279267,135372492,93225
1,-1,10,135279267,135377532,98265
1,-1,10,135281699,135369831,88132
1,-1,10,135281699,135377390,95691
1,-1,10,135281699,135377390,95691
1,-1,10,135281699,135377390,95691
1,-1,10,135281699,135377390,95691
1,-1,10,135281699,135377390,95691
1,-1,10,135281699,135377390,95691
1,-1,10,135295139,135372521,77382
1,-1,10,135295747,135377390,81643
1,-1,10,135295747,135434113,138366
1,-1,10,135316810,135434178,117368
1,-1,10,135316810,135434178,117368
1,-1,10,135316867,135332584,15717
-1,-1,10,135323834,135345854,22020
1,-1,10,135338156,135354334,16178
1,-1,10,135342180,135434113,91933
1,-1,10,135349664,135434113,84449
1,-1,10,135352362,135369831,17469
1,-1,10,135352362,135434113,81751
1,-1,10,135352362,135434113,81751
1,-1,10,135352362,135434113,81751
1,-1,10,135352362,135434113,81751
1,-1,10,135352362,135434113,81751
1,-1,10,135352362,135434113,81751
1,-1,10,135352362,135434113,81751
1,-1,10,135352362,135434113,81751
1,-1,10,135352362,135434113,81751
1,-1,10,135352362,135434113,81751
1,-1,10,135352362,135434113,81751
1,-1,10,135352362,135434113,81751
1,-1,10,135352362,135434113,81751
1,-1,10,135352362,135434113,81751
1,-1,10,135352362,135434113,81751
1,-1,10,135352362,135434113,81751
1,-1,10,135352362,135434113,81751
1,-1,10,135352362,135434113,81751
1,-1,10,135352362,135434113,81751
1,-1,10,135352362,135434113,81751
1,-1,10,135352362,135434113,81751
1,-1,10,135352362,135434113,81751
1,-1,10,135352362,135434113,81751
1,-1,10,135352362,135434113,81751
1,-1,10,135352362,135434113,81751
1,-1,10,135352362,135434113,81751
1,-1,10,135352362,135434113,81751
1,-1,10,135352362,135434113,81751
1,-1,10,135352362,135434113,81751
1,-1,10,135352362,135434113,81751
1,-1,10,135352362,135434113,81751
1,-1,10,135352362,135434113,81751
1,-1,10,135352362,135434113,81751
1,-1,10,135352362,135434113,81751
1,-1,10,135352362,135434113,81751
1,-1,10,135352362,135434113,81751
1,-1,10,135352362,135434113,81751
1,-1,10,135352362,135434113,81751
1,-1,10,135352362,135434113,81751
1,-1,10,135352362,135434113,81751
1,-1,10,135352372,135372492,20120
1,-1,10,135352372,135372492,20120
-1,-1,10,135352372,135377532,25160
-1,-1,10,135352372,135377532,25160
-1,-1,10,135352372,135377532,25160
-1,-1,10,135352372,135377532,25160
-1,-1,10,135352372,135377532,25160
-1,-1,10,135352372,135377532,25160
-1,-1,10,135352372,135377532,25160
-1,-1,10,135352372,135377532,25160
1,-1,10,135352372,135404523,52151
1,-1,10,135352372,135434178,81806
1,-1,10,135352372,135434178,81806
1,-1,10,135352372,135434178,81806
1,-1,10,135352372,135434178,81806
1,-1,10,135352372,135434178,81806
1,-1,10,135352372,135434178,81806
1,-1,10,135352372,135434178,81806
1,-1,10,135352372,135434178,81806
1,-1,10,135352372,135434178,81806
1,-1,10,135352372,135434178,81806
1,-1,10,135352372,135434178,81806
1,-1,10,135352372,135434178,81806
1,-1,10,135352372,135434178,81806
1,-1,10,135352372,135434178,81806
1,-1,10,135352372,135434178,81806
1,-1,10,135352372,135434178,81806
1,-1,10,135352372,135434178,81806
1,-1,10,135352372,135434178,81806
1,-1,10,135352372,135434178,81806
1,-1,10,135352372,135434178,81806
1,-1,10,135352372,135434178,81806
1,-1,10,135352372,135434178,81806
1,-1,10,135352372,135434178,81806
1,-1,10,135352372,135434178,81806
1,-1,10,135352372,135434178,81806
1,-1,10,135354275,135369831,15556
1,-1,10,135354275,135434113,79838
1,-1,10,135391263,135411383,20120
1,-1,10,135391263,135443414,52151
1,-1,10,135391263,135443414,52151
1,-1,11,61793,116316,54523
1,1,11,61793,10749516,10687723
1,1,11,138203,5484157,5345954
1,1,11,193187,5291338,5098151
1,1,11,196855,2137415,1940560
1,1,11,196855,5343104,5146249
1,-1,11,196966,244236,47270
1,-1,11,196966,244236,47270
1,-1,11,200222,237805,37583
1,1,11,230615,6644927,6414312
1,1,11,230615,25584362,25353747
1,1,11,230615,31995219,31764604
1,1,11,230615,37698540,37467925
1,1,11,230616,134938470,134707854
1,1,11,230616,134938470,134707854
1,-1,11,313991,504786,190795
1,-1,11,359217,414570,55353
1,-1,11,359217,414570,55353
1,-1,11,371634,414570,42936
1,-1,11,371634,414570,42936
1,-1,11,371634,414570,42936
1,-1,11,371634,414570,42936
1,-1,11,371634,414570,42936
1,-1,11,371634,414570,42936
1,-1,11,371634,426161,54527
1,-1,11,371634,426161,54527
1,-1,11,371634,426161,54527
1,-1,11,371634,426161,54527
1,-1,11,371634,426161,54527
1,1,11,446754,18926289,18479535
-1,-1,11,662668,699404,36736
-1,1,11,1126807,3235153,2108346
1,-1,11,1362463,1468991,106528
1,-1,11,1362463,1468991,106528
1,1,11,1558609,3381999,1823390
1,-1,11,1996741,2159676,162935
1,1,11,1996741,2909925,913184
1,-1,11,2016675,2016841,166
1,-1,11,2016675,2016841,166
1,-1,11,2019681,2020547,866
-1,1,11,2475746,2482833,7087
1,-1,11,2904944,2905042,98
1,-1,11,3547816,3645310,97494
1,-1,11,3645310,3655670,10360
1,-1,11,5269595,5275588,5993
1,-1,11,5269595,5275588,5993
1,-1,11,5269595,5275588,5993
1,-1,11,5269595,5275588,5993
1,-1,11,5269595,5275588,5993
1,-1,11,5269595,5275588,5993
1,-1,11,5269595,5275588,5993
1,-1,11,5269595,5275588,5993
1,1,11,6282812,6659230,376418
-1,-1,11,7686529,7818037,131508
-1,-1,11,7712477,7818037,105560
-1,-1,11,7817491,7847049,29558
-1,-1,11,7817491,7847049,29558
-1,-1,11,7817491,7847049,29558
-1,-1,11,7817491,7847049,29558
-1,-1,11,7817491,7847049,29558
-1,-1,11,7817491,7847049,29558
-1,-1,11,7817491,7847049,29558
-1,-1,11,7817491,7847049,29558
-1,-1,11,7817491,7847049,29558
-1,-1,11,7817491,7894373,76882
-1,1,11,10011063,16847353,6836290
1,1,11,10172921,13963463,3790542
1,-1,11,18908667,18956427,47760
1,-1,11,18908667,19048572,139905
1,-1,11,18955543,19076609,121066
-1,1,11,20101020,34485543,14384523
-1,1,11,23527622,27901352,4373730
1,-1,11,24563723,24657683,93960
1,1,11,24616945,31118086,6501141
-1,-1,11,24847925,25085213,237288
1,-1,11,25424279,26330690,906411
-1,1,11,25771208,35614978,9843770
-1,1,11,26390509,35274523,8884014
1,1,11,26574629,50508019,23933390
-1,1,11,27895487,34494489,6599002
-1,1,11,29238811,45494063,16255252
-1,1,11,31210842,31722681,511839
-1,1,11,31210842,35436121,4225279
-1,1,11,31320870,31811619,490749
1,1,11,31622079,32144347,522268
-1,1,11,31825724,31839168,13444
-1,1,11,31828509,34576695,2748186
-1,-1,11,36294301,36310900,16599
-1,1,11,39200802,49157287,9956485
-1,1,11,39706376,44866811,5160435
-1,-1,11,40339615,40652281,312666
-1,1,11,41139872,48664555,7524683
-1,1,11,42475897,48372559,5896662
-1,1,11,42575209,46136343,3561134
-1,1,11,44214357,44305745,91388
-1,1,11,47232210,47448882,216672
1,-1,11,47589813,47617121,27308
1,-1,11,50008083,51378911,1370828
1,-1,11,50008083,51378911,1370828
1,-1,11,50008083,51378911,1370828
1,-1,11,50032805,51378911,1346106
1,-1,11,50049613,51378911,1329298
1,-1,11,50121285,51378911,1257626
1,-1,11,50121285,51378911,1257626
1,-1,11,50121285,51378911,1257626
1,-1,11,50121285,51378911,1257626
1,-1,11,55029738,55980347,950609
1,-1,11,55033164,55980347,947183
1,-1,11,55033261,55997702,964441
1,-1,11,55086995,55980406,893411
1,-1,11,55086995,55980406,893411
1,-1,11,55086995,55980406,893411
1,1,11,55086995,58766250,3679255
-1,-1,11,55368154,55560160,192006
1,-1,11,55368362,55438706,70344
-1,-1,11,55368362,55450758,82396
1,-1,11,55368362,55450758,82396
1,-1,11,55368362,55450758,82396
1,-1,11,55368362,55450758,82396
1,-1,11,55368362,55450758,82396
1,-1,11,55368362,55450758,82396
-1,-1,11,55368362,55450758,82396
1,-1,11,55368362,55450758,82396
1,-1,11,55368362,55450758,82396
-1,-1,11,55368362,55450758,82396
-1,-1,11,55368362,55450758,82396
-1,-1,11,55368362,55450758,82396
-1,-1,11,55703736,55816312,112576
-1,-1,11,55740538,55821016,80478
-1,-1,11,55740538,55821016,80478
-1,-1,11,55740538,55821016,80478
1,-1,11,55740538,55821016,80478
-1,-1,11,55740538,55821016,80478
1,-1,11,55917298,56537994,620696
-1,-1,11,56322990,56352364,29374
-1,-1,11,56322990,56352364,29374
1,1,11,62016992,62713565,696573
-1,1,11,65508902,67473140,1964238
-1,-1,11,67164667,67411909,247242
1,-1,11,67259243,67274585,15342
1,-1,11,67511222,67643217,131995
1,-1,11,67574343,67643217,68874
1,-1,11,67764080,67811086,47006
1,-1,11,69587777,69588196,419
1,1,11,70853054,71088948,235894
-1,1,11,71088949,72833199,1744250
-1,1,11,71154800,71157788,2988
-1,1,11,75652798,98228688,22575890
-1,1,11,80318996,96116221,15797225
-1,-1,11,80656651,80902908,246257
-1,-1,11,81137098,81218937,81839
-1,-1,11,84333985,84419443,85458
-1,-1,11,84419443,84583725,164282
-1,1,11,88152458,109414650,21262192
-1,1,11,88156563,114491338,26334775
1,-1,11,89540275,89956475,416200
-1,-1,11,89631979,89656912,24933
-1,1,11,90819827,109466308,18646481
-1,-1,11,92293847,92397611,103764
1,-1,11,96632623,97924186,1291563
1,-1,11,96808589,97273356,464767
-1,-1,11,97720768,98228629,507861
-1,-1,11,97720768,98309787,589019
-1,-1,11,97720768,98309787,589019
-1,1,11,98228629,105929873,7701244
1,1,11,101323715,103914833,2591118
-1,-1,11,103267305,103347787,80482
1,-1,11,104321199,104405899,84700
1,-1,11,104643215,104701837,58622
1,1,11,106467595,113879729,7412134
-1,1,11,107349817,108093259,743442
1,-1,11,107537206,107582654,45448
1,-1,11,109804992,109928090,123098
1,1,11,112832130,131059210,18227080
1,1,11,116676984,134945165,18268181
1,1,11,116681007,134938470,18257463
1,1,11,116681007,134938470,18257463
1,1,11,116681007,134938470,18257463
1,1,11,116684163,134938470,18254307
1,1,11,116722088,134868420,18146332
1,1,11,116722111,134868407,18146296
1,1,11,116722111,134868407,18146296
1,1,11,116739651,134945165,18205514
1,1,11,116739651,134945165,18205514
1,1,11,117204668,127579051,10374383
1,1,11,119054729,134946516,15891787
-1,1,11,119295007,134945165,15650158
-1,1,11,119513909,134938470,15424561
-1,1,11,119950851,125699001,5748150
-1,1,11,120296802,124641109,4344307
-1,1,11,120386468,134945165,14558697
-1,1,11,120527021,134938470,14411449
-1,1,11,121136603,134938470,13801867
-1,1,11,121416261,134938470,13522209
-1,1,11,121482185,134938470,13456285
-1,1,11,121501072,134868348,13367276
-1,1,11,121559102,134938470,13379368
-1,1,11,121559760,134945165,13385405
-1,1,11,121651167,134945165,13293998
-1,1,11,121677255,134938470,13261215
-1,1,11,121679628,134946516,13266888
-1,1,11,122053151,125827872,3774721
-1,1,11,122403610,134938470,12534860
1,1,11,122884694,134938470,12053776
-1,1,11,123670646,134868420,11197774
-1,1,11,123833781,134945165,11111384
-1,1,11,123860285,134868407,11008122
-1,1,11,124075932,134868420,10792488
-1,1,11,124184921,134688010,10503089
-1,1,11,124254553,125315622,1061069
-1,1,11,124809955,134945165,10135210
-1,1,11,125111368,134868407,9757039
-1,1,11,125662934,134938470,9275536
-1,1,11,125780310,128942331,3162021
-1,1,11,125916253,134868407,8952154
-1,1,11,125916253,134945165,9028912
-1,1,11,126069484,134945165,8875681
-1,1,11,126762944,134938470,8175526
-1,1,11,127434377,134945165,7510788
-1,1,11,127785859,134938470,7152611
-1,1,11,129721809,134938470,5216661
-1,1,11,130576399,134945165,4368766
-1,1,11,131081923,134945165,3863242
-1,1,11,131426397,134938470,3512073
-1,1,11,132806620,134868407,2061787
-1,-1,11,133546203,133626429,80226
1,-1,11,134157357,134207815,50458
1,-1,11,134157357,134207815,50458
-1,-1,11,134157357,134207815,50458
-1,-1,11,134157357,134207815,50458
-1,-1,11,134157357,134207815,50458
-1,-1,11,134157357,134207815,50458
-1,-1,11,134157357,134207815,50458
1,-1,11,134157357,134228038,70681
-1,1,11,134247841,134938470,690629
1,-1,11,134300576,134711672,411096
1,-1,11,134300598,134720418,419820
1,-1,11,134353814,134711613,357799
1,-1,11,134353814,134711613,357799
1,-1,11,134353814,134711613,357799
1,-1,11,134353814,134711613,357799
1,-1,11,134353814,134711613,357799
1,-1,11,134353814,134711613,357799
1,-1,11,134353814,134711613,357799
1,-1,11,134353814,134711613,357799
1,-1,11,134353814,134711613,357799
1,-1,11,134353814,134711613,357799
1,-1,11,134353814,134711613,357799
-1,-1,11,134381632,134446101,64469
1,-1,11,134381632,134711672,330040
1,-1,11,134381632,134711672,330040
1,-1,11,134381632,134711672,330040
1,-1,11,134381632,134711672,330040
1,-1,11,134381632,134711672,330040
1,-1,11,134381632,134711672,330040
1,-1,11,134381632,134711672,330040
1,-1,11,134381632,134711672,330040
1,-1,11,134381632,134720344,338712
-1,-1,11,134381662,134446131,64469
1,-1,11,134381667,134720418,338751
1,-1,11,134381667,134720418,338751
1,-1,11,134381667,134720418,338751
1,-1,11,134381667,134720418,338751
1,-1,11,134381667,134720418,338751
1,-1,11,134381667,134720418,338751
1,-1,11,134381667,134720418,338751
1,-1,11,134381667,134720418,338751
1,-1,11,134381667,134720418,338751
1,-1,11,134381667,134720418,338751
-1,-1,11,134381667,134868420,486753
1,-1,11,134479138,134662766,183628
1,-1,11,134555490,134737625,182135
-1,-1,11,134668757,134904181,235424
1,-1,11,134711613,134816320,104707
1,-1,11,134711613,134816320,104707
1,-1,11,134737566,134816413,78847
1,-1,11,134778896,134945106,166210
1,-1,11,134816261,134890799,74538
1,-1,12,70794,230421,159627
1,-1,12,91682,176861,85179
1,1,12,147099,7054359,6907260
1,-1,12,148034,176816,28782
1,-1,12,148034,176816,28782
1,-1,12,148034,176816,28782
1,-1,12,148034,176816,28782
1,-1,12,148034,176816,28782
1,-1,12,148034,176816,28782
1,-1,12,148034,176816,28782
1,-1,12,148034,176816,28782
1,-1,12,148034,176816,28782
1,1,12,148375,37864477,37716102
-1,1,12,173786,2865649,2691863
-1,1,12,173786,5737510,5563724
-1,1,12,173786,6378954,6205168
1,1,12,173786,8257049,8083263
1,1,12,173786,11677456,11503670
1,1,12,173786,20026080,19852294
1,1,12,173786,25286865,25113079
1,1,12,173786,28219229,28045443
1,1,12,173786,34835837,34662051
1,1,12,173786,34835837,34662051
1,1,12,173786,37869301,37695515
1,1,12,173787,133777902,133604115
1,1,12,173787,133777902,133604115
1,1,12,173787,133777902,133604115
1,1,12,189578,34756150,34566572
1,-1,12,282465,369192,86727
-1,1,12,282465,2667263,2384798
-1,1,12,282465,2959765,2677300
-1,1,12,282465,3112486,2830021
-1,1,12,282465,3112486,2830021
-1,1,12,282465,3748769,3466304
-1,1,12,282465,4114078,3831613
-1,1,12,282465,4529751,4247286
1,1,12,282465,11256448,10973983
1,1,12,282465,34756196,34473731
1,1,12,282465,34756209,34473744
1,1,12,282465,34761006,34478541
1,1,12,282465,133773393,133490928
-1,1,12,309062,5916532,5607470
1,-1,12,461549,475768,14219
1,-1,12,461549,475768,14219
1,1,12,527587,6345080,5817493
1,-1,12,574727,835424,260697
1,-1,12,673437,702446,29009
1,-1,12,673437,702446,29009
1,1,12,733373,18723930,17990557
1,-1,12,754496,866727,112231
1,1,12,1367440,20810511,19443071
1,1,12,1832285,9735479,7903194
1,1,12,2980907,15140282,12159375
-1,1,12,6108512,6252553,144041
1,-1,12,6806571,6840710,34139
1,-1,12,7899994,8071941,171947
1,-1,12,7899994,8088660,188666
-1,-1,12,8003414,8088660,85246
1,-1,12,8325164,8379000,53836
1,-1,12,8325164,8379000,53836
1,-1,12,8325164,8379000,53836
1,-1,12,8325164,8379000,53836
1,-1,12,8325164,8379000,53836
1,-1,12,8325164,8379000,53836
1,-1,12,8325164,8379000,53836
1,-1,12,8325164,8379000,53836
1,-1,12,8328462,8379000,50538
1,-1,12,8328462,8379000,50538
1,-1,12,8340669,8379000,38331
1,-1,12,8340669,8379000,38331
1,-1,12,8352346,8379000,26654
1,-1,12,8352346,8379000,26654
1,-1,12,8352346,8379000,26654
1,-1,12,8352346,8379000,26654
-1,-1,12,9623843,9721829,97986
-1,-1,12,9637353,9687869,50516
-1,-1,12,9637353,9687869,50516
-1,-1,12,9637353,9687869,50516
-1,-1,12,9637353,9693919,56566
-1,-1,12,9637353,9693919,56566
-1,-1,12,9637353,9693919,56566
-1,-1,12,9637353,9693919,56566
-1,-1,12,9637353,9693919,56566
1,-1,12,9637353,9693919,56566
1,-1,12,9637353,9721829,84476
-1,-1,12,9637353,9721829,84476
1,-1,12,9637353,9721829,84476
1,-1,12,9637353,9721829,84476
1,-1,12,9637353,9721829,84476
-1,-1,12,11192674,11273638,80964
-1,1,12,11256448,14367063,3110615
1,-1,12,11513416,11553484,40068
-1,1,12,12514722,15433522,2918800
-1,1,12,12514722,15433522,2918800
-1,1,12,15993788,22174586,6180798
1,1,12,18037107,26681362,8644255
-1,-1,12,21017576,21356582,339006
1,-1,12,22208422,22235024,26602
1,1,12,22329117,27545626,5216509
-1,1,12,22735149,24052760,1317611
-1,1,12,23674558,23735393,60835
-1,1,12,23899592,24266672,367080
1,-1,12,24965813,25225609,259796
1,-1,12,25097583,25225609,128026
-1,1,12,25416767,34217463,8800696
1,-1,12,25485811,25623204,137393
-1,-1,12,27306290,27760067,453777
1,-1,12,27378911,27728702,349791
1,-1,12,33515025,37864477,4349452
1,-1,12,33515025,37864477,4349452
1,-1,12,33515025,37864477,4349452
1,-1,12,33515025,37864477,4349452
1,-1,12,33528404,33579087,50683
1,-1,12,33545353,37864477,4319124
1,-1,12,34044997,37864477,3819480
1,-1,12,34044997,37864477,3819480
1,1,12,37857750,49791459,11933709
1,-1,12,38323017,38864308,541291
1,-1,12,38323017,38864308,541291
1,-1,12,38453610,38861446,407836
1,-1,12,38527748,38721130,193382
1,-1,12,38527748,38826097,298349
1,-1,12,38527748,38826097,298349
1,-1,12,38527748,38826097,298349
-1,1,12,41107689,46945683,5837994
-1,1,12,43928619,48084409,4155790
-1,-1,12,45667640,45782413,114773
-1,1,12,50516142,53642244,3126102
-1,1,12,51027671,53245693,2218022
1,-1,12,52704767,52747397,42630
1,-1,12,52704767,52779684,74917
1,-1,12,52704767,52779684,74917
1,-1,12,52704767,52779684,74917
1,1,12,53814390,56596726,2782336
-1,-1,12,57336297,57374437,38140
-1,-1,12,57346683,57350897,4214
-1,1,12,59495114,70574966,11079852
-1,-1,12,60367402,60454894,87492
-1,1,12,61300932,66961857,5660925
-1,-1,12,63931234,64135026,203792
-1,-1,12,63931234,64135026,203792
-1,-1,12,63931234,64135026,203792
-1,-1,12,63931234,64135026,203792
-1,-1,12,63931234,64135026,203792
-1,-1,12,63931234,64135026,203792
-1,-1,12,63931234,64150760,219526
-1,-1,12,63947732,64078170,130438
1,-1,12,63947732,64078170,130438
1,-1,12,63947732,64078170,130438
1,-1,12,63947732,64116509,168777
1,-1,12,63947732,64116509,168777
1,-1,12,63947732,64116509,168777
1,-1,12,63947732,64116509,168777
1,-1,12,63947732,64116509,168777
1,-1,12,63947732,64116509,168777
1,-1,12,63947732,64116509,168777
1,-1,12,63947732,64116509,168777
1,-1,12,63947732,64116509,168777
-1,-1,12,63947732,64116509,168777
1,-1,12,63947732,64116509,168777
1,-1,12,63947732,64116509,168777
1,-1,12,63947732,64116509,168777
1,-1,12,63947732,64116509,168777
1,-1,12,63947732,64116509,168777
-1,-1,12,63947732,64116509,168777
-1,-1,12,63947732,64116509,168777
1,-1,12,64020292,64116509,96217
-1,1,12,65838956,71420117,5581161
-1,-1,12,66895380,66911133,15753
-1,-1,12,67177292,67249002,71710
-1,-1,12,67183476,67210339,26863
-1,1,12,70163517,77357997,7194480
-1,1,12,73879477,93189581,19310104
-1,-1,12,74338711,74420680,81969
-1,-1,12,74338711,74420680,81969
-1,-1,12,74359565,74468373,108808
-1,-1,12,74359565,74468373,108808
-1,-1,12,83091644,83140037,48393
1,-1,12,83165733,84206428,1040695
1,-1,12,84028770,84426004,397234
-1,-1,12,86422840,86485493,62653
-1,-1,12,88077553,88201641,124088
1,1,12,91438095,109571015,18132920
-1,-1,12,99958415,100005273,46858
-1,-1,12,99958415,100005273,46858
1,-1,12,101596807,101879937,283130
1,-1,12,109559096,109647327,88231
1,-1,12,109836267,110075116,238849
1,-1,12,112162458,112305133,142675
1,-1,12,112194796,112304163,109367
-1,1,12,112963559,116095198,3131639
-1,1,12,113515580,114810171,1294591
1,1,12,114706208,133777902,19071694
-1,1,12,114828057,114832670,4613
-1,1,12,114995645,115376925,381280
-1,1,12,116028864,118791808,2762944
1,1,12,121135475,133779076,12643601
-1,1,12,121156589,127984760,6828171
-1,1,12,122355664,128287262,5931598
1,-1,12,123185916,123187546,1630
1,-1,12,123185916,123187546,1630
1,-1,12,123185916,123199400,13484
1,-1,12,123185916,123199400,13484
1,-1,12,123185916,123199400,13484
1,-1,12,123185916,123199400,13484
1,-1,12,123185916,123199400,13484
1,-1,12,123185916,123199400,13484
1,-1,12,123185916,123199400,13484
1,-1,12,123185916,123199400,13484
1,-1,12,123185916,123199400,13484
1,-1,12,123185916,123199400,13484
1,-1,12,123185916,123199400,13484
1,-1,12,123185916,123199400,13484
1,-1,12,123185916,123200173,14257
1,-1,12,123185916,123200755,14839
1,1,12,123994372,133767986,9773614
1,-1,12,124113899,124192840,78941
-1,-1,12,126647428,126794429,147001
-1,-1,12,127696154,127798205,102051
1,-1,12,128590089,128689778,99689
1,-1,12,131450373,132135146,684773
-1,-1,12,131733523,132078262,344739
-1,1,12,131749518,133777902,2028384
-1,-1,12,131839750,132089098,249348
-1,1,12,131862310,133777902,1915592
-1,1,12,132135087,133767986,1632899
-1,1,12,132382041,133777902,1395861
1,-1,12,132701526,132746992,45466
1,-1,12,132701526,132746992,45466
1,-1,12,132726992,132746992,20000
1,-1,12,132726992,132746992,20000
1,-1,12,132726992,132746992,20000
1,-1,12,132726992,132746992,20000
1,-1,12,132726992,132746992,20000
1,-1,12,132726992,132826002,99010
1,-1,12,132736992,132826002,89010
-1,1,12,133153200,133767986,614786
1,1,12,133324869,133777902,453033
1,-1,12,133712947,133779017,66070
1,-1,12,133727565,133772989,45424
1,-1,12,133763907,133773393,9486
-1,1,13,19020001,115085141,96065140
1,1,13,19030180,115105760,96075580
1,-1,13,19327344,19380812,53468
1,-1,13,19327344,19380812,53468
1,-1,13,19327344,19380812,53468
1,1,13,19436286,23063313,3627027
1,1,13,19436286,34151488,14715202
1,1,13,19436286,115107733,95671447
1,1,13,19436286,115107733,95671447
1,1,13,19436287,115107733,95671446
1,1,13,19436287,115107733,95671446
1,1,13,19436287,115107733,95671446
1,1,13,19436287,115107733,95671446
1,1,13,19436287,115107733,95671446
1,1,13,19571503,115092510,95521007
1,1,13,19571503,115092510,95521007
1,-1,13,20026165,20129722,103557
-1,1,13,20246074,25560010,5313936
1,1,13,20246074,41488903,21242829
1,1,13,20246074,115085141,94839067
1,1,13,20246074,115085141,94839067
1,1,13,20246074,115085141,94839067
1,1,13,20246074,115085141,94839067
1,1,13,20246074,115085141,94839067
1,1,13,20246074,115085141,94839067
1,1,13,20246074,115085141,94839067
1,1,13,20246074,115085141,94839067
1,1,13,20246074,115085141,94839067
-1,1,13,20333330,22665578,2332248
1,-1,13,20398449,20436518,38069
1,1,13,20407270,115064089,94656819
1,1,13,20407270,115085141,94677871
1,1,13,20407270,115085141,94677871
1,-1,13,20411535,20530702,119167
1,1,13,20411535,115085141,94673606
1,-1,13,20419133,20445461,26328
1,-1,13,20425451,20445320,19869
-1,1,13,20459423,22588637,2129214
-1,-1,13,20808567,21095903,287336
-1,-1,13,20808567,21095903,287336
-1,-1,13,20803674,21087711,284037
-1,-1,13,20808544,21001316,192772
-1,-1,13,20867199,21078901,211702
-1,-1,13,20867199,21095903,228704
-1,-1,13,20867199,21095903,228704
-1,-1,13,21721135,21742457,21322
1,-1,13,21728320,21742457,14137
1,-1,13,23517984,23619382,101398
1,-1,13,23517984,23795488,277504
-1,1,13,23671134,24896556,1225422
-1,1,13,23681101,24430171,749070
-1,1,13,23681101,24430171,749070
1,-1,13,24776253,24910684,134431
1,-1,13,27416494,27641229,224735
-1,1,13,29647457,37130151,7482694
1,1,13,29895591,37569485,7673894
-1,1,13,30887946,39841818,8953872
-1,1,13,31592297,49065340,17473043
-1,1,13,31682663,33765790,2083127
1,1,13,31937609,91227546,59289937
1,1,13,31937609,91227546,59289937
1,1,13,32127745,66044499,33916754
-1,1,13,32920483,32922331,1848
-1,1,13,32926238,33397752,471514
-1,1,13,32946120,62698217,29752097
1,1,13,33105623,87409299,54303676
-1,1,13,37351455,63530009,26178554
-1,1,13,37351455,63530009,26178554
1,1,13,38199035,39032633,833598
-1,1,13,38438363,68537920,30099557
-1,1,13,39088314,51999350,12911036
-1,1,13,41516434,115085141,73568707
-1,1,13,41717956,85711687,43993731
1,1,13,41862629,85711687,43849058
-1,1,13,42457841,91796698,49338857
-1,1,13,47312129,51342279,4030150
-1,1,13,47691722,84875070,37183348
-1,1,13,48339337,62632653,14293316
-1,1,13,48756523,48899280,142757
-1,1,13,48881438,51501609,2620171
-1,1,13,48906943,52778614,3871671
1,-1,13,52150871,52272652,121781
1,-1,13,52793642,52893811,100169
-1,1,13,53551300,109850651,56299351
1,1,13,53932358,96586363,42654005
-1,-1,13,55153988,55457713,303725
1,1,13,56431743,115107733,58675990
1,1,13,56987542,69758302,12770760
-1,-1,13,57793354,57872497,79143
-1,1,13,61110478,85127323,24016845
1,1,13,61424168,115107733,53683565
-1,1,13,61686543,83302092,21615549
-1,1,13,64287498,80212550,15925052
-1,-1,13,64446655,64913525,466870
-1,-1,13,64504041,64845402,341361
1,1,13,64640033,74267715,9627682
1,-1,13,65943201,66491226,548025
-1,1,13,66895130,88507684,21612554
-1,-1,13,67109147,67162425,53278
-1,-1,13,67307371,67369938,62567
-1,-1,13,67327801,67341918,14117
-1,-1,13,67327801,67348819,21018
1,-1,13,67593035,67716015,122980
1,1,13,68624430,115085141,46460711
1,-1,13,69509381,69615712,106331
1,1,13,71871468,115107733,43236265
-1,1,13,72174742,82221361,10046619
-1,-1,13,72826303,73017334,191031
-1,1,13,73255678,80212603,6956925
-1,1,13,77455170,81099829,3644659
-1,1,13,77635915,93112659,15476744
-1,-1,13,78751523,79255257,503734
-1,1,13,78878937,91936194,13057257
1,1,13,79538358,115085141,35546783
1,1,13,79573453,115085141,35511688
1,1,13,80058840,115107733,35048893
-1,1,13,80572498,108719528,28147030
-1,-1,13,81161198,81417735,256537
-1,-1,13,81682597,82033267,350670
-1,1,13,81851091,102864674,21013583
1,1,13,82221361,115092569,32871208
1,1,13,83435292,115107733,31672441
1,1,13,83862266,115107733,31245467
1,1,13,84619041,115085141,30466100
1,1,13,85176519,115107733,29931214
1,1,13,86963003,93390362,6427359
1,-1,13,87111222,87361937,250715
-1,1,13,87441182,115085141,27643959
-1,1,13,88073140,115107733,27034593
-1,1,13,88596734,100518796,11922062
1,1,13,89589905,115085141,25495236
-1,-1,13,90041897,90255725,213828
-1,1,13,91935136,92046713,111577
-1,1,13,91935331,92046713,111382
-1,-1,13,92065460,92267510,202050
-1,-1,13,92173306,92249821,76515
-1,1,13,93997311,110110501,16113190
-1,-1,13,94253664,94277058,23394
1,1,13,94269729,115107733,20838004
1,-1,13,94342109,94423150,81041
-1,1,13,94474530,115107733,20633203
1,-1,13,95963329,96016904,53575
1,1,13,96397109,111516165,15119056
-1,1,13,96586481,115107733,18521252
1,1,13,97397313,115085141,17687828
-1,1,13,97866125,109815264,11949139
1,1,13,98660269,104349582,5689313
-1,1,13,99333632,100773336,1439704
-1,1,13,100016737,101862895,1846158
1,1,13,101357397,115107733,13750336
-1,1,13,101747941,105726899,3978958
1,1,13,102415138,115105760,12690622
1,1,13,102521058,115059020,12537962
-1,1,13,103170306,115107733,11937427
-1,1,13,103535672,115085141,11549469
-1,1,13,103880953,115107733,11226780
1,-1,13,103940341,104473494,533153
1,-1,13,103940341,104473494,533153
-1,-1,13,104834556,104931959,97403
-1,-1,13,104834556,105862032,1027476
-1,1,13,104950552,115085141,10134589
-1,1,13,105620486,108955885,3335399
-1,1,13,105620486,115085141,9464655
-1,1,13,106056749,115107733,9050984
-1,1,13,106450862,115107733,8656871
-1,1,13,106513424,115107733,8594309
-1,1,13,107727825,115085141,7357316
-1,1,13,108361003,112755426,4394423
-1,-1,13,108447340,108745644,298304
-1,1,13,108570480,115085141,6514661
-1,1,13,109151651,115107733,5956082
-1,1,13,110902315,115085141,4182826
-1,1,13,111282121,115107733,3825612
-1,1,13,111510243,115107733,3597490
-1,1,13,111550457,115107733,3557276
-1,1,13,111853333,115085141,3231808
-1,1,13,112008088,115085141,3077053
-1,1,13,112091743,115092510,3000767
1,-1,13,113105619,113538619,433000
1,-1,13,114517405,114528430,11025
1,-1,13,114781654,114893774,112120
1,-1,13,114792894,114886865,93971
1,1,13,114843912,115085141,241229
1,-1,13,114990361,115085141,94780
1,-1,13,114998561,115054713,56152
1,-1,14,19057055,20427125,1370070
1,-1,14,19100771,20201260,1100489
1,-1,14,19100771,20427125,1326354
1,-1,14,19188847,20427125,1238278
1,-1,14,19188847,20427125,1238278
1,-1,14,19188847,20427125,1238278
1,-1,14,19357159,20201260,844101
1,-1,14,19357159,20201260,844101
1,-1,14,19357159,20376193,1019034
1,-1,14,19357159,20427125,1069966
1,-1,14,19357159,20427125,1069966
1,-1,14,19357159,20427125,1069966
1,-1,14,19357159,20427125,1069966
1,-1,14,19357159,20427125,1069966
1,-1,14,19373470,20004126,630656
1,-1,14,19361410,20201260,839850
1,-1,14,19361410,20201260,839850
1,-1,14,19361410,20201260,839850
1,-1,14,19361410,20201260,839850
1,-1,14,19361410,20201260,839850
1,-1,14,19361410,20201260,839850
1,-1,14,19361410,20201260,839850
1,-1,14,19361410,20201260,839850
1,-1,14,19361410,20201260,839850
1,-1,14,19361410,20201260,839850
1,-1,14,19361410,20201260,839850
1,-1,14,19361410,20201260,839850
1,-1,14,19361410,20201260,839850
1,-1,14,19361410,20201260,839850
1,-1,14,19361410,20201260,839850
1,-1,14,19361410,20201260,839850
1,-1,14,19361410,20201260,839850
1,-1,14,19361410,20201260,839850
1,-1,14,19361410,20201260,839850
1,-1,14,19361410,20201260,839850
1,-1,14,19361410,20201260,839850
1,-1,14,19361410,20201260,839850
1,-1,14,19361410,20201260,839850
-1,-1,14,19361410,20242150,880740
1,-1,14,19361410,20280344,918934
1,-1,14,19361410,20311153,949743
1,-1,14,19361410,20350911,989501
1,-1,14,19361410,20376193,1014783
1,-1,14,19361410,20376193,1014783
-1,-1,14,19361410,20427125,1065715
1,-1,14,19361410,20427125,1065715
-1,-1,14,19361410,20427125,1065715
1,-1,14,19361410,20427125,1065715
1,-1,14,19361410,20427125,1065715
1,-1,14,19361410,20427125,1065715
1,-1,14,19361410,20427125,1065715
1,-1,14,19361410,20427125,1065715
1,-1,14,19361410,20427125,1065715
1,-1,14,19361410,20427125,1065715
1,-1,14,19361410,20427125,1065715
1,-1,14,19361410,20427125,1065715
-1,-1,14,19361410,20427125,1065715
1,-1,14,19361410,20427125,1065715
1,-1,14,19361410,20427125,1065715
-1,-1,14,19361410,20427125,1065715
-1,-1,14,19361410,20427125,1065715
1,-1,14,19361410,20427125,1065715
1,-1,14,19361410,20427125,1065715
1,-1,14,19361410,20427125,1065715
1,-1,14,19361410,20427125,1065715
1,-1,14,19361410,20427125,1065715
1,-1,14,19361410,20427125,1065715
1,-1,14,19361410,20427125,1065715
1,-1,14,19361410,20427125,1065715
1,-1,14,19361410,20427125,1065715
1,-1,14,19361410,20427125,1065715
1,-1,14,19361410,20427125,1065715
1,-1,14,19361410,20427125,1065715
1,-1,14,19361410,20427125,1065715
1,-1,14,19361410,20427125,1065715
-1,-1,14,19361410,20427125,1065715
1,-1,14,19361410,20427125,1065715
1,-1,14,19361410,20427125,1065715
-1,-1,14,19361410,20427125,1065715
-1,-1,14,19361410,20427125,1065715
1,-1,14,19361410,20427125,1065715
1,-1,14,19361410,20427125,1065715
1,-1,14,19361410,20427125,1065715
-1,-1,14,19361410,20427125,1065715
1,-1,14,19361410,20427125,1065715
1,-1,14,19361410,20427125,1065715
1,-1,14,19361410,20427125,1065715
1,-1,14,19361410,20427125,1065715
-1,-1,14,19361410,20427125,1065715
1,-1,14,19361410,20427125,1065715
-1,-1,14,19361410,20427125,1065715
1,-1,14,19361410,20427125,1065715
1,-1,14,19361410,20427125,1065715
1,-1,14,19361410,20427125,1065715
1,-1,14,19361410,20427125,1065715
1,-1,14,19361410,20427125,1065715
1,-1,14,19361410,20427125,1065715
1,-1,14,19361410,20427125,1065715
1,-1,14,19361410,20427125,1065715
1,-1,14,19361410,20427125,1065715
1,-1,14,19361410,20427125,1065715
1,-1,14,19361410,20427125,1065715
1,-1,14,19361410,20427125,1065715
-1,-1,14,19361410,20427125,1065715
1,-1,14,19361410,20427125,1065715
1,-1,14,19361410,20427125,1065715
1,-1,14,19361410,20427125,1065715
1,-1,14,19361410,20427125,1065715
1,-1,14,19361410,20427125,1065715
1,-1,14,19361410,20427125,1065715
1,-1,14,19361410,20427125,1065715
1,-1,14,19361410,20427125,1065715
1,-1,14,19361410,20427125,1065715
1,-1,14,19361410,20427125,1065715
1,-1,14,19361410,20427125,1065715
1,-1,14,19361410,20427125,1065715
1,-1,14,19361410,20427125,1065715
1,-1,14,19361410,20427125,1065715
1,-1,14,19361410,20427125,1065715
1,-1,14,19361410,20427125,1065715
1,-1,14,19361410,20427125,1065715
1,-1,14,19361410,20427125,1065715
1,-1,14,19361410,20427125,1065715
1,-1,14,19361410,20427125,1065715
1,-1,14,19361410,20427125,1065715
-1,-1,14,19361410,20427125,1065715
1,-1,14,19361410,20427125,1065715
1,-1,14,19361410,20427125,1065715
1,-1,14,19361410,20427125,1065715
1,-1,14,19361410,20427125,1065715
-1,-1,14,19361410,20427125,1065715
-1,-1,14,19361410,20427125,1065715
1,-1,14,19361410,20427125,1065715
1,-1,14,19361410,20427125,1065715
-1,-1,14,19361410,20427125,1065715
1,-1,14,19361410,20427125,1065715
1,-1,14,19361410,20427125,1065715
1,-1,14,19361410,20427125,1065715
1,-1,14,19361410,20427125,1065715
-1,-1,14,19361410,20427125,1065715
1,-1,14,19361410,20427125,1065715
1,-1,14,19361410,20427125,1065715
1,-1,14,19361410,20427125,1065715
-1,-1,14,19361410,20427125,1065715
1,-1,14,19361410,20427125,1065715
1,-1,14,19361410,20427125,1065715
1,-1,14,19361410,20427125,1065715
1,-1,14,19361410,20427125,1065715
1,-1,14,19361410,20427125,1065715
1,-1,14,19361410,20427125,1065715
1,-1,14,19361410,20427125,1065715
1,-1,14,19361410,20427125,1065715
1,-1,14,19361410,20427125,1065715
1,-1,14,19361410,20427125,1065715
-1,-1,14,19361410,20427125,1065715
-1,-1,14,19361410,20427125,1065715
-1,-1,14,19361410,20427125,1065715
1,-1,14,19361410,20427125,1065715
1,-1,14,19361410,20427125,1065715
1,-1,14,19361410,20427125,1065715
1,-1,14,19361410,20427125,1065715
1,-1,14,19361410,20427125,1065715
-1,-1,14,19361410,20445326,1083916
-1,-1,14,19376792,19434604,57812
1,-1,14,19376792,20414203,1037411
-1,-1,14,19376792,20435888,1059096
-1,-1,14,19434605,20435888,1001283
1,-1,14,19467197,20427125,959928
1,-1,14,19467197,20427125,959928
1,-1,14,19467197,20427125,959928
1,-1,14,19467197,20427125,959928
1,-1,14,19467197,20427125,959928
1,-1,14,19467197,20427125,959928
1,-1,14,19467197,20427125,959928
1,-1,14,19467197,20427125,959928
1,-1,14,19467197,20427125,959928
-1,-1,14,19474802,20435888,961086
1,-1,14,19520766,20427125,906359
1,-1,14,19554412,20409332,854920
-1,-1,14,19572282,20261126,688844
-1,-1,14,19601648,20414203,812555
-1,-1,14,19643241,19794590,151349
1,-1,14,19689326,20420820,731494
-1,-1,14,19728671,20414203,685532
-1,-1,14,19728671,20414203,685532
1,1,14,19794561,34049214,14254653
1,1,14,19794561,107234280,87439719
-1,-1,14,19820023,20186485,366462
-1,-1,14,19980910,20427125,446215
1,-1,14,20085860,20137126,51266
-1,-1,14,20085860,20435888,350028
-1,-1,14,20097119,20146553,49434
-1,-1,14,20097119,20242202,145083
-1,-1,14,20186485,20406327,219842
-1,-1,14,20201260,20406327,205067
-1,-1,14,20201260,20406327,205067
-1,-1,14,20201260,20406327,205067
-1,-1,14,20201260,20406327,205067
-1,-1,14,20201260,20406327,205067
-1,-1,14,20201260,20406327,205067
-1,-1,14,20201260,20406327,205067
-1,-1,14,20201260,20406327,205067
-1,-1,14,20201260,20406327,205067
-1,-1,14,20201260,20406327,205067
-1,-1,14,20201260,20406327,205067
-1,-1,14,20201260,20406327,205067
-1,-1,14,20201260,20406327,205067
-1,-1,14,20201260,20406327,205067
-1,-1,14,20201260,20406327,205067
-1,-1,14,20201260,20406327,205067
-1,-1,14,20201260,20406327,205067
-1,-1,14,20201260,20406327,205067
-1,-1,14,20201260,20406327,205067
-1,-1,14,20201260,20406327,205067
-1,-1,14,20201260,20406327,205067
-1,-1,14,20201260,20406327,205067
-1,-1,14,20201260,20406327,205067
-1,-1,14,20201260,20406327,205067
-1,-1,14,20201260,20406327,205067
-1,-1,14,20201260,20406327,205067
-1,-1,14,20201260,20406327,205067
-1,-1,14,20201260,20406327,205067
-1,-1,14,20201260,20406327,205067
-1,-1,14,20201260,20406327,205067
-1,-1,14,20201260,20406327,205067
-1,-1,14,20201260,20406327,205067
-1,-1,14,20201260,20406327,205067
-1,-1,14,20201260,20406327,205067
-1,-1,14,20201260,20406327,205067
-1,-1,14,20201260,20406327,205067
-1,-1,14,20201260,20406327,205067
-1,-1,14,20201260,20406327,205067
-1,-1,14,20201260,20406327,205067
-1,-1,14,20201260,20406327,205067
-1,-1,14,20201260,20406327,205067
-1,-1,14,20201260,20406327,205067
-1,-1,14,20201260,20406327,205067
-1,-1,14,20201260,20406327,205067
-1,-1,14,20201260,20406327,205067
-1,-1,14,20201260,20406327,205067
-1,-1,14,20201260,20406327,205067
-1,-1,14,20201260,20406327,205067
-1,-1,14,20201260,20406327,205067
-1,-1,14,20201260,20406327,205067
-1,-1,14,20201260,20406327,205067
-1,-1,14,20201260,20406327,205067
-1,-1,14,20201260,20406327,205067
-1,-1,14,20201260,20406327,205067
-1,-1,14,20201260,20406327,205067
-1,-1,14,20201260,20406327,205067
-1,-1,14,20201260,20406327,205067
-1,-1,14,20201260,20406327,205067
-1,-1,14,20201260,20406327,205067
-1,-1,14,20201260,20406327,205067
-1,-1,14,20201260,20406327,205067
-1,-1,14,20201260,20406327,205067
-1,-1,14,20201260,20406327,205067
-1,-1,14,20201260,20406327,205067
-1,-1,14,20201260,20406327,205067
-1,-1,14,20201260,20406327,205067
-1,-1,14,20201260,20406327,205067
-1,-1,14,20201260,20406327,205067
-1,-1,14,20201260,20406327,205067
-1,-1,14,20201260,20406327,205067
-1,-1,14,20201260,20406327,205067
-1,-1,14,20201260,20406327,205067
-1,-1,14,20201260,20406327,205067
-1,-1,14,20201260,20406327,205067
-1,-1,14,20201260,20406327,205067
-1,-1,14,20201260,20406327,205067
-1,-1,14,20201260,20406327,205067
-1,-1,14,20201260,20406327,205067
-1,-1,14,20201260,20406327,205067
-1,-1,14,20201260,20406327,205067
-1,-1,14,20201260,20406327,205067
-1,-1,14,20201260,20406327,205067
-1,-1,14,20201260,20406327,205067
-1,-1,14,20201260,20406327,205067
-1,-1,14,20201260,20406327,205067
-1,-1,14,20201260,20406327,205067
-1,-1,14,20201260,20406327,205067
-1,-1,14,20201260,20406327,205067
-1,-1,14,20201260,20406327,205067
-1,-1,14,20201260,20406327,205067
-1,-1,14,20201260,20406327,205067
-1,-1,14,20201260,20406327,205067
-1,-1,14,20201260,20406327,205067
-1,-1,14,20201260,20406327,205067
-1,-1,14,20201260,20406327,205067
-1,-1,14,20201260,20406327,205067
-1,-1,14,20201260,20406327,205067
-1,-1,14,20201260,20406327,205067
-1,-1,14,20201260,20406327,205067
-1,-1,14,20201260,20406327,205067
-1,-1,14,20201260,20406327,205067
-1,-1,14,20201260,20406327,205067
-1,-1,14,20201260,20406327,205067
-1,-1,14,20201260,20406327,205067
-1,-1,14,20201260,20406327,205067
-1,-1,14,20201260,20406327,205067
-1,-1,14,20201260,20406327,205067
-1,-1,14,20201260,20406327,205067
-1,-1,14,20201260,20406327,205067
-1,-1,14,20201260,20406327,205067
-1,-1,14,20201260,20406327,205067
-1,-1,14,20201260,20406327,205067
-1,-1,14,20201260,20406327,205067
-1,-1,14,20201260,20406327,205067
-1,-1,14,20201260,20406327,205067
-1,-1,14,20201260,20406327,205067
-1,-1,14,20201260,20406327,205067
-1,-1,14,20201260,20406327,205067
-1,-1,14,20201260,20406327,205067
-1,-1,14,20201260,20406327,205067
-1,-1,14,20201260,20406327,205067
-1,-1,14,20201260,20406327,205067
-1,-1,14,20201260,20406327,205067
-1,-1,14,20201260,20406327,205067
-1,-1,14,20201260,20406327,205067
-1,-1,14,20201260,20406327,205067
-1,-1,14,20201260,20406327,205067
-1,-1,14,20201260,20406327,205067
-1,-1,14,20201260,20406327,205067
-1,-1,14,20201260,20406327,205067
-1,-1,14,20201260,20406327,205067
-1,-1,14,20201260,20406327,205067
-1,-1,14,20201260,20406327,205067
-1,-1,14,20201260,20406327,205067
-1,-1,14,20201260,20406327,205067
-1,-1,14,20201260,20406327,205067
-1,-1,14,20201260,20406327,205067
-1,-1,14,20201260,20406327,205067
-1,-1,14,20201260,20406327,205067
-1,-1,14,20201260,20406327,205067
-1,-1,14,20201260,20406327,205067
-1,-1,14,20201260,20406327,205067
-1,-1,14,20201260,20406327,205067
-1,-1,14,20201260,20406327,205067
-1,-1,14,20201260,20406327,205067
-1,-1,14,20201260,20406327,205067
-1,-1,14,20201260,20406327,205067
-1,-1,14,20201260,20406327,205067
-1,-1,14,20201260,20406327,205067
-1,-1,14,20201260,20406327,205067
-1,-1,14,20201260,20406327,205067
-1,-1,14,20201260,20406327,205067
-1,-1,14,20201260,20406327,205067
-1,-1,14,20201260,20406327,205067
-1,-1,14,20201260,20406327,205067
-1,-1,14,20201260,20406327,205067
-1,-1,14,20201260,20406327,205067
-1,-1,14,20201260,20406327,205067
-1,-1,14,20201260,20406327,205067
-1,-1,14,20201260,20406327,205067
-1,-1,14,20201260,20406327,205067
-1,-1,14,20201260,20406327,205067
-1,-1,14,20201260,20406327,205067
-1,-1,14,20201260,20406327,205067
-1,-1,14,20201260,20406327,205067
-1,-1,14,20201260,20406327,205067
-1,-1,14,20201260,20406327,205067
-1,-1,14,20201260,20406327,205067
-1,-1,14,20201260,20406327,205067
-1,-1,14,20201260,20406327,205067
-1,-1,14,20201260,20406327,205067
-1,-1,14,20201260,20406327,205067
-1,-1,14,20201260,20406327,205067
-1,-1,14,20201260,20406327,205067
-1,-1,14,20201260,20406327,205067
-1,-1,14,20201260,20406327,205067
-1,-1,14,20201260,20406327,205067
-1,-1,14,20201260,20406327,205067
-1,-1,14,20201260,20406327,205067
-1,-1,14,20201260,20406327,205067
-1,-1,14,20201260,20406327,205067
-1,-1,14,20201260,20406327,205067
-1,-1,14,20201260,20406327,205067
-1,-1,14,20201260,20406327,205067
-1,-1,14,20201260,20406327,205067
-1,-1,14,20201260,20406327,205067
-1,-1,14,20201260,20406327,205067
-1,-1,14,20201260,20406327,205067
-1,-1,14,20201260,20406327,205067
-1,-1,14,20201260,20406327,205067
-1,-1,14,20201260,20406327,205067
-1,-1,14,20201260,20406327,205067
-1,-1,14,20201260,20406327,205067
-1,-1,14,20201260,20406327,205067
-1,-1,14,20201260,20406327,205067
-1,-1,14,20201260,20406327,205067
-1,-1,14,20201260,20406327,205067
-1,-1,14,20201260,20406327,205067
-1,-1,14,20201260,20406327,205067
-1,-1,14,20201260,20406327,205067
-1,-1,14,20201260,20406327,205067
1,-1,14,20198966,20465976,267010
1,-1,14,20203478,20409332,205854
1,-1,14,20203478,20420820,217342
1,-1,14,20217284,20406327,189043
1,-1,14,20217284,20406327,189043
1,-1,14,20217284,20406327,189043
-1,-1,14,20253908,20406327,152419
-1,-1,14,20338772,20420820,82048
-1,-1,14,20338772,20420820,82048
-1,-1,14,20350922,20397702,46780
-1,-1,14,20376238,20397702,21464
1,1,14,20490852,44562875,24072023
1,1,14,20511672,49111245,28599573
1,1,14,20511673,107285437,86773764
1,1,14,20511673,107285437,86773764
1,1,14,20511673,107285437,86773764
1,1,14,20619308,107263478,86644170
1,-1,14,20691395,20716774,25379
1,-1,14,20757405,20886235,128830
1,-1,14,20967930,20980067,12137
1,-1,14,20967930,20980067,12137
1,-1,14,20967930,20980067,12137
1,-1,14,20971275,20977156,5881
1,-1,14,20971275,20977156,5881
1,-1,14,20971275,20980067,8792
1,-1,14,20971275,20980067,8792
1,-1,14,22330761,22996342,665581
-1,-1,14,22322590,22964922,642332
-1,-1,14,22369144,22952425,583281
-1,-1,14,22387418,22980010,592592
1,-1,14,22441988,22980175,538187
1,-1,14,22441988,22980175,538187
1,-1,14,22441988,22980175,538187
1,-1,14,22441988,22980175,538187
1,-1,14,22441988,22980175,538187
1,-1,14,22441988,22996342,554354
1,-1,14,22441988,22897028,455040
-1,-1,14,22441989,22911507,469518
1,-1,14,22468548,22980175,511627
1,-1,14,22468548,22980175,511627
1,-1,14,22468548,22980175,511627
1,-1,14,22468548,22980175,511627
1,-1,14,22468548,22980175,511627
1,-1,14,22468548,22980175,511627
1,-1,14,22468548,22996342,527794
1,-1,14,22468548,23030320,561772
1,-1,14,22489905,22793429,303524
1,-1,14,22598068,22811855,213787
-1,-1,14,22618708,22952425,333717
-1,-1,14,22696964,22964922,267958
-1,-1,14,22696964,22964922,267958
-1,-1,14,22696964,22964922,267958
-1,-1,14,22696964,22964922,267958
-1,-1,14,22696964,22964922,267958
-1,-1,14,22696964,22964922,267958
-1,-1,14,22696964,22964922,267958
1,1,14,23164384,54733411,31569027
-1,1,14,24233721,31377083,7143362
-1,1,14,24453274,25843700,1390426
-1,-1,14,27068986,28179920,1110934
1,1,14,27174014,33887605,6713591
-1,1,14,27188661,29723971,2535310
-1,-1,14,27799870,27924402,124532
1,-1,14,28224092,28256820,32728
-1,1,14,29273194,33703472,4430278
-1,1,14,30851760,38181546,7329786
-1,1,14,31261477,45154334,13892857
-1,1,14,34049147,49348823,15299676
-1,1,14,34349618,42828688,8479070
-1,-1,14,34680977,34797265,116288
-1,1,14,35537482,44463980,8926498
-1,-1,14,35579022,35620232,41210
-1,1,14,35850213,40138562,4288349
-1,1,14,35983284,37283221,1299937
1,1,14,36660917,37697705,1036788
-1,-1,14,36747497,36787893,40396
-1,1,14,37002653,37810624,807971
-1,-1,14,40436124,40591751,155627
-1,-1,14,40733870,40890943,157073
-1,-1,14,40733870,40890943,157073
-1,-1,14,40859536,40960013,100477
-1,-1,14,40960013,41634431,674418
-1,-1,14,41018728,41234652,215924
1,-1,14,43856486,44223814,367328
1,-1,14,43856486,44223814,367328
1,-1,14,43856486,44223814,367328
1,-1,14,43856486,44223814,367328
1,-1,14,43856486,44223814,367328
1,-1,14,43856486,44223814,367328
1,-1,14,43856486,44223814,367328
1,-1,14,43856486,44623069,766583
-1,-1,14,44973489,45393462,419973
-1,-1,14,45821442,45979670,158228
-1,-1,14,45821442,45979670,158228
-1,-1,14,45821442,45979729,158287
-1,-1,14,48786773,48891586,104813
-1,-1,14,48786773,48906286,119513
-1,-1,14,48786773,48906286,119513
-1,-1,14,48786773,48906286,119513
-1,1,14,52011564,55787316,3775752
-1,1,14,53820659,55003253,1182594
1,-1,14,56568535,56819234,250699
-1,1,14,58120131,64560246,6440115
-1,1,14,59073273,61983038,2909765
1,1,14,62493932,107285437,44791505
-1,1,14,62719418,66220134,3500716
1,-1,14,63779634,63849018,69384
-1,1,14,70028816,82441728,12412912
1,-1,14,72638897,72665618,26721
1,1,14,73750741,107285437,33534696
-1,-1,14,74004581,74040262,35681
-1,-1,14,74008382,74042276,33894
1,1,14,74122475,107287505,33165030
1,1,14,77689138,107287505,29598367
1,-1,14,78146198,78205077,58879
1,-1,14,78146198,78205077,58879
1,-1,14,78146198,78205077,58879
-1,-1,14,80674955,80736720,61765
1,1,14,93007328,105329995,12322667
1,1,14,93331784,107289540,13957756
-1,1,14,95990744,107287708,11296964
-1,1,14,95990744,107287708,11296964
1,1,14,98104857,107263478,9158621
-1,-1,14,99178605,99183596,4991
1,1,14,99914349,107258824,7344475
-1,1,14,100260674,101410904,1150230
-1,1,14,100297992,107263478,6965486
-1,1,14,100397006,101488936,1091930
-1,1,14,100661319,107285437,6624118
-1,1,14,100729173,102967034,2237861
1,1,14,100775719,106453697,5677978
-1,1,14,101048396,107285437,6237041
-1,1,14,102131939,107263478,5131539
-1,1,14,102392007,107284531,4892524
-1,1,14,102670706,107285437,4614731
-1,1,14,102705759,107285437,4579678
-1,1,14,103071433,107287505,4216072
-1,1,14,103153637,107285437,4131800
-1,1,14,103390060,104436909,1046849
-1,1,14,103711336,107285437,3574101
1,1,14,103788751,107263478,3474727
-1,1,14,103965059,107285437,3320378
-1,1,14,104289937,107287505,2997568
-1,1,14,104517595,107285437,2767842
1,-1,14,104804779,104913869,109090
-1,1,14,104915608,107285437,2369829
1,-1,14,105047592,105081292,33700
-1,1,14,105489733,107258965,1769232
1,-1,14,105929852,105996549,66697
1,-1,14,105937585,105957346,19761
1,-1,14,105937585,105957346,19761
1,-1,14,105957346,105996549,39203
1,-1,14,105957346,105996549,39203
-1,-1,14,106072662,106209522,136860
1,1,14,106252705,107263478,1010773
1,1,14,106252705,107263478,1010773
1,1,14,106252705,107263478,1010773
-1,1,14,106252705,107287505,1034800
-1,-1,14,106252705,107287708,1035003
1,-1,14,106361449,107124613,763164
-1,-1,14,106453638,106774672,321034
-1,-1,14,106572867,106923671,350804
-1,-1,14,106572867,106923671,350804
1,-1,14,106572867,107145709,572842
1,-1,14,106512914,106923671,410757
-1,-1,14,106538421,106774672,236251
1,-1,14,106538421,106852173,313752
1,-1,14,106538421,107169357,630936
1,-1,14,106538451,106572278,33827
-1,-1,14,106539719,106559073,19354
1,-1,14,106539719,106559073,19354
1,-1,14,106539719,106559073,19354
1,-1,14,106539719,106559073,19354
-1,-1,14,106539719,106572277,32558
-1,-1,14,106539719,106572277,32558
1,-1,14,106574892,106923823,348931
-1,-1,14,106602112,106803289,201177
-1,-1,14,106602112,106803289,201177
-1,-1,14,106602112,106803289,201177
-1,-1,14,106664991,106852183,187192
-1,-1,14,106664991,106923671,258680
1,-1,14,106664991,107182651,517660
1,-1,14,106716345,107124579,408234
1,-1,14,106786177,106810256,24079
-1,-1,14,106786177,106810256,24079
-1,-1,14,106786177,106810256,24079
1,-1,14,106831508,107089193,257685
1,-1,14,106852114,107169357,317243
1,-1,14,106852124,107089193,237069
-1,-1,14,106906709,106931163,24454
-1,-1,14,106906709,106931163,24454
1,-1,14,106906901,107169357,262456
1,-1,14,106906901,107169357,262456
1,-1,14,106906901,107169357,262456
1,-1,14,106906901,107169357,262456
1,-1,14,106906901,107169357,262456
1,-1,14,106906901,107169357,262456
1,-1,14,106923612,107021833,98221
1,-1,14,106923612,107109083,185471
1,-1,14,106923612,107182651,259039
1,-1,14,106923612,107182651,259039
1,-1,14,106923612,107182651,259039
1,-1,14,106923612,107182651,259039
1,-1,14,106923612,107182651,259039
1,-1,14,106957881,107182651,224770
1,-1,14,107070359,107169498,99139
1,-1,14,107070559,107169357,98798
1,-1,14,107070559,107169357,98798
1,-1,14,107070559,107169357,98798
1,-1,14,107070559,107169357,98798
-1,-1,14,107070604,107109083,38479
1,-1,14,107079944,107145709,65765
-1,-1,14,107079944,107152026,72082
-1,-1,14,107080001,107134861,54860
-1,-1,14,107080001,107134861,54860
-1,-1,14,107134790,107182651,47861
1,-1,14,107141076,107182651,41575
1,-1,14,107141076,107182651,41575
1,-1,14,107141076,107182651,41575
1,-1,14,107141076,107182651,41575
1,-1,14,107141076,107182651,41575
1,-1,14,107141076,107182651,41575
1,-1,14,107141076,107182651,41575
1,-1,14,107145650,107182651,37001
1,-1,14,107145650,107182651,37001
1,-1,14,107145650,107182651,37001
1,-1,14,107145650,107182651,37001
1,-1,14,107145650,107182651,37001
1,-1,14,107145650,107182651,37001
1,-1,14,107145650,107182651,37001
1,-1,14,107145650,107182651,37001
1,-1,14,107145650,107182651,37001
1,-1,14,107145650,107182651,37001
1,-1,14,107145650,107189879,44229
-1,-1,14,107148712,107168761,20049
-1,-1,14,107148712,107168761,20049
-1,-1,14,107148712,107168761,20049
-1,-1,14,107148712,107168761,20049
-1,-1,14,107148712,107168761,20049
-1,-1,14,107148712,107175214,26502
-1,-1,14,107148712,107180121,31409
-1,-1,14,107148712,107180121,31409
-1,-1,14,107148712,107180121,31409
-1,-1,14,107148712,107180121,31409
-1,-1,14,107148712,107180121,31409
-1,-1,14,107148712,107180121,31409
-1,-1,14,107148712,107180121,31409
1,-1,14,107148712,107180121,31409
1,-1,14,107148712,107180121,31409
1,-1,14,107148712,107180121,31409
-1,-1,14,107148712,107180121,31409
-1,-1,14,107148712,107180121,31409
1,-1,14,107148712,107180121,31409
-1,-1,14,107148712,107180121,31409
-1,-1,14,107148712,107182649,33937
1,-1,14,107148712,107182651,33939
1,-1,14,107148712,107182651,33939
1,-1,14,107148712,107182651,33939
1,-1,14,107148712,107182651,33939
1,-1,14,107148712,107182651,33939
1,-1,14,107148712,107182651,33939
1,-1,14,107148712,107182651,33939
-1,-1,14,107148712,107182651,33939
-1,-1,14,107148712,107182651,33939
1,-1,14,107148712,107182651,33939
1,-1,14,107148712,107182651,33939
1,-1,14,107148712,107182651,33939
-1,-1,14,107148712,107182651,33939
-1,-1,14,107148712,107182651,33939
1,-1,14,107148712,107182651,33939
-1,-1,14,107148712,107182651,33939
1,-1,14,107148712,107182651,33939
1,-1,14,107148712,107182651,33939
-1,-1,14,107148712,107182651,33939
1,-1,14,107148712,107182651,33939
1,-1,14,107148712,107182651,33939
1,-1,14,107148712,107182651,33939
1,-1,14,107148712,107182651,33939
-1,-1,14,107148712,107182651,33939
1,-1,14,107148712,107182651,33939
1,-1,14,107148712,107182651,33939
1,-1,14,107148712,107182651,33939
1,-1,14,107148712,107182651,33939
1,-1,14,107148712,107182651,33939
1,-1,14,107148712,107182651,33939
1,-1,14,107148712,107182651,33939
1,-1,14,107148712,107182651,33939
1,-1,14,107148712,107182651,33939
1,-1,14,107148712,107182651,33939
1,-1,14,107148712,107182651,33939
1,-1,14,107148712,107182651,33939
1,-1,14,107148712,107182651,33939
1,-1,14,107148712,107182651,33939
-1,-1,14,107148712,107182651,33939
1,-1,14,107148712,107182651,33939
1,-1,14,107148712,107182651,33939
1,-1,14,107148712,107182651,33939
1,-1,14,107148712,107182651,33939
1,-1,14,107148712,107182651,33939
1,-1,14,107148712,107182651,33939
1,-1,14,107148712,107182651,33939
1,-1,14,107148712,107182651,33939
1,-1,14,107148712,107182651,33939
1,-1,14,107148712,107182651,33939
1,-1,14,107148712,107182651,33939
1,-1,14,107148712,107182651,33939
1,-1,14,107148712,107182651,33939
1,-1,14,107148712,107182651,33939
1,-1,14,107148712,107182651,33939
1,-1,14,107148712,107182651,33939
1,-1,14,107148712,107182651,33939
1,-1,14,107148712,107182651,33939
-1,-1,14,107148712,107182651,33939
-1,-1,14,107148712,107182651,33939
1,-1,14,107148712,107182651,33939
1,-1,14,107148712,107182651,33939
1,-1,14,107148712,107182651,33939
1,-1,14,107148712,107182651,33939
1,-1,14,107148712,107182651,33939
1,-1,14,107148712,107182651,33939
1,-1,14,107148712,107182651,33939
1,-1,14,107148712,107182651,33939
1,-1,14,107148712,107182651,33939
1,-1,14,107148712,107182651,33939
1,-1,14,107148712,107182651,33939
1,-1,14,107148712,107182651,33939
-1,-1,14,107148712,107182651,33939
1,-1,14,107148712,107182651,33939
1,-1,14,107148712,107182651,33939
1,-1,14,107148712,107182651,33939
1,-1,14,107148712,107182651,33939
1,-1,14,107148712,107182651,33939
1,-1,14,107148712,107182651,33939
1,-1,14,107148712,107182651,33939
1,-1,14,107148712,107182651,33939
-1,-1,14,107148712,107182651,33939
1,-1,14,107148712,107182651,33939
1,-1,14,107148712,107182651,33939
1,-1,14,107148712,107182651,33939
1,-1,14,107148712,107182651,33939
1,-1,14,107148712,107182651,33939
1,-1,14,107148712,107182651,33939
1,-1,14,107148712,107182651,33939
1,-1,14,107148712,107182651,33939
1,-1,14,107148712,107182651,33939
1,-1,14,107148712,107182651,33939
1,-1,14,107148712,107182651,33939
1,-1,14,107148712,107182651,33939
1,-1,14,107148712,107182651,33939
1,-1,14,107148712,107182651,33939
1,-1,14,107148712,107182651,33939
1,-1,14,107148712,107182651,33939
1,-1,14,107148712,107182651,33939
-1,-1,14,107148712,107182651,33939
1,-1,14,107148712,107182651,33939
1,-1,14,107148712,107182651,33939
1,-1,14,107148712,107182651,33939
-1,-1,14,107148712,107182651,33939
1,-1,14,107148712,107182651,33939
1,-1,14,107148712,107182651,33939
1,-1,14,107148712,107182651,33939
1,-1,14,107148712,107182651,33939
1,-1,14,107148712,107182651,33939
1,-1,14,107148712,107182651,33939
1,-1,14,107148712,107182651,33939
-1,-1,14,107148712,107182651,33939
1,-1,14,107148712,107182651,33939
1,-1,14,107148712,107182651,33939
-1,-1,14,107148712,107182651,33939
-1,-1,14,107148712,107182651,33939
1,-1,14,107148712,107182651,33939
-1,-1,14,107148712,107182651,33939
-1,-1,14,107148712,107182651,33939
1,-1,14,107148712,107182651,33939
1,-1,14,107148712,107182651,33939
-1,-1,14,107148712,107182651,33939
1,-1,14,107148712,107182651,33939
1,-1,14,107148712,107182651,33939
1,-1,14,107148712,107182651,33939
1,-1,14,107148712,107182651,33939
-1,-1,14,107148712,107182651,33939
1,-1,14,107148712,107182651,33939
-1,-1,14,107148712,107182651,33939
-1,-1,14,107148712,107182651,33939
-1,-1,14,107148712,107182651,33939
1,-1,14,107148712,107182651,33939
1,-1,14,107148712,107182651,33939
1,-1,14,107148712,107182651,33939
1,-1,14,107148712,107182651,33939
-1,-1,14,107148712,107182651,33939
-1,-1,14,107148712,107182651,33939
1,-1,14,107148712,107182651,33939
-1,-1,14,107148712,107182651,33939
-1,-1,14,107148712,107182651,33939
-1,-1,14,107148712,107182651,33939
1,-1,14,107148712,107182651,33939
-1,-1,14,107148712,107182651,33939
-1,-1,14,107148712,107182651,33939
1,-1,14,107148712,107182651,33939
1,-1,14,107148712,107182651,33939
1,-1,14,107148712,107182651,33939
1,-1,14,107148712,107182651,33939
1,-1,14,107148712,107182651,33939
-1,-1,14,107148712,107182651,33939
1,-1,14,107148712,107182651,33939
-1,-1,14,107148712,107182651,33939
1,-1,14,107148712,107182651,33939
-1,-1,14,107148712,107182651,33939
1,-1,14,107148712,107182651,33939
1,-1,14,107148712,107182651,33939
-1,-1,14,107148712,107182651,33939
1,-1,14,107148712,107182651,33939
-1,-1,14,107148712,107182651,33939
1,-1,14,107148712,107182651,33939
1,-1,14,107148712,107182651,33939
1,-1,14,107148712,107182651,33939
-1,-1,14,107148712,107182651,33939
1,-1,14,107148712,107182651,33939
1,-1,14,107148712,107182651,33939
1,-1,14,107148712,107182651,33939
-1,-1,14,107148712,107182651,33939
-1,-1,14,107148712,107182651,33939
-1,-1,14,107148712,107182651,33939
-1,-1,14,107148712,107182651,33939
1,-1,14,107148712,107182651,33939
-1,-1,14,107148712,107182651,33939
-1,-1,14,107148712,107182651,33939
1,-1,14,107148712,107182651,33939
-1,-1,14,107148712,107182651,33939
1,-1,14,107148712,107182651,33939
1,-1,14,107148712,107182651,33939
1,-1,14,107148712,107182651,33939
1,-1,14,107148712,107182651,33939
-1,-1,14,107148712,107182651,33939
1,-1,14,107148712,107182651,33939
-1,-1,14,107148712,107182651,33939
1,-1,14,107148712,107182651,33939
1,-1,14,107148712,107182651,33939
-1,-1,14,107148712,107182651,33939
1,-1,14,107148712,107182651,33939
1,-1,14,107148712,107182651,33939
-1,-1,14,107148712,107182651,33939
1,-1,14,107148712,107182651,33939
-1,-1,14,107148712,107182651,33939
-1,-1,14,107148712,107182651,33939
1,-1,14,107148712,107182651,33939
1,-1,14,107148712,107182651,33939
1,-1,14,107148712,107182651,33939
1,-1,14,107148712,107182651,33939
1,-1,14,107148712,107182651,33939
1,-1,14,107148712,107182651,33939
1,-1,14,107148712,107182651,33939
-1,-1,14,107148712,107182651,33939
-1,-1,14,107148712,107182651,33939
1,-1,14,107148712,107182651,33939
1,-1,14,107148712,107182651,33939
-1,-1,14,107148712,107182651,33939
1,-1,14,107148712,107182651,33939
-1,-1,14,107148712,107182651,33939
1,-1,14,107148712,107182651,33939
1,-1,14,107148712,107182651,33939
1,-1,14,107148712,107182651,33939
-1,-1,14,107148712,107182651,33939
-1,-1,14,107148712,107182651,33939
1,-1,14,107148712,107182651,33939
-1,-1,14,107148712,107182651,33939
-1,-1,14,107148712,107182651,33939
-1,-1,14,107148712,107182651,33939
-1,-1,14,107148712,107182651,33939
-1,-1,14,107148712,107182651,33939
1,-1,14,107148712,107182651,33939
1,-1,14,107148712,107182651,33939
1,-1,14,107148712,107182651,33939
1,-1,14,107148712,107182651,33939
-1,-1,14,107148712,107182651,33939
1,-1,14,107148712,107182651,33939
-1,-1,14,107148712,107182651,33939
-1,-1,14,107148712,107182651,33939
1,-1,14,107148712,107182651,33939
1,-1,14,107148712,107182651,33939
-1,-1,14,107148712,107182651,33939
1,-1,14,107148712,107182651,33939
1,-1,14,107148712,107182651,33939
1,-1,14,107148712,107182651,33939
1,-1,14,107148712,107182651,33939
-1,-1,14,107148712,107182651,33939
1,-1,14,107148712,107182651,33939
-1,-1,14,107148712,107182651,33939
-1,-1,14,107148712,107182651,33939
1,-1,14,107148712,107182651,33939
1,-1,14,107148712,107182651,33939
1,-1,14,107148712,107182651,33939
1,-1,14,107148712,107182651,33939
-1,-1,14,107148712,107182651,33939
-1,-1,14,107148712,107182651,33939
-1,-1,14,107148712,107182651,33939
-1,-1,14,107148712,107182651,33939
1,-1,14,107148712,107182651,33939
1,-1,14,107148712,107182651,33939
1,-1,14,107148712,107182651,33939
1,-1,14,107148712,107182651,33939
1,-1,14,107148712,107182651,33939
1,-1,14,107148712,107182651,33939
1,-1,14,107148712,107182651,33939
1,-1,14,107148712,107182651,33939
1,-1,14,107148712,107182651,33939
-1,-1,14,107148712,107182651,33939
1,-1,14,107148712,107182651,33939
-1,-1,14,107148712,107182651,33939
1,-1,14,107148712,107182651,33939
1,-1,14,107148712,107182651,33939
-1,-1,14,107148712,107182651,33939
-1,-1,14,107148712,107182651,33939
1,-1,14,107148712,107182651,33939
-1,-1,14,107148712,107182651,33939
1,-1,14,107148712,107182651,33939
1,-1,14,107148712,107182651,33939
1,-1,14,107148712,107182651,33939
1,-1,14,107148712,107182651,33939
1,-1,14,107148712,107182651,33939
-1,-1,14,107148712,107182651,33939
1,-1,14,107148712,107182651,33939
1,-1,14,107148712,107182651,33939
1,-1,14,107148712,107182651,33939
-1,-1,14,107148712,107182651,33939
1,-1,14,107148712,107182651,33939
1,-1,14,107148712,107182651,33939
1,-1,14,107148712,107182651,33939
1,-1,14,107148712,107182651,33939
1,-1,14,107148712,107182651,33939
-1,-1,14,107148712,107182651,33939
-1,-1,14,107148712,107182651,33939
1,-1,14,107148712,107182651,33939
-1,-1,14,107148712,107182651,33939
-1,-1,14,107148712,107182651,33939
-1,-1,14,107148712,107182651,33939
-1,-1,14,107148712,107182651,33939
1,-1,14,107148712,107182651,33939
-1,-1,14,107148712,107182651,33939
1,-1,14,107148712,107182651,33939
1,-1,14,107148712,107182651,33939
1,-1,14,107148712,107182651,33939
1,-1,14,107148712,107182651,33939
-1,-1,14,107148712,107182651,33939
1,-1,14,107148712,107182651,33939
-1,-1,14,107148712,107182651,33939
1,-1,14,107148712,107182651,33939
1,-1,14,107148712,107182651,33939
1,-1,14,107148712,107182651,33939
1,-1,14,107148712,107182651,33939
1,-1,14,107148712,107182651,33939
1,-1,14,107148712,107182651,33939
-1,-1,14,107148712,107182651,33939
1,-1,14,107148712,107182651,33939
-1,-1,14,107148712,107182651,33939
1,-1,14,107148712,107182651,33939
1,-1,14,107148712,107182651,33939
-1,-1,14,107148712,107182651,33939
-1,-1,14,107148712,107182651,33939
1,-1,14,107148712,107182651,33939
-1,-1,14,107148712,107182651,33939
1,-1,14,107148712,107182651,33939
1,-1,14,107148712,107182651,33939
1,-1,14,107148712,107182651,33939
-1,-1,14,107148712,107182651,33939
1,-1,14,107148712,107182651,33939
-1,-1,14,107148712,107182651,33939
1,-1,14,107148712,107182651,33939
1,-1,14,107148712,107182651,33939
1,-1,14,107148712,107182651,33939
-1,-1,14,107148712,107182651,33939
-1,-1,14,107148712,107182651,33939
1,-1,14,107148712,107182651,33939
1,-1,14,107148712,107182651,33939
1,-1,14,107148712,107182651,33939
1,-1,14,107148712,107182651,33939
1,-1,14,107148712,107182651,33939
1,-1,14,107148712,107182651,33939
1,-1,14,107148712,107182651,33939
-1,-1,14,107148712,107182651,33939
1,-1,14,107148712,107182651,33939
1,-1,14,107148712,107182651,33939
1,-1,14,107148712,107185512,36800
-1,-1,14,107148712,107185512,36800
-1,-1,14,107148712,107185512,36800
-1,-1,14,107148712,107185512,36800
-1,-1,14,107148712,107185512,36800
-1,-1,14,107148712,107189879,41167
1,-1,14,107148739,107160026,11287
1,-1,14,107148739,107168750,20011
1,-1,14,107148739,107182658,33919
-1,-1,14,107148739,107182658,33919
1,-1,14,107148739,107182658,33919
1,-1,14,107148739,107182658,33919
1,-1,14,107148739,107182658,33919
1,-1,14,107148739,107182658,33919
1,-1,14,107148739,107182658,33919
1,-1,14,107148739,107182658,33919
1,-1,14,107148739,107182658,33919
1,-1,14,107148739,107182658,33919
1,-1,14,107148739,107182658,33919
1,-1,14,107148739,107182658,33919
1,-1,14,107148739,107182658,33919
1,-1,14,107148739,107182658,33919
1,-1,14,107148739,107182658,33919
-1,-1,14,107148739,107182658,33919
1,-1,14,107148739,107182658,33919
1,-1,14,107148739,107185512,36773
-1,-1,14,107148740,107180095,31355
-1,-1,14,107155096,107182651,27555
1,-1,14,107155096,107182651,27555
1,-1,14,107155096,107182651,27555
1,-1,14,107155096,107182651,27555
1,-1,14,107155096,107182651,27555
1,-1,14,107155096,107182651,27555
1,-1,14,107155096,107182651,27555
1,-1,14,107155096,107182651,27555
1,-1,14,107155096,107182651,27555
1,-1,14,107155096,107182651,27555
-1,-1,14,107160845,107180121,19276
-1,-1,14,107160845,107182651,21806
1,-1,14,107160845,107182651,21806
1,-1,14,107160845,107182651,21806
1,-1,14,107160845,107182651,21806
1,-1,14,107160845,107182651,21806
1,-1,14,107160845,107182651,21806
1,-1,14,107160845,107182651,21806
1,-1,14,107160845,107182651,21806
1,-1,14,107160845,107182651,21806
1,-1,14,107160845,107182651,21806
1,-1,14,107160845,107182651,21806
1,-1,14,107160845,107182651,21806
1,-1,14,107160845,107182651,21806
1,-1,14,107160845,107182651,21806
1,-1,14,107160845,107182651,21806
1,-1,14,107160845,107182651,21806
1,-1,14,107160845,107182651,21806
1,-1,14,107160845,107182651,21806
-1,-1,14,107160845,107182651,21806
-1,-1,14,107160845,107182651,21806
-1,-1,14,107160845,107182651,21806
-1,-1,14,107160845,107182651,21806
-1,-1,14,107160845,107182651,21806
-1,-1,14,107163040,107180121,17081
-1,-1,14,107163040,107182651,19611
-1,-1,14,107163040,107182651,19611
-1,-1,14,107189820,107214878,25058
-1,-1,14,107189831,107214893,25062
1,-1,14,107258735,107270326,11591
1,-1,14,107259155,107269750,10595
1,1,15,20045834,32914140,12868306
1,-1,15,20063340,20624533,561193
1,-1,15,20063340,21929931,1866591
1,-1,15,20063340,22303901,2240561
-1,-1,15,20063340,22332342,2269002
1,-1,15,20063340,22652060,2588720
1,-1,15,20063340,22652060,2588720
1,-1,15,20063340,22652060,2588720
1,-1,15,20063340,22652060,2588720
1,-1,15,20063340,22652060,2588720
1,-1,15,20063340,22652060,2588720
1,-1,15,20063340,22652060,2588720
1,-1,15,20063340,22652060,2588720
1,-1,15,20063340,22652060,2588720
1,-1,15,20063340,22652060,2588720
1,-1,15,20063340,22652060,2588720
1,-1,15,20063340,22652060,2588720
1,-1,15,20063340,22652060,2588720
1,-1,15,20063340,22652060,2588720
1,-1,15,20063340,22652060,2588720
1,-1,15,20063340,22652060,2588720
1,-1,15,20063340,22652060,2588720
1,-1,15,20063340,22684152,2620812
1,-1,15,20063340,22762571,2699231
1,-1,15,20063340,22762571,2699231
1,-1,15,20063340,22762571,2699231
1,-1,15,20063340,22762571,2699231
1,-1,15,20063340,22762571,2699231
1,-1,15,20063340,22762571,2699231
1,-1,15,20063340,22762571,2699231
1,-1,15,20063340,22762571,2699231
1,-1,15,20063340,22762571,2699231
1,-1,15,20063340,22762571,2699231
1,-1,15,20063340,22815074,2751734
1,-1,15,20063340,22835864,2772524
1,1,15,20063340,29093456,9030116
1,1,15,20063340,29209620,9146280
1,1,15,20063340,30448351,10385011
1,1,15,20063340,32439302,12375962
1,1,15,20063340,32942613,12879273
1,1,15,20063340,32942613,12879273
1,1,15,20063340,32986584,12923244
1,1,15,20063340,102521392,82458052
1,-1,15,20102594,22652060,2549466
1,-1,15,20102594,22762571,2659977
1,-1,15,20172592,22586922,2414330
-1,-1,15,20172592,22586922,2414330
-1,-1,15,20172592,22586922,2414330
1,-1,15,20172592,22652060,2479468
1,1,15,20190548,28406650,8216102
1,1,15,20190548,32917801,12727253
1,-1,15,20207712,20816349,608637
1,-1,15,20190682,22141158,1950476
1,-1,15,20190682,22141158,1950476
1,-1,15,20190682,22141158,1950476
1,-1,15,20190682,22141158,1950476
1,-1,15,20190682,22303901,2113219
1,-1,15,20190682,22303901,2113219
1,-1,15,20190682,22303901,2113219
1,-1,15,20190682,22303901,2113219
1,-1,15,20190682,22303901,2113219
1,-1,15,20190682,22303901,2113219
1,-1,15,20190682,22303901,2113219
1,-1,15,20190682,22303901,2113219
1,-1,15,20190682,22303901,2113219
1,-1,15,20190682,22303901,2113219
1,-1,15,20190682,22303901,2113219
1,-1,15,20190682,22303901,2113219
1,-1,15,20190682,22303901,2113219
1,-1,15,20190682,22303901,2113219
1,-1,15,20190682,22303901,2113219
1,-1,15,20190682,22303901,2113219
1,-1,15,20190682,22303901,2113219
1,-1,15,20190682,22303901,2113219
1,-1,15,20190682,22303901,2113219
1,-1,15,20190682,22303901,2113219
1,-1,15,20190682,22303901,2113219
1,-1,15,20190682,22303901,2113219
1,-1,15,20190682,22303901,2113219
1,-1,15,20190682,22303901,2113219
1,-1,15,20190682,22303901,2113219
1,-1,15,20190682,22303901,2113219
1,-1,15,20190682,22303901,2113219
1,-1,15,20190682,22303901,2113219
1,-1,15,20190682,22303901,2113219
1,-1,15,20190682,22303901,2113219
1,-1,15,20190682,22303901,2113219
1,-1,15,20190682,22303901,2113219
1,-1,15,20190682,22303901,2113219
1,-1,15,20190682,22303901,2113219
1,-1,15,20190682,22303901,2113219
1,-1,15,20190682,22303901,2113219
1,-1,15,20190682,22303901,2113219
1,-1,15,20190682,22303901,2113219
1,-1,15,20190682,22303901,2113219
1,-1,15,20190682,22318585,2127903
1,-1,15,20190682,22318585,2127903
1,-1,15,20190682,22318585,2127903
1,-1,15,20190682,22332342,2141660
1,-1,15,20190682,22409342,2218660
1,-1,15,20190682,22409342,2218660
1,-1,15,20190682,22409342,2218660
1,-1,15,20190682,22409342,2218660
1,-1,15,20190682,22432504,2241822
1,-1,15,20190682,22432504,2241822
1,-1,15,20190682,22432504,2241822
1,-1,15,20190682,22509196,2318514
1,-1,15,20190682,22558685,2368003
1,-1,15,20190682,22558685,2368003
1,-1,15,20190682,22558685,2368003
1,-1,15,20190682,22558685,2368003
1,-1,15,20190682,22586922,2396240
1,-1,15,20190682,22586922,2396240
1,-1,15,20190682,22586922,2396240
1,-1,15,20190682,22586922,2396240
1,-1,15,20190682,22586922,2396240
1,-1,15,20190682,22586922,2396240
1,-1,15,20190682,22586922,2396240
1,-1,15,20190682,22586922,2396240
1,-1,15,20190682,22586922,2396240
1,-1,15,20190682,22586922,2396240
1,-1,15,20190682,22586922,2396240
-1,-1,15,20190682,22586922,2396240
1,-1,15,20190682,22586922,2396240
1,-1,15,20190682,22586922,2396240
1,-1,15,20190682,22652060,2461378
1,-1,15,20190682,22652060,2461378
1,-1,15,20190682,22652060,2461378
-1,-1,15,20190682,22652060,2461378
-1,-1,15,20190682,22652060,2461378
1,-1,15,20190682,22652060,2461378
1,-1,15,20190682,22652060,2461378
1,-1,15,20190682,22652060,2461378
1,-1,15,20190682,22652060,2461378
1,-1,15,20190682,22652060,2461378
1,-1,15,20190682,22652060,2461378
1,-1,15,20190682,22652060,2461378
1,-1,15,20190682,22652060,2461378
1,-1,15,20190682,22652060,2461378
1,-1,15,20190682,22652060,2461378
1,-1,15,20190682,22652060,2461378
1,-1,15,20190682,22652060,2461378
1,-1,15,20190682,22652060,2461378
1,-1,15,20190682,22652060,2461378
1,-1,15,20190682,22652060,2461378
1,-1,15,20190682,22652060,2461378
-1,-1,15,20190682,22652060,2461378
1,-1,15,20190682,22652060,2461378
1,-1,15,20190682,22652060,2461378
1,-1,15,20190682,22652060,2461378
1,-1,15,20190682,22652060,2461378
-1,-1,15,20190682,22652060,2461378
1,-1,15,20190682,22652060,2461378
1,-1,15,20190682,22652060,2461378
1,-1,15,20190682,22652060,2461378
1,-1,15,20190682,22652060,2461378
1,-1,15,20190682,22652060,2461378
1,-1,15,20190682,22652060,2461378
1,-1,15,20190682,22652060,2461378
1,-1,15,20190682,22652060,2461378
1,-1,15,20190682,22652060,2461378
1,-1,15,20190682,22652060,2461378
1,-1,15,20190682,22652060,2461378
1,-1,15,20190682,22652060,2461378
1,-1,15,20190682,22652060,2461378
1,-1,15,20190682,22652060,2461378
1,-1,15,20190682,22652060,2461378
1,-1,15,20190682,22652060,2461378
1,-1,15,20190682,22652060,2461378
1,-1,15,20190682,22652060,2461378
1,-1,15,20190682,22652060,2461378
1,-1,15,20190682,22652060,2461378
1,-1,15,20190682,22652060,2461378
1,-1,15,20190682,22652060,2461378
1,-1,15,20190682,22652060,2461378
1,-1,15,20190682,22652060,2461378
1,-1,15,20190682,22652060,2461378
1,-1,15,20190682,22652060,2461378
1,-1,15,20190682,22652060,2461378
1,-1,15,20190682,22652060,2461378
-1,-1,15,20190682,22652060,2461378
1,-1,15,20190682,22652060,2461378
1,-1,15,20190682,22663583,2472901
1,-1,15,20190682,22663583,2472901
1,-1,15,20190682,22663583,2472901
1,-1,15,20190682,22663583,2472901
1,-1,15,20190682,22663583,2472901
1,-1,15,20190682,22663583,2472901
1,-1,15,20190682,22663583,2472901
1,-1,15,20190682,22663583,2472901
1,-1,15,20190682,22663583,2472901
1,-1,15,20190682,22663583,2472901
1,-1,15,20190682,22663583,2472901
1,-1,15,20190682,22663583,2472901
1,-1,15,20190682,22663583,2472901
1,-1,15,20190682,22663583,2472901
1,-1,15,20190682,22669079,2478397
1,-1,15,20190682,22669079,2478397
1,-1,15,20190682,22669079,2478397
1,-1,15,20190682,22669079,2478397
1,-1,15,20190682,22684152,2493470
1,-1,15,20190682,22684152,2493470
1,-1,15,20190682,22684152,2493470
1,-1,15,20190682,22684152,2493470
1,-1,15,20190682,22684152,2493470
1,-1,15,20190682,22684152,2493470
1,-1,15,20190682,22684152,2493470
1,-1,15,20190682,22684152,2493470
1,-1,15,20190682,22684501,2493819
1,-1,15,20190682,22729364,2538682
1,-1,15,20190682,22748632,2557950
1,-1,15,20190682,22748632,2557950
1,-1,15,20190682,22748632,2557950
1,-1,15,20190682,22748632,2557950
1,-1,15,20190682,22762571,2571889
1,-1,15,20190682,22762571,2571889
1,-1,15,20190682,22762571,2571889
1,-1,15,20190682,22762571,2571889
1,-1,15,20190682,22762571,2571889
1,-1,15,20190682,22762571,2571889
1,-1,15,20190682,22762571,2571889
1,-1,15,20190682,22762571,2571889
1,-1,15,20190682,22762571,2571889
1,-1,15,20190682,22762571,2571889
1,-1,15,20190682,22762571,2571889
1,-1,15,20190682,22762571,2571889
1,-1,15,20190682,22762571,2571889
1,-1,15,20190682,22762571,2571889
1,-1,15,20190682,22762571,2571889
1,-1,15,20190682,22762571,2571889
1,-1,15,20190682,22762571,2571889
1,-1,15,20190682,22762571,2571889
1,-1,15,20190682,22762571,2571889
1,-1,15,20190682,22762571,2571889
1,-1,15,20190682,22762571,2571889
1,-1,15,20190682,22762571,2571889
1,-1,15,20190682,22762571,2571889
1,-1,15,20190682,22762571,2571889
1,-1,15,20190682,22762571,2571889
1,-1,15,20190682,22762571,2571889
1,-1,15,20190682,22762571,2571889
1,-1,15,20190682,22762571,2571889
1,-1,15,20190682,22762571,2571889
1,-1,15,20190682,22762571,2571889
1,-1,15,20190682,22762571,2571889
1,-1,15,20190682,22762571,2571889
1,-1,15,20190682,22762571,2571889
1,-1,15,20190682,22762571,2571889
1,-1,15,20190682,22762571,2571889
1,-1,15,20190682,22798604,2607922
1,-1,15,20190682,22835864,2645182
1,-1,15,20190682,22835864,2645182
1,-1,15,20207772,21929931,1722159
1,-1,15,20207772,22652060,2444288
1,-1,15,20207772,22652060,2444288
1,-1,15,20207772,22663583,2455811
1,-1,15,20207772,22663583,2455811
1,-1,15,20207772,22684152,2476380
1,-1,15,20207772,22684152,2476380
1,-1,15,20207772,22684152,2476380
1,-1,15,20261544,20816349,554805
1,-1,15,20223655,22141158,1917503
1,-1,15,20223655,22141158,1917503
1,-1,15,20223655,22141158,1917503
1,-1,15,20223655,22141158,1917503
1,-1,15,20223655,22141158,1917503
1,-1,15,20223655,22141158,1917503
1,-1,15,20223655,22141158,1917503
1,-1,15,20223655,22141158,1917503
1,-1,15,20223655,22141158,1917503
1,-1,15,20223655,22141158,1917503
1,-1,15,20223655,22141158,1917503
1,-1,15,20223655,22141158,1917503
1,-1,15,20223655,22141158,1917503
1,-1,15,20223655,22652060,2428405
1,-1,15,20223655,22652060,2428405
1,-1,15,20223655,22652060,2428405
1,-1,15,20223655,22652060,2428405
1,-1,15,20223655,22652060,2428405
1,-1,15,20223655,22652060,2428405
1,-1,15,20223655,22652060,2428405
1,-1,15,20223655,22652060,2428405
1,-1,15,20223655,22652060,2428405
1,-1,15,20223655,22652060,2428405
1,-1,15,20223655,22652060,2428405
1,-1,15,20223655,22652060,2428405
1,-1,15,20223655,22652060,2428405
1,-1,15,20223655,22652060,2428405
1,-1,15,20223655,22652060,2428405
1,-1,15,20223655,22652060,2428405
1,-1,15,20223655,22652060,2428405
1,-1,15,20223655,22652060,2428405
1,-1,15,20223655,22652060,2428405
1,-1,15,20223655,22652060,2428405
1,-1,15,20223655,22652060,2428405
1,-1,15,20223655,22652060,2428405
1,-1,15,20223655,22652060,2428405
1,-1,15,20223655,22652060,2428405
1,-1,15,20223655,22652060,2428405
1,-1,15,20223655,22652060,2428405
1,-1,15,20223655,22663583,2439928
1,-1,15,20223655,22663583,2439928
1,-1,15,20223655,22663583,2439928
1,-1,15,20223655,22663583,2439928
1,-1,15,20223655,22663583,2439928
1,-1,15,20223655,22684152,2460497
1,-1,15,20223655,22684152,2460497
1,-1,15,20223655,22762571,2538916
1,-1,15,20223655,22762571,2538916
1,-1,15,20223655,22762571,2538916
1,-1,15,20223655,22762571,2538916
1,-1,15,20223655,22762571,2538916
-1,-1,15,20394226,22589782,2195556
-1,-1,15,20408298,22652060,2243762
-1,-1,15,20408298,22652060,2243762
-1,-1,15,20408298,22652060,2243762
-1,-1,15,20408298,22652060,2243762
-1,-1,15,20408298,22652060,2243762
-1,-1,15,20408313,20849140,440827
1,-1,15,20423115,22652121,2229006
-1,-1,15,20423126,22409532,1986406
1,-1,15,20423126,22589782,2166656
-1,-1,15,20423126,22648468,2225342
1,-1,15,20423175,22141158,1717983
1,-1,15,20423175,22586922,2163747
1,-1,15,20423175,22586922,2163747
1,-1,15,20423175,22652060,2228885
1,-1,15,20423175,22652060,2228885
1,-1,15,20423175,22652060,2228885
-1,-1,15,20432880,22461833,2028953
-1,-1,15,20432880,22648468,2215588
1,-1,15,20462603,22648468,2185865
-1,-1,15,20492146,22578600,2086454
-1,-1,15,20492147,22344608,1852461
1,-1,15,20530579,22303901,1773322
1,-1,15,20530579,22669079,2138500
1,-1,15,20530579,22684152,2153573
1,-1,15,20530579,22684152,2153573
1,-1,15,20530579,22684152,2153573
1,-1,15,20530579,22684152,2153573
1,-1,15,20530579,22684152,2153573
1,-1,15,20530579,22684152,2153573
1,-1,15,20530579,22684152,2153573
1,-1,15,20530579,22684152,2153573
1,-1,15,20530579,22684501,2153922
1,-1,15,20530579,22717733,2187154
1,-1,15,20530579,22717733,2187154
1,-1,15,20530579,22748632,2218053
1,-1,15,20530579,22748632,2218053
1,-1,15,20530579,22748632,2218053
1,-1,15,20530579,22748632,2218053
1,-1,15,20530579,22762571,2231992
1,-1,15,20530579,22762571,2231992
1,-1,15,20530579,22762571,2231992
1,-1,15,20530579,22762571,2231992
1,-1,15,20530579,22762571,2231992
1,-1,15,20530579,22762571,2231992
1,-1,15,20530579,22762571,2231992
1,-1,15,20530579,22762571,2231992
1,-1,15,20530579,22762571,2231992
1,-1,15,20530579,22762571,2231992
1,-1,15,20530579,22762571,2231992
1,-1,15,20530579,22762571,2231992
1,-1,15,20530579,22762571,2231992
1,-1,15,20530579,22762571,2231992
1,-1,15,20530579,22762571,2231992
1,-1,15,20530579,22762571,2231992
1,-1,15,20530579,22762571,2231992
1,-1,15,20530579,22762571,2231992
1,-1,15,20530579,22762571,2231992
1,-1,15,20530579,22762571,2231992
1,-1,15,20530579,22762571,2231992
1,-1,15,20530579,22762571,2231992
1,-1,15,20530579,22762571,2231992
1,-1,15,20530579,22784133,2253554
1,-1,15,20530579,22815074,2284495
-1,-1,15,20575676,22285320,1709644
-1,-1,15,20604598,20877978,273380
-1,-1,15,20604598,22264518,1659920
-1,-1,15,20624452,22669082,2044630
1,1,15,20686196,30509384,9823188
-1,-1,15,20699921,22141158,1441237
1,-1,15,20733395,23487423,2754028
1,1,15,20733395,28406650,7673255
1,1,15,20733395,102511616,81778221
-1,-1,15,20765649,22141158,1375509
-1,-1,15,20765649,22303901,1538252
1,-1,15,20765649,22509196,1743547
1,-1,15,20765649,22586922,1821273
1,-1,15,20765649,22586922,1821273
1,-1,15,20765649,22652060,1886411
1,-1,15,20765649,22652060,1886411
1,-1,15,20765649,22652060,1886411
-1,-1,15,20787762,22652060,1864298
1,-1,15,20787762,22652060,1864298
1,-1,15,20796186,22303901,1507715
1,-1,15,20796186,22409342,1613156
1,-1,15,20796186,22586922,1790736
1,-1,15,20796186,22652060,1855874
1,-1,15,20796186,22652060,1855874
1,-1,15,20796186,22652060,1855874
1,-1,15,20796186,22652060,1855874
1,-1,15,20796186,22652060,1855874
1,-1,15,20796186,22652060,1855874
1,-1,15,20816349,22267887,1451538
1,-1,15,20816349,22303901,1487552
1,-1,15,20816349,22332342,1515993
1,-1,15,20816349,22450180,1633831
1,-1,15,20816349,22558685,1742336
1,-1,15,20816349,22586922,1770573
1,-1,15,20816349,22652060,1835711
1,-1,15,20816349,22652060,1835711
1,-1,15,20816349,22652060,1835711
1,-1,15,20816349,22652060,1835711
1,-1,15,20816349,22652060,1835711
1,-1,15,20816349,22652060,1835711
1,-1,15,20816349,22652060,1835711
1,-1,15,20816349,22652060,1835711
1,-1,15,20816349,22652060,1835711
1,-1,15,20816349,22652060,1835711
1,-1,15,20816349,22652060,1835711
1,-1,15,20816349,22652060,1835711
1,-1,15,20816349,22652060,1835711
1,-1,15,20816349,22652060,1835711
1,-1,15,20816349,22652060,1835711
1,-1,15,20816349,22652060,1835711
1,-1,15,20816349,22652060,1835711
1,-1,15,20816349,22663583,1847234
1,-1,15,20816349,22663583,1847234
1,-1,15,20816349,22663583,1847234
1,-1,15,20816349,22663583,1847234
1,-1,15,20816349,22684152,1867803
1,-1,15,20816349,22684152,1867803
1,-1,15,20816349,22684152,1867803
1,-1,15,20816349,22684152,1867803
1,-1,15,20816349,22684152,1867803
1,-1,15,20816349,22684501,1868152
-1,-1,15,21071443,22558726,1487283
-1,-1,15,21071443,22589782,1518339
-1,-1,15,21071443,22589782,1518339
-1,-1,15,21979073,22698568,719495
1,-1,15,21129984,22318626,1188642
1,-1,15,21142955,21272405,129450
1,-1,15,21200729,22648468,1447739
1,-1,15,21230379,22652060,1421681
1,-1,15,21272460,22652060,1379600
1,-1,15,21272460,22652060,1379600
1,-1,15,21272460,22652060,1379600
1,-1,15,21272460,22652060,1379600
1,-1,15,21272460,22652060,1379600
1,-1,15,21272460,22652060,1379600
1,-1,15,21272460,22652060,1379600
1,-1,15,21272460,22762571,1490111
1,-1,15,21310163,22762571,1452408
1,-1,15,21336136,22684152,1348016
1,-1,15,21336136,22684152,1348016
1,-1,15,21336136,22684152,1348016
1,-1,15,21336136,22684501,1348365
1,-1,15,21365551,22684152,1318601
-1,-1,15,21381757,22652060,1270303
-1,-1,15,21381757,22652060,1270303
-1,-1,15,21381757,22652060,1270303
-1,-1,15,21381757,22652060,1270303
-1,-1,15,21381757,22652060,1270303
-1,-1,15,21381757,22652060,1270303
-1,-1,15,21381757,22652060,1270303
-1,-1,15,21381757,22652060,1270303
-1,-1,15,21381757,22652060,1270303
-1,-1,15,21381757,22652060,1270303
-1,-1,15,21381757,22652060,1270303
-1,-1,15,21381757,22652060,1270303
-1,-1,15,21381757,22652060,1270303
-1,-1,15,21381757,22652060,1270303
-1,-1,15,21381757,22652060,1270303
-1,-1,15,21381757,22652060,1270303
-1,-1,15,21381757,22652060,1270303
-1,-1,15,21381757,22652060,1270303
-1,-1,15,21381757,22652060,1270303
-1,-1,15,21381757,22652060,1270303
-1,-1,15,21381757,22652060,1270303
-1,-1,15,21381757,22652060,1270303
-1,-1,15,21381757,22652060,1270303
-1,-1,15,21381757,22652060,1270303
-1,-1,15,21381757,22652060,1270303
-1,-1,15,21381757,22652060,1270303
-1,-1,15,21381757,22652060,1270303
1,-1,15,21381757,22762571,1380814
1,-1,15,21381757,22762571,1380814
1,-1,15,21381757,22762571,1380814
-1,-1,15,22267946,22652060,384114
-1,-1,15,22267946,22652060,384114
-1,-1,15,22267946,22652060,384114
-1,-1,15,22267946,22652060,384114
-1,-1,15,22267946,22652060,384114
-1,-1,15,22303901,22558744,254843
-1,-1,15,22285307,22652060,366753
-1,-1,15,22285307,22652060,366753
-1,-1,15,22285307,22652060,366753
-1,-1,15,22285307,22652060,366753
-1,-1,15,22285307,22652060,366753
-1,-1,15,22285307,22652060,366753
-1,-1,15,22285307,22652060,366753
-1,-1,15,22285307,22652060,366753
-1,-1,15,22285307,22652060,366753
-1,-1,15,22285307,22652060,366753
-1,-1,15,22285307,22652060,366753
-1,-1,15,22285307,22652060,366753
-1,-1,15,22285307,22652060,366753
-1,-1,15,22285307,22652060,366753
-1,-1,15,22285307,22652060,366753
-1,-1,15,22285307,22652060,366753
-1,-1,15,22285307,22652060,366753
-1,-1,15,22285307,22652060,366753
-1,-1,15,22285307,22652060,366753
-1,-1,15,22285307,22652060,366753
-1,-1,15,22285307,22652060,366753
-1,-1,15,22285307,22652060,366753
-1,-1,15,22285307,22652060,366753
-1,-1,15,22285307,22652060,366753
-1,-1,15,22285307,22652060,366753
-1,-1,15,22285307,22652060,366753
-1,-1,15,22285307,22652060,366753
-1,-1,15,22285307,22652060,366753
-1,-1,15,22285307,22652060,366753
-1,-1,15,22285307,22652060,366753
-1,-1,15,22285307,22652060,366753
-1,-1,15,22285307,22652060,366753
-1,-1,15,22285307,22652060,366753
-1,-1,15,22285307,22652060,366753
-1,-1,15,22285307,22652060,366753
-1,-1,15,22285307,22652060,366753
-1,-1,15,22285307,22663583,378276
1,-1,15,22285320,22589782,304462
-1,-1,15,22285321,22648468,363147
1,1,15,22304596,28577787,6273191
-1,-1,15,22304626,22589782,285156
-1,-1,15,22304626,22589782,285156
-1,-1,15,22304626,22589782,285156
1,-1,15,22304626,22698552,393926
1,1,15,22318644,29209620,6890976
1,1,15,22409401,28952953,6543552
-1,1,15,22652047,28726590,6074543
1,-1,15,22652060,22698579,46519
1,1,15,22652060,28883749,6231689
-1,-1,15,22698522,23086303,387781
1,-1,15,22698522,23146132,447610
-1,-1,15,22698522,23217514,518992
-1,-1,15,22698522,23217514,518992
1,-1,15,22698522,23217514,518992
1,-1,15,22698522,23217514,518992
-1,-1,15,22698522,23260514,561992
-1,-1,15,22698522,23260514,561992
1,-1,15,22698522,23300287,601765
1,-1,15,22698522,23300287,601765
-1,-1,15,22698522,23300287,601765
-1,-1,15,22698522,23300287,601765
-1,-1,15,22698522,23300287,601765
-1,-1,15,22698522,23300287,601765
-1,-1,15,22698522,23300287,601765
-1,-1,15,22698522,23300287,601765
-1,-1,15,22698522,23300287,601765
-1,-1,15,22698522,23300287,601765
-1,1,15,22698522,28406650,5708128
-1,1,15,22698522,28406650,5708128
-1,1,15,22698522,28406650,5708128
-1,1,15,22698522,28557186,5858664
-1,1,15,22698522,28691460,5992938
-1,1,15,22698522,28691460,5992938
1,1,15,22698522,28940098,6241576
1,1,15,22698522,29030517,6331995
-1,1,15,22698522,29030517,6331995
-1,1,15,22698522,29030517,6331995
1,1,15,22698522,29030517,6331995
1,1,15,22698522,29085896,6387374
-1,1,15,22698522,29085896,6387374
-1,1,15,22698522,29085896,6387374
1,1,15,22698522,30366124,7667602
1,1,15,22698522,30366124,7667602
1,1,15,22698522,30366124,7667602
1,1,15,22698522,30653936,7955414
-1,1,15,22698522,38381783,15683261
-1,-1,15,22765628,23076420,310792
-1,-1,15,22765628,23082821,317193
-1,1,15,22765628,23085096,319468
-1,-1,15,22765628,23086303,320675
-1,1,15,22765628,23146132,380504
1,-1,15,22765628,23217514,451886
1,-1,15,22765628,23217514,451886
-1,-1,15,22765628,23260514,494886
-1,-1,15,22765628,23260514,494886
-1,-1,15,22765628,23300287,534659
-1,-1,15,22765628,23300287,534659
1,1,15,22765628,28520313,5754685
1,1,15,22765628,28557186,5791558
-1,1,15,22765628,28557186,5791558
1,1,15,22765628,28557186,5791558
-1,1,15,22765628,28691460,5925832
-1,1,15,22765628,28691460,5925832
-1,1,15,22765628,28912057,6146429
-1,1,15,22765628,28912057,6146429
1,1,15,22765628,28912057,6146429
-1,1,15,22765628,28940098,6174470
-1,1,15,22765628,28976193,6210565
1,1,15,22765628,29006852,6241224
1,1,15,22765628,29006852,6241224
1,1,15,22765628,29006852,6241224
1,1,15,22765628,29085896,6320268
1,1,15,22765628,29096442,6330814
1,1,15,22765628,30366124,7600496
1,1,15,22765628,30366124,7600496
1,1,15,22765628,30366124,7600496
1,1,15,22765628,30366124,7600496
1,1,15,22765628,30653936,7888308
1,1,15,22765628,30819509,8053881
1,1,15,22765628,30819509,8053881
1,1,15,22765628,30819509,8053881
1,1,15,22765628,30819509,8053881
-1,1,15,22765628,32676855,9911227
1,1,15,22765628,38837526,16071898
1,-1,15,22765637,23085235,319598
1,-1,15,22765637,23085235,319598
1,-1,15,22765637,23146102,380465
1,-1,15,22765637,23217513,451876
1,-1,15,22765637,23217513,451876
1,-1,15,22765637,23217513,451876
1,-1,15,22765637,23300313,534676
1,-1,15,22765637,23300313,534676
-1,-1,15,22765637,23403639,638002
1,1,15,22765637,28520316,5754679
1,1,15,22765637,29085888,6320251
-1,1,15,22765637,29085888,6320251
1,1,15,22765637,29085888,6320251
1,1,15,22765637,30366079,7600442
1,1,15,22765637,31467435,8701798
1,1,15,22765637,32509932,9744295
1,1,15,22765637,32899558,10133921
-1,1,15,22770421,23082328,311907
-1,1,15,22770421,23082328,311907
-1,1,15,22770421,23082328,311907
-1,1,15,22770421,23082328,311907
-1,1,15,22770421,23082328,311907
-1,1,15,22770421,23082328,311907
-1,1,15,22770421,23082328,311907
-1,1,15,22770421,23082328,311907
-1,1,15,22770421,23191651,421230
-1,1,15,22770421,23191651,421230
-1,1,15,22770421,23191761,421340
-1,1,15,22770421,23195725,425304
-1,1,15,22770421,23195725,425304
-1,1,15,22770421,23206905,436484
-1,1,15,22770421,23213566,443145
-1,1,15,22770421,23282799,512378
-1,1,15,22770421,23282799,512378
-1,1,15,22770421,23282799,512378
-1,1,15,22770421,23282799,512378
-1,1,15,22770421,23282905,512484
-1,1,15,22770421,23282905,512484
-1,1,15,22770421,23282976,512555
-1,1,15,22770421,23283811,513390
-1,1,15,22770421,23290819,520398
-1,1,15,22770421,23291159,520738
-1,1,15,22770421,28415107,5644686
-1,1,15,22770421,28419123,5648702
-1,1,15,22770421,28527747,5757326
1,1,15,22770421,28527747,5757326
1,1,15,22770421,28534245,5763824
-1,1,15,22770421,28534458,5764037
-1,1,15,22770421,28539975,5769554
-1,1,15,22770421,28545355,5774934
-1,1,15,22770421,28545355,5774934
-1,1,15,22770421,28560269,5789848
1,1,15,22770421,28561670,5791249
-1,1,15,22770421,28561671,5791250
1,1,15,22770421,28644578,5874157
-1,1,15,22770421,28660038,5889617
1,1,15,22770421,28660038,5889617
-1,1,15,22770421,28704050,5933629
-1,1,15,22770421,28709715,5939294
-1,1,15,22770421,28709715,5939294
-1,1,15,22770421,28723454,5953033
-1,1,15,22770421,28723454,5953033
-1,1,15,22770421,28723454,5953033
-1,1,15,22770421,28723454,5953033
-1,1,15,22770421,28723454,5953033
-1,1,15,22770421,28723454,5953033
-1,1,15,22770421,28723454,5953033
-1,1,15,22770421,28823722,6053301
-1,1,15,22770421,28823722,6053301
-1,1,15,22770421,28823722,6053301
1,1,15,22770421,28823722,6053301
-1,1,15,22770421,28823722,6053301
-1,1,15,22770421,28823722,6053301
-1,1,15,22770421,28823722,6053301
-1,1,15,22770421,28828168,6057747
-1,1,15,22770421,28915864,6145443
1,1,15,22770421,28915864,6145443
1,1,15,22770421,28928730,6158309
-1,1,15,22770421,28928730,6158309
-1,1,15,22770421,28928730,6158309
1,1,15,22770421,28958779,6188358
1,1,15,22770421,28958779,6188358
1,1,15,22770421,29009042,6238621
-1,1,15,22770421,29021034,6250613
1,1,15,22770421,29062203,6291782
-1,1,15,22770421,29062203,6291782
1,1,15,22770421,29069001,6298580
-1,1,15,22770421,29081921,6311500
1,1,15,22770421,30369944,7599523
1,1,15,22770421,30386398,7615977
1,1,15,22770421,30386398,7615977
1,1,15,22770421,30386398,7615977
1,1,15,22770421,30386553,7616132
1,1,15,22770421,30386553,7616132
1,1,15,22770421,30386553,7616132
1,1,15,22770421,31073669,8303248
1,1,15,22770421,31073669,8303248
1,1,15,22770421,31122895,8352474
-1,1,15,22770421,31760986,8990565
1,1,15,22770421,33707835,10937414
-1,1,15,22770422,30316012,7545590
1,1,15,22770422,102429112,79658690
1,1,15,22770422,102429112,79658690
1,-1,15,22784523,23085096,300573
-1,-1,15,22784523,23085096,300573
1,-1,15,22784523,23085096,300573
1,-1,15,22784523,23085096,300573
1,-1,15,22784523,23085096,300573
1,-1,15,22784523,23085096,300573
1,-1,15,22784523,23085096,300573
-1,1,15,22784523,28525460,5740937
-1,1,15,22815306,28406650,5591344
1,-1,15,22815577,23217514,401937
-1,-1,15,22824342,23086303,261961
-1,-1,15,22860857,23300238,439381
-1,1,15,22860857,28399196,5538339
-1,1,15,22860857,28399196,5538339
1,-1,15,22866888,23699760,832872
1,1,15,23179889,26225694,3045805
-1,1,15,23276605,30370018,7093413
1,1,15,23282829,32444044,9161215
-1,1,15,23282829,32446830,9164001
-1,1,15,23286571,28540415,5253844
-1,1,15,23286571,28545355,5258784
-1,1,15,23286571,28545355,5258784
-1,1,15,23286571,28545504,5258933
1,1,15,23288374,28534245,5245871
-1,1,15,23290786,28545459,5254673
-1,1,15,23290786,28561097,5270311
1,1,15,23290862,28534245,5243383
1,1,15,23290862,28561097,5270235
-1,1,15,23290862,28823722,5532860
1,1,15,23300138,29338429,6038291
1,1,15,23300238,28520313,5220075
-1,1,15,23300238,28520313,5220075
-1,1,15,23300238,28520313,5220075
-1,1,15,23300238,28520313,5220075
-1,1,15,23300238,28520313,5220075
1,1,15,23300254,28691447,5391193
-1,-1,15,23300285,23643764,343479
-1,-1,15,23300285,23643764,343479
1,-1,15,23328927,23597805,268878
-1,1,15,23353638,28592766,5239128
1,1,15,23487423,28406650,4919227
1,1,15,23569415,28399196,4829781
-1,1,15,23615768,28534458,4918690
-1,1,15,23615768,28534458,4918690
-1,1,15,23615768,28540415,4924647
-1,1,15,23615768,28545355,4929587
-1,1,15,23615768,28659911,5044143
-1,1,15,23615768,28823722,5207954
-1,1,15,23615768,28823722,5207954
-1,1,15,23615769,28163991,4548222
-1,1,15,23615769,28545355,4929586
-1,1,15,23615769,28545355,4929586
1,1,15,23615769,28561097,4945328
-1,1,15,23615769,28561671,4945902
-1,1,15,23615769,28635058,5019289
-1,1,15,23615769,28660038,5044269
-1,1,15,23615769,28660038,5044269
-1,1,15,23620191,28357230,4737039
-1,1,15,23620191,28437018,4816827
-1,1,15,23620191,28527734,4907543
1,1,15,23620191,28534245,4914054
-1,1,15,23620191,28534359,4914168
-1,1,15,23620191,28539975,4919784
-1,1,15,23620191,28539975,4919784
-1,1,15,23620191,28540415,4920224
-1,1,15,23620191,28545355,4925164
-1,1,15,23620191,28545355,4925164
-1,1,15,23620191,28545355,4925164
-1,1,15,23620191,28545355,4925164
-1,1,15,23620191,28545355,4925164
-1,1,15,23620191,28545504,4925313
-1,1,15,23620191,28545601,4925410
-1,1,15,23620191,28561232,4941041
-1,1,15,23620191,28561671,4941480
-1,1,15,23620191,28709715,5089524
1,1,15,23620191,28958779,5338588
-1,1,15,23622526,102521392,78898866
-1,1,15,23625784,28540345,4914561
1,1,15,23643767,28525460,4881693
-1,1,15,23656064,28520316,4864252
-1,1,15,23656064,28691447,5035383
-1,1,15,23656936,28520313,4863377
-1,1,15,23656936,28520313,4863377
1,1,15,23656936,28520313,4863377
-1,1,15,23656936,28520313,4863377
-1,1,15,23656936,28520313,4863377
1,1,15,23656936,28520313,4863377
1,1,15,23656936,28525460,4868524
-1,1,15,23667814,28542124,4874310
-1,1,15,23667814,28940008,5272194
-1,1,15,23668011,28525460,4857449
1,1,15,23668011,28525460,4857449
-1,1,15,23668011,28525460,4857449
-1,1,15,23668011,28525460,4857449
-1,1,15,23668011,28525460,4857449
-1,1,15,23668011,28557186,4889175
-1,1,15,23668011,28557186,4889175
-1,1,15,23668011,28557186,4889175
-1,1,15,23668011,28557186,4889175
-1,1,15,23668011,28691460,5023449
-1,1,15,23668011,28801348,5133337
-1,1,15,23684655,28399196,4714541
-1,1,15,23684655,28399196,4714541
1,1,15,23689315,28522493,4833178
-1,1,15,23699701,28525460,4825759
-1,1,15,23707252,28535207,4827955
-1,1,15,23707435,28520316,4812881
-1,1,15,23707435,28557186,4849751
-1,1,15,23707435,28691447,4984012
-1,1,15,23707435,28940068,5232633
-1,1,15,23707452,27296222,3588770
1,1,15,23707452,28406650,4699198
-1,1,15,23707452,28406650,4699198
-1,1,15,23707452,28406650,4699198
-1,1,15,23707452,28406650,4699198
1,1,15,23707452,28520313,4812861
-1,1,15,23707452,28520313,4812861
-1,1,15,23707452,28520313,4812861
-1,1,15,23707452,28520313,4812861
-1,1,15,23707452,28520313,4812861
-1,1,15,23707452,28557186,4849734
1,1,15,23707452,28940098,5232646
-1,1,15,23769081,28525460,4756379
-1,1,15,24179003,37238599,13059596
-1,1,15,24244854,28557186,4312332
-1,1,15,24296571,27467567,3170996
-1,-1,15,24350467,24668288,317821
-1,-1,15,24350467,24668288,317821
-1,-1,15,24350467,24795327,444860
-1,-1,15,24350467,24795327,444860
-1,-1,15,24350467,24795327,444860
-1,-1,15,24350467,24795327,444860
-1,-1,15,24350467,24795327,444860
1,1,15,24342084,25118317,776233
-1,-1,15,24431653,24699937,268284
-1,-1,15,24431653,24738239,306586
-1,-1,15,24470092,24738199,268107
-1,-1,15,24487792,24777982,290190
-1,-1,15,24487792,24777982,290190
-1,-1,15,24487792,24777982,290190
-1,-1,15,24504433,24723143,218710
-1,-1,15,24504433,24723143,218710
-1,-1,15,24504433,24723143,218710
-1,-1,15,24504433,24723143,218710
-1,-1,15,24504433,24777982,273549
-1,-1,15,24504433,24777982,273549
-1,-1,15,24504433,24777982,273549
-1,-1,15,24504460,24738239,233779
-1,-1,15,24540420,24777982,237562
-1,-1,15,24540420,24777982,237562
-1,-1,15,24540420,24777982,237562
-1,-1,15,24681387,24738209,56822
-1,-1,15,25068901,25082506,13605
-1,-1,15,25078407,25114364,35957
-1,1,15,25279016,37496505,12217489
1,1,15,25580017,25596966,16949
-1,1,15,25582420,25798470,216050
1,-1,15,25585059,25585246,187
1,-1,15,25683179,25684070,891
1,-1,15,25683179,25684070,891
1,-1,15,25683179,25684070,891
1,-1,15,25683179,25684070,891
1,1,15,27958867,28399196,440329
1,-1,15,28356357,28399196,42839
1,-1,15,28525218,28976133,450915
1,-1,15,28525218,28976133,450915
1,-1,15,28525218,28976133,450915
1,-1,15,28525218,28976133,450915
1,-1,15,28525218,28976133,450915
1,-1,15,28525218,28976133,450915
1,-1,15,28525218,28976133,450915
1,-1,15,28525218,28976133,450915
1,-1,15,28525218,28976133,450915
1,-1,15,28525218,28976133,450915
1,-1,15,28525218,28976133,450915
1,-1,15,28525218,28976133,450915
1,-1,15,28525218,29093456,568238
1,-1,15,28525218,29096386,571168
1,-1,15,28525218,29096386,571168
1,-1,15,28525218,29096386,571168
1,-1,15,28525218,29096386,571168
1,-1,15,28525218,29096386,571168
1,-1,15,28525218,29096386,571168
1,-1,15,28525218,29096386,571168
1,-1,15,28525218,29209620,684402
-1,1,15,28547475,32446830,3899355
-1,-1,15,28579796,28755702,175906
-1,-1,15,28579796,28846113,266317
1,-1,15,28579796,29093456,513660
-1,-1,15,28646272,28846113,199841
1,-1,15,28691401,29030517,339116
1,1,15,28940039,30366124,1426085
1,1,15,28940039,31077833,2137794
-1,1,15,28989650,32514980,3525330
-1,1,15,29096445,32633241,3536796
-1,1,15,29096445,32635875,3539430
-1,1,15,29096445,32732884,3636439
-1,1,15,29209620,102521392,73311772
-1,1,15,29214105,32418220,3204115
1,-1,15,30366079,31077996,711917
-1,-1,15,30390007,30849983,459976
-1,-1,15,30390007,30849983,459976
-1,-1,15,30390007,30865176,475169
-1,-1,15,30390007,30865176,475169
-1,-1,15,30390007,30865176,475169
-1,-1,15,30390007,30865176,475169
-1,-1,15,30390007,30865176,475169
-1,-1,15,30390007,30865176,475169
-1,-1,15,30390007,30865176,475169
-1,-1,15,30390007,30888859,498852
-1,-1,15,30390007,31077996,687989
-1,1,15,30386398,32444044,2057646
1,1,15,30386398,32444196,2057798
1,1,15,30386398,32446830,2060432
-1,-1,15,30405535,30833816,428281
-1,-1,15,30405535,30865176,459641
-1,-1,15,30405535,30865176,459641
-1,-1,15,30448351,30653920,205569
-1,-1,15,30448351,30833816,385465
-1,-1,15,30448351,30849983,401632
-1,-1,15,30448351,30849983,401632
-1,-1,15,30448351,30865176,416825
-1,-1,15,30462313,30800272,337959
-1,-1,15,30462313,30800272,337959
-1,-1,15,30462313,30800272,337959
-1,-1,15,30462313,30800272,337959
-1,-1,15,30462313,30800272,337959
-1,-1,15,30462313,30833816,371503
-1,-1,15,30462313,30833816,371503
-1,-1,15,30462313,30833816,371503
-1,-1,15,30462313,30833816,371503
-1,-1,15,30462313,30833816,371503
-1,-1,15,30462313,30849983,387670
-1,-1,15,30462313,30865176,402863
-1,-1,15,30462313,30865176,402863
-1,-1,15,30491382,30865176,373794
-1,-1,15,30489810,30783644,293834
-1,-1,15,30509325,30865176,355851
-1,-1,15,30509325,30865176,355851
-1,1,15,30509325,32509926,2000601
-1,1,15,30509325,32899558,2390233
1,1,15,30583466,32509926,1926460
1,1,15,30653859,32443124,1789265
1,1,15,30653877,31864690,1210813
1,1,15,30653877,32706883,2053006
1,1,15,30653877,32706883,2053006
1,1,15,30653877,32861626,2207749
-1,1,15,30653877,32861626,2207749
1,1,15,30653877,32899558,2245681
-1,1,15,30653877,32914199,2260322
1,1,15,30730513,32861626,2131113
1,1,15,30730513,32899558,2169045
-1,1,15,30819465,32509926,1690461
-1,1,15,30819465,32509926,1690461
-1,1,15,30819465,32514980,1695515
-1,1,15,30819465,32514980,1695515
1,1,15,30913573,32444044,1530471
1,1,15,30913574,32439524,1525950
-1,1,15,30921917,32514980,1593063
-1,1,15,30921917,32514980,1593063
-1,1,15,30921917,32514980,1593063
-1,1,15,30921917,32514980,1593063
-1,1,15,30921917,32514980,1593063
-1,1,15,30921917,32514980,1593063
-1,1,15,30921917,32514980,1593063
-1,1,15,30921917,32514980,1593063
-1,1,15,30921917,32514980,1593063
-1,1,15,30921917,32514980,1593063
-1,1,15,30921917,32514980,1593063
-1,1,15,30921917,32514980,1593063
-1,1,15,30921917,32514980,1593063
-1,1,15,30921917,32514980,1593063
-1,1,15,30921917,32514980,1593063
-1,1,15,30921917,32539666,1617749
-1,1,15,30921917,32539666,1617749
-1,1,15,30921917,32539666,1617749
-1,1,15,30921917,32567325,1645408
1,1,15,30921917,32861626,1939709
1,1,15,30921917,32861626,1939709
1,1,15,30921917,32861626,1939709
1,1,15,30921917,32861626,1939709
-1,1,15,30921917,32914199,1992282
-1,1,15,30954726,32443895,1489169
-1,1,15,30954726,32514957,1560231
-1,1,15,30954726,32514957,1560231
-1,1,15,30954726,32514957,1560231
-1,1,15,30954726,32514957,1560231
-1,1,15,30954726,32539670,1584944
-1,1,15,30954726,32539670,1584944
-1,-1,15,30938215,31244225,306010
-1,1,15,30954724,32443124,1488400
-1,1,15,30954724,32509932,1555208
-1,1,15,30954724,32861612,1906888
-1,-1,15,30954726,31077833,123107
-1,1,15,30954726,32509926,1555200
-1,1,15,30954726,32509926,1555200
-1,1,15,30954726,32509926,1555200
-1,1,15,30954726,32509926,1555200
-1,1,15,30954726,32509926,1555200
-1,1,15,30954726,32509926,1555200
-1,1,15,31042916,32899558,1856642
-1,1,15,31073668,32446829,1373161
-1,1,15,31073668,32446830,1373162
1,1,15,31073669,32446830,1373161
-1,1,15,31073669,32446830,1373161
1,1,15,31073735,32439281,1365546
1,1,15,31073735,32444044,1370309
-1,1,15,31073735,32444196,1370461
-1,1,15,31073735,32446830,1373095
-1,1,15,31073735,32446830,1373095
-1,1,15,31073735,32446830,1373095
-1,1,15,31073735,32446830,1373095
-1,1,15,31073735,32446830,1373095
-1,1,15,31073735,32446830,1373095
-1,1,15,31073735,32446830,1373095
-1,1,15,31073735,32446830,1373095
-1,1,15,31073735,32446830,1373095
1,1,15,31089934,32443019,1353085
-1,1,15,31089934,32462642,1372708
-1,1,15,31098690,32446830,1348140
-1,1,15,31098690,32446830,1348140
-1,1,15,31112919,32444261,1331342
-1,1,15,31112919,32446830,1333911
-1,1,15,31115047,32418220,1303173
-1,1,15,31115047,32418220,1303173
1,1,15,31115047,32917801,1802754
1,1,15,31126934,32444043,1317109
1,-1,15,31261835,31609620,347785
1,-1,15,31355015,31369385,14370
-1,1,15,31541529,34233745,2692216
-1,1,15,31956606,32446830,490224
-1,1,15,31967641,32446830,479189
-1,1,15,31967641,32446830,479189
-1,1,15,31972646,32509926,537280
-1,1,15,31972646,32509926,537280
-1,1,15,31999631,32446830,447199
-1,1,15,32003537,32446830,443293
1,-1,15,32003537,32446830,443293
-1,1,15,32003537,32446830,443293
-1,1,15,32003537,32446830,443293
-1,1,15,32065077,32514957,449880
-1,1,15,32011475,32446830,435355
1,-1,15,32020625,32443019,422394
1,-1,15,32020625,32443019,422394
1,-1,15,32021733,32350044,328311
1,-1,15,32021733,32510863,489130
1,-1,15,32021733,32510863,489130
1,-1,15,32024132,32418220,394088
1,-1,15,32024132,32418220,394088
1,-1,15,32030812,32439084,408272
1,-1,15,32030812,32510067,479255
1,-1,15,32031012,32509926,478914
1,1,15,32031012,32635959,604947
1,-1,15,32064983,32430030,365047
1,-1,15,32064983,32443124,378141
1,-1,15,32064983,32509932,444949
1,-1,15,32064983,32509932,444949
1,-1,15,32064983,32509932,444949
1,-1,15,32064983,32509932,444949
1,-1,15,32064983,32509932,444949
1,-1,15,32064983,32509932,444949
1,-1,15,32064983,32509932,444949
1,-1,15,32064983,32509932,444949
1,-1,15,32064983,32509932,444949
1,-1,15,32064983,32509932,444949
-1,1,15,32065000,32445252,380252
-1,1,15,32065000,32445252,380252
1,-1,15,32065000,32509926,444926
-1,1,15,32065000,32514980,449980
-1,1,15,32065000,32514980,449980
-1,1,15,32065000,32514980,449980
-1,1,15,32065000,32514980,449980
-1,1,15,32065000,32539666,474666
-1,1,15,32065000,32676855,611855
1,-1,15,32098670,32426869,328199
1,-1,15,32098670,32908373,809703
1,-1,15,32115751,32148947,33196
1,-1,15,32115751,32148947,33196
1,-1,15,32248451,32510863,262412
-1,-1,15,32462643,32861654,399011
-1,-1,15,32462643,32861654,399011
-1,-1,15,32462643,32861654,399011
-1,-1,15,32509657,32861654,351997
-1,-1,15,32539611,32861654,322043
-1,-1,15,32539611,32861654,322043
-1,-1,15,32539611,32861654,322043
-1,-1,15,32539611,32861654,322043
-1,-1,15,34695196,34841416,146220
-1,-1,15,34695196,34841417,146221
1,-1,15,34724213,34757001,32788
-1,-1,15,34785023,34964202,179179
1,1,15,36905047,40037396,3132349
-1,1,15,41689327,52446981,10757654
1,1,15,41745084,102354798,60609714
-1,1,15,42850434,49592633,6742199
-1,1,15,43077825,43634458,556633
1,-1,15,43591116,43851142,260026
1,-1,15,43851548,43948346,96798
1,-1,15,43851548,43951301,99753
-1,1,15,43868571,44014518,145947
-1,-1,15,43888927,43938847,49920
-1,1,15,43888927,43951301,62374
-1,-1,15,43916972,43950720,33748
-1,-1,15,43916972,43950720,33748
-1,-1,15,43916972,43951301,34329
1,-1,15,43916972,43951301,34329
-1,-1,15,43916972,43951301,34329
-1,-1,15,43916975,43951317,34342
-1,1,15,47574384,50369056,2794672
-1,1,15,47753041,52786419,5033378
1,1,15,48728235,48793803,65568
1,1,15,48728235,48793803,65568
1,-1,15,50821997,51000060,178063
-1,1,15,51568887,57380584,5811697
-1,-1,15,53845372,53901663,56291
-1,1,15,54713558,62769295,8055737
1,-1,15,57656005,57748274,92269
1,-1,15,57656005,57748274,92269
1,-1,15,57656005,57748274,92269
1,-1,15,57656005,57748274,92269
-1,1,15,58088503,62221756,4133253
1,1,15,60120659,102461201,42340542
-1,1,15,70317639,78998335,8680696
1,1,15,72447290,102461201,30013911
1,-1,15,72921369,72957425,36056
-1,1,15,72943184,75567198,2624014
-1,1,15,72963970,75535330,2571360
-1,1,15,72977572,76019966,3042394
-1,1,15,74399305,76040549,1641244
-1,1,15,75535348,76040549,505201
-1,-1,15,75541862,75589035,47173
1,-1,15,75552647,75580628,27981
1,-1,15,75552647,75580628,27981
1,-1,15,75552647,75580628,27981
1,-1,15,75552647,75580628,27981
1,-1,15,75552647,75589035,36388
1,-1,15,75562397,75580623,18226
1,-1,15,75562397,75580623,18226
1,-1,15,75562397,75586721,24324
1,-1,15,75562397,75586721,24324
1,-1,15,75562397,75586721,24324
1,-1,15,75562397,75586721,24324
1,-1,15,75562397,75586721,24324
1,-1,15,75562397,75586721,24324
1,-1,15,75562397,75586721,24324
1,-1,15,75562397,75586721,24324
1,-1,15,75562397,75586721,24324
1,-1,15,75562397,75586721,24324
1,-1,15,75562397,75588048,25651
1,-1,15,75562401,75589035,26634
1,1,15,76061144,102429112,26367968
-1,1,15,76298495,80274759,3976264
1,1,15,77354675,98130043,20775368
-1,-1,15,77611057,77634432,23375
1,-1,15,77722862,77737043,14181
1,1,15,80648093,102429112,21781019
-1,1,15,80703867,83955596,3251729
1,1,15,83528428,102351195,18822767
-1,-1,15,83770116,83960718,190602
1,1,15,84380129,102383473,18003344
1,1,15,85089467,102495441,17405974
1,-1,15,85771281,86136957,365676
1,-1,15,85834072,86088001,253929
1,-1,15,85834072,86101813,267741
1,1,15,85940770,102429112,16488342
1,1,15,86148286,102511616,16363330
1,1,15,86369896,102461201,16091305
-1,1,15,88295992,94215607,5919615
1,1,15,88447966,102383473,13935507
1,1,15,89219806,98907972,9688166
1,1,15,89817501,102383473,12565972
1,1,15,89817712,102444623,12626911
1,1,15,89924847,102429112,12504265
-1,1,15,90346994,102354798,12007804
1,-1,15,90857664,90943754,86090
-1,1,15,91589712,93889459,2299747
1,-1,15,92397220,92592961,195741
1,1,15,93148806,102429112,9280306
-1,1,15,93506889,93574471,67582
1,1,15,93584754,102481529,8896775
-1,1,15,93741946,102383473,8641527
-1,1,15,93741946,102383473,8641527
-1,-1,15,93805530,93889806,84276
-1,-1,15,94150634,94218046,67412
-1,-1,15,94218046,94334589,116543
1,-1,15,94285748,94529561,243813
-1,1,15,94348261,101867081,7518820
-1,1,15,94782891,102429112,7646221
-1,1,15,95013454,102521392,7507938
-1,1,15,95136822,102045577,6908755
1,1,15,95202449,98779894,3577445
-1,1,15,95238218,102429112,7190894
-1,1,15,96313856,102351195,6037339
-1,1,15,96567356,102461201,5893845
1,-1,15,96873441,96875578,2137
-1,1,15,96913435,102429112,5515677
-1,1,15,97223728,102429112,5205384
-1,1,15,97557295,102383473,4826178
-1,1,15,97715984,102461201,4745217
-1,1,15,98220018,102429112,4209094
-1,1,15,98224943,102461201,4236258
-1,1,15,98484657,102338129,3853472
-1,-1,15,98554119,98685713,131594
-1,1,15,98628330,102383473,3755143
1,1,15,98668456,99927895,1259439
-1,1,15,98737093,102429112,3692019
-1,1,15,98818228,102399760,3581532
1,1,15,98823526,102429112,3605586
-1,1,15,99010526,102383473,3372947
-1,1,15,99435936,99722958,287022
-1,1,15,99696192,102383473,2687281
1,1,15,99878488,102383473,2504985
-1,1,15,99927895,102399814,2471919
1,-1,15,100411220,100598650,187430
1,-1,15,100492038,100591941,99903
1,-1,15,101710679,102014393,303714
1,-1,15,101780775,102009117,228342
-1,-1,15,101935884,101992296,56412
1,-1,15,102014334,102256748,242414
1,-1,15,102040846,102256734,215888
1,-1,15,102040980,102263418,222438
1,-1,15,102161480,102206379,44899
1,-1,15,102161480,102249013,87533
1,-1,15,102161480,102249013,87533
1,-1,15,102161480,102249013,87533
1,-1,15,102161480,102249013,87533
1,-1,15,102161506,102252063,90557
1,-1,15,102161506,102252063,90557
1,-1,15,102161506,102252063,90557
1,-1,15,102226242,102263418,37176
1,-1,15,102226242,102263418,37176
1,-1,15,102234331,102263389,29058
1,-1,15,102415472,102502618,87146
1,-1,16,62993,82412,19419
1,-1,16,62993,82412,19419
-1,-1,16,66203,82412,16209
1,-1,16,66203,82412,16209
1,-1,16,66203,82412,16209
1,-1,16,66203,82412,16209
1,-1,16,66203,179080,112877
1,-1,16,69193,82412,13219
1,-1,16,69193,82412,13219
1,-1,16,69193,82412,13219
1,-1,16,69193,82412,13219
1,-1,16,69193,82412,13219
1,-1,16,69193,82412,13219
1,1,16,69193,90274381,90205188
-1,-1,16,72569,82612,10043
-1,-1,16,72769,82412,9643
-1,-1,16,72769,82412,9643
-1,-1,16,72769,82412,9643
-1,-1,16,72769,82412,9643
-1,-1,16,72769,82412,9643
-1,-1,16,72769,82412,9643
-1,-1,16,72769,82412,9643
-1,-1,16,72769,82412,9643
-1,-1,16,72769,82412,9643
-1,-1,16,72769,82412,9643
-1,-1,16,72769,82412,9643
-1,-1,16,72769,82412,9643
-1,-1,16,72769,82412,9643
1,-1,16,72769,82412,9643
-1,-1,16,72769,82412,9643
-1,-1,16,72769,82412,9643
-1,-1,16,72769,82412,9643
-1,-1,16,72769,82412,9643
-1,-1,16,72769,82412,9643
-1,-1,16,72769,82412,9643
-1,-1,16,72769,82412,9643
-1,-1,16,72769,82412,9643
-1,-1,16,72769,82412,9643
-1,-1,16,72769,82412,9643
-1,-1,16,72769,82412,9643
-1,-1,16,72769,82412,9643
-1,-1,16,72769,82412,9643
-1,-1,16,72769,82412,9643
-1,-1,16,72769,82412,9643
-1,-1,16,72769,82412,9643
-1,-1,16,72769,82412,9643
-1,-1,16,72769,82412,9643
-1,-1,16,72769,82412,9643
-1,-1,16,72798,82437,9639
1,1,16,78801,9169448,9090647
-1,1,16,85880,643107,557227
-1,1,16,85880,754083,668203
1,1,16,85880,9883129,9797249
1,1,16,85880,19806921,19721041
1,1,16,85880,22442007,22356127
1,1,16,85881,90155062,90069181
1,1,16,85881,90155062,90069181
1,1,16,93732,13420663,13326931
-1,1,16,96722,1917328,1820606
-1,1,16,96766,932211,835445
-1,1,16,96766,1594015,1497249
1,1,16,96766,4297186,4200420
1,1,16,96766,11619372,11522606
1,-1,16,97133,109978,12845
1,1,16,97133,5122974,5025841
-1,1,16,109978,1271651,1161673
1,-1,16,114294,185756,71462
-1,-1,16,202249,204466,2217
1,-1,16,202249,204466,2217
-1,-1,16,202249,215724,13475
-1,1,16,215499,233437,17938
-1,1,16,215499,233437,17938
-1,1,16,215499,233437,17938
-1,1,16,215499,234337,18838
-1,1,16,215674,232684,17010
1,-1,16,216621,223674,7053
-1,1,16,223658,225684,2026
-1,1,16,223658,225684,2026
-1,1,16,223658,225684,2026
-1,1,16,230541,231196,655
1,-1,16,400651,446961,46310
1,-1,16,400651,446961,46310
1,-1,16,449695,474204,24509
1,-1,16,542760,615476,72716
-1,-1,16,571803,608532,36729
1,-1,16,584395,772554,188159
-1,-1,16,686673,772554,85881
1,-1,16,686673,772554,85881
-1,-1,16,686673,772554,85881
-1,-1,16,686673,772554,85881
1,-1,16,686673,836508,149835
-1,-1,16,700260,772554,72294
-1,-1,16,700260,772554,72294
1,1,16,716662,15836961,15120299
1,-1,16,755749,766588,10839
1,-1,16,813654,824069,10415
1,-1,16,813654,824069,10415
1,-1,16,813654,834971,21317
1,-1,16,816211,824069,7858
1,-1,16,816211,824069,7858
1,-1,16,816211,830254,14043
1,-1,16,816211,863586,47375
1,-1,16,824069,863010,38941
1,-1,16,845689,848782,3093
1,-1,16,845689,857580,11891
1,-1,16,1029282,1035586,6304
1,-1,16,1034540,1036105,1565
1,-1,16,1278591,1306279,27688
1,-1,16,1278591,1306880,28289
1,-1,16,1279620,1306279,26659
1,-1,16,1279620,1306279,26659
1,-1,16,1279620,1306279,26659
1,-1,16,1279620,1306279,26659
1,-1,16,1279620,1306279,26659
1,-1,16,1279620,1306279,26659
1,-1,16,1279620,1306279,26659
1,-1,16,1279620,1306279,26659
1,-1,16,1279620,1306279,26659
1,-1,16,1279620,1306279,26659
1,-1,16,1279620,1306279,26659
1,-1,16,1279620,1306279,26659
1,-1,16,1279620,1306279,26659
1,-1,16,1279620,1306279,26659
-1,-1,16,1307542,1486510,178968
-1,-1,16,1804786,1866284,61498
-1,1,16,2075886,2138687,62801
1,1,16,3052290,5011702,1959412
-1,1,16,3146027,6362229,3216202
1,1,16,3586972,4099566,512594
-1,1,16,3610565,4316797,706232
-1,1,16,3649387,3800697,151310
1,1,16,3716024,3809066,93042
-1,1,16,3716036,3788580,72544
-1,1,16,3716036,3817969,101933
-1,1,16,3750607,3860718,110111
1,1,16,3776703,4694962,918259
-1,1,16,3776715,3809010,32295
-1,1,16,3776715,3809010,32295
-1,1,16,3870523,4718348,847825
-1,1,16,3900967,3934582,33615
-1,1,16,3922991,4004415,81424
1,1,16,4694893,29182141,24487248
1,-1,16,5613366,6017776,404410
-1,-1,16,6303204,6602026,298822
-1,1,16,6306086,6618137,312051
-1,1,16,6337330,6469280,131950
-1,-1,16,6575078,6679243,104165
-1,1,16,6836910,7046219,209309
-1,-1,16,6950959,6972248,21289
-1,-1,16,6980832,7038142,57310
-1,-1,16,7046160,7073977,27817
-1,1,16,9916365,10185615,269250
1,-1,16,14015996,14051021,35025
1,1,16,14809973,16794773,1984800
-1,1,16,14809982,16477578,1667596
-1,1,16,14809982,16477578,1667596
-1,1,16,14868192,18738030,3869838
1,1,16,14866283,16390970,1524687
-1,1,16,14866283,16494783,1628500
1,1,16,14866283,16855348,1989065
-1,1,16,14866284,16391910,1525626
-1,1,16,14866284,16544419,1678135
-1,1,16,14877687,16292235,1414548
-1,1,16,14877687,16292235,1414548
-1,1,16,14877687,16292235,1414548
-1,1,16,14877687,16327945,1450258
-1,-1,16,14897702,15148790,251088
1,1,16,14892713,16533890,1641177
-1,1,16,14892880,16533890,1641010
-1,1,16,14896385,16330672,1434287
-1,1,16,14897372,16495076,1597704
-1,1,16,14897625,16391910,1494285
-1,1,16,14897625,16494783,1597158
-1,1,16,14897625,16516109,1618484
-1,1,16,14897788,16508039,1610251
-1,1,16,14899630,16458353,1558723
-1,1,16,14899676,16514111,1614435
-1,1,16,14905705,16391045,1485340
-1,1,16,14906734,16330672,1423938
-1,1,16,14906734,16498084,1591350
-1,1,16,14906734,16516109,1609375
-1,1,16,14906845,16515901,1609056
-1,1,16,14910116,16525348,1615232
-1,1,16,14910205,16194578,1284373
-1,1,16,14910213,16525374,1615161
-1,1,16,14910213,16742194,1831981
-1,1,16,14968855,16127877,1159022
-1,1,16,15048751,16194578,1145827
-1,1,16,15048751,16292235,1243484
-1,-1,16,15048781,15073773,24992
-1,-1,16,15048781,15073773,24992
-1,-1,16,15048781,15116377,67596
-1,1,16,15049968,16295900,1245932
-1,1,16,15049968,16391910,1341942
1,1,16,15154687,18546759,3392072
-1,1,16,15404452,18306854,2902402
-1,1,16,15420069,16388596,968527
-1,1,16,15422920,18181971,2759051
-1,1,16,15449696,16319630,869934
-1,1,16,15449696,16330627,880931
-1,1,16,15449696,16388596,938900
1,1,16,15449696,16391910,942214
-1,1,16,15449696,16514368,1064672
-1,1,16,15481747,16388244,906497
-1,1,16,15481920,16388244,906324
-1,1,16,15481920,18181971,2700051
1,-1,16,15489920,15567615,77695
-1,1,16,15492307,16292235,799928
-1,1,16,15492307,16292235,799928
-1,1,16,15492307,16292235,799928
-1,1,16,15492307,16305677,813370
-1,1,16,15492307,16362707,870400
-1,1,16,15492307,18162167,2669860
-1,1,16,15492307,18366738,2874431
-1,1,16,15507164,16212672,705508
-1,1,16,15507164,16362703,855539
-1,1,16,15507164,16400833,893669
-1,1,16,15507164,16438224,931060
-1,1,16,15507164,16544788,1037624
-1,1,16,15494600,16327171,832571
-1,1,16,15494600,16327171,832571
-1,1,16,15509728,16330672,820944
-1,1,16,15551062,18306841,2755779
-1,1,16,15551302,16194578,643276
-1,1,16,15551302,18141051,2589749
1,-1,16,15977824,16012820,34996
1,-1,16,15977824,16012829,35005
1,-1,16,15986060,16019877,33817
1,-1,16,15986060,16019877,33817
1,-1,16,15986060,16019877,33817
1,-1,16,15986060,16041539,55479
-1,-1,16,16245325,16259284,13959
1,-1,16,16252669,16327899,75230
1,-1,16,16292245,16847701,555456
1,-1,16,16305656,16847701,542045
1,-1,16,16305656,16847701,542045
1,-1,16,16305656,16847701,542045
1,-1,16,16305656,16847701,542045
1,-1,16,16305656,16847701,542045
1,-1,16,16300012,16315139,15127
1,-1,16,16300012,16327171,27159
-1,-1,16,16525289,16772370,247081
1,-1,16,18242569,18779856,537287
1,-1,16,18242569,18779856,537287
1,-1,16,18242569,18779856,537287
1,-1,16,18242569,18779856,537287
1,-1,16,18242569,18779856,537287
1,1,16,18238275,30177240,11938965
1,1,16,19424115,30142220,10718105
1,1,16,21379628,29351826,7972198
1,-1,16,21415521,21521511,105990
-1,-1,16,21475047,21770456,295409
-1,-1,16,21475047,21839326,364279
-1,-1,16,21475039,21531511,56472
-1,-1,16,21475039,21531511,56472
-1,-1,16,21475039,21531511,56472
-1,-1,16,21475039,21531511,56472
-1,-1,16,21475039,21531511,56472
-1,-1,16,21475039,21531511,56472
-1,-1,16,21475039,21531511,56472
-1,-1,16,21475039,21531511,56472
-1,-1,16,21475039,21531511,56472
-1,-1,16,21475039,21531511,56472
-1,-1,16,21475039,21531511,56472
-1,-1,16,21475039,21830004,354965
1,-1,16,21475060,21837551,362491
1,-1,16,21494870,21862393,367523
-1,-1,16,21536930,21837492,300562
-1,-1,16,21574922,21837558,262636
-1,-1,16,21574922,21839326,264404
-1,-1,16,21574922,21839326,264404
-1,-1,16,21574922,21839326,264404
-1,-1,16,21596412,21839326,242914
-1,-1,16,21596412,21839326,242914
-1,1,16,21596299,30399167,8802868
-1,-1,16,21596650,21728367,131717
1,-1,16,21599687,21837551,237864
-1,-1,16,21654404,21728426,74022
-1,-1,16,21654404,21823813,169409
-1,1,16,21761404,22431357,669953
-1,1,16,21761404,22431357,669953
-1,1,16,21801889,22431357,629468
-1,1,16,21801889,22431357,629468
-1,1,16,21801889,22710614,908725
-1,-1,16,21837292,22408072,570780
-1,1,16,21837492,22407931,570439
-1,1,16,21838419,22407951,569532
-1,1,16,21959950,22407951,448001
-1,1,16,21986752,22407872,421120
1,1,16,22718350,28858721,6140371
1,1,16,23763368,31955076,8191708
1,1,16,24406741,33853445,9446704
-1,-1,16,25961844,26020520,58676
1,-1,16,26684264,26750184,65920
1,1,16,27323067,31204727,3881660
-1,1,16,28338667,29353391,1014724
-1,1,16,28384463,29343462,958999
-1,1,16,28404177,30190593,1786416
-1,1,16,28404153,29182196,778043
-1,1,16,28404153,29331350,927197
-1,1,16,28404153,29353391,949238
-1,1,16,28404153,30197341,1793188
-1,1,16,28404153,30197341,1793188
-1,1,16,28404153,30332014,1927861
-1,1,16,28441538,30178406,1736868
-1,1,16,28466730,29427247,960517
-1,1,16,28486693,29048572,561879
-1,1,16,28486693,30197290,1710597
-1,1,16,28503824,30190593,1686769
-1,1,16,28503803,30190568,1686765
1,1,16,28503803,30190568,1686765
1,1,16,28631584,29095327,463743
1,1,16,28689085,29043450,354365
-1,1,16,28689085,29051191,362106
-1,1,16,28689085,29051191,362106
-1,1,16,28689085,29051191,362106
-1,1,16,28708173,29051191,343018
-1,1,16,28733739,29044776,311037
-1,1,16,28733739,29044776,311037
-1,1,16,28763834,29043863,280029
1,1,16,28802397,29043450,241053
1,1,16,28802397,29051191,248794
1,1,16,28808193,29043863,235670
1,1,16,28808193,29088624,280431
1,1,16,28819028,29043863,224835
-1,1,16,28819028,29043972,224944
-1,1,16,28819028,29051191,232163
-1,1,16,28819028,29051191,232163
-1,1,16,28819028,29051191,232163
-1,1,16,28819028,29051191,232163
-1,1,16,28819028,29051191,232163
-1,1,16,28819028,29051191,232163
1,1,16,28819028,29051191,232163
-1,1,16,28819028,29051191,232163
-1,1,16,28819028,29051191,232163
-1,1,16,28819028,29051191,232163
-1,1,16,28819028,29051191,232163
-1,1,16,28819028,29051191,232163
-1,1,16,28819028,29051191,232163
-1,1,16,28819028,29051191,232163
-1,1,16,28819028,29051191,232163
-1,1,16,28819028,29051191,232163
-1,1,16,28819028,29051191,232163
-1,1,16,28820743,29044776,224033
1,1,16,28824794,29043901,219107
-1,1,16,28824794,29043960,219166
-1,1,16,28824794,29043960,219166
-1,1,16,28824794,29044776,219982
-1,1,16,28824794,29044776,219982
-1,1,16,28824794,29044776,219982
-1,1,16,28824794,29044776,219982
-1,1,16,28824794,29044776,219982
-1,1,16,28824794,29044776,219982
1,1,16,28824857,29088624,263767
-1,1,16,28843754,29044850,201096
-1,1,16,28843754,29044850,201096
-1,1,16,28843754,29044850,201096
-1,1,16,28826162,29043901,217739
-1,1,16,28843754,29031071,187317
-1,1,16,28843754,29031071,187317
-1,1,16,28861531,29031059,169528
-1,1,16,28861531,29031059,169528
-1,1,16,28861531,29043960,182429
1,-1,16,29060171,29624872,564701
1,1,16,29060171,30197290,1137119
-1,1,16,29238593,30190568,951975
-1,1,16,29238593,30190568,951975
1,1,16,29238593,30190568,951975
1,1,16,29329436,30190593,861157
1,1,16,29329436,30332569,1003133
-1,1,16,29351826,30191848,840022
1,1,16,29421694,30344958,923264
1,1,16,29432212,30177240,745028
-1,1,16,29432212,30177916,745704
-1,1,16,29432212,30226930,794718
1,1,16,29432212,30332125,899913
-1,1,16,29439269,30197341,758072
1,1,16,29447842,30289652,841810
1,1,16,29447842,30289652,841810
-1,1,16,29478059,30190568,712509
-1,1,16,29478059,30190568,712509
1,1,16,29478060,30332569,854509
1,1,16,29567295,30177240,609945
-1,1,16,29567295,30177240,609945
-1,1,16,29567295,30177807,610512
-1,1,16,29567295,30177807,610512
-1,1,16,29567295,30177916,610621
-1,1,16,29567295,30177916,610621
-1,1,16,29567295,30177916,610621
-1,1,16,29567295,30177916,610621
-1,1,16,29567295,30177916,610621
-1,1,16,29567295,30177916,610621
-1,1,16,29567295,30177916,610621
-1,1,16,29567295,30177916,610621
-1,1,16,29567295,30177916,610621
-1,1,16,29567295,30177916,610621
-1,1,16,29567295,30177916,610621
-1,1,16,29567295,30177916,610621
-1,1,16,29567295,30177916,610621
-1,1,16,29567295,30177916,610621
-1,1,16,29567295,30177916,610621
-1,1,16,29567295,30177916,610621
-1,1,16,29567295,30177916,610621
-1,1,16,29567295,30177916,610621
-1,1,16,29567295,30177916,610621
-1,1,16,29567295,30177916,610621
-1,1,16,29567295,30177916,610621
-1,1,16,29567295,30177999,610704
-1,1,16,29567295,30177999,610704
-1,1,16,29567295,30177999,610704
-1,1,16,29567295,30177999,610704
-1,1,16,29567295,30177999,610704
-1,1,16,29567295,30177999,610704
-1,1,16,29567295,30177999,610704
-1,1,16,29567295,30177999,610704
-1,1,16,29567295,30177999,610704
-1,1,16,29567295,30177999,610704
-1,1,16,29567295,30177999,610704
-1,1,16,29567295,30177999,610704
-1,1,16,29567295,30177999,610704
-1,1,16,29567295,30177999,610704
-1,1,16,29567295,30178406,611111
-1,1,16,29567295,30178406,611111
-1,1,16,29567295,30178406,611111
-1,1,16,29567295,30178406,611111
-1,1,16,29567295,30190029,622734
-1,1,16,29567295,30190029,622734
-1,1,16,29567295,30190029,622734
-1,1,16,29567295,30190029,622734
-1,1,16,29567295,30226930,659635
-1,1,16,29567295,30243606,676311
-1,1,16,29567295,30320307,753012
1,1,16,29567295,30321320,754025
-1,1,16,29567295,30321320,754025
-1,1,16,29567296,30177807,610511
-1,1,16,29567296,30177916,610620
-1,1,16,29567296,30177999,610703
-1,1,16,29567296,30178406,611110
-1,1,16,29580020,30177240,597220
-1,1,16,29580020,30177916,597896
-1,1,16,29580020,30177916,597896
-1,1,16,29580020,30177999,597979
-1,1,16,29580020,30177999,597979
-1,1,16,29580610,30177240,596630
1,1,16,29592751,30190593,597842
-1,1,16,29592751,30190593,597842
-1,1,16,29590554,30190568,600014
-1,1,16,29590554,30197341,606787
-1,1,16,29590554,30197341,606787
-1,1,16,29590554,30197341,606787
-1,1,16,29590554,30197341,606787
-1,1,16,29590554,30197341,606787
-1,1,16,29590554,30197341,606787
-1,1,16,29590554,30197341,606787
-1,1,16,29590554,30197341,606787
-1,1,16,29590554,30197341,606787
-1,1,16,29590554,30197341,606787
-1,1,16,29590554,30197341,606787
-1,1,16,29590554,30197341,606787
-1,1,16,29590554,30197341,606787
-1,1,16,29590554,30332014,741460
1,1,16,29591078,30177916,586838
1,1,16,29591078,30240227,649149
-1,1,16,29592783,30190568,597785
-1,1,16,29592783,30190568,597785
-1,1,16,29592783,30190568,597785
-1,1,16,29592783,30190568,597785
1,1,16,29592783,30190568,597785
1,1,16,29592783,30190568,597785
-1,1,16,29592783,30190568,597785
-1,1,16,29592783,30190568,597785
1,1,16,29592783,30190568,597785
-1,1,16,29592783,30190568,597785
-1,1,16,29592783,30190568,597785
-1,1,16,29592783,30190568,597785
-1,1,16,29592783,30190568,597785
-1,1,16,29592783,30190568,597785
-1,1,16,29592783,30190568,597785
-1,1,16,29592783,30190568,597785
1,1,16,29592783,30197290,604507
-1,1,16,29592783,30332581,739798
-1,1,16,29592783,30332581,739798
-1,1,16,29592783,30332581,739798
1,1,16,29592783,30332581,739798
-1,1,16,29592783,30703233,1110450
-1,1,16,29592791,30190593,597802
-1,1,16,29592791,30190593,597802
-1,1,16,29592791,30190593,597802
1,1,16,29592791,30332569,739778
1,1,16,29620658,30190593,569935
1,1,16,29620658,30190593,569935
-1,1,16,29597822,30177240,579418
1,1,16,29597822,30240227,642405
1,1,16,29609934,30177916,567982
-1,1,16,29620689,30197290,576601
1,1,16,29656657,30190593,533936
-1,1,16,29656657,30190593,533936
-1,1,16,29656657,30190593,533936
1,1,16,29656657,30190593,533936
-1,1,16,29656657,30190593,533936
-1,1,16,29656657,30190593,533936
-1,1,16,29656657,30190593,533936
-1,1,16,29656657,30197466,540809
-1,1,16,29656657,30197466,540809
-1,1,16,29656657,30197466,540809
1,1,16,29656657,30250660,594003
1,-1,16,29624765,29624872,107
1,1,16,29624765,30197290,572525
1,1,16,29626499,30177240,550741
-1,1,16,29646320,30197290,550970
-1,1,16,29646320,30197290,550970
-1,1,16,29646320,30197290,550970
-1,1,16,29646320,30197290,550970
-1,1,16,29646320,30197290,550970
-1,1,16,29646320,30197290,550970
-1,1,16,29646320,30197290,550970
1,1,16,29646320,30197290,550970
1,1,16,29646320,30197290,550970
1,1,16,29646320,30197290,550970
-1,1,16,29646320,30197290,550970
-1,1,16,29646320,30197290,550970
-1,1,16,29646320,30197290,550970
-1,1,16,29646320,30197290,550970
-1,1,16,29646320,30197290,550970
-1,1,16,29656684,30197290,540606
-1,1,16,29656684,30197290,540606
1,1,16,29656684,30197290,540606
1,1,16,29656684,30197290,540606
-1,1,16,29656684,30197341,540657
-1,1,16,29656684,30197341,540657
-1,1,16,29656684,30197341,540657
-1,1,16,29656684,30197341,540657
-1,1,16,29656684,30197341,540657
-1,1,16,29656684,30197341,540657
-1,1,16,29656684,30197341,540657
-1,1,16,29656684,30197341,540657
-1,1,16,29656684,30197341,540657
-1,1,16,29656684,30197341,540657
-1,1,16,29656684,30197341,540657
-1,1,16,29656684,30197341,540657
-1,1,16,29656684,30197341,540657
-1,1,16,29656684,30197341,540657
-1,1,16,29673954,30190509,516555
-1,1,16,29673954,30190568,516614
-1,1,16,29673954,30190568,516614
-1,1,16,29673954,30190568,516614
-1,1,16,29673954,30190568,516614
-1,1,16,29673954,30190568,516614
-1,1,16,29673954,30190568,516614
-1,1,16,29673954,30190568,516614
-1,1,16,29673954,30190568,516614
-1,1,16,29673954,30190568,516614
-1,1,16,29673954,30190568,516614
-1,1,16,29673954,30190568,516614
-1,1,16,29673954,30190568,516614
1,1,16,29673954,30190568,516614
-1,1,16,29673954,30190568,516614
-1,1,16,29673954,30190568,516614
-1,1,16,29673954,30190568,516614
-1,1,16,29673954,30190568,516614
-1,1,16,29673954,30190568,516614
-1,1,16,29673954,30197341,523387
-1,1,16,29673954,30197341,523387
-1,-1,16,29673954,30198600,524646
-1,1,16,29673954,30198600,524646
-1,1,16,29673954,30332581,658627
1,1,16,29673954,30332581,658627
-1,1,16,29673967,30190593,516626
-1,1,16,29673967,30190593,516626
-1,1,16,29673967,30190593,516626
1,1,16,29673967,30332569,658602
-1,-1,16,29725594,29738388,12794
1,1,16,29920934,31450018,1529084
1,-1,16,29974678,29979311,4633
1,1,16,30703233,35147508,4444275
1,-1,16,31891842,34201210,2309368
-1,-1,16,31905717,33298169,1392452
1,-1,16,31955098,32654375,699277
1,-1,16,31955098,33782385,1827287
1,-1,16,31955098,33786268,1831170
1,-1,16,31955098,33798382,1843284
1,-1,16,31955098,33798382,1843284
1,-1,16,31955098,33853445,1898347
1,-1,16,31955098,33948472,1993374
-1,-1,16,31955106,33850611,1895505
1,-1,16,31986098,32746861,760763
1,-1,16,31986098,32786090,799992
1,-1,16,31986098,33780444,1794346
1,-1,16,31986098,33780444,1794346
1,-1,16,31986098,33781281,1795183
1,-1,16,31986098,33781506,1795408
1,-1,16,31986098,33785365,1799267
1,-1,16,31986098,33785365,1799267
1,-1,16,31986098,33785784,1799686
1,-1,16,31986098,33785784,1799686
1,-1,16,31986098,33785784,1799686
1,-1,16,31986098,33785784,1799686
1,-1,16,31986098,33785784,1799686
1,-1,16,31986098,33785784,1799686
1,-1,16,31986098,33786268,1800170
1,-1,16,31986098,33786268,1800170
1,-1,16,31986098,33798382,1812284
1,-1,16,31986098,33798382,1812284
1,-1,16,31986098,33798382,1812284
1,-1,16,31986098,33798382,1812284
1,-1,16,31986098,33798382,1812284
1,-1,16,31986098,33853445,1867347
1,-1,16,31986098,33853445,1867347
1,-1,16,31986098,33853445,1867347
1,-1,16,31986098,33853445,1867347
1,-1,16,31986098,33853445,1867347
1,-1,16,31986098,33853445,1867347
1,-1,16,31986098,33853445,1867347
1,-1,16,31986098,33853445,1867347
1,-1,16,31986098,33853445,1867347
1,-1,16,31986098,33853445,1867347
1,-1,16,31986098,33853445,1867347
1,-1,16,31986098,33853445,1867347
1,-1,16,31986098,33853445,1867347
1,-1,16,31986098,33853445,1867347
1,-1,16,31986098,33853445,1867347
1,-1,16,31986098,33853445,1867347
1,-1,16,31986098,33853445,1867347
1,-1,16,31986098,33853445,1867347
1,-1,16,31986098,33923118,1937020
1,-1,16,31986098,33923118,1937020
1,-1,16,31986098,33923118,1937020
1,-1,16,31986098,33923118,1937020
1,-1,16,31986098,33923118,1937020
1,-1,16,31986098,33923118,1937020
1,-1,16,31986098,33924190,1938092
1,-1,16,31986098,33924190,1938092
1,-1,16,31986098,33948472,1962374
1,-1,16,31955157,34197489,2242332
1,-1,16,31955157,34197489,2242332
1,-1,16,31955157,34197489,2242332
1,-1,16,31955157,34197489,2242332
1,-1,16,31955157,90294753,58339596
1,-1,16,31986098,90294753,58308655
1,-1,16,31986098,90294753,58308655
1,-1,16,31986098,90294753,58308655
1,-1,16,31986098,90294753,58308655
1,-1,16,31986098,90294753,58308655
1,-1,16,31986098,90294753,58308655
-1,-1,16,31986157,32637879,651722
1,-1,16,31994667,32654375,659708
1,-1,16,31994667,32746861,752194
-1,-1,16,31986157,33773134,1786977
1,-1,16,31994667,33785151,1790484
1,-1,16,31994667,33785784,1791117
1,-1,16,31994667,33785784,1791117
1,-1,16,31994667,33785784,1791117
1,-1,16,31994667,33785784,1791117
1,-1,16,31994667,33786268,1791601
1,-1,16,31994667,33786268,1791601
1,-1,16,31994667,33786268,1791601
1,-1,16,31994667,33798382,1803715
1,-1,16,31994667,33798382,1803715
1,-1,16,31994667,33798382,1803715
1,-1,16,31994667,33798382,1803715
1,-1,16,31994667,33798382,1803715
1,-1,16,31994667,33798382,1803715
1,-1,16,31994667,33798382,1803715
1,-1,16,31994667,33798382,1803715
1,-1,16,31994667,33798382,1803715
1,-1,16,31994667,33798382,1803715
1,-1,16,31994667,33827494,1832827
1,-1,16,31994667,33850681,1856014
1,-1,16,31994667,33853445,1858778
1,-1,16,31994667,33853445,1858778
1,-1,16,31994667,33853445,1858778
1,-1,16,31994667,33853445,1858778
1,-1,16,31994667,33853445,1858778
1,-1,16,31994667,33853445,1858778
1,-1,16,31994667,33853445,1858778
1,-1,16,31994667,33853445,1858778
1,-1,16,31994667,33923118,1928451
1,-1,16,31994667,33923118,1928451
1,-1,16,31994667,33923118,1928451
1,-1,16,31994667,33923118,1928451
1,-1,16,31994667,33923118,1928451
1,-1,16,31994667,33923118,1928451
1,-1,16,31994667,33923118,1928451
1,-1,16,31994667,33924190,1929523
1,-1,16,31994667,33924190,1929523
1,-1,16,31994667,33948472,1953805
1,-1,16,31994667,34179903,2185236
1,-1,16,31994667,90294753,58300086
1,-1,16,31994667,90294753,58300086
-1,-1,16,32051494,33654328,1602834
-1,-1,16,32066967,32573867,506900
-1,-1,16,32066967,33465560,1398593
1,-1,16,32066967,33773134,1706167
1,-1,16,32143401,33827494,1684093
1,-1,16,32300741,33773134,1472393
1,-1,16,32440875,33853445,1412570
1,-1,16,32440875,90294753,57853878
1,-1,16,32470624,33798382,1327758
1,-1,16,32470624,33924190,1453566
-1,-1,16,32470625,33773134,1302509
-1,-1,16,32470655,32637879,167224
-1,-1,16,32470655,33298169,827514
1,-1,16,32486838,33853445,1366607
1,-1,16,32486838,34179903,1693065
-1,-1,16,32486849,32654347,167498
1,-1,16,32486849,33785709,1298860
1,-1,16,32491714,33299481,807767
1,-1,16,32491714,33786268,1294554
-1,-1,16,32573813,32833950,260137
1,-1,16,32676790,33780444,1103654
1,-1,16,32573813,33786268,1212455
1,-1,16,32573813,33786268,1212455
1,-1,16,32676790,33798382,1121592
1,-1,16,32676790,33798382,1121592
1,-1,16,32573813,33798382,1224569
1,-1,16,32676790,33853445,1176655
1,-1,16,32676790,33923118,1246328
1,-1,16,32676790,33924190,1247400
1,-1,16,32573813,32746843,173030
1,-1,16,32573813,90294753,57720940
1,-1,16,32573813,90294753,57720940
1,-1,16,32621995,90294753,57672758
-1,-1,16,32651055,33654328,1003273
1,-1,16,32654316,33853445,1199129
1,-1,16,32676790,33798382,1121592
1,-1,16,32722515,33853445,1130930
-1,-1,16,32890035,33465531,575496
1,-1,16,32892940,33781506,888566
1,-1,16,32894346,33781506,887160
1,-1,16,32894346,33781506,887160
1,-1,16,32894346,33781506,887160
1,-1,16,32894346,33781506,887160
1,-1,16,32894888,33780444,885556
1,-1,16,32894888,33780444,885556
1,-1,16,32894888,33780444,885556
1,-1,16,32894888,33780990,886102
1,-1,16,32894888,33781281,886393
1,-1,16,32894888,33781506,886618
1,-1,16,32894888,33781506,886618
1,-1,16,32894888,33781506,886618
1,-1,16,32894888,33781506,886618
1,-1,16,32895593,33779735,884142
1,-1,16,32895593,33780125,884532
1,-1,16,32895807,33779518,883711
1,-1,16,32895807,33780125,884318
1,-1,16,32993227,33779518,786291
1,-1,16,33107015,33620020,513005
-1,-1,16,33380842,33633240,252398
1,-1,16,33373287,33444401,71114
-1,-1,16,33444401,33654328,209927
1,1,16,34197492,64509054,30311562
1,-1,16,34427859,34682448,254589
1,-1,16,34427916,34727365,299449
1,-1,16,34427916,34727365,299449
1,-1,16,34481842,34727492,245650
1,-1,16,34482042,34682448,200406
1,-1,16,34482042,34727349,245307
1,-1,16,34482042,34727349,245307
1,-1,16,34482042,34727349,245307
1,-1,16,34482042,34727349,245307
1,-1,16,34482042,34727349,245307
1,-1,16,34482042,34727349,245307
1,-1,16,34482042,34727349,245307
1,-1,16,34482072,34727321,245249
1,-1,16,34482072,34727365,245293
1,-1,16,34482072,34727365,245293
1,-1,16,34482072,34727365,245293
1,-1,16,34482072,34727365,245293
1,-1,16,34482072,34727365,245293
1,-1,16,34482072,34727365,245293
1,-1,16,34482072,34727365,245293
1,-1,16,34482072,34727365,245293
1,-1,16,34482072,34727365,245293
1,-1,16,34482072,34727365,245293
1,-1,16,34482072,34727365,245293
1,-1,16,34482072,34727365,245293
1,-1,16,34482072,34727365,245293
1,-1,16,34482072,34727365,245293
1,-1,16,34482072,34727365,245293
1,-1,16,34482072,34727365,245293
1,-1,16,34482072,34727365,245293
1,-1,16,34482072,34727365,245293
-1,-1,16,34482072,34727365,245293
1,-1,16,34482072,34727365,245293
1,-1,16,34482072,34727365,245293
1,-1,16,34482072,34727365,245293
1,-1,16,34482072,34727365,245293
1,-1,16,34482072,34727365,245293
1,-1,16,34482072,34727365,245293
1,-1,16,34482072,34727365,245293
-1,-1,16,34482072,34727365,245293
1,-1,16,34482072,34727365,245293
1,-1,16,34482072,34727365,245293
1,-1,16,34482072,34727365,245293
1,-1,16,34482072,34727365,245293
1,-1,16,34482072,34727365,245293
1,-1,16,34482072,34727365,245293
1,-1,16,34482072,34727365,245293
1,-1,16,34482072,34727365,245293
1,-1,16,34482072,34727365,245293
1,-1,16,34482072,34727365,245293
1,-1,16,34482072,34727365,245293
1,-1,16,34482072,34727365,245293
1,-1,16,34482072,34727365,245293
1,-1,16,34482072,34727365,245293
1,-1,16,34482072,34727365,245293
1,-1,16,34482072,34727365,245293
1,-1,16,34482072,34727365,245293
1,-1,16,34482072,34727365,245293
1,-1,16,34482072,34727365,245293
1,-1,16,34482072,34727365,245293
1,-1,16,34482072,34727365,245293
1,-1,16,34482072,34727365,245293
1,-1,16,34482072,34727365,245293
1,-1,16,34482072,34727365,245293
1,-1,16,34482072,34727365,245293
1,-1,16,34482072,34727365,245293
1,-1,16,34482072,34727365,245293
1,-1,16,34482072,34727365,245293
1,-1,16,34482072,34727365,245293
1,-1,16,34482072,34727365,245293
1,-1,16,34482072,34727365,245293
1,-1,16,34482072,34727365,245293
1,-1,16,34482072,34727365,245293
1,-1,16,34482072,34727365,245293
1,-1,16,34482072,34727365,245293
1,-1,16,34482072,34727365,245293
1,-1,16,34482072,34727365,245293
1,-1,16,34482072,34727531,245459
1,-1,16,34517838,34701953,184115
1,-1,16,34539683,34609385,69702
1,-1,16,34625151,34747559,122408
-1,-1,16,35020750,35039170,18420
1,-1,16,35020750,35068935,48185
1,1,16,46464488,90155062,43690574
1,1,16,46500741,52389705,5888964
-1,1,16,46500741,52456082,5955341
-1,1,16,46737110,51838691,5101581
-1,1,16,49604464,53500977,3896513
1,1,16,49719432,68435615,18716183
1,1,16,52933095,90155062,37221967
-1,1,16,55491389,63875526,8384137
-1,1,16,55491389,63875526,8384137
1,1,16,57051473,89797669,32746196
-1,-1,16,60419108,60942833,523725
1,1,16,62959833,84619401,21659568
-1,-1,16,63466967,63573954,106987
1,1,16,64423281,90148393,25725112
1,1,16,65545386,90163403,24618017
1,1,16,65991732,83645048,17653316
-1,1,16,66279791,67506926,1227135
1,1,16,69087360,83308286,14220926
-1,1,16,69590043,75939743,6349700
-1,-1,16,70052164,70193942,141778
1,-1,16,70121905,70196755,74850
1,-1,16,70148761,70196755,47994
1,-1,16,70284178,70285129,951
-1,1,16,70448476,84941726,14493250
1,-1,16,70740804,71120139,379335
1,1,16,70783301,90163403,19380102
-1,-1,16,70860486,71196477,335991
-1,-1,16,70929925,71196477,266552
1,-1,16,72093025,72110913,17888
1,-1,16,72093025,72110913,17888
1,-1,16,72093025,72110913,17888
1,-1,16,72093025,72110913,17888
1,-1,16,72093025,72110913,17888
1,-1,16,72093025,72110913,17888
1,-1,16,72093025,72110913,17888
1,-1,16,72093025,72119382,26357
1,-1,16,72107854,72110913,3059
1,-1,16,72887051,73410660,523609
1,1,16,75411879,90148400,14736521
-1,1,16,75575400,79188037,3612637
1,1,16,76370100,90155062,13784962
1,1,16,76370100,90155062,13784962
-1,1,16,78180603,78208482,27879
-1,1,16,78180603,78208482,27879
-1,-1,16,78658225,78745720,87495
-1,1,16,78824347,83289026,4464679
1,1,16,80101212,90124279,10023067
1,1,16,80751188,90163070,9411882
1,1,16,80980556,90148393,9167837
1,-1,16,81050917,81076406,25489
-1,1,16,83432665,84941726,1509061
-1,1,16,83721255,86106846,2385591
1,-1,16,83986845,84014686,27841
1,-1,16,84097011,84438495,341484
-1,-1,16,84619342,84641841,22499
-1,1,16,85491404,87883528,2392124
1,1,16,85586582,90163403,4576821
1,1,16,85838574,90155062,4316488
1,-1,16,86519903,86536742,16839
1,-1,16,86519903,86536742,16839
1,-1,16,86519903,86542583,22680
-1,1,16,86983712,89402222,2418510
-1,1,16,88116155,89524926,1408771
1,-1,16,88506907,88590613,83706
-1,-1,16,88729110,88785985,56875
1,1,16,89249149,89336307,87158
-1,-1,16,89283689,89603390,319701
-1,1,16,89296939,89420254,123315
-1,1,16,89434509,89490401,55892
-1,1,16,89474299,89525832,51533
-1,1,16,89539973,89570635,30662
1,-1,16,89648650,89660320,11670
1,-1,16,89648650,89689822,41172
1,-1,16,89648650,89701883,53233
1,-1,16,89648650,89701883,53233
1,-1,16,89648650,89701883,53233
1,-1,16,89648650,89701883,53233
1,-1,16,89648650,89701883,53233
1,-1,16,89648650,89701883,53233
1,-1,16,89648650,89701883,53233
1,-1,16,89660320,89689822,29502
1,-1,16,89660320,89689822,29502
1,-1,16,89660320,89689822,29502
1,-1,16,89660320,89689822,29502
1,-1,16,90016428,90030233,13805
1,-1,16,90038122,90049044,10922
-1,-1,16,90086851,90148400,61549
1,-1,16,90103155,90133246,30091
1,-1,16,90111208,90127921,16713
1,-1,16,90111208,90133246,22038
1,-1,16,90123933,90274381,150448
1,1,17,525,1874153,1873628
-1,1,17,525,1968434,1967909
-1,1,17,525,2092064,2091539
-1,1,17,525,2264023,2263498
-1,1,17,525,2363548,2363023
-1,1,17,525,2518160,2517635
-1,1,17,525,2750745,2750220
-1,1,17,525,2891302,2890777
-1,1,17,525,3146162,3145637
-1,1,17,525,3825428,3824903
1,1,17,525,4151421,4150896
-1,1,17,525,5838697,5838172
1,1,17,525,14667519,14666994
1,1,17,525,15027737,15027212
1,1,17,526,81041938,81041412
1,1,17,526,81041938,81041412
1,-1,17,6160,264204,258044
1,1,17,6160,2002365,1996205
-1,1,17,45835,2204282,2158447
1,1,17,45835,2913975,2868140
-1,1,17,45835,6862369,6816534
-1,1,17,45835,7600330,7554495
1,1,17,45835,12247218,12201383
-1,1,17,48858,2940028,2891170
-1,1,17,48858,3379400,3330542
-1,1,17,50690,1824246,1773556
-1,1,17,50690,2588655,2537965
-1,1,17,50690,4168935,4118245
1,1,17,50690,5048327,4997637
1,1,17,50690,7394448,7343758
1,-1,17,96559,161423,64864
1,-1,17,192700,249192,56492
1,-1,17,199921,264204,64283
1,-1,17,199921,264204,64283
1,1,17,396627,726714,330087
1,1,17,396627,783601,386974
-1,1,17,396627,3558393,3161766
-1,1,17,396627,4638828,4242201
1,-1,17,751195,872943,121748
1,-1,17,751195,887645,136450
1,1,17,751195,1544895,793700
-1,1,17,800049,2390454,1590405
1,1,17,874171,2306440,1432269
1,1,17,1017065,1544906,527841
1,1,17,1061434,1515760,454326
1,1,17,1113102,1834395,721293
1,1,17,1113102,6742486,5629384
-1,1,17,1114083,1784979,670896
-1,1,17,1130686,2165287,1034601
1,1,17,1229079,1348455,119376
-1,1,17,1263628,1483869,220241
-1,1,17,1277162,1505103,227941
-1,1,17,1645999,2855558,1209559
-1,-1,17,1703045,1859251,156206
-1,1,17,1751557,5378509,3626952
-1,1,17,1915993,2548152,632159
-1,1,17,1936753,2901448,964695
-1,1,17,1965674,5161635,3195961
-1,1,17,1965674,5161635,3195961
1,1,17,1965723,4045177,2079454
-1,1,17,1997443,2825460,828017
-1,-1,17,2157929,2234362,76433
-1,1,17,2201586,2631484,429898
1,1,17,2318075,2625846,307771
1,1,17,2339561,2588596,249035
-1,1,17,2484513,2670859,186346
-1,1,17,2496180,2512300,16120
1,1,17,2502864,2528223,25359
-1,1,17,2522288,2579941,57653
1,1,17,2826023,3339732,513709
-1,-1,17,3058762,3447162,388400
-1,-1,17,3505485,3558334,52849
-1,-1,17,3505485,3558334,52849
-1,-1,17,3527845,3558334,30489
-1,-1,17,3527845,3558334,30489
-1,-1,17,3540345,3561266,20921
-1,-1,17,3540391,3561146,20755
-1,-1,17,3540391,3561146,20755
-1,-1,17,3543464,3560089,16625
-1,-1,17,3543464,3560089,16625
1,-1,17,5441311,5711877,270566
1,1,17,5636273,11998666,6362393
-1,1,17,6564810,6660724,95914
-1,1,17,7241916,8692213,1450297
-1,1,17,10237826,10803633,565807
-1,1,17,10771948,21510992,10739044
-1,1,17,14111972,15442178,1330206
1,1,17,14111972,15442178,1330206
1,1,17,14083054,15463054,1380000
-1,1,17,14083054,15475087,1392033
1,1,17,14083054,15491532,1408478
1,1,17,14083054,15491533,1408479
1,1,17,14083054,15567669,1484615
-1,1,17,14087787,15473312,1385525
-1,1,17,14087787,15483608,1395821
-1,1,17,14087787,15490100,1402313
1,1,17,14087933,15437330,1349397
1,1,17,14087933,15484358,1396425
-1,1,17,14087933,15484858,1396925
1,1,17,14087933,15484858,1396925
1,1,17,14087933,15484858,1396925
1,1,17,14087933,15484858,1396925
-1,1,17,14087933,15484859,1396926
1,1,17,14087933,15490100,1402167
-1,1,17,14087933,15491532,1403599
1,1,17,14087933,15491532,1403599
1,1,17,14087933,15500645,1412712
1,1,17,14087933,15500645,1412712
1,1,17,14090300,15473590,1383290
-1,1,17,14098660,15500645,1401985
1,1,17,14098660,15501133,1402473
-1,1,17,14100118,15455238,1355120
-1,1,17,14100118,15455238,1355120
1,1,17,14100118,15458649,1358531
1,1,17,14100118,15492400,1392282
1,1,17,14111772,15442066,1330294
1,1,17,14111772,15442066,1330294
-1,1,17,14111772,15442066,1330294
1,1,17,14111772,15442066,1330294
-1,1,17,14111772,15442066,1330294
-1,1,17,14111772,15442066,1330294
1,1,17,14111772,15442066,1330294
-1,1,17,14111772,15442066,1330294
-1,1,17,14111772,15442066,1330294
-1,1,17,14111772,15442066,1330294
1,1,17,14111772,15442066,1330294
1,1,17,14111772,15442066,1330294
-1,1,17,14111772,15442069,1330297
1,1,17,14111772,15442069,1330297
1,1,17,14111772,15442069,1330297
-1,1,17,14111772,15442069,1330297
1,1,17,14111772,15482872,1371100
1,1,17,14111772,15482872,1371100
1,1,17,14111772,15482872,1371100
1,1,17,14111772,15482872,1371100
1,1,17,14111772,15482872,1371100
-1,1,17,14111772,15482872,1371100
-1,1,17,14111772,15491748,1379976
-1,1,17,14131948,15442178,1310230
1,-1,17,14368263,14423007,54744
-1,1,17,14574435,15856310,1281875
-1,1,17,14970116,17375771,2405655
1,1,17,15093600,15856310,762710
1,1,17,15113717,18184130,3070413
1,1,17,15455676,18917513,3461837
-1,1,17,15633207,20413564,4780357
1,-1,17,15633426,15648509,15083
1,-1,17,15633426,15648509,15083
1,-1,17,15633426,15648509,15083
1,-1,17,15633426,15648509,15083
1,-1,17,15633426,15648509,15083
1,-1,17,15633426,15648509,15083
-1,-1,17,15633426,15664206,30780
-1,-1,17,15633426,15664206,30780
-1,-1,17,15633426,15664206,30780
1,-1,17,15637681,15674162,36481
1,-1,17,15637681,15674162,36481
1,-1,17,15638231,15648509,10278
1,-1,17,15638231,15648509,10278
1,-1,17,15638231,15648509,10278
1,-1,17,15638231,15648509,10278
1,-1,17,15638231,15648509,10278
1,-1,17,15638231,15648509,10278
1,-1,17,15638231,15648509,10278
1,-1,17,15638231,15648509,10278
1,-1,17,15638231,15648509,10278
1,-1,17,15638231,15648509,10278
1,-1,17,15638231,15664206,25975
1,-1,17,15638231,15664206,25975
1,-1,17,15648509,15674162,25653
1,-1,17,15648509,15674162,25653
-1,-1,17,15680229,15696860,16631
1,1,17,15713010,20581410,4868400
-1,1,17,15745315,20261191,4515876
-1,1,17,15754173,20552548,4798375
-1,1,17,15763752,20615408,4851656
-1,1,17,15786351,20524013,4737662
-1,1,17,15786351,20561331,4774980
1,1,17,16329947,20901901,4571954
1,-1,17,16527734,16722779,195045
-1,1,17,16559476,20294010,3734534
1,-1,17,16581147,16631051,49904
1,1,17,16581524,20376764,3795240
-1,1,17,16581524,20434651,3853127
-1,1,17,16581524,20464320,3882796
1,1,17,16591260,20473937,3882677
1,1,17,16600022,20396173,3796151
1,1,17,16603008,20433959,3830951
-1,1,17,16603130,20261191,3658061
-1,1,17,16603130,20294038,3690908
-1,1,17,16603130,20331605,3728475
1,1,17,16603130,20395527,3792397
1,1,17,16621729,20449523,3827794
-1,1,17,16637872,20294010,3656138
1,1,17,16637872,20294010,3656138
-1,1,17,16637902,18236686,1598784
-1,1,17,16637902,18738016,2100114
-1,1,17,16637902,20219464,3581562
-1,1,17,16637902,20261250,3623348
-1,1,17,16637902,20294038,3656136
-1,1,17,16637902,20294038,3656136
-1,1,17,16637902,20294038,3656136
-1,1,17,16637902,20294038,3656136
-1,1,17,16651292,18722974,2071682
1,1,17,16651292,20437532,3786240
1,-1,17,16691204,16722779,31575
1,-1,17,16691204,16722779,31575
1,-1,17,16691204,16722779,31575
1,-1,17,16691204,16722779,31575
1,-1,17,16697042,16722779,25737
1,-1,17,16697042,16722779,25737
-1,1,17,16727264,20395889,3668625
-1,1,17,16727264,20413564,3686300
1,1,17,16738161,20338182,3600021
1,1,17,16740141,20261191,3521050
-1,1,17,16741411,20304154,3562743
-1,1,17,16741411,20339728,3598317
-1,1,17,16741411,20408379,3666968
-1,1,17,16741411,20410218,3668807
-1,1,17,16741411,20449523,3708112
-1,1,17,16741411,20489023,3747612
1,1,17,16741771,20430791,3689020
-1,1,17,16745600,20396173,3650573
-1,1,17,16756434,20339795,3583361
1,1,17,16757563,81048189,64290626
-1,1,17,16757564,20261191,3503627
1,1,17,16757564,20395482,3637918
1,1,17,16757564,20395527,3637963
1,1,17,16757564,20463361,3705797
-1,1,17,16761814,20304295,3542481
1,1,17,16761814,20339795,3577981
-1,1,17,16761814,20462650,3700836
-1,1,17,16761814,20462723,3700909
1,1,17,16761814,20474268,3712454
-1,1,17,16772264,20297091,3524827
1,1,17,16772264,20433502,3661238
1,1,17,16777242,20395476,3618234
1,1,17,16782546,20219464,3436918
1,1,17,16782546,20219464,3436918
-1,1,17,16782547,20294010,3511463
-1,1,17,16892401,20274129,3381728
-1,1,17,16922265,20051943,3129678
-1,1,17,16971147,18922732,1951585
-1,1,17,17200426,21900910,4700484
1,1,17,17234825,18921097,1686272
-1,1,17,17234825,19925841,2691016
1,1,17,17262786,18250574,987788
-1,-1,17,17310100,17344539,34439
-1,1,17,17627289,17627351,62
-1,1,17,17691726,18236686,544960
1,1,17,17980441,18424702,444261
1,-1,17,18265938,18284408,18470
1,-1,17,18605287,18858079,252792
1,-1,17,18752653,18925454,172801
-1,1,17,18775930,20219464,1443534
-1,1,17,18775930,20219464,1443534
1,-1,17,18852748,18925454,72706
1,-1,17,18852748,18925454,72706
-1,-1,17,18934579,19051450,116871
-1,1,17,19494823,19563018,68195
-1,-1,17,19504649,19536309,31660
-1,-1,17,19504649,19536309,31660
-1,-1,17,19504649,19536309,31660
-1,-1,17,19504649,19536309,31660
-1,-1,17,19504649,19536309,31660
-1,-1,17,19504649,19536309,31660
-1,-1,17,19504649,19536309,31660
-1,-1,17,19504649,19536309,31660
-1,-1,17,19504649,19536309,31660
-1,-1,17,19504649,19536309,31660
-1,-1,17,19504649,19536309,31660
-1,-1,17,19504649,19536309,31660
-1,-1,17,19504649,19536309,31660
-1,-1,17,19504649,19536309,31660
-1,-1,17,19504649,19536309,31660
-1,-1,17,19504649,19536309,31660
-1,-1,17,19504649,19536309,31660
-1,-1,17,19504649,19536309,31660
-1,-1,17,19504649,19536309,31660
-1,-1,17,19504649,19536309,31660
-1,-1,17,19504649,19536309,31660
-1,-1,17,19504649,19536309,31660
-1,-1,17,19504649,19536309,31660
-1,-1,17,19504649,19536309,31660
-1,-1,17,19504649,19536309,31660
-1,-1,17,19504649,19536309,31660
-1,-1,17,19504649,19536309,31660
-1,-1,17,19504649,19536309,31660
-1,-1,17,19504649,19536309,31660
-1,-1,17,19504649,19536309,31660
-1,-1,17,19504649,19536309,31660
-1,-1,17,19504649,19536309,31660
-1,-1,17,19504649,19536309,31660
-1,-1,17,19504649,19546080,41431
1,-1,17,19947875,19986611,38736
-1,-1,17,20351046,20581470,230424
1,-1,17,21381527,21501929,120402
1,-1,17,21433385,21703526,270141
1,-1,17,21529633,22263006,733373
1,-1,17,21529633,22263006,733373
1,-1,17,21529633,22263006,733373
1,-1,17,21531335,22263006,731671
1,-1,17,21531335,22263006,731671
1,-1,17,21553854,22174114,620260
1,-1,17,21556872,22174114,617242
1,-1,17,21736290,22174114,437824
-1,-1,17,21736290,22174114,437824
1,-1,17,25401773,25658315,256542
1,-1,17,25958205,26093532,135327
1,-1,17,25991972,26061973,70001
1,-1,17,25991972,26061973,70001
1,-1,17,26610151,27231415,621264
-1,1,17,27274843,30817038,3542195
-1,1,17,28952286,30386515,1434229
-1,1,17,28959760,30367155,1407395
-1,1,17,28993036,30386515,1393479
-1,1,17,28993036,30412788,1419752
-1,1,17,28993036,30412788,1419752
-1,1,17,28997791,30386515,1388724
-1,1,17,28997893,30408615,1410722
-1,1,17,29005171,30400885,1395714
-1,1,17,29011937,30348421,1336484
-1,1,17,29033863,30326952,1293089
-1,1,17,29033863,30326952,1293089
-1,1,17,29103348,30298773,1195425
-1,1,17,29131151,30259046,1127895
-1,1,17,29325832,29326647,815
-1,1,17,29428900,30326958,898058
-1,1,17,29519017,29577999,58982
-1,1,17,29533283,29588731,55448
-1,1,17,29578241,32142196,2563955
-1,-1,17,33685101,33754832,69731
-1,-1,17,33685101,33754832,69731
-1,-1,17,33685101,33754832,69731
-1,-1,17,33685101,33754832,69731
-1,-1,17,33687356,33738467,51111
-1,-1,17,33687356,33767930,80574
-1,-1,17,33687356,33767930,80574
-1,-1,17,33687356,33767930,80574
-1,-1,17,33687356,33767930,80574
1,-1,17,34205640,34245061,39421
-1,1,17,34360168,36248859,1888691
-1,-1,17,34419138,34750759,331621
-1,-1,17,34419138,34750759,331621
-1,-1,17,34419138,34750759,331621
-1,-1,17,34419138,34750759,331621
-1,-1,17,34419138,34750759,331621
1,1,17,34425362,36410559,1985197
-1,-1,17,34431826,34766807,334981
-1,-1,17,34437505,34611377,173872
-1,1,17,34447113,36283612,1836499
-1,1,17,34475679,36283612,1807933
1,-1,17,34508117,34611388,103271
-1,-1,17,34508117,34766807,258690
-1,-1,17,34508117,34766807,258690
-1,-1,17,34508117,34766807,258690
-1,-1,17,34508117,34790209,282092
-1,-1,17,34508117,34790209,282092
-1,-1,17,34508117,34817400,309283
-1,-1,17,34508117,34817400,309283
-1,-1,17,34508117,34817400,309283
-1,-1,17,34508117,34817400,309283
-1,-1,17,34508117,34817400,309283
1,1,17,34508117,36248918,1740801
-1,1,17,34508117,36248918,1740801
-1,-1,17,34516300,34817400,301100
1,1,17,34526601,36188734,1662133
1,1,17,34526601,36188734,1662133
-1,-1,17,34539912,34817400,277488
-1,1,17,34604364,36188734,1584370
1,1,17,34604364,36231917,1627553
1,1,17,34611352,36248918,1637566
1,1,17,34611352,36248918,1637566
-1,1,17,34611352,36248918,1637566
1,1,17,34750818,36263019,1512201
-1,1,17,34750818,81048189,46297371
-1,1,17,34817422,36188700,1371278
-1,1,17,34817422,36188700,1371278
-1,1,17,34817422,36188700,1371278
-1,1,17,34817422,36248918,1431496
-1,1,17,34817422,36248918,1431496
-1,1,17,34817422,36248918,1431496
-1,1,17,34817422,36248918,1431496
-1,1,17,34817422,36248918,1431496
-1,1,17,34817422,36248918,1431496
-1,1,17,34817422,36248918,1431496
-1,1,17,34817422,36263019,1445597
-1,1,17,34822465,36244358,1421893
-1,1,17,34822465,36283612,1461147
-1,1,17,34822465,36283807,1461342
-1,1,17,34822465,36283807,1461342
-1,1,17,34822465,36283807,1461342
-1,1,17,34822465,36283807,1461342
-1,1,17,34822465,36283807,1461342
-1,1,17,34822465,36300630,1478165
-1,1,17,34822465,36300630,1478165
-1,1,17,34822465,36307773,1485308
1,1,17,34822465,36307773,1485308
-1,1,17,34822465,36316144,1493679
-1,1,17,34822465,36316161,1493696
1,1,17,34822465,36351919,1529454
-1,1,17,34822465,36397323,1574858
-1,1,17,34822466,36244358,1421892
-1,1,17,34822466,36283612,1461146
-1,1,17,34822466,36283807,1461341
-1,1,17,34822466,36283807,1461341
-1,1,17,34822466,36300466,1478000
-1,1,17,34822466,36307773,1485307
-1,1,17,34822466,36316161,1493695
-1,1,17,34822466,36351934,1529468
-1,1,17,34822466,36393628,1571162
-1,1,17,34822466,36404136,1581670
-1,1,17,34822466,36404136,1581670
-1,1,17,34822467,36307773,1485306
1,-1,17,34849849,34906608,56759
1,-1,17,34849849,34906608,56759
1,-1,17,34849849,34906608,56759
1,-1,17,34849849,34906608,56759
1,1,17,34849849,36151287,1301438
1,-1,17,34856055,34906608,50553
1,-1,17,34856055,34906608,50553
1,-1,17,34856055,34906608,50553
1,1,17,34856055,36248859,1392804
-1,1,17,34856055,36248859,1392804
1,1,17,34856055,36248859,1392804
-1,1,17,34856055,36248859,1392804
-1,1,17,34856055,36248918,1392863
-1,1,17,34856055,36248918,1392863
1,1,17,34856055,36248918,1392863
1,1,17,34856055,36248918,1392863
-1,1,17,34856055,36248918,1392863
1,1,17,34856055,36248918,1392863
1,1,17,34856055,36248918,1392863
1,1,17,34856055,36248918,1392863
-1,1,17,34856305,36248926,1392621
-1,1,17,35076189,36248926,1172737
1,-1,17,37381717,37596822,215105
-1,1,17,41214475,41293060,78585
-1,1,17,42011535,42931393,919858
1,1,17,42580684,81085615,38504931
-1,1,17,43585760,44248995,663235
-1,1,17,43593476,44224221,630745
-1,1,17,43622197,44201470,579273
-1,1,17,43629215,44399455,770240
-1,1,17,43648491,44214888,566397
-1,1,17,43651731,44351152,699421
-1,1,17,43651731,44351152,699421
-1,1,17,43655747,44176717,520970
-1,1,17,43655747,44224221,568474
-1,1,17,43655747,44351152,695405
-1,1,17,43655747,44351152,695405
-1,1,17,43655747,44351152,695405
-1,1,17,43656693,44176717,520024
-1,1,17,43656693,44694311,1037618
-1,1,17,43703800,44212416,508616
-1,1,17,43703801,44187492,483691
-1,1,17,43703801,44212416,508615
-1,1,17,43703801,44212416,508615
-1,1,17,43703801,44212416,508615
1,1,17,43703801,44212416,508615
-1,1,17,43703801,44212416,508615
-1,1,17,43703801,44212824,509023
-1,1,17,43703801,44225820,522019
-1,1,17,43706886,44171947,465061
-1,1,17,43706886,44176717,469831
-1,1,17,43706886,44207977,501091
-1,1,17,43706886,44351152,644266
-1,1,17,43706886,44351152,644266
-1,1,17,43706895,44762543,1055648
1,1,17,43708346,44158662,450316
-1,1,17,43710370,44212416,502046
-1,1,17,43710370,44212416,502046
-1,1,17,43717703,44345038,627335
-1,-1,17,44156473,44462445,305972
-1,-1,17,44156473,44762543,606070
-1,-1,17,44156473,44762543,606070
1,-1,17,44156473,44762543,606070
-1,-1,17,44156473,44762543,606070
1,-1,17,44156473,44762543,606070
-1,-1,17,44156473,44787644,631171
-1,-1,17,44156473,44787644,631171
-1,-1,17,44156473,44787644,631171
-1,-1,17,44156473,44787644,631171
-1,-1,17,44156473,44787644,631171
1,-1,17,44156473,44787644,631171
-1,-1,17,44156473,44787644,631171
-1,-1,17,44156473,44787644,631171
-1,-1,17,44156473,44787644,631171
1,-1,17,44156473,44787644,631171
-1,-1,17,44156473,44787644,631171
-1,-1,17,44156473,44787644,631171
-1,-1,17,44156473,44787644,631171
1,-1,17,44156473,44787644,631171
-1,-1,17,44156473,44787644,631171
-1,-1,17,44156473,44787644,631171
-1,-1,17,44156473,44787644,631171
-1,-1,17,44156473,44787644,631171
1,-1,17,44156473,44787644,631171
1,-1,17,44171917,44325221,153304
1,-1,17,44171917,44368862,196945
1,-1,17,44171917,44368862,196945
1,-1,17,44188471,44268724,80253
-1,-1,17,44223908,44345038,121130
1,-1,17,44223908,44345038,121130
-1,-1,17,44223908,44368862,144954
-1,-1,17,44223908,44485830,261922
1,-1,17,44223908,44485830,261922
-1,-1,17,44223908,44694283,470375
-1,-1,17,44223908,44694283,470375
-1,-1,17,44223908,44694283,470375
-1,-1,17,44223908,44694283,470375
-1,-1,17,44223908,44694283,470375
-1,-1,17,44223908,44694283,470375
-1,-1,17,44223908,44694283,470375
-1,-1,17,44223908,44694283,470375
1,-1,17,44223908,44694283,470375
-1,-1,17,44223908,44694283,470375
-1,-1,17,44223908,44694283,470375
-1,-1,17,44223908,44694283,470375
-1,-1,17,44223908,44694283,470375
-1,-1,17,44223908,44694311,470403
-1,-1,17,44223908,44694311,470403
-1,-1,17,44223908,44694311,470403
-1,-1,17,44223908,44787644,563736
-1,-1,17,44223908,44787644,563736
-1,-1,17,44223908,44787644,563736
-1,-1,17,44223908,44787644,563736
-1,-1,17,44223908,44787644,563736
-1,-1,17,44223908,44787644,563736
-1,-1,17,44223908,44787644,563736
-1,-1,17,44223908,44787644,563736
-1,-1,17,44223908,44787644,563736
-1,-1,17,44223908,44787644,563736
-1,-1,17,44223908,44787644,563736
-1,-1,17,44223908,44787644,563736
-1,-1,17,44223908,44787644,563736
-1,-1,17,44223908,44787644,563736
1,-1,17,44223908,44787644,563736
-1,-1,17,44223908,44787644,563736
-1,-1,17,44223908,44787644,563736
-1,-1,17,44223908,44787644,563736
-1,-1,17,44223908,44787644,563736
-1,-1,17,44223908,44787644,563736
-1,-1,17,44223908,44787644,563736
-1,-1,17,44223908,44787644,563736
-1,-1,17,44223908,44787644,563736
1,-1,17,44223908,44787924,564016
1,-1,17,44223908,44787924,564016
-1,-1,17,44223908,44873614,649706
1,-1,17,44305975,44597336,291361
-1,-1,17,44305975,44694283,388308
-1,-1,17,44305975,44762543,456568
-1,-1,17,44305975,44787644,481669
-1,-1,17,44305975,44787644,481669
-1,-1,17,44305975,44787644,481669
-1,-1,17,44305975,44787644,481669
-1,-1,17,44305975,44787644,481669
-1,-1,17,44305975,44787644,481669
-1,-1,17,44325222,44758916,433694
-1,-1,17,44347533,44787644,440111
1,-1,17,44351093,44628150,277057
-1,-1,17,44351093,44694283,343190
-1,-1,17,44351093,44694283,343190
-1,-1,17,44354705,44762543,407838
-1,-1,17,44354705,44787644,432939
-1,-1,17,44354705,44787644,432939
-1,-1,17,44354705,44787644,432939
-1,-1,17,44354705,44787644,432939
-1,-1,17,44354705,44787644,432939
-1,-1,17,44354705,44787644,432939
-1,-1,17,44354705,44787644,432939
-1,-1,17,44354705,44787644,432939
-1,-1,17,44354705,44787644,432939
-1,-1,17,44354705,44787644,432939
-1,-1,17,44354705,44787644,432939
-1,-1,17,44354705,44787644,432939
-1,-1,17,44354705,44787644,432939
-1,-1,17,44354705,44787644,432939
-1,-1,17,44354705,44787644,432939
-1,-1,17,44375355,44787644,412289
-1,-1,17,44375355,44787644,412289
-1,-1,17,44375355,44787644,412289
-1,-1,17,44375355,44787644,412289
-1,-1,17,44375355,44787644,412289
-1,-1,17,44375355,44787644,412289
-1,-1,17,44375355,44787644,412289
-1,-1,17,44375355,44787644,412289
-1,-1,17,44375355,44787644,412289
-1,-1,17,44375355,44787644,412289
-1,-1,17,44375355,44787644,412289
-1,-1,17,44375355,44787644,412289
-1,-1,17,44375355,44787644,412289
-1,-1,17,44375355,44787644,412289
-1,-1,17,44375355,44787644,412289
-1,-1,17,44375355,44787644,412289
-1,-1,17,44375355,44787644,412289
-1,-1,17,44375355,44787644,412289
-1,-1,17,44375355,44787644,412289
-1,-1,17,44375355,44787644,412289
-1,-1,17,44375355,44787644,412289
-1,-1,17,44375355,44787644,412289
-1,-1,17,44375355,44787644,412289
-1,-1,17,44375355,44787644,412289
1,-1,17,44381698,44762741,381043
-1,-1,17,44399514,44787644,388130
-1,-1,17,44399514,44787644,388130
-1,-1,17,44399514,44787644,388130
-1,-1,17,44399514,44787644,388130
-1,-1,17,44399514,44787644,388130
-1,-1,17,44399514,44787644,388130
-1,-1,17,44424422,44528251,103829
1,-1,17,44485771,44694283,208512
1,-1,17,44485771,44694283,208512
1,-1,17,44485771,44694283,208512
-1,-1,17,44485800,44758915,273115
-1,-1,17,44485800,44758915,273115
-1,-1,17,45481907,45567563,85656
1,-1,17,45599998,45662523,62525
1,-1,17,45599998,45662523,62525
1,-1,17,45599998,45662523,62525
1,-1,17,45599998,45662523,62525
1,-1,17,45599998,45662523,62525
1,-1,17,45599998,45662523,62525
1,-1,17,45599998,45662523,62525
1,-1,17,45599998,45662523,62525
1,-1,17,45599998,45662523,62525
-1,1,17,46064252,47406759,1342507
-1,1,17,47438517,48346801,908284
1,1,17,49076980,58740945,9663965
-1,-1,17,50514419,50751079,236660
1,1,17,52189051,57477162,5288111
1,-1,17,52582241,53041465,459224
-1,1,17,54760866,56162300,1401434
-1,1,17,55496167,57812825,2316658
-1,1,17,56623275,60285107,3661832
1,-1,17,57229181,57624852,395671
1,1,17,57595736,73049225,15453489
-1,1,17,58332553,60315303,1982750
-1,-1,17,62532634,62620233,87599
-1,1,17,62649313,65683004,3033691
1,1,17,64241326,81041938,16800612
-1,1,17,65580340,66636016,1055676
1,-1,17,65990513,66076010,85497
1,-1,17,65990513,66076010,85497
-1,1,17,66416655,69347376,2930721
1,1,17,67002415,81041938,14039523
1,1,17,67912576,81048189,13135613
1,-1,17,68450159,68618075,167916
1,-1,17,70117099,70119330,2231
1,-1,17,70118429,70120373,1944
-1,-1,17,70880685,70939838,59153
1,-1,17,71847857,72586839,738982
1,-1,17,71847857,72648066,800209
1,-1,17,71847837,72606952,759115
1,-1,17,71847837,72606952,759115
1,-1,17,71847837,72606952,759115
1,-1,17,71847837,72606952,759115
1,-1,17,71847837,72647997,800160
1,-1,17,71847837,72647997,800160
1,-1,17,71847857,72607045,759188
1,-1,17,71863765,72648066,784301
1,-1,17,71863765,72648066,784301
1,-1,17,72537226,72541067,3841
1,1,17,73951701,81041938,7090237
1,1,17,73951701,81041938,7090237
-1,1,17,78514452,81041938,2527486
1,1,17,78981996,81048189,2066193
1,-1,17,79119183,79225629,106446
-1,-1,17,79371605,79482530,110925
1,-1,17,79495582,79514678,19096
-1,-1,17,79518741,79601555,82814
1,-1,17,79817155,79829187,12032
-1,-1,17,79817564,79975488,157924
1,-1,17,79829409,79849387,19978
1,-1,17,80869490,81006643,137153
1,-1,17,81006643,81044494,37851
-1,1,18,1,15157836,15157835
-1,1,18,14275,8751794,8737519
-1,1,18,14275,12794384,12780109
-1,1,18,14275,13626665,13612390
-1,1,18,14275,18529906,18515631
-1,1,18,14275,18529906,18515631
1,-1,18,14316,69754,55438
1,-1,18,14316,69754,55438
-1,-1,18,14316,69754,55438
1,-1,18,14316,69754,55438
1,-1,18,14316,69754,55438
1,-1,18,14316,69754,55438
1,-1,18,14316,69754,55438
1,-1,18,14316,69754,55438
1,-1,18,14316,69754,55438
1,-1,18,14316,69754,55438
1,-1,18,14316,69754,55438
1,-1,18,14316,69754,55438
1,1,18,14316,14206224,14191908
-1,1,18,48782,14978075,14929293
-1,1,18,85432,7094699,7009267
-1,1,18,118760,4470508,4351748
-1,1,18,118760,6275717,6156957
-1,1,18,118760,8999130,8880370
1,1,18,118760,14089409,13970649
-1,1,18,118760,14089409,13970649
-1,1,18,118760,14089409,13970649
1,1,18,118760,14089409,13970649
1,1,18,118760,14089409,13970649
-1,1,18,118760,15024002,14905242
1,1,18,118760,78012829,77894069
1,1,18,118760,78012829,77894069
1,1,18,118760,78012829,77894069
1,1,18,118760,78012829,77894069
1,1,18,118760,78012829,77894069
1,1,18,118760,78012829,77894069
1,1,18,118760,78012829,77894069
1,1,18,118760,78012829,77894069
1,1,18,118760,78012829,77894069
1,1,18,118760,78012829,77894069
1,1,18,131500,4421014,4289514
-1,1,18,133157,14089409,13956252
-1,1,18,133157,14089409,13956252
-1,1,18,136226,1742272,1606046
-1,1,18,136226,2994134,2857908
-1,1,18,136226,3297143,3160917
1,1,18,136226,3547887,3411661
-1,1,18,136226,4002983,3866757
-1,1,18,136226,4464955,4328729
-1,1,18,136226,4802274,4666048
-1,1,18,136226,5323941,5187715
1,1,18,136226,9789368,9653142
1,1,18,136226,14337133,14200907
-1,1,18,136226,14983938,14847712
-1,1,18,136226,15157836,15021610
1,1,18,136226,15157836,15021610
-1,1,18,136226,15157836,15021610
1,1,18,136226,15175005,15038779
1,1,18,136226,15198990,15062764
1,1,18,136226,15198990,15062764
1,1,18,136226,15198990,15062764
-1,1,18,136226,15198990,15062764
-1,1,18,136226,15198990,15062764
-1,1,18,136226,15198990,15062764
1,1,18,136226,15198990,15062764
1,1,18,136226,15198990,15062764
-1,1,18,136226,15198990,15062764
1,1,18,136226,18521285,18385059
1,1,18,136226,18534784,18398558
1,1,18,136226,21657790,21521564
1,1,18,136226,78014123,77877897
1,1,18,136226,78014123,77877897
1,1,18,136226,78014123,77877897
1,1,18,136226,78014123,77877897
1,1,18,136226,78014123,77877897
1,1,18,136226,78014123,77877897
1,1,18,136226,78014123,77877897
1,1,18,136227,46171053,46034826
1,1,18,136227,78014123,77877896
1,1,18,136227,78014123,77877896
1,1,18,136227,78014123,77877896
1,1,18,136227,78014123,77877896
1,1,18,136227,78014123,77877896
1,1,18,136227,78014123,77877896
1,1,18,136227,78014123,77877896
1,1,18,136227,78014123,77877896
1,1,18,136227,78014123,77877896
1,1,18,136227,78014123,77877896
1,1,18,136227,78014123,77877896
1,1,18,136227,78014123,77877896
1,1,18,136227,78014123,77877896
1,1,18,136227,78014123,77877896
1,1,18,136227,78014123,77877896
1,1,18,136227,78014123,77877896
1,1,18,136227,78014123,77877896
1,1,18,136227,78014123,77877896
-1,1,18,148963,1949962,1800999
1,1,18,148963,2221286,2072323
-1,1,18,148963,2313457,2164494
-1,1,18,148963,6086667,5937704
-1,1,18,148963,10900515,10751552
-1,1,18,148963,10900515,10751552
-1,1,18,148963,10900515,10751552
-1,1,18,148963,14081887,13932924
-1,1,18,148963,14081887,13932924
1,1,18,148963,14081887,13932924
-1,1,18,148963,14081887,13932924
-1,1,18,148963,14081887,13932924
-1,1,18,148963,14081887,13932924
1,1,18,148963,78010032,77861069
1,1,18,148963,78010032,77861069
1,1,18,148963,78010032,77861069
1,1,18,148963,78010032,77861069
1,1,18,148963,78010032,77861069
1,1,18,148963,78010032,77861069
-1,1,18,149089,1754474,1605385
-1,1,18,149089,5276566,5127477
1,1,18,149089,5458471,5309382
1,1,18,149089,77992274,77843185
1,1,18,149089,78012819,77863730
1,1,18,163323,78005185,77841862
1,1,18,163323,78005185,77841862
1,1,18,163323,78005185,77841862
1,1,18,163323,78005185,77841862
-1,1,18,180229,10762630,10582401
1,-1,18,374344,699626,325282
-1,1,18,958975,11954934,10995959
1,-1,18,1664567,1783663,119096
-1,-1,18,1725225,1828442,103217
-1,-1,18,1725225,1828442,103217
-1,-1,18,1919685,1980787,61102
-1,-1,18,1919685,1980787,61102
-1,-1,18,1919685,1980787,61102
-1,-1,18,1919685,1980787,61102
-1,-1,18,1919685,1980787,61102
-1,-1,18,1919685,1980787,61102
-1,-1,18,1919685,1980787,61102
-1,-1,18,1919685,1980787,61102
-1,-1,18,1919685,1980787,61102
-1,-1,18,1919685,1980787,61102
-1,-1,18,1919685,1980787,61102
-1,-1,18,1919685,1980787,61102
1,-1,18,1919685,1980787,61102
-1,-1,18,1919685,1980787,61102
-1,-1,18,1919685,1980787,61102
-1,-1,18,1919685,1980787,61102
1,1,18,2425506,11904117,9478611
-1,1,18,2666704,5267842,2601138
1,1,18,2737126,9660466,6923340
1,-1,18,2741687,2918018,176331
1,1,18,4465872,15198990,10733118
1,-1,18,8293083,8402122,109039
1,1,18,8779841,22265343,13485502
1,1,18,10077654,14081887,4004233
1,1,18,12159445,12739784,580339
1,1,18,12254327,23262749,11008422
1,1,18,13340111,20989843,7649732
1,-1,18,14076307,15102539,1026232
1,-1,18,14444782,14511925,67143
1,-1,18,14695718,15165151,469433
1,-1,18,14695718,15215782,520064
1,-1,18,14807929,14837135,29206
1,-1,18,14807929,14850046,42117
1,-1,18,14807929,14850046,42117
1,-1,18,14807929,14850046,42117
1,-1,18,14807929,14850046,42117
1,1,18,14869204,78014123,63144919
1,1,18,15380696,78016181,62635485
1,1,18,18521285,37940584,19419299
1,1,18,18521285,64495798,45974513
1,1,18,18529339,31943419,13414080
1,1,18,18542080,72403402,53861322
-1,1,18,20069932,36887326,16817394
-1,1,18,26945022,28816268,1871246
-1,-1,18,28972140,29019935,47795
1,1,18,29703068,78010032,48306964
-1,-1,18,30042619,32043220,2000601
1,1,18,31879854,78014123,46134269
1,1,18,33417216,78014123,44596907
1,-1,18,34378358,34851799,473441
1,1,18,36374692,63300040,26925348
-1,-1,18,37050859,37400276,349417
-1,-1,18,37063132,37251629,188497
1,1,18,37947419,78014123,40066704
-1,1,18,39302787,46570257,7267470
-1,1,18,39915139,44306423,4391284
1,1,18,40231357,78012829,37781472
-1,1,18,41413445,43724104,2310659
1,1,18,42930373,78014123,35083750
1,1,18,43776770,78014123,34237353
1,-1,18,44543250,44559113,15863
1,-1,18,44543250,44560442,17192
1,-1,18,44543250,44560442,17192
1,-1,18,44543250,44560442,17192
1,-1,18,44543250,44560442,17192
1,-1,18,44543250,44560442,17192
1,-1,18,44543250,44560442,17192
1,-1,18,44543250,44560442,17192
1,-1,18,44543250,44569729,26479
1,-1,18,44543250,44569729,26479
1,-1,18,44560400,44561897,1497
-1,1,18,46177798,78014123,31836325
1,1,18,46725781,78012829,31287048
1,-1,18,47015598,47015643,45
1,-1,18,47015598,47015679,81
1,-1,18,47015598,47015679,81
1,-1,18,47015598,47015679,81
1,1,18,47454437,78014123,30559686
-1,1,18,47656799,78014123,30357324
-1,1,18,48693529,78014123,29320594
-1,1,18,48716799,78010032,29293233
-1,1,18,49947422,78012829,28065407
-1,1,18,50739715,63705988,12966273
-1,1,18,51391427,78010032,26618605
1,1,18,51486198,78012819,26526621
-1,1,18,51994667,53616240,1621573
1,-1,18,52008963,52258392,249429
-1,1,18,52524987,58257864,5732877
-1,1,18,52759345,52961970,202625
-1,1,18,52837852,77989426,25151574
-1,1,18,52846595,78012829,25166234
-1,1,18,53100584,78014123,24913539
-1,1,18,53214922,53346803,131881
-1,1,18,54462182,78014123,23551941
-1,1,18,54876647,78016181,23139534
-1,1,18,55793243,68705548,12912305
-1,1,18,57234913,78010032,20775119
-1,1,18,57234913,78010032,20775119
-1,1,18,57664166,78012829,20348663
-1,1,18,58768873,78014123,19245250
-1,1,18,59243242,78010032,18766790
-1,1,18,59280571,78009973,18729402
-1,1,18,59332806,78014123,18681317
-1,1,18,59494344,78010032,18515688
-1,1,18,59809990,78014123,18204133
-1,1,18,59876469,78014123,18137654
-1,1,18,60641553,78014123,17372570
-1,1,18,60796196,78014123,17217927
-1,1,18,60973433,78010032,17036599
-1,1,18,61424150,78012829,16588679
-1,1,18,61513707,64226011,2712304
-1,1,18,61673145,78014123,16340978
-1,1,18,62414964,78012829,15597865
-1,1,18,62492471,78016181,15523710
-1,1,18,63326060,78012829,14686769
-1,1,18,63360824,78010032,14649208
-1,1,18,63857253,78012829,14155576
-1,1,18,64123586,78014123,13890537
-1,1,18,64316464,78012819,13696355
-1,1,18,64524888,78014123,13489235
-1,-1,18,64570466,64669306,98840
1,1,18,65353599,78010032,12656433
-1,1,18,65439813,78010032,12570219
-1,-1,18,65648458,65772355,123897
-1,1,18,65648458,78005185,12356727
-1,1,18,66007239,78014123,12006884
-1,1,18,66084833,78010032,11925199
-1,1,18,66230659,78012829,11782170
-1,1,18,66497471,78012829,11515358
-1,1,18,66525141,78014123,11488982
-1,1,18,66593317,78014123,11420806
-1,1,18,66593317,78014123,11420806
-1,1,18,66625843,78014123,11388280
-1,1,18,66867826,78010032,11142206
-1,1,18,67318038,78012829,10694791
-1,1,18,67431406,78014123,10582717
-1,1,18,68735040,78010032,9274992
-1,-1,18,68956411,69131423,175012
1,1,18,69540119,78012829,8472710
-1,1,18,69711141,78012819,8301678
-1,1,18,70093947,78010032,7916085
-1,1,18,70306575,78012829,7706254
-1,1,18,70340543,78014123,7673580
-1,1,18,71000074,78012829,7012755
1,1,18,71000074,78012829,7012755
1,-1,18,72165066,72343451,178385
-1,1,18,72942828,78016181,5073353
-1,1,18,73136006,77982126,4846120
-1,1,18,73389017,78016181,4627164
-1,1,18,73587460,78009973,4422513
-1,1,18,73658861,78010032,4351171
-1,1,18,73700832,78010032,4309200
1,1,18,74064964,78014123,3949159
1,-1,18,74118672,74251404,132732
1,-1,18,74347427,74439776,92349
-1,1,18,74347427,78010032,3662605
-1,1,18,74975665,78010032,3034367
-1,1,18,74975665,78010032,3034367
-1,1,18,75968374,78016181,2047807
-1,1,18,76553781,78016181,1462400
-1,1,18,76869103,78016181,1147078
-1,1,18,77098565,78014123,915558
-1,1,18,77682576,78010032,327456
-1,1,18,77682576,78010032,327456
-1,1,18,77682576,78010032,327456
1,-1,18,77762403,77844770,82367
1,-1,19,61112,113418,52306
-1,-1,19,61112,113418,52306
1,-1,19,61112,113418,52306
1,-1,19,61112,113418,52306
1,-1,19,61112,113418,52306
1,-1,19,61112,113418,52306
1,-1,19,61112,168688,107576
1,-1,19,61112,168688,107576
1,-1,19,61112,168688,107576
-1,-1,19,61112,186241,125129
1,-1,19,61112,186241,125129
1,-1,19,61112,202952,141840
-1,-1,19,74459,113418,38959
1,-1,19,74459,113418,38959
-1,-1,19,74503,113418,38915
1,-1,19,91171,127601,36430
1,-1,19,91171,127601,36430
1,-1,19,91171,131425,40254
1,-1,19,91171,156185,65014
1,-1,19,91171,168688,77517
1,-1,19,91171,202952,111781
1,-1,19,127601,138477,10876
1,-1,19,127601,156185,28584
1,1,19,259395,2068506,1809111
1,1,19,259395,6795622,6536227
1,1,19,260912,58956888,58695976
1,1,19,260912,58956888,58695976
1,-1,19,260928,307812,46884
1,1,19,275925,1892275,1616350
1,-1,19,277373,291274,13901
1,-1,19,277373,291274,13901
1,-1,19,293260,314516,21256
1,-1,19,405501,425585,20084
1,-1,19,474645,508220,33575
1,-1,19,474645,509267,34622
1,-1,19,548651,571351,22700
1,-1,19,548651,579366,30715
-1,1,19,786550,1297499,510949
-1,1,19,839492,995557,156065
1,-1,19,985898,1002665,16767
1,-1,19,1102683,1144296,41613
1,-1,19,1102683,1144296,41613
1,-1,19,1102683,1161675,58992
1,-1,19,1102683,1161675,58992
1,-1,19,1121303,1161675,40372
1,-1,19,1228274,1282855,54581
1,-1,19,1228274,1282855,54581
1,-1,19,1228274,1282855,54581
1,-1,19,1239074,1282855,43781
-1,1,19,1549143,4288717,2739574
1,-1,19,1911809,1952590,40781
-1,-1,19,1952590,2050814,98224
-1,1,19,3338022,4833151,1495129
-1,1,19,3437994,4039215,601221
1,-1,19,3767254,3771952,4698
1,-1,19,3767254,3771952,4698
1,-1,19,6870116,7103355,233239
1,-1,19,6916239,7103296,187057
1,-1,19,6916239,7103355,187116
1,-1,19,7989408,7990287,879
1,-1,19,8143599,8373452,229853
1,1,19,9678768,14853426,5174658
-1,1,19,9846119,11338677,1492558
1,1,19,10267082,11000364,733282
-1,1,19,10286133,11040457,754324
-1,1,19,10396803,13068208,2671405
-1,1,19,10430150,13888674,3458524
1,1,19,11338618,45129651,33791033
-1,1,19,11635978,14265833,2629855
-1,1,19,12204632,13497073,1292441
-1,1,19,12574343,14726197,2151854
-1,1,19,12691241,14853485,2162244
1,-1,19,13006740,13007077,337
1,-1,19,13006847,13007077,230
-1,1,19,13085208,13519400,434192
-1,1,19,13145480,13394500,249020
-1,1,19,13644739,15481900,1837161
-1,1,19,14124666,16431349,2306683
-1,1,19,14265774,17025123,2759349
-1,1,19,14883158,16788770,1905612
1,1,19,15244405,24376393,9131988
1,-1,19,15803290,15824046,20756
-1,-1,19,17003240,17037020,33780
1,-1,19,18304742,18311144,6402
1,-1,19,20278152,20308753,30601
-1,-1,19,20385317,20484861,99544
-1,-1,19,20630766,20682607,51841
-1,-1,19,20641426,20718976,77550
1,-1,19,20830072,20946600,116528
1,-1,19,20830072,20946600,116528
1,-1,19,20830072,20946600,116528
1,-1,19,20830072,20946600,116528
1,-1,19,20830072,20946600,116528
1,-1,19,20830072,20946600,116528
1,-1,19,20830072,20946600,116528
1,-1,19,20830072,21001149,171077
1,-1,19,21774679,22985475,1210796
1,-1,19,21774679,23013344,1238665
-1,-1,19,22253865,22301793,47928
-1,-1,19,22253865,22301793,47928
1,-1,19,22396734,22444256,47522
-1,-1,19,23624528,24311535,687007
-1,-1,19,23624807,24043127,418320
1,-1,19,28272497,28483449,210952
1,-1,19,28290018,28330525,40507
1,-1,19,28408804,28512197,103393
-1,-1,19,29140834,29531957,391123
-1,1,19,30152765,38605363,8452598
-1,1,19,30162231,38393630,8231399
1,1,19,30735448,36120396,5384948
1,-1,19,31087430,31784588,697158
-1,1,19,31858259,35908000,4049741
1,-1,19,34366153,34688730,322577
1,-1,19,37130813,37342652,211839
1,-1,19,39262641,39281318,18677
1,-1,19,39262641,39281318,18677
1,-1,19,39262641,39281318,18677
1,-1,19,39262641,39281318,18677
1,-1,19,41350886,41381485,30599
-1,-1,19,41448821,41510949,62128
-1,-1,19,41448821,41510949,62128
-1,-1,19,41448821,41510949,62128
-1,-1,19,41450201,41512853,62652
1,-1,19,43200136,43709209,509073
1,-1,19,43200136,43709209,509073
1,-1,19,43200136,43772170,572034
-1,-1,19,43214850,43709209,494359
-1,-1,19,43214850,43709209,494359
1,-1,19,43214850,43746146,531296
-1,-1,19,43214850,43746146,531296
-1,-1,19,43214850,43746146,531296
1,-1,19,43214850,43746146,531296
1,-1,19,43214850,43772170,557320
1,-1,19,43214850,43772170,557320
1,-1,19,43214850,43772170,557320
-1,-1,19,43214850,43772170,557320
-1,-1,19,43214850,43772170,557320
1,-1,19,43214850,43772170,557320
1,-1,19,43214850,43772170,557320
1,-1,19,43214850,43772170,557320
1,-1,19,43214850,43772170,557320
-1,-1,19,43214850,43772170,557320
1,-1,19,43214850,43772170,557320
1,-1,19,43214850,43772170,557320
1,-1,19,43214850,43772170,557320
1,-1,19,43214850,43772170,557320
-1,-1,19,43214850,43772170,557320
1,-1,19,43214850,43772170,557320
1,-1,19,43214850,43772170,557320
1,-1,19,43214850,43772170,557320
1,-1,19,43214850,43772170,557320
1,-1,19,43214850,43772170,557320
1,-1,19,43214850,43772170,557320
-1,-1,19,43214850,43772170,557320
1,-1,19,43214850,43820878,606028
1,-1,19,43214850,43820878,606028
1,-1,19,43214850,43820878,606028
1,-1,19,43214850,43820878,606028
1,-1,19,43242595,43530001,287406
-1,-1,19,43242795,43741310,498515
1,-1,19,43242795,43741310,498515
-1,-1,19,43242811,43529887,287076
-1,-1,19,43242811,43741714,498903
-1,-1,19,43316938,43530666,213728
-1,-1,19,43316938,43530666,213728
-1,-1,19,43316938,43530666,213728
-1,-1,19,43316938,43530666,213728
-1,-1,19,43316938,43530666,213728
-1,-1,19,43316938,43530666,213728
-1,-1,19,43354259,43645608,291349
-1,-1,19,43354259,43645608,291349
-1,-1,19,43354259,43741310,387051
-1,-1,19,43442934,43772170,329236
-1,-1,19,43514125,43746146,232021
-1,-1,19,43514125,43746146,232021
1,-1,19,43529801,43741310,211509
1,-1,19,43529801,43741310,211509
-1,-1,19,43564107,43842435,278328
-1,-1,19,43690000,43757736,67736
-1,-1,19,43691306,43746118,54812
-1,-1,19,43691306,43757736,66430
-1,-1,19,43708962,43757736,48774
-1,-1,19,45351707,45385809,34102
-1,-1,19,45351707,45385809,34102
1,1,19,45474677,48760659,3285982
1,-1,19,46713522,46721782,8260
1,-1,19,46713522,46721782,8260
1,-1,19,48807201,48846153,38952
1,-1,19,49030319,49114045,83726
-1,-1,19,49185469,49206253,20784
1,-1,19,49519850,49558959,39109
1,-1,19,49535281,49540108,4827
1,-1,19,50126530,50250620,124090
1,1,19,50489390,59095359,8605969
1,1,19,50655777,59092570,8436793
1,-1,19,52224551,52328897,104346
1,-1,19,52272356,52627403,355047
1,-1,19,52368797,52616696,247899
1,1,19,52647126,58956888,6309762
-1,-1,19,52798800,52890248,91448
1,1,19,53115685,59092570,5976885
1,-1,19,53328041,53352600,24559
1,1,19,53458309,59092570,5634261
1,-1,19,53606604,53636067,29463
1,-1,19,53606604,53636067,29463
1,1,19,54344821,58956888,4612067
-1,-1,19,54726783,54744331,17548
1,-1,19,54726783,54746032,19249
1,-1,19,54726783,54746032,19249
1,-1,19,54726783,54746032,19249
-1,-1,19,54726783,54746032,19249
-1,-1,19,54726783,54746032,19249
1,-1,19,54726783,54746032,19249
1,-1,19,54726783,54844690,117907
1,-1,19,54726783,54844690,117907
1,-1,19,54769799,54835745,65946
-1,-1,19,55028722,55148430,119708
-1,-1,19,55116560,55164779,48219
1,-1,19,55148430,55176347,27917
-1,-1,19,55148430,55176347,27917
1,-1,19,55587736,55602281,14545
1,-1,19,57966534,57968833,2299
1,-1,19,57988849,58015974,27125
1,-1,19,57988849,58015974,27125
1,-1,19,57988849,58015974,27125
1,-1,19,57988849,58015974,27125
1,-1,19,58336963,58362366,25403
1,-1,19,58336963,58362366,25403
1,-1,19,59060208,59092570,32362
1,-1,19,59060208,59092570,32362
1,-1,20,60734,108266,47532
-1,1,20,60734,1227410,1166676
1,1,20,60734,6366659,6305925
1,-1,20,60747,151608,90861
1,1,20,60747,13010049,12949302
1,1,20,60747,29462103,29401356
-1,1,20,61568,431502,369934
-1,1,20,61568,1513319,1451751
-1,1,20,61568,1823540,1761972
1,1,20,61568,4904599,4843031
1,1,20,61568,4914872,4853304
1,1,20,61568,26305479,26243911
1,1,20,61568,26305479,26243911
1,1,20,61569,18668675,18607106
1,1,20,61569,62915555,62853986
1,1,20,61569,62915555,62853986
1,1,20,65043,6139725,6074682
-1,1,20,70580,344879,274299
-1,1,20,70580,1474759,1404179
-1,1,20,70580,1833123,1762543
1,1,20,70580,29519992,29449412
1,1,20,80198,62908674,62828476
-1,1,20,121521,2073612,1952091
1,-1,20,571151,642377,71226
1,1,20,1249947,8607558,7357611
1,-1,20,1563728,1591178,27450
1,-1,20,1563728,1591178,27450
1,-1,20,1563728,1591178,27450
1,-1,20,1563728,1591178,27450
1,-1,20,1563728,1591178,27450
1,-1,20,1563728,1591178,27450
-1,1,20,2463101,8185680,5722579
-1,1,20,4323680,6892377,2568697
-1,1,20,4392930,12667768,8274838
1,-1,20,5472181,5761701,289520
-1,1,20,6598342,13373206,6774864
-1,1,20,6713937,7303989,590052
1,1,20,7103757,8558193,1454436
-1,-1,20,8196584,8256690,60106
-1,1,20,9121901,16858469,7736568
-1,1,20,9531622,12064082,2532460
-1,-1,20,14700040,14838217,138177
-1,-1,20,14700040,14838217,138177
-1,-1,20,14700040,14884729,184689
-1,-1,20,14700040,14910957,210917
-1,-1,20,14734607,15041530,306923
-1,-1,20,14734411,14838217,103806
-1,-1,20,14734411,14875711,141300
-1,-1,20,14734411,15098434,364023
-1,-1,20,14734411,15154704,420293
-1,-1,20,14756393,14799098,42705
-1,-1,20,14776687,14991571,214884
-1,-1,20,14756520,14817895,61375
-1,-1,20,14756520,14910957,154437
-1,-1,20,14756520,15199338,442818
-1,-1,20,14776880,14928568,151688
-1,-1,20,14991493,15154704,163211
-1,-1,20,15041479,15154704,113225
1,-1,20,16053735,16609376,555641
-1,1,20,17753416,21407427,3654011
-1,1,20,18500917,25847320,7346403
1,-1,20,23805934,23814845,8911
1,-1,20,25435258,25562423,127165
1,-1,20,25466406,25593286,126880
1,-1,20,25466406,25593296,126890
1,-1,20,25466406,25593296,126890
1,-1,20,25466406,25593296,126890
1,-1,20,25745618,26066998,321380
1,-1,20,25745618,26066998,321380
1,-1,20,25755038,26062991,307953
1,-1,20,25755038,26066998,311960
1,-1,20,25755038,26066998,311960
1,-1,20,25755038,26066998,311960
1,-1,20,25755038,26066998,311960
1,-1,20,25755038,26066998,311960
1,-1,20,25755038,26066998,311960
1,-1,20,25755038,26066998,311960
1,-1,20,25755038,26066998,311960
1,-1,20,25755038,26066998,311960
1,-1,20,25755038,26066998,311960
1,1,20,25755100,39058066,13302966
1,-1,20,25773783,26066998,293215
1,-1,20,25773783,26066998,293215
1,-1,20,25776170,26225123,448953
-1,-1,20,26128860,26225123,96263
-1,-1,20,26128860,26225123,96263
-1,-1,20,26154923,26225123,70200
1,-1,20,29446093,29647301,201208
1,-1,20,29446093,29647301,201208
1,-1,20,29446093,29647301,201208
1,-1,20,29446093,29647301,201208
1,-1,20,29446093,29647301,201208
1,-1,20,29446093,29647359,201266
1,-1,20,29486144,29647301,161157
1,-1,20,29614695,29647301,32606
1,-1,20,29614695,29647301,32606
1,-1,20,29614695,29647301,32606
1,-1,20,29614695,29647301,32606
1,-1,20,29614695,29647301,32606
1,-1,20,29614695,29647301,32606
1,-1,20,29614695,29647301,32606
1,-1,20,29614695,29647301,32606
1,1,20,29842786,31163090,1320304
1,1,20,29842786,32060886,2218100
1,1,20,30650571,34494528,3843957
-1,1,20,30824541,46297763,15473222
1,-1,20,31590721,31652979,62258
-1,1,20,32020169,35450284,3430115
1,-1,20,32452247,32528867,76620
1,-1,20,32452247,32528867,76620
-1,1,20,33825749,46260562,12434813
-1,1,20,33873527,34332759,459232
-1,-1,20,36908452,36948558,40106
1,-1,20,41067417,41107347,39930
-1,-1,20,41224904,41312488,87584
1,-1,20,43933602,44003301,69699
-1,-1,20,44350693,44370415,19722
1,-1,20,46494494,47131037,636543
-1,1,20,47627844,52045480,4417636
-1,1,20,49398527,51409386,2010859
-1,1,20,53211427,56765639,3554212
1,1,20,54773088,62908674,8135586
1,1,20,55804471,62904442,7099971
1,-1,20,57425665,57426598,933
1,-1,20,57462934,57465925,2991
1,-1,20,57463534,57464754,1220
1,1,20,57617021,62908674,5291653
1,1,20,59901605,62908679,3007074
1,-1,20,60711779,60772528,60749
1,-1,20,61040925,61121437,80512
1,-1,20,61040925,61131437,90512
-1,1,20,61179280,62915555,1736275
-1,1,20,61211869,62908674,1696805
-1,1,20,61294659,62915555,1620896
-1,1,20,61465730,62298789,833059
-1,1,20,61540307,62965520,1425213
1,-1,20,61595624,61637326,41702
-1,1,20,61785315,62908674,1123359
-1,1,20,61827144,62907467,1080323
-1,1,20,61884113,62915555,1031442
-1,1,20,62090403,62318983,228580
-1,1,20,62090403,62318983,228580
-1,1,20,62654677,62893130,238453
1,-1,20,62731576,62907467,175891
1,-1,20,62762136,62908674,146538
1,-1,21,9734796,10205155,470359
1,-1,21,9734796,10944001,1209205
1,-1,21,9734796,10944001,1209205
1,-1,21,9734796,10944001,1209205
1,1,21,10697897,48090972,37393075
-1,-1,21,10864216,11033703,169487
-1,-1,21,10898991,11047451,148460
-1,-1,21,10915083,11176283,261200
1,1,21,10944001,48090972,37146971
1,-1,21,10991392,11096086,104694
1,-1,21,10991392,11096086,104694
1,-1,21,10991392,14417582,3426190
-1,-1,21,11132929,11176283,43354
1,1,21,14386013,48097372,33711359
1,1,21,14577835,48069743,33491908
1,1,21,14577835,48118159,33540324
1,1,21,14577894,48090258,33512364
1,1,21,14771770,48080867,33309097
-1,1,21,15006457,19583516,4577059
-1,1,21,15006457,29225300,14218843
1,1,21,15006457,43598570,28592113
1,1,21,15006457,44827632,29821175
1,1,21,15006457,48097372,33090915
1,1,21,15006457,48097372,33090915
1,1,21,15006457,48097372,33090915
1,1,21,15006457,48097372,33090915
1,1,21,15006457,48097372,33090915
1,1,21,15006457,48097372,33090915
1,1,21,15006457,48097372,33090915
1,1,21,15006457,48097372,33090915
1,1,21,15006457,48097372,33090915
1,1,21,15006457,48097372,33090915
1,1,21,15006457,48097372,33090915
1,1,21,15006457,48097372,33090915
1,1,21,15006457,48097372,33090915
1,1,21,15006457,48097372,33090915
1,1,21,15006457,48097372,33090915
1,1,21,15006457,48097372,33090915
1,1,21,15006457,48097372,33090915
1,1,21,15006457,48097372,33090915
1,1,21,15006457,48097372,33090915
1,1,21,15006457,48097372,33090915
1,1,21,15006457,48097372,33090915
1,1,21,15006457,48097372,33090915
1,1,21,15006457,48097372,33090915
1,1,21,15006457,48097372,33090915
1,1,21,15006457,48097372,33090915
1,1,21,15006457,48097372,33090915
1,1,21,15006457,48097372,33090915
1,1,21,15006457,48097372,33090915
1,1,21,15006457,48097372,33090915
1,1,21,15006457,48097372,33090915
1,1,21,15006457,48097372,33090915
1,1,21,15006457,48097372,33090915
1,1,21,15006457,48097372,33090915
1,1,21,15006457,48097372,33090915
1,1,21,15006457,48097372,33090915
1,1,21,15006457,48097372,33090915
1,1,21,15006457,48097372,33090915
1,1,21,15006457,48097372,33090915
1,1,21,15006457,48097372,33090915
1,1,21,15006457,48097372,33090915
1,1,21,15006457,48097372,33090915
1,1,21,15006457,48097372,33090915
1,1,21,15006457,48097372,33090915
1,1,21,15006457,48097372,33090915
1,1,21,15006457,48097372,33090915
1,1,21,15006457,48097372,33090915
1,1,21,15006457,48097372,33090915
1,1,21,15006457,48097372,33090915
-1,1,21,15006458,29235160,14228702
1,1,21,15006458,48097372,33090914
1,1,21,15006458,48097372,33090914
1,1,21,15006458,48097372,33090914
1,1,21,15006458,48097372,33090914
1,1,21,15006458,48097372,33090914
1,1,21,15006458,48097372,33090914
1,1,21,15006458,48097372,33090914
1,1,21,15006458,48097372,33090914
1,1,21,15006458,48097372,33090914
1,1,21,15006458,48097372,33090914
1,1,21,15006458,48097372,33090914
1,1,21,15006458,48097372,33090914
1,1,21,15006458,48097372,33090914
1,1,21,15006458,48097372,33090914
1,1,21,15006458,48097372,33090914
1,1,21,15006458,48097372,33090914
1,1,21,15006458,48097372,33090914
1,1,21,15006458,48097372,33090914
1,1,21,15006458,48097372,33090914
1,1,21,15006458,48097372,33090914
1,1,21,15006458,48097372,33090914
1,1,21,15006458,48097372,33090914
1,1,21,15006458,48097372,33090914
1,1,21,15006458,48097372,33090914
1,1,21,15006458,48097372,33090914
1,1,21,15006458,48097372,33090914
1,1,21,15006458,48097372,33090914
1,1,21,15006458,48097372,33090914
1,1,21,15006458,48097372,33090914
1,1,21,15006458,48097372,33090914
1,1,21,15006458,48097372,33090914
1,1,21,15006458,48097372,33090914
1,1,21,15006458,48097372,33090914
1,1,21,15006458,48097372,33090914
1,1,21,15006458,48097372,33090914
1,1,21,15006458,48097372,33090914
1,1,21,15006458,48097372,33090914
1,1,21,15006458,48097372,33090914
1,1,21,15006458,48097372,33090914
1,1,21,15006458,48097372,33090914
1,1,21,15006458,48097372,33090914
1,1,21,15006458,48097372,33090914
1,1,21,15006458,48097372,33090914
1,1,21,15006458,48097372,33090914
1,1,21,15006458,48097372,33090914
1,1,21,15006458,48097372,33090914
1,1,21,15006458,48097372,33090914
1,1,21,15006458,48097372,33090914
1,1,21,15006458,48097372,33090914
1,1,21,15006458,48097372,33090914
1,1,21,15006458,48097372,33090914
1,1,21,15006458,48097372,33090914
1,1,21,15006458,48097372,33090914
1,1,21,15006458,48097372,33090914
1,1,21,15006458,48097372,33090914
1,1,21,15006458,48097372,33090914
1,1,21,15006458,48097372,33090914
1,1,21,15006458,48097372,33090914
1,1,21,15006458,48097372,33090914
1,1,21,15006458,48097372,33090914
1,1,21,15006458,48097372,33090914
1,1,21,15006458,48097372,33090914
1,1,21,15006458,48097372,33090914
1,1,21,15006458,48097372,33090914
1,1,21,15006458,48097372,33090914
1,1,21,15006458,48097372,33090914
1,1,21,15006458,48097372,33090914
1,1,21,15006458,48097372,33090914
1,1,21,15006458,48097372,33090914
1,1,21,15006458,48097372,33090914
1,1,21,15006458,48097372,33090914
1,1,21,15006458,48097372,33090914
1,1,21,15006458,48097372,33090914
1,1,21,15006458,48097372,33090914
1,1,21,15006458,48097372,33090914
1,1,21,15285841,48097372,32811531
1,1,21,15442582,20723130,5280548
-1,1,21,15451032,39025955,23574923
1,1,21,15451032,48090972,32639940
1,1,21,15451032,48090972,32639940
1,1,21,15451032,48090972,32639940
1,1,21,15451032,48090972,32639940
1,1,21,15451032,48090972,32639940
1,1,21,15451032,48090972,32639940
1,1,21,15451032,48090972,32639940
1,1,21,15451032,48090972,32639940
1,1,21,15451032,48090972,32639940
1,1,21,15451032,48090972,32639940
1,1,21,15451032,48090972,32639940
1,1,21,15451032,48090972,32639940
1,1,21,15451032,48090972,32639940
1,1,21,15451032,48090972,32639940
1,1,21,15451032,48090972,32639940
1,1,21,15451032,48090972,32639940
1,1,21,15451032,48090972,32639940
1,1,21,15451032,48090972,32639940
1,1,21,15451032,48090972,32639940
1,1,21,15451032,48090972,32639940
1,1,21,15451032,48090972,32639940
1,1,21,15451032,48090972,32639940
1,1,21,15451032,48090972,32639940
1,1,21,15451032,48090972,32639940
1,1,21,15451032,48090972,32639940
1,1,21,15451032,48090972,32639940
1,1,21,15451032,48090972,32639940
1,1,21,15451032,48090972,32639940
1,1,21,15451032,48090972,32639940
1,1,21,15451032,48090972,32639940
1,1,21,15451032,48090972,32639940
-1,1,21,15485038,22669593,7184555
1,1,21,15485038,48072996,32587958
1,1,21,15485038,48072996,32587958
1,1,21,15485038,48072996,32587958
1,1,21,15485038,48084162,32599124
1,1,21,15485038,48090352,32605314
1,1,21,15485038,48090352,32605314
1,1,21,15485038,48090352,32605314
1,1,21,15485038,48090352,32605314
1,1,21,15485038,48090352,32605314
-1,1,21,15485038,48090352,32605314
1,1,21,15485038,48090352,32605314
1,1,21,15485038,48090352,32605314
1,1,21,15485038,48090352,32605314
1,1,21,15485038,48090352,32605314
1,1,21,15485038,48090352,32605314
1,1,21,15499847,44391157,28891310
1,1,21,15499847,44391157,28891310
1,1,21,15499847,48080911,32581064
1,1,21,15499847,48090317,32590470
1,1,21,15499847,48090317,32590470
1,1,21,15499847,48090317,32590470
1,1,21,15499847,48090317,32590470
1,1,21,15499847,48090317,32590470
1,1,21,15499847,48090317,32590470
1,1,21,15499847,48090317,32590470
1,1,21,15499847,48090317,32590470
1,1,21,15499847,48090317,32590470
1,1,21,15499847,48090317,32590470
1,1,21,15499847,48090317,32590470
1,1,21,15499847,48090317,32590470
1,1,21,15499847,48090317,32590470
1,1,21,15499847,48090317,32590470
1,1,21,15499847,48090317,32590470
1,1,21,15499847,48090317,32590470
1,1,21,15499847,48090317,32590470
1,1,21,15499847,48090317,32590470
1,1,21,15499847,48090317,32590470
1,1,21,15499847,48090317,32590470
1,1,21,15499847,48090317,32590470
1,1,21,15499847,48090317,32590470
1,1,21,15499847,48090317,32590470
1,1,21,15499847,48090317,32590470
1,1,21,15499847,48090317,32590470
1,1,21,15499847,48090317,32590470
1,1,21,15513244,48090352,32577108
1,1,21,15530370,48119895,32589525
1,1,21,15530429,48119895,32589466
-1,1,21,16714035,24198636,7484601
1,-1,21,19412023,19602127,190104
-1,1,21,20795486,33213462,12417976
-1,-1,21,23727134,23833530,106396
-1,-1,21,23727134,23991316,264182
-1,-1,21,23782183,23927167,144984
-1,-1,21,24526599,24622562,95963
-1,-1,21,24526599,24622562,95963
-1,-1,21,24526599,24622562,95963
-1,1,21,25303376,25851449,548073
1,1,21,29812033,39282854,9470821
-1,1,21,29880468,36062331,6181863
1,-1,21,33037771,33038082,311
1,1,21,34111831,48090258,13978427
1,1,21,34997018,36118212,1121194
1,1,21,35319225,48090972,12771747
1,1,21,35319225,48090972,12771747
-1,1,21,36162250,48056450,11894200
-1,1,21,36916169,41365265,4449096
-1,1,21,37144475,39930433,2785958
-1,1,21,37144475,39930433,2785958
1,1,21,37439289,48090972,10651683
1,-1,21,37498151,37600266,102115
1,-1,21,37498151,37600266,102115
1,-1,21,37507345,37578365,71020
1,1,21,37578365,48090317,10511952
1,1,21,37891471,48090317,10198846
-1,1,21,37914123,48097372,10183249
-1,1,21,38176362,41901945,3725583
-1,1,21,38699545,48097372,9397827
-1,1,21,38790552,43619940,4829388
-1,1,21,39041930,48090972,9049042
-1,1,21,40188323,48097372,7909049
-1,1,21,40747863,45666031,4918168
-1,1,21,41254101,48097372,6843271
-1,1,21,41628166,48119895,6491729
-1,1,21,41667952,48090352,6422400
-1,1,21,42410406,48097372,5686966
-1,1,21,43153800,48090972,4937172
-1,1,21,43268694,48097372,4828678
1,1,21,43407305,48119895,4712590
-1,1,21,43498966,48097372,4598406
-1,1,21,43549809,48090972,4541163
-1,1,21,43598607,48097372,4498765
-1,1,21,44333323,48090317,3756994
-1,1,21,44333323,48090317,3756994
-1,1,21,44491278,48090317,3599039
-1,1,21,44491278,48090317,3599039
1,-1,21,44592471,44662664,70193
-1,1,21,44828064,48097372,3269308
-1,1,21,45265857,47057233,1791376
-1,1,21,45773272,48097372,2324100
-1,1,21,45814926,48090317,2275391
-1,1,21,46798076,48090960,1292884
1,-1,21,47987100,48022981,35881
-1,1,22,44166,11675280,11631114
1,-1,22,16054691,17450189,1395498
1,1,22,16054691,18661724,2607033
1,1,22,16054691,51220902,35166211
1,1,22,16054691,51220902,35166211
1,1,22,16054691,51237463,35182772
1,-1,22,16087694,16417038,329344
-1,-1,22,16087694,16431732,344038
-1,-1,22,16087694,16431732,344038
-1,-1,22,16087694,16431732,344038
-1,-1,22,16087694,16431732,344038
-1,-1,22,16087694,16431732,344038
-1,-1,22,16087694,16431732,344038
-1,-1,22,16087694,16431732,344038
-1,-1,22,16087694,16431732,344038
-1,-1,22,16087694,16431732,344038
-1,-1,22,16087694,16431732,344038
-1,-1,22,16087694,16431732,344038
-1,-1,22,16087694,16431732,344038
-1,-1,22,16087694,16431732,344038
-1,-1,22,16087694,16431732,344038
-1,-1,22,16087694,16431732,344038
-1,-1,22,16087694,16431732,344038
-1,-1,22,16087694,16431732,344038
-1,-1,22,16087694,16431732,344038
1,-1,22,16087694,16849852,762158
1,1,22,16087694,18641706,2554012
1,1,22,16087694,19010508,2922814
1,1,22,16087694,20311784,4224090
1,1,22,16087694,20311784,4224090
1,1,22,16087694,20311784,4224090
1,1,22,16087694,20311784,4224090
1,-1,22,16431732,17267283,835551
1,1,22,16466033,18890162,2424129
1,1,22,16888899,18644773,1755874
1,1,22,16888899,18648856,1759957
1,1,22,16888899,18649190,1760291
1,1,22,16888899,18916828,2027929
1,1,22,16888899,18916828,2027929
-1,1,22,16888899,20000830,3111931
1,1,22,16888899,20311858,3422959
1,1,22,16888899,20311858,3422959
-1,1,22,16888899,20716903,3828004
1,1,22,16888899,23723805,6834906
1,1,22,16888900,18640300,1751400
-1,1,22,16888900,20026751,3137851
1,1,22,16888900,51197838,34308938
1,1,22,16888900,51197838,34308938
-1,1,22,17177911,19892632,2714721
1,-1,22,17267393,17290275,22882
1,-1,22,17267393,17290275,22882
1,-1,22,17267393,17290275,22882
1,-1,22,17267393,17290275,22882
1,-1,22,17267393,17290275,22882
1,1,22,17397498,18661773,1264275
1,1,22,17397498,18661773,1264275
1,1,22,17397498,18661773,1264275
1,1,22,17397498,18984519,1587021
1,1,22,17397498,20659606,3262108
1,1,22,17397498,20659606,3262108
1,1,22,17397498,20708934,3311436
-1,1,22,17397498,20708934,3311436
1,1,22,17397498,51178264,33780766
1,1,22,17397498,51178264,33780766
1,1,22,17397498,51178264,33780766
1,1,22,17397633,18628206,1230573
1,1,22,17397633,18661758,1264125
1,1,22,17397633,18706059,1308426
1,1,22,17397633,19584890,2187257
1,1,22,17397633,51178213,33780580
1,-1,22,17541672,17550637,8965
1,1,22,18570312,19184416,614104
-1,-1,22,18628073,18848020,219947
-1,-1,22,18628073,19010531,382458
1,-1,22,18609960,18651614,41654
-1,1,22,18628019,21464119,2836100
-1,1,22,18628019,21505417,2877398
-1,1,22,18628019,21505417,2877398
-1,1,22,18628019,21505417,2877398
-1,-1,22,18641420,18848020,206600
-1,-1,22,18641420,18848020,206600
-1,-1,22,18641420,18848020,206600
-1,-1,22,18641420,18848020,206600
-1,-1,22,18641420,18848020,206600
-1,1,22,18628132,21561468,2933336
-1,1,22,18628132,21561468,2933336
-1,1,22,18628132,21561468,2933336
-1,1,22,18628132,21561468,2933336
-1,1,22,18628132,21561468,2933336
-1,1,22,18628132,21561468,2933336
1,1,22,18628132,21712996,3084864
-1,1,22,18628132,21883879,3255747
1,1,22,18628132,21900562,3272430
1,1,22,18628132,51203353,32575221
-1,1,22,18628147,21440515,2812368
1,1,22,18631979,21465659,2833680
1,1,22,18636748,21465659,2828911
1,1,22,18640729,21465659,2824930
1,1,22,18640729,21465659,2824930
-1,-1,22,18661699,18953074,291375
-1,-1,22,18661699,19010531,348832
-1,1,22,18641479,21712996,3071517
-1,1,22,18641479,21722262,3080783
1,1,22,18641479,21917191,3275712
-1,1,22,18644241,21465662,2821421
1,1,22,18644772,21041014,2396242
-1,1,22,18644790,21465659,2820869
-1,1,22,18644790,21465659,2820869
1,1,22,18644790,21465659,2820869
1,1,22,18644790,21465659,2820869
-1,1,22,18644790,21465659,2820869
1,1,22,18644790,21465659,2820869
1,1,22,18644790,21465659,2820869
-1,1,22,18644790,21465659,2820869
-1,1,22,18644790,21465659,2820869
-1,1,22,18644790,21465659,2820869
1,1,22,18644790,21465659,2820869
-1,1,22,18644790,21465659,2820869
-1,1,22,18644790,21798907,3154117
-1,1,22,18644790,21798907,3154117
-1,1,22,18644790,21798907,3154117
-1,1,22,18644790,21798907,3154117
-1,1,22,18644790,21798907,3154117
-1,1,22,18644790,21798907,3154117
-1,1,22,18644790,21798907,3154117
-1,1,22,18644790,21800471,3155681
-1,1,22,18644790,21915509,3270719
-1,1,22,18645353,21465662,2820309
-1,1,22,18648856,21465662,2816806
1,1,22,18648866,21465659,2816793
-1,1,22,18648866,21465659,2816793
1,1,22,18648866,21465659,2816793
-1,1,22,18648866,21465662,2816796
-1,1,22,18648866,21798907,3150041
-1,1,22,18648866,21800797,3151931
1,1,22,18650664,21440455,2789791
-1,1,22,18650664,21440455,2789791
-1,1,22,18650664,21440455,2789791
-1,1,22,18650664,21440455,2789791
1,1,22,18650664,21440455,2789791
1,1,22,18651614,21440455,2788841
1,1,22,18661699,21505445,2843746
-1,1,22,18661699,21505445,2843746
1,1,22,18661699,22905025,4243326
-1,1,22,18661724,20659606,1997882
-1,1,22,18661724,21440514,2778790
-1,1,22,18661724,21440514,2778790
-1,1,22,18661724,21440514,2778790
-1,1,22,18661724,21440514,2778790
1,1,22,18661724,21440514,2778790
1,1,22,18661724,21461752,2800028
-1,1,22,18661724,21461811,2800087
-1,1,22,18661724,21464119,2802395
-1,1,22,18661724,21464119,2802395
-1,1,22,18661724,21464119,2802395
-1,1,22,18661724,21464119,2802395
-1,1,22,18661724,21505417,2843693
-1,1,22,18661724,21505417,2843693
-1,1,22,18661724,21505417,2843693
-1,1,22,18661724,21505417,2843693
-1,1,22,18661724,21505417,2843693
-1,1,22,18661724,21505417,2843693
-1,1,22,18661724,21505417,2843693
1,1,22,18661724,21505417,2843693
-1,1,22,18661724,21505417,2843693
-1,1,22,18661724,21505417,2843693
-1,1,22,18661724,21561514,2899790
-1,1,22,18661724,21561514,2899790
-1,1,22,18661724,21561514,2899790
1,1,22,18661724,21661435,2999711
-1,1,22,18661724,21809009,3147285
-1,-1,22,18661748,18813961,152213
-1,-1,22,18661748,18813961,152213
-1,1,22,18706001,20311763,1605762
-1,1,22,18706001,20659606,1953605
-1,1,22,18706001,20659606,1953605
-1,1,22,18706001,20659606,1953605
-1,1,22,18706001,21025713,2319712
-1,1,22,18706001,21025713,2319712
-1,1,22,18706001,21440514,2734513
-1,1,22,18706001,21440514,2734513
-1,1,22,18706001,21440514,2734513
-1,1,22,18706001,21440514,2734513
-1,1,22,18706001,21464119,2758118
-1,1,22,18706001,21464119,2758118
-1,1,22,18706001,21464119,2758118
-1,1,22,18706001,21464119,2758118
-1,1,22,18706001,21464119,2758118
-1,1,22,18706001,21464119,2758118
-1,1,22,18706001,21464119,2758118
-1,1,22,18706001,21464119,2758118
-1,1,22,18706001,21464119,2758118
-1,1,22,18706001,21464119,2758118
-1,1,22,18706001,21464119,2758118
-1,1,22,18706001,21464119,2758118
-1,1,22,18706001,21464119,2758118
-1,1,22,18706001,21505417,2799416
-1,1,22,18706001,21505417,2799416
-1,1,22,18706001,21505417,2799416
-1,1,22,18706001,21505417,2799416
-1,1,22,18706001,21505417,2799416
-1,1,22,18706001,21505417,2799416
-1,1,22,18706001,21505417,2799416
-1,1,22,18706001,21505417,2799416
-1,1,22,18706001,21505417,2799416
-1,1,22,18706001,21505417,2799416
-1,1,22,18706001,21505417,2799416
-1,1,22,18706001,21505417,2799416
-1,1,22,18706001,21505417,2799416
-1,1,22,18706001,21505417,2799416
-1,1,22,18706001,21505417,2799416
-1,1,22,18706001,21505417,2799416
-1,1,22,18706001,21505417,2799416
-1,1,22,18706001,21505417,2799416
-1,1,22,18706001,21505417,2799416
-1,1,22,18706001,21505417,2799416
-1,1,22,18706001,21505417,2799416
-1,1,22,18706001,21505417,2799416
-1,1,22,18706001,21505417,2799416
-1,1,22,18706001,21505417,2799416
-1,1,22,18706001,21505417,2799416
-1,1,22,18706001,21505417,2799416
-1,1,22,18706001,21505417,2799416
1,1,22,18713491,20412989,1699498
1,1,22,18713491,21712996,2999505
1,1,22,18713491,21917191,3203700
-1,1,22,18765085,21661435,2896350
-1,1,22,18787999,21065894,2277895
-1,1,22,18787999,21468378,2680379
-1,1,22,18787999,21684798,2896799
-1,1,22,18848020,21468378,2620358
-1,1,22,18848020,21468378,2620358
1,1,22,18848020,21468378,2620358
-1,1,22,18876630,21465659,2589029
-1,1,22,18890042,21440455,2550413
-1,1,22,18890162,21464056,2573894
-1,1,22,18890162,21464056,2573894
-1,1,22,18890221,21561468,2671247
-1,1,22,18890221,21561468,2671247
-1,1,22,18890221,21561468,2671247
-1,1,22,18891526,21796215,2904689
1,-1,22,18894339,19010683,116344
1,-1,22,18894339,19010683,116344
-1,1,22,18894339,20255110,1360771
-1,1,22,18894339,21440455,2546116
-1,1,22,18894339,21440455,2546116
1,1,22,18894339,21440455,2546116
-1,1,22,18894339,21440455,2546116
-1,1,22,18894339,21440455,2546116
-1,1,22,18894339,21440455,2546116
-1,1,22,18894339,21440455,2546116
-1,1,22,18894339,21440455,2546116
-1,1,22,18894820,21440515,2545695
-1,1,22,18894820,21440515,2545695
-1,1,22,18894820,21440515,2545695
-1,1,22,18894820,21440515,2545695
1,1,22,18894820,21440515,2545695
-1,1,22,18894820,21440515,2545695
-1,1,22,18894820,21440515,2545695
-1,1,22,18894820,21440515,2545695
-1,1,22,18894820,21440515,2545695
-1,1,22,18894820,21440515,2545695
-1,1,22,18894820,21440515,2545695
1,1,22,18894820,21440515,2545695
-1,1,22,18894820,21440515,2545695
-1,1,22,18894820,21440515,2545695
1,1,22,18894820,21505445,2610625
-1,1,22,18894835,20238206,1343371
1,1,22,18894835,20311784,1416949
-1,1,22,18894835,20659606,1764771
-1,1,22,18894835,20659606,1764771
-1,1,22,18894835,20659606,1764771
-1,1,22,18894835,20659606,1764771
-1,1,22,18894835,20659606,1764771
-1,1,22,18894835,21461752,2566917
1,1,22,18894835,21461752,2566917
1,1,22,18894835,21461752,2566917
-1,1,22,18894835,21461752,2566917
-1,1,22,18894835,21461752,2566917
-1,1,22,18894835,21461752,2566917
-1,1,22,18894835,21461752,2566917
-1,1,22,18894835,21461811,2566976
-1,1,22,18894835,21464119,2569284
-1,1,22,18894835,21505417,2610582
1,1,22,18894835,21505417,2610582
-1,1,22,18894835,21505417,2610582
1,1,22,18894835,21505417,2610582
1,1,22,18894835,21505417,2610582
-1,1,22,18894835,21505417,2610582
1,1,22,18894835,21505417,2610582
-1,1,22,18894835,21505417,2610582
1,1,22,18894835,21505417,2610582
-1,1,22,18894835,21505417,2610582
1,1,22,18894835,21505417,2610582
1,1,22,18894835,21505417,2610582
1,1,22,18894835,21505417,2610582
-1,1,22,18894835,21505417,2610582
1,1,22,18894835,21505417,2610582
1,1,22,18894835,21505417,2610582
1,1,22,18894835,21505417,2610582
-1,1,22,18894835,21505417,2610582
1,1,22,18894835,21505417,2610582
1,1,22,18894835,21505417,2610582
1,1,22,18894835,21505417,2610582
1,1,22,18894835,21505417,2610582
1,1,22,18894835,21505417,2610582
-1,1,22,18894835,21505417,2610582
-1,1,22,18894835,21505417,2610582
1,1,22,18894835,21505417,2610582
-1,1,22,18894835,21561514,2666679
1,1,22,18894835,21561514,2666679
1,1,22,18894835,21561514,2666679
1,1,22,18894835,21561514,2666679
1,1,22,18894835,21561514,2666679
1,1,22,18894835,21561514,2666679
1,1,22,18894835,21561514,2666679
1,1,22,18894835,21561514,2666679
1,1,22,18894835,21561514,2666679
1,1,22,18894835,21809009,2914174
1,1,22,18894835,21809009,2914174
1,1,22,18894835,21809009,2914174
1,1,22,18894835,21809009,2914174
-1,1,22,18896972,20311763,1414791
-1,1,22,18896972,21382953,2485981
-1,1,22,18896972,21382953,2485981
-1,1,22,18896972,21382953,2485981
1,1,22,18908832,21358123,2449291
-1,1,22,18916827,21465662,2548835
-1,1,22,18916827,21465662,2548835
-1,1,22,18916827,21465662,2548835
1,1,22,18916828,20312661,1395833
-1,1,22,18916828,20312661,1395833
-1,1,22,18916828,21041014,2124186
-1,1,22,18916828,21041014,2124186
-1,1,22,18916828,21049800,2132972
1,1,22,18916828,21465659,2548831
1,1,22,18916828,21465659,2548831
1,1,22,18916828,21465659,2548831
-1,1,22,18916828,21465659,2548831
1,1,22,18916828,21465659,2548831
1,1,22,18916828,21465659,2548831
1,1,22,18916828,21465659,2548831
-1,1,22,18916828,21465659,2548831
1,1,22,18916828,21465659,2548831
1,1,22,18916828,21465659,2548831
1,1,22,18916828,21465659,2548831
-1,1,22,18916828,21465662,2548834
-1,1,22,18916828,21465662,2548834
-1,1,22,18916828,21465662,2548834
-1,1,22,18916828,21465662,2548834
-1,1,22,18916828,21465662,2548834
-1,1,22,18916828,21465662,2548834
1,1,22,18916828,21465662,2548834
-1,1,22,18916828,21465662,2548834
-1,1,22,18916828,21465662,2548834
-1,1,22,18916828,21465662,2548834
-1,1,22,18916828,21465662,2548834
-1,1,22,18916828,21465662,2548834
-1,1,22,18916828,21465662,2548834
1,1,22,18916828,21465662,2548834
-1,1,22,18916828,21465662,2548834
-1,1,22,18916828,21465662,2548834
1,1,22,18916828,21465662,2548834
-1,1,22,18916828,21465662,2548834
-1,1,22,18916828,21465662,2548834
-1,1,22,18916828,21465662,2548834
-1,1,22,18916828,21465662,2548834
-1,1,22,18916828,21465662,2548834
-1,1,22,18916828,21465662,2548834
-1,1,22,18916828,21465662,2548834
1,1,22,18916828,21465662,2548834
1,1,22,18916828,21465662,2548834
-1,1,22,18916828,21465662,2548834
-1,1,22,18916828,21465662,2548834
1,1,22,18916828,21465662,2548834
-1,1,22,18916828,21465662,2548834
1,1,22,18916828,21465662,2548834
-1,1,22,18916828,21465662,2548834
-1,1,22,18916828,21465662,2548834
1,1,22,18916828,21465662,2548834
-1,1,22,18916842,19004772,87930
-1,1,22,18916842,20311858,1395016
-1,1,22,18916842,20312661,1395819
1,1,22,18916842,20312661,1395819
1,1,22,18916842,20312661,1395819
-1,1,22,18916842,20312661,1395819
-1,1,22,18916842,20716903,1800061
1,1,22,18916842,20716903,1800061
1,1,22,18916842,21465659,2548817
1,1,22,18916842,21465659,2548817
1,1,22,18916842,21465659,2548817
1,1,22,18916842,21465659,2548817
1,1,22,18916842,21465659,2548817
1,1,22,18916842,21465659,2548817
1,1,22,18916842,21465659,2548817
1,1,22,18916842,21465659,2548817
1,1,22,18916842,21465659,2548817
1,1,22,18916842,21465659,2548817
-1,1,22,18916842,21465659,2548817
1,1,22,18916842,21465659,2548817
-1,1,22,18916842,21465659,2548817
-1,1,22,18916842,21465659,2548817
1,1,22,18916842,21465659,2548817
-1,1,22,18916842,21465659,2548817
-1,1,22,18916842,21465659,2548817
1,1,22,18916842,21465659,2548817
-1,1,22,18916842,21465659,2548817
-1,1,22,18916842,21465659,2548817
-1,1,22,18916842,21465659,2548817
-1,1,22,18916842,21465659,2548817
-1,1,22,18916842,21465659,2548817
-1,1,22,18916842,21465659,2548817
-1,1,22,18916842,21465659,2548817
1,1,22,18916842,21465659,2548817
1,1,22,18916842,21465659,2548817
-1,1,22,18916842,21465659,2548817
1,1,22,18916842,21465659,2548817
-1,1,22,18916842,21465659,2548817
-1,1,22,18916842,21465659,2548817
-1,1,22,18916842,21465659,2548817
-1,1,22,18916842,21465659,2548817
1,1,22,18916842,21465659,2548817
-1,1,22,18916842,21465659,2548817
1,1,22,18916842,21465659,2548817
1,1,22,18916842,21465659,2548817
-1,1,22,18916842,21465659,2548817
-1,1,22,18916842,21465659,2548817
-1,1,22,18916842,21465661,2548819
-1,1,22,18916842,21465662,2548820
-1,1,22,18916842,21465662,2548820
-1,1,22,18916842,21465662,2548820
-1,1,22,18916842,21465662,2548820
-1,1,22,18916842,21465662,2548820
-1,1,22,18916842,21465662,2548820
-1,1,22,18916842,21465662,2548820
-1,1,22,18916842,21465662,2548820
-1,1,22,18916842,21465662,2548820
-1,1,22,18916842,21465662,2548820
-1,1,22,18916842,21465662,2548820
-1,1,22,18916842,21465662,2548820
-1,1,22,18916842,21465662,2548820
-1,1,22,18916842,21465662,2548820
-1,1,22,18916842,21465662,2548820
-1,1,22,18916842,21465662,2548820
-1,1,22,18916842,21465662,2548820
-1,1,22,18916842,21465662,2548820
-1,1,22,18916842,21465662,2548820
-1,1,22,18916842,21465662,2548820
-1,1,22,18916842,21465662,2548820
-1,1,22,18916842,21465662,2548820
-1,1,22,18916842,21465662,2548820
-1,1,22,18916842,21465662,2548820
-1,1,22,18916842,21465662,2548820
-1,1,22,18916842,21465662,2548820
-1,1,22,18916842,21465662,2548820
-1,1,22,18916842,21465662,2548820
1,1,22,18916842,21465662,2548820
-1,1,22,18916842,21465662,2548820
-1,1,22,18916842,21465662,2548820
-1,1,22,18916842,21465662,2548820
-1,1,22,18916842,21465662,2548820
-1,1,22,18916842,21798907,2882065
-1,1,22,18916842,21798907,2882065
-1,1,22,18916842,21798907,2882065
-1,1,22,18916842,21798907,2882065
-1,1,22,18916842,21800471,2883629
-1,1,22,18916842,21800471,2883629
-1,1,22,18916842,21800797,2883955
-1,1,22,18916842,21804716,2887874
-1,1,22,18916842,21804886,2888044
-1,1,22,18916842,21915509,2998667
-1,1,22,18916842,21915509,2998667
-1,1,22,18917047,21465659,2548612
-1,1,22,18917047,21465659,2548612
-1,1,22,18917047,21465662,2548615
-1,1,22,18919942,20311763,1391821
1,1,22,18919942,20311763,1391821
1,1,22,18919942,20311763,1391821
-1,1,22,18919942,20311763,1391821
1,1,22,18919942,20311763,1391821
-1,1,22,18919942,20311763,1391821
1,1,22,18919942,20311763,1391821
-1,1,22,18919942,20659606,1739664
1,1,22,18919942,20708934,1788992
1,1,22,18919942,21440514,2520572
-1,1,22,18919942,21440514,2520572
-1,1,22,18919942,21440514,2520572
-1,1,22,18919942,21440514,2520572
-1,1,22,18919942,21440514,2520572
1,1,22,18919942,21440514,2520572
-1,1,22,18919942,21440514,2520572
-1,1,22,18919942,21505417,2585475
-1,1,22,18919942,21505417,2585475
-1,1,22,18919942,21505417,2585475
1,1,22,18919942,21505417,2585475
-1,1,22,18919942,21505417,2585475
-1,1,22,18919942,21505417,2585475
-1,1,22,18919942,21505417,2585475
1,1,22,18919942,21505417,2585475
1,1,22,18919942,21505417,2585475
-1,1,22,18919942,21505417,2585475
-1,1,22,18919942,21505417,2585475
-1,1,22,18919942,21505417,2585475
-1,1,22,18919942,21505417,2585475
-1,1,22,18919942,21505417,2585475
1,1,22,18919942,21505417,2585475
1,1,22,18919942,21505417,2585475
-1,1,22,18919942,21505417,2585475
-1,1,22,18919942,21505417,2585475
-1,1,22,18919942,21505417,2585475
-1,1,22,18919942,21505417,2585475
-1,1,22,18919942,21505417,2585475
-1,1,22,18919942,21505417,2585475
-1,1,22,18919942,21505417,2585475
-1,1,22,18919942,21505417,2585475
-1,1,22,18919942,21505417,2585475
-1,1,22,18919942,21505417,2585475
1,1,22,18919942,21561514,2641572
1,1,22,18919942,21561514,2641572
-1,1,22,18919942,21561514,2641572
-1,1,22,18919942,21561514,2641572
-1,1,22,18919942,21561514,2641572
-1,1,22,18919942,21561514,2641572
1,1,22,18919942,21561514,2641572
1,1,22,18919942,21801604,2881662
1,1,22,18919942,21809009,2889067
1,1,22,18919942,21809009,2889067
1,1,22,18919987,21561468,2641481
1,1,22,18937381,21465659,2528278
1,1,22,18970561,21465659,2495098
1,1,22,18970561,21465659,2495098
-1,1,22,18970561,21465662,2495101
-1,1,22,18999803,21455499,2455696
1,-1,22,19006337,19010683,4346
-1,1,22,19023801,21440455,2416654
-1,1,22,19023801,21440455,2416654
-1,1,22,19023801,21440455,2416654
-1,1,22,19024656,21465659,2441003
1,1,22,19024656,21465659,2441003
-1,1,22,19024656,21798907,2774251
-1,1,22,19024657,21465662,2441005
1,1,22,19024792,21465659,2440867
-1,1,22,19035323,21464119,2428796
-1,1,22,19058829,21440514,2381685
1,1,22,19058829,21561514,2502685
1,-1,22,19139027,19147404,8377
-1,1,22,19478208,20168230,690022
1,-1,22,19694673,19712255,17582
1,-1,22,19711077,19712255,1178
1,-1,22,19711077,19712255,1178
1,-1,22,19711077,19712255,1178
1,-1,22,19711077,19712255,1178
1,-1,22,19711077,19712255,1178
1,-1,22,19711077,19712255,1178
1,-1,22,19711077,19712255,1178
1,-1,22,19711077,19712255,1178
1,-1,22,19711077,19712255,1178
1,-1,22,19711077,19712255,1178
1,-1,22,19746385,19750037,3652
1,-1,22,19747933,19749476,1543
1,-1,22,19747933,19749476,1543
1,-1,22,19753293,19756992,3699
1,-1,22,20127284,20144076,16792
1,-1,22,20127284,20144076,16792
1,-1,22,20127284,20144076,16792
1,-1,22,20127284,20144076,16792
1,-1,22,20127284,20144076,16792
1,-1,22,20127284,20144076,16792
1,-1,22,20127284,20144076,16792
1,-1,22,20127284,20144076,16792
1,-1,22,20127284,20144076,16792
1,-1,22,20130578,20133609,3031
-1,1,22,20279766,23822986,3543220
-1,-1,22,20311613,20732528,420915
-1,-1,22,20321692,20708883,387191
-1,-1,22,20321692,20732528,410836
-1,-1,22,20321692,20732528,410836
1,1,22,20717654,21465659,748005
-1,1,22,20754407,21440515,686108
-1,1,22,20754422,21440514,686092
-1,1,22,20754422,21440514,686092
-1,1,22,20754422,21461752,707330
1,1,22,20895155,21374512,479357
1,1,22,21025654,21505417,479763
1,1,22,21025654,22336268,1310614
-1,1,22,21029655,22481498,1451843
1,-1,22,21044196,21049198,5002
1,-1,22,21044196,21049198,5002
1,-1,22,21044196,21049198,5002
1,-1,22,21044196,21049198,5002
1,-1,22,21044196,21049198,5002
1,-1,22,21044196,21049198,5002
1,-1,22,21044196,21049198,5002
1,-1,22,21044196,21049198,5002
1,-1,22,21044196,21049198,5002
1,-1,22,21044196,21049198,5002
1,-1,22,21044196,21065882,21686
1,-1,22,21044196,21065882,21686
1,-1,22,21044196,21065882,21686
1,-1,22,21044196,21065882,21686
1,-1,22,21044196,21065882,21686
1,-1,22,21044196,21065882,21686
1,-1,22,21044196,21065882,21686
1,-1,22,21044196,21065882,21686
1,-1,22,21044196,21065882,21686
1,1,22,21044196,21440455,396259
1,-1,22,21044808,21065882,21074
1,-1,22,21045809,21065882,20073
1,-1,22,21049198,21065882,16684
1,-1,22,21049198,21065882,16684
1,-1,22,21049198,21065882,16684
1,-1,22,21055472,21065882,10410
1,-1,22,21055472,21065882,10410
1,-1,22,21055472,21065882,10410
1,-1,22,21055472,21065882,10410
1,-1,22,21055472,21065882,10410
1,-1,22,21055472,21065882,10410
1,-1,22,21055472,21065882,10410
-1,1,22,21059669,21461606,401937
1,1,22,21065882,21440455,374573
-1,1,22,21065882,21937680,871798
1,1,22,21081260,21440455,359195
-1,1,22,21081260,24593820,3512560
1,1,22,21261514,37583387,16321873
1,-1,22,21368160,21377192,9032
1,-1,22,21387900,21461752,73852
1,-1,22,21400683,21461752,61069
-1,-1,22,21468378,21684857,216479
-1,-1,22,21468378,21684857,216479
-1,-1,22,21468378,21684857,216479
-1,-1,22,21468378,21684857,216479
-1,-1,22,21468378,21684857,216479
-1,-1,22,21468378,21684857,216479
-1,-1,22,21468378,21684857,216479
-1,-1,22,21468378,21684857,216479
-1,-1,22,21468378,21684857,216479
-1,-1,22,21468378,21684857,216479
-1,-1,22,21468378,21684857,216479
-1,-1,22,21468378,21684857,216479
-1,-1,22,21468378,21684857,216479
-1,-1,22,21468378,21684857,216479
-1,1,22,21505358,22959664,1454306
-1,1,22,21505386,22905025,1399639
-1,1,22,21798705,22916612,1117907
-1,1,22,21798906,22997928,1199022
-1,1,22,21798907,22962196,1163289
-1,1,22,21798907,22962196,1163289
-1,1,22,21798907,22962962,1164055
-1,1,22,21798907,23666232,1867325
-1,1,22,21801633,22998308,1196675
1,1,22,21804562,24659578,2855016
-1,1,22,21808938,22905025,1096087
-1,1,22,21808950,22905068,1096118
-1,1,22,21808950,22905068,1096118
-1,1,22,21808950,23654222,1845272
-1,1,22,21808950,23756873,1947923
1,1,22,21808950,23756873,1947923
-1,1,22,21808950,24643108,2834158
-1,1,22,21808950,24643108,2834158
-1,1,22,21917191,22959668,1042477
1,1,22,21937680,22990230,1052550
-1,-1,22,22336262,22556709,220447
-1,-1,22,22336262,22556709,220447
-1,-1,22,22313381,22336268,22887
1,-1,22,22313381,22336268,22887
1,-1,22,22313381,22336268,22887
1,-1,22,22313381,22336268,22887
1,-1,22,22313381,22336268,22887
1,-1,22,22313381,22336268,22887
1,-1,22,22313381,22336268,22887
1,-1,22,22323131,22574790,251659
-1,-1,22,22336268,22556733,220465
1,-1,22,22348942,22556704,207762
-1,-1,22,22728411,23228810,500399
1,1,22,23012013,23643164,631151
1,1,22,23012013,24959827,1947814
1,1,22,23012013,24959827,1947814
-1,1,22,23012069,23654237,642168
1,1,22,23258229,25046758,1788529
1,1,22,23258938,25002659,1743721
1,1,22,23621418,36643415,13021997
1,1,22,23637907,36614412,12976505
-1,1,22,23690387,24666092,975705
1,1,22,23720171,24959827,1239656
1,1,22,23739611,24544632,805021
-1,-1,22,24328565,24385948,57383
-1,-1,22,24347988,24385948,37960
-1,-1,22,24347988,24385948,37960
-1,-1,22,24347988,24385948,37960
-1,-1,22,24347988,24385948,37960
-1,-1,22,24347988,24385948,37960
-1,-1,22,24347988,24385948,37960
-1,-1,22,24347988,24385948,37960
-1,-1,22,24347988,24385948,37960
-1,-1,22,24347988,24385948,37960
-1,-1,22,24347988,24385948,37960
-1,-1,22,24371005,24382415,11410
-1,-1,22,24371005,24382415,11410
-1,-1,22,24371005,24382415,11410
-1,-1,22,24371005,24382415,11410
-1,-1,22,24371005,24382415,11410
1,-1,22,24640758,24658565,17807
1,-1,22,24640758,24658565,17807
1,-1,22,24640758,24658565,17807
1,-1,22,24640758,24658565,17807
1,-1,22,24640758,24658565,17807
1,-1,22,25010707,25053267,42560
1,-1,22,25010707,25053267,42560
-1,-1,22,25664650,25903747,239097
-1,-1,22,25664650,25903747,239097
-1,-1,22,25664650,25903747,239097
-1,-1,22,25664650,25903747,239097
-1,-1,22,25664650,25903747,239097
-1,-1,22,25664650,25903747,239097
-1,-1,22,25664650,25903747,239097
-1,-1,22,25664650,25903747,239097
-1,-1,22,25664650,25903747,239097
-1,-1,22,25664650,25903747,239097
-1,-1,22,25664650,25903747,239097
-1,-1,22,25664650,25903747,239097
-1,-1,22,25664650,25903747,239097
-1,-1,22,25664650,25903747,239097
-1,-1,22,25664650,25903747,239097
-1,-1,22,25664650,25903747,239097
-1,-1,22,25664650,25903747,239097
-1,-1,22,25664650,25903747,239097
-1,-1,22,25664650,25903747,239097
-1,-1,22,25664650,25903747,239097
-1,-1,22,25664650,25903747,239097
-1,-1,22,25664650,25903747,239097
-1,-1,22,25664650,25903747,239097
-1,-1,22,25664650,25903747,239097
-1,-1,22,25659172,25886807,227635
1,-1,22,25664618,25892253,227635
1,-1,22,25664618,25892253,227635
-1,-1,22,25664646,25903514,238868
1,-1,22,25695468,25903811,208343
-1,-1,22,25695469,25903543,208074
-1,-1,22,25695469,25903543,208074
-1,-1,22,25695469,25903543,208074
-1,-1,22,25695469,25903543,208074
-1,-1,22,25695469,25903543,208074
-1,-1,22,25695469,25903543,208074
-1,-1,22,25695469,25903543,208074
1,-1,22,25695469,25903543,208074
1,-1,22,25695469,25903543,208074
1,-1,22,25726380,25799552,73172
1,-1,22,25970646,26108401,137755
-1,1,22,26847008,31847912,5000904
-1,1,22,28368472,29156338,787866
-1,-1,22,28873373,28943898,70525
-1,1,22,29998464,30035142,36678
-1,1,22,36877226,38548989,1671763
-1,1,22,37843259,39499685,1656426
-1,1,22,37866631,39054815,1188184
1,1,22,39312492,51203353,11890861
-1,-1,22,39323589,39380039,56450
-1,-1,22,39353666,39380039,26373
-1,-1,22,39353666,39380039,26373
-1,-1,22,39353666,39380039,26373
-1,-1,22,39353666,39380039,26373
-1,-1,22,39353666,39380039,26373
-1,-1,22,39353666,39380039,26373
-1,-1,22,39353666,39380039,26373
-1,-1,22,39353666,39380039,26373
-1,-1,22,39353666,39380039,26373
-1,-1,22,39353666,39380039,26373
-1,-1,22,39353666,39380039,26373
-1,-1,22,39353666,39407494,53828
-1,-1,22,39353666,39407494,53828
-1,-1,22,39353666,39407494,53828
-1,-1,22,39353666,39407494,53828
-1,-1,22,39353666,39407494,53828
-1,-1,22,39359112,39385485,26373
-1,-1,22,39359112,39385485,26373
-1,-1,22,39359112,39385485,26373
-1,-1,22,39359112,39385485,26373
-1,-1,22,39359112,39385485,26373
1,1,22,40598018,51174234,10576216
1,-1,22,41128510,41288860,160350
1,-1,22,41647929,41677294,29365
1,1,22,41673826,42810963,1137137
-1,1,22,42267147,51178264,8911117
-1,1,22,42441918,51197838,8755920
1,1,22,42476081,51178264,8702183
1,-1,22,42486662,42525705,39043
1,-1,22,42486662,42536651,49989
1,-1,22,42486662,42540449,53787
1,-1,22,42522607,42536651,14044
-1,-1,22,42522607,42537387,14780
-1,-1,22,42523991,42537387,13396
-1,-1,22,42523991,42537387,13396
-1,-1,22,42523991,42537387,13396
-1,-1,22,42523991,42540449,16458
1,-1,22,42523991,42540449,16458
1,1,22,42776967,51197838,8420871
-1,1,22,42889451,50706908,7817457
-1,1,22,43050743,51197838,8147095
1,1,22,43106282,51178264,8071982
-1,1,22,43233100,51174234,7941134
-1,1,22,43381459,51197838,7816379
-1,1,22,43583986,51183872,7599886
-1,1,22,43875989,51197838,7321849
-1,1,22,44298441,51178264,6879823
1,-1,22,44388759,51121542,6732783
-1,1,22,45002243,51178264,6176021
-1,1,22,45160169,51178264,6018095
1,1,22,45193119,51178264,5985145
-1,1,22,45261208,51197838,5936630
-1,1,22,46543160,51197838,4654678
-1,1,22,46757062,51197727,4440665
-1,1,22,46866460,51197838,4331378
-1,1,22,47128342,51218950,4090608
-1,1,22,47187586,51237463,4049877
-1,1,22,47247169,51176099,3928930
-1,1,22,47315714,51178264,3862550
-1,1,22,48457263,51203353,2746090
-1,1,22,48556939,51197838,2640899
-1,1,22,48637187,51178264,2541077
-1,1,22,48896156,51203353,2307197
-1,1,22,48896208,51203353,2307145
-1,1,22,49010148,51178264,2168116
-1,1,22,49146203,51203353,2057150
-1,1,22,49305443,51197838,1892395
1,-1,22,49371757,49499379,127622
1,-1,22,49399646,49995123,595477
1,1,22,49595767,50181440,585673
-1,1,22,49628164,51197838,1569674
-1,1,22,49711443,51178264,1466821
-1,1,22,49711443,51178264,1466821
-1,1,22,49774048,51178264,1404216
-1,-1,22,49843984,49898417,54433
-1,-1,22,49843984,49898417,54433
-1,1,22,49898417,51203353,1304936
-1,1,22,49923409,51197838,1274429
-1,1,22,49928762,51203353,1274591
-1,1,22,50145416,51197838,1052422
-1,1,22,50587992,51218950,630958
1,-1,22,50713396,51178264,464868
-1,1,22,50857155,51203353,346198
-1,1,22,50857138,51178264,321126
-1,1,22,50923886,51197838,273952
-1,1,22,51123497,51203353,79856
-1,1,22,51121360,51183840,62480
-1,1,22,51121362,51197838,76476
-1,1,22,51121452,51183872,62420
-1,1,22,51123491,51178264,54773
-1,1,22,51123491,51178264,54773
-1,1,22,51123491,51178264,54773
-1,1,22,51123491,51178264,54773
-1,1,22,51123491,51178264,54773
-1,1,22,51123491,51203353,79862
-1,1,22,51123491,51203353,79862
-1,1,22,51123491,51203353,79862
-1,1,22,51123491,51203353,79862
-1,1,22,51123491,51203353,79862
-1,1,22,51123491,51237463,113972
-1,1,22,51127896,51197838,69942
-1,1,22,51127896,51197838,69942
-1,1,22,51127896,51197838,69942
-1,1,22,51127897,51176099,48202
-1,1,22,51127897,51183872,55975
-1,1,22,51127898,51197838,69940
-1,1,22,51132803,51203353,70550
-1,1,22,51137326,51165677,28351
-1,1,22,51147983,51183871,35888
1,-1,22,51182469,51220902,38433
-1,1,X,17642,6454929,6437287
-1,1,X,60001,155260560,155200559
-1,1,X,60679,2695400,2634721
-1,1,X,60679,3676181,3615502
-1,1,X,60679,8448318,8387639
-1,1,X,60679,9427683,9367004
-1,1,X,60679,16205542,16144863
-1,1,X,60679,36202463,36141784
-1,1,X,60679,49016667,48955988
-1,1,X,60679,49824045,49763366
-1,1,X,60679,49824045,49763366
-1,1,X,60679,51948998,51888319
1,1,X,60679,52886834,52826155
1,1,X,60679,75640898,75580219
1,1,X,60679,155251871,155191192
1,1,X,60679,155251871,155191192
-1,1,X,60679,155251871,155191192
-1,1,X,60679,155251871,155191192
1,1,X,60679,155251871,155191192
1,1,X,60679,155251871,155191192
-1,1,X,60679,155251871,155191192
-1,1,X,60679,155251871,155191192
-1,1,X,60679,155251871,155191192
1,1,X,60679,155251871,155191192
1,1,X,60679,155251871,155191192
1,1,X,60679,155251871,155191192
1,1,X,60679,155251871,155191192
1,1,X,60679,155251871,155191192
-1,1,X,60679,155251871,155191192
1,1,X,60679,155251871,155191192
1,1,X,60679,155251871,155191192
1,1,X,60679,155251871,155191192
1,1,X,60679,155251871,155191192
-1,1,X,60679,155251871,155191192
1,1,X,60679,155251871,155191192
1,1,X,60679,155251871,155191192
1,1,X,60679,155252491,155191812
1,1,X,60679,155252491,155191812
1,1,X,60701,2854384,2793683
1,1,X,60701,8097511,8036810
-1,1,X,60701,8115153,8054452
-1,1,X,60701,8392011,8331310
-1,1,X,60701,8434426,8373725
-1,1,X,60701,8536442,8475741
-1,1,X,60701,8536442,8475741
1,1,X,60701,21884360,21823659
-1,1,X,60701,37318587,37257886
-1,1,X,60701,48928877,48868176
-1,1,X,60701,51776830,51716129
-1,1,X,60701,52886834,52826133
-1,1,X,60701,53047381,52986680
-1,1,X,60701,53776922,53716221
-1,1,X,60701,58081470,58020769
-1,1,X,60701,58081487,58020786
-1,1,X,60701,58081487,58020786
-1,1,X,60701,58081487,58020786
-1,1,X,60701,58544094,58483393
-1,1,X,60701,61931689,61870988
-1,1,X,60701,87573652,87512951
-1,1,X,60701,105357395,105296694
-1,1,X,60701,127527686,127466985
-1,1,X,60701,155208354,155147653
-1,1,X,60701,155208354,155147653
-1,1,X,60701,155208354,155147653
-1,1,X,60701,155208354,155147653
1,1,X,60701,155209024,155148323
1,1,X,60701,155226891,155166190
1,1,X,60701,155232894,155172193
1,1,X,60701,155232894,155172193
-1,1,X,60701,155232894,155172193
-1,1,X,60701,155232894,155172193
-1,1,X,60701,155232894,155172193
-1,1,X,60701,155232907,155172206
-1,1,X,60701,155232907,155172206
-1,1,X,60701,155232907,155172206
1,1,X,60701,155232907,155172206
-1,1,X,60701,155232907,155172206
-1,1,X,60701,155232907,155172206
-1,1,X,60701,155232907,155172206
1,1,X,60701,155232907,155172206
1,1,X,60701,155232907,155172206
-1,1,X,60701,155232907,155172206
1,1,X,60701,155232907,155172206
-1,1,X,60701,155232907,155172206
1,1,X,60701,155232907,155172206
-1,1,X,60701,155232907,155172206
-1,1,X,60701,155232907,155172206
-1,1,X,60701,155232907,155172206
-1,1,X,60701,155232907,155172206
1,1,X,60701,155232907,155172206
-1,1,X,60701,155232907,155172206
1,1,X,60701,155232907,155172206
1,1,X,60701,155232907,155172206
1,1,X,60701,155232907,155172206
1,1,X,60701,155232907,155172206
1,1,X,60701,155246225,155185524
1,1,X,60701,155260560,155199859
1,1,X,60701,155260560,155199859
1,1,X,60701,155260560,155199859
1,1,X,60701,155260560,155199859
-1,1,X,60701,155260560,155199859
1,1,X,60701,155260560,155199859
1,1,X,60701,155260560,155199859
1,1,X,60701,155260560,155199859
1,1,X,60701,155260560,155199859
1,-1,X,60702,92362,31660
-1,1,X,70140,9427683,9357543
-1,1,X,70297,643638,573341
-1,1,X,70297,8654089,8583792
1,1,X,70297,155228918,155158621
1,1,X,70297,155246585,155176288
1,1,X,70297,155246585,155176288
-1,1,X,70297,155246585,155176288
-1,1,X,70297,155255792,155185495
-1,1,X,70297,155255792,155185495
1,1,X,70297,155255792,155185495
-1,1,X,71267,2217264,2145997
-1,1,X,71267,155255792,155184525
1,-1,X,77606,92362,14756
-1,-1,X,77606,92362,14756
1,-1,X,77606,92362,14756
-1,-1,X,77606,92362,14756
-1,-1,X,77606,92362,14756
-1,-1,X,77606,92362,14756
-1,-1,X,77606,92362,14756
-1,-1,X,77606,92362,14756
-1,-1,X,77606,92362,14756
1,-1,X,77606,171878,94272
-1,1,X,90904,155227831,155136927
-1,1,X,150002,37152232,37002230
1,1,X,164504,155209024,155044520
1,1,X,168546,372029,203483
-1,1,X,168546,1998539,1829993
1,1,X,168546,2674479,2505933
1,1,X,168546,2696762,2528216
1,1,X,168546,2696762,2528216
-1,1,X,168546,3259868,3091322
-1,1,X,168546,5896155,5727609
-1,1,X,168546,6502019,6333473
-1,1,X,168546,7721374,7552828
-1,1,X,168546,9766970,9598424
-1,1,X,168546,9868031,9699485
-1,1,X,168546,16985413,16816867
1,1,X,168546,24780527,24611981
-1,1,X,168546,31085327,30916781
-1,1,X,168546,35841052,35672506
-1,1,X,168546,35903121,35734575
-1,1,X,168546,37515849,37347303
1,1,X,168546,43917011,43748465
-1,1,X,168546,50032363,49863817
-1,1,X,168546,52573789,52405243
-1,1,X,168546,54996659,54828113
-1,1,X,168546,55240087,55071541
-1,1,X,168546,55529093,55360547
-1,1,X,168546,56455292,56286746
-1,1,X,168546,56455292,56286746
-1,1,X,168546,56684082,56515536
-1,1,X,168546,57504183,57335637
-1,1,X,168546,57683964,57515418
-1,1,X,168546,58140271,57971725
-1,1,X,168546,58527164,58358618
-1,1,X,168546,74549686,74381140
1,1,X,168546,117981120,117812574
1,1,X,168546,154930047,154761501
1,1,X,168546,155081533,154912987
1,1,X,168546,155196888,155028342
-1,1,X,168546,155233731,155065185
-1,1,X,168546,155233731,155065185
1,1,X,168546,155233731,155065185
1,1,X,168546,155233731,155065185
1,1,X,168546,155233731,155065185
1,1,X,168546,155233731,155065185
-1,1,X,168546,155233731,155065185
1,1,X,168546,155233731,155065185
-1,1,X,168546,155233731,155065185
-1,1,X,168546,155233731,155065185
-1,1,X,168546,155233731,155065185
1,1,X,168546,155233731,155065185
1,1,X,168546,155233731,155065185
1,1,X,168546,155233731,155065185
1,1,X,168546,155233731,155065185
-1,1,X,168546,155233731,155065185
-1,1,X,168546,155233731,155065185
-1,1,X,168546,155233731,155065185
1,1,X,168546,155233731,155065185
1,1,X,168546,155233731,155065185
-1,1,X,168546,155233731,155065185
-1,1,X,168547,3880686,3712139
-1,1,X,168547,51386559,51218012
-1,1,X,168547,65665687,65497140
-1,1,X,168547,112474026,112305479
-1,1,X,168547,151304063,151135516
-1,1,X,168547,155233731,155065184
1,1,X,168547,155233731,155065184
-1,1,X,168547,155233731,155065184
1,1,X,168547,155233731,155065184
1,1,X,168547,155233731,155065184
-1,1,X,168547,155233731,155065184
1,1,X,168547,155233731,155065184
1,1,X,168547,155233731,155065184
1,1,X,168547,155233731,155065184
1,1,X,168547,155233731,155065184
1,1,X,168547,155233731,155065184
-1,1,X,168547,155233731,155065184
1,1,X,168547,155233731,155065184
1,1,X,168547,155233731,155065184
1,1,X,168547,155233731,155065184
-1,1,X,168547,155233731,155065184
1,1,X,168547,155233731,155065184
-1,1,X,168547,155233731,155065184
1,1,X,168547,155233731,155065184
1,1,X,168547,155233731,155065184
-1,1,X,168547,155233731,155065184
1,1,X,168547,155233731,155065184
-1,1,X,168547,155233731,155065184
1,1,X,168547,155233731,155065184
1,1,X,168547,155233731,155065184
-1,1,X,168547,155233731,155065184
1,1,X,168547,155233731,155065184
-1,1,X,168547,155233731,155065184
-1,1,X,168547,155233731,155065184
1,1,X,168547,155233731,155065184
-1,1,X,168547,155233731,155065184
1,1,X,168547,155233731,155065184
-1,1,X,168547,155233731,155065184
1,1,X,168547,155233731,155065184
1,1,X,168547,155233731,155065184
1,1,X,168547,155233731,155065184
-1,1,X,168547,155233731,155065184
-1,1,X,168547,155233731,155065184
1,1,X,168547,155233731,155065184
1,1,X,168547,155233846,155065299
-1,1,X,168564,57413442,57244878
-1,1,X,168566,155233731,155065165
-1,1,X,169791,12949463,12779672
1,1,X,169921,2666411,2496490
1,-1,X,176426,697169,520743
-1,1,X,219609,1342026,1122417
1,-1,X,225816,438701,212885
1,-1,X,225816,477447,251631
1,-1,X,281527,456062,174535
1,-1,X,281527,580777,299250
1,-1,X,281527,697169,415642
1,-1,X,298643,438701,140058
1,-1,X,298643,524370,225727
-1,1,X,318707,155224707,154906000
1,1,X,332881,2749927,2417046
1,-1,X,338874,580777,241903
-1,1,X,344213,673537,329324
-1,-1,X,352512,353164,652
-1,-1,X,353093,387718,34625
1,1,X,395646,2696692,2301046
-1,1,X,401671,1342026,940355
-1,-1,X,426624,456062,29438
1,-1,X,438701,524370,85669
-1,-1,X,456062,498819,42757
1,-1,X,456062,809513,353451
1,-1,X,456062,983987,527925
-1,1,X,463756,1217076,753320
-1,1,X,513354,640818,127464
-1,1,X,513354,650520,137166
-1,1,X,517225,839488,322263
-1,1,X,519455,592812,73357
-1,1,X,545953,803877,257924
-1,1,X,553069,155233731,154680662
1,-1,X,571286,590637,19351
-1,-1,X,628237,836076,207839
1,-1,X,628237,1252522,624285
-1,-1,X,677536,723469,45933
1,-1,X,697169,756122,58953
-1,-1,X,697169,1238257,541088
1,-1,X,714137,1505988,791851
1,-1,X,756122,1618582,862460
1,-1,X,809513,1321581,512068
1,-1,X,876551,1378591,502040
1,-1,X,909049,1252522,343473
1,-1,X,909049,1252522,343473
1,-1,X,909049,1252522,343473
1,-1,X,909049,1252522,343473
1,-1,X,909049,1252522,343473
1,-1,X,909049,1252522,343473
1,-1,X,909049,1252522,343473
1,-1,X,909049,1252522,343473
1,-1,X,909049,1252522,343473
1,-1,X,909049,1252522,343473
1,-1,X,909049,1252522,343473
1,-1,X,917876,1471350,553474
1,-1,X,958625,1378591,419966
1,-1,X,974682,1252522,277840
1,-1,X,974682,1414338,439656
1,-1,X,1015836,1238257,222421
1,-1,X,1015836,1347283,331447
1,-1,X,1015836,1505988,490152
-1,-1,X,1035386,1199297,163911
1,-1,X,1110841,1583754,472913
-1,1,X,1118268,154929305,153811037
1,-1,X,1123365,1505988,382623
1,-1,X,1223372,1321581,98209
1,-1,X,1321581,1430714,109133
1,-1,X,1321581,1430714,109133
1,-1,X,1321581,1448838,127257
1,-1,X,1321581,1570890,249309
-1,1,X,1321581,7896531,6574950
1,-1,X,1347283,1464141,116858
1,-1,X,1378591,1414338,35747
1,-1,X,1378591,1414338,35747
1,-1,X,1378591,1430714,52123
1,-1,X,1378597,1414338,35741
-1,1,X,1658660,9442004,7783344
1,-1,X,1729895,2066618,336723
1,-1,X,1748418,2066618,318200
1,-1,X,1793480,1942205,148725
1,-1,X,1793480,2017309,223829
1,-1,X,1793480,2066618,273138
1,-1,X,1810323,1926298,115975
1,-1,X,1810323,2066618,256295
1,-1,X,1810323,2066618,256295
1,-1,X,1810323,2066618,256295
-1,1,X,1837147,3618538,1781391
1,-1,X,1936120,1938684,2564
-1,-1,X,1936120,1938684,2564
1,-1,X,1936120,1942198,6078
1,-1,X,1942205,2272030,329825
1,-1,X,2066618,2166859,100241
1,-1,X,2066618,2166859,100241
1,-1,X,2066618,2272030,205412
1,-1,X,2066618,2361399,294781
-1,-1,X,2118389,2289645,171256
1,1,X,2217264,155221853,153004589
1,-1,X,2326635,2615004,288369
1,-1,X,2524696,2576743,52047
-1,1,X,2683677,6235107,3551430
1,1,X,2683677,154751965,152068288
1,-1,X,2700316,2799420,99104
1,1,X,2700316,154785891,152085575
-1,1,X,2703632,155233731,152530099
1,-1,X,2707626,2802518,94892
-1,1,X,2708886,6413964,3705078
1,-1,X,2709027,2802518,93491
1,-1,X,2709027,2802518,93491
1,-1,X,2741284,2799420,58136
1,-1,X,2852856,2856474,3618
1,1,X,2854502,17305446,14450944
1,-1,X,2856291,2856474,183
1,-1,X,2856291,2856474,183
1,1,X,2881940,4934968,2053028
1,-1,X,2970843,3140922,170079
1,1,X,3669874,154974696,151304822
-1,1,X,3711398,9389098,5677700
1,-1,X,4524506,5028348,503842
-1,1,X,5803207,5833017,29810
-1,1,X,5900508,6018691,118183
-1,-1,X,6018632,6022691,4059
1,-1,X,6324569,6653705,329136
-1,1,X,6445297,8137963,1692666
-1,1,X,6445297,8137963,1692666
-1,1,X,6445297,8137963,1692666
1,-1,X,6449644,6454095,4451
-1,1,X,6449644,8115094,1665450
1,-1,X,6449688,8115094,1665406
-1,1,X,6449752,8067142,1617390
-1,1,X,6449752,8135644,1685892
-1,1,X,6449752,8135644,1685892
-1,1,X,6449752,8135644,1685892
-1,1,X,6449752,8135644,1685892
-1,1,X,6449752,8135644,1685892
1,-1,X,6452681,8097511,1644830
1,-1,X,6452681,8097511,1644830
1,-1,X,6452681,8097511,1644830
1,-1,X,6452689,6592470,139781
-1,1,X,6452689,8115153,1662464
1,-1,X,6452695,8097511,1644816
-1,1,X,6452695,8097511,1644816
1,-1,X,6452695,8497777,2045082
1,-1,X,6453036,6507660,54624
1,-1,X,6453036,6570937,117901
1,-1,X,6453036,6570937,117901
1,-1,X,6453036,6653705,200669
1,-1,X,6453036,8139186,1686150
1,-1,X,6453049,8097511,1644462
1,-1,X,6453072,7809341,1356269
-1,1,X,6453129,155260560,148807431
1,-1,X,6453272,6453313,41
1,-1,X,6453272,6939872,486600
1,-1,X,6454212,8115094,1660882
-1,1,X,6454212,8115094,1660882
-1,1,X,6454212,8115153,1660941
-1,1,X,6454212,8115153,1660941
-1,1,X,6454368,8115153,1660785
-1,1,X,6454368,8115153,1660785
1,-1,X,6456036,6570937,114901
-1,1,X,6456036,8131751,1675715
-1,1,X,6456036,8131751,1675715
-1,1,X,6458939,8135053,1676114
-1,1,X,6458939,8135644,1676705
-1,1,X,6458939,8135644,1676705
1,-1,X,6460492,6552712,92220
-1,-1,X,6488462,8097511,1609049
-1,1,X,6488721,8097511,1608790
-1,1,X,6488721,8097511,1608790
-1,-1,X,6488721,8097511,1608790
-1,1,X,6488721,8097511,1608790
-1,1,X,6488721,8097511,1608790
-1,1,X,6488721,8097511,1608790
1,-1,X,6488721,8097511,1608790
-1,-1,X,6488721,8097511,1608790
1,-1,X,6488721,8097511,1608790
-1,-1,X,6488721,8097511,1608790
-1,1,X,6488721,8097511,1608790
-1,1,X,6512892,7936824,1423932
-1,1,X,6523326,8127576,1604250
-1,1,X,6551155,8032120,1480965
-1,1,X,6551155,8032120,1480965
-1,1,X,6628264,7828224,1199960
1,1,X,6628264,8097511,1469247
-1,-1,X,6705268,7885155,1179887
-1,1,X,6705268,7939269,1234001
-1,1,X,6722953,8135053,1412100
-1,-1,X,6755142,6818667,63525
-1,-1,X,6755142,6818667,63525
-1,1,X,6755142,7867359,1112217
-1,1,X,6783100,7744191,961091
-1,1,X,6807735,7828224,1020489
1,-1,X,6880529,7346525,465996
-1,1,X,6939872,8097511,1157639
-1,1,X,6990250,9342357,2352107
-1,1,X,7145359,7177501,32142
1,-1,X,7218800,7391581,172781
1,-1,X,7269569,7706446,436877
-1,-1,X,7381734,7482524,100790
1,-1,X,7398741,7803244,404503
1,-1,X,7433896,7584692,150796
-1,-1,X,7469576,7744132,274556
1,-1,X,7491589,7828224,336635
1,-1,X,7513049,8137963,624914
1,-1,X,7513049,8138346,625297
1,-1,X,7513049,8164722,651673
1,-1,X,7532546,8097511,564965
1,-1,X,7532546,8115094,582548
1,-1,X,7533820,8151615,617795
1,-1,X,7613959,8224972,611013
1,-1,X,7679108,7960118,281010
1,-1,X,7828165,8097452,269287
1,-1,X,7920725,8131751,211026
1,-1,X,7920725,8151615,230890
1,-1,X,7964677,8131751,167074
1,-1,X,8067038,8184213,117175
1,-1,X,8076652,8131751,55099
1,-1,X,8144071,8184213,40142
-1,1,X,8144071,53989266,45845195
-1,1,X,8250344,9702358,1452014
1,-1,X,8250338,8391952,141614
1,-1,X,8250338,8391952,141614
1,-1,X,8250338,8391952,141614
-1,1,X,8419281,8833845,414564
1,-1,X,8448259,8536442,88183
1,-1,X,8448259,8674356,226097
1,-1,X,9985848,10002126,16278
-1,1,X,10533428,10669918,136490
-1,1,X,11258243,14177713,2919470
1,-1,X,11641372,11681931,40559
-1,1,X,12272674,30428697,18156023
-1,1,X,13038260,142561303,129523043
1,-1,X,13399913,13495629,95716
1,-1,X,14356913,14428075,71162
-1,1,X,14878636,14942042,63406
1,1,X,15191748,23970702,8778954
-1,1,X,15807916,18920546,3112630
1,-1,X,16083896,16497277,413381
-1,1,X,18372715,18491396,118681
1,1,X,18578748,18606226,27478
-1,1,X,18582314,18613550,31236
-1,1,X,18662177,18690178,28001
-1,1,X,18662232,18695095,32863
1,-1,X,19127936,19351757,223821
-1,1,X,20173087,20235708,62621
-1,1,X,20258161,20813822,555661
1,-1,X,22129362,22129540,178
1,-1,X,22129362,22129540,178
1,-1,X,22129362,22129540,178
1,1,X,22166967,22219901,52934
1,1,X,22166967,22219901,52934
1,-1,X,22815879,22871355,55476
-1,-1,X,22894147,22960744,66597
-1,1,X,22960744,23019707,58963
-1,1,X,22960744,23019707,58963
-1,1,X,23351370,23449835,98465
1,-1,X,26255142,26345329,90187
1,-1,X,28252469,28304589,52120
-1,1,X,30045134,30341004,295870
-1,1,X,30112028,34078784,3966756
1,1,X,30322057,30341063,19006
1,-1,X,30326814,30327501,687
1,-1,X,30962926,31375215,412289
-1,1,X,31088082,155233731,124145649
1,1,X,31207964,31963300,755336
-1,1,X,31449215,31543991,94776
1,1,X,31537077,31619941,82864
-1,1,X,31558361,32077563,519202
-1,1,X,31637969,31894898,256929
-1,1,X,31658889,31683682,24793
-1,1,X,31664103,31792102,127999
-1,1,X,31683623,31766614,82991
-1,1,X,31713409,31858935,145526
-1,1,X,31743030,31824743,81713
-1,1,X,31762980,31864904,101924
-1,1,X,31762980,31864904,101924
-1,1,X,31763002,32580328,817326
-1,1,X,31875003,32501088,626085
-1,1,X,31888992,31920827,31835
-1,1,X,31888825,32371709,482884
-1,1,X,31916929,32040440,123511
-1,1,X,31923771,32043955,120184
-1,1,X,31942461,32104259,161798
-1,1,X,31951570,32096169,144599
-1,-1,X,32035638,32077563,41925
-1,1,X,32053680,32248240,194560
-1,1,X,32077637,32237871,160234
-1,1,X,32221858,32371650,149792
-1,1,X,32285940,32390689,104749
-1,1,X,32293846,32371702,77856
-1,1,X,32349168,32534563,185395
1,1,X,32470878,32663191,192313
1,1,X,32519833,32950412,430579
-1,1,X,32575523,32772668,197145
1,1,X,32644702,32681484,36782
-1,1,X,32649520,32925773,276253
-1,1,X,32684174,32719596,35422
-1,1,X,33140639,35911784,2771145
1,-1,X,33595181,34078725,483544
1,-1,X,33656151,33708829,52678
-1,-1,X,33897006,34008729,111723
-1,1,X,36255823,155251871,118996048
-1,1,X,36667388,44316141,7648753
-1,1,X,37094357,155246585,118152228
1,-1,X,37423768,37669766,245998
-1,1,X,37521774,98488534,60966760
-1,1,X,38135974,38957292,821318
1,1,X,38486799,38628556,141757
1,-1,X,38488617,38547951,59334
1,-1,X,38488617,38547951,59334
-1,1,X,41150139,46528262,5378123
-1,1,X,41687057,43144754,1457697
-1,1,X,41708906,41713659,4753
-1,-1,X,42331117,42441959,110842
-1,1,X,42740733,43608143,867410
1,1,X,43221119,50674794,7453675
1,1,X,43499856,43982742,482886
1,-1,X,44514646,44703618,188972
1,-1,X,46407630,46532878,125248
1,1,X,46818746,53957191,7138445
1,-1,X,46950670,47024580,73910
1,1,X,47881447,52616581,4735134
1,1,X,48120296,52616581,4496285
1,1,X,48204101,58081470,9877369
1,1,X,48224454,52813336,4588882
1,1,X,48245740,52616581,4370841
1,1,X,48287896,52616581,4328685
-1,1,X,48287896,52616581,4328685
1,1,X,48290189,52154997,3864808
1,1,X,48317353,51497588,3180235
1,1,X,48317353,51497588,3180235
1,-1,X,48369787,48370706,919
1,-1,X,48369856,48370750,894
1,-1,X,48369856,48370750,894
1,-1,X,48369856,48371066,1210
1,-1,X,48369856,48371066,1210
1,1,X,48811187,53303085,4491898
-1,1,X,48957474,101429714,52472240
-1,1,X,49102754,122869859,73767105
-1,1,X,50032384,118431567,68399183
-1,1,X,51397726,58495933,7098207
-1,1,X,51450890,53258946,1808056
1,1,X,52570756,74232626,21661870
1,1,X,52838147,64525424,11687277
-1,1,X,53321095,155232907,101911812
1,1,X,53559548,53622547,62999
1,1,X,53559548,53622547,62999
1,1,X,53559732,53790650,230918
1,1,X,53559732,53790650,230918
1,1,X,53776863,62203737,8426874
1,1,X,53790650,58041201,4250551
-1,1,X,54012008,91458107,37446099
1,1,X,55000501,155230750,100230249
1,-1,X,55101485,55117828,16343
1,-1,X,55101485,55117828,16343
-1,1,X,55240087,78225374,22985287
-1,1,X,55532799,150239235,94706436
1,1,X,56154308,63087733,6933425
1,1,X,56457791,155233731,98775940
-1,1,X,56457792,75777827,19320035
1,1,X,57415659,155233731,97818072
1,1,X,57511767,155233731,97721964
1,1,X,58140271,155046703,96906432
1,1,X,61781074,155232907,93451833
-1,1,X,61781848,63455936,1674088
1,-1,X,61931689,62146866,215177
1,-1,X,61931689,62146866,215177
1,-1,X,61931689,62146866,215177
1,-1,X,61931689,62146866,215177
1,-1,X,61931689,62146866,215177
1,-1,X,61931689,62148398,216709
1,-1,X,61931689,62178500,246811
1,1,X,61931689,77860506,15928817
1,1,X,61931689,155232907,93301218
1,1,X,61931700,155208553,93276853
1,-1,X,61998756,62133212,134456
1,-1,X,62215643,62278218,62575
-1,-1,X,63882845,63971002,88157
-1,1,X,64174689,64450154,275465
1,1,X,65665749,77427705,11761956
1,-1,X,65815490,65895015,79525
1,-1,X,66516192,66630636,114444
1,-1,X,66647877,66728634,80757
1,-1,X,66647877,66728634,80757
-1,1,X,66752153,67573743,821590
1,-1,X,66911026,67265082,354056
1,-1,X,67176568,67573802,397234
1,1,X,67280452,67573802,293350
-1,1,X,67497166,67594258,97092
-1,1,X,67497166,68081565,584399
1,1,X,68701338,155233731,86532393
-1,-1,X,69732435,69756363,23928
1,-1,X,71047501,71094447,46946
1,-1,X,72224362,72298286,73924
1,-1,X,72224362,72298286,73924
1,1,X,72224362,139262228,67037866
1,1,X,73111197,74781209,1670012
-1,1,X,73729951,155251871,81521920
-1,1,X,73904450,155233731,81329281
-1,1,X,74306252,155251871,80945619
1,-1,X,74360310,74516106,155796
-1,1,X,74560735,116609286,42048551
-1,1,X,74787886,155233731,80445845
1,-1,X,75251957,75360247,108290
-1,1,X,75777833,155233731,79455898
-1,1,X,75824420,155251871,79427451
-1,1,X,76634813,155242832,78608019
1,1,X,77054444,77143054,88610
-1,1,X,77250619,77294719,44100
-1,1,X,77442685,155233731,77791046
-1,1,X,77450503,89938535,12488032
-1,1,X,77860506,155246225,77385719
-1,1,X,78230501,155233731,77003230
-1,1,X,78348649,155232894,76884245
-1,1,X,79166568,155232894,76066326
-1,1,X,79862302,155233731,75371429
-1,1,X,79977813,91407618,11429805
-1,1,X,80177055,82970633,2793578
-1,1,X,80364969,108686022,28321053
-1,1,X,81186415,85220287,4033872
1,-1,X,81202690,81314758,112068
1,-1,X,81202690,81314758,112068
1,-1,X,81202690,81314758,112068
-1,1,X,81352168,155233731,73881563
-1,1,X,81466759,155232894,73766135
-1,-1,X,84030980,84132021,101041
1,1,X,84378746,155251871,70873125
1,1,X,84378746,155251871,70873125
-1,1,X,85881434,155233731,69352297
-1,-1,X,86428535,86473678,45143
-1,1,X,86776682,114054291,27277609
-1,1,X,86900388,155233731,68333343
1,1,X,87062750,99541150,12478400
-1,1,X,87594927,155232907,67637980
1,1,X,88489463,92357412,3867949
-1,1,X,88812621,155233731,66421110
-1,1,X,90480161,100281763,9801602
-1,-1,X,91214315,91246061,31746
1,-1,X,91214315,91246061,31746
1,-1,X,91434301,91519622,85321
-1,1,X,91477679,155246585,63768906
1,-1,X,91754117,91797605,43488
1,1,X,92846589,111773320,18926731
-1,1,X,92879337,100099708,7220371
1,-1,X,93345492,93524330,178838
1,-1,X,93622826,94376002,753176
1,1,X,93717928,155231300,61513372
-1,1,X,94043221,155246585,61203364
1,-1,X,94086549,94681639,595090
1,-1,X,94277650,94388722,111072
1,-1,X,94315189,94375943,60754
1,-1,X,94315189,94375943,60754
1,-1,X,94315189,94375943,60754
1,-1,X,94348475,94388722,40247
1,-1,X,94348475,94388722,40247
1,-1,X,94348475,94388722,40247
1,-1,X,94348475,94388722,40247
1,-1,X,94348475,94388722,40247
1,-1,X,94348475,94388722,40247
1,-1,X,94348475,94388722,40247
1,-1,X,94348475,94388722,40247
1,-1,X,94348475,94388722,40247
1,-1,X,94348475,94388722,40247
1,-1,X,94348475,94388722,40247
1,-1,X,94348475,94388722,40247
1,-1,X,94348475,94388722,40247
1,-1,X,94348475,94388722,40247
1,-1,X,94348475,94388722,40247
1,-1,X,94348475,94388722,40247
1,-1,X,94348475,94388722,40247
1,-1,X,94348475,94388722,40247
1,-1,X,94348475,94388722,40247
-1,-1,X,94416437,94462590,46153
-1,-1,X,94754981,95056650,301669
1,-1,X,94860137,94911489,51352
1,-1,X,94988206,95077344,89138
-1,1,X,95078035,104202418,9124383
1,1,X,95101284,155232907,60131623
1,1,X,95498487,129063677,33565190
-1,-1,X,95729423,95845434,116011
-1,-1,X,96774546,96823322,48776
1,-1,X,96774576,96823352,48776
-1,1,X,97624055,99779618,2155563
-1,1,X,98266555,99564962,1298407
-1,1,X,98495811,155233731,56737920
1,1,X,99611312,103506684,3895372
1,1,X,99852684,110894344,11041660
-1,1,X,100598538,100615055,16517
-1,1,X,101452257,155232907,53780650
1,-1,X,101596705,101693437,96732
1,-1,X,101596705,101693437,96732
1,1,X,102605732,103288063,682331
1,1,X,102659333,103167860,508527
1,1,X,102857802,103087615,229813
1,1,X,102857802,103135921,278119
1,1,X,103027027,103303380,276353
1,1,X,103158718,111556067,8397349
1,-1,X,103220412,103223099,2687
1,-1,X,103220412,103269195,48783
1,-1,X,103220412,103269195,48783
-1,1,X,105371166,155232907,49861741
-1,1,X,105694656,155224707,49530051
-1,1,X,105708840,155232907,49524067
-1,1,X,105965526,155233731,49268205
-1,1,X,107370001,110989043,3619042
-1,1,X,110293613,155251871,44958258
1,1,X,110561548,110591406,29858
1,1,X,110988950,153783638,42794688
-1,1,X,112474054,155233731,42759677
-1,-1,X,112828750,113202825,374075
1,-1,X,112841647,112968325,126678
1,-1,X,113202825,113306088,103263
-1,1,X,113767592,155251871,41484279
1,-1,X,114218436,114395542,177106
1,-1,X,114218436,114395542,177106
1,-1,X,114218436,114395542,177106
1,-1,X,114239463,114401048,161585
1,-1,X,115944547,116047048,102501
1,-1,X,115944547,116047048,102501
1,-1,X,115944547,116047048,102501
1,-1,X,115944547,116047048,102501
1,-1,X,115944547,116047048,102501
1,-1,X,115944547,116047048,102501
1,-1,X,115944547,116047048,102501
-1,-1,X,116105972,116162380,56408
-1,-1,X,116141925,116195097,53172
-1,-1,X,116338320,116394255,55935
1,1,X,116394255,139283477,22889222
-1,-1,X,116409787,116466743,56956
-1,1,X,116621104,155233731,38612627
1,-1,X,117856805,118042000,185195
-1,1,X,117990537,155233731,37243194
-1,1,X,118431633,155233731,36802098
-1,-1,X,120968146,121033911,65765
-1,-1,X,121480340,121526377,46037
1,1,X,122607629,122727785,120156
-1,1,X,122927376,155251871,32324495
1,1,X,122992947,127851125,4858178
-1,-1,X,124807304,124875430,68126
-1,-1,X,125101992,125287185,185193
-1,-1,X,125191679,125301888,110209
-1,-1,X,125191679,125301888,110209
1,-1,X,125325276,125360226,34950
-1,-1,X,126152297,126345993,193696
-1,-1,X,126223902,126583848,359946
1,1,X,126307810,131646710,5338900
-1,-1,X,126550521,126707466,156945
-1,-1,X,126640473,126707466,66993
-1,1,X,126773628,155233731,28460103
-1,-1,X,127330420,127572796,242376
-1,1,X,127607213,155232894,27625681
1,-1,X,127913672,127993055,79383
1,-1,X,128674689,128674924,235
1,-1,X,130769212,130813232,44020
1,-1,X,130769212,130813232,44020
1,-1,X,130918053,130969915,51862
-1,1,X,132821337,133224500,403163
-1,1,X,133081342,135086194,2004852
1,1,X,133944147,155233731,21289584
-1,1,X,134114063,155233731,21119668
1,-1,X,134215720,134372869,157149
1,-1,X,134293036,134330110,37074
1,-1,X,134427695,134613879,186184
1,-1,X,134674526,134725220,50694
1,-1,X,134725220,134910134,184914
-1,1,X,136201142,155232907,19031765
1,-1,X,136260894,136371994,111100
-1,1,X,138415183,155208354,16793171
-1,1,X,138613087,155232894,16619807
1,1,X,139865555,154785891,14920336
-1,-1,X,139973117,140020798,47681
-1,-1,X,140084056,140649779,565723
1,-1,X,140296053,140591220,295167
-1,-1,X,140353121,140559832,206711
-1,-1,X,140353121,140559832,206711
-1,-1,X,140353121,140649779,296658
-1,-1,X,140353121,140649779,296658
-1,-1,X,140353121,140649779,296658
-1,-1,X,140353121,140764153,411032
-1,-1,X,140353121,140764153,411032
-1,-1,X,140308067,140988326,680259
1,-1,X,140352891,140557758,204867
-1,-1,X,140353091,140557617,204526
1,-1,X,140353091,140557617,204526
-1,1,X,140738414,155251871,14513457
-1,1,X,141689794,147944759,6254965
-1,1,X,142641674,155232894,12591220
1,1,X,142899598,155260560,12360962
1,-1,X,143366681,143570340,203659
1,-1,X,143378614,143615265,236651
1,-1,X,143436117,143485415,49298
1,-1,X,143756944,143843203,86259
-1,-1,X,144342100,144478571,136471
1,-1,X,146050508,146122279,71771
-1,1,X,146232592,155233731,9001139
1,1,X,146715565,154664396,7948831
1,1,X,146715565,154664396,7948831
-1,1,X,146750503,147319132,568629
-1,1,X,146989853,146993413,3560
-1,1,X,147573612,147620560,46948
-1,1,X,148555685,148587685,32000
-1,-1,X,148644765,148651627,6862
-1,-1,X,148644765,148651627,6862
1,-1,X,148684071,148734910,50839
1,-1,X,148705057,148830445,125388
1,-1,X,148878834,149084873,206039
1,1,X,148956425,154664314,5707889
1,-1,X,149436538,149504964,68426
-1,1,X,150253008,155233731,4980723
1,1,X,150328134,151314272,986138
-1,1,X,150919335,154751965,3832630
1,1,X,151201777,154741703,3539926
-1,1,X,151311551,155233731,3922180
-1,1,X,151539534,151734489,194955
-1,1,X,151963528,155233731,3270203
1,1,X,152228560,154930047,2701487
1,1,X,152465185,155232907,2767722
1,1,X,152568327,153832724,1264397
1,1,X,152716809,153496099,779290
1,1,X,152864376,154751965,1887589
1,1,X,152886474,153368990,482516
1,1,X,152899437,153624564,725127
1,1,X,152932487,153333945,401458
1,-1,X,152955274,152955898,624
1,-1,X,152955274,152956990,1716
1,1,X,152964386,153333945,369559
1,1,X,152970475,153524157,553682
1,1,X,153068282,153523170,454888
1,1,X,153079349,153333945,254596
1,1,X,153079349,153611431,532082
1,1,X,153097608,153681801,584193
1,1,X,153120607,153333945,213338
1,1,X,153126904,153333945,207041
-1,1,X,153126942,153143271,16329
1,-1,X,153169608,153170664,1056
1,1,X,153253477,153438781,185304
-1,1,X,153269534,153321371,51837
-1,1,X,153287517,153310135,22618
-1,1,X,153287517,153330916,43399
-1,1,X,153290315,153294658,4343
-1,1,X,153296301,153300368,4067
1,1,X,153333946,153541192,207246
1,1,X,153333946,153623000,289054
1,1,X,153333946,153783638,449692
1,-1,X,153420154,153560505,140351
1,1,X,153576890,153998328,421438
1,-1,X,153787710,153964873,177163
-1,1,X,153908131,155232894,1324763
1,-1,X,154078083,154115785,37702
1,1,X,154117578,154553189,435611
-1,1,X,154120620,154565718,445098
-1,1,X,154250433,154317840,67407
1,-1,X,154556681,154577793,21112
1,-1,X,154556681,154577793,21112
1,-1,X,154556681,154577793,21112
1,-1,X,154672335,154679310,6975
1,-1,X,154672335,154722370,50035
1,-1,X,154672335,154722370,50035
1,-1,X,154722370,154776718,54348
1,-1,X,154736503,154842445,105942
1,-1,X,154739403,154776718,37315
-1,1,X,154762193,155232894,470701
-1,1,X,154929220,155251871,322651
-1,-1,X,154933719,155224707,290988
-1,-1,X,154933719,155224707,290988
-1,-1,X,154933719,155224707,290988
-1,-1,X,154933719,155246585,312866
-1,-1,X,154933719,155246585,312866
-1,-1,X,154933719,155246585,312866
-1,-1,X,154974667,155208354,233687
-1,-1,X,154974696,155226057,251361
-1,-1,X,155014787,155036311,21524
-1,-1,X,155014787,155036311,21524
-1,-1,X,155014787,155036311,21524
-1,-1,X,155029751,155232907,203156
1,-1,X,155118767,155250178,131411
-1,-1,X,155181535,155251871,70336
-1,-1,X,155181535,155251871,70336
-1,-1,X,155201393,155233992,32599
1,-1,X,155228918,155240563,11645
-1,-1,X,155231256,155251871,20615
-1,-1,X,155231256,155251871,20615
1,-1,X,155236606,155246585,9979
1,-1,X,155236606,155250178,13572
-1,-1,X,155236606,155255792,19186
1,-1,X,155236606,155255792,19186
1,-1,X,155236606,155255792,19186
-1,1,Y,10001,1292026,1282025
-1,1,Y,10679,15251375,15240696
-1,1,Y,10679,59354877,59344198
-1,1,Y,10701,1292026,1281325
-1,1,Y,10701,20063386,20052685
-1,1,Y,10701,59335913,59325212
-1,1,Y,10701,59335913,59325212
1,1,Y,10863,2620854,2609991
1,1,Y,10863,2620854,2609991
1,1,Y,10863,6115322,6104459
1,1,Y,10863,6115322,6104459
1,1,Y,10863,19571769,19560906
1,1,Y,10863,59363566,59352703
1,1,Y,10863,59363566,59352703
-1,-1,Y,20297,39498,19201
1,-1,Y,20297,39498,19201
1,-1,Y,20297,39498,19201
-1,-1,Y,20297,39498,19201
1,-1,Y,20297,39498,19201
1,-1,Y,20297,39498,19201
-1,-1,Y,20297,39498,19201
1,-1,Y,20297,39498,19201
-1,-1,Y,20297,39498,19201
1,-1,Y,20297,39498,19201
-1,-1,Y,20297,39498,19201
-1,-1,Y,20297,39498,19201
-1,-1,Y,20297,39498,19201
-1,-1,Y,20297,39498,19201
-1,-1,Y,20297,39498,19201
-1,-1,Y,20297,39498,19201
1,-1,Y,20297,39498,19201
1,-1,Y,20297,39498,19201
-1,-1,Y,20297,39498,19201
-1,-1,Y,20297,39498,19201
1,-1,Y,20297,39498,19201
-1,-1,Y,20297,39498,19201
1,-1,Y,20297,100002,79705
-1,1,Y,20297,593638,573341
-1,1,Y,20297,2640984,2620687
-1,1,Y,20297,59356174,59335877
-1,-1,Y,21267,39498,18231
1,1,Y,114504,59349650,59235146
1,-1,Y,126426,647169,520743
-1,1,Y,168546,1605584,1437038
-1,1,Y,168546,2058729,1890183
-1,1,Y,168546,28451874,28283328
-1,1,Y,286952,623541,336589
-1,1,Y,288874,59327713,59038839
-1,1,Y,469455,540957,71502
1,1,Y,474597,59095986,58621389
-1,1,Y,478512,574896,96384
-1,-1,Y,647169,1188257,541088
-1,-1,Y,731071,769170,38099
-1,-1,Y,731071,769170,38099
1,-1,Y,827633,1464209,636576
1,-1,Y,859049,1202522,343473
1,-1,Y,859049,1202522,343473
1,-1,Y,965836,1297283,331447
1,-1,Y,1060841,1533754,472913
-1,1,Y,1167123,59030571,57863448
1,-1,Y,1173372,1271581,98209
1,-1,Y,1743480,1892205,148725
1,-1,Y,2211474,2311399,99925
-1,1,Y,2650141,28799937,26149796
1,1,Y,2650313,19566674,16916361
1,1,Y,2650559,59032389,56381830
1,1,Y,2653804,2894892,241088
-1,1,Y,2654637,28722108,26067471
-1,1,Y,2654852,59031480,56376628
1,1,Y,2654852,59031480,56376628
1,1,Y,2654852,59031480,56376628
1,1,Y,2723745,26435098,23711353
1,1,Y,2934029,6094557,3160528
1,1,Y,2934029,6094557,3160528
1,1,Y,6123482,20597870,14474388
-1,1,Y,6138322,28609908,22471586
1,-1,Y,7153362,7640496,487134
1,-1,Y,7450517,7500739,50222
1,-1,Y,7450517,7500739,50222
1,-1,Y,9484809,9631997,147188
1,-1,Y,10005572,13197765,3192193
-1,1,Y,13134518,59336737,46202219
1,-1,Y,13272343,13871154,598811
1,-1,Y,13622055,13849453,227398
1,-1,Y,13675923,13745434,69511
1,-1,Y,13675923,13745434,69511
1,-1,Y,13675923,13848141,172218
1,-1,Y,13704922,13745434,40512
1,-1,Y,13704922,13745434,40512
1,-1,Y,13704922,13745434,40512
1,-1,Y,13704922,13745434,40512
1,-1,Y,13704922,13820061,115139
1,-1,Y,13704922,13820061,115139
1,-1,Y,13723022,13745434,22412
1,-1,Y,13723022,13745434,22412
1,-1,Y,13723022,13745434,22412
-1,1,Y,13870873,59335913,45465040
-1,1,Y,13871147,59336737,45465590
1,-1,Y,13992304,14389646,397342
1,-1,Y,14022441,14489087,466646
-1,1,Y,14521194,28307254,13786060
1,1,Y,14814859,28799937,13985078
-1,1,Y,14844481,16824498,1980017
-1,1,Y,15077631,59358798,44281167
-1,1,Y,15415024,59349591,43934567
1,-1,Y,15704763,16059952,355189
1,-1,Y,15744612,16023278,278666
1,-1,Y,15991426,16166538,175112
1,1,Y,16020740,24504676,8483936
1,-1,Y,16077897,16166538,88641
1,-1,Y,16099893,16104120,4227
1,-1,Y,16099893,16393891,293998
1,-1,Y,16162322,16188682,26360
-1,1,Y,16174765,59335913,43161148
-1,1,Y,16188682,59311360,43122678
1,-1,Y,17112219,17636880,524661
1,-1,Y,17116826,17630471,513645
1,-1,Y,17271029,17284349,13320
-1,1,Y,17743696,59357161,41613465
1,-1,Y,18274705,18555560,280855
-1,1,Y,18423451,59336737,40913286
1,-1,Y,19363636,21311821,1948185
1,-1,Y,19419098,21251249,1832151
-1,1,Y,19758763,28311693,8552930
-1,-1,Y,19948055,20229152,281097
-1,-1,Y,19950655,20231722,281067
1,-1,Y,20626494,20700103,73609
-1,1,Y,20707618,59335913,38628295
-1,1,Y,20805226,59336998,38531772
1,-1,Y,20944017,21017616,73599
1,-1,Y,20961386,21026254,64868
1,-1,Y,21053353,21412851,359498
-1,1,Y,21053353,59354877,38301524
1,-1,Y,22529253,22559512,30259
1,-1,Y,23654028,24201753,547725
-1,-1,Y,23657252,23710797,53545
1,-1,Y,23657252,23710797,53545
1,-1,Y,23657252,23710797,53545
1,-1,Y,23657252,23710797,53545
1,-1,Y,23659141,23710797,51656
1,-1,Y,23663589,23699532,35943
1,-1,Y,23663589,23699532,35943
1,-1,Y,23663717,23699532,35815
-1,-1,Y,24044065,24884056,839991
-1,-1,Y,24026594,24068956,42362
1,-1,Y,24026594,24068956,42362
1,-1,Y,24026594,24068956,42362
1,-1,Y,24026594,24068956,42362
1,-1,Y,24037845,24068956,31111
1,-1,Y,24037845,24068956,31111
1,-1,Y,24037904,24069015,31111
1,-1,Y,24073913,25516121,1442208
-1,1,Y,24073794,59336737,35262943
1,-1,Y,24073920,24238124,164204
-1,1,Y,24073920,24640516,566596
-1,1,Y,24073920,28279159,4205239
1,-1,Y,24073920,28279159,4205239
-1,-1,Y,24082686,24884056,801370
-1,-1,Y,24092746,24884056,791310
-1,-1,Y,24092746,24884056,791310
-1,-1,Y,24092746,24884056,791310
-1,-1,Y,24092746,24884056,791310
-1,-1,Y,24092746,24928129,835383
-1,-1,Y,24100109,24238124,138015
1,-1,Y,24100109,24238124,138015
-1,-1,Y,24105967,24884056,778089
-1,1,Y,24108372,59358798,35250426
1,-1,Y,24121709,24238124,116415
1,-1,Y,24121709,24238124,116415
1,-1,Y,24138858,24238124,99266
-1,-1,Y,24239391,24639309,399918
1,-1,Y,24245628,24310366,64738
1,-1,Y,24315060,24332210,17150
1,-1,Y,24355423,24468107,112684
-1,-1,Y,24371278,24504817,133539
1,-1,Y,24371478,24504676,133198
1,-1,Y,24371478,24504676,133198
1,-1,Y,24371478,24504676,133198
1,-1,Y,24546458,24563613,17155
1,-1,Y,24568307,24636946,68639
1,-1,Y,24636917,25507194,870277
1,-1,Y,24639250,25290695,651445
1,-1,Y,24639250,25504031,864781
1,-1,Y,24639250,25602807,963557
-1,-1,Y,24639250,28362288,3723038
-1,-1,Y,24640516,25504031,863515
1,-1,Y,24640516,25504031,863515
-1,-1,Y,24640516,25504031,863515
1,-1,Y,24640516,25504031,863515
1,-1,Y,24640516,25504031,863515
1,-1,Y,24640516,25554346,913830
1,-1,Y,24640516,26282422,1641906
1,-1,Y,24640516,26282422,1641906
1,-1,Y,24640516,26282422,1641906
1,-1,Y,24640516,26282422,1641906
1,-1,Y,24640516,28469464,3828948
1,-1,Y,24640516,59363566,34723050
1,-1,Y,24648785,25290695,641910
1,-1,Y,24648785,25504031,855246
1,-1,Y,24648785,25504031,855246
1,-1,Y,24648785,25504031,855246
1,-1,Y,24648785,25543954,895169
1,-1,Y,24648785,25602807,954022
1,-1,Y,24648785,25602807,954022
1,-1,Y,24648785,26276087,1627302
1,-1,Y,24648785,26276087,1627302
1,-1,Y,24648785,26282422,1633637
1,-1,Y,24648785,26282422,1633637
1,-1,Y,24648785,26420387,1771602
1,-1,Y,24648785,27593899,2945114
1,-1,Y,24648785,28455771,3806986
1,-1,Y,24648785,25290695,641910
1,-1,Y,24648785,25290695,641910
1,-1,Y,24648785,59363566,34714781
1,-1,Y,24650933,25602807,951874
-1,-1,Y,24811900,25504031,692131
-1,-1,Y,24873007,25203027,330020
-1,-1,Y,24873007,25206309,333302
-1,-1,Y,24873007,25288251,415244
-1,-1,Y,24873007,25496928,623921
1,-1,Y,24873007,25502911,629904
-1,-1,Y,24873007,25504031,631024
-1,-1,Y,24873007,25504031,631024
1,-1,Y,24873007,25504031,631024
-1,-1,Y,24873007,25504031,631024
-1,-1,Y,24873007,25504031,631024
-1,-1,Y,24873007,25504031,631024
-1,-1,Y,24873007,25504031,631024
-1,-1,Y,24873007,25504031,631024
-1,-1,Y,24873007,25504031,631024
-1,-1,Y,24873007,25504031,631024
1,-1,Y,24873007,25504031,631024
-1,-1,Y,24873007,25504031,631024
-1,-1,Y,24873007,25504031,631024
-1,-1,Y,24873007,25504031,631024
-1,-1,Y,24873007,25504031,631024
-1,-1,Y,24873007,25504031,631024
-1,-1,Y,24873007,25504031,631024
-1,-1,Y,24873007,25504031,631024
-1,-1,Y,24873007,25504031,631024
-1,-1,Y,24873007,25286966,413959
1,-1,Y,24873007,59363566,34490559
-1,-1,Y,24873007,59363566,34490559
-1,-1,Y,24873007,59363566,34490559
-1,-1,Y,24873007,59363566,34490559
-1,1,Y,24873150,27895495,3022345
-1,1,Y,24873150,27895495,3022345
-1,1,Y,24873150,27895495,3022345
1,-1,Y,24895192,25504031,608839
1,-1,Y,24895192,25577351,682159
1,-1,Y,24895192,26273887,1378695
1,-1,Y,24895192,26298568,1403376
1,-1,Y,24895192,26420387,1525195
1,-1,Y,24895192,28455771,3560579
1,-1,Y,24901458,25504031,602573
1,-1,Y,24901458,25504031,602573
1,-1,Y,24901458,25577351,675893
1,-1,Y,24901458,25597267,695809
1,-1,Y,24901458,26282422,1380964
1,-1,Y,24901458,28455771,3554313
1,-1,Y,24901458,28455771,3554313
1,-1,Y,24895251,59032329,34137078
1,-1,Y,24908983,25507194,598211
1,-1,Y,24908983,26276087,1367104
1,-1,Y,24942529,25554346,611817
1,-1,Y,24942529,25602807,660278
1,-1,Y,24942529,28455771,3513242
1,-1,Y,24947707,25504031,556324
1,-1,Y,24947707,26298568,1350861
1,-1,Y,24956669,25504031,547362
1,-1,Y,24956669,25504031,547362
1,-1,Y,24956669,25543954,587285
1,-1,Y,24956669,25543954,587285
1,-1,Y,24958833,25543954,585121
1,-1,Y,24958833,25602807,643974
1,-1,Y,24958833,26276087,1317254
1,-1,Y,24958833,26276087,1317254
1,-1,Y,24958833,59363566,34404733
1,-1,Y,25037661,26282422,1244761
1,-1,Y,25081036,25602807,521771
1,-1,Y,25081036,26276087,1195051
1,-1,Y,25081036,26276087,1195051
-1,-1,Y,25208967,25496928,287961
-1,-1,Y,25208967,25496928,287961
-1,-1,Y,25208967,25496928,287961
-1,-1,Y,25208967,25504031,295064
-1,-1,Y,25208967,25504031,295064
-1,-1,Y,25208967,25504031,295064
-1,-1,Y,25208967,25504031,295064
-1,-1,Y,25208967,25504031,295064
-1,-1,Y,25208967,25504031,295064
-1,-1,Y,25208967,25507194,298227
-1,-1,Y,25208967,25507194,298227
-1,-1,Y,25208967,25507194,298227
-1,-1,Y,25208967,25507194,298227
-1,-1,Y,25208967,25507194,298227
-1,-1,Y,25208967,25507194,298227
-1,-1,Y,25208967,25507194,298227
-1,-1,Y,25208967,25507194,298227
-1,-1,Y,25208967,25507194,298227
-1,-1,Y,25208967,25507194,298227
-1,-1,Y,25208967,25507194,298227
-1,-1,Y,25208967,25507194,298227
-1,-1,Y,25208967,25507194,298227
-1,-1,Y,25208967,25507194,298227
-1,-1,Y,25208967,25507194,298227
-1,-1,Y,25208967,25507194,298227
-1,-1,Y,25208967,25507194,298227
-1,-1,Y,25208967,25507194,298227
-1,-1,Y,25208967,25507194,298227
-1,-1,Y,25208967,25507194,298227
-1,-1,Y,25208967,25507194,298227
-1,-1,Y,25208967,25510310,301343
-1,-1,Y,25208967,25510310,301343
-1,-1,Y,25208967,25510310,301343
-1,-1,Y,25208967,25510310,301343
-1,-1,Y,25208967,25510310,301343
-1,-1,Y,25208967,25510310,301343
-1,-1,Y,25208967,25510310,301343
-1,-1,Y,25208967,25510310,301343
1,-1,Y,25208967,25723051,514084
-1,-1,Y,25206309,59363566,34157257
-1,-1,Y,25208967,59363566,34154599
-1,-1,Y,25208967,59363566,34154599
-1,-1,Y,25270777,25496928,226151
-1,-1,Y,25270777,25507194,236417
-1,-1,Y,25270777,25510310,239533
-1,-1,Y,25273111,25507194,234083
-1,-1,Y,25273111,25507194,234083
-1,-1,Y,25273111,25510310,237199
-1,-1,Y,25273883,27028530,1754647
-1,-1,Y,25278883,27028530,1749647
1,-1,Y,25315779,26276087,960308
1,-1,Y,25340039,26276087,936048
1,-1,Y,25342141,26298568,956427
1,-1,Y,25376473,26276087,899614
1,-1,Y,25410388,26276087,865699
1,-1,Y,25410388,26298568,888180
1,-1,Y,25410388,26307414,897026
1,-1,Y,25410388,26276087,865699
1,-1,Y,25410388,26307414,897026
-1,-1,Y,25606503,25847864,241361
-1,-1,Y,25606503,25847864,241361
-1,-1,Y,25606503,25847864,241361
1,-1,Y,25617277,26276087,658810
1,-1,Y,25617277,26276087,658810
1,-1,Y,25617277,26282422,665145
1,-1,Y,25617277,26282422,665145
1,-1,Y,25617277,26298568,681291
1,-1,Y,25617277,26319203,701926
1,-1,Y,25617277,26928360,1311083
1,-1,Y,25617277,28342367,2725090
-1,-1,Y,25620538,25847864,227326
-1,-1,Y,25620538,25847864,227326
-1,-1,Y,25620538,25847864,227326
-1,-1,Y,25620538,25847864,227326
1,-1,Y,25620538,26276087,655549
1,-1,Y,25620538,26282422,661884
1,-1,Y,25620538,26282422,661884
1,-1,Y,25620538,26298568,678030
-1,-1,Y,25620538,27427269,1806731
1,-1,Y,25620538,27593899,1973361
1,-1,Y,25620538,27593899,1973361
-1,-1,Y,25620538,28342367,2721829
1,-1,Y,25620538,28455771,2835233
1,-1,Y,25620538,26298568,678030
1,-1,Y,25628928,26298568,669640
1,-1,Y,25655654,26303185,647531
-1,-1,Y,25720771,26189897,469126
-1,-1,Y,25847805,26139515,291710
-1,-1,Y,25847805,26139515,291710
1,-1,Y,25847805,26357153,509348
-1,-1,Y,25850195,26139515,289320
-1,-1,Y,25850195,26139515,289320
-1,-1,Y,25850195,26139515,289320
1,-1,Y,25850195,28112172,2261977
-1,-1,Y,25857684,26139515,281831
-1,-1,Y,25857684,26139515,281831
-1,-1,Y,25857684,26139515,281831
-1,-1,Y,25857684,26139515,281831
-1,-1,Y,25857684,26139515,281831
-1,-1,Y,25857684,26139515,281831
-1,-1,Y,25857684,26139515,281831
-1,-1,Y,25857684,26139515,281831
-1,-1,Y,25857684,26139515,281831
-1,-1,Y,25857684,26139515,281831
-1,-1,Y,25857684,26139515,281831
-1,-1,Y,25857684,26176817,319133
-1,-1,Y,25857684,26189897,332213
-1,-1,Y,25857684,26282422,424738
-1,-1,Y,25873834,26139515,265681
-1,-1,Y,25873834,26139515,265681
-1,-1,Y,25873834,26139515,265681
-1,-1,Y,25873834,26139515,265681
-1,-1,Y,25873834,26139515,265681
-1,-1,Y,25873834,26139515,265681
-1,-1,Y,25873834,26139515,265681
-1,-1,Y,25873834,26139515,265681
-1,-1,Y,25873834,26139515,265681
-1,-1,Y,25873834,26139515,265681
-1,-1,Y,25873834,26139515,265681
-1,-1,Y,25873834,26139515,265681
-1,-1,Y,25873834,26139515,265681
-1,-1,Y,25873834,26139515,265681
-1,-1,Y,25873834,26139515,265681
-1,-1,Y,25873834,26139515,265681
-1,-1,Y,25873834,26139515,265681
-1,-1,Y,25873834,26139515,265681
-1,-1,Y,25873834,26139515,265681
-1,-1,Y,25873834,26139515,265681
-1,-1,Y,25873834,26139515,265681
-1,-1,Y,25873834,26139515,265681
-1,-1,Y,25873834,26139515,265681
-1,-1,Y,25873834,26139515,265681
-1,-1,Y,25873834,26139515,265681
-1,-1,Y,25873834,26139515,265681
-1,-1,Y,25873834,26139515,265681
-1,-1,Y,25873834,26139515,265681
-1,-1,Y,25873834,26139515,265681
-1,-1,Y,25873834,26139515,265681
-1,-1,Y,25873834,26139515,265681
-1,-1,Y,25873834,26139515,265681
-1,-1,Y,25873834,26139515,265681
-1,-1,Y,25873834,26139515,265681
-1,-1,Y,25873834,26139515,265681
-1,-1,Y,25873834,26139515,265681
-1,-1,Y,25873834,26139515,265681
-1,-1,Y,25873834,26139515,265681
-1,-1,Y,25873834,26139515,265681
-1,-1,Y,25873834,26139515,265681
-1,-1,Y,25873834,26139515,265681
-1,-1,Y,25873834,26139515,265681
-1,-1,Y,25873834,26139515,265681
-1,-1,Y,25873834,26139515,265681
-1,-1,Y,25873834,26139515,265681
-1,-1,Y,25873834,26189897,316063
-1,-1,Y,25873834,26191446,317612
-1,-1,Y,25873834,26282422,408588
-1,-1,Y,25876504,26139515,263011
-1,-1,Y,25876504,26139515,263011
1,-1,Y,26458730,27449144,990414
1,-1,Y,26465961,27444389,978428
1,-1,Y,26465961,27496483,1030522
1,-1,Y,26473026,27422045,949019
1,-1,Y,26473026,27444389,971363
1,-1,Y,26473026,27699439,1226413
1,-1,Y,26473026,28455771,1982745
1,-1,Y,26493944,27444389,950445
1,-1,Y,26493944,28455771,1961827
1,-1,Y,26502929,27444389,941460
1,-1,Y,26502929,27455478,952549
1,-1,Y,26502929,27455478,952549
1,-1,Y,26509175,27449144,939969
1,-1,Y,26513288,27427269,913981
1,-1,Y,26513288,27427269,913981
1,-1,Y,26513288,27449144,935856
1,-1,Y,26513288,27449144,935856
1,-1,Y,26513288,27449144,935856
1,-1,Y,26513288,27449144,935856
-1,-1,Y,26518043,26943549,425506
-1,-1,Y,26518043,27444389,926346
-1,-1,Y,26518043,27444389,926346
1,-1,Y,26518043,27449144,931101
-1,-1,Y,26528959,26840055,311096
-1,-1,Y,26528959,27427269,898310
-1,-1,Y,26528959,27427269,898310
-1,-1,Y,26528959,27427269,898310
-1,-1,Y,26528959,27433474,904515
-1,-1,Y,26528959,27433474,904515
-1,-1,Y,26528959,27433474,904515
-1,-1,Y,26528959,27433474,904515
1,-1,Y,26528959,27433474,904515
-1,-1,Y,26528959,27433474,904515
-1,-1,Y,26528959,27433474,904515
1,-1,Y,26528959,27433474,904515
-1,-1,Y,26528959,27433474,904515
-1,-1,Y,26528959,27433474,904515
-1,-1,Y,26528959,27433474,904515
1,-1,Y,26528959,27433474,904515
-1,-1,Y,26528959,27433474,904515
-1,-1,Y,26528959,27444389,915430
1,-1,Y,26528959,27455478,926519
-1,-1,Y,26535221,26920686,385465
1,-1,Y,26535221,27419680,884459
1,-1,Y,26535221,27422045,886824
1,-1,Y,26535221,27427269,892048
-1,-1,Y,26535221,27427269,892048
1,-1,Y,26535221,27427269,892048
1,-1,Y,26535221,27427269,892048
-1,-1,Y,26535221,27427269,892048
-1,-1,Y,26535221,27427269,892048
1,-1,Y,26535221,27427269,892048
-1,-1,Y,26535221,27427269,892048
-1,-1,Y,26535221,27427269,892048
-1,-1,Y,26535221,27427269,892048
1,-1,Y,26535221,27433474,898253
1,-1,Y,26535221,27593899,1058678
1,-1,Y,26551784,27386140,834356
1,-1,Y,26551784,27427269,875485
1,-1,Y,26551784,27444389,892605
1,-1,Y,26561760,27400648,838888
1,-1,Y,26561760,27449144,887384
1,-1,Y,26576268,27247605,671337
1,-1,Y,26576268,27371986,795718
1,-1,Y,26576268,27386140,809872
1,-1,Y,26576268,27386140,809872
1,-1,Y,26576268,27386140,809872
1,-1,Y,26576268,27386140,809872
1,-1,Y,26576268,27400648,824380
1,-1,Y,26576268,27427269,851001
1,-1,Y,26576268,27444389,868121
1,-1,Y,26576268,27449144,872876
1,-1,Y,26576268,27449144,872876
1,-1,Y,26578698,27383710,805012
1,-1,Y,26581462,27427269,845807
1,-1,Y,26590418,27386140,795722
1,-1,Y,26590418,27400648,810230
1,-1,Y,26714783,27380942,666159
1,-1,Y,26714783,27386140,671357
1,-1,Y,26714783,27449144,734361
-1,-1,Y,26842712,27112587,269875
-1,-1,Y,26842712,27112587,269875
-1,-1,Y,26842712,27112587,269875
-1,-1,Y,26842712,27112587,269875
-1,-1,Y,26842712,27112587,269875
-1,-1,Y,26842712,27112587,269875
-1,-1,Y,26842712,27112587,269875
-1,-1,Y,26842712,27112587,269875
-1,-1,Y,26842712,27119690,276978
-1,-1,Y,26842712,27119690,276978
-1,-1,Y,26842712,27119690,276978
-1,-1,Y,26842712,27119690,276978
-1,-1,Y,26842712,27119690,276978
-1,-1,Y,26842712,27119690,276978
-1,-1,Y,26842712,27119690,276978
-1,-1,Y,26842712,27119690,276978
-1,-1,Y,26842712,27119690,276978
-1,-1,Y,26842712,27119690,276978
-1,-1,Y,26842712,27119690,276978
-1,-1,Y,26842712,27119690,276978
-1,-1,Y,26842712,27119690,276978
-1,-1,Y,26842712,27119690,276978
-1,-1,Y,26842712,27119690,276978
-1,-1,Y,26842712,27119690,276978
-1,-1,Y,26842712,27119690,276978
-1,-1,Y,26842712,27119690,276978
-1,-1,Y,26842712,27119690,276978
-1,-1,Y,26842712,27119690,276978
-1,-1,Y,26842712,27119690,276978
-1,-1,Y,26842712,27119690,276978
-1,-1,Y,26842712,27119690,276978
-1,-1,Y,26842712,27119690,276978
-1,-1,Y,26842712,27119690,276978
-1,-1,Y,26842712,27119690,276978
-1,-1,Y,26842712,27119690,276978
-1,-1,Y,26842712,27119690,276978
-1,-1,Y,26842712,27119690,276978
-1,-1,Y,26842712,27119690,276978
-1,-1,Y,26842712,27119690,276978
-1,-1,Y,26842712,27119690,276978
-1,-1,Y,26842712,27119690,276978
-1,-1,Y,26842712,27119690,276978
-1,-1,Y,26842712,27119690,276978
-1,-1,Y,26842712,27119690,276978
-1,-1,Y,26842712,27119690,276978
-1,-1,Y,26842712,27119690,276978
-1,-1,Y,26842712,27173910,331198
1,-1,Y,26868357,27422045,553688
-1,-1,Y,26910196,27112587,202391
-1,-1,Y,27000949,27433474,432525
1,-1,Y,27028442,28455771,1427329
-1,-1,Y,27041717,27444389,402672
-1,-1,Y,27122348,27433474,311126
1,-1,Y,27606702,28342367,735665
1,-1,Y,27606702,28455771,849069
1,-1,Y,27643237,28455771,812534
1,-1,Y,27655024,28455771,800747
1,-1,Y,27655024,28455771,800747
1,-1,Y,27655024,28455771,800747
1,-1,Y,27659235,28455771,796536
1,-1,Y,27663870,28342367,678497
1,-1,Y,27663870,28455771,791901
1,-1,Y,27663870,28455771,791901
1,-1,Y,27663870,28455771,791901
1,-1,Y,27663870,28455771,791901
1,-1,Y,27663870,28455771,791901
1,-1,Y,27663870,28455771,791901
1,-1,Y,27663870,28455771,791901
1,-1,Y,27663870,28455771,791901
1,-1,Y,27663870,28455771,791901
1,-1,Y,27663870,28455771,791901
1,-1,Y,27663870,28455771,791901
1,-1,Y,27663870,28455771,791901
1,-1,Y,27663870,28455771,791901
1,-1,Y,27663870,28455771,791901
1,-1,Y,27663870,28455771,791901
1,-1,Y,27663870,28455771,791901
1,-1,Y,27663870,28455771,791901
1,-1,Y,27663870,28455771,791901
1,-1,Y,27663870,28455771,791901
1,-1,Y,27663870,28455771,791901
1,-1,Y,27663870,28455771,791901
1,-1,Y,27663870,28455771,791901
1,-1,Y,27663870,28727756,1063886
1,-1,Y,27663870,28727756,1063886
1,-1,Y,27663870,28727756,1063886
1,-1,Y,27672705,28291566,618861
1,-1,Y,27672705,28342367,669662
1,-1,Y,27672705,28342367,669662
1,-1,Y,27672705,28345628,672923
1,-1,Y,27672705,28455771,783066
1,-1,Y,27672705,28455771,783066
1,-1,Y,27672705,28455771,783066
1,-1,Y,27672705,28455771,783066
1,-1,Y,27672705,28455771,783066
1,-1,Y,27672705,28609908,937203
-1,-1,Y,27680011,27992745,312734
-1,-1,Y,27680011,28088551,408540
-1,-1,Y,27680011,28342367,662356
1,-1,Y,27680011,28342367,662356
1,-1,Y,27680011,28455771,775760
1,-1,Y,27680011,28455771,775760
1,-1,Y,27680011,28455771,775760
1,-1,Y,27680011,28455771,775760
1,-1,Y,27680011,28455771,775760
1,-1,Y,27686344,28455771,769427
1,-1,Y,27686344,28455771,769427
-1,-1,Y,27772528,28088551,316023
-1,-1,Y,27772528,28088551,316023
-1,-1,Y,27772528,28088551,316023
-1,-1,Y,27792217,27992745,200528
-1,-1,Y,27792217,27992745,200528
-1,-1,Y,27792217,27992745,200528
-1,-1,Y,27792217,27992745,200528
-1,-1,Y,27792217,27992745,200528
-1,-1,Y,27792217,27992745,200528
-1,-1,Y,27792217,27992745,200528
-1,-1,Y,27792217,27992745,200528
-1,-1,Y,27792217,27992745,200528
-1,-1,Y,27792217,28088551,296334
-1,-1,Y,27792217,28088551,296334
-1,-1,Y,27792217,28088551,296334
-1,-1,Y,27792217,28088551,296334
-1,-1,Y,27792217,28088551,296334
-1,-1,Y,27792217,28088551,296334
-1,-1,Y,27792217,28088551,296334
-1,-1,Y,27792217,28088551,296334
-1,-1,Y,27792217,28088551,296334
-1,-1,Y,27792217,28088551,296334
-1,-1,Y,27792217,28088551,296334
-1,-1,Y,27792217,28088551,296334
-1,-1,Y,27792217,28088551,296334
-1,-1,Y,27792217,28088551,296334
-1,-1,Y,27792217,28088551,296334
-1,-1,Y,27792217,28088551,296334
-1,-1,Y,27792217,28088551,296334
-1,-1,Y,27792217,28088551,296334
-1,-1,Y,27792217,28088551,296334
-1,-1,Y,27792217,28088551,296334
-1,-1,Y,27792217,28088551,296334
-1,-1,Y,27792217,28088551,296334
-1,-1,Y,27792217,28088551,296334
-1,-1,Y,27792217,28088551,296334
-1,-1,Y,27792217,28088551,296334
-1,-1,Y,27792217,28088551,296334
-1,-1,Y,27792217,28088551,296334
-1,-1,Y,27792217,28088551,296334
-1,-1,Y,27792217,28088551,296334
-1,-1,Y,27792217,28088551,296334
-1,-1,Y,27792217,28088551,296334
-1,-1,Y,27792217,28088551,296334
-1,-1,Y,27792217,28088551,296334
-1,-1,Y,27792217,28088551,296334
-1,-1,Y,27792217,28104707,312490
-1,-1,Y,27792217,28104707,312490
-1,-1,Y,27792217,28104707,312490
-1,-1,Y,27792217,28104707,312490
-1,-1,Y,27792217,28112172,319955
-1,-1,Y,27792217,28112172,319955
-1,-1,Y,27809091,28088551,279460
-1,-1,Y,27809091,28088551,279460
-1,-1,Y,27809091,28088551,279460
-1,-1,Y,27809091,28112172,303081
-1,-1,Y,27809091,28114563,305472
-1,-1,Y,27822921,28088551,265630
-1,-1,Y,27822921,28088551,265630
-1,-1,Y,27822921,28088551,265630
-1,-1,Y,27822921,28088551,265630
-1,-1,Y,27822921,28088551,265630
-1,-1,Y,27822921,28104707,281786
-1,-1,Y,27822921,28114563,291642
-1,-1,Y,27822921,28114563,291642
-1,-1,Y,28114504,28342367,227863
-1,-1,Y,28114504,28342367,227863
-1,-1,Y,28114504,28342367,227863
-1,-1,Y,28114504,28345628,231124
-1,-1,Y,28114504,28345628,231124
1,-1,Y,28321432,59079469,30758037
1,-1,Y,28393720,59028689,30634969
-1,-1,Y,28536083,59354877,30818794
1,-1,Y,28548467,58968344,30419877
1,-1,Y,28555864,59077471,30521607
1,-1,Y,28555864,59079469,30523605
1,-1,Y,28609908,59077471,30467563
1,-1,Y,28609908,59079469,30469561
1,-1,Y,28609908,59079469,30469561
1,-1,Y,28629836,58968344,30338508
1,-1,Y,28629836,58968344,30338508
1,-1,Y,28629836,59032329,30402493
1,-1,Y,28629836,59077471,30447635
1,-1,Y,28629836,59079469,30449633
1,-1,Y,28629836,59088015,30458179
1,-1,Y,28629836,59088015,30458179
1,-1,Y,28629836,59088015,30458179
1,-1,Y,28673402,58968344,30294942
1,-1,Y,28673402,58968344,30294942
1,-1,Y,28673402,58968344,30294942
1,-1,Y,28673402,58968344,30294942
1,-1,Y,28673402,58968344,30294942
1,-1,Y,28673402,59019002,30345600
1,-1,Y,28673402,59028689,30355287
1,-1,Y,28673402,59028689,30355287
1,-1,Y,28673402,59032329,30358927
1,-1,Y,28673402,59077471,30404069
1,-1,Y,28673402,59079469,30406067
1,-1,Y,28673402,59079469,30406067
1,-1,Y,28673402,59079469,30406067
1,-1,Y,28673402,59079469,30406067
1,-1,Y,28673402,59079469,30406067
1,-1,Y,28673402,59088015,30414613
1,-1,Y,28673402,59088015,30414613
1,-1,Y,28673402,59088015,30414613
1,-1,Y,28689355,58968344,30278989
1,-1,Y,28689355,59088015,30398660
1,-1,Y,28703883,59032329,30328446
1,-1,Y,28703883,59077471,30373588
1,-1,Y,28703883,59077471,30373588
1,-1,Y,28703883,59077471,30373588
1,-1,Y,28703883,59079469,30375586
1,-1,Y,28703883,59079469,30375586
1,-1,Y,28703883,59079469,30375586
1,-1,Y,28703883,59088015,30384132
1,-1,Y,28703883,59088015,30384132
1,-1,Y,28703883,59088015,30384132
-1,-1,Y,28768132,58968344,30200212
1,-1,Y,28776663,59001403,30224740
1,-1,Y,28776663,59032329,30255666
1,-1,Y,28776663,59077471,30300808
-1,-1,Y,28784029,59178329,30394300
1,-1,Y,58969260,58995640,26380
1,-1,Y,58983344,58995640,12296
1,-1,Y,58983344,58995640,12296
-1,-1,Y,58983344,59358798,375454
-1,-1,Y,59002344,59031421,29077
1,-1,Y,59002344,59031480,29136
1,-1,Y,59002344,59031480,29136
-1,-1,Y,59028692,59349591,320899
1,1,Y,59077471,59329063,251592
1,1,Y,59077471,59349650,272179
-1,-1,Y,59033287,59363566,330279
-1,-1,Y,59036725,59327713,290988
-1,-1,Y,59036725,59327713,290988
-1,-1,Y,59036725,59327713,290988
-1,-1,Y,59036725,59349591,312866
1,-1,Y,59036725,59358798,322073
-1,-1,Y,59049836,59354877,305041
-1,-1,Y,59049836,59354877,305041
-1,-1,Y,59049836,59354877,305041
-1,-1,Y,59077673,59335913,258240
-1,-1,Y,59117793,59139317,21524
-1,-1,Y,59138674,59313102,174428
-1,-1,Y,59138674,59354877,216203
-1,-1,Y,59138674,59354877,216203
-1,-1,Y,59304399,59336998,32599
1,-1,Y,59331924,59343569,11645