chr,start,end,size,gain_loss,pathogenicity,genes_in_proximity,number_of_genes_in_proximity,gene_density
chr16,28837450,29042118,204668,1,1,11273;27040;79874;7284;930;84901;487;83985;25970,9,4.39736548947564000000
chr2,1944993,2285993,341000,1,1,23040,1,0.29325513196480900000
chr21,15538980,15925852,386872,1,1,149998;54033;64092;6782,4,1.03393370417089000000
chr10,123150811,135380935,12230124,1,1,196792;253738;1755;8433;399818;5791;282973;50632;10570;1793;340784;4942;54780;7390;594857;119467;196743;118663;9184;1571;84435;503542;10844;80313;256536;8038;4288;5654;92170;36;118471;51363;170394;55844;54777;118670;4255;399823;1488;118611;11101;2849;85442;387718;27287;118672;59338;2263;55760;282974;54764;664;282969;56647;119587;118856;101;1892;23172;80007;3167;642938;387715;10579;10539;118472;9679;3632;64376;84504;26098;50624;92565;399814;390010;64077;93426,77,0.62959296242621900000
chr10,102969339,103407534,438195,1,1,27343;8945;6468;10660;25911,5,1.14104451214642000000
chr22,23717624,24264805,547181,1,1,266747;4320;4282;3543;7621;51233;6598;66035;29802;400916;150248;91319,12,2.19305860400855000000
chr19,30379880,32843746,2463866,1,1,57616;8725;9745;22847;100507527,5,0.20293311405733900000
chr13,93422696,95020009,1597313,1,1,10082;2262,2,0.12521027500558800000
chr6,162828496,163217807,389311,1,1,135138;5071,2,0.51372809912897400000
chr16,14910228,16127848,1217620,1,1,4629;100288332;123811;89927;4363;9284;54820;23420;255027;23042;54700;123803;9665,13,1.06765657594323000000
chr2,37843822,49189860,11346038,1,1,27436;79833;678;90411;9655;170850;57504;11037;388946;9419;64225;729967;129285;2492;5495;10128;286749;130589;2956;8491;805;285051;3973;130271;6546;92906;6654;91461;90423;100271715;55133;5581;400950;9167;151393;80204;4436;80745;9581;64241;728819;1545;79823;2034;165140;63892;23433;5281;10602;11036;51626;6432;6496;4072;57217;23498;130733;64240;344387;6519;10736;90957;56660;3344,64,0.56407355589678100000
chr19,52092087,53759581,1667494,1,1,90338;80110;7728;2357;90333;90321;162967;9668;388559;162962;100049587;388558;100529240;284370;5518;3036;2359;162963;284371;84436;55762;59348;79788;125893;8778;84765;400713;162966;342926;2358;84671;90317;81856;55769;147657;65251;7576;79898;100271846;147660;55786;147650;147658;147664,44,2.63869015420745000000
chr12,191619,8327369,8135750,1,1,4704;144195;55846;10436;25977;2784;51279;57101;6337;1822;171017;9332;654429;83461;928;50856;5927;920;57121;79923;55080;55810;10233;715;283358;894;1108;5763;81029;2251;83695;775;84318;3736;50813;55200;170482;10867;3902;9918;7450;5777;196513;4908;27239;83758;9573;57097;3741;7167;7132;11331;283316;341392;5893;2288;51147;84519;84727;6540;84766;2597;7289;83714;93589;5830;939;57102;8798;10566;10635;6843;8078;8079;26290;113246;7004;440073;6539;56341;10536;4055;4839;359787;196500;6515;719;2305;4815;716;51258;9746;144699;10162;360030;8074;25900;65125;440077;339;23085;3742;57103;79602;2026,105,1.29060012906001000000
chr1,145413388,145747269,333881,1,1,148738;128077;10401;200035;27246;84265;284615;9939;11126;8515;148741;10628;10623;8799;5174,15,4.49261862759486000000
chr11,3940257,4272871,332614,1,1,6240;6786,2,0.60129760022127800000
chr19,54635055,54911129,276074,1,1,11025;79143;4849;6203;147798;26121;10288;79165;3903;79042;23547;10990,12,4.34666067793418000000
chr14,103261041,103838966,577925,1,1,81693;91828;7127;9578;1983;7187;107984640,7,1.21122983086041000000
chr14,102548357,102774090,225733,1,1,5891;91833;3320,3,1.32900373450049000000
chr16,28837450,29042118,204668,1,1,11273;27040;79874;7284;930;84901;487;83985;25970,9,4.39736548947564000000
chr7,6316522,6714612,398090,1,1,55146;54753;5879;392862;79034;221955;100131017;84792;11014,9,2.26079529754578000000
chrY,11091,59335913,59324822,1,1,1617;6845;286530;378948;83259;7258;159163;8287;9426;86614;57055;8227;8284;207063;100289087;378950;5940;442867;100533178;10251;28227;7404;728395;57135;378951;9081;438;9084;378949;9086;203611;9085;353515;728403;4267;442868;293;9189;3581;140032;57054;90665;90655;3563;6192;8653;353513;64591;728137;22829;159119;7544;6736;8225;9082;8623;442862;9087;266;6473;1438;9083;64109;55344;253175,65,0.10956627901892400000
chrY,11091,59335913,59324822,1,1,1617;6845;286530;378948;83259;7258;159163;8287;9426;86614;57055;8227;8284;207063;100289087;378950;5940;442867;100533178;10251;28227;7404;728395;57135;378951;9081;438;9084;378949;9086;203611;9085;353515;728403;4267;442868;293;9189;3581;140032;57054;90665;90655;3563;6192;8653;353513;64591;728137;22829;159119;7544;6736;8225;9082;8623;442862;9087;266;6473;1438;9083;64109;55344;253175,65,0.10956627901892400000
chr16,15048751,16267306,1218555,1,1,4629;100288332;123811;89927;4363;54820;368;255027;23042;54700;123803;9665,12,0.98477294828711100000
chr1,239983019,242987796,3004777,1,1,6000;128025;64388;23596;1131;200150;2271;9156;1122;440738;56776;8564;441925,13,0.43264441920315600000
chr2,37419986,52750571,15330585,1,1,27436;79833;678;90411;9655;170850;57504;11037;388946;9419;64225;729967;129285;2492;5495;10128;286749;130589;2956;8491;805;285051;3973;130271;6546;10153;90423;92906;6654;91461;100271715;23683;55133;9378;5581;400950;9167;151393;80204;4436;80745;9581;64241;728819;1545;79823;2034;165140;63892;23433;5281;25797;10602;11036;51626;6432;6496;4072;57217;100505876;23498;130733;64240;344387;55471;6519;10736;90957;56660;3344,70,0.45660358035913200000
chr7,72745047,74139390,1394343,1,1,5982;51085;9275;84277;7462;135886;83451;1364;6804;7461;155382;3984;26608;8468;9031;155368;2969;8326;7458;9569;2006;1365;114049,23,1.64952239154928000000
chr22,18894835,21464119,2569284,1,1,54487;27037;9342;29801;65078;10587;1312;6545;8214;421;7290;2812;6899;5625;7625;79680;64976;6576;3053;8218;5413;80764;23617;400891;1399;7122;150209;128977;8220;388849;84861;7353;51586;2928;128989;5297;9127;9993;54584;91179;85376;8216;85359;8318;728229;5902,46,1.79038206753321000000
chr17,34817422,36209228,1391806,1,1,26574;284099;9326;284098;11072;6928;79154;79922;3975;11276;79893;11056;6871;31;80179,15,1.07773640866615000000
chr2,238287742,238643604,355862,1,1,64284;51052;9208;1293;79083,5,1.40503903198431000000
chr5,15775864,16503362,727498,1,1,23194;54463;441061;90441,4,0.54982969025344400000
chr2,42891967,43458494,566527,1,1,63892;23498;165140;57504;678,5,0.88257046883908400000
chrX,7820636,8295650,475014,1,1,8228;51480,2,0.42104022197240500000
chr8,86842195,87153738,311543,1,1,245972;85481,2,0.64196595654532400000
chr2,33505098,33774777,269679,1,1,25780;4052,2,0.74162244742823900000
chr6,162748288,163089403,341115,1,1,5071,1,0.29315626694809700000
chr10,79590069,80270769,680700,1,1,9231;11128;6229,3,0.44072278536800400000
chr12,2763920,2977845,213925,1,1,775;2305;83714;55846;2288,5,2.33726773401893000000
chr3,49315808,49637281,321473,1,1,387;6988;7375;2876;8927;84276;275;1605,8,2.48854491668041000000
chr15,32021733,32510863,489130,1,1,161725;1139,2,0.40888925234600200000
chr1,145632334,145747269,114935,1,1,11126;27246;5174,3,2.61017096619829000000
chr8,120743147,120942109,198962,1,1,79075;6873;64798,3,1.50782561494155000000
chr12,129867094,130452266,585172,1,1,121256,1,0.17088992638062000000
chr16,29652999,30199351,546352,1,1,653808;5531;26470;283897;253980;146378;8479;83719;23475;283899;124446;9344;3835;4150;226;253982;83723;5595;6911;11151;8448;79447;112476;9961;10423;6693;79153,27,4.94186897824113000000
chrY,6628691,8500680,1871989,1,1,266;90665,2,0.10683823462637900000
chr17,39880835,40962292,1081457,1,1,5878;4669;28958;79132;6776;284119;124817;115024;47;79990;94086;10609;8678;84514;8506;201181;6774;162427;7283;2826;60681;10266;9001;317719;7266;29893;28511;3728;80347;83538;55175;84313;6945;27175;535;23415;1267;6777;2145;65266;3060;2648;3292,43,3.97611740457549000000
chr10,3233362,6135095,2901733,1,1,1109;79754;3601;79861;83592;3559;84991;54906;8644;1316;114131;51806;54522;84893;1646;2665;1645;810;10276,19,0.65478112562389400000
chr10,50668443,51047666,379223,1,1,8505;6572;267004;1103;2074;282966;55753,7,1.84587960118453000000
chr4,16833244,17805581,972337,1,1,51056;27146;645104;5860;54876;80306;9079,7,0.71991500889095000000
chr9,94874885,95671971,797086,1,1,55035;4969;401541;54829;64768;3376;83744;1842;23299;10558;4958,11,1.38002674742750000000
chr2,11240726,11765461,524735,1,1,130813;9475;1876;130814;9687,5,0.95286192077906000000
chr17,872943,2096909,1223966,1,1,10594;29928;286753;124935;727910;5345;29;8578;4641;146760;83547;114826;124997;1801;5176;124641;1398;7531;23293;5306;3090;727857;64359;6117;51763,25,2.04254039736398000000
chr12,54703782,63507273,8803491,1,1,6490;9958;6601;10330;23306;10102;121364;1606;79837;5557;116986;338811;4640;64375;341416;25895;5869;4637;4665;5036;10956;403282;9840;4234;9194;9924;2735;121130;90070;283373;8608;25946;1431;390326;5939;85406;506;27165;2647;114785;10540;3071;6171;6231;8630;4035;117159;4284;3626;3678;5502;84872;6472;5153;10728;83729;56901;319;51561;84305;8914;23344;84324;6302;390321;2065;254786;1017;115557;121355;403284;6773;4141;196410;283365;4666;5959;9880;11176;283375;3679;3798;53831;341418;140465;23041;246329;4327;390327;441639;196403;121227;2583;10677;22818;11247;121129;967;22864;65012;58158;91419;390323;283377;6778;1019;11318;79035;10106;92979;57460;1649;6866;118430;10193;93058;10220;121214;6821;64333;29095;254783;1594,123,1.39717300784427000000
chrX,6449644,8133172,1683528,1,1,51481;412;8228;26609;8226,5,0.29699535736857400000
chr3,1,15331546,15331545,1,1,7476;23473;285367;3708;79188;6538;23066;9797;29995;80852;5468;8536;132001;23225;84522;3269;63924;2177;55287;56852;25917;115795;285368;6533;285362;6854;27255;7862;6161;51738;78987;9922;10093;7508;55845;57633;8553;375323;10533;51185;55831;9901;79885;6396;9695;7428;23609;4968;491;6419;151835;5894;3568;26140;7079;859;7182;84077;100526693;55207;64145;9467;2917;51095;64432;401052;100129480;10752;132014;2199;10474;27258;51066;152330;84818;55209;131474;3656;64419;6529;51244;152273;9686;5021;80746,85,0.55441248745641700000
chr15,22586922,23470963,884041,1,1,123606;114791;81614;23191;283767,5,0.56558462786228200000
chrX,87794699,88453612,658913,1,1,53336,1,0.15176510404256700000
chrX,42990220,43571143,580923,1,1,4128,1,0.17213985330241700000
chr15,34159744,34473315,313571,1,1,57099;56851;1133;79768;161779,5,1.59453520893195000000
chr15,37100788,37515525,414737,1,1,4212;84529,2,0.48223331894670600000
chr1,46204885,46474015,269130,1,1,23139;3652,2,0.74313528777914000000
chr9,90100688,90721587,620899,1,1,286234;1612;23552;441452;1514,5,0.80528395117402300000
chr15,32076948,32510863,433915,1,1,161725;1139,2,0.46091976539183900000
chr18,53654029,58526971,4872942,1,1,100505549;51046;4677;4160;115701;3998;147372;30062;23335;9480;101927322;339302;5205;23327;284257;10892;55205;90701;2235;2922;5366;9352,22,0.45147264219438700000
chr16,15048751,16249607,1200856,1,1,4629;100288332;123811;89927;4363;54820;368;255027;23042;54700;123803;9665,12,0.99928717514839400000
chr4,132573408,135992638,3419230,1,1,57575;132430,2,0.05849270157316120000
chr7,151748853,152765153,1016300,1,1,58508;57180;7516;63917,4,0.39358457148479800000
chr5,37239208,37516662,277454,1,1,65250;9631;55100,3,1.08126031702552000000
chr11,25552237,26683322,1131085,1,1,143662;63982,2,0.17682137063085400000
chr5,41135465,41429038,293573,1,1,729;345557,2,0.68126156015709900000
chr7,108440818,110767443,2326625,1,1,154907;83943;54674,3,0.12894213721592400000
chr1,148625214,149748048,1122834,1,1,728945;730262;653598;554282;388692;644634,6,0.53436215860937600000
chr9,135792597,139609502,3816905,1,1,10422;9328;7410;6834;6835;11091;360203;6256;138151;1621;57109;3933;8022;728489;64170;6621;5900;158055;51162;8328;2220;138311;8019;1289;56623;90120;642968;7248;9719;9858;5047;2219;29989;10439;138162;26301;1757;26086;157922;6837;11182;57582;23203;9919;11094;1056;28;6838;11093;389827;392399;402381;6130;169714;10807;157927;10555;51116;6836;169436;4851;29991,62,1.62435271509246000000
chr16,15048751,16267306,1218555,1,1,4629;100288332;123811;89927;4363;54820;368;255027;23042;54700;123803;9665,12,0.98477294828711100000
chrX,79915477,80012744,97267,1,1,254065,1,1.02809791604552000000
chrX,47027435,47615974,588539,1,1,6853;2002;7712;369;7592;5127;8409;7076;8237;5199;8241;7317,12,2.03894729151339000000
chr15,22432628,23179948,747320,1,1,123606;114791;81614;23191;283767,5,0.66905743188995300000
chr12,47796477,50359499,2563022,1,1,23519;5630;10024;65244;5213;9416;144233;387856;1280;54934;84790;79962;29843;7471;79657;51564;377;7421;341567;112;25766;57701;50846;51303;121274;7480;362;27289;8085;10376;3906;140461;7009;121268;7846;8909;784;84070;121273;338761;359;904;341568;23109;79022;91010;55652;23416;121275;23017;55716;10411;85478;5571;10445,55,2.14590432700148000000
chr3,98237753,98923309,685556,1,1,2838;131566;10402;1371;56650,5,0.72933502150079600000
chr13,113469872,113988959,519087,1,1,55795;79774;23263;3916;23250;2155;2159;8858;8451,9,1.73381340700114000000
chr15,32076948,32510863,433915,1,1,161725;1139,2,0.46091976539183900000
chr15,22866888,23699760,832872,1,1,123606;114791;283685;81614;23191,5,0.60033234398563000000
chr8,2433724,2832481,398757,1,1,64478,1,0.25077929666438500000
chr15,32076948,32510863,433915,1,1,161725;1139,2,0.46091976539183900000
chr18,3648271,5709075,2060804,1,1,642597;9229;7541;23136,4,0.19409900213703000000
chr5,22308449,34002057,11693608,1,1,23037;1010;1008;6897;55322;81792;10923;23600;1007;51151;4883;29102;51289;1004;51663;56979;54545;64083,18,0.15393024975696100000
chr8,35215315,50115893,14900578,1,1,203102;10947;27257;389649;3620;1978;84513;9530;492307;157848;155;9070;6575;137994;59339;27121;55145;81790;84197;8754;83877;11212;80139;4173;6591;79645;2339;2515;7994;51125;79698;84296;157855;8749;286;11160;340441;6867;5591;84376;6422;7336;56892;55290;2260;169355;137964;1142;23514;6770;138050;203100;7419;114926;25960;23259;8973;3551;1052;137970;5423;137362;80223;5327;54904,65,0.43622468873355100000
chrX,74494014,74649810,155796,1,1,158866;139596,2,1.28373000590516000000
chr5,58885458,59212317,326859,1,1,5144,1,0.30594231763543300000
chr14,26658915,27538931,880016,1,1,4857,1,0.11363429755822600000
chr15,31014508,33009483,1994975,1,1,9824;51621;653125;22909;161725;283710;54893;643699;4308;728047;1139;6447,12,0.60151129713404900000
chr10,32300151,33391685,1091534,1,1,79741;3799;3688;80314,4,0.36645674802617200000
chr16,15048751,16276115,1227364,1,1,4629;100288332;123811;89927;4363;54820;368;255027;23042;54700;123803;9665,12,0.97770506548994400000
chr2,111368818,113065741,1696923,1,1,10461;699;129804;55289;64682;84524;376940;10018;84910,9,0.53037173755084900000
chr3,147279734,194396744,47117010,1,1,4311;2992;29970;26996;4291;55324;5290;1857;1360;653659;5984;170506;5648;10051;55341;9370;165679;6750;3592;389161;1894;389170;8626;56925;285386;54165;170572;401097;8706;151742;4071;2814;25976;6747;80012;6657;26998;5010;23043;23101;6514;604;131578;151790;4154;10242;57129;152137;152078;116931;344658;100505385;2119;9197;6498;51555;27074;79929;1173;197;51193;29909;53836;84343;7095;105374250;64747;344758;200909;84239;57709;1608;339829;151963;64110;132112;5437;59345;83893;23200;79674;151827;10686;56670;590;1356;285382;1427;2693;57018;116441;257313;152138;1370;27094;151613;2122;9934;51319;26084;4711;8975;344892;51068;254827;7881;22871;5217;79718;8833;5912;285313;10195;1974;8893;64805;1181;5276;5274;55892;3556;93109;110599564;55486;131408;344901;11235;51714;6596;79740;27333;90407;9076;344752;285242;6480;131920;3273;344657;25937;55669;185;55214;83939;86;10644;116832;23355;4976;131149;8646;80117;5708;1962;286827;3280;84002;200916;6476;57552;7066;9175;64393;11342;200879;55171;110599583;53829;57110;94032;7104;59343;13;55689;8087;5584;5806;10057;5918;9718;64778;5337;5028;56922;89857;90113;131118;2049;285315;3827;79572;56648;654502;27230;7401;51726;1981;51122;344905;8743;57560;131831;54800;84517;9819;389177;152118;647309;3840;64108;1359;85476;6434;4026;2257;22865;6474;23007;6478;79782,220,0.46692266763107400000
chr1,146324068,149079826,2755758,1,1,9557;728945;284565;644591;51205;645142;51463;2703;5565;607;2702;730262;2330;200030;149013,15,0.54431484912681000000
chr16,29592812,30332551,739739,1,1,653808;654483;5531;26470;283897;253980;146378;8479;83719;23475;283899;548593;124446;9344;3835;4150;226;613037;253982;83723;5595;6911;11151;6818;79447;112476;8448;9961;10423;6693;79153,31,4.19066724885399000000
chr11,353347,872723,519376,1,1,64787;6343;11187;283229;57661;8045;10522;66005;101927423;79751;115399;3265;3665;6181;59307;283232;977;338440;6888;5441;7106;81490;53841;347862;51286;1815;57104;6050;338707;256329;55367,31,5.96870090262161000000
chr21,46827940,47121128,293188,1,1,80781;6573,2,0.68215615918796100000
chr4,8281059,9948077,1667018,1,1,728373;100287205;100287327;100287478;728393;644414;152992;728419;8532;100288520;56606;100287404;94031;728379;728369;100287178;100287441;100287513;728386;100287144;3166;100287238;8310;100287364;1816;728405;27201;728400,28,1.67964593063782000000
chrX,17185494,17489809,304315,1,1,4810,1,0.32860687116967600000
chr6,84183925,85270515,1086590,1,1,9892;22832;134701;51167;112609;167681,6,0.55218619718569100000
chrX,123388516,123598378,209862,1,1,4068;10178,2,0.95300721426461200000
chr15,32021733,32510863,489130,1,1,161725;1139,2,0.40888925234600200000
chr18,1,4391015,4391014,1,1,116;55556;10403;9663;103910;7050;9984;9097;7525;81035;23347;10627;494514;64863;1068;8736;27098;9229;84034;7298,20,0.45547566006394000000
chr2,54202447,63086967,8884520,1,1,150684;400954;10575;84542;200728;388951;53335;9736;57223;23301;6233;84140;64895;55120;55704;7444;6711;57142;339804;114800;130162;150962;4528;112942;5966;5194;98;87178;2202;130872;7514;129852;10678,33,0.37143255910279900000
chr8,86842195,87153738,311543,1,1,245972;85481,2,0.64196595654532400000
chr19,28357923,40998913,12640990,1,1,26065;163131;5438;148268;92285;163087;54623;25999;57731;284323;6183;126393;388531;57817;2865;91442;374897;126248;199720;84902;390927;148266;22847;55851;728361;101927572;83889;57716;388533;29946;163126;3960;390916;27335;53827;57828;27033;94274;126374;100507527;10298;147923;282618;51276;91646;728485;8857;9745;399473;2821;339324;51599;1178;1340;374900;163183;57711;84306;84063;333;115727;6324;115703;64377;284403;79713;5349;163255;342865;84079;6829;163175;5714;84924;8725;1054;3963;4793;57616;643669;10683;57655;199745;1155;79047;163081;22933;282616;84964;3191;148003;126375;126272;4868;84911;1050;8193;10870;10430;56301;55900;11045;148137;933;6217;55095;199704;348303;126526;2867;55588;53822;84807;92609;54938;4099;388536;23646;90075;55957;7386;79935;653499;147991;147965;644096;282617;29950;11136;92283;495;57677;10775;9141;9710;148109;84775;4294;79171;163115;6261;898;23094;90522;5348;57622;645;2091;9424;115290;93099;4037;284459;5184;9149;342897;79156;284406;26330;85415;284402;79414;2116;390928;148103;64857;374899;83636;147929;826;1891;84503;81;29124;10054;7705;148014;9535;22835;339327;10653;11184;56891;126231;208;7305;64073;58510;1346;147746;199746;7538;126432;55094;7392;23354;3249;339318;25850;342892;342898;5704;2864;126433;342900;9757;147968,207,1.63752997194049000000
chr19,13993244,24301987,10308743,1,1,5989;684;117579;976;23031;26993;353088;57719;163227;7652;56242;80714;7644;93343;9534;58525;25804;51477;53345;100271849;83483;100287226;3718;64981;27151;8907;84705;126549;57834;10331;404037;3640;55049;3337;26658;4207;26664;64926;9518;126402;125972;23581;126541;23025;84449;6511;9002;10994;7594;1311;79086;4713;54862;4854;58513;79709;7643;102724279;6528;23383;9524;26538;90378;23309;85360;57615;8625;55723;171392;199777;23476;84167;100130519;284439;79629;7562;7311;93323;5585;9441;93436;390892;126364;55201;26659;199786;5143;27106;26333;79939;388512;7561;646457;54815;729991;79883;100129842;79041;5864;3594;1463;115098;126370;57794;117286;115861;3780;91120;79173;148206;11316;114770;388523;30817;90379;10270;23373;284443;730087;6142;3727;80726;79036;4051;25796;54929;51079;284433;126382;66002;10212;4650;83878;51291;10437;23770;10755;170463;5731;148198;8529;84769;9454;54858;2657;170959;79016;26539;55850;4218;284434;84941;10523;55295;80264;79852;26532;8178;163223;10365;9170;9466;5296;54555;10147;57130;148113;81931;94039;126410;90649;29086;5976;148213;113835;83983;5566;84658;9244;11283;113230;79575;23149;100129543;2063;7171;7639;26017;376497;440515;374887;342979;25789;7757;22859;10715,196,1.90129873254188000000
chr17,1201214,1492475,291261,1,1,124935;1398;7531;4641;5306;286753;51763,7,2.40334270636989000000
chrX,152764591,153406233,641642,1,1,492;3654;8260;3421;5973;1852;3897;4204;3054;215;6748;10134;5365;139728;26576;8269;554;6535;633;92002;57595;393,22,3.42870323326715000000
chr18,19418331,35493382,16075051,1,1,85019;25800;64762;25941;1824;4864;8780;25925;1828;10982;55197;1823;284252;7572;9331;114876;59340;5932;1829;147407;57565;80206;6760;51444;252884;84307;80816;83539;57534;83608;55034;147409;100101467;29919;1830;91768;361;7276;55364;1837;26256;4225;8715;1000;56853;125488;6875;54941;147463;2627;3909;143471;1825;125476;2589;57536;55250;22878;374864;64693,60,0.37324920462149700000
chr22,18847964,21505387,2657423,1,1,54487;27037;9342;29801;65078;10587;1312;6545;8214;7290;421;2812;6899;5625;7625;79680;64976;6576;3053;8218;5413;80764;23617;400891;1399;7122;150209;128977;8220;388849;84861;7353;51586;2928;128989;5297;9127;9993;54584;91179;85376;8216;85359;8318;728229;5902,46,1.73100029615157000000
chr12,33525320,34345585,820265,1,1,341359;84920,2,0.24382364235948100000
chr11,9248819,9606836,358017,1,1,23258;7702;440026;10527;7465,5,1.39658172656606000000
chr22,33440621,33852735,412114,1,1,9215;8224,2,0.48530261044274200000
chr7,1468185,1779622,311437,1,1,84262;392617;79778;26173;7975;202915,6,1.92655336392272000000
chr4,22176592,22927879,751287,1,1,166647,1,0.13310492528155000000
chr22,21075575,21440514,364939,1,1,80764;9342;3053;8216;400891;1399;6545;150209;9127;5297,10,2.74018397595215000000
chr14,21499240,21852363,353123,1,1,122664;440163;51222;643382;84659;122665;3183;55701;57096;11198;390445;57447,12,3.39824933521747000000
chr5,179222229,179491865,269636,1,1,51149;23061;55819;4056;8878;11282,6,2.22522215134478000000
chr19,12744531,13538042,793511,1,1,773;9592;10661;439;4125;51398;84292;55621;2193;1777;811;256126;22983;7001;84261;10535;4066;90480;8677;1725;5886;4784;199699;83546;105372280;112939;54831;79002;29911;30000;2639;3726,32,4.03271032159605000000
chr7,72401115,74194373,1793258,1,1,5982;378108;51085;9275;84277;7462;55695;135886;653361;9883;83451;1364;135892;6804;7461;155382;3984;26608;8468;9031;155368;2969;8326;7458;9569;2006;1365;114049,28,1.56140388053476000000
chr16,77850811,79451199,1600388,1,1,51741;57687;10143,3,0.18745454227349900000
chr1,145632334,145747269,114935,1,1,11126;27246;5174,3,2.61017096619829000000
chr3,158272621,158422532,149911,1,1,4291;5918;85476;56925,4,2.66824982823142000000
chr17,625445,1492445,867000,1,1,79850;1398;51031;7531;50628;29928;5306;286753;124935;29;727857;55178;4641;64359;51763,15,1.73010380622837000000
chr4,183807043,190896645,7089602,1,1,285440;53842;205860;25854;55325;7098;60684;836;80014;83891;57587;55602;2160;3818;79682;353322;291;100132463;27295;3660;441054;391723;201965;2195;339976;201973;4543;132625;55805;133121;256309;8470;2180;56977;3622;2483;1635,37,0.52189107371612700000
chrX,122497099,122869859,372760,1,1,57187;2892,2,0.53653825517759400000
chr22,18628019,21965120,3337101,1,1,54487;27037;7332;9342;29801;65078;10587;1312;6545;8214;7290;421;2812;645426;6899;5625;7625;79680;23119;64976;11274;6576;3053;8218;5413;80764;23617;400891;1399;7122;150209;128977;8220;388849;84861;7353;51586;2928;128989;5297;9127;150221;9993;54584;91179;85376;8216;440804;85359;8318;728229;5902,52,1.55823872277165000000
chr7,72648553,74133303,1484750,1,1,5982;51085;9275;84277;7462;55695;135886;83451;1364;135892;6804;7461;155382;3984;26608;8468;9031;155368;2969;8326;7458;9569;2006;1365;114049,25,1.68378514901499000000
chr15,32076948,32438943,361995,1,1,161725;1139,2,0.55249381897540000000
chr18,6942021,8055875,1113854,1,1,5797;339291;284217,3,0.26933511932443600000
chrX,6552712,8115153,1562441,1,1,412;8228;26609;8226,4,0.25600966692502300000
chr3,188927500,189456465,528965,1,1,285386;8626,2,0.37809684950800100000
chr16,28837450,29042118,204668,1,1,11273;27040;79874;7284;930;84901;487;83985;25970,9,4.39736548947564000000
chr7,11221210,12448132,1226922,1,1,221806;54664;221981,3,0.24451432120379300000
chr5,90321536,94014681,3693145,1,1,57561;7025;285600;84059;83989;84250;134187,7,0.18954035110996200000
chr8,69956739,72340843,2384104,1,1,2138;10499;389668;81796;23213;51110;63978;23471,8,0.33555583145701700000
chr8,39068643,43055737,3987094,1,1,203102;10947;8973;3620;84376;6422;3551;2339;56892;2515;7994;51125;169355;137964;157848;79698;5423;1142;84296;6575;55145;138050;8749;27121;286;81790;84197;7419;5327;114926,30,0.75242770799986200000
chr8,47536057,51322400,3786343,1,1,5591;23514;4173;6591;79645;7336;1052;492307;54212,9,0.23769637351925100000
chr22,18889039,19010508,121469,1,1,5625;8214,2,1.64651063234241000000
chr17,34817422,36168104,1350682,1,1,26574;284099;9326;284098;11072;6928;79154;79922;3975;11276;79893;11056;6871;31;80179,15,1.11055007766447000000
chr5,176515874,176684195,168321,1,1,64324;2264,2,1.18820586854878000000
chr15,22880274,23648846,768572,1,1,123606;23191;81614,3,0.39033428227934400000
chr15,32076948,32510863,433915,1,1,161725;1139,2,0.46091976539183900000
chr4,9766686,10785309,1018623,1,1,116449;85460;56606;1816;9948,5,0.49085873772730400000
chr20,9496077,11982624,2486547,1,1,128710;22903;8195;63926;24141;182;57144;6616,8,0.32173130047411100000
chr17,1409812,3447132,2037320,1,1,10594;8388;443;63826;5345;26189;162514;146760;9905;114826;124641;23293;8386;8390;23108;6117;84690;23277;55720;4994;124935;8387;727910;8578;79066;4335;83547;124997;1801;5176;8383;4995;8392;5306;3090;4991;5048;51763,38,1.86519545284982000000
chr10,485716,21613561,21127845,1,1,221079;22884;22929;3698;57118;221060;8516;1787;114131;51806;54522;11164;783;55691;9200;8029;10659;105;55301;10531;10529;57713;5214;221044;79861;222389;9712;84991;54906;9397;84898;8872;6251;414149;55388;83643;3422;338596;10133;653567;387638;83592;23560;91734;2625;79746;79723;8644;3559;23185;1316;221061;26019;84893;80760;80013;55176;810;389941;10276;254427;51182;7431;340895;221074;1109;83860;10557;221078;509;79754;5209;3601;644890;441549;5588;22944;8027;22982;5264;8559;4360;55526;9317;83641;1646;2665;1645;64421,89,0.42124504415855000000
chr10,135340935,135372634,31699,1,1,93426;1571,2,6.30934729802202000000
chr7,72700414,74360689,1660275,1,1,5982;84163;51085;9275;84277;7462;55695;135886;653361;83451;1364;135892;6804;7461;155382;3984;26608;8468;9031;155368;2969;8326;7458;9569;2006;1365;114049,27,1.62623661742784000000
chr15,32326036,33009483,683447,1,1,9824;643699;653125;728047;1139;6447,6,0.87790274885982400000
chr16,88900248,89051689,151441,1,1,2588;863;390748;51693;100129697,5,3.30161581077779000000
chrX,7584633,8115153,530520,1,1,8228;26609,2,0.37698861494382900000
chr7,16877677,17748786,871109,1,1,196;155465,2,0.22959239314483000000
chrX,139089231,154929220,15839989,1,1,4110;2157;50814;541578;2556;139067;4104;494119;139728;8517;3423;6901;474383;92002;4105;57595;266740;2332;389895;84968;64663;9142;246100;100272147;728269;100533997;3149;26576;474382;8273;728695;6535;114824;393;23641;1038;55217;8270;537;3421;100132963;6658;4101;215;91966;4100;55879;2010;4534;6134;101928917;116442;100506164;2652;84548;100133053;100129239;2334;203547;139135;139081;60343;728458;8269;10046;728712;5956;2664;79184;4515;158521;4108;2564;8263;1193;492;1260;9130;3054;7411;9947;10134;79057;84631;30014;30848;441525;554;8266;8776;29944;494118;2539;7739;8260;55559;4204;65991;5365;8277;4354;10838;139735;2316;83692;11219;10251;55558;139716;645188;51438;1736;3654;5973;139065;4109;1852;3897;474384;6748;4103;474381;9248;1069;1485;1774;64648;4107;83740;89885;100130086;633,132,0.83333391203743900000
chr22,22998284,23603489,605205,1,1,2781;100423062;613;27156;9609,5,0.82616634033096200000
chr14,35983284,39789708,3806424,1,1,26257;161198;4253;7080;6751;10484;84684;3169;122553;253970;253959;5083;8487;5411;51562;145282;89874;319089;84312,19,0.49915616337013400000
chr16,14780135,16223052,1442917,1,1,100288332;642799;642778;8399;23042;123803;9665;4629;123811;89927;4363;9284;54820;23420;255027;54700,16,1.10886488966448000000
chr5,33947411,34744129,796718,1,1,114899;26064;23600;51151,4,0.50205969991891700000
chr7,151664495,152008417,343922,1,1,58508;168391;63917,3,0.87229081012555200000
chr15,32076948,32510863,433915,1,1,161725;1139,2,0.46091976539183900000
chr18,67957981,68632752,674771,1,1,220158;9306,2,0.29639685167264200000
chr20,8099741,8575520,475779,1,1,23236,1,0.21018161793605900000
chr16,15929435,16276115,346680,1,1,4363;4629;123811;368,4,1.15380177685474000000
chr19,30286892,31644321,1357429,1,1,8725;9745;898,3,0.22100603420142000000
chr5,137542010,137708167,166157,1,1,2676;8697;51307;51780;995,5,3.00920214014456000000
chr2,157161543,166349728,9188185,1,1,130940;25801;151258;10716;4065;90;6328;100526664;151525;6326;10010;22837;22925;2888;4929;2641;80034;10213;11227;29994;57282;8502;90134;2820;2191;92196;130399;55137;5937;1803;85461;64135;64844;9936;57471;9595;151531;3694,38,0.41357460695447500000
chr17,14111772,15497883,1386111,1,1,1352;64518;9953;201158;284040;100533496;5376;374286;146822,9,0.64929864924237700000
chr15,31014508,32914140,1899632,1,1,9824;51621;653125;22909;161725;283710;54893;643699;4308;728047;1139,11,0.57905952310763400000
chr7,72726578,74139390,1412812,1,1,5982;51085;9275;84277;7462;135886;83451;1364;135892;6804;7461;155382;3984;26608;8468;9031;155368;2969;8326;7458;9569;2006;1365;114049,24,1.69873981817821000000
chr19,863268,2640528,1777260,1,1,374291;55111;1943;126306;54760;26528;6929;8175;645191;55643;1153;10347;55009;116444;148223;57455;6209;126308;399664;113179;4946;22904;339366;4616;81926;2788;374872;23526;513;148229;51690;26517;10025;84939;2879;83855;1265;126520;91304;56928;53615;113178;84444;10297;91300;84634;92840;8943;360200;1820;84823;1675;90007;390874;6794;255057;10975;57418;2593;1455;268;5434;2872;113177,64,3.60104880546459000000
chr16,15154627,16249667,1095040,1,1,4629;100288332;123811;89927;4363;54820;255027;23042;54700;368;9665,11,1.00452951490357000000
chr10,15415276,15889966,474690,1,1,80013;8516,2,0.42132760327792900000
chr22,38573008,51103900,12530892,1,1,10126;200315;150383;91582;115650;2033;55267;25813;25776;6942;79174;27352;10478;4668;11144;415116;83642;158;6767;23542;9978;646851;84271;164684;83933;91689;1565;79924;27351;84844;4809;84247;440829;6305;150350;51512;1890;25830;23654;25817;9402;91289;26286;113828;5905;5155;26150;171568;7008;400935;23492;2192;80274;23764;6721;54471;758;150368;1120;10521;4700;440836;5465;150372;9929;50;25829;27350;63929;253190;3761;64098;79087;55020;8398;638;11015;85352;55586;11252;9145;85378;79879;468;25771;79019;23151;23774;80305;10766;1727;79640;150379;55007;56993;1375;55964;164668;553158;23467;7380;102800317;6300;10343;83746;23313;2547;53947;23264;27254;29781;5372;23466;25777;2847;64800;27341;410;4248;706;9567;9701;1454;56666;5600;27127;60489;150356;9889;140564;414918;25809;8911;10454;9997;9620;267020;150365;200316;64781;112885;29780;644186;23170;150353;23779;23209;7477;25814;80339;10762;27349;55687;6122;348645;57591;55615;113730;9582;23112;54456,161,1.28482473554157000000
chrX,154120738,154794704,673966,1,1,7411;83740;1193;55217;474381;2157;474383;79184;474384;100272147;116442;65991;4515,13,1.92888068537582000000
chr3,195747856,197387258,1639402,1,1,622;255798;80235;200933;5062;5130;4241;26043;1739;84984;348793;255758;116211;131540;200931;375387;22916;7037;165918;54965;205564,21,1.28095488476896000000
chr15,32076948,32510863,433915,1,1,161725;1139,2,0.46091976539183900000
chrX,11720098,12160740,440642,1,1,9758;10943,2,0.45388319769790400000
chr1,145413388,145747269,333881,1,1,148738;128077;10401;200035;27246;84265;284615;9939;11126;8515;148741;10628;10623;8799;5174,15,4.49261862759486000000
chr8,120743147,120942109,198962,1,1,79075;6873;64798,3,1.50782561494155000000
chr2,78914816,80052374,1137558,1,1,130120;5068;1496;5968;5967,5,0.43953802795110200000
chr16,15048751,16899676,1850925,1,1,101059938;4629;100288332;123811;89927;4363;54820;408050;368;255027;23042;54700;123803;9665,14,0.75637856747302000000
chr9,116883765,117153582,269817,1,1,5005;5004;80709;85301,4,1.48248627773639000000
chr15,20787768,23146103,2358335,1,1,114791;100996331;123606;283694;81614;100287399;390538;23191;283767,9,0.38162517199634500000
chr5,80021305,80305389,284084,1,1,5924;4437,2,0.70401712169640000000
chr1,89591763,90000784,409021,1,1,163351;2634;388646;115361;115362;23507,6,1.46691734654211000000
chr4,68606403,68974716,368313,1,1,339967;2798;389208;9407,4,1.08603280362083000000
chr1,145489708,145968803,479095,1,1,128077;10401;200035;27246;9939;11126;8515;148741;10623;653519;8799;5174,12,2.50472244544401000000
chr1,110827787,125000001,14172214,1,1,1117;83998;10885;200162;4893;829;7252;11085;10286;148281;440603;27159;10352;963;10717;51592;333926;2210;81839;3744;914;8458;11218;3158;79961;4808;10100;3737;128344;126868;653820;128346;54665;26227;653464;80143;5738;79679;7482;284467;3283;5016;260425;140;515;128338;64783;84432;343505;64858;4853;10542;3738;270;476;4803;845;55924;9122;163259;3321;79084;7812;26191;4343;80263;54879;57413;6847;5906;55791;3752;3284;6913;204851;6566;51179;56944;54855;90874;54834;389;55917;9398;965;55356;10745;9860;10390;10905,90,0.63504544879155800000
chrX,1256608,6413964,5157356,1,1,414;286530;57502;1438;3563;5613;25878;347527;415;416;207063;4267;293;7499;9189;438;64109;8227;8623;8908,20,0.38779560689624700000
chr18,65676232,66381438,705206,1,1,54495,1,0.14180253713099400000
chr2,200256583,200340204,83621,1,1,23314,1,1.19587185037251000000
chr15,22784523,23699760,915237,1,1,123606;114791;81614;283685;23191,5,0.54630658507031500000
chr15,31014508,32914140,1899632,1,1,9824;51621;653125;22909;161725;283710;54893;643699;4308;728047;1139,11,0.57905952310763400000
chr17,34817422,36168104,1350682,1,1,26574;284099;9326;284098;11072;6928;79154;79922;3975;11276;79893;11056;6871;31;80179,15,1.11055007766447000000
chr1,146155983,147824178,1668195,1,1,9557;51205;51463;2703;5565;607;2702;2330;200030;149013,10,0.59945030407116700000
chr15,32064800,32510067,445267,1,1,161725;1139,2,0.44916870102657500000
chr13,73284847,75178957,1894110,1,1,688;79866;10464;11278;22894;440145,6,0.31677146522641200000
chr17,14111772,15442066,1330294,1,1,1352;64518;9953;201158;284040;100533496;5376;146822,8,0.60137082479512000000
chr1,146324068,147356634,1032566,1,1,9557;607;2702;2330;51205;149013;5565,7,0.67792276716452000000
chr9,133246817,141018984,7772167,1,1,29952;10422;9328;54863;84960;360203;2889;138151;57109;3933;158067;728489;83543;389799;286257;8636;2220;441478;84628;56654;89958;27158;643596;11253;9919;11094;389812;1056;401563;6838;389813;25;157922;51116;6836;54461;8022;83549;6256;6621;375775;10585;9022;84929;84814;8721;8021;8328;56623;84726;7248;9719;9858;2219;256158;20;29989;138307;401562;6837;23203;91373;727800;142680;92714;347148;10807;10555;85014;64975;29991;64794;774;6834;158062;64170;158055;9329;26012;286336;7186;7270;286262;2902;11092;2529;441476;29882;401565;94107;414332;4851;100505993;28;389827;169714;286256;157927;59335;169436;10319;7410;954;6835;11091;10811;8939;1621;25920;23064;5900;51162;733;138311;29085;8019;9442;1289;389816;90120;377841;79813;55684;5047;10439;92715;158056;10383;26301;1757;26086;445;11182;57582;56751;116225;23404;11093;392399;402381;6130;375791;54932;5730;642968;138162,146,1.87849797874904000000
chr8,53467337,53694718,227381,1,1,389658;9821,2,0.87958096762702300000
chr3,61735252,63270300,1535048,1,1,55079;57415;8618;132204;5793,5,0.32572271355684000000
chr15,32021733,32510863,489130,1,1,161725;1139,2,0.40888925234600200000
chr5,9958240,15560300,5602060,1,1,134147;10299;1501;56172;7204;134145;54491;22948;1767;23194;90268;651746;83853;1611,14,0.24990806953156500000
chr6,76657174,77173441,516267,1,1,3617,1,0.19369822204402000000
chr18,77385857,77702630,316773,1,1,26251;9150;80148,3,0.94705041149340400000
chr9,33124815,33255317,130502,1,1,2683;27290;573,3,2.29881534382615000000
chr3,73914,18784667,18710753,1,1,7476;23473;285367;3708;79188;6538;23066;1618;9797;29995;80852;5468;8536;339862;132001;23225;84522;3269;63924;2177;55287;56852;25917;115795;285368;6533;285362;6854;131965;27255;7862;8292;6161;51738;5021;78987;6304;285381;9922;10093;7508;85403;55845;23228;57633;8553;375323;10533;51185;55831;9901;79885;23243;6396;9695;7428;23609;4968;491;6419;151835;5894;3568;26140;26061;9779;686;7079;859;7182;84077;100526693;55207;64145;9467;2917;51095;64432;401052;100129480;10752;132014;2199;10474;27258;51066;152330;84818;55209;131474;3656;64419;6529;51244;92106;152273;9686;23180;80746;117248,100,0.53445203407901300000
chr15,32021733,32510863,489130,1,1,161725;1139,2,0.40888925234600200000
chr1,144994947,145747269,752322,1,1,148738;128077;27246;84265;11126;9659;10628;8799;5174;388677;10401;200035;284615;8515;148741;10623;100132406;9939,18,2.39259253351623000000
chrX,38491539,38547951,56412,1,1,7102,1,1.77267248103240000000
chr8,144546105,145699139,1153034,1,1,65263;340371;26873;84948;81858;727957;93100;225689;203054;84232;79581;8694;286077;8928;4796;2907;83481;642658;50626;84875;29894;55630;642475;340390;26233;90990;1537;23246;1936;100130274;23144;286075;23513;83482;79792;340393;51236;22827;8733;9831;7264;5339;54512;375686;51160;3297,46,3.98947472494306000000
chr4,8839900,10520199,1680299,1,1,728373;100287205;100287327;100287478;728393;644414;728419;100288520;56606;100287404;728379;85460;9948;728369;100287178;116449;100287441;100287513;728386;100287144;3166;100287238;100287364;1816;728405;728400,26,1.54734365728957000000
chr8,53467337,53694718,227381,1,1,389658;9821,2,0.87958096762702300000
chr13,20153689,20530702,377013,1,1,54737;9205;55269,3,0.79572852925495900000
chrX,6552712,8115153,1562441,1,1,412;8228;26609;8226,4,0.25600966692502300000
chrX,517114,819243,302129,1,1,6473,1,0.33098444704083400000
chr21,47424794,48067924,643130,1,1,54058;3275;10841;1291;54059;6285;23181;8888;1292;5116;84221;4047,12,1.86587470651346000000
chr15,20481702,23699760,3218058,1,1,727832;114791;100996331;123606;283694;81614;100287399;283685;390538;23191;283767,11,0.34182106102500300000
chr15,32076948,32510863,433915,1,1,161725;1139,2,0.46091976539183900000
chr1,144927778,145747269,819491,1,1,148738;128077;27246;84265;11126;9659;10628;8799;5174;388677;10401;200035;284615;8515;148741;10623;100132406;9939,18,2.19648537933913000000
chr17,34817422,36168104,1350682,1,1,26574;284099;9326;284098;11072;6928;79154;79922;3975;11276;79893;11056;6871;31;80179,15,1.11055007766447000000
chr16,8798181,8958942,160761,1,1,18;25880;5373;23589,4,2.48816566206978000000
chr15,82349104,82564256,215152,1,1,283726;79631,2,0.92957536997099700000
chr5,175576602,176025426,448824,1,1,192286;285598;1212;51491;23197;375484;57179;54825;114787;22838,10,2.22804484608666000000
chr3,1492662,2217371,724709,1,1,152330,1,0.13798641937660500000
chr10,92095432,92594891,499459,1,1,3363,1,0.20021663439841900000
chr17,2016700,2270173,253473,1,1,23293;9905;63826;55720,4,1.57807734946128000000
chr17,60507373,68351025,7843652,1,1,55062;5718;26207;974;55852;5705;6329;10672;11232;2688;9931;9120;10351;1655;2186;2081;350;786;1442;5578;4215;57003;1534;10349;54757;162333;27092;23461;51321;3759;64750;5608;8787;80774;8313;5573;22901;1443;51204;92340;3838;117246;284018;9902;1636;284021;11325;3773;27091;23460;11011;5175;1444;374819;3384;10350;81033;25926;339175;26115;10238;90799;92335;6603;2689;201134,66,0.84144477597935200000
chrX,8556249,8959724,403475,1,1,171482;3730,2,0.49569366131730600000
chr12,33525320,34345585,820265,1,1,341359;84920,2,0.24382364235948100000
chrX,7744132,8164803,420671,1,1,8228;26609;51480,3,0.71314637804840400000
chr15,32076948,32510863,433915,1,1,161725;1139,2,0.46091976539183900000
chr4,188106143,189749994,1643851,1,1,205860;132625;339976,3,0.18249829212015000000
chr2,2606014,3584798,978784,1,1,51112;7260;55256,3,0.30650276261156700000
chr17,34817422,36168104,1350682,1,1,26574;284099;9326;284098;11072;6928;79154;79922;3975;11276;79893;11056;6871;31;80179,15,1.11055007766447000000
chr15,20481702,23699760,3218058,1,1,727832;114791;100996331;123606;283694;81614;100287399;283685;390538;23191;283767,11,0.34182106102500300000
chr1,144927778,145747269,819491,1,1,148738;128077;27246;84265;11126;9659;10628;8799;5174;388677;10401;200035;284615;8515;148741;10623;100132406;9939,18,2.19648537933913000000
chrX,74579928,75007141,427213,1,1,158866;139599,2,0.46815054785317900000
chr3,81201515,82326724,1125209,1,1,2632,1,0.08887237837592840000
chr2,206420160,206659509,239349,1,1,117583;8828,2,0.83559989805681200000
chr1,182988454,183711450,722996,1,1,403314;10092;23057;23179;3915;4688;3918;9887,8,1.10650681331570000000
chr1,46508396,46671143,162747,1,1,10103;8503;55624;110117499;110117498;541468,6,3.68670390237608000000
chr1,57027891,58043159,1015268,1,1,8613;199920;732;731;1600;5563,6,0.59097696371795400000
chrX,481940,1464218,982278,1,1,6473;1438;3563;64109,4,0.40721669425559800000
chrX,64085656,65069420,983764,1,1,81887;4478;55906;340554,4,0.40660158330656500000
chr15,63042626,63191224,148598,1,1,83660,1,0.67295656738314100000
chrX,6552712,8115153,1562441,1,1,412;8228;26609;8226,4,0.25600966692502300000
chr5,115248754,115425300,176546,1,1,206338;51397;1176;644100,4,2.26569845819220000000
chrX,6552712,8115153,1562441,1,1,412;8228;26609;8226,4,0.25600966692502300000
chr16,15492317,18112776,2620459,1,1,4629;123811;64131;89927;4363;54820;408050;255027;101059938;368;9665,11,0.41977378772192200000
chr6,123209534,125146451,1936917,1,1,154215;134829;10345,3,0.15488531516838400000
chr17,34417306,36168104,1750798,1,1,26574;9326;6928;3975;414060;79893;729877;6351;31;6349;80179;284098;11072;9560;414062;101060321;414059;6348;79922;11276;79154;11056;6871;284099,24,1.37080348503939000000
chr22,18889039,21561514,2672475,1,1,54487;27037;9342;29801;65078;10587;1312;6545;8214;7290;421;2812;6899;5625;7625;79680;64976;6576;3053;8218;5413;80764;23617;400891;1399;7122;150209;128977;8220;388849;84861;7353;51586;2928;128989;5297;9127;9993;54584;91179;85376;8216;85359;8318;728229;5902,46,1.72125090038260000000
chr15,22866888,23179948,313060,1,1,123606;23191;114791;81614,4,1.27771034306523000000
chr12,119484508,119950748,466240,1,1,84530;160777;26353,3,0.64344543582704200000
chr4,78804617,78971901,167284,1,1,65008,1,0.59778580139164500000
chr1,245132097,245665521,533424,1,1,55083;84288,2,0.37493626083565800000
chr4,115565811,116029918,464107,1,1,64579;7368,2,0.43093510763681700000
chr1,145632334,145747269,114935,1,1,11126;27246;5174,3,2.61017096619829000000
chr15,32076948,32510863,433915,1,1,161725;1139,2,0.46091976539183900000
chr7,8217864,8520019,302155,1,1,30010;3382,2,0.66191193261736500000
chr20,12889507,13243373,353866,1,1,55304;140862,2,0.56518569175902700000
chr20,8099741,8575520,475779,1,1,23236,1,0.21018161793605900000
chrX,71792872,71925753,132881,1,1,55869;5255,2,1.50510607235045000000
chr11,64544599,64785731,241132,1,1,23130;4221;5526;283129;55561;116071;5871;402;10938;7536;170589,11,4.56181676426190000000
chr22,21989140,22467350,478210,1,1,29799;23753;23759;9647;8940;5594;164592,7,1.46379205788252000000
chr15,32076948,32510863,433915,1,1,161725;1139,2,0.46091976539183900000
chr5,179222229,179663556,441327,1,1,255426;55819;4056;8878;11282;5601;51149;23061,8,1.81271483503162000000
chr19,54080106,54982120,902014,1,1,79143;55422;284415;5582;26121;503834;4696;114823;94059;23547;29844;10990;11025;91662;91663;59284;4849;57348;6203;59283;147798;79042;148170;59285;79165;441864;3903;126014;10288,29,3.21502770466977000000
chr4,71552,5897005,5825453,1,1,7700;521;7469;401115;79155;4636;133060;55646;654254;166793;54872;53407;1609;55351;2121;79441;7468;152877;285489;353497;10861;92305;285498;10815;27065;2580;53834;84179;5158;402160;3425;152687;4487;6047;54729;6002;54360;10227;10336;10417;84286;345222;2261;255403;4043;8602;7884;170960;57732;132884;10296;3064;3083;57654;10460;85013;118;1400;3954;152;339983;6452;10608;1487;2868;285464;8603,67,1.15012514906566000000
chr1,55075653,55252418,176765,1,1,26027;55001;374977;338094;7268;25973,6,3.39433711424773000000
chr2,69350061,70165488,815427,1,1,307;4084;22848;64395;27247;11017;2673;84168,8,0.98108107776661800000
chr3,53262296,54358357,1096061,1,1,776;7086;58515;93973;55540;55349;55802;55799,8,0.72988638406074100000
chrX,53325084,53904597,579513,1,1,23096;158787;10075;8243;3028,5,0.86279341447042600000
chr7,15994233,17074396,1080163,1,1,57037;27075;25928;28969;155465;729920;100506049;10551,8,0.74062896062909000000
chr8,11207613,11841901,634288,1,1,1508;640;252969;2222;2626;83648;613210;613209,8,1.26125671619201000000
chr8,52042609,52518751,476142,1,1,137902,1,0.21002138017650200000
chr9,37423984,37660586,236602,1,1,64425;22844;9925;26267;401505;9380,6,2.53590417663418000000
chr16,74872495,75255243,382748,1,1,440387;1504;84937;197257;79726;162239,6,1.56761106524397000000
chr11,61634784,64399606,2764822,1,1,79081;9356;4246;79829;83707;5331;25824;79842;256364;2495;114571;10629;9376;283234;116085;85329;221091;3619;387775;2011;83706;5866;1351;3995;283237;54979;10482;6094;3338;1128;23769;1937;404552;25858;26472;790955;56834;64852;80150;7356;5436;144097;4250;374395;10647;387601;84304;23193;2785;28992;9415;54663;10963;55867;102288414;51504;26580;2286;9379;79064;283238;6520;50801;2101;572;7439;8986;55611;7423;221092;10313;26229;11145;283248;751071;5920;25923;79026;10648;9219;80789;6811;117245;51035;65998,85,3.07433896286994000000
chr20,497015,974841,477826,1,1,6939;1457;343637;83541;51378;140809;113278;85508,8,1.67424962224743000000
chr2,212247400,212513478,266078,1,1,2066,1,0.37582964393899500000
chr16,31307853,31500990,193137,1,1,1339;6524;79798;3687;3684;283933;3681;7041;64755,9,4.65990462728529000000
chr2,158593134,158749661,156527,1,1,90,1,0.63886741584519000000
chr2,61804054,62869158,1065104,1,1,150684;200728;84140;10575;10678,5,0.46943772626898400000
chr16,15048751,16249607,1200856,1,1,4629;100288332;123811;89927;4363;54820;368;255027;23042;54700;123803;9665,12,0.99928717514839400000
chr15,20481702,23699760,3218058,1,1,727832;114791;100996331;123606;283694;81614;100287399;283685;390538;23191;283767,11,0.34182106102500300000
chr7,151776590,152032715,256125,1,1,58508;63917,2,0.78086871644704700000
chr11,62470205,62760655,290450,1,1,374395;283237;10482;9356;2785;54663;221092;79842;10629;1128;9376;26580;79064;6811;5436;6520,16,5.50869340678258000000
chr11,7278825,7465744,186919,1,1,143425,1,0.53499109239831200000
chr8,53363992,53694718,330726,1,1,389658;9821,2,0.60473019962143900000
chr6,123539625,124280442,740817,1,1,154215;10345,2,0.26997220636135500000
chr17,7306518,7460844,154326,1,1,254863;2256;201243;8742;57659;57555;374768;1140;643664;407977;284114;5430,12,7.77574744372303000000
chr15,32021733,32510863,489130,1,1,161725;1139,2,0.40888925234600200000
chr18,67365639,67958040,592401,1,1,10666;25914;220164;9306,4,0.67521830651872600000
chr15,32076948,32510863,433915,1,1,161725;1139,2,0.46091976539183900000
chr6,104736519,120222447,15485928,1,1,221264;441168;64780;25842;84816;256380;51175;221303;51389;28962;8528;8724;221302;619208;254394;221301;5350;202;728464;222545;222553;57107;2444;85413;79632;27244;262;8763;84071;285755;11149;8936;112495;84154;5980;11231;1300;51250;9474;4082;55278;10758;8838;6610;639;7101;23097;117247;2534;345895;57673;254228;442247;222546;57531;91749;7259;285761;3066;2830;9841;23270;116150;100128327;246269;6098;221294;3841;2309;51362;389421;29940;55084;245806;57120;3910;5550;4121;64208;221262;387119;9896;222537;285753,84,0.54242793844837700000
chr13,69124880,72252517,3127637,1,1,1602;57626,2,0.06394603977379730000
chr3,2962570,5218766,2256196,1,1,51095;51185;3568;285362;3708;57633;8553;6419;152330;55207,10,0.44322390430618600000
chr12,1367681,1644535,276854,1,1,23085,1,0.36120121074645800000
chr8,8093066,11936001,3842935,1,1,1508;83650;83595;100133267;203076;2626;83648;613210;137075;613209;157285;640;66036;252969;286046;79660;2222;54984;613211;4482;8658;203074;9258;90459;94137,25,0.65054444064237400000
chr15,32021733,32510863,489130,1,1,161725;1139,2,0.40888925234600200000
chr15,90039583,90199075,159492,1,1,51458;90381;374654,3,1.88097208637424000000
chr15,22866888,23699760,832872,1,1,123606;114791;283685;81614;23191,5,0.60033234398563000000
chr15,32076948,32510863,433915,1,1,161725;1139,2,0.46091976539183900000
chr18,9593755,11408826,1815071,1,1,9989;11031;63895;147495;9218;8774;84203,7,0.38565984471130900000
chr16,28837450,28998957,161507,1,1,11273;27040;79874;7284;930;84901;487;83985;25970,9,5.57251388484710000000
chr19,12997640,13476228,478588,1,1,8677;5886;4784;773;256126;112939;9592;10661;2193;199699;4066;2639;90480;55621;811,15,3.13421982999992000000
chr22,18055303,23603489,5548186,1,1,7332;9342;65078;100423062;1312;6545;613;8214;421;129025;91227;7625;55670;23119;64976;529;6576;83733;164592;8218;5413;80764;23753;5594;23617;7441;7122;150209;8940;128977;5297;2928;128989;140883;150221;54584;91179;8318;728229;101929372;57553;54487;27037;29801;10587;7290;2812;23532;645426;29799;23759;6899;150223;9647;27156;5625;79680;637;11274;9609;3053;400891;1399;2781;8220;388849;84861;51586;7353;9127;51807;9993;8216;85376;440804;85359;23786;5902,78,1.40586490791765000000
chr6,53363035,53687132,324097,1,1,2729;401265;55227,3,0.92564880267327400000
chr9,10164896,11952581,1787685,1,1,5789,1,0.05593826652905850000
chr3,61067122,61330106,262984,1,1,2272,1,0.38025127003924200000
chrX,6552712,8115153,1562441,1,1,412;8228;26609;8226,4,0.25600966692502300000
chr17,1256332,1564729,308397,1,1,10594;1398;7531;5306;124935;8578;4641;83547;51763,9,2.91831632603430000000
chr6,113465762,128774807,15309045,1,1,441168;25842;221303;51389;345895;51020;23493;2173;221302;254228;222546;57515;7259;285761;254394;221301;154215;5350;3066;222553;387357;222545;116150;23270;84870;352999;60487;2444;100128327;3298;81847;6098;5570;79632;221294;10345;387104;3841;154214;7164;135112;245806;29940;5796;387103;57120;4121;9729;135114;55862;1300;387119;134829;4082;222537;221322;10924;2697,58,0.37886099361521200000
chr3,633449,3006111,2372662,1,1,27255;152330,2,0.08429350661830470000
chr16,21951379,22380197,428818,1,1,7385;730094;1039;146177;55718;29904;255762,7,1.63239416255847000000
chr17,72110043,72586885,476842,1,1,6169;10871;100130520;388419;100131439;94015;350383;55890;146723;11314;124599;124602;64446,13,2.72626991749888000000
chr16,27556808,27738842,182034,1,1,23247;2975,2,1.09869584802839000000
chr15,20481702,23699760,3218058,1,1,727832;114791;100996331;123606;283694;81614;100287399;283685;390538;23191;283767,11,0.34182106102500300000
chr15,31014508,32914140,1899632,1,1,9824;51621;653125;22909;161725;283710;54893;643699;4308;728047;1139,11,0.57905952310763400000
chrX,116870319,117198392,328073,1,1,90293,1,0.30481020992279200000
chr2,188210149,189115157,905008,1,1,10203;7035,2,0.22099252161306900000
chr5,178231925,178917594,685669,1,1,2916;117608;80108;30832;345462;9509;285676,7,1.02090075532072000000
chrX,23604216,25068919,1464703,1,1,10549;6303;80311;9468;1968;7543;79135;23597;254158;170302;5165;170067;5422;100130302,14,0.95582517411379600000
chr14,105283325,105653797,370472,1,1,3714;283638;29933;122618;122616;113146;55038;256281,8,2.15940745859336000000
chr16,77549380,77992625,443245,1,1,283927;57687,2,0.45121772383219200000
chr2,109511995,110074155,562160,1,1,344558;10913,2,0.35577059911768900000
chr6,48853322,50153671,1300349,1,1,245915;245928;135398;167;6005;10321;55166;7180;403339;245927;5232;4594;389396;245913,14,1.07663404209178000000
chr18,65676232,66381438,705206,1,1,54495,1,0.14180253713099400000
chr12,702446,998561,296115,1,1,65125;4815,2,0.67541326849366000000
chr16,21951379,22380197,428818,1,1,7385;730094;1039;146177;55718;29904;255762,7,1.63239416255847000000
chr16,67694530,68550178,855648,1,1,55512;80152;54920;50855;5681;64174;57610;64180;55794;123904;84138;6560;81577;57215;100131303;10204;65057;23659;54496;9057;5699;55815;388284;23644;4775;3931;80004;84080;1506,29,3.38924417517484000000
chrX,154120738,154560375,439637,1,1,7411;1193;2157;79184;100272147;116442;65991;4515,8,1.81968305670360000000
chr4,25552218,25725235,173017,1,1,10568,1,0.57797788656606000000
chr1,235420451,235659215,238764,1,1,9453;6905;51742;148789,4,1.67529443299660000000
chr7,43360,1434969,1391609,1,1,23353;2852;90637;11033;5575;54919;90639;84310;340260;54905;115330;5154;51608;56975,14,1.00602971093173000000
chr15,22784523,23699760,915237,1,1,123606;114791;81614;283685;23191,5,0.54630658507031500000
chrX,154120738,154560375,439637,1,1,7411;1193;2157;79184;100272147;116442;65991;4515,8,1.81968305670360000000
chrX,6552712,8115153,1562441,1,1,412;8228;26609;8226,4,0.25600966692502300000
chr5,180008319,180665978,657659,1,1,79908;2324;90933;26693;285659;4245;92304;134083;81786;10399;153579;10917;643836,13,1.97670829411595000000
chr17,1184275,1464993,280718,1,1,1398;7531;4641;5306;286753;51763,6,2.13737629934668000000
chrX,154120738,154560375,439637,1,1,7411;1193;2157;79184;100272147;116442;65991;4515,8,1.81968305670360000000
chrX,71768463,71925753,157290,1,1,55869;5255,2,1.27153665204400000000
chr16,15048751,16276115,1227364,1,1,4629;100288332;123811;89927;4363;54820;368;255027;23042;54700;123803;9665,12,0.97770506548994400000
chr5,178078984,178507337,428353,1,1,2916;117608;80108;30832;345462;285676;6940,7,1.63416621338009000000
chrX,6552712,8115153,1562441,1,1,412;8228;26609;8226,4,0.25600966692502300000
chr15,82349104,82564256,215152,1,1,283726;79631,2,0.92957536997099700000
chr6,145982093,146179955,197862,1,1,84085;7957,2,1.01080551091165000000
chr17,15688588,16532793,844205,1,1,9487;7314;136;57336;9611;54902;201161;388341;51393;125150;57547,11,1.30300104832357000000
chr6,45910207,46189164,278957,1,1,59084;22875;10231;53405,4,1.43391275357851000000
chr17,433983,674677,240694,1,1,55275;50628;79850;51031,4,1.66186111826635000000
chr17,77655336,81099040,3443704,1,1,339231;84733;26502;147111;83882;79058;6904;57674;2194;80233;339230;55036;2642;57332;284184;57521;9146;51181;10966;57597;6182;2548;79643;100130370;79415;5831;5148;116729;284129;125058;4097;284001;5833;9775;3607;4884;9123;56270;8535;71;64118;924;284207;284004;25794;51547;1468;400629;79092;5881;5034;124565;146712;201254;5986;10458;79755;339229;22994;2873;284186;396;201255;256933;51529;1453;284131;55666;348262;79701;64122;339221;6398;6448;255275;146705;79672;2837;9625;10189,80,2.32308003243020000000
chr16,14968855,16292235,1323380,1,1,4629;100288332;123811;89927;4363;9284;54820;23420;123803;255027;23042;54700;368;9665,14,1.05789720261754000000
chrX,151963529,155233098,3269569,1,1,3581;8263;1193;492;9130;2157;50814;3054;7411;10134;139728;8517;30848;554;6901;474383;92002;57595;8266;6845;29944;84968;2539;246100;7739;8260;55559;4204;100272147;65991;5365;8277;26576;4354;474382;10838;139735;2316;8273;6535;114824;11219;393;10251;55558;139716;1736;55217;8270;3654;537;3421;5973;100132963;1852;3897;215;474384;6748;4100;2010;474381;6134;1069;116442;2652;1485;1774;60343;728458;8269;83740;5956;2664;633;79184;4515,77,2.35505046689640000000
chr15,46364600,62197383,15832783,1,1,2585;9236;23741;283652;8854;10681;100820829;2553;283659;5597;145788;5873;256764;373509;3175;6095;256586;10017;102;80031;55329;3990;9318;6938;9101;11001;9245;196951;101928527;27023;663;388121;302;6557;440279;9488;81488;92483;23312;29767;399694;366;145773;55930;29766;1854;56204;54778;29106;10776;161582;9133;145781;2200;26108;342035;79811;2958;4643;54822;3067;4644;9728;56986;51187;22995;54816;1588;50804;84888;64864;2252;54629;54832;79895;79664;399697;23431;4734;123169;84952;374618,82,0.51791273839854900000
chr9,9910369,19437090,9526721,1,1,54801;4781;100129385;11168;10670;9350;8777;6456;340481;340485;54875;123;6619;203238;7306;158219;158297;5789;6194;54796;286343;55667;158326;92949,24,0.25192298588360000000
chr15,22765428,29086044,6320616,1,1,2562;7681;123606;4948;57194;81614;2558;8924;114791;23742;7337;6638;2567;8926;283685;653720;54551;4692;23191,19,0.30060361205300200000
chrX,153576890,153832724,255834,1,1,55558;2539;1774;246100;8270;9130;537;60343;2010;8517;2664;6134;2316;8273;6901;8266,16,6.25405536402511000000
chr19,50908837,51227034,318197,1,1,6320;342918;5424;4606;84258;126119;6689;284361;94030;50944;554235;112703,12,3.77124862899399000000
chr16,29673967,30190593,516626,1,1,653808;5531;26470;283897;253980;146378;8479;83719;23475;283899;124446;9344;3835;4150;226;253982;83723;5595;6911;8448;79447;112476;9961;10423;6693;79153,26,5.03265418310344000000
chr17,34856055,36248918,1392863,1,1,26574;284099;284098;11072;6928;79154;79922;3975;11276;79893;11056;6871;31;80179,14,1.00512397845301000000
chr17,29049501,30361836,1312335,1,1,79915;79736;55352;114659;55813;2124;84440;2123;55803;4974;4763;23512;84282;51379,14,1.06680077876457000000
chr8,70960318,80205291,9244973,1,1,51101;100130301;54332;54968;23643;157869;10499;55284;157506;51050;2138;3574;6921;9312;5569;389668;6129;9242;83690;7013;27067;79776;3174;56704;51110;63978;23471;5828;8989,29,0.31368398804409700000
chr3,9732661,10351437,618776,1,1,55831;115795;6396;401052;132014;7428;285368;285367;4968;10474;7862;151835;51738;84818;78987;3656;64419;9797;26140;10093;8536;55845;84522;63924;100526693;2177,26,4.20184363970160000000
chr17,34437475,36168104,1730629,1,1,26574;9326;6928;3975;414060;79893;729877;31;6349;80179;284098;11072;9560;414062;101060321;414059;79922;11276;79154;11056;6871;284099,22,1.27121410770304000000
chr4,13343352,13889103,545751,1,1,9364;579;259282,3,0.54970123737748500000
chr7,114699365,131966259,17266894,1,1,25913;168850;29923;51691;3614;79974;1080;3952;83992;10447;84928;9296;84691;51384;4698;4233;100130705;27044;22797;857;136263;26136;830;6677;8976;23554;154865;381;29999;7328;142685;26958;5078;64753;2861;7982;813;23553;730130;3751;4899;4232;51530;340348;442721;5420;91584;168433;858;114960;2918;6561;10157;1357;375616;389549;136991;378925;7472;401399;93979;56311;57464;5803;136259;1358;93664;55131;100287482;23008;2318;50833;6608;23534;54556;4289;611;64101;154872;79571;23382;346653;95681;51200;55798;3663,86,0.49806294056128500000
chr1,189065962,206264281,17198319,1,1,2331;2005;360023;7139;1118;10440;55220;134;10877;5317;5877;3075;23528;1116;55224;127833;149345;59349;148811;339479;9911;140609;6051;6738;252839;10446;127829;9928;8497;2165;388722;5929;91156;81788;51022;3078;5778;64407;51377;2494;5788;3814;9877;81494;431704;6003;10878;89796;64710;23271;23114;5549;163486;5996;23046;9580;493;127845;1465;8934;4660;259266;6900;85414;1999;83479;440712;5972;8707;26254;553;647219;29089;4608;3898;779;343450;23612;51706;4194;55765;7135;254428;93273;56956;51094;148808;54900;92703;2848;115019;7832;729533;25802;4656;5129;25778;84919;388730;100381270;9283;59352;3080;127124;6635;5287;22874;79577;10765;55705;5997;23418,112,0.65122643672326300000
chr19,113418,920937,807519,1,1,566;25759;610;51298;400668;1675;126567;91978;284451;682;8612;997;8174;3004;5064;54531;27006;79948;5442;5657;126353;1991;91300;84634;5725;10025;55658;10272,28,3.46741067392842000000
chr8,8149999,11897788,3747789,1,1,1508;83650;83595;203076;2626;83648;613210;137075;613209;157285;640;66036;252969;286046;79660;2222;54984;613211;4482;8658;203074;9258;90459;94137,24,0.64037756661327500000
chrX,72229941,72413748,183807,1,1,340529,1,0.54404892087896600000
chr9,38190770,39103677,912907,1,1,253650;347252;79937;219,4,0.43816073269237700000
chr15,23699641,28525520,4825879,1,1,2562;7681;23742;8924;7337;6638;2567;4948;8926;57194;54551;4692;2558,13,0.26938097701993800000
chr16,15048751,16276115,1227364,1,1,4629;100288332;123811;89927;4363;54820;368;255027;23042;54700;123803;9665,12,0.97770506548994400000
chr3,195740357,197310451,1570094,1,1,622;255798;80235;200933;5062;5130;4241;26043;1739;84984;348793;255758;116211;131540;200931;375387;22916;7037;165918;54965;205564,21,1.33749953824421000000
chr22,18894835,21505417,2610582,1,1,54487;27037;9342;29801;65078;10587;1312;6545;8214;421;7290;2812;6899;5625;7625;79680;64976;6576;3053;8218;5413;80764;23617;400891;1399;7122;150209;128977;8220;388849;84861;7353;51586;2928;128989;5297;9127;9993;54584;91179;85376;8216;85359;8318;728229;5902,46,1.76205918833425000000
chrX,6451676,8097482,1645806,1,1,51481;412;8228;26609;8226,5,0.30380251378352000000
chr8,18787886,26174797,7386911,1,1,55909;80346;55806;63898;9583;8756;9796;649;54793;10361;57805;91782;2796;203069;2675;157310;27299;10863;23221;64641;23516;4747;55790;1960;4741;6570;9046;5520;5533;23039;10174;8795;6781;64236;541565;79873;137814;6440;526;203190;55124;23362;8797;4023;4017;4824;8794;8793;661;8822;55174;2039;51312;157313;64760;11178;80005,57,0.77163512596808000000
chr22,18651614,21464119,2812505,1,1,54487;27037;9342;29801;65078;10587;1312;6545;8214;7290;421;2812;6899;5625;7625;79680;64976;11274;6576;3053;8218;5413;80764;23617;400891;1399;7122;150209;128977;8220;388849;84861;7353;51586;2928;128989;5297;9127;9993;54584;91179;85376;8216;85359;8318;728229;5902,47,1.67110814025220000000
chr16,29597822,30302615,704793,1,1,653808;654483;5531;26470;283897;253980;146378;8479;83719;23475;283899;548593;124446;9344;3835;4150;226;613037;253982;83723;5595;6911;11151;6818;79447;112476;8448;9961;10423;6693;79153,31,4.39845458169988000000
chr3,196394806,197317103,922297,1,1,622;80235;22916;5062;54965;4241;205564;1739;84984,9,0.97582449037566000000
chr16,28819028,29043972,224944,1,1,11273;79874;7284;930;84901;27040;487;83985;25970,9,4.00099580339996000000
chr2,238189332,241266598,3077266,1,1,151176;51052;9208;375316;377007;389090;51665;339768;4705;150677;55502;64284;150678;117581;10267;140739;79083;51540;9759;150681;8864;26146;1293;80895,24,0.77991307868738000000
chr1,146506310,147824207,1317897,1,1,9557;51205;51463;5565;607;2702;2330;200030;2703,9,0.68290617552054500000
chr17,1692,1361431,1359739,1,1,51031;50628;29928;286753;29;400566;359845;55178;55275;100506388;79850;1398;8447;7531;727857;9501;64359,17,1.25023993575238000000
chr17,41396597,60351208,18954611,1,1,9842;654364;10900;84687;92591;84366;79170;1213;81671;10882;2896;55040;100506650;84336;388407;9110;59342;7343;57508;348235;5245;1394;255061;26689;1659;360205;342538;3674;2535;90506;2793;8913;55273;65264;101927581;6827;63897;51326;8161;23531;51651;78995;8288;91369;9343;10614;84643;124995;10642;9496;51136;1353;51629;252983;9884;124801;146894;9020;124783;3131;10014;84073;11248;54799;7484;54828;7706;7473;55181;81558;55379;29916;10040;6198;284067;79089;162417;3212;3690;284076;6668;5414;162540;4831;90507;92579;201176;146909;100506084;54903;284071;56970;56934;4905;51174;3213;4222;2695;8631;55316;8405;64847;54894;9570;146956;284069;113026;5164;5889;1747;80221;201191;51649;388403;79665;50964;10481;51751;1277;6442;23131;10513;3216;84669;6521;22834;6909;246744;10140;9256;83990;7716;124989;4804;140735;9043;51096;9520;10237;4185;516;4353;474170;51225;5697;2118;6426;22843;124773;3219;339210;55771;79777;4355;3214;284083;4591;114881;9969;4836;30009;284058;752;124535;1845;388394;80279;162461;8165;4779;79877;3218;162466;124857;3837;9755;4830;996;124790;51264;80320;64132;8714;4356;80174;1748;3675;162282;56155;3217;124808;10052;5539;55163;284161;10241;4025;9241;124540;404093;729220;124538;3215;4635;51226;8526;388389;3211;10951;8493;2670;104909134;124872;58488;11267;762;11143;379;4137;51747;1101,221,1.16594321033547000000
chr2,84848470,92262019,7413549,1,1,56888;129303;8673;83439;388969;51255;84173;729857;200523;9168;100526767;10618;10713;65055;22934;51315;51652;25885;54884;284948;925;5343;129293;2168;400966;2677;51318;10791;926;5342;150572;55818;9451;822;10989;7844;84913;64795;55258;8869;4144;10578;55037;6439;344167;1768,46,0.62048554612642300000
chr7,12789029,13183870,394841,1,1,,0,0.00000000000000000000
chr3,159720,258637,98917,1,1,10752,1,1.01094857304609000000
chr3,497398,1197716,700318,1,1,27255,1,0.14279227436678800000
chr1,243427494,243728361,300867,1,1,10806;10000,2,0.66474555202132500000
chr5,178620610,178851888,231278,1,1,9509,1,0.43238007938498300000
chr17,29421304,29425365,4061,1,1,4763,1,24.62447672986950000000
chr12,100422496,100667842,245346,1,1,55681;23074;64431;120863,4,1.63035060689801000000
chr15,42621710,43056143,434433,1,1,2595;64397;8773;55142;825;146057;146059;255252;57519,9,2.07166582649108000000
chr10,51308714,51728752,420038,1,1,8505;4477;100652748;8031;100287932,5,1.19036849046991000000
chr6,123509819,124321488,811669,1,1,154215;10345,2,0.24640586248828000000
chr2,200075259,200467796,392537,1,1,23314,1,0.25475305512601400000
chr1,144967252,145746786,779534,1,1,148738;128077;27246;84265;11126;9659;10628;8799;5174;388677;10401;200035;284615;8515;148741;10623;100132406;9939,18,2.30907183009336000000
chr3,167436954,168125978,689024,1,1,5274;27333;11235,3,0.43539847668586300000
chr3,285408,1636926,1351518,1,1,27255;10752,2,0.14798175089048000000
chr15,98221582,98335502,113920,1,1,,0,0.00000000000000000000
chr3,89787833,90309977,522144,1,1,,0,0.00000000000000000000
chr15,20150696,30390051,10239355,1,1,321;7681;2562;727832;100996331;123606;4948;57194;283694;81614;100287399;390538;2558;23359;7082;8924;114791;23742;7337;6638;653073;2567;8926;283685;653720;54551;4692;23191;283767;56160,30,0.29298720476045600000
chr16,29652360,30195608,543248,1,1,653808;5531;26470;283897;253980;146378;8479;83719;23475;283899;124446;9344;3835;4150;226;253982;83723;5595;6911;11151;8448;79447;112476;9961;10423;6693;79153,27,4.97010573439755000000
chr22,18765102,21808997,3043895,1,1,54487;27037;9342;29801;65078;10587;1312;6545;8214;7290;421;2812;6899;5625;7625;79680;23119;64976;6576;3053;8218;5413;80764;23617;400891;1399;7122;150209;128977;8220;388849;84861;7353;51586;2928;128989;5297;9127;9993;54584;91179;85376;8216;440804;85359;8318;728229;5902,48,1.57692693079098000000
chr4,69663481,70715739,1052258,1,1,10941;7363;54490;7365;574537;79799;27284;10720;6783;7364,10,0.95033727469879100000
chr15,33740257,34469176,728919,1,1,57099;56851;1133;6263;79768;161779,6,0.82313672712605900000
chr7,157886367,158377714,491347,1,1,5799,1,0.20352215440411800000
chr6,161387080,161770704,383624,1,1,4216;5071;56895,3,0.78201572372948500000
chr7,83840486,84862326,1021840,1,1,223117,1,0.09786267908870270000
chr1,175443890,175752647,308757,1,1,7143,1,0.32387929666371900000
chr19,52288798,52578302,289504,1,1,80110;284370;2359;79898;284371;59348;9668;84765;65251,9,3.10876533657566000000
chr8,38361540,42628658,4267118,1,1,6867;203102;83877;10947;8973;389649;3620;3551;6422;56892;2515;7994;51125;169355;137964;157848;79698;5423;1142;84296;6575;8749;59339;203100;27121;286;5327;7419;8754;114926,30,0.70305063042550000000
chr6,115195554,116374692,1179138,1,1,2444,1,0.08480771546672230000
chr10,4895138,5583494,688356,1,1,8644;1109;114131;51806;1646;79861;1645;810;10276,9,1.30746299879713000000
chr2,135720300,136376702,656402,1,1,22930;84083;23518;80122,4,0.60938266489133200000
chr5,16497,369929,353432,1,1,153478;57491;10016;6389;389257;133957,6,1.69763914982231000000
chr19,56370487,56579976,209489,1,1,126206;147945;126204;126205,4,1.90940813121453000000
chr18,26420162,28015230,1595068,1,1,,0,0.00000000000000000000
chr15,100363528,100923826,560298,1,1,170691,1,0.17847645360147600000
chr21,47703271,47831225,127954,1,1,8888;5116;54059;54058,4,3.12612345061506000000
chr11,66138374,66706329,567955,1,1,79703;83759;9986;266743;5091;254359;8722;10072;5936;55231;246330;65003;9973;78999;100526737;582;10432;89;6712;3177,20,3.52140574517347000000
chr5,697770,1478459,780689,1,1,7015;340024;9319;348932;81037;65980;6531;10723;79888;85409;79844,11,1.40901178318127000000
chr3,160691342,164272614,3581272,1,1,165679;131149;8706;151742;51068,5,0.13961519817539700000
chr2,62137876,62481776,343900,1,1,150684;10678,2,0.58156440825821500000
chr1,188784197,189174977,390780,1,1,,0,0.00000000000000000000
chr6,106567157,106819449,252292,1,1,9474,1,0.39636611545352200000
chr4,185713439,186004793,291354,1,1,2180;391723,2,0.68645016028611200000
chr9,36980017,37391146,411129,1,1,5079;84186,2,0.48646531867126900000
chr4,185787194,186383829,596635,1,1,353322;83891;57587;55805;291;55325;256309;441054;391723,9,1.50845994619826000000
chr15,22652047,30859049,8207002,1,1,321;7681;2562;101059918;123606;4948;57194;81614;2558;23359;7082;8924;114791;23742;7337;6638;89832;653073;2567;8926;283685;653720;54551;4692;23191;283767;56160,27,0.32898736956564700000
chr7,73390591,73445806,55215,1,1,2006,1,1.81110205560083000000
chr5,14904681,15187548,282867,1,1,,0,0.00000000000000000000
chr15,99297379,99911898,614519,1,1,145814;3480;64927;123355;23336,5,0.81364449268452200000
chr16,15491554,18306841,2815287,1,1,4629;123811;64131;89927;4363;54820;408050;255027;101059938;368;9665,11,0.39072392974499600000
chr17,34817620,36249799,1432179,1,1,26574;284099;9326;284098;11072;6928;79154;79922;3975;11276;79893;11056;6871;31;80179,15,1.04735511413029000000
chr16,29652360,30199384,547024,1,1,653808;5531;26470;283897;253980;146378;8479;83719;23475;283899;124446;9344;3835;4150;226;253982;83723;5595;6911;11151;8448;79447;112476;9961;10423;6693;79153,27,4.93579806370470000000
chr3,159720,1197716,1037996,1,1,27255;10752,2,0.19267896986115600000
chr4,112633106,113001482,368376,1,1,,0,0.00000000000000000000
chr3,195611044,195848768,237724,1,1,10188;7037,2,0.84131177331695600000
chr1,144896178,147441119,2544941,1,1,9557;148738;128077;27246;84265;11126;9659;10628;2330;653519;8799;149013;5174;388677;10401;200035;51205;284615;8515;51463;5565;148741;607;2702;10623;100132406;2703;9939,28,1.10022196978240000000
chr19,2787398,3054462,267064,1,1,115196;80032;58492;79816;7064;148254;166;7089;126295,9,3.36997873168978000000
chr19,2068443,2397612,329169,1,1,4946;55111;268;360200;126306;113177;8175;645191;51690;8943;56928;126308;84444;374872,14,4.25313440816116000000
chr16,29652360,30199168,546808,1,1,653808;5531;26470;283897;253980;146378;8479;83719;23475;283899;124446;9344;3835;4150;226;253982;83723;5595;6911;11151;8448;79447;112476;9961;10423;6693;79153,27,4.93774780178783000000
chr2,137108312,137603680,495368,1,1,80731,1,0.20187012483648500000
chr16,29652360,30199384,547024,1,1,653808;5531;26470;283897;253980;146378;8479;83719;23475;283899;124446;9344;3835;4150;226;253982;83723;5595;6911;11151;8448;79447;112476;9961;10423;6693;79153,27,4.93579806370470000000
chr18,68328082,70100930,1772848,1,1,,0,0.00000000000000000000
chr3,6209671,6981117,771446,1,1,2917,1,0.12962670102638400000
chr7,157194222,158651071,1456849,1,1,55112;54892;5799;10049;57488,5,0.34320646820638200000
chr9,291320,614309,322989,1,1,81704;23189,2,0.61921613429559500000
chr3,93527439,93977082,449643,1,1,415117;200895;5627;63899;200894,5,1.11199329245646000000
chr19,28466718,28825884,359166,1,1,,0,0.00000000000000000000
chr2,108532448,109335603,803155,1,1,6819;9648;27233;3987;442038;60482,6,0.74705380655041700000
chr7,16963703,17412348,448645,1,1,196,1,0.22289337895217800000
chr4,67992436,74983706,6991270,1,1,6779;4589;9508;213;26057;1060;22902;10720;10879;58503;389208;26952;54490;2919;3346;54959;79799;7367;10117;2798;6374;174;2920;7365;8671;339967;27284;173;7364;55236;401137;3576;1448;5473;85438;285521;6783;1633;5196;5197;7363;1446;574537;92597;57050;9407;3347;401138;2926;10886;260436;28983;6372;7366;10941;258;91746;132724;2638;166824;26228;3512;2921;1447,64,0.91542738300766500000
chr13,106069924,107578791,1508867,1,1,1948;55082;267012,3,0.19882468103550500000
chr9,500548,877583,377035,1,1,1761;23189,2,0.53045473231928100000
chr2,117435816,117777783,341967,1,1,,0,0.00000000000000000000
chr1,188784197,189174977,390780,1,1,,0,0.00000000000000000000
chr4,186373368,186620175,246807,1,1,8470;27295;256309,3,1.21552468122865000000
chr15,23682019,28526437,4844418,1,1,2562;7681;23742;8924;7337;6638;2567;4948;8926;57194;283685;54551;4692;2558,14,0.28899240321541200000
chr15,100193139,100623895,430756,1,1,4205;145748;170691,3,0.69644996239170200000
chr3,195740402,197322923,1582521,1,1,622;255798;80235;200933;5062;5130;4241;26043;1739;84984;348793;255758;116211;131540;200931;375387;22916;7037;165918;54965;205564,21,1.32699660857581000000
chr22,49399602,49978478,578876,1,1,,0,0.00000000000000000000
chr1,108317399,108739628,422229,1,1,29957;10451,2,0.47367660677026000000
chr17,65655241,65941965,286724,1,1,2186;25926;26207,3,1.04630236743349000000
chr21,47561655,48095807,534152,1,1,54058;3275;10841;54059;6285;23181;8888;5116;84221;4047,10,1.87212628615076000000
chr12,27306290,27602656,296366,1,1,23012;56938,2,0.67484124359744400000
chr3,15837101,16243602,406501,1,1,117248;23243,2,0.49200370970797100000
chr4,68604106,68818114,214008,1,1,339967;2798;9407,3,1.40181675451385000000
chr4,128905306,129259012,353706,1,1,55132;10424;80167,3,0.84816203287476000000
chr22,21053355,21505445,452090,1,1,80764;9342;3053;8216;400891;1399;6545;150209;9127;5297,10,2.21194894821828000000
chr15,100363528,100923826,560298,1,1,170691,1,0.17847645360147600000
chr19,34858012,38167046,3309034,1,1,2867;53822;84807;5438;4099;388536;148268;90075;92285;163087;55957;25999;644096;126393;57817;92283;2865;495;57677;374897;148109;79171;163115;390927;148266;55851;728361;101927572;388533;5348;53827;27033;126374;93099;147923;51276;284459;728485;2821;339324;51599;284406;26330;1340;284402;79414;374900;163183;2116;148103;374899;57711;84306;84063;333;933;6324;115703;147929;826;84503;284403;79713;5349;163255;10054;7705;163175;22835;84924;57655;199745;1155;7305;58510;9757;1346;84964;199746;126375;4868;84911;25850;7392;3249;339318;10870;23354;342892;2864;10430;55900;11045;148137;163081;199704,96,2.90114879448201000000
chr12,2689306,3044015,354709,1,1,775;2305;83714;55846;7289;83695;2288,7,1.97344865791395000000
chr1,3143120,3404441,261321,1,1,63976;27237,2,0.76534224191702900000
chr15,57624512,58424060,799548,1,1,81488;8854;100820829;145781;84952,5,0.62535332462841500000
chr19,28778563,29349914,571351,1,1,,0,0.00000000000000000000
chr3,1865713,2206719,341006,1,1,152330,1,0.29324997214125300000
chr22,21053355,21441944,388589,1,1,80764;9342;3053;8216;400891;1399;6545;150209;9127;5297,10,2.57341304051324000000
chr6,17345934,18015797,669863,1,1,51439;10486;63971;9972,4,0.59713702652632000000
chr13,76799402,77466755,667353,1,1,115207,1,0.14984573381703500000
chr1,150168348,150415402,247054,1,1,51107;23632;9129;23248;148523;54460;79630;81611,8,3.23815845928421000000
chr10,35072064,35500482,428418,1,1,1390;56288;8453,3,0.70025068974692900000
chr2,133989036,134686673,697637,1,1,344148,1,0.14334102119010300000
chr7,152947401,153526670,579269,1,1,,0,0.00000000000000000000
chr12,126029167,126647517,618350,1,1,114795,1,0.16172070833670300000
chr19,37913558,38644016,730458,1,1,163115;126231;390927;148266;163255;23094;22835;148268;51276;83889;84775,11,1.50590451470174000000
chr11,132228968,134263150,2034182,1,1,4978;23310;112937;29087;83700;112936;219938;89944;27034;27087;22997,11,0.54075790661799200000
chr20,3188938,3593780,404842,1,1,8455;25943;83959;3704,4,0.98803977848148200000
chr22,19500893,20930894,1430001,1,1,54487;27037;5413;29801;65078;10587;1312;7122;421;388849;51586;84861;2812;128989;6899;54584;91179;85376;7625;79680;85359;8318;728229;5902,24,1.67832050467098000000
chr13,20107909,20611032,503123,1,1,7750;9205;93492;54737;55269,5,0.99379277035635400000
chr1,145394735,145746786,352051,1,1,148738;128077;10401;200035;27246;84265;284615;5174;11126;8515;148741;10628;10623;8799;9939,15,4.26074631232407000000
chr6,1729378,2005538,276160,1,1,2762,1,0.36210892236384700000
chr9,2602116,2962629,360513,1,1,7436;169522;9933,3,0.83214752311289700000
chr13,23541339,24912001,1370662,1,1,6445;4285;55504;221178;338872;387911;542767;26278,8,0.58365957471645100000
chr2,236114526,236532064,417538,1,1,116987,1,0.23949915935795100000
chr2,166430295,170143173,3712878,1,1,79809;115677;6335;129446;6323;57818;10170;8647;27347;253782;2591;6332;4036;57405;8708;80034,16,0.43093255420727500000
chr2,38896057,39355498,459441,1,1,90957;100271715;729967;6432;130589;79833;6654,7,1.52359062425861000000
chr11,132529009,132976360,447351,1,1,4978,1,0.22353811660195200000
chr11,131948790,132297920,349130,1,1,4978;50863,2,0.57285251911895300000
chr12,125910988,127149187,1238199,1,1,114795,1,0.08076246225364420000
chr5,25320231,27565118,2244887,1,1,1007,1,0.04454567200932610000
chr16,29437088,30199696,762608,1,1,653808;5531;26470;552900;283897;253980;146378;8479;83719;23475;283899;124446;9344;3835;4150;445329;226;253982;83723;5595;6911;11151;79008;79447;112476;8448;6693;9961;10423;107282092;79153,31,4.06499800683969000000
chr4,62442582,62845213,402631,1,1,23284,1,0.24836637020000900000
chr12,126794386,127569800,775414,1,1,,0,0.00000000000000000000
chr3,79071226,79803650,732424,1,1,6091,1,0.13653293720577200000
chr3,95784627,96328137,543510,1,1,,0,0.00000000000000000000
chr12,114206604,114787864,581260,1,1,9904,1,0.17204005092385500000
chr6,169235012,169493437,258425,1,1,,0,0.00000000000000000000
chr22,23694101,24994500,1300399,1,1,4320;3543;7621;2952;66035;388886;391322;400916;150248;266747;51733;2678;653689;4282;83606;23384;135;51233;6598;1652;29802;56241;100037417;2687;23523;6634;91319,27,2.07628581689158000000
chr1,147125765,147394398,268633,1,1,2702;2703;51205,3,1.11676525222143000000
chr4,188750910,190807379,2056469,1,1,205860;132625;339976,3,0.14588111953061300000
chr3,138605195,138723711,118516,1,1,729627;668;401089,3,2.53130379020554000000
chr6,63518531,64057802,539271,1,1,51557,1,0.18543552314142600000
chr7,5617810,6777328,1159518,1,1,5395;54476;51622;84132;5879;79034;9265;84792;221955;54753;7559;222967;7965;55146;654231;392862;100310846;6624;100131017;27102;11014,21,1.81109736976916000000
chr5,112250207,112455819,205612,1,1,167227;4163;7905,3,1.45905880979709000000
chr7,64273436,65560647,1287211,1,1,51351;2086;435;154807;168374;10793;109504726;2990;7697,9,0.69918606972749600000
chr6,58188154,58704227,516073,1,1,,0,0.00000000000000000000
chr22,23666957,25066484,1399527,1,1,4320;3543;7621;2952;66035;388886;391322;400916;150248;266747;51733;2678;653689;4282;83606;23384;135;51233;6598;1652;29802;56241;100037417;2687;23523;6634;91319,27,1.92922323041999000000
chr7,80262433,80475319,212886,1,1,10512;948,2,0.93946995105361600000
chr16,28403347,29318305,914958,1,1,6799;8663;27040;7284;487;26471;246778;728689;25970;100507607;55911;11273;79874;930;84901;112869;728734;83985;6817;1201,20,2.18589268578448000000
chr15,30930422,32509932,1579510,1,1,51621;22909;161725;283710;54893;89839;4308;1139,8,0.50648618875474000000
chr4,16856199,17805184,948985,1,1,51056;27146;645104;5860;54876;80306;9079,7,0.73763020490313300000
chr1,145379494,145814295,434801,1,1,148738;128077;27246;84265;11126;10628;653519;8799;5174;10401;200035;284615;8515;148741;10623;9939,16,3.67984434258431000000
chr20,60978814,61314492,335678,1,1,140893;140628;28231;128826;81928,5,1.48952269734686000000
chr10,34830984,35139935,308951,1,1,56288,1,0.32367592271913700000
chr15,85055886,85723256,667370,1,1,23478;57538;9154;5151;4828;54993;9640;84942,8,1.19873533422240000000
chr3,64052,290614,226562,1,1,10752,1,0.44138028442545500000
chr21,15196306,15693539,497233,1,1,149998;54033,2,0.40222591823149300000
chr8,126077180,126349313,272133,1,1,286053;9897,2,0.73493475616702100000
chr6,100288688,100633593,344905,1,1,84539,1,0.28993490961279200000
chr3,187445608,187962482,516874,1,1,4026;604,2,0.38694149831487000000
chr3,59722807,60993301,1270494,1,1,2272,1,0.07870954132801890000
chr8,8103647,11852988,3749341,1,1,1508;83650;83595;203076;2626;83648;613210;137075;613209;157285;640;66036;252969;286046;79660;2222;54984;613211;4482;8658;203074;9258;90459;94137,24,0.64011248910141800000
chr11,131948790,132297920,349130,1,1,4978;50863,2,0.57285251911895300000
chr11,132529009,132976360,447351,1,1,4978,1,0.22353811660195200000
chr4,564467,926906,362439,1,1,10815;10336;2580;84179;5158;521;4636;84286,8,2.20726798164657000000
chr11,25459925,26691036,1231111,1,1,143662;159963;63982,3,0.24368233246230400000
chr22,21499435,22957026,1457591,1,1,7332;23753;5594;7441;8940;23532;129025;645426;29799;150221;140883;23759;150223;9647;440804;23119;164592,17,1.16630796979400000000
chr15,23684240,24085595,401355,1,1,4692;7681;283685;54551,4,0.99662393641539300000
chr21,47045443,47482279,436836,1,1,1291;54039,2,0.45783772399710600000
chr21,44992642,45280382,287740,1,1,1476;8566;8568;11077;23076,5,1.73767984986446000000
chr3,178013205,178346721,333516,1,1,10242,1,0.29983569004185700000
chr15,30419801,32702923,2283122,1,1,728498;101059918;51621;89832;653125;22909;161725;283710;54893;89839;4308;1139,12,0.52559609166746200000
chr4,63636515,64134877,498362,1,1,,0,0.00000000000000000000
chr2,74918093,75338106,420013,1,1,56655;3099;6869,3,0.71426360612647700000
chr6,118739885,118890010,150125,1,1,5350;387119,2,1.33222314737719000000
chr16,29652360,30195608,543248,1,1,653808;5531;26470;283897;253980;146378;8479;83719;23475;283899;124446;9344;3835;4150;226;253982;83723;5595;6911;11151;8448;79447;112476;9961;10423;6693;79153,27,4.97010573439755000000
chr1,144896398,150715897,5819499,1,1,9557;84265;9659;10628;54507;126961;51107;200035;317772;284615;5565;730262;653604;644634;723790;2029;27246;11126;1520;54460;8349;8799;9129;56957;149013;10401;9900;8515;8370;51027;1893;333932;10262;79630;148738;128077;8337;148523;2330;653519;554282;5174;51177;388677;81611;55204;8338;51205;554313;645142;10903;2209;148741;653598;10623;80222;100132406;9939;4170;728945;284565;11311;84072;440689;388692;644591;23632;51463;23248;607;2702;200030;2703,73,1.25440351480428000000
chr2,109232445,109496339,263894,1,1,5903;3987;165055,3,1.13682008685305000000
chr17,14104811,15442178,1337367,1,1,1352;64518;9953;201158;284040;100533496;5376;146822,8,0.59819032472014000000
chr11,33105882,33504760,398878,1,1,1479;10114,2,0.50140644507844500000
chr9,86763706,87406685,642979,1,1,64078;4915,2,0.31105214944811600000
chr7,75155769,75499658,343889,1,1,10344;6369;3092,3,0.87237451619563300000
chr2,109210529,110447039,1236510,1,1,344558;65124;5903;151011;10913;3987;165055,7,0.56610945321914100000
chr7,141954089,142470340,516251,1,1,136541;100463482;5644,3,0.58111267581079800000
chr9,71589103,71801885,212782,1,1,5568;9414;8395;2395,4,1.87985825868730000000
chr2,4745097,5303962,558865,1,1,,0,0.00000000000000000000
chr16,8798190,9274514,476324,1,1,18;5373;25880;23589;29035;7874,6,1.25964679503867000000
chr2,158971035,159512023,540988,1,1,8502;130940;151531,3,0.55454095100076200000
chr19,42676560,43757765,1081205,1,1,5670;634;1088;3991;2931;5678;5680;284338;84518;5671;1954;5050;5673;116115;23152;440533;2077;284340;162989;5676;5669;5672;284339;5675,24,2.21974556166499000000
chr20,25456163,25733021,276858,1,1,140838;22981;26152,3,1.08358797650781000000
chr7,72745782,74142342,1396560,1,1,5982;51085;9275;84277;7462;135886;83451;1364;6804;7461;155382;3984;26608;8468;9031;155368;2969;8326;7458;9569;2006;1365;114049,23,1.64690382081686000000
chr7,8197222,8492998,295776,1,1,30010;3382,2,0.67618738504814500000
chr1,83132286,83545426,413140,1,1,,0,0.00000000000000000000
chr16,12007006,12213974,206968,1,1,92017;2935;608,3,1.44949943952688000000
chr15,29025265,30366138,1340873,1,1,7082;321;23359;56160,4,0.29831311391906600000
chr9,584313,902298,317985,1,1,1761;23189,2,0.62896048555749500000
chr11,33035383,33663708,628325,1,1,91614;1479;55346;10114;25758,5,0.79576652210241500000
chr2,131477993,131915728,437735,1,1,130074;50649;344561;55041;205147,5,1.14224359486904000000
chr1,247087852,247405042,317190,1,1,93474;7678;388759;25909;57116;79862,6,1.89161070651660000000
chr1,246194535,246660806,466271,1,1,64754,1,0.21446755213170000000
chr3,84202903,84550414,347511,1,1,,0,0.00000000000000000000
chr13,113538529,113779872,241343,1,1,2155;2159;23263;23250,4,1.65739217628023000000
chr5,23253076,23548783,295707,1,1,56979,1,0.33817258299600600000
chr16,29592791,30193606,600815,1,1,653808;5531;26470;283897;253980;146378;8479;83719;23475;283899;124446;9344;3835;4150;226;253982;83723;5595;6911;8448;79447;112476;9961;10423;6693;79153,26,4.32745520667760000000
chr6,118470465,119612691,1142226,1,1,79632;4121;254394;25842;5350;222553;387119,7,0.61283844002850600000
chr13,113538529,113779872,241343,1,1,2155;2159;23263;23250,4,1.65739217628023000000
chr6,141057205,141970570,913365,1,1,,0,0.00000000000000000000
chr10,88622655,89012295,389640,1,1,6623;657;54537;79812;2746;10974;643161;119385;728118,9,2.30982445334155000000
chr14,43638712,44188294,549582,1,1,,0,0.00000000000000000000
chr2,29344308,30217546,873238,1,1,79745;238,2,0.22903263486014100000
chr2,109210529,110381356,1170827,1,1,344558;65124;5903;151011;10913;3987;165055,7,0.59786800270236300000
chr16,28824778,29076269,251491,1,1,11273;79874;7284;930;84901;27040;487;83985;25970,9,3.57865689030621000000
chr12,123647901,123929358,281457,1,1,8099;196383;91574;55206;387893;10198,6,2.13176435476822000000
chr2,45433372,45961602,528230,1,1,5581;55133,2,0.37862294833689900000
chr5,49559609,49885107,325498,1,1,133418,1,0.30722154974838600000
chr7,56164357,56596555,432198,1,1,51142;389493,2,0.46275086881475600000
chr6,119975943,120608299,632356,1,1,,0,0.00000000000000000000
chr2,107706446,108650803,944357,1,1,285190;60482,2,0.21178431461830600000
chr1,175443890,175752647,308757,1,1,7143,1,0.32387929666371900000
chr8,16330947,16604037,273090,1,1,,0,0.00000000000000000000
chr8,53308370,53527450,219080,1,1,389658;9705,2,0.91290852656563800000
chr4,188852926,189499535,646609,1,1,205860;132625;339976,3,0.46395889942762900000
chr10,134591651,134872554,280903,1,1,3632;84504;54777,3,1.06798432199015000000
chr5,45127204,45908506,781302,1,1,348980,1,0.12799148088703200000
chr3,2262738,2376688,113950,1,1,152330,1,0.87757788503729700000
chr19,45422574,45749641,327067,1,1,5971;388552;1209;344;162979;90332;341;346;11129;79090;284352;79760;284353,13,3.97472077586550000000
chr7,16963703,17412348,448645,1,1,196,1,0.22289337895217800000
chr3,31173180,31523252,350072,1,1,,0,0.00000000000000000000
chr15,30930422,32509932,1579510,1,1,51621;22909;161725;283710;54893;89839;4308;1139,8,0.50648618875474000000
chr1,92292579,92598191,305612,1,1,253152;7049;284697;646817;676,5,1.63606141120113000000
chr17,906875,1078162,171287,1,1,29,1,0.58381546760699900000
chr17,1965723,2408426,442703,1,1,4335;79066;55720;23293;9905;63826,6,1.35531044515172000000
chr17,1084006,1935766,851760,1,1,10594;286753;124935;727910;5345;29;8578;4641;146760;83547;114826;124997;1801;5176;1398;7531;5306;727857;6117;51763,20,2.34807927115619000000
chr2,2581397,3584769,1003372,1,1,51112;7260;55256,3,0.29899179965157500000
chr5,13806064,14159397,353333,1,1,1767;7204,2,0.56603826984742400000
chr22,46461631,46670722,209091,1,1,10343;150383;5465;55020,4,1.91304264650320000000
chr13,43517133,43718448,201315,1,1,94240;29103,2,0.99346794824032000000
chr13,90147011,91936432,1789421,1,1,,0,0.00000000000000000000
chr17,1288562,1537072,248510,1,1,1398;7531;4641;5306;124935;51763,6,2.41438976298740000000
chr8,2323600,2870252,546652,1,1,64478,1,0.18293173719294900000
chr1,2043664,3143883,1100219,1,1,79258;5192;5590;199990;6497;100287898;11079;127281;9651;140625;388585;63976;55229;79906;8764,15,1.36336493007301000000
chr13,87275887,87587791,311904,1,1,,0,0.00000000000000000000
chr4,185787194,186158891,371697,1,1,57587;391723;291;83891,4,1.07614535495309000000
chr4,185494173,185746158,251985,1,1,836;201973;79682;2180,4,1.58739607516320000000
chr13,20146801,20501639,354838,1,1,54737;9205;55269,3,0.84545623636701800000
chr5,137364103,138254137,890034,1,1,51308;1495;7478;2676;8697;51306;51307;1958;8382;26045;10902;51780;3313;2107;995;10112,16,1.79768413341513000000
chr19,12423043,12718875,295832,1,1,163050;147837;90576;79973;10224;57474;163051,7,2.36620784769734000000
chr3,22769259,23024497,255238,1,1,,0,0.00000000000000000000
chr7,16877649,17131582,253933,1,1,155465,1,0.39380466501006200000
chr3,89732071,90089847,357776,1,1,,0,0.00000000000000000000
chr7,151717005,152039367,322362,1,1,58508;168391;63917,3,0.93063078154373000000
chr17,34497643,36391100,1893457,1,1,26574;9326;6928;3975;414060;79893;729877;31;729873;6349;80179;284098;11072;9560;414062;101060321;414059;79922;11276;79154;11056;101060376;6871;284099,24,1.26752284313824000000
chr17,34815461,36249799,1434338,1,1,26574;284099;9326;284098;11072;6928;79154;79922;3975;11276;79893;11056;6871;31;80179,15,1.04577861006262000000
chr10,81679543,88940418,7260875,1,1,657;27069;84332;23063;54537;81619;5995;387694;79812;2746;119385;80195;10718;643161;26103;4143;387695;219348;6623;143241;92211;6441;54462;94233;2894;84293;340745;10974;11155;311,30,0.41317334343312600000
chr9,519607,839220,319613,1,1,23189,1,0.31287838729964100000
chr20,32828550,33042598,214048,1,1,83737;191;434,3,1.40155479144865000000
chr1,22430216,22976085,545869,1,1,714;54361;2046;712;9923,5,0.91597068161042300000
chr15,22652047,28726651,6074604,1,1,2562;7681;123606;4948;57194;81614;2558;8924;114791;23742;7337;6638;2567;8926;283685;54551;4692;23191;283767,19,0.31277759011122400000
chr4,188002248,188414222,411974,1,1,,0,0.00000000000000000000
chr4,189469131,189836679,367548,1,1,,0,0.00000000000000000000
chr19,1727570,1938355,210785,1,1,83855;57455;113178;390874;148229;113179;81926,7,3.32091942026235000000
chr16,29652360,30193606,541246,1,1,653808;5531;26470;283897;253980;146378;8479;83719;23475;283899;124446;9344;3835;4150;226;253982;83723;5595;6911;8448;79447;112476;9961;10423;6693;79153,26,4.80373065112721000000
chr5,52843500,53072275,228775,1,1,4724,1,0.43711069828434000000
chr4,120443213,120811471,368258,1,1,8654,1,0.27154875114729300000
chr16,29652360,30199384,547024,1,1,653808;5531;26470;283897;253980;146378;8479;83719;23475;283899;124446;9344;3835;4150;226;253982;83723;5595;6911;11151;8448;79447;112476;9961;10423;6693;79153,27,4.93579806370470000000
chr13,87636450,88070619,434169,1,1,,0,0.00000000000000000000
chr18,416561,683796,267235,1,1,1068;55556;27098;494514;7298;81035,6,2.24521488577469000000
chr9,37712037,37911074,199037,1,1,51010;79269;92014;22844;158234,5,2.51209574099288000000
chr9,569882,794666,224784,1,1,23189,1,0.44487152110470500000
chr14,95806465,96113360,306895,1,1,51218;161176,2,0.65168868831359300000
chr16,28824778,29039612,214834,1,1,11273;79874;7284;930;84901;27040;487;83985;25970,9,4.18928102628076000000
chr7,72590780,74133327,1542547,1,1,5982;51085;9275;84277;7462;55695;135886;83451;1364;135892;6804;7461;155382;3984;26608;8468;9031;155368;2969;8326;7458;9569;2006;1365;114049,25,1.62069616031148000000
chr1,147125765,147386358,260593,1,1,2702;2703;51205,3,1.15122048558480000000
chr7,87391067,88129132,738065,1,1,53616;79689;6717;10926;154661;55972,6,0.81293652998042200000
chr16,28824778,29039612,214834,1,1,11273;79874;7284;930;84901;27040;487;83985;25970,9,4.18928102628076000000
chr1,93834099,94391219,557120,1,1,8412;30836;54874;2730,4,0.71797817346352700000
chr5,37292628,37557020,264392,1,1,9631;55100,2,0.75645254016763000000
chr17,34815461,36249799,1434338,1,1,26574;284099;9326;284098;11072;6928;79154;79922;3975;11276;79893;11056;6871;31;80179,15,1.04577861006262000000
chr19,28202909,28740984,538075,1,1,,0,0.00000000000000000000
chr12,85761993,87341749,1579756,1,1,9182;25834;4922,3,0.18990274447446300000
chr1,231971505,232332142,360637,1,1,27185,1,0.27728713359971400000
chr7,16963703,17412348,448645,1,1,196,1,0.22289337895217800000
chr10,7250788,7792747,541959,1,1,57713;3698;80760,3,0.55354740856780700000
chr10,12300044,12629820,329776,1,1,57118,1,0.30323613604386000000
chr9,91472,450115,358643,1,1,81704;2298;157983;55871,4,1.11531522990829000000
chr3,138485292,138775082,289790,1,1,389152;668;729627;401089;389151,5,1.72538734945995000000
chr6,168924952,169281611,356659,1,1,64094,1,0.28037985863247500000
chr19,49642268,50548528,906260,1,1,259307;100507003;3276;126129;22809;6237;57479;8463;3661;11284;951;53635;160;5639;6205;25888;83596;51070;126133;23521;147872;80199;57030;2323;8541;28968;114132;54795;23636;57333;55011;3270;27120;60385;51231;84335;113091;2217;58506;199800;81857;79735,42,4.63443162006488000000
chr19,49625878,50594143,968265,1,1,259307;100507003;3276;126129;22809;6237;57479;8463;3661;11284;951;53635;160;5639;6205;25888;83596;51070;126133;23521;147872;80199;57030;2323;8541;28968;114132;54795;23636;57333;55011;3270;27120;60385;51231;84335;113091;2217;58506;199800;81857;79735,42,4.33765549720376000000
chr1,147125765,147386358,260593,1,1,2702;2703;51205,3,1.15122048558480000000
chr3,145298456,145898578,600122,1,1,5352,1,0.16663278466711800000
chr7,68783746,69330800,547054,1,1,26053,1,0.18279731068596500000
chr13,90147011,91936432,1789421,1,1,,0,0.00000000000000000000
chr11,45449325,46180545,731220,1,1,1408;120071;9409;143678;51317;55343;8534;9479,8,1.09406197861109000000
chr9,85675279,86696306,1021027,1,1,80010;414328;257019;55582;80318;29979;84267;3190;158158,9,0.88146542647745800000
chr4,14341945,14638360,296415,1,1,,0,0.00000000000000000000
chr22,45756162,46622239,866077,1,1,7477;25814;27127;55267;5465;26150;2192,7,0.80824222326652300000
chr13,90147011,91936432,1789421,1,1,,0,0.00000000000000000000
chr2,38896057,39355498,459441,1,1,90957;100271715;729967;6432;130589;79833;6654,7,1.52359062425861000000
chr10,104899060,105240726,341666,1,1,22978;9118;729020;6877;119395;84108;51063;255022;22984;84833,10,2.92683497919020000000
chr7,97502748,97809819,307071,1,1,4951;22853,2,0.65131516815329400000
chr1,146155929,147825519,1669590,1,1,9557;51205;51463;2703;5565;607;2702;2330;200030;149013,10,0.59894944267754400000
chr6,28641388,28871256,229868,1,1,5987,1,0.43503227939513100000
chr16,147877,802402,654525,1,1,3040;146325;84331;124093;3039;4833;8312;64714;89941;8131;84264;58986;84326;10573;26063;9727;117166;6650;9028;65990;64428;3042;146330;339123;398;283948;8786;83986;79006;10273;84219;3049;57799;3050;9091;197335;55692,37,5.65295443260380000000
chr8,590409,860041,269632,1,1,9228;157697,2,0.74175172086399200000
chr22,40390067,40770401,380334,1,1,113828;23112;158;27352,4,1.05170718368592000000
chr22,18643474,21722313,3078839,1,1,54487;27037;9342;29801;65078;10587;1312;6545;8214;7290;421;2812;6899;5625;7625;79680;64976;11274;6576;3053;8218;5413;80764;23617;400891;1399;7122;150209;128977;8220;388849;84861;7353;51586;2928;128989;5297;9127;9993;54584;91179;85376;8216;85359;8318;728229;5902,47,1.52654945581760000000
chr9,22973960,23348716,374756,1,1,,0,0.00000000000000000000
chr1,188784197,189174977,390780,1,1,,0,0.00000000000000000000
chr7,15173333,15394446,221113,1,1,392636,1,0.45225744302686900000
chr20,53786591,54211011,424420,1,1,,0,0.00000000000000000000
chr4,172979916,173225080,245164,1,1,442117,1,0.40789022858168400000
chr17,15755722,20560226,4804504,1,1,9487;2314;9720;125170;54902;11216;79018;254272;7314;8533;5598;218;224;80039;51655;256223;201163;7156;51030;10750;10743;100129396;140775;51393;57547;1819;147166;7732;91647;201161;3996;4239;201164;55244;9611;55090;645027;79999;284194;10400;54890;9706;92521;22905;729288;100996259;23164;83450;51168;5636;644815;125150;10517;654346;388436;27077;388341;6470;6720;146691;136;23495;57336;125206;146802;56953;400581,67,1.39452480422537000000
chr4,85755841,86555973,800132,1,1,83478;23001,2,0.24995875680512700000
chr3,190625696,191281778,656082,1,1,344901;257313;152137;152138,4,0.60967988757502900000
chr1,25008103,25221071,212968,1,1,25932,1,0.46955411141580000000
chr1,15825145,16177547,352402,1,1,842;23341;388595;440567;23207;54751;284723;79814;6248;84301;23013,11,3.12143517914200000000
chr16,28824778,29039612,214834,1,1,11273;79874;7284;930;84901;27040;487;83985;25970,9,4.18928102628076000000
chr9,12621309,12859987,238678,1,1,7306;286343,2,0.83794903593963400000
chr1,145394735,145799615,404880,1,1,148738;128077;27246;84265;11126;10628;653519;8799;5174;10401;200035;284615;8515;148741;10623;9939,16,3.95178818415333000000
chr2,85406355,85614201,207846,1,1,83439;84173;10618;54884,4,1.92450179459792000000
chr9,115379600,115592639,213039,1,1,58493;158405;401548,3,1.40819286609494000000
chr2,203261308,203851208,589900,1,1,659;55759;130026;150864;79800,5,0.84760128835395800000
chr1,70384195,72336849,1952654,1,1,9295;81573;5733;55631;9406;257194;57554;11147;1491,9,0.46091114964555900000
chr15,30930422,32426904,1496482,1,1,51621;22909;161725;283710;54893;89839;4308;1139,8,0.53458711832150300000
chr7,19682014,19980145,298131,1,1,221830;256130,2,0.67084603748016800000
chr19,45518087,46034450,516363,1,1,5971;10848;6253;147699;2067;79090;10849;80207;1158;147700;284353;7408;388552;90332;57787;162979;11129;284352;2354;79760;2068,21,4.06690642048326000000
chr4,186038919,186184136,145217,1,1,57587;291;83891,3,2.06587383019894000000
chr2,182714041,183222120,508079,1,1,151242;6744;5136,3,0.59045935769831100000
chr2,170173,381573,211400,1,1,52;26751;285016,3,1.41911069063387000000
chr2,109210529,109496339,285810,1,1,5903;3987;165055,3,1.04964836779679000000
chr9,115379600,115592639,213039,1,1,58493;158405;401548,3,1.40819286609494000000
chr17,2326495,2561733,235238,1,1,5048;79066,2,0.85020277336144700000
chr5,7099458,8136044,1036586,1,1,4552;79072;108;134121,4,0.38588211687211700000
chr11,9516182,10172980,656798,1,1,7465;81846;7702;23075,4,0.60901525278700600000
chr22,23694101,24994500,1300399,1,1,4320;3543;7621;2952;66035;388886;391322;400916;150248;266747;51733;2678;653689;4282;83606;23384;135;51233;6598;1652;29802;56241;100037417;2687;23523;6634;91319,27,2.07628581689158000000
chr17,38922557,40334331,1411774,1,1,83900;653240;728318;100132476;83899;83895;162605;8689;3861;3884;83902;3886;3859;147184;81872;85289;8688;3883;7266;85285;3728;728224;390792;730755;342574;3858;85280;3860;23415;100132386;100505753;353288;83755;2520;3872;5878;3882;81851;79132;3866;83897;3880;83896;83901;115024;10209;47;3857;81870;100533177;94086;10609;81850;25984;84616;100505724;201181;125115;3868;60681;100507608;9001;728255;317719;28511;81871;85291;83538;8687;55175;85294;728279;3885;3881;85290;1267;2648;54474;85293,79,5.59579649433975000000
chr5,173758764,174107678,348914,1,1,,0,0.00000000000000000000
chr9,71589103,71801885,212782,1,1,5568;9414;8395;2395,4,1.87985825868730000000
chr3,30226342,30577168,350826,1,1,,0,0.00000000000000000000
chr11,132529009,132976360,447351,1,1,4978,1,0.22353811660195200000
chr11,131948790,132297920,349130,1,1,4978;50863,2,0.57285251911895300000
chr3,5579943,7215728,1635785,1,1,2917,1,0.06113272832309870000
chr5,94478219,95081024,602805,1,1,317671;285601;153643;83890;9652;22836;153642;79772,8,1.32712900523387000000
chr1,245706209,245925782,219573,1,1,55083;64754,2,0.91085880322261800000
chr19,2258197,2530043,271846,1,1,4946;84823;645191;56928;51690;26517;4616;2788;360200;374872,10,3.67855329855874000000
chr6,84989012,85384998,395986,1,1,,0,0.00000000000000000000
chr13,109161265,109815708,654443,1,1,23026,1,0.15280169548761300000
chr19,54558485,55116628,558143,1,1,79143;11027;284415;26121;11024;10288;4696;114823;94059;23547;29844;10990;11025;57348;6203;147798;79042;148170;79165;441864;3903;3904;126014;4849,24,4.29997330433240000000
chr13,23553332,24910774,1357442,1,1,6445;4285;55504;221178;338872;387911;542767;26278,8,0.58934378043408100000
chr4,151894804,152224270,329466,1,1,345062;152503;6189;987,4,1.21408582372688000000
chr16,83743188,84190735,447547,1,1,3281;123872;1012;83693;146167;8720;23417;54550;29948,9,2.01096197717782000000
chr1,145394735,145814295,419560,1,1,148738;128077;27246;84265;11126;10628;653519;8799;5174;10401;200035;284615;8515;148741;10623;9939,16,3.81351892458766000000
chr2,127820385,128032967,212582,1,1,339761;2071;274,3,1.41122014093385000000
chr13,20309816,21179530,869714,1,1,7750;51084;9205;10804;2700;55269;8100;2706,8,0.91984261492858600000
chr7,517337,914236,396899,1,1,23353;5154;5575;54919,4,1.00781307083162000000
chr7,63534210,63777276,243066,1,1,442319;730291;728927;168417,4,1.64564357005916000000
chr2,240774571,241006600,232029,1,1,389090;4705;150681,3,1.29294183054704000000
chr21,43162948,44941200,1778252,1,1,49854;7031;89766;4731;5316;1409;54101;54020;64699;25966;9619;63977;10785;7033;5152;89765;7307;875;7032;150094;53347;90625,22,1.23716998490653000000
chr4,70324493,70667852,343359,1,1,27284;10941;7363;574537,4,1.16496145433788000000
chr10,85070155,85452467,382312,1,1,,0,0.00000000000000000000
chr4,188586393,188927040,340647,1,1,132625,1,0.29355902150906900000
chr6,170684291,170870793,186502,1,1,5689;84498;6908,3,1.60856183847894000000
chr11,81341260,89243427,7902167,1,1,84233;60494;1740;58487;65084;220042;51501;27314;50507;5547;8726;2915;54843;51585;220382;220388;11098;8301;338699;10873;23682;220047;55863;1075;60492;7299;8322,27,0.34167842820836400000
chr5,17855840,18516154,660314,1,1,,0,0.00000000000000000000
chr4,154417256,155088308,671052,1,1,285533;6423;7097;23240,4,0.59607899238807100000
chr18,65688078,66532585,844507,1,1,54495;79839,2,0.23682456154892700000
chr4,128939094,129261363,322269,1,1,55132;10424;80167,3,0.93089934185416500000
chr12,2253529,3598972,1345443,1,1,7004;10867;56341;83714;55846;83695;2288;775;2305;7289,10,0.74324962112850600000
chr1,145412876,145899418,486542,1,1,148738;128077;27246;84265;11126;10628;653519;8799;5174;10401;200035;284615;8515;148741;10623;9939,16,3.28851363294433000000
chr16,63571587,64276928,705341,1,1,,0,0.00000000000000000000
chr22,21468352,22957026,1488674,1,1,7332;23753;5594;7441;8940;23532;129025;645426;29799;150221;140883;23759;150223;9647;440804;23119;164592,17,1.14195586139074000000
chr1,4859368,5496181,636813,1,1,,0,0.00000000000000000000
chr5,94430002,94670467,240465,1,1,79772,1,0.41586093610296700000
chr7,70236315,70525737,289422,1,1,26053,1,0.34551623580792100000
chr2,242768430,243087748,319318,1,1,285093;5133,2,0.62633487620491200000
chr7,63534210,63777276,243066,1,1,442319;730291;728927;168417,4,1.64564357005916000000
chr12,67269286,70909616,3640330,1,1,11052;55801;55832;8089;1368;8445;117177;10818;50616;10576;4069;4193;376132;196446;56890;27345;4848;144453;5908;3458;55508;57122,22,0.60434081525576000000
chr10,56104317,56555709,451392,1,1,65217,1,0.22153693463774300000
chr3,123095672,123163551,67879,1,1,111,1,1.47320968193403000000
chr6,167623337,168192844,569507,1,1,83887;54346;6953,3,0.52677140052712300000
chr6,111435514,111656531,221017,1,1,91749;5980;117247,3,1.35736165091373000000
chr2,108549754,110457691,1907937,1,1,5903;10913;3987;442038;60482;6819;9648;344558;151011;65124;27233;165055,12,0.62895158487937500000
chr10,34686335,35292929,606594,1,1,56288,1,0.16485491119265900000
chr7,72721410,74142342,1420932,1,1,5982;51085;9275;84277;7462;55695;135886;83451;1364;135892;6804;7461;155382;3984;26608;8468;9031;155368;2969;8326;7458;9569;2006;1365;114049,25,1.75940861350156000000
chr1,114865188,115075117,209929,1,1,51592,1,0.47635152837387900000
chr3,81629181,82093427,464246,1,1,2632,1,0.21540304062932200000
chr11,101170325,102219157,1048832,1,1,7225;253935;329;330;10413;85016;57562,7,0.66740907981449800000
chr4,186713235,186990904,277669,1,1,8470;7098,2,0.72028206245565800000
chr4,186327217,186430593,103376,1,1,441054;256309;27295;55325,4,3.86937006655317000000
chr6,123509819,124321488,811669,1,1,154215;10345,2,0.24640586248828000000
chr3,95784627,96328137,543510,1,1,,0,0.00000000000000000000
chr6,123509819,124321488,811669,1,1,154215;10345,2,0.24640586248828000000
chr2,51226180,52247261,1021081,1,1,9378,1,0.09793542334055770000
chr17,34815077,36249799,1434722,1,1,26574;284099;9326;284098;11072;6928;79154;79922;3975;11276;79893;11056;6871;31;80179,15,1.04549870985459000000
chr19,11338617,12129263,790646,1,1,64748;126070;1995;126069;115950;126068;126074;1264;55552;2057;84337;126075;90592;284390;374882;199692;51295;163059;9545;57572;54;26526;5589;7620;55908;115948;57139;90594,28,3.54140791201119000000
chr7,41097,611191,570094,1,1,5154;5575;56975,3,0.52622900784782900000
chr18,55940650,56606964,666314,1,1,10892;55205;23327;101927322;115701,5,0.75039695999183600000
chr18,53104130,53223310,119180,1,1,6925,1,0.83906695754321200000
chr10,81641918,81976960,335042,1,1,6441;80195;219348;311,4,1.19388017024731000000
chr15,85149663,85728854,579191,1,1,23478;57538;9154;5151;4828;54993;9640;84942,8,1.38123693220371000000
chr1,147125765,147441119,315354,1,1,2702;51463;2703;51205,4,1.26841581207151000000
chr15,22299329,28726651,6427322,1,1,2562;7681;123606;4948;57194;283694;81614;390538;2558;8924;114791;23742;7337;6638;2567;8926;283685;54551;4692;23191;283767,21,0.32673016849008000000
chr14,89181308,89461560,280252,1,1,161436;123016,2,0.71364343519404000000
chr2,114581448,114932564,351116,1,1,10096,1,0.28480616092687300000
chr8,2262856,3387381,1124525,1,1,64478,1,0.08892643560614480000
chr2,115476196,115922635,446439,1,1,57628,1,0.22399476748223200000
chr3,162307728,163133540,825812,1,1,,0,0.00000000000000000000
chr7,140978829,141456242,477413,1,1,100507421;55750;6742;494551;57189,5,1.04731123785904000000
chr4,63607544,64134877,527333,1,1,,0,0.00000000000000000000
chr17,10009854,10414763,404909,1,1,4622;4619;8735;8522;4626,5,1.23484536031553000000
chr2,109210529,109496339,285810,1,1,5903;3987;165055,3,1.04964836779679000000
chr22,49010019,51178515,2168496,1,1,85358;410;400935;85378;9701;56666;5600;49;9889;23774;80305;414918;79174;9997;1120;440836;1375;415116;83642;23542;644186;23209;6300;83933;79924;79087;6305;1890;348645;23654;25817;113730;29781;55586;91289;54456,36,1.66013679527193000000
chr1,564426,2281249,1716823,1,1,85452;83858;126789;5590;81669;728661;29101;199990;339453;6497;643988;9636;126792;219293;8510;163688;84808;64856;26155;81399;6339;55052;254173;80772;65220;339456;375790;984;388581;54587;54973;84069;148398;401934;54998;9906;116983;339451;643965;51150;7293;118424;728642;2563;8784;55210;2782;54991;1855;83756;142678;441869;57801;79906,54,3.14534462783875000000
chr1,194012942,194311009,298067,1,1,,0,0.00000000000000000000
chr12,27331272,27760067,428795,1,1,341346;23012;8496;56938,4,0.93284669830571700000
chr2,114315940,114555037,239097,1,1,80255;11159,2,0.83648059155907400000
chr10,35425564,35683850,258286,1,1,1390;219771,2,0.77433542662010300000
chr12,475066,769160,294094,1,1,283358;5927;4815;84318,4,1.36010935279196000000
chr5,157900279,158309572,409293,1,1,1879,1,0.24432374851267900000
chr6,53788459,54775188,986729,1,1,222584;27283;90523;55227,4,0.40537979526293400000
chr9,12249496,12794655,545159,1,1,7306;286343,2,0.36686544659448000000
chr20,49550687,49856519,305832,1,1,3755;8813;27304,3,0.98093070705485400000
chr20,49872256,50008001,135745,1,1,4773,1,0.73667538399204400000
chr20,50286006,50333944,47938,1,1,10079,1,2.08602778589011000000
chr20,49272475,49549132,276657,1,1,84612;55653;140876;23394,4,1.44583364960944000000
chr20,50052033,50254914,202881,1,1,4773;10079,2,0.98579955737599900000
chr16,7238561,7748673,510112,1,1,54715,1,0.19603538046546600000
chr16,29652360,30199384,547024,1,1,653808;5531;26470;283897;253980;146378;8479;83719;23475;283899;124446;9344;3835;4150;226;253982;83723;5595;6911;11151;8448;79447;112476;9961;10423;6693;79153,27,4.93579806370470000000
chr1,25719563,25994080,274517,1,1,55219;57134;26119;6006,4,1.45710466018498000000
chrX,154118673,154560356,441683,1,1,7411;1193;2157;79184;100272147;116442;65991;4515,8,1.81125377250200000000
chr17,19958955,22205821,2246866,1,1,23326;92521;25979;339184;100996259;339263;256302;284194;5606;100462977;256223;8834;3768,13,0.57858368055771900000
chr3,12641572,12793182,151610,1,1,55287;5894,2,1.31917419695271000000
chr15,22784523,23179948,395425,1,1,123606;23191;114791;81614,4,1.01156982992982000000
chrX,6467006,8131810,1664804,1,1,412;8228;26609;8226,4,0.24026852410253700000
chr15,32021733,32510863,489130,1,1,161725;1139,2,0.40888925234600200000
chr2,163367097,168684662,5317565,1,1,6326;79809;2591;6335;6323;129446;151258;22837;6332;90134;2888;6328;8708;80034;55137,15,0.28208399897321400000
chr16,15048751,16276115,1227364,1,1,4629;100288332;123811;89927;4363;54820;368;255027;23042;54700;123803;9665,12,0.97770506548994400000
chr10,87192947,87450629,257682,1,1,2894,1,0.38807522450151700000
chr16,15048751,16276115,1227364,1,1,4629;100288332;123811;89927;4363;54820;368;255027;23042;54700;123803;9665,12,0.97770506548994400000
chr1,759762,2495194,1735432,1,1,85452;83858;126789;5590;81669;728661;29101;199990;339453;6497;643988;9636;126792;219293;8510;163688;84808;64856;26155;388585;55229;6339;55052;254173;80772;65220;339456;11079;8764;375790;984;388581;54587;54973;84069;148398;5192;401934;54998;9906;116983;339451;643965;51150;7293;118424;728642;2563;8784;55210;2782;54991;1855;9651;83756;142678;441869;57801;79906,59,3.39972986553204000000
chrX,153609113,153740434,131321,1,1,55558;2010;1774;2664;8270;9130;6134;537;8273;6901;8266;60343,12,9.13791396654000000000
chrX,46130431,46587265,456834,1,1,641339;84679;56548;55634,4,0.87559157155553200000
chr15,22784523,23179948,395425,1,1,123606;23191;114791;81614,4,1.01156982992982000000
chr15,20481702,23179948,2698246,1,1,727832;114791;100996331;123606;283694;81614;100287399;390538;23191;283767,10,0.37061113034171100000
chr5,148985478,149372929,387451,1,1,133522;389337;5145;81789;1836,5,1.29048576465153000000
chr1,145382124,145792051,409927,1,1,148738;128077;27246;84265;11126;10628;653519;8799;5174;10401;200035;284615;8515;148741;10623;9939,16,3.90313397263415000000
chrX,6448752,8135645,1686893,1,1,51481;412;8228;26609;8226,5,0.29640291352207900000
chr6,162573254,162664364,91110,1,1,5071,1,1.09757436066293000000
chr9,86741461,87435983,694522,1,1,64078;4915,2,0.28796783975165700000
chr9,2077800,11573590,9495790,1,1,10171;23081;55664;89882;50808;158358;5789;6019;169792;55064;6505;29126;2315;5991;26953;90865;7436;3717;90871;6013;57589;3641;403313;169522;115426;6595;79956;9933;2731;55848;11172;80380,32,0.33699144568277100000
chr16,14968859,16291983,1323124,1,1,4629;100288332;123811;89927;4363;9284;54820;23420;123803;255027;23042;54700;368;9665,14,1.05810188614219000000
chr12,49005890,52622880,3616990,1,1,113251;10024;9802;1990;9416;283471;79962;613227;25840;377;160622;57701;50846;4891;60673;29127;91;51303;362;57228;6602;2819;57609;784;401720;341405;5463;23416;144501;85478;84070;10445;466;5630;65244;144233;54934;84790;3164;283403;7471;121006;41;112;25766;51474;7480;51411;8085;10376;27289;7009;121268;6334;7024;363;7846;94;81566;359;338761;904;23109;91010;25875;91012;84987;23017;55716;9498;11226;5571,72,1.99060544817652000000
chr16,15492317,16276115,783798,1,1,4629;123811;89927;4363;54820;255027;368;9665,8,1.02067114230963000000
chr16,15048751,16276115,1227364,1,1,4629;100288332;123811;89927;4363;54820;368;255027;23042;54700;123803;9665,12,0.97770506548994400000
chrX,45980424,46407689,427265,1,1,641339;55634,2,0.46809357190502400000
chr16,15048751,16276115,1227364,1,1,4629;100288332;123811;89927;4363;54820;368;255027;23042;54700;123803;9665,12,0.97770506548994400000
chr16,29652999,30198600,545601,1,1,653808;5531;26470;283897;253980;146378;8479;83719;23475;283899;124446;9344;3835;4150;226;253982;83723;5595;6911;11151;8448;79447;112476;9961;10423;6693;79153,27,4.94867128176085000000
chr14,68750616,75420179,6669563,1,1,1743;338917;5228;57452;22990;9628;283571;55334;51241;9870;145482;5890;8816;6430;2079;9240;8110;4293;641372;5826;56252;8747;23508;641371;646658;57862;400224;4329;122970;8650;10965;89932;64093;53349;56936;55333;4053;399671;83544;83694;91750;5663;80127;6547;91748;55218;10577;26094;122961;8748;100529257;58517;6554;145483;10001;87;79697;9766;51077;26037;51004;957;55237;677,64,0.95958310911824400000
chr3,195953281,196960881,1007600,1,1,255798;80235;200933;5062;5130;4241;26043;1739;84984;348793;255758;116211;200931;375387;22916;165918;54965;205564,18,1.78642318380310000000
chrX,10638506,13935688,3297182,1,1,265;3052;92552;10943;2824;7114;4281;5634;9367;170082;6399;25975;51311;51284;395;171484;8481;9758,18,0.54592072867072500000
chr17,29248273,29497422,249149,1,1,84282;55803;4763,3,1.20409875215233000000
chrX,20684395,27884677,7200282,1,1,80311;286514;139411;9468;7543;1968;23597;254158;404281;139422;5165;168400;5422;6611;23676;347442;10549;6303;347541;158506;158809;170302;79135;22866;51360;5251;170067;100130302;257240,29,0.40276200293266300000
chr1,64538290,76333231,11794941,1,1,100526835;9295;431707;81573;5733;1647;148581;57708;23169;54741;9406;57554;6121;10022;26135;4919;200132;79971;5876;127254;149233;3716;400757;9829;5142;3595;57685;51086;55970;204962;205;11147;1429;55635;127253;34;55631;3953;9077;257194;4438;84251;79819;127255;55225;1491;8790,47,0.39847592285540000000
chr16,15048751,16276115,1227364,1,1,4629;100288332;123811;89927;4363;54820;368;255027;23042;54700;123803;9665,12,0.97770506548994400000
chr16,28837450,29042118,204668,1,1,11273;27040;79874;7284;930;84901;487;83985;25970,9,4.39736548947564000000
chrX,38491539,38547951,56412,1,1,7102,1,1.77267248103240000000
chr16,15048751,16276115,1227364,1,1,4629;100288332;123811;89927;4363;54820;368;255027;23042;54700;123803;9665,12,0.97770506548994400000
chr12,163618,9721829,9558211,1,1,4704;144195;55846;10436;25977;2784;51279;57101;6337;1822;171017;9332;654429;83461;928;50856;5927;920;57379;57121;4074;79923;55080;26253;144568;55810;10233;715;283358;894;1108;2;5763;81029;2251;83695;775;84318;3736;50813;55200;170482;10867;3902;9918;7450;5777;196513;5858;4908;27239;57494;93978;83758;9573;57097;338339;3741;7167;7132;11331;283316;341392;5893;2288;51147;1911;84519;84727;6540;84766;2597;10219;7289;83714;93589;5830;939;57102;8798;10566;10635;6843;8078;8079;26290;113246;7004;6539;440073;56341;10536;4055;4839;359787;196500;6515;719;2305;55138;4815;716;51258;9746;144699;10162;360030;8074;25900;65125;440077;339;23085;3742;57103;8076;79602;2026,118,1.23454064782625000000
chr10,110729064,119434861,8705797,1,1,3026;8036;840;26033;143187;153;79949;10285;7511;5407;9126;4601;64429;55088;340706;2018;4892;92482;6934;9937;143379;11023;142940;150;119548;387712;1847;57700;338567;2674;51703;118987;5408;6571;259217;3983;6975;84632;27250;282996;56165;374355;374354;5406;120;57698;57678,47,0.53987015778107400000
chr20,24780394,31184566,6404172,1,1,5834;22981;8530;26090;245934;140838;171023;5326;81502;22974;3397;128853;9371;26152;245936;3055;30813;81572;2307;9837;245930;343702;23509;164395;9777;245932;245929;117285;598;955;245937;84701;28954;140706;84532;57136;85366;140688,38,0.59336320136311100000
chr16,15048751,16276115,1227364,1,1,4629;100288332;123811;89927;4363;54820;368;255027;23042;54700;123803;9665,12,0.97770506548994400000
chr16,15048751,16276115,1227364,1,1,4629;100288332;123811;89927;4363;54820;368;255027;23042;54700;123803;9665,12,0.97770506548994400000
chr16,9188000,9934830,746830,1,1,29035;2903,2,0.26779856192172200000
chr16,14929038,16294417,1365379,1,1,4629;100288332;123811;89927;4363;9284;54820;23420;123803;255027;23042;54700;368;9665,14,1.02535632963448000000
chr16,28837450,29042118,204668,1,1,11273;27040;79874;7284;930;84901;487;83985;25970,9,4.39736548947564000000
chrX,38491539,38547951,56412,1,1,7102,1,1.77267248103240000000
chrX,48732626,49173655,441029,1,1,27238;10245;89801;90060;7355;56850;11152;778;79917;5355;10084;55593;4007;11040;50943;6855;11230;3750;28952;7030,20,4.53484918225332000000
chrX,52903251,53324469,421218,1,1,23096;29057;64061;727866;8242;54328,6,1.42444055097361000000
chr1,146496425,147398560,902135,1,1,9557;607;2702;2330;51205;2703;5565,7,0.77593708258741800000
chr16,29674848,30198600,523752,1,1,653808;5531;26470;283897;253980;146378;8479;83719;23475;283899;124446;9344;3835;4150;226;253982;83723;5595;6911;11151;8448;79447;112476;9961;10423;6693;79153,27,5.15511157952619000000
chr11,25676607,30921119,5244512,1,1,341019;159963;63982;143662;196074;627;120534;91057;81930;55327;387758;55366;3739;2488;744;8424,16,0.30508081590813400000
chr11,30949381,31474810,525429,1,1,120526;341019;196294,3,0.57096201389721500000
chr10,131029721,132227575,1197854,1,1,4255;253738;10539,3,0.25044788429975600000
chr16,29673954,30119759,445805,1,1,653808;5531;26470;283897;253980;146378;8479;83719;23475;283899;124446;9344;3835;4150;226;253982;83723;6911;8448;79447;112476;9961;10423;6693;79153,25,5.60783302116396000000
chr11,55028487,57893993,2865506,1,1,390155;84767;390144;219541;26519;10978;219453;9246;390168;390174;8501;280636;25921;283189;282770;219431;81328;5553;390148;219479;710;219956;338674;219484;219952;282775;349667;120586;81309;219428;390152;81168;10394;6749;390154;219493;51075;219464;219482;5024;390157;219469;390142;219437;219473;29015;390162;390181;26338;219436;10798;219447;219954;187;219537;81327;79097;219487;219432;219429;81300;1500;643376;338675;219438;85456;390167;219539;390151;219527;219477;219417,72,2.51264523612933000000
chr11,4393574,10150556,5756982,1,1,26515;341277;120775;256892;23258;390038;10527;143630;8642;65975;338322;56676;23538;390093;10612;340980;120065;322;160298;390058;23647;119678;120793;119682;56673;7275;390066;401667;79608;401665;119679;112464;53840;9866;390064;390036;282763;445372;51700;119772;341276;390084;6881;440026;143501;79345;119692;3046;390054;1200;283298;390075;390078;81846;119774;4004;23378;120066;23075;119694;3043;3611;387748;79473;119695;8590;56675;56547;390063;144125;84067;6609;26496;120787;50613;6157;390037;120796;283297;8495;283111;117854;56674;887;144124;390081;8665;6737;143502;3047;1262;27288;390067;63875;390079;390083;119687;81285;6764;390072;10346;196335;55128;85363;144132;401666;7465;3263;3048;3045;255725;338323;56672;390059;7702;79339;120776;390077;79324;390061;143425;57758;7761;7762;338751;81282;338755;143503,128,2.22338718446575000000
chr12,6554075,8985509,2431434,1,1,144195;10436;25977;2784;51279;1822;171017;9332;83461;50856;920;57379;57121;79923;55080;26253;144568;55810;10233;715;1108;5763;50813;170482;3902;9918;5777;27239;57494;93978;9573;83758;338339;7167;11331;341392;283316;51147;84519;84727;2597;5830;939;6843;8078;8079;113246;10536;4839;359787;196500;6515;719;55138;716;51258;9746;10162;360030;25900;440077;339;8076;2026,64,2.63219153799774000000
chr16,29652999,30198600,545601,1,1,653808;5531;26470;283897;253980;146378;8479;83719;23475;283899;124446;9344;3835;4150;226;253982;83723;5595;6911;11151;8448;79447;112476;9961;10423;6693;79153,27,4.94867128176085000000
chr16,29652999,30198600,545601,1,1,653808;5531;26470;283897;253980;146378;8479;83719;23475;283899;124446;9344;3835;4150;226;253982;83723;5595;6911;11151;8448;79447;112476;9961;10423;6693;79153,27,4.94867128176085000000
chr8,8100384,11860569,3760185,1,1,1508;83650;83595;203076;2626;83648;613210;137075;613209;157285;640;66036;252969;286046;79660;2222;54984;613211;4482;8658;203074;9258;90459;94137,24,0.63826646827217300000
chrX,31235053,31395246,160193,1,1,1756,1,0.62424700205377300000
chrX,31792043,32070620,278577,1,1,1756,1,0.35896717963076600000
chr11,116669828,120724121,4054293,1,1,143941;196264;6230;2900;10632;7070;283150;23650;5818;9354;2542;114902;79849;83552;3587;338657;55823;4162;23187;100533181;6330;56649;3014;345;84000;257160;10525;917;23365;9854;337;916;5049;7379;9159;867;22897;4297;486;23387;372;57453;6876;51399;25988;915;1656;10205;11181;23621;283149;6327;79671;9099;219902;51092;335;64137;643;79102;25833;3145;120425;84866;1798;56912;283152;53826;220323,69,1.70189969003227000000
chr8,9720329,11906266,2185937,1,1,1508;83650;83595;203076;2626;83648;613210;613209;640;66036;252969;286046;2222;54984;613211;4482;203074;94137,18,0.82344550643499800000
chrX,154112019,154568774,456755,1,1,474382;7411;8263;1193;2157;79184;100272147;116442;65991;4515,10,2.18935753303193000000
chr22,18919942,20311763,1391821,1,1,54487;27037;5413;29801;65078;23617;10587;1312;7122;421;7290;128977;8220;2812;388849;7353;2928;128989;6899;9993;54584;5625;79680;85359;64976;8318;5902;6576;8218,29,2.08360126769175000000
chr1,146641601,147786706,1145105,1,1,9557;51205;51463;5565;607;2702;2330;200030;2703,9,0.78595412647748500000
chrX,139531883,139801281,269398,1,1,6658,1,0.37119800443952800000
chr16,15048751,16999359,1950608,1,1,101059938;4629;100288332;123811;89927;4363;54820;408050;368;255027;23042;54700;123803;9665,14,0.71772493499462700000
chr16,15048751,16249607,1200856,1,1,4629;100288332;123811;89927;4363;54820;368;255027;23042;54700;123803;9665,12,0.99928717514839400000
chrX,29063153,29750769,687616,1,1,11141,1,0.14543000744601600000
chr16,15492317,18112776,2620459,1,1,4629;123811;64131;89927;4363;54820;408050;255027;101059938;368;9665,11,0.41977378772192200000
chr16,14968855,16311070,1342215,1,1,4629;100288332;123811;89927;4363;9284;54820;23420;123803;255027;23042;54700;368;9665,14,1.04305197006441000000
chr16,15131723,16276115,1144392,1,1,4629;100288332;123811;89927;4363;54820;368;255027;23042;54700;123803;9665,12,1.04859174129145000000
chr22,49995123,51178264,1183141,1,1,85358;410;400935;85378;9701;56666;5600;49;9889;23774;80305;414918;79174;9997;1120;440836;1375;415116;83642;23542;644186;23209;6300;83933;79924;79087;6305;1890;348645;23654;113730;29781;55586;91289;54456,35,2.95822729497161000000
chr15,20575646,23699760,3124114,1,1,727832;114791;100996331;123606;283694;81614;100287399;283685;390538;23191;283767,11,0.35209982734304800000
chr15,22784523,23179948,395425,1,1,123606;23191;114791;81614,4,1.01156982992982000000
chrX,38491539,38547951,56412,1,1,7102,1,1.77267248103240000000
chr1,146564743,149224043,2659300,1,1,9557;728945;284565;644591;51205;645142;51463;5565;607;2702;730262;2330;200030;2703,14,0.52645433008686500000
chr10,130178957,132911532,2732575,1,1,4255;253738;256536;10539,4,0.14638207551485300000
chr16,86106889,87595215,1488326,1,1,79791;64779;100506581;2294;81631;23174;2300;2303,8,0.53751664621863800000
chr8,12528482,31463049,18934567,1,1,29942;2053;55806;7993;64760;8756;157574;54793;9796;7486;286097;389643;1808;619373;203069;2675;10671;51669;157310;23221;7976;4747;55790;1960;2137;6570;1135;55246;5516;5520;137492;26281;5533;23087;10174;8795;51201;541565;57509;55124;23362;8797;56154;4824;8794;157773;11030;2267;137868;23484;11178;4481;80005;55909;80346;9583;63898;286133;427;1191;55756;649;55872;10361;79618;57805;91782;2796;81551;2961;10;27299;10863;5157;10687;64641;157570;23516;55140;665;4741;148;9046;23039;5108;6781;5368;64236;79873;137814;10395;55893;23303;51435;6440;2936;526;203190;91694;2185;9108;4023;1846;100507341;57604;4017;8793;29883;6542;661;2039;55174;7991;8822;51312;157313;9,117,0.61791748393295700000
chr15,32021733,32510863,489130,1,1,161725;1139,2,0.40888925234600200000
chr1,33594206,41886350,8292144,1,1,29889;79693;339559;22955;55223;80149;79647;353500;149175;4520;1503;27095;149076;54933;55700;84879;4725;63967;643314;284656;2709;64744;64064;4610;6421;9202;192669;79932;64960;84970;65243;2275;64769;6018;127687;127550;1296;8761;192670;200172;51440;100132074;2707;64121;79753;7802;81025;2899;284654;9132;127534;1912;127391;127700;127703;339488;114784;26508;1441;113444;83931;5538;27285;9967;10946;54936;23499;79729;9204;10450;1298;51118;55194;84967;127396;2701;10487;54802;5690;5453;3633;7579;163732;9783;100506144;23154;58512;656;127540;64789;84618;10269;54955;4802;79830;26292;55143;26523,98,1.18184151167659000000
chr3,196892527,197324783,432256,1,1,1739;622,2,0.46268877702102500000
chr16,74915119,76001300,1086181,1,1,23536;10428;440387;11345;124491;4166;1504;79726;23563;162239;9564;84937;54386;197257;3735;79583,16,1.47305099242207000000
chr16,10092048,10520294,428246,1,1,80063;2903,2,0.46702129150068000000
chr6,74915089,76030220,1115131,1,1,27145;1347;55754;1303,4,0.35870225112565300000
chr16,15492317,18162167,2669850,1,1,4629;123811;64131;89927;4363;54820;408050;255027;101059938;368;9665,11,0.41200816525273000000
chr10,46264302,51804163,5539861,1,1,119016;5599;253725;644168;267004;8031;195977;100652748;9721;83849;642517;57705;474354;170371;118738;653145;5949;644054;414189;100133093;728113;5540;143162;6572;2662;26095;118461;282966;58504;100287932;8505;2658;1103;2074;170370;4477;196740;55753,38,0.68593778796977000000
chr3,112152600,115492949,3340349,1,1,64422;151887;7634;201633;91653;205717;131450;1814;80218;79691;523;2596;152185;54847;54762;55779;254887;151888;57577;25871;26137;55032;29083;344807,24,0.71848779873001300000
chr17,7213188,7460864,247676,1,1,201243;8742;57659;1140;407977;284114;57048;147040;254863;2256;9744;2874;8711;339168;57555;374768;84461;1984;643664;5430,20,8.07506581178637000000
chr4,84871064,103137712,18266648,1,1,23001;55008;658;83478;56955;5783;8649;9429;131;4547;152926;2895;8633;1040;130;126;84103;5530;4825;4299;6622;56916;345275;5602;1758;6696;1977;345274;93587;79982;128;10098;51191;100996939;84992;401145;266812;10611;285555;124;22915;3381;8916;285513;10144;5311;55024;51170;127;27306;115265;132989;27071;474;51705;1834;166815;53343;5910;3015;57563;8404;23173;5161;125,65,0.35583977969028600000
chr15,32076948,32510863,433915,1,1,161725;1139,2,0.46091976539183900000
chrX,44821712,44970948,149236,1,1,7403,1,0.67007960545712800000
chr22,50821612,51178264,356652,1,1,23542;85358;644186;410;9701;79924;49;6305;1890;113730;9997;29781;55586;91289;440836;1120;1375,17,4.76655114789767000000
chr17,43703801,44292742,588941,1,1,246744;162540;104909134;1394;4137;284058,6,1.01877777230656000000
chr19,51294464,56379713,5085249,1,1,84798;79143;2204;2357;9437;342931;27338;503834;388561;114823;147807;23547;7137;729767;284370;6158;2359;115653;284371;10859;729974;402665;8778;400713;125893;54776;7138;3904;3812;5655;81856;51206;4696;147657;147744;11025;59284;945;147808;29903;59283;255043;147945;90353;126017;23640;199713;25818;29924;55554;27036;112401;90333;27180;90321;284415;162967;9668;26121;89887;162962;11202;317703;10990;147645;147798;59348;6861;26085;79042;163033;342926;354;91661;84671;100507290;51545;43849;3817;284369;3809;89858;91664;54869;3816;43847;147664;65251;3982;79165;388564;3811;9622;84922;284366;29844;91662;5650;57348;5518;55762;6203;162963;284297;162966;11027;352909;646643;5653;2358;5794;90317;5582;338321;55769;7576;79898;4818;84446;147660;11012;59285;4849;90338;80110;3805;7728;729956;22870;3802;125875;55655;388559;100049587;388558;100529240;94059;11338;51157;946;91663;170958;89790;3036;84436;79788;84787;79763;84765;441864;126014;3903;112724;57106;3804;204801;55422;27181;125965;147646;11024;284418;11006;2109;100130827;100271846;3589;55786;147650;147658;148170;317701;93650;100129083;10288;284417,176,3.46099079907395000000
chr12,32974290,32977096,2806,1,1,5318,1,35.63791874554530000000
chr12,32974290,32977096,2806,1,1,5318,1,35.63791874554530000000
chr12,32974290,32977096,2806,1,1,5318,1,35.63791874554530000000
chrX,153608050,153609162,1112,1,1,2010,1,89.92805755395680000000
chr19,55663138,55668012,4874,1,1,7137,1,20.51702913418140000000
chr17,34817422,36168104,1350682,1,1,26574;284099;9326;284098;11072;6928;79154;79922;3975;11276;79893;11056;6871;31;80179,15,1.11055007766447000000
chr4,9766686,14583875,4817189,1,1,9957;116449;9364;579;85460;56606;1816;9948;259282,9,0.18683095058134500000
chr12,1202907,1601450,398543,1,1,23085,1,0.25091395407772800000
chr12,1522022,2612192,1090170,1,1,144699;654429;93589;81029;196513;775;23085;79602,8,0.73383050349945400000
chr22,20754422,21440514,686092,1,1,80764;9342;91179;8216;7625;400891;1399;84861;6545;150209;5297;51586;9127;3053,14,2.04054266774718000000
chr4,157732013,167396654,9664641,1,1,100506013;92345;391712;1363;2891;55319;152756;7092;4889;56884;23520;201931;51313;11275;2110;5481;59350;55314;57600;6307;55016;152940;84076;166655;4886;201725;9693;2743;56034,29,0.30006287869358000000
chrX,113202825,133429516,20226691,1,1,10735;4694;158798;3598;84528;100130613;728075;6594;23157;100129520;728082;55609;23439;57187;347454;29071;203427;170261;9016;331;55026;5358;100507170;10178;65109;4068;51114;2892;51213;57481;139170;79576;63035;6170;10813;3547;3358;57826;83844;728062;203413;8862;7512;158763;2000;255313;158800;55796;8450;139804;90167;139760;727940;292;10857;57631;7737;7319;51270;139741;186;54521;9131;51634;3597;2719;653282;728072;728096;728049;9363;3920;11254;10009;2747;90161;347468;90293;728042;10495;2239;643311;728036;79836;51765;139818;54440;4952;55922;28985;340578;728090;63932;347475,94,0.46473246662046700000
chr14,102000488,103226064,1225576,1,1,3320;23186;9895;5527;91833;51550;1778;55778;5891;1735;122416,11,0.89753715803834300000
chr19,22936709,41513116,18576407,1,1,26065;163131;53916;5438;148268;92285;163087;7652;8425;54623;7644;25999;9534;57731;284323;6183;126393;388531;57817;2865;91442;374897;126248;199720;84902;390927;148266;22847;55851;728361;101927572;83889;57716;388533;29946;163126;3960;390916;27335;53827;57828;27033;94274;126374;100507527;10298;147923;282618;1548;51276;91646;728485;8857;9745;1555;399473;2821;339324;51599;1178;1340;374900;163183;57711;84306;84063;333;115727;6324;115703;171392;64377;112398;284403;79713;5349;163255;342865;84079;6829;163175;5714;80271;84924;8725;1054;3963;4793;57616;643669;10683;57655;199745;1155;79047;22933;79934;9757;282616;84964;3191;148003;126375;126272;4868;84911;1050;8193;10870;10430;56301;55900;11045;148137;933;6217;55095;199704;388523;348303;126526;2867;55588;53822;84807;92609;54938;4099;388536;23646;90075;55957;92799;7386;79935;730087;653499;147991;147965;644096;282617;29950;11136;92283;495;57677;1549;10775;9141;9253;9710;148109;84775;4294;79171;163115;6261;898;23094;8190;284325;90522;5348;57622;645;2091;9424;115290;93099;4037;284459;5184;9149;342897;79156;284406;26330;85415;284402;79414;2116;390928;148103;64857;374899;6626;83636;147929;826;1891;84503;81;29124;10054;7705;148014;9535;148213;22835;339327;10653;11184;56891;126231;208;7305;64073;58510;1346;147746;100129543;199746;126432;55094;7538;7392;23354;3249;339318;25850;342892;342898;5704;2864;126433;342900;163081;147968,228,1.22736328935945000000
chr3,57156030,60522686,3366656,1,1,8309;5162;2317;11102;7871;200845;378;57406;200844;1776;8820;54756;201625;131177;201627;11170;54899;201626;2272;142686;26060,21,0.62376435252072100000
chr22,18919942,21801661,2881719,1,1,54487;27037;9342;29801;65078;10587;1312;6545;421;7290;2812;6899;5625;7625;79680;23119;64976;6576;3053;8218;5413;80764;23617;400891;1399;7122;150209;128977;8220;388849;84861;7353;51586;2928;128989;5297;9127;9993;54584;91179;85376;8216;440804;85359;8318;728229;5902,47,1.63097095865350000000
chr15,22784523,23179948,395425,1,1,123606;23191;114791;81614,4,1.01156982992982000000
chr21,41915676,46827999,4912323,1,1,386672;5211;4599;5316;54084;56894;3689;8209;1409;54101;1826;386679;386676;386680;386681;326;53347;5152;1476;29947;64699;11077;6612;63977;755;8566;7307;7113;875;7032;150094;85395;386685;353323;7031;7109;386674;386675;386683;8568;4731;23076;104;353332;4600;5822;7033;386677;89765;353333;25825;23275;90625;49854;23308;386678;89766;754;25966;54020;80781;9619;386684;7327;10785;386682;54097;81543;7226,69,1.40463076226869000000
chr21,33409273,35888993,2479720,1,1,29980;3588;6526;10215;9992;56246;9946;3455;3460;6651;8867;116448;54065;539;94104;9875;1827;6453;101928147;3454;3753;56245;54943;56683;140290;59271;757;54069;2618;64968,30,1.20981401125934000000
chr21,40765086,40934287,169201,1,1,7485;150082;6450;106865373,4,2.36405222191358000000
chr21,37692080,38459559,767479,1,1,23562;51227;8208;6493;7267;53820;3141;23515,8,1.04237379784984000000
chr21,41239529,41460416,220887,1,1,1826;5121,2,0.90544033827251000000
chr15,28257467,29237481,980014,1,1,4948;321;8924;653720,4,0.40815743448563000000
chr17,77990959,81041938,3050979,1,1,339231;26502;147111;83882;79058;6904;57674;2194;80233;339230;55036;2642;284184;57521;9146;51181;10966;57597;6182;2548;79643;100130370;79415;5831;5148;116729;284129;125058;4097;284001;5833;9775;3607;4884;9123;56270;924;71;64118;284207;284004;25794;51547;1468;400629;79092;5881;5034;124565;146712;201254;5986;10458;79755;339229;22994;2873;284186;396;201255;256933;51529;1453;284131;55666;348262;79701;64122;6398;6448;255275;146705;79672;2837;9625;10189,76,2.49100370733460000000
chr22,23023650,24988402,1964752,1,1,4320;100423062;613;391322;400916;150248;27156;653689;4282;29802;100037417;2687;9609;6634;3543;2781;7621;2952;66035;266747;51733;2678;83606;23384;135;51233;6598;1652;56241;388886;23523;91319,32,1.62870428430662000000
chr16,87502161,89688617,2186456,1,1,54758;863;23174;115992;4597;146429;763;124245;197320;100287036;1535;51693;100129697;348180;9780;81620;27132;353;197322;2588;8140;6137;6687;54971;27189;1013;333929;161882;57338;84627;390748;1800;29123,33,1.50929174883922000000
chrX,118084529,133677144,15592615,1,1,10735;4694;158798;84528;100130613;728075;6594;23157;100129520;728082;55609;23439;57187;347454;29071;203427;9016;331;55026;100507170;10178;65109;4068;51114;2892;57481;139170;79576;6170;63035;10813;3547;3251;57826;83844;728062;728090;8862;7512;158763;2000;255313;158800;84295;55796;8450;139760;90167;727940;292;10857;7737;139741;7319;51270;9131;2719;51634;653282;728072;728096;728049;9363;3920;10009;2747;90161;728042;10495;2239;643311;728036;79836;51765;54440;4952;55922;28985;340578;347468;63932;347475,82,0.52588998060941000000
chr2,166152059,166198692,46633,1,1,6326,1,2.14440417729934000000
chr10,95959384,97039485,1080101,1,1,1559;1558;64318;9124;142827;51196;1557;3070;1562;23232,10,0.92583934280220100000
chr22,24311435,25010896,699461,1,1,51733;2678;2687;83606;23384;135;2952;1652;56241;100037417;391322;388886;23523;6634,14,2.00154118671377000000
chr17,5960,4736729,4730769,1,1,10594;8388;50628;10514;5023;7326;5338;400566;55178;146760;114826;55421;124641;100506388;84254;83460;8386;8390;246;23108;23140;55720;1497;29928;727910;29;8578;359845;4641;124936;4335;124997;5176;124976;4995;51479;7531;83903;5026;400569;5048;51763;51031;286753;443;63826;5345;162514;26189;9905;388323;1398;124975;23293;7442;727857;9501;409;64359;6117;84690;30851;23277;342527;4994;124935;8387;5694;79066;83547;55275;8383;1801;9032;50488;79850;489;8447;8392;23729;5306;3090;27043;201305;4991;58191;84225;284013;3682,89,1.88130090477891000000
chrX,6353666,6921861,568195,1,1,51481,1,0.17599591689472800000
chr17,1180460,3808666,2628206,1,1,10594;8388;286753;63826;443;5345;5023;26189;162514;146760;114826;9905;55421;124641;1398;3682;23293;84254;83460;7442;8386;8390;23108;6117;84690;30851;23277;55720;4994;1497;124935;8387;727910;8578;79066;4641;83547;4335;124997;1801;5176;8383;4995;7531;8392;23729;5306;3090;83903;4991;5026;5048;51763,53,2.01658469693776000000
chrX,53449334,53681188,231854,1,1,158787;3028;8243;10075,4,1.72522363211331000000
chr10,95959384,97039485,1080101,1,1,1559;1558;64318;9124;142827;51196;1557;3070;1562;23232,10,0.92583934280220100000
chr3,195725365,197339329,1613964,1,1,622;255798;80235;200933;5062;5130;4241;26043;1739;84984;348793;255758;116211;131540;200931;375387;22916;7037;165918;54965;205564,21,1.30114426344082000000
chr1,145899369,148867581,2968212,1,1,9557;728945;284565;644591;51205;645142;51463;2703;5565;607;2702;730262;2330;200030;149013,15,0.50535473881245700000
chr16,15052746,16279283,1226537,1,1,4629;100288332;123811;89927;4363;54820;368;255027;23042;54700;123803;9665,12,0.97836428905120700000
chr1,146496005,147400685,904680,1,1,9557;51205;51463;5565;607;2702;2330;2703,8,0.88429057788389300000
chr5,88066153,88127836,61683,1,1,4208,1,1.62119222476209000000
chr15,32076948,32510863,433915,1,1,161725;1139,2,0.46091976539183900000
chr10,48334407,51047666,2713259,1,1,143162;5599;6572;2662;644168;267004;26095;118461;282966;58504;8505;2658;57705;474354;170371;118738;1103;2074;170370;5949;196740;644054;55753,23,0.84768907059738900000
chrX,5303120,53480455,48177335,1,1,23096;64061;6759;9500;10214;170685;727837;729431;6756;9502;8242;27344;729447;54328;729422;80311;6102;92552;254158;60506;56850;10943;2824;100873985;170082;347541;139425;729408;59272;389840;170067;81557;2002;8544;55634;2857;7592;57477;425054;727866;645864;5931;7403;6839;51480;3750;7076;140462;8241;347411;7454;265;645037;645051;158724;7355;6197;10084;347442;5355;55593;158787;6303;8409;51360;2710;8406;660;2925;171482;392465;5160;26748;11238;653220;58526;57393;2623;6907;4113;1536;3730;9468;23597;2187;6611;2574;9767;9282;8712;139341;54539;256714;10742;9104;494197;29057;442444;6103;54880;2742;369;280658;170627;347344;8243;4007;7504;5277;9758;56548;1184;645073;94056;10245;57502;11141;653067;11152;641339;256643;23676;4114;6758;8852;7712;23708;5009;1654;51284;2277;170302;79135;11230;9210;441490;64743;389856;55787;139189;139422;170062;4935;4693;100288814;10013;1964;55190;50943;53940;30011;6322;5638;28952;8239;94122;139411;5634;84679;9506;64840;10682;3266;25763;389852;170626;171483;159013;7543;90060;168400;4281;24140;6247;10149;1183;27197;357;8233;286514;548313;6792;79742;4128;139105;139604;7102;10549;4115;11040;6855;8573;55841;729396;729442;51481;3028;795;10389;83604;1756;778;5422;9367;7317;5935;4112;412;158506;340602;158809;6990;5127;22866;5475;10159;85417;100132399;7030;729428;190;7569;729201;89801;1968;57232;4943;79917;5256;26609;54960;6853;80231;25975;51311;8905;395;347404;171484;286464;63904;257397;80258;100008586;3052;4810;404281;5199;92745;140456;257240;9185;27238;4129;2543;8228;158747;8226;56474;5165;7114;6399;728239;5251;8481;8237;6757;100130302,268,0.55627817520417000000
chr20,8099741,8510038,410297,1,1,23236,1,0.24372588637011700000
chr7,74111367,76643261,2531894,1,1,84163;442590;5447;389524;7784;6369;7532;3092;729438;105375355;653361;3315;83862;10344;4191;81554;2969;113878;57414;51657;136853;222183;22932;375593;100101267,25,0.98740310613319500000
chr17,34817422,36168104,1350682,1,1,26574;284099;9326;284098;11072;6928;79154;79922;3975;11276;79893;11056;6871;31;80179,15,1.11055007766447000000
chr22,21926261,22916612,990351,1,1,129025;7332;29799;23753;140883;23759;150223;9647;5594;164592;7441;8940;23532,13,1.31266591339838000000
chr3,108633408,108914802,281394,1,1,9626;27136,2,0.71074720854033800000
chr8,120743147,120942109,198962,1,1,79075;6873;64798,3,1.50782561494155000000
chr10,79891073,81234807,1343734,1,1,10105;57178;219654,3,0.22325847228692600000
chr22,21926261,22916612,990351,1,1,129025;7332;29799;23753;140883;23759;150223;9647;5594;164592;7441;8940;23532,13,1.31266591339838000000
chr11,43246502,48664526,5418024,1,1,10062;5913;8539;55709;9776;9409;2147;221120;5795;51317;4722;399888;9479;283254;1132;60529;1408;8567;390110;120071;55626;119764;79096;390113;55343;29763;5702;4607;256144;51144;57586;91252;387763;84364;23788;2132;114971;114900;143678;9793;403253;4192;90139;8534;79797;79841;55761;8525;1643;256148;53;3732;9537;84680;392;4038;90993;10658;23360;23279;56981;119765;6688,63,1.16278554690788000000
chr17,37288416,37999699,711283,1,1,84152;390790;6143;57125;93210;5409;2064;51755;84961;22806;8557;5469;782;84299;10948;342667;2886;4761,18,2.53063829727408000000
chr16,29478080,30190538,712458,1,1,653808;5531;26470;283897;253980;146378;8479;83719;23475;283899;124446;9344;3835;4150;226;253982;83723;5595;6911;8448;79447;112476;9961;10423;6693;79153,26,3.64933792588475000000
chr3,197621620,197837020,215400,1,1,84223;6165;89782,3,1.39275766016713000000
chr7,70257765,70469189,211424,1,1,26053,1,0.47298319963674900000
chr10,95959384,97039485,1080101,1,1,1559;1558;64318;9124;142827;51196;1557;3070;1562;23232,10,0.92583934280220100000
chrX,128452412,128891247,438835,1,1,7512;6594;4952;8862,4,0.91150432394863700000
chrX,6552712,8115153,1562441,1,1,412;8228;26609;8226,4,0.25600966692502300000
chrX,6552712,8115153,1562441,1,1,412;8228;26609;8226,4,0.25600966692502300000
chr13,114053469,114272122,218653,1,1,55002;7027;55208;113622;101928841,5,2.28672828637156000000
chr19,53768936,57656483,3887547,1,1,79143;2204;3811;9437;342931;388566;27338;342933;503834;388561;114823;147807;23547;84922;29844;7137;91662;57348;6158;6203;115653;10859;729974;57663;7138;54776;284297;11027;352909;3904;646643;85569;3812;23619;5794;5582;338321;126206;51206;90485;147948;4696;147744;5178;11025;59284;147808;29903;59283;84446;255043;147945;58491;59285;126017;23640;199713;29924;4849;79149;3805;112401;729956;89887;284415;22870;3802;147949;26121;55655;126208;94059;317703;10990;11338;51157;91663;170958;147798;84787;79763;6861;126014;441864;79042;163033;3903;112724;126205;57106;3804;147670;91661;204801;55422;100507290;125965;51545;11024;126204;284418;3809;63934;57573;91664;11006;54869;100130827;3589;148170;114026;55311;79165;140612;388564;10288;284417,117,3.00960991597015000000
chrX,70454069,70877660,423591,1,1,2833;93953;9203;4841;8473;26548;6872,7,1.65253747128716000000
chrX,114142995,114622643,479648,1,1,57631;3598;139804;3358;51213,5,1.04243111615184000000
chrX,118256911,118715504,458593,1,1,57481;292;10857;7319;63932;203427,6,1.30834966953268000000
chrX,6896184,7145418,249234,1,1,412;8226,2,0.80245873355962700000
chr6,145982093,146179955,197862,1,1,84085;7957,2,1.01080551091165000000
chr11,630301,743814,113513,1,1,64787;283232;10522;1815,4,3.52382546492472000000
chr5,139062820,139820632,757812,1,1,5201;54882;84249;83697;9542;84418;404734;5813;1839;51523;492311,11,1.45154734947454000000
chr13,103450138,106696128,3245990,1,1,2073;100533467;267012;79070;6555;54841,6,0.18484345299893100000
chr15,32076948,32510863,433915,1,1,161725;1139,2,0.46091976539183900000
chr2,236114456,236430044,315588,1,1,116987,1,0.31686882897955600000
chr22,18894835,21440514,2545679,1,1,54487;27037;9342;29801;65078;10587;1312;6545;8214;421;7290;2812;6899;5625;7625;79680;64976;6576;3053;8218;5413;80764;23617;400891;1399;7122;150209;128977;8220;388849;84861;7353;51586;2928;128989;5297;9127;9993;54584;91179;85376;8216;85359;8318;728229;5902,46,1.80698351991748000000
chr6,170072404,170566208,493804,1,1,387263;55274;55780;253769;6991,5,1.01254748847721000000
chr12,117962514,118171796,209282,1,1,283455,1,0.47782417981479500000
chr12,1601310,1968701,367391,1,1,144699;654429;23085;93589;81029;79602,6,1.63313744756948000000
chr17,34628791,36180571,1551780,1,1,26574;9326;6928;3975;79893;729877;31;80179;284098;11072;79154;101060321;79922;11276;11056;6871;284099,17,1.09551611697534000000
chr19,30286892,34862143,4575251,1,1,26065;57616;85415;84902;898;22847;79047;2821;390916;55094;1050;147991;64377;388531;11136;100507527;91442;4037;9141;56301;84079;91646;9710;5184;9745;126248;8725;1054,28,0.61198828217293400000
chr4,147830359,148804576,974217,1,1,1909;90826;83894;79658;55751,5,0.51323267814049600000
chr20,2437896,2597419,159523,1,1,6628;117532;79175,3,1.88060655830194000000
chr20,3605196,3803465,198269,1,1,1059;55317;54976;80332;6614;25876;8455;994;64096;116835,10,5.04365281511482000000
chr8,145564111,145699139,135028,1,1,50626;29894;55630;203054;26233;340393;79581;51160;90990;8928;4796,11,8.14645851230856000000
chr8,142238251,142871167,632916,1,1,389690;105375787;57210;2843;11156,5,0.78999424884186800000
chr17,50446239,57086139,6639900,1,1,5889;4591;3131;51649;124535;100506650;8165;7706;10040;9110;59342;9256;7716;5414;26689;162282;140735;54903;56155;101927581;55273;6827;4025;8161;124540;9241;404093;23531;4353;124538;6426;8288;22843;339210;8526;84643;1353;58488;252983;54894;284083,41,0.61747917890329700000
chr22,21452237,23654436,2202199,1,1,7332;23753;5594;7441;2781;100423062;613;8940;23532;129025;645426;29799;91227;140883;23759;150223;9647;27156;150221;440804;23119;9609;164592,23,1.04441060957706000000
chr12,128287203,129191296,904093,1,1,92293,1,0.11060809009692600000
chr8,120743147,120942109,198962,1,1,79075;6873;64798,3,1.50782561494155000000
chr16,72798,7154737,7081939,1,1,90850;51025;645811;3039;9074;64714;9717;23162;84326;197358;9143;146434;84256;1186;57524;3483;10942;9727;117166;79585;9235;197342;21;9080;390667;65990;899;4913;29965;7329;5493;8786;79006;57465;3050;26048;146310;4992;8938;390664;146439;64223;3040;100463285;7249;30812;752014;57407;146325;124093;84231;115939;89941;54442;51172;23295;8131;64711;84264;58986;124222;79622;6923;90864;124401;9894;79903;79641;9088;83886;81889;84891;4993;7727;64063;146330;54715;10273;283869;10921;3049;124220;51330;25837;51734;9091;9351;8912;388199;113000;79412;283870;7627;283951;3029;51005;51764;254528;4917;124056;90861;84331;84464;100529144;114984;84662;4832;6123;1632;10573;146556;57585;64499;342346;91151;9028;29855;260429;9742;10131;283871;10232;79228;1877;3042;1387;339123;4210;398;283948;54985;84219;7023;23430;23524;23059;63922;80178;6755;7177;84656;5170;56052;55692;527;64285;84309;65993;115;7755;146562;4833;8312;54925;10607;1773;3163;6345;84572;7752;646174;1775;51728;124402;26063;5310;64718;10127;79652;6650;10101;4350;64428;64788;25823;7760;114990;196483;360226;83986;4716;64386;440335;124404;57799;6187;9093;2671;197335,189,2.66876063179872000000
chr16,72797,12937282,12864485,1,1,4682;90850;146279;51025;645811;3039;9074;283953;64714;9717;23274;23162;84326;197358;9143;146434;84256;1186;57524;3483;10942;9727;117166;79585;79091;9235;197342;21;9080;390667;65990;899;4913;8651;29965;7329;5493;8786;79006;18;57465;3050;58531;26048;23589;146310;4992;8938;390664;146439;64223;29066;3040;100463285;7249;30812;752014;57407;146325;124093;84231;7142;115939;89941;54442;51172;23295;8131;64711;84264;58986;80063;124222;9516;79622;6923;90864;5620;124401;9894;79903;79641;9088;83886;116028;81889;84891;4993;7727;51061;25880;64063;146330;54715;55313;10273;283869;10921;3049;124220;51330;25837;51734;9091;9351;8912;388199;113000;79412;283870;7627;283951;3029;51005;51764;254528;4917;124056;90861;84331;84464;100529144;114984;84662;4832;6123;1632;4261;10573;146556;57585;2013;64499;342346;91151;9028;29855;260429;9742;10131;283871;10232;79228;1877;5619;3042;1387;339123;4210;2935;398;283948;54985;84219;7023;23430;23524;23059;63922;80178;6755;8303;7177;84656;5170;56052;55692;5373;527;64285;84309;29035;2903;608;65993;115;7755;146562;4833;8312;54925;92017;10607;1773;3163;6345;84572;7752;646174;1775;51728;124402;26063;5310;64718;10127;79652;6650;10101;780776;4350;64428;64788;25823;7760;114990;196483;360226;83986;4716;64386;440335;124404;28955;26156;57799;7874;6187;9093;2671;197335,221,1.71790786805690000000
chr16,21951379,22380197,428818,1,1,7385;730094;1039;146177;55718;29904;255762,7,1.63239416255847000000
chr1,51050433,51295749,245316,1,1,11124,1,0.40763749612744400000
chr16,57653652,60696431,3042779,1,1,64785;2806;1258;10300;4324;23019;55238;3801;57567;79650;79918;374739;9289;1459;729159;29105;84229;222487;388282;29070;221191;65009,22,0.72302326261618100000
chr8,120743147,120942109,198962,1,1,79075;6873;64798,3,1.50782561494155000000
chr8,113352093,115430696,2078603,1,1,114788,1,0.04810923490440450000
chr12,44618145,45173492,555347,1,1,4753;84216,2,0.36013519475211000000
chrX,53283713,53904597,620884,1,1,23096;158787;10075;8243;3028,5,0.80530340611128600000
chr1,15378572,16826343,1447771,1,1,1969;114827;440567;63036;79814;55092;51032;374955;842;11330;388595;26099;23254;27129;79180;128272;7709;23013;23341;1188;79363;23207;54751;149563;284723;727684;84301;6248;348487;1187;55707;54455,32,2.21029430759423000000
chr7,6316522,6714612,398090,1,1,55146;54753;5879;392862;79034;221955;100131017;84792;11014,9,2.26079529754578000000
chr4,9627944,10252290,624346,1,1,9948;56606;1816,3,0.48050279812796100000
chr18,55206760,55319324,112564,1,1,2235;100505549;4677;5205,4,3.55353398955261000000
chrX,428231,819243,391012,1,1,6473,1,0.25574662670199400000
chr11,34651737,34764237,112500,1,1,26298,1,0.88888888888888900000
chr9,4116616,4600270,483654,1,1,169792;6505;55064,3,0.62027813271470900000
chr9,107420142,107696328,276186,1,1,55335;286365;25934;19,4,1.44829933450646000000
chr12,289648,450538,160890,1,1,6540;6539;5927,3,1.86462800671266000000
chr6,132025,57297712,57165687,1,1,56658;401236;6005;57510;10665;7021;80742;1832;9750;23113;8831;720;8340;6046;11329;266727;3135;114327;4439;4201;5314;80740;22875;389362;988;51439;6204;7942;222696;55809;8357;222584;3017;8521;7280;51302;26268;255626;26529;8344;3134;5467;89822;64288;221468;9820;3710;8361;116113;5603;717;6428;8367;2740;221409;51473;7915;8449;6222;6732;26707;404220;648791;6310;442184;100113407;1871;3127;51069;24149;2295;11119;1589;63915;117283;441150;10384;401250;100529239;2939;56244;9436;534;8336;10554;401251;3024;6048;654;23564;84062;5558;2941;896;5292;2766;721;55173;6293;51567;10475;5514;4337;81688;4855;27242;441151;8899;7918;80864;10321;222663;10786;26240;85236;389384;55362;57128;378884;199;116511;1906;170680;8294;8968;6631;54511;58496;3013;347734;55166;8343;8331;3107;387032;85315;7923;79865;2289;107080638;578;9656;135644;54898;10486;100507436;90523;54210;5225;221496;3077;245928;54209;2178;1616;81697;170954;10473;221424;221749;6892;55604;8870;4050;3115;7287;81853;11131;22858;60481;84547;394263;7172;10591;23;51522;57827;26692;116138;107080644;4224;285852;116369;7913;8354;11118;2940;4594;389396;8342;221391;63940;54887;55937;2822;79897;23787;9697;4188;25862;79969;221711;25803;696;8345;221476;1208;7629;221357;6659;6499;10246;5272;353219;51513;27232;5252;59084;8356;7020;282890;8737;9025;83795;7422;80863;389376;221443;81567;347744;8366;7917;57691;135458;171558;23304;8859;79692;129685;6015;100130357;222662;442213;2739;8360;203068;64771;222642;3018;4277;51299;3008;3159;81797;3109;4800;3111;85235;7922;10050;55856;10471;222658;2162;4795;7936;56897;11120;2794;89845;81696;222698;27283;5961;10667;177;26531;1769;7932;285848;64928;340205;3006;259215;5696;9856;10211;50619;401262;63027;3062;442194;285782;3133;8332;629;93643;57497;23607;80317;221472;5429;51053;89870;245927;3117;5698;7940;6745;6239;442191;54901;81578;6882;10048;2296;10107;6941;11165;7919;154467;222659;6568;442186;101929726;3304;29113;8352;4835;80352;9972;8334;26716;6722;51000;340156;26212;9521;8365;84300;8341;3119;2914;1026;8969;63933;4739;7741;55003;55776;6992;54676;63971;2968;8464;4736;10537;670;170679;10799;8346;5987;2978;83741;9587;55227;88745;8369;221710;6257;9532;245915;9425;10919;100188893;101928603;51256;10279;202658;255488;7005;3105;8330;5754;5528;389400;3605;340204;3303;1388;6903;7718;8645;222611;7745;57176;4758;8350;221692;51406;10231;3400;80345;4794;221477;2651;167;8347;9277;7407;221527;221481;6891;653;80739;860;10864;54535;55633;23506;3010;7738;221416;80737;221613;7941;140767;50854;2938;8355;55770;8329;154150;83732;1302;2729;221458;2880;8335;3120;65989;94234;23294;9481;29993;114821;7124;346157;23408;221662;8705;705;2979;346171;5460;3305;57819;221400;25844;7148;5190;28978;57699;403339;154141;57505;11074;84830;100507679;7180;51645;28973;1797;5232;245913;4172;389383;8362;202500;9450;114781;51596;221393;23500;84630;135398;80736;100287718;3720;11270;9247;60685;3662;221336;55168;221687;6954;94026;1460;401265;3123;29777;3113;8358;5089;405754;285855;27154;10695;80741;5269;135656;221504;3833;9753;5863;3012;56940;8368;259197;29116;1192;3118;54438;221395;10590;8339;8364;3112;221421;8970;1432;401258;23070;266977;8348;9477;7746;257202;10930;1041;3326;30834;221545;8359;10817;2762;1992;8351;7726;9308;2030;8363;4049;7916;3122;347733;3106;154007;4117;89953;3108;3007;51715;58530;222643;4295;9374;29964;3096;222826;63943;112744;667;2550;10455;3009;53405;9278;221491;5617;4340;647024;780;221656;9533;8353;57380;10385;6890;26036;7920,592,1.03558625998844000000
chr7,152765094,154868010,2102916,1,1,22976;3361;1804,3,0.14265905057548700000
chr2,106341862,107159540,817678,1,1,80146;84417;8440;653489,4,0.48919012129469100000
chr6,45515290,45980278,464988,1,1,53405;860,2,0.43011862671724900000
chr7,88244878,89895731,1650853,1,1,219557;26872;261729;219578;79846,5,0.30287372649169900000
chr22,40405726,41616314,1210588,1,1,2847;158;6767;23112;9978;2033;63929;150353;57591;83746;27352;113828;10478,13,1.07385832339326000000
chrY,59079666,59312107,232441,1,1,10251;6845,2,0.86043340030373300000
chr4,129785683,129920976,135293,1,1,132320;79960,2,1.47827308138632000000
chr15,32076948,32510863,433915,1,1,161725;1139,2,0.46091976539183900000
chr18,55875298,56016769,141471,1,1,23327,1,0.70685864947586400000
chr18,54986863,55361839,374976,1,1,100505549;51046;4677;2235;9480;5205,6,1.60010240655402000000
chr12,27553663,27768451,214788,1,1,341346;8496;56938,3,1.39672607408235000000
chr16,17330187,17676004,345817,1,1,64131,1,0.28917028370496500000
chr12,80069355,87351008,7281653,1,1,29080;8825;84125;9182;4922;8499;160335;5074;283310;79611;55117;8092;25834;144448;4659;4617;84190;374462;4618,19,0.26092976416206600000
chr10,68754191,68936303,182112,1,1,347731;29119,2,1.09822526796697000000
chr4,174538991,180659951,6120960,1,1,55247;11086;116966;132851;3248;175;140458;26269;7424;8001;80817;2823;60559,13,0.21238498536177300000
chr1,146155982,148545497,2389515,1,1,9557;644591;51205;645142;51463;2703;5565;607;2702;2330;200030;149013,12,0.50219395986214800000
chr22,18894865,21505388,2610523,1,1,54487;27037;9342;29801;65078;10587;1312;6545;8214;421;7290;2812;6899;5625;7625;79680;64976;6576;3053;8218;5413;80764;23617;400891;1399;7122;150209;128977;8220;388849;84861;7353;51586;2928;128989;5297;9127;9993;54584;91179;85376;8216;85359;8318;728229;5902,46,1.76209901234350000000
chr15,22866888,23699760,832872,1,1,123606;114791;283685;81614;23191,5,0.60033234398563000000
chr16,14968877,16127847,1158970,1,1,4629;100288332;123811;89927;4363;9284;54820;23420;255027;23042;54700;123803;9665,13,1.12168563465836000000
chr16,28843802,29031029,187227,1,1,11273;27040;79874;7284;930;84901;487;83985;25970,9,4.80699899053021000000
chr16,15048751,16249607,1200856,1,1,4629;100288332;123811;89927;4363;54820;368;255027;23042;54700;123803;9665,12,0.99928717514839400000
chr16,14910205,16742212,1832007,1,1,100288332;23042;101059938;368;123803;9665;4629;123811;89927;4363;9284;54820;23420;408050;255027;54700,16,0.87335910834401800000
chr15,36841726,37184183,342457,1,1,4212;84529,2,0.58401492742154500000
chr16,88755341,89897010,1141669,1,1,27132;863;353;29123;1800;197322;2588;115992;146429;6137;197320;6687;2175;100287036;1013;51693;100129697;124044;124045;84501;348180;92822;9780;390748;81620;9605;5119;8558,28,2.45254973201515000000
chr10,26193189,26991875,798686,1,1,2572;23590;53904;54518,4,0.50082260112234300000
chr9,112820590,113112463,291873,1,1,255220;11217;7295;445815;401546,5,1.71307383690852000000
chr19,2329320,3808325,1479005,1,1,60680;6915;80032;58492;56926;4145;126321;51343;56928;9546;10362;126295;84839;79816;116541;148252;4782;23396;2769;166;360200;84823;2767;8698;83475;29985;27134;100128569;4616;2788;7089;115196;284422;23217;7064;148254;26517;6449;58509;126326,40,2.70452094482439000000
chr15,22765628,29031690,6266062,1,1,2562;7681;123606;4948;57194;81614;2558;8924;114791;23742;7337;6638;2567;8926;283685;653720;54551;4692;23191,19,0.30322074693802900000
chr3,6274495,6969739,695244,1,1,2917,1,0.14383439483116700000
chr22,22998284,23603489,605205,1,1,2781;100423062;613;27156;9609,5,0.82616634033096200000
chrX,6552712,8115153,1562441,1,1,412;8228;26609;8226,4,0.25600966692502300000
chr3,158082197,158730235,648038,1,1,4291;51319;5918;85476;64747;56925,6,0.92587163098460300000
chr21,15485037,19149818,3664781,1,1,149998;8204;10950;54033;29761;64092;388813;6782;1525,9,0.24558084098340400000
chr4,1508670,2233647,724977,1,1,7469;7884;401115;3954;7468;152877;92305;79441;353497;10460;2261;339983,12,1.65522492437691000000
chr3,14107444,14236174,128730,1,1,79188;7508;131474;27258,4,3.10727880059038000000
chr3,15366585,15610035,243450,1,1,8292;26061;131965;85403;9467,5,2.05380981721093000000
chrX,138645477,138987611,342134,1,1,4168;2158;286410,3,0.87684942157166500000
chr1,146011052,148193391,2182339,1,1,9557;644591;51205;51463;2703;5565;607;2702;2330;200030;149013,11,0.50404634660334600000
chr13,23566962,24910743,1343781,1,1,6445;4285;55504;221178;338872;387911;542767;26278,8,0.59533510296692700000
chr7,153157388,154108148,950760,1,1,1804,1,0.10517901468299000000
chrY,11529,24393042,24381513,1,1,353515;728403;4267;293;286530;9189;140032;378948;90665;83259;90655;3563;6192;7258;159163;8287;8653;353513;64591;728137;22829;159119;9426;7544;6736;86614;8227;8225;9082;8623;442862;8284;207063;100289087;9087;378950;266;6473;1438;5940;100533178;28227;7404;728395;438;64109;9084;378949;9086;55344;203611,51,0.20917487770344700000
chr11,109702636,110772239,1069603,1,1,5962;2230;57569;85463,4,0.37397052925244200000
chr8,130857383,131107320,249937,1,1,50807;51571,2,0.80020165081600600000
chr3,195740357,197310451,1570094,1,1,622;255798;80235;200933;5062;5130;4241;26043;1739;84984;348793;255758;116211;131540;200931;375387;22916;7037;165918;54965;205564,21,1.33749953824421000000
chr7,40789006,40917568,128562,1,1,79783,1,0.77783481899783800000
chr10,81839279,81958740,119461,1,1,80195;219348;311,3,2.51127983191167000000
chr15,30819486,32942630,2123144,1,1,728498;9824;51621;653125;22909;161725;283710;54893;89839;643699;4308;728047;1139;6447,14,0.65939945665484800000
chr17,7589672,9331515,1741843,1,1,146754;388333;9423;54785;92162;5187;23533;643904;124637;55135;59344;9212;23135;146850;58485;3000;5198;116840;1949;399512;22899;84314;6844;162387;6154;247;84667;1107;29098;9482;7157;9196;84316;80169;124751;81565;4628;242;146849;146852,40,2.29641821909322000000
chr1,145388355,145833054,444699,1,1,148738;128077;27246;84265;11126;10628;653519;8799;5174;10401;200035;284615;8515;148741;10623;9939,16,3.59793928027722000000
chr2,2606014,3627439,1021425,1,1,51112;6201;7260;246243;55256,5,0.48951220109161200000
chr14,62170423,62889299,718876,1,1,3091;83851;6617,3,0.41731814666229000000
chr12,33525320,34345585,820265,1,1,341359;84920,2,0.24382364235948100000
chr15,44792878,45568844,775966,1,1,140691;9153;90527;90525;405753;80208;6652;197135;8669;145645;567;50506;51496;53905,14,1.80420276146120000000
chr22,18818398,21505387,2686989,1,1,54487;27037;9342;29801;65078;10587;1312;6545;8214;7290;421;2812;6899;5625;7625;79680;64976;6576;3053;8218;5413;80764;23617;400891;1399;7122;150209;128977;8220;388849;84861;7353;51586;2928;128989;5297;9127;9993;54584;91179;85376;8216;85359;8318;728229;5902,46,1.71195341700320000000
chr3,113410537,113953629,543092,1,1,7634;54762;205717;254887;57577;1814;523;80218;79691,9,1.65717778939848000000
chr5,162918139,164485709,1567570,1,1,3161;27430,2,0.12758600891826200000
chr15,32076948,32510863,433915,1,1,161725;1139,2,0.46091976539183900000
chr15,32076948,32510863,433915,1,1,161725;1139,2,0.46091976539183900000
chr5,42684848,42811390,126542,1,1,100129792;2690;6414,3,2.37075437404182000000
chr16,1713427,2100490,387063,1,1,3029;197342;7249;10101;254528;81889;90850;65993;90861;124056;4913;10607;4716;64711;23162;9143;283869;4832;6123;90864;6187;3483;51734;57585;9351;2671;146310,27,6.97560862185226000000
chr15,31014508,32914140,1899632,1,1,9824;51621;653125;22909;161725;283710;54893;643699;4308;728047;1139,11,0.57905952310763400000
chr15,31014508,32914140,1899632,1,1,9824;51621;653125;22909;161725;283710;54893;643699;4308;728047;1139,11,0.57905952310763400000
chr13,23566962,24910743,1343781,1,1,6445;4285;55504;221178;338872;387911;542767;26278,8,0.59533510296692700000
chr16,21951379,22718338,766959,1,1,730094;100132247;29904;7385;1039;146177;55718;255762,8,1.04308052972845000000
chr15,99618235,102383443,2765208,1,1,390649;4205;123355;204219;80213;79705;55829;390648;55180;145748;5046;220;23336;170691;22856;100128108;64927;140460;6627;123283,20,0.72327289665008900000
chrY,14500589,30000000,15499411,1,1,353515;1617;442868;140032;378948;57054;159163;8287;8653;353513;22829;159119;9426;86614;57055;9082;9085;442862;8284;9087;378950;5940;442867;100533178;7404;57135;378951;9081;9083;9084;378949;9086;203611;253175,34,0.21936317451030900000
chr10,103138986,103366970,227984,1,1,8945;27343;25911,3,1.31588181626781000000
chr22,18970561,21800471,2829910,1,1,54487;27037;9342;29801;65078;10587;1312;6545;421;7290;2812;6899;7625;79680;23119;64976;6576;3053;8218;5413;80764;23617;400891;1399;7122;150209;128977;8220;388849;84861;7353;51586;2928;128989;5297;9127;9993;54584;91179;85376;8216;440804;85359;8318;728229;5902,46,1.62549339024916000000
chr5,139889574,140078803,189229,1,1,929;3035;3550;10307;54882;55374;10011;373863;23438;54853;404734;113829;4695;8637,14,7.39844315617585000000
chr18,76712045,77219827,507782,1,1,374868;4772;27164,3,0.59080471540936900000
chr17,71832402,72586885,754483,1,1,6169;10871;100130520;388419;100131439;94015;350383;55890;146723;11314;124599;124602;64446,13,1.72303418367279000000
chr7,40731678,40917568,185890,1,1,79783,1,0.53795255258486200000
chr11,36595952,37725879,1129927,1,1,5897;5896;119710,3,0.26550387768413400000
chr1,145382123,145809279,427156,1,1,148738;128077;27246;84265;11126;10628;653519;8799;5174;10401;200035;284615;8515;148741;10623;9939,16,3.74570414555806000000
chr13,24222769,24492936,270167,1,1,4285;55504;542767;387911,4,1.48056572416320000000
chr2,2606014,3584798,978784,1,1,51112;7260;55256,3,0.30650276261156700000
chr1,145656021,148545497,2889476,1,1,9557;27246;11126;2330;653519;149013;5174;644591;51205;645142;51463;5565;607;2702;200030;2703,16,0.55373361813699100000
chrX,121979085,123122339,1143254,1,1,57187;10735;2892;331,4,0.34987850468924700000
chr5,13830687,14153620,322933,1,1,1767;7204,2,0.61932351292683000000
chr15,32021733,32510863,489130,1,1,161725;1139,2,0.40888925234600200000
chr17,51885,3469907,3418022,1,1,10594;8388;51031;50628;286753;63826;443;5345;400566;26189;55178;162514;146760;114826;9905;124641;100506388;1398;23293;7442;727857;8386;9501;8390;23108;64359;6117;84690;23277;55720;4994;29928;124935;8387;727910;29;8578;359845;79066;4641;55275;83547;4335;124997;5176;1801;8383;4995;79850;7531;8392;5306;3090;4991;5048;51763,56,1.63837447506189000000
chr15,30509354,32861596,2352242,1,1,728498;101059918;51621;89832;653125;22909;161725;283710;54893;89839;4308;728047;1139,13,0.55266422417421300000
chr15,30955149,32513176,1558027,1,1,161725;283710;54893;51621;4308;22909;1139,7,0.44928618053474000000
chr1,176160185,182067488,5907303,1,1,9068;127665;7827;6646;126859;777;163589;9213;26092;89884;64222;89866;10228;84320;84066;3140;148753;9857;460;55103;51278;27;60676;64326;163590;57710;9462;9917;57795;5768,30,0.50784596625566700000
chr15,47384497,48918698,1534201,1,1,399697;50804;2200;6557;1854;283652;80031,7,0.45626355347180700000
chr7,72766342,74133302,1366960,1,1,5982;51085;9275;84277;7462;135886;83451;1364;6804;7461;155382;3984;26608;8468;9031;155368;2969;8326;7458;9569;2006;1365;114049,23,1.68256569321707000000
chr20,61704274,62186812,482538,1,1,54915;79444;3785;55738;1137;128414;57642;79025;1917;79144;6725;5753,12,2.48685077651916000000
chr19,47965015,48598963,633948,1,1,6543;84215;64100;6822;8775;56344;100131137;11133;29997;6415;30846;284355;1406;29998;8605,15,2.36612466637642000000
chr1,98031472,105019553,6988081,1,1,9890;277;276;178;54873;54112;148867;101928436;1806;55599;54482;2135;1901;391059;118427;8556;51611;279;8634;1629;1301;163404;23443;64645;51375;278;163786;280;7412;127495,30,0.42930240791427600000
chr1,189005477,196799273,7793796,1,1,8707;5996;64407;51377;10878;3075;339479;79577;51022;431704;6738;3078;6003;343450;5997,15,0.19246077264531900000
chr3,195740357,197317103,1576746,1,1,622;255798;80235;200933;5062;5130;4241;26043;1739;84984;348793;255758;116211;131540;200931;375387;22916;7037;165918;54965;205564,21,1.33185687485492000000
chr1,145729354,147824177,2094823,1,1,9557;51205;51463;5565;607;2702;149013;2330;653519;200030;2703;5174,12,0.57284076029335200000
chr6,95674141,96213391,539250,1,1,79694,1,0.18544274455261900000
chr16,14968878,16194549,1225671,1,1,4629;100288332;123811;89927;4363;9284;54820;23420;255027;23042;54700;123803;9665,13,1.06064351689809000000
chr2,12413298,26742511,14329213,1,1,375189;7447;114818;100526794;64342;93034;375190;150946;348654;9540;109;9741;1653;6382;54454;23369;4613;80304;55252;3030;60526;81553;85465;57665;10890;92749;388931;3797;3032;100129278;653140;388;22979;165082;343930;5443;130502;8648;51594;79172;729475;57539;151449;1838;165324;391356;4148;338;79677;2281;28951;151354;130497;9381;51277;10408;3790;51639;50618;1788,60,0.41872501999935400000
chr2,42708267,47426010,4717743,1,1,51626;6496;678;9581;64241;728819;9655;90411;57217;805;79823;285051;23498;170850;57504;64240;388946;2034;165140;9419;130271;63892;23433;6519;10736;5495;90423;5281;55133;5581;10128,31,0.65709386882668300000
chr1,143700200,149699391,5999191,1,1,9557;148738;128077;84265;9659;10628;2330;653519;554282;5174;388677;200035;51205;284615;645142;5565;148741;730262;653598;10623;728833;100132406;644634;9939;728945;27246;284565;11126;400818;8799;388692;149013;10401;644591;8515;51463;607;2702;200030;2703,40,0.66675656767720800000
chr2,228099299,229273078,1173779,1,1,56918;79853;6364;1285;56947;80704;164781;80309;3267,9,0.76675421863911400000
chr3,195740386,197230147,1489761,1,1,255798;80235;200933;5062;5130;4241;26043;1739;84984;348793;255758;116211;131540;200931;375387;22916;7037;165918;54965;205564,20,1.34249721935263000000
chr3,195740402,197361280,1620878,1,1,622;255798;80235;200933;5062;5130;4241;26043;1739;84984;348793;255758;116211;131540;200931;375387;22916;7037;165918;54965;205564,21,1.29559411627525000000
chr16,28856819,29042014,185195,1,1,27040;79874;7284;84901;930;487;83985;25970,8,4.31977105213424000000
chr7,44146147,66096117,21949970,1,1,222008;816;100130988;908;442319;168374;154881;154664;90827;435;80099;136288;165;23386;222068;10320;9238;256979;346288;10793;375567;23480;168507;2631;730291;29881;5814;3484;3364;441234;5478;54606;5723;51142;401335;25870;5425;27297;389493;728927;94239;1956;349075;23148;154807;10268;7378;168417;3486;2086;64005;58498;10652;11055;4967;7697;51351;2887;83637;63979;81552;285877;107;5260;109504726;2990;51427;83605;51373;2645;64759;1644;23242;340252;8460;55915,76,0.34624193108236600000
chr16,29592812,30190538,597726,1,1,653808;5531;26470;283897;253980;146378;8479;83719;23475;283899;124446;9344;3835;4150;226;253982;83723;5595;6911;8448;79447;112476;9961;10423;6693;79153,26,4.34981914790389000000
chr11,73107317,85756385,12649068,1,1,81544;10825;26005;26011;23201;58487;220042;100507050;28971;27314;5547;11309;871;56946;51400;58473;10008;100532726;5870;7351;338699;220047;726;7352;5612;4975;5058;9789;341152;192134;80168;51773;374407;79053;51585;80227;220382;25987;220388;57558;283212;6188;7069;92105;4718;100506127;51642;25884;84649;7405;387787;143570;283219;4647;1207;282679;55863;220032;10714;84233;51287;79731;9846;84957;1740;65987;55331;254225;54843;408;2615;8301;7481;283209;283208;4135;60492;100287896,78,0.61664622247267500000
chr5,115887109,131086617,15199508,1,1,51735;401207;4015;93166;501;28966;96459;171019;57507;100127206;6558;285605;337876;28965;9627;728586;3295;51808;51334;90624;115123;100505841;133619;153241;1657;389320;25816;153443;94033;2201;65983;3094;340069;84466;6643;51015;5480;56990;1456;4001;613212;57556;133923,43,0.28290389399446400000
chr11,203788,3131418,2927630,1,1,7054;11187;283229;4583;5719;4676;430;23410;66005;101927423;439915;114879;3265;5441;5002;7136;4046;5003;6050;4586;55367;54472;7140;51272;1850;723961;833;103344718;3784;402778;171389;59307;1509;440021;440023;338440;6888;8519;6150;90019;387266;29125;9024;51286;387733;387264;338707;3630;6343;4588;115399;10581;3665;6181;7106;53841;101927503;347862;60626;7262;10410;64787;57661;3481;1028;10077;8045;81532;10522;79751;975;727897;283232;10078;80162;977;81490;161;1815;57104;29850;256329,82,2.80090038700246000000
chrX,48811186,53561588,4750402,1,1,23096;729442;64061;9500;389856;170685;3028;727837;139189;778;729431;9502;26748;55190;653220;8242;50943;340602;28952;729447;54328;85417;100132399;7030;729428;729422;89801;56850;79917;2574;9506;8712;729408;81557;170626;6757;494197;29057;100008586;57477;280658;90060;170627;727866;8243;4007;10075;3750;1184;27238;645073;645037;645051;2543;653067;11152;5355;55593;8852;23708;158787;728239;6855;11230;9210;729396,66,1.38935610080999000000
chr12,50508123,51080548,572425,1,1,113251;57609;91012;84987;121006;51474,6,1.04817224963969000000
chr8,8093169,11756752,3663583,1,1,1508;83650;83595;203076;2626;83648;137075;157285;640;66036;252969;286046;79660;2222;54984;4482;8658;203074;9258;90459;94137,21,0.57320934178371300000
chr8,1,10315964,10315963,1,1,389610;401447;441308;728358;503841;1669;504180;26260;55894;1667;245910;157285;245908;100132396;503618;392188;157695;100289462;4482;9228;245909;90459;9920;1672;1668;9172;503614;140596;100133251;653423;645402;100131980;137075;157697;1673;64478;1671;9639;100131608;79648;1670;169270;285;79660;8658;9258;414325;55326;10407;645836;2055,51,0.49437943893362200000
chr5,49441944,57955138,8513194,1,1,115827;4338;10769;3672;4724;8611;493869;112574;11082;3003;54622;53918;3670;65056;345651;8988;3673;133396;54514;153129;10468;79722;10309;202309;79668;4214;166979;3001;54505;3572;133383;345643;101928448;23517;166968;133418,36,0.42287301334845700000
chr15,50846572,64182638,13336066,1,1,9236;8854;10681;100820829;283659;5597;145788;5873;83464;256764;3175;6095;114294;256586;10017;102;55329;3990;6938;9245;101928527;9960;27023;771;663;51762;283807;8925;388121;302;440279;9488;81488;92483;23312;29767;83660;145773;366;55930;29766;145741;56204;54778;29106;10776;161582;9133;145781;26108;342035;79811;2958;54822;4644;51187;4643;54816;1588;51065;84888;64864;54629;54832;79664;388125;23431;4734;123169;7168;84952;374618,72,0.53988934967778400000
chr11,774448,3183592,2409144,1,1,7054;283229;4583;4588;4676;430;66005;101927423;439915;114879;6181;5441;7106;5002;101927503;347862;7136;4046;5003;4586;55367;54472;7262;7140;1850;3481;723961;10077;1028;833;81532;103344718;3784;402778;79751;975;727897;440023;977;440021;1509;90019;6150;10078;387266;29125;9024;51286;161;57104;29850;387264;3630,53,2.19995151804956000000
chr17,1715,2339591,2337876,1,1,10594;51031;50628;286753;63826;5345;400566;55178;146760;114826;9905;124641;100506388;1398;23293;727857;9501;64359;6117;55720;29928;124935;727910;29;8578;359845;79066;4641;55275;83547;4335;124997;5176;1801;79850;8447;7531;5306;3090;51763,40,1.71095472984880000000
chr17,1235799,2339575,1103776,1,1,10594;55720;124935;63826;727910;5345;8578;79066;4641;146760;83547;114826;9905;4335;124997;1801;5176;124641;1398;7531;23293;5306;3090;6117;51763,25,2.26495230916418000000
chr22,21464060,22962941,1498881,1,1,7332;23753;5594;7441;8940;23532;129025;645426;29799;150221;140883;23759;150223;9647;440804;23119;164592,17,1.13417943118900000000
chr3,195571638,197299782,1728144,1,1,622;255798;80235;200933;10188;5062;5130;4241;26043;1739;84984;348793;255758;116211;131540;200931;375387;22916;7037;165918;54965;205564,22,1.27304206130971000000
chr16,46505617,54206543,7700926,1,1,643802;85320;55027;85407;23594;123970;5934;255919;113;64127;9683;124460;80205;94160;79068;388276;79801;388272;10294;869;23322;1540;6477;29117;81831;27324;23090;6299;5257;64282;84706;91807;81533;64400;83752;55737,36,0.46747624896019000000
chr13,112218250,115096466,2878216,1,1,7027;55795;283489;79774;23263;3916;22821;8858;643365;10426;55002;8451;101928841;2621;400165;23250;6656;348013;2155;113622;65110;2159;55208;496;122258;6011;8881,27,0.93808108911909300000
chr15,23656965,28940069,5283104,1,1,2562;7681;23742;8924;7337;6638;2567;4948;8926;57194;283685;54551;4692;2558,14,0.26499572978309700000
chr7,4290999,4403382,112383,1,1,221935,1,0.88981429575647600000
chr15,23656965,28691431,5034466,1,1,2562;7681;23742;8924;7337;6638;2567;4948;8926;57194;283685;54551;4692;2558,14,0.27808311745476100000
chr2,200205410,200256585,51175,1,1,23314,1,1.95407914020518000000
chr22,21007295,21798705,791410,1,1,80764;9342;3053;8216;440804;23119;400891;1399;6545;150209;9127;5297,12,1.51628106796730000000
chr13,51541817,55154018,3612201,1,1,10562;144983;540;26586;9724;79621;79758;440138;55901;83446;4752;10910;341676;11061;5100;647174;26512;220108;51028;115825,20,0.55367904499223600000
chr16,29580020,30190029,610009,1,1,653808;5531;26470;283897;253980;146378;8479;83719;23475;283899;124446;9344;3835;4150;226;253982;83723;5595;6911;8448;79447;112476;9961;10423;6693;79153,26,4.26223219657415000000
chr15,31014308,32510863,1496555,1,1,161725;283710;54893;51621;4308;22909;1139,7,0.46774091162703700000
chr15,22784523,28525460,5740937,1,1,2562;7681;123606;4948;57194;81614;2558;8924;114791;23742;7337;6638;2567;8926;283685;54551;4692;23191,18,0.31353766815417100000
chr15,22318597,23699760,1381163,1,1,114791;123606;283694;81614;283685;390538;23191;283767,8,0.57922200348546800000
chrX,6552712,8115153,1562441,1,1,412;8228;26609;8226,4,0.25600966692502300000
chr14,20511672,34254306,13742634,1,1,54930;25983;122665;390442;84962;10038;90809;9985;85446;493901;116173;51310;122748;26534;5720;55644;10379;6038;84502;1053;394;51016;4624;599;57820;122742;55701;4625;23428;100528064;1241;4860;122664;56339;9472;643382;22985;64184;161247;57523;161424;5693;11035;23351;55072;8906;10901;317749;112487;63874;64806;2290;10876;2856;122704;1511;6035;57447;51222;4857;122651;145553;3002;4901;2999;100529063;57680;390443;10278;10202;29082;161253;115817;390439;60686;11198;728635;9878;10548;23256;84659;26277;11154;64403;57096;338879;390437;90668;341799;64067;6036;4323;56948;84932;4738;55017;283;6039;7011;51292;9362;27141;56413;196883;5106;9056;1690;1215;79178;25938;29091;5721;440163;283629;6037;122706;7051;91875;6297;29986;390445;90673;80224;1603;26686;5018;80344;5875;123103;25831;643866;10419;26687;26020;3183;26533;57594;390436;79711;328;8106;55632;5587;29966;4776;55147;100507650;64745,148,1.07694056321372000000
chr16,29673954,30197341,523387,1,1,653808;5531;26470;283897;253980;146378;8479;83719;23475;283899;124446;9344;3835;4150;226;253982;83723;5595;6911;11151;8448;79447;112476;9961;10423;6693;79153,27,5.15870665492265000000
chr16,15375911,18242713,2866802,1,1,4629;100288332;123811;64131;89927;4363;54820;408050;255027;101059938;368;9665,12,0.41858489006216700000
chr6,2977261,16186451,13209190,1,1,6745;154007;6239;57128;9450;4117;51256;1906;405754;100130357;63933;1832;221711;4739;29116;654;55003;81853;9425;10048;84062;63027;51299;54438;3096;9521;51522;222826;23408;670;3720;9247;10799;285782;107080638;10455;404220;648791;54898;389362;100113407;221687;2162;4835;9308;7020;8899;8737;221692;84830;63915;51406;81567;7280;51000;347744;221710;347733;221749;26240;83732;10667;2651,63,0.47694067539341900000
chrX,152857869,153533691,675822,1,1,3654;8260;3421;5973;1852;3897;4204;3054;215;6748;10134;5365;139728;8277;26576;728458;8269;5956;554;6535;92002;57595;393;2652,24,3.55123094542646000000
chr17,34437475,36168104,1730629,1,1,26574;9326;6928;3975;414060;79893;729877;31;6349;80179;284098;11072;9560;414062;101060321;414059;79922;11276;79154;11056;6871;284099,22,1.27121410770304000000
chr7,158738830,158909738,170908,1,1,7434;55112,2,1.17022023544831000000
chr14,64395237,64536156,140919,1,1,23224,1,0.70962751651658100000
chr11,17224139,20243291,3019152,1,1,54503;3767;283284;55293;6291;6289;3746;3939;4925;6288;117195;117194;84867;7251;79733;340990;144110;160287;120237;10083;4654;6833;144108;8048;3948;11234;89797;26297;2965;113174;259249;100528017;5286;7166;374383;117196,36,1.19238779630837000000
chrX,153560562,153868487,307925,1,1,55558;2539;1485;1774;246100;8270;9130;537;60343;2010;8517;2664;6134;2316;8273;6901;8266,17,5.52082487618738000000
chrX,153576915,153832695,255780,1,1,55558;2539;1774;246100;8270;9130;537;60343;2010;8517;2664;2316;6134;8273;6901;8266,16,6.25537571350379000000
chrX,153576915,153832695,255780,1,1,55558;2539;1774;246100;8270;9130;537;60343;2010;8517;2664;2316;6134;8273;6901;8266,16,6.25537571350379000000
chr3,187183407,189363665,2180258,1,1,285386;6750;8626;344892;4026;604,6,0.27519678863694100000
chr3,189372066,197851986,8479920,1,1,131583;622;80235;200933;57110;84239;5062;5130;151963;6165;55341;3556;255758;116211;93109;152002;131540;200931;375387;8626;344901;22916;23527;7037;165918;54965;9076;10686;84859;2814;79572;131920;84248;255798;55214;1370;152138;344905;10188;89782;26043;4241;347;131578;1739;4976;348793;647309;84984;152137;3280;5504;9711;84223;2257;200958;4585;205564;257313,59,0.69576128076680000000
chr10,121246833,121775059,528226,1,1,11196;6001;22876;9531;79892;7073,6,1.13587744639605000000
chr22,18916842,21465659,2548817,1,1,54487;27037;9342;29801;65078;10587;1312;6545;421;7290;2812;6899;5625;7625;79680;64976;6576;3053;8218;5413;80764;23617;400891;1399;7122;150209;128977;8220;388849;84861;7353;51586;2928;128989;5297;9127;9993;54584;91179;85376;8216;85359;8318;728229;5902,45,1.76552494745602000000
chr16,14780194,16899617,2119423,1,1,100288332;642799;642778;8399;23042;101059938;368;123803;9665;4629;123811;89927;4363;9284;54820;23420;408050;255027;54700,19,0.89647040727594300000
chr15,20102541,24431712,4329171,1,1,7681;727832;114791;100996331;54551;123606;283694;81614;100287399;283685;4692;390538;23191;283767,14,0.32338754925596600000
chr22,22283292,22569881,286589,1,1,9647;8940,2,0.69786349092254100000
chr22,17096855,18641468,1544613,1,1,27440;51816;51807;23765;27439;27443;55670;637;529;11274;150165;23786;83733;128954;101929372;57553,16,1.03585817288861000000
chrX,15191748,20379007,5187259,1,1,660;10742;2925;8544;55787;4810;795;10389;5160;6247;11238;645864;5931;1964;10149;140456;30011;5277;5475;6322;140462;57393;9185;8233;94056;6792;56474;6197;139105;5256;256643;8905;2277;256714;59272;389840,36,0.69400814572783000000
chr16,29707373,30197341,489968,1,1,653808;5531;26470;283897;253980;146378;8479;83719;23475;283899;124446;9344;3835;4150;226;253982;83723;5595;6911;11151;8448;79447;112476;9961;10423;79153,26,5.30646899389348000000
chr16,15048751,16276115,1227364,1,1,4629;100288332;123811;89927;4363;54820;368;255027;23042;54700;123803;9665,12,0.97770506548994400000
chr3,4027674,4869174,841500,1,1,3708;285362;6419,3,0.35650623885918000000
chr17,36473175,55198277,18725102,1,1,9842;654364;83900;653240;2896;55040;83899;83895;84336;8678;147183;7343;5245;1394;1659;3674;2793;85285;7266;65264;3728;8161;51755;78995;10614;100132386;100505753;124995;83755;51629;3872;2520;9020;3882;124783;3131;28958;5409;124817;83901;7473;147179;3857;81558;55379;284067;5469;84514;782;162417;3212;3690;6668;201181;7283;90507;92579;100506084;146909;317719;728255;284071;28511;56934;8687;55175;84313;4222;3213;2695;8631;55316;8405;9570;10493;113026;5164;1747;672;84951;284119;51751;54883;2064;1277;23131;3216;6521;22834;3884;246744;10140;3886;113277;6155;9520;80755;10237;516;474170;728224;730755;390792;5697;2118;3858;3219;85280;22806;339210;23415;4355;3060;6605;3292;5691;81851;5914;3866;752;1845;3487;8165;47;79877;124857;22794;81870;162466;84961;996;51195;51264;100533177;10609;8714;84299;8506;4761;84616;100505724;6774;3868;80174;94103;29893;80725;124808;10052;5539;85291;440435;85294;100170841;10197;8557;3211;8526;3885;3881;2670;124872;58488;125111;192666;11143;54474;379;4137;10241;8153;10900;100885848;92591;339287;84366;57125;79170;7153;10882;728318;100506650;388381;284110;8689;146923;59342;30837;2886;3859;81872;255061;360205;125113;162427;3883;10266;90506;2535;8913;55273;51326;23531;6945;91369;3860;9343;84643;10642;353288;1353;65266;252983;8639;9884;124801;146894;5878;4669;10014;84073;11248;83897;54799;3880;7484;83896;115024;7706;10209;100505591;5709;29916;10040;4302;81850;79089;342667;25984;284076;162540;4831;9349;55876;2826;57636;201176;100507608;990;56970;4905;728279;314;85290;6777;2145;10948;93210;2648;64847;146956;85293;124626;9862;284069;1440;80221;201191;6776;50964;10481;100132476;6442;79990;162605;3861;83902;147184;85289;124989;1236;84311;4804;8688;494188;9043;9572;51096;4185;51225;342574;79777;3214;84152;390790;3927;114881;4836;30009;79132;6143;284058;388394;284106;80279;162461;4779;3218;3837;9755;4830;124790;80320;94086;64132;2538;125115;8396;3675;4356;1748;60681;162282;3217;9001;80347;7067;81871;83538;55163;9241;729220;3215;4635;51226;4077;27175;535;388389;1267;10951;7703;100885850;104909134;11267;51747;3430;84687;1101,349,1.86380827191222000000
chr10,136361,2903915,2767554,1,1,22982;105;22884;10771;3422;23560;91734;23185,8,0.28906391709068700000
chr15,23699701,29213461,5513760,1,1,2562;7681;23742;8924;7337;6638;2567;4948;8926;57194;653720;54551;4692;2558,14,0.25391021734714600000
chr1,146564743,147786706,1221963,1,1,9557;51205;51463;5565;607;2702;2330;200030;2703,9,0.73651984552723800000
chr1,145440247,145747269,307022,1,1,128077;10401;200035;27246;84265;284615;9939;11126;8515;148741;10628;10623;8799;5174,14,4.55993381581776000000
chr1,146641601,149224043,2582442,1,1,9557;728945;284565;644591;51205;645142;51463;5565;607;2702;730262;2330;200030;2703,14,0.54212253363289500000
chr1,145740598,147786706,2046108,1,1,9557;51205;51463;5565;607;2702;149013;2330;653519;200030;2703;5174,12,0.58647930607768500000
chr22,18641409,21440514,2799105,1,1,54487;27037;9342;29801;65078;10587;1312;6545;8214;7290;421;2812;6899;5625;7625;79680;64976;11274;6576;3053;8218;5413;80764;23617;400891;1399;7122;150209;128977;8220;388849;84861;7353;51586;2928;128989;5297;9127;9993;54584;91179;85376;8216;85359;8318;728229;5902,47,1.67910814349587000000
chr1,145388355,145833054,444699,1,1,148738;128077;27246;84265;11126;10628;653519;8799;5174;10401;200035;284615;8515;148741;10623;9939,16,3.59793928027722000000
chr3,195740357,197310451,1570094,1,1,622;255798;80235;200933;5062;5130;4241;26043;1739;84984;348793;255758;116211;131540;200931;375387;22916;7037;165918;54965;205564,21,1.33749953824421000000
chr7,72726578,74139390,1412812,1,1,5982;51085;9275;84277;7462;135886;83451;1364;135892;6804;7461;155382;3984;26608;8468;9031;155368;2969;8326;7458;9569;2006;1365;114049,24,1.69873981817821000000
chr17,14111772,15422557,1310785,1,1,1352;64518;9953;201158;284040;100533496;5376;146822,8,0.61032129601727200000
chr1,245925622,249098872,3173250,1,1,127077;84838;391194;25909;127069;93474;127074;81472;127066;388759;127068;646627;343172;81469;25893;441933;391190;391196;403244;127623;343173;7678;284532;343169;127064;26246;391189;26696;391191;64754;441932;401993;81466;127059;127062;57116;79862;343563;317705;391195;26245;343171;401992;254879;163882;114548;26188;81470;148823;64216;403239;284521;391211;401994;391192;51097,56,1.76475222563618000000
chr5,10907655,11363917,456262,1,1,1501,1,0.21917231765959000000
chr8,116900770,132161678,15260908,1,1,56169;114569;4715;6873;84985;286053;79139;55039;90390;7373;114907;4609;100533106;401474;312;441376;64798;55093;10221;6641;29028;50807;137209;157769;654463;3037;27085;4982;83940;6713;169026;11244;157378;51571;9897;93594;11236;114;9788;8667;84294;157638;340359;22882;79075;10584;28998;4856;5885;84933;5168;2131;5462,53,0.34729257263067200000
chr2,96732519,98212850,1480331,1,1,81562;51239;56910;55683;23397;57730;10865;54910;9391;26504;93082;51252;90342;151;151313;1844;26505;200539;375248;23020;150771;431705;55654,23,1.55370656967935000000
chr22,17068186,23871065,6802879,1,1,7332;9342;65078;100423062;1312;613;51816;6545;8214;421;129025;91227;150160;7625;55670;27439;23119;64976;529;6576;83733;164592;8218;23753;5413;80764;5594;23617;7441;7122;150209;8940;128977;5297;2928;128989;140883;150221;54584;91179;8318;728229;101929372;57553;54487;27037;27440;29801;10587;7290;2812;23532;645426;29799;23759;150223;9647;6899;27156;5625;27443;79680;637;11274;150165;9609;3053;2781;1399;400891;8220;388849;84861;51586;7353;9127;51807;23765;9993;8216;85376;440804;85359;23786;128954;5902,86,1.26417065480659000000
chr15,84657433,102465355,17807922,1,1,145814;145946;2242;51458;123355;80213;204219;100526783;79705;56963;51335;145748;400451;220;57538;145858;100133220;91433;8128;23336;176;64963;4122;4205;342132;64784;55829;26682;145873;100505679;5045;5046;123624;9154;5151;374659;7026;64782;26276;170691;100128108;54993;9055;390637;64927;140460;6627;123283;643707;3418;55215;11057;5346;55070;390649;374655;5428;390648;56964;3480;11214;3669;10519;6017;9899;374654;10509;283777;22856;145864;26589;28232;290;55898;57188;91947;55784;348110;4828;8826;4916;1106;55180;84942;4240;55897;23478;90381;8800;641;9640;64410;10239,93,0.52223948420259200000
chr1,144009907,151856908,7847001,1,1,9557;10962;57530;84265;117145;7286;9659;10628;11189;54507;126961;51107;200035;5298;317772;5692;284615;126626;339398;5565;79626;8394;653604;100534012;730262;65005;644634;723790;2029;27246;11126;400818;51686;1520;5710;388695;6097;54460;8349;8799;9129;56957;149013;79005;10401;9900;284486;55793;23126;8515;29956;8370;51027;1893;10500;9869;333932;10262;79630;57592;11022;148738;128077;54964;8337;284485;148523;2330;1513;653519;554282;81611;51177;388677;55204;5174;8338;51205;29765;554313;5993;645142;10903;2209;148741;653598;56882;10623;80222;100132406;9939;4170;728945;284565;11311;84072;440689;388692;8991;58497;405;644591;8416;6944;100191040;23632;51463;23248;607;2702;149428;200030;81609;2703,114,1.45278431849314000000
chr16,14910005,16349730,1439725,1,1,4629;100288332;123811;89927;4363;9284;54820;23420;408050;368;255027;23042;54700;123803;9665,15,1.04186563406206000000
chr7,72726572,74133332,1406760,1,1,5982;51085;9275;84277;7462;135886;83451;1364;135892;6804;7461;155382;3984;26608;8468;9031;155368;2969;8326;7458;9569;2006;1365;114049,24,1.70604793994711000000
chr15,74054718,74343860,289142,1,1,161514;9399;4016;5371,4,1.38340331048412000000
chr1,146564743,147786706,1221963,1,1,9557;51205;51463;5565;607;2702;2330;200030;2703,9,0.73651984552723800000
chr15,32021733,32510863,489130,1,1,161725;1139,2,0.40888925234600200000
chr15,22866888,23179948,313060,1,1,123606;23191;114791;81614,4,1.27771034306523000000
chr2,19457387,21971966,2514579,1,1,4148;388;338;23369;130497;60526;64342;130502;100129278;57539;151449;9741;6382,13,0.51698514940274300000
chr18,64400620,71429559,7028939,1,1,54495;147381;9306;79839;81832;92126;10666;25914;220158;220164,10,0.14226898255910300000
chr7,73048479,74115258,1066779,1,1,5982;84277;7462;135886;83451;1364;6804;7461;155382;3984;155368;2969;7458;9569;2006;1365;114049,17,1.59358217587710000000
chr16,29591078,30177807,586729,1,1,653808;5531;26470;283897;253980;146378;8479;83719;23475;283899;124446;9344;3835;4150;226;253982;83723;5595;6911;8448;79447;112476;9961;10423;6693;79153,26,4.43134735116212000000
chrX,122516347,123044339,527992,1,1,57187;2892;331,3,0.56819042712768400000
chr8,89614825,90488074,873249,1,1,,0,0.00000000000000000000
chr16,15052746,16308351,1255605,1,1,4629;100288332;123811;89927;4363;54820;368;255027;23042;54700;123803;9665,12,0.95571457584192500000
chr15,32021733,32438943,417210,1,1,161725;1139,2,0.47937489513674200000
chr1,168313814,174826764,6512950,1,1,481;9588;8548;149281;2153;6402;51603;356;92346;57821;2328;91687;7292;730159;10560;80133;339416;8674;462;6401;5396;51430;23215;92344;27252;5279;149041;92342;26052;29922;6403;1805;2329;2326;2327;9293;55732;6375;57147;4653;22920;84614;284525;6846;55157;9910;8995,47,0.72163919575614700000
chr16,15449696,16293381,843685,1,1,4629;100288332;123811;89927;4363;54820;255027;368;9665,9,1.06674884583701000000
chr16,29633373,30332581,699208,1,1,653808;654483;5531;26470;283897;253980;146378;8479;83719;23475;283899;548593;124446;9344;3835;4150;226;613037;253982;83723;5595;6911;11151;6818;79447;112476;8448;9961;10423;6693;79153,31,4.43358771638768000000
chr15,22765628,23179948,414320,1,1,123606;23191;114791;81614,4,0.96543734311643200000
chr2,205852911,210196206,4343295,1,1,130749;54891;57683;391475;3417;200576;151194;1418;2825;117583;130752;7855;4719;1419;1933;5746;1385;8609;389073;1421;8745;389072;8828;22868;1420;151195;200726,27,0.62164785030719800000
chr1,117757951,121322377,3564426,1,1,83998;10885;200162;4853;3284;3158;6913;653820;11085;51179;54855;26227;653464;90874;54834;10352;3283;2210;343505;10905,20,0.56110016030631600000
chr17,29055566,30395625,1340059,1,1,79915;79736;55352;114659;55813;2124;84440;2123;55803;4974;4763;23512;84282;51379,14,1.04473012009173000000
chr10,102969339,103410136,440797,1,1,27343;8945;6468;10660;25911,5,1.13430899030620000000
chr18,2313428,4391016,2077588,1,1,23347;10403;9663;10627;64863;8736;103910;7050;9229;84034,10,0.48132738541038900000
chr10,95959384,97039485,1080101,1,1,1559;1558;64318;9124;142827;51196;1557;3070;1562;23232,10,0.92583934280220100000
chr22,18886915,21463730,2576815,1,1,54487;27037;9342;29801;65078;10587;1312;6545;8214;7290;421;2812;6899;5625;7625;79680;64976;6576;3053;8218;5413;80764;23617;400891;1399;7122;150209;128977;8220;388849;84861;7353;51586;2928;128989;5297;9127;9993;54584;91179;85376;8216;85359;8318;728229;5902,46,1.78514949656844000000
chr4,1600410,1994893,394483,1,1,7469;7884;3954;7468;152877;92305;10460;2261,8,2.02797078708081000000
chrX,74697085,75189273,492188,1,1,158866;139599,2,0.40634879355043200000
chr22,22315092,22578983,263891,1,1,8940,1,0.37894433686635800000
chr17,14111772,15442066,1330294,1,1,1352;64518;9953;201158;284040;100533496;5376;146822,8,0.60137082479512000000
chr16,16276056,18669725,2393669,1,1,408050;101059953;64131;283820;101059938;368,6,0.25066122341894400000
chr16,18737961,28628827,9890866,1,1,204474;57020;23049;343;162083;6340;23247;6296;116285;146183;51704;7385;79728;10229;146177;56061;124454;123876;730094;400506;6338;146395;5579;55718;10368;51451;50615;55114;6799;51573;123879;162073;2813;57146;10261;23204;55623;728741;112479;57149;29904;9956;9951;728276;1039;388228;9738;54988;79831;257629;4706;23214;55567;5930;23117;26471;197370;7369;728689;51760;63928;124274;100132247;115584;1428;112869;79838;27327;6210;1201;348158;255762;81691;79905;246778;10595;51108;23062;7783;55911;440345;3566;5347;84516;57478;91949;2975;6817;124152;342357,90,0.90993043480722500000
chr6,84956081,88452718,3496637,1,1,57231;4907;57150;10492;57038;206412;23036;55122;1081;23595;3354;10559;154313;9096;375519,15,0.42898362054740000000
chr7,66808840,70189959,3381119,1,1,26053,1,0.02957600723310830000
chr4,168441574,190790881,22349307,1,1,53842;205860;1182;25854;7098;55714;60684;60559;80014;83891;132851;55602;80817;3818;54969;291;100132463;27295;91351;441054;2195;442117;201965;57630;133121;56977;3622;1635;55601;285440;11341;175;55325;140458;3148;51166;836;51809;57587;9464;8819;9848;8001;2160;2823;79682;353322;11086;116966;23022;84869;3660;4750;391723;339976;55247;201973;4543;11199;55805;132625;3248;256309;8470;2180;26269;7424,67,0.29978558171848500000
chr12,53637649,54007964,370315,1,1,84975;54458;6667;6895;269;8086;11016;8620;9700;5094;5204;121340;7786;60314,14,3.78056519449658000000
chr2,86498757,92262019,5763262,1,1,150572;926;55818;9451;729857;7844;55258;64795;100526767;65055;22934;51315;51652;925;5343;2168;400966;344167;200523;5342,20,0.34702569482352200000
chr22,23654178,25040614,1386436,1,1,4320;3543;7621;2952;66035;613;388886;391322;400916;150248;266747;51733;2678;653689;4282;83606;23384;135;51233;6598;1652;29802;56241;100037417;2687;23523;6634;91319,28,2.01956671638648000000
chr1,146476526,147820342,1343816,1,1,9557;51205;51463;5565;607;2702;2330;200030;2703,9,0.66973454699155200000
chr1,146501348,147743617,1242269,1,1,9557;51205;51463;5565;607;2702;2330;200030;2703,9,0.72448076865799600000
chr22,47285486,51169045,3883559,1,1,85358;410;400935;85378;9701;56666;5600;25771;9889;23774;80305;414918;79174;9997;1120;440836;1375;415116;83642;23542;644186;23209;6300;83933;79924;79087;6305;1890;348645;23654;25817;113730;29781;55586;91289;54456,36,0.92698475805311600000
chr5,146179403,146804546,625143,1,1,1809;5521;202374,3,0.47989020112198300000
chr2,149150955,149674850,523895,1,1,26122;55777;3800,3,0.57263382929785600000
chrX,153120607,153626762,506155,1,1,8260;3654;5973;3897;4204;3054;8277;728458;2010;8269;5956;2316;554;6134;393;2652,16,3.16108701879859000000
chr15,22762571,23128379,365808,1,1,123606;23191;114791;81614,4,1.09346979836417000000
chr2,1742241,1848126,105885,1,1,7837;23040,2,1.88884166784719000000
chr20,65043,20841621,20776578,1,1,57761;10326;3642;140850;5786;9762;100303755;551;5621;9751;23236;343641;146;245938;8760;57325;63926;631;5332;388780;100128496;54453;128637;23767;54976;650;57144;140809;128646;64949;80343;55317;83541;55968;7692;10741;128653;55321;55612;56255;6616;55614;55304;55617;56914;5126;54363;81623;140881;55184;140856;22888;29058;51340;140885;60493;245939;85364;3420;1114;140862;65992;128710;6939;57186;2280;25943;92675;27111;994;140733;140680;57593;10616;51126;1457;54498;80332;64773;26074;22903;84515;5020;113278;140836;117532;56265;1059;343637;51605;6628;8195;11237;9770;85508;3704;64601;64096;9491;83959;92667;182;400830;80023;56261;116835;6629;80025;9962;149840;24141;10528;23627;51378;6238;8455;54675;11034;7053;57419;164312;128674;2797;10483;6614;25876;27131;5173;400831;58495;5111;79133;642636;57506;140901;10621;55423;100288797;284759;6666;79175;51575,142,0.68346192525063600000
chr10,46691553,48284679,1593126,1,1,83849;642517;195977;653145;100133093;728113;9721;5540,8,0.50215739370269500000
chr7,155596409,156024479,428070,1,1,6469;389602,2,0.46721330623496200000
chr1,241288878,249136658,7847780,1,1,127077;25909;200150;200159;127069;84288;51029;81469;391196;55083;127623;343173;127064;26246;391189;79894;441925;441932;401993;6000;10472;57116;80851;79862;23596;343563;317705;391195;26245;114548;440738;26188;159;284521;163882;391211;343169;128025;84838;391194;3192;9156;93474;1122;127074;8564;81472;388759;127066;127068;343172;25893;391190;441933;403244;646627;7678;284532;10000;2271;26696;391191;64754;81466;127059;127062;10806;401992;343171;254879;116228;257044;9859;81470;148823;64216;403239;401994;391192;51097,80,1.01939656820145000000
chr15,23669311,28495157,4825846,1,1,2562;7681;23742;8924;7337;6638;2567;4948;8926;57194;283685;54551;4692;2558,14,0.29010457441037300000
chr16,15496393,18306854,2810461,1,1,4629;123811;64131;89927;4363;54820;408050;255027;101059938;368;9665,11,0.39139486368962200000
chr15,54827066,55676446,849380,1,1,9236;51187;101928527;440279;9488;5873,6,0.70639760766676900000
chr8,36789591,43646413,6856822,1,1,6867;203102;10947;27257;389649;3620;1978;84513;6422;84376;56892;9530;55290;2260;169355;137964;157848;1142;6770;155;9070;6575;137994;59339;203100;27121;55145;81790;7419;84197;138050;8754;114926;83877;25960;11212;80139;23259;8973;3551;2339;2515;7994;51125;79698;5423;84296;157855;340441;137362;8749;11160;80223;286;5327;54904,56,0.81670488164925400000
chr1,146496425,147814497,1318072,1,1,9557;51205;51463;5565;607;2702;2330;200030;2703,9,0.68281550628493700000
chr6,161722224,162492316,770092,1,1,5071,1,0.12985461477330000000
chrX,32472659,32663243,190584,1,1,1756,1,0.52470301809176000000
chr2,221313309,223390722,2077413,1,1,130367;151278;5077;2043,4,0.19254717285392900000
chr13,19703703,39597278,19893575,1,1,51569;51084;3146;2322;8900;241;646799;387496;122042;6541;10804;26960;9107;55578;29880;51082;4081;2254;387914;2706;51761;5412;6049;221154;9818;675;90634;11340;26524;23111;9201;8100;219333;253832;10631;93492;10284;4285;728591;5983;55504;122011;56163;64328;7223;90627;222484;341640;5994;221143;283537;542767;51371;54737;6445;221178;100526761;78988;10208;53342;219409;219402;84935;10443;161003;84056;23047;10129;221150;479;2700;400120;219287;4093;387911;3651;145173;1045;255967;55835;143;338872;55269;7278;1024;26278;2835;10810;80209;7750;646625;9205;23281;10808;5042;122046;2321;6144;9365;2971;54937,101,0.50770160717719200000
chr1,146571304,147381411,810107,1,1,9557;607;2702;2330;51205;2703;5565,7,0.86408338651560900000
chr12,38805636,44949234,6143598,1,1,85437;114134;144402;80070;5756;55605;120892;144165;4753;84216;51535;10138;225;283463;29951;51135;283464;1272;283461;83448,20,0.32554213345339300000
chr17,78589583,81029941,2440358,1,1,339231;26502;147111;83882;79058;6904;2194;80233;339230;2642;284184;57521;9146;51181;10966;57597;6182;79643;100130370;79415;5831;5148;116729;4097;284001;5833;3607;9123;56270;924;71;64118;284004;25794;51547;1468;400629;5881;5034;124565;146712;201254;5986;10458;79755;339229;22994;2873;284186;396;201255;256933;51529;1453;55666;348262;79701;64122;6398;255275;79672;146705;2837;9625;10189,65,2.66354362761529000000
chr15,83196738,84812671,1615933,1,1,8120;646;6457;64506;123720;50810;123722;83640;9455;123207;53339;57188;53346,13,0.80448879996881100000
chr22,20671459,21440515,769056,1,1,80764;9342;3053;91179;8216;7625;400891;1399;6545;150209;51586;9127;84861;5297,14,1.82041359796946000000
chr2,85824180,86469217,645037,1,1,129303;388969;51255;25885;8869;10989;10713;10578;84913;55037;6439;65055;51318,13,2.01538826454917000000
chr16,15251767,18779974,3528207,1,1,4629;100288332;123811;64131;89927;4363;283820;54820;408050;101059953;255027;101059938;368;9665,14,0.39680211506864500000
chr12,1630579,2064591,434012,1,1,144699;654429;93589;81029;196513;79602,6,1.38245025483166000000
chr10,81670940,88947473,7276533,1,1,657;27069;84332;23063;54537;81619;5995;387694;79812;2746;119385;80195;10718;643161;26103;4143;387695;219348;6623;143241;92211;6441;54462;94233;2894;84293;340745;10974;11155;311,30,0.41228425680196900000
chr7,114215737,114323256,107519,1,1,93986,1,0.93006817399715400000
chr1,9514846,12157740,2642894,1,1,10277;100526739;56998;84275;199953;57540;374946;1325;93611;22883;4878;10747;5226;1676;378708;10459;26232;26270;57085;4879;9927;943;148345;60672;5195;54897;284498;64802;116362;5351;1185;84328;6723;23095;2475;90231;10218;23435;29914;4524;5293;5394,42,1.58916702675173000000
chrX,154120620,154565718,445098,1,1,7411;1193;2157;79184;100272147;116442;65991;4515,8,1.79735698655128000000
chr1,198652996,203347714,4694718,1,1,2331;23046;7139;1118;10440;134;5317;1465;4660;5877;1999;23528;83479;1116;127833;149345;647219;59349;29089;4608;3898;6051;779;252839;23612;51706;9928;55765;7135;127829;51094;8497;92703;2848;91156;7832;25802;4656;5778;5788;9283;2494;59352;10765;55705;89796;23271,47,1.00112509420161000000
chr3,290737,726704,435967,1,1,10752,1,0.22937515912901700000
chr22,23696302,24997023,1300721,1,1,4320;3543;7621;2952;66035;388886;391322;400916;150248;266747;51733;2678;653689;4282;83606;23384;135;51233;6598;1652;29802;56241;100037417;2687;23523;6634;91319,27,2.07577182193568000000
chr20,4206678,7064094,2857416,1,1,9962;149840;8760;51605;164312;128674;9770;55612;1114;84515;5621;5111;23627;650;29058;54675;56261;146,18,0.62993977775724600000
chr1,146096700,147844778,1748078,1,1,9557;51205;51463;2703;5565;607;2702;2330;200030;149013,10,0.57205685329830800000
chr5,177414498,180715096,3300598,1,1,2916;117608;2324;285679;30832;91522;134083;51149;345462;10917;153579;23138;23061;3182;9509;9945;3187;84851;646019;80108;57472;64777;643836;9794;79908;285659;90933;255426;26693;6940;11282;10399;821;85007;55819;4245;5626;285676;55651;4056;57396;8878;5601;92304;81786;80230,46,1.39368684099063000000
chr5,160584916,169338386,8753470,1,1,900;79646;2566;2554;2559;6586;5917;23286;100131897;1794;27430;54908;2561;134492;3161;57451,16,0.18278465568511700000
chr7,140012638,143545719,3533081,1,1,373156;2041;1180;90956;100507421;136541;340307;5304;136242;135927;259285;8972;7791;100507507;93432;494551;23601;4708;5644;56302;401409;55750;84255;6742;55503;23608;285966;259286;135924;27147;50831;130075;3792;57189;346517;51650;441294;9715;259287;135932;338398;2051;5726;835;100463482;50832;54429;673,48,1.35858758969862000000
chr7,139736834,140010108,273274,1,1,80853;64761,2,0.73186618558662700000
chr22,20754422,21440514,686092,1,1,80764;9342;91179;8216;7625;400891;1399;84861;6545;150209;5297;51586;9127;3053,14,2.04054266774718000000
chr8,74860448,82978768,8118320,1,1,347051;51101;54332;54968;23462;23643;3612;619279;79752;64089;5375;51050;55824;2167;646480;3574;6921;5569;11075;7163;3174;92421;83690;2171;79776;56704;65986;28957;646486;5828,30,0.36953458350988900000
chr2,96779631,98021592,1241961,1,1,81562;51239;56910;55683;23397;10865;54910;9391;26504;93082;51252;90342;151;151313;1844;26505;200539;375248;23020;150771;431705;55654,22,1.77139217737111000000
chr15,22925956,23179948,253992,1,1,123606;23191;81614,3,1.18113956345082000000
chr16,15492317,16249607,757290,1,1,4629;123811;89927;4363;54820;255027;368;9665,8,1.05639847350421000000
chr15,18946233,26829529,7883296,1,1,2562;7681;727832;100996331;123606;57194;283694;81614;100287399;390538;114791;23742;7337;6638;8926;283685;54551;4692;23191;283767,20,0.25370099004274400000
chrX,53392891,53790726,397835,1,1,10075;158787;8243;3028,4,1.00544195457916000000
chr7,71769113,71970656,201543,1,1,83698,1,0.49617203276720100000
chr7,122399131,122505782,106651,1,1,93664,1,0.93763771553947000000
chr7,134590557,136845543,2254986,1,1,800;389558;136319;767558;26266;4850;346673;78996;29062;55281;647087;1129;23165;340351,14,0.62084642654100700000
chr17,1176410,1393978,217568,1,1,1398;286753;7531;4641,4,1.83850566259744000000
chr21,34991676,36599680,1608004,1,1,9992;6526;9946;861;54102;101928147;3753;54065;539;1827;6453;64968,12,0.74626680033134300000
chr19,45764048,46689083,925035,1,1,6633;4858;147920;8189;80207;729440;2828;147700;444882;57787;1762;388553;1760;26145;2354;81492;2068;8993;10848;6253;54814;147699;2067;2696;10849;339344;1158;7408;147912;24139;3171;339345;388555;23403,34,3.67553660131779000000
chr2,17049,9484638,9467589,1,1,7837;23040;51112;9781;57498;129642;54221;26751;285016;6664;7260;78989;55821;55256;6201;642273;8853;129607;728597;7173;3398;246243;129787;91543;52,25,0.26405877990690100000
chr16,29652999,30198553,545554,1,1,653808;5531;26470;283897;253980;146378;8479;83719;23475;283899;124446;9344;3835;4150;226;253982;83723;5595;6911;11151;8448;79447;112476;9961;10423;6693;79153,27,4.94909761453495000000
chrX,15379039,22033959,6654920,1,1,660;10742;2925;8544;55787;4810;404281;795;10389;5160;6247;11238;645864;5931;1964;10149;30011;22866;5475;6322;57393;257240;9185;8233;94056;6792;56474;6197;139105;5256;256643;23676;6611;8905;2277;256714;51360;59272;389840,39,0.58603258942256300000
chr4,1806405,13343411,11537006,1,1,728373;257236;7469;401115;79155;644414;728393;133060;728419;55646;6286;53407;166793;114932;55351;2121;9948;79441;100287513;7468;285489;3166;84448;1816;353497;152789;100287205;9778;8532;57537;100287404;728379;27065;116449;402160;728386;4487;6047;6002;54360;728405;27201;7466;10227;57533;9957;152992;93621;93624;345222;56606;2261;4043;8602;100287441;57732;132884;3064;3083;100287238;768239;100287364;85013;728400;100287327;100287478;118;1400;3954;152;100288520;60312;85460;94031;23324;55330;728369;100287178;339983;6452;5522;10608;100287144;8310;80273;2868;54436;389199;8603,89,0.77143064673798400000
chr12,244335,8226547,7982212,1,1,4704;144195;55846;10436;2784;51279;57101;6337;1822;171017;9332;654429;83461;928;5927;920;57121;79923;55080;55810;10233;715;283358;894;1108;5763;81029;2251;83695;775;84318;3736;50813;55200;170482;10867;3902;9918;7450;5777;196513;4908;27239;83758;9573;57097;3741;7167;7132;11331;283316;341392;5893;2288;51147;84519;84727;6540;84766;2597;7289;83714;93589;5830;939;57102;8798;10566;10635;6843;8078;8079;26290;113246;7004;440073;6539;56341;10536;4055;4839;359787;196500;6515;719;2305;4815;716;51258;9746;144699;10162;360030;8074;25900;65125;339;23085;3742;57103;79602;2026,102,1.27784128008627000000
chrX,149386685,149750457,363772,1,1,10046;4534,2,0.54979492649241800000
chr6,45390329,45459852,69523,1,1,860,1,1.43837291256131000000
chr10,81665871,88942232,7276361,1,1,657;27069;84332;23063;54537;81619;5995;387694;79812;2746;119385;80195;10718;643161;26103;4143;387695;219348;6623;143241;92211;6441;54462;94233;2894;84293;340745;10974;11155;311,30,0.41229400245534800000
chr17,16705818,18747176,2041358,1,1,2314;125170;55090;79018;10400;54890;254272;8533;729288;23164;83450;51168;80039;51655;201163;7156;51030;10517;654346;10743;140775;6470;146691;1819;6720;23495;147166;91647;56953;645027;3996;201164,32,1.56758393187280000000
chr6,123527352,124324556,797204,1,1,154215;10345,2,0.25087681446656100000
chr6,73037504,80896703,7859199,1,1,594;1347;134728;135228;6785;1303;25821;167691;55754;340168;83699;55510;101928601;55023;9324;115004;4646;154288;7272;100129128;80759;27145;3617;441161;26054;26503;1915;56479;22999;3351,30,0.38171828961195700000
chr6,84252330,97078182,12825852,1,1,84694;57226;55122;22881;3354;135293;57150;60468;134701;4907;10492;2570;2569;58528;154313;51167;9096;1268;10690;22832;23376;206412;23036;1081;9457;51465;9994;10957;81833;57231;57038;135295;2045;8732;79694;112609;23595;9892;10559;23195;6885;375519,42,0.32746362580825000000
chr8,128707459,146304022,17596563,1,1,65263;1584;340371;84948;137835;11156;93100;225689;203054;84988;22898;111188157;8694;8581;27161;286077;51059;2907;642658;50626;23237;2765;9684;55630;114822;642475;340390;6132;26233;338328;23639;90990;2875;57210;203062;1936;6482;80728;51337;23144;286075;23513;83482;137797;340393;51236;9401;28991;2843;22827;7038;83696;575;389690;2738;6503;7553;7564;5339;414919;375686;90987;3786;51160;4062;10656;65265;56169;389692;10086;81858;5747;26873;727957;84232;79581;1585;4609;57152;58500;340385;8000;8928;729330;83481;4796;116447;51105;84875;29894;4061;54108;57623;50807;8629;79943;23246;1537;113655;100130274;105375787;8840;51571;66004;79792;286128;441381;114;80778;8733;432355;10397;169044;9831;7264;54512;23167;51305;3297;54742,120,0.68195135606879600000
chr8,487644,18600102,18112458,1,1,377630;1508;83650;504180;503841;10407;286097;245910;245908;503618;54984;157695;100289462;4482;203074;9228;245909;90459;9920;1672;26281;137492;9172;51201;503614;83595;57509;653423;645402;2626;100131980;613210;23362;1673;79648;1670;66036;285;157773;8658;9258;2267;414325;137868;645836;4481;2055;389610;401447;392197;728358;1669;245940;203076;427;83648;55894;1667;613209;157285;10;252969;100132396;392188;5157;613211;1668;5108;140596;100133267;10395;100133251;85002;91694;9108;137075;157697;57604;64478;728957;9639;100131608;1671;640;286046;79660;2222;29883;6542;653333;7991;55326;94137;9,94,0.51897980936657000000
chr2,42442212,52127745,9685533,1,1,9167;80204;27436;4436;678;9581;64241;728819;9655;90411;79823;170850;57504;11037;388946;2034;165140;9419;129285;2492;63892;23433;5495;5281;10128;11036;286749;51626;6496;2956;4072;57217;805;285051;23498;64240;3973;130271;9378;6519;10736;90423;56660;55133;3344;5581,46,0.47493514296012400000
chrX,41509726,41527913,18187,1,1,8573,1,5.49843294661022000000
chrX,10490989,10491339,350,1,1,4281,1,285.71428571428600000000
chr17,2192853,2706401,513548,1,1,4335;23277;55720;23293;63826;79066;9905;23108;5048,9,1.75251388380443000000
chr17,75012045,76507774,1495729,1,1,283999;9489;10801;125061;11322;6397;57690;7083;8632;9021;100141515;332;9144;147138,14,0.93599843287119500000
chr8,161472,146294098,146132626,1,1,377630;1508;1584;55806;51366;9166;137835;11156;767;137872;157724;137886;9070;4067;100289462;59339;4747;11059;862;6132;1135;79776;26233;10565;56704;65986;1936;51101;6101;23144;6591;116328;57509;79645;528;96764;81796;2515;613210;51125;22827;79698;7038;2738;10404;28998;157855;340441;79977;375686;389677;5462;23484;80005;6867;91147;65265;427;1191;55756;56892;79139;55872;4609;9420;54212;81551;157285;4986;138050;8629;84549;25960;64236;85002;51435;91694;137970;340359;137075;157697;4017;3646;9639;57094;5423;169270;169044;8793;4856;100130742;661;2039;7991;5168;5150;79845;29942;340371;203111;4715;23643;3620;761;203054;84988;55039;79848;8694;9530;392255;23414;81034;23221;157695;55790;5516;9920;85479;115111;51201;11212;80139;157657;26166;83482;83595;55284;286144;93594;653423;84675;619279;64089;5375;1673;2167;575;7553;7564;5324;23471;100130301;55656;54928;56169;245940;10499;649;2669;84232;10361;79752;8928;729330;4796;759;4061;29088;5569;10687;203100;7419;157769;79943;6674;79792;441381;526;80778;640;5862;432355;7264;8822;54714;56943;90362;203102;115908;116039;79870;84513;93100;26260;54793;389643;619373;245910;51669;9684;29967;4482;203074;114822;2137;55246;157777;27012;7994;28991;56154;79075;8836;79648;1670;50484;64168;645836;54968;92140;63898;81858;793;1585;85481;613209;646480;252969;389676;5157;23212;10987;94241;29028;148;23246;114926;5828;27085;5108;56260;100133267;10395;51571;286128;1052;64478;286046;79660;2222;29883;3174;55174;51001;28957;137392;54742;389649;9699;9796;90390;111188157;286077;203069;2675;137682;50626;286151;157680;54984;6575;389668;7163;9242;90459;23639;26281;8795;83877;137902;2831;11236;2339;23213;8797;23362;4824;8323;6503;8794;157773;11075;5885;84933;2171;63978;4603;79145;55909;80346;728358;389658;286133;727957;4325;100861412;91782;58500;55290;169355;10;401474;23514;7201;6921;157753;613211;55140;10221;9694;26986;3037;6713;113655;4147;79873;137814;55893;157378;66004;203190;100507341;114786;57604;8733;6917;54512;653333;94137;9791;51633;3297;64760;116447;83650;114569;504180;4683;84948;225689;286053;25879;286097;169200;492307;51059;2907;10434;23237;10671;245908;7976;25897;55093;642475;8754;1672;2875;3788;203062;83988;6482;4982;80728;51337;286075;2626;9650;9401;6156;55824;389690;286;8658;2267;414325;137868;90987;4481;11178;646486;138046;1669;203076;83648;23678;79618;57152;100533106;2260;340385;2961;51105;29894;100132396;6770;441376;64798;55636;1581;55529;100130274;105375787;140596;3551;6440;2936;2185;9108;1846;168975;79815;728957;100131608;10940;10584;6383;80243;85453;137735;9;65263;10947;157869;253943;3612;7486;55074;114907;157506;157848;642658;79666;100533105;157310;9312;55145;137994;340419;85444;137209;100127983;8895;57210;137492;23087;9172;503614;1807;4173;8439;286183;137797;23513;9788;51236;22882;8749;11160;414919;6129;2131;195814;10656;392197;138009;5591;389692;84955;9583;5747;23462;26873;6422;55894;80185;78986;27299;286148;10247;4741;64321;169166;50807;9046;1537;23039;25788;8840;245972;114;157638;157807;1671;9831;5327;51312;10407;2053;27257;8601;7381;8756;6788;7373;8767;8581;9705;2765;503618;155;27121;84197;9228;1960;6570;5179;340390;90990;654463;5533;137695;54704;541565;11244;645402;84294;2843;51050;83696;734;7227;51606;11030;9258;27067;4062;6224;2055;1875;389610;7071;25962;55638;6873;51123;7336;79581;1667;8000;83481;137964;114788;2138;84875;1142;312;54108;392188;64641;23516;92421;9134;1345;100132813;6781;5368;80124;9897;100133251;401466;4023;157567;1666;1015;84750;444;7013;157313;3786;54332;7993;503841;84985;1978;157574;54845;22898;100129654;7274;27161;55630;81790;245909;83690;338328;5520;10174;169026;55156;100131980;286187;340393;8667;55353;55124;66036;51582;3574;285;84296;5339;254778;51160;51110;4956;401447;115294;10086;84376;6386;93035;4342;57805;2796;5440;1392;10863;157570;57623;665;81501;6641;9821;1668;284;347051;83940;23259;8973;51115;23303;760;3084;10397;137362;80223;377677;6542;27319;23167;51305;55326;9760;1808;7534;54904;8989,659,0.45096021199263200000
chr22,18919942,21440514,2520572,1,1,54487;27037;9342;29801;65078;10587;1312;6545;421;7290;2812;6899;5625;7625;79680;64976;6576;3053;8218;5413;80764;23617;400891;1399;7122;150209;128977;8220;388849;84861;7353;51586;2928;128989;5297;9127;9993;54584;91179;85376;8216;85359;8318;728229;5902,45,1.78530904889842000000
chr5,58056339,68826968,10770629,1,1,57688;80006;115827;891;92259;285672;5295;11174;64924;100132916;3350;5144;285668;23398;285671;64946;153562;102157402;27292;55789;51194;401190;54557;79993;4064;57486;202243;140890;373;91942;64105;6880;1022;100130733;1161;10283;3796;55914;100506658;643155;5884;375449,42,0.38994937064492700000
chr9,204193,489842,285649,1,1,81704;23189;157983,3,1.05023997983539000000
chr22,16133474,18651673,2518199,1,1,27440;51816;51807;23765;150160;27439;27443;55670;637;529;23784;11274;150165;23786;81061;83733;128954;101929372;57553,19,0.75450748729548400000
chr8,12556004,20951879,8395875,1,1,5108;51201;26281;63898;10395;57509;427;286097;526;4481;91694;9108;23362;4023;57604;10;157773;5157;29883;6542;2267;55790;137868;6570;55174;7991;9;137492;11178,29,0.34540771509818800000
chr16,24296627,24996058,699431,1,1,55114;27327;5930;115584;10368,5,0.71486679886936700000
chr9,139665148,141018984,1353836,1,1,29952;54863;54461;774;84960;954;10811;25920;375775;9022;286257;733;8636;8721;441478;29085;389816;377841;26012;79813;56654;55684;89958;7186;286262;20;2902;27158;92715;158056;10383;2529;441476;643596;401562;29882;401565;11253;94107;116225;91373;401563;727800;142680;100505993;92714;389813;375791;54932;5730;286256;85014;64975,53,3.91480208828839000000
chr1,27001256,27190935,189679,1,1,55650;2810;84243;8289,4,2.10882596386527000000
chr8,1765533,6939296,5173763,1,1,389610;64478;9172;9639;1671;79648;1670;285;728358;1669;55326;9920;1672;1667;1668,15,0.28992437419340600000
chr2,21634412,40805194,19170782,1,1,388939;114818;79833;9637;375190;6716;54454;339778;3777;64225;729967;200634;9577;9784;92749;11321;3797;3032;253635;1058;6801;339779;8890;22950;51374;8491;22924;6546;30845;100271715;7349;8884;64838;51639;9913;1788;151393;23160;58484;1545;109;253558;54978;80304;5212;150921;790;85465;2976;84226;10890;10602;51232;54497;2646;55622;6432;165082;5443;84450;238;57448;100505876;4052;440854;1838;51646;165324;344387;55471;2281;11117;130106;57159;54867;90957;84661;50618;5500;5610;7781;165186;9553;151056;55676;55252;79635;56896;84696;22979;130589;130557;6683;4358;25940;3795;391365;391356;26160;10153;92906;6654;23683;375189;92291;80745;150946;100128731;79745;5496;9540;10669;245711;79623;51072;29959;2355;388931;25797;84272;653140;81606;8648;79172;130733;64080;60509;285126;25780;7498;9381;51277;55006;10113;3030,135,0.70419662588620500000
chr1,852863,5578149,4725286,1,1,57470;388588;85452;1677;83858;5590;127262;728661;199990;9636;100287898;8510;64856;26155;140625;55229;8764;65220;339456;375790;388581;148398;401934;643965;51150;8784;2782;9651;1855;9731;27237;57801;126789;81669;29101;339453;6497;643988;7161;126792;219293;163688;84808;388585;63976;6339;55052;254173;80772;11079;79258;984;54587;5192;54973;84069;339448;54998;9906;148870;116983;339451;55966;7293;118424;728642;2563;127281;55210;54991;83756;142678;441869;1953;79906;49856,76,1.60836825538179000000
chr16,3536906,4634069,1097163,1,1,342346;57407;51025;10131;115;114990;84464;29965;1387;100529144;1773;3163;6345;197358;84662;7023;23059;646174;9093;79585;79903,21,1.91402735965394000000
chr11,18690219,33211190,14520971,1,1,79832;54503;10553;283284;258010;341019;159963;5080;143662;196074;627;120534;91057;100500938;117194;10196;91614;84867;3739;79733;2620;2488;1479;5954;9152;744;55346;144110;493860;7490;57084;120237;4745;338645;203859;63982;196294;2188;81930;8048;26610;79056;55327;89797;387758;55366;259249;120526;8424;10480,50,0.34432959063137000000
chr2,165798270,166304847,506577,1,1,6326;6328;151258,3,0.59221006875558900000
chr11,66046441,75415180,9368739,1,1,5031;2017;83759;9986;81544;266743;3636;23201;5091;2950;254263;871;57571;246330;9973;5883;245911;100526737;10809;440050;5870;338692;55191;595;10072;5936;9049;9965;2248;283212;57830;55107;6188;6199;1119;219931;116512;91703;51111;79703;51642;10312;5790;3508;2348;1717;387787;143570;374403;390212;4723;9600;4041;219927;57010;5499;3177;10897;254439;51083;2350;5138;55291;84957;254359;401;387273;100131539;408;283209;4728;254552;7351;116535;1374;3846;10825;26005;26579;222;53838;100507050;10263;11309;57124;78999;81622;58473;51400;4926;100129216;10008;256472;9633;55298;91683;9828;7352;55199;51475;9610;8722;8500;9789;55231;341152;374407;29984;80227;582;80194;11041;102724265;10432;55004;25906;221;440051;22941;25884;22992;347853;23529;8772;65003;2352;89849;9873;81570;10714;5029;51287;220074;116985;57175;254225;25855;156;54961;10068;283208;89;6712;220064;57804;4135;100287896;2249,148,1.57972166798541000000
chr2,201726125,212683848,10957723,1,1,1493;130749;54891;57683;3417;51602;10314;130540;53938;57404;65065;389072;57679;8828;4709;151050;79800;151195;8324;200576;2066;2825;117583;66008;1373;1419;1933;8609;55437;659;29851;1385;200726;6120;940;843;8837;285172;391475;60491;151194;55759;4719;1421;130026;4632;100652824;58538;1195;65062;65061;389073;33;150864;65059;151254;1418;285175;10152;130752;841;7855;5746;4133;8745;7341;22868;4999;1420,69,0.62969286593574200000
chr16,29673954,30131105,457151,1,1,653808;5531;26470;283897;253980;146378;8479;83719;23475;283899;124446;9344;3835;4150;226;253982;83723;5595;6911;8448;79447;112476;9961;10423;6693;79153,26,5.68739869321078000000
chr16,29673954,30197341,523387,1,1,653808;5531;26470;283897;253980;146378;8479;83719;23475;283899;124446;9344;3835;4150;226;253982;83723;5595;6911;11151;8448;79447;112476;9961;10423;6693;79153,27,5.15870665492265000000
chr17,80480969,81029941,548972,1,1,64122;6904;3607;10966;79672;56270;146712;79755,8,1.45726922320264000000
chr16,7126757,31928113,24801356,1,1,4682;100862671;146547;23049;343;642799;642778;6340;146279;23247;83719;26000;51704;7385;283953;146177;29108;10847;101059938;368;124454;23274;730094;64131;79874;11151;283820;146395;79447;728734;408050;83985;339105;78994;7041;55718;10368;79091;51451;50615;64319;9726;6799;8663;27040;146378;162073;5073;124446;1731;8651;728888;2813;57146;10261;2521;18;5595;2072;1339;4363;55623;112479;57149;29904;58531;9956;9951;728741;1039;23589;9738;388228;124411;257629;79831;10421;29066;55567;22928;23117;730183;283899;548593;7142;197370;445329;728689;25970;226;9516;80063;51760;63928;493829;100132247;115584;5620;79798;112869;9961;54820;9810;27327;255027;107282092;79077;1201;348158;5531;116028;7284;729993;9344;81691;3835;51061;25880;9274;54715;10595;65988;55911;55313;440345;8448;89927;84516;101059953;57478;91949;2975;6817;54700;342357;204474;57020;654483;162083;552900;6296;116285;146183;487;23475;79728;10229;3681;56061;613037;79724;83723;6810;123876;400506;6338;6911;4261;5579;197407;2013;93129;9739;54620;653808;55114;146542;100288332;51573;253980;8399;123879;8479;3687;5619;5261;2935;23204;23361;10308;3683;57496;123811;728276;930;8303;84901;84148;79001;283933;10423;54988;29895;6693;4706;23214;5373;5930;283897;29035;2903;608;112755;26471;51283;7369;23042;1489;92017;90835;253982;9665;51333;124274;1428;11273;112476;23420;79759;10295;79838;6210;115509;79153;5652;260434;255762;51327;26470;780776;80270;4150;79905;246778;3684;51108;23062;123803;100507607;7783;28955;4629;146540;3566;6524;26156;79008;6818;92595;9284;7874;5347;124152;64755,254,1.02413755118873000000
chr22,36683246,36981923,298677,1,1,10369;25828;4627;8664;80020,5,1.67404922374337000000
chr22,21926261,22916612,990351,1,1,129025;7332;29799;23753;140883;23759;150223;9647;5594;164592;7441;8940;23532,13,1.31266591339838000000
chr9,1,69053560,69053559,1,1,58524;10171;55664;23586;92014;3439;100129669;51754;100287171;79269;10210;2189;6461;79937;25853;7094;54796;158326;55064;4712;84688;2315;6366;5991;6456;51510;1211;26953;3717;10488;2592;3444;55833;971;157983;3641;7306;23349;25822;158219;286319;79956;55958;3443;64922;2731;253650;1271;10280;79886;27240;100129969;7415;84720;56656;10020;27290;7016;5646;26165;4300;9350;54914;340485;6363;10850;730112;2298;26267;11258;3442;881;81704;3452;158038;7169;347252;6019;347240;169792;6505;26149;203259;138715;54801;10497;4781;3447;727830;728577;441430;8777;51271;158234;7436;90871;3448;3590;25769;338376;646962;573;647060;360;3456;55848;768;152006;10655;80380;27019;30968;2683;54926;203260;23081;50808;57462;56832;389730;259308;5079;158358;401494;392309;401505;203238;54586;23189;730098;9853;5789;3301;54840;80256;286343;55667;1993;29126;340481;3441;90865;123;63951;138716;3449;55234;403313;169522;1030;9373;6595;3467;65083;441459;219;92949;3445;1029;84210;4882;10670;4799;89882;8434;4507;364;9380;375704;203228;84904;727905;9925;6619;26206;7010;51010;441425;9827;158297;3440;6194;3446;64425;1761;100129385;11168;392307;3451;54875;57704;9833;6013;138724;138474;57589;80173;48;55871;115426;158376;84186;79817;9933;692094;84681;11172;152007;22844;318;401498,211,0.30555992052487800000
chr12,1,38453221,38453220,1,1,4704;83857;144195;25977;2842;6337;65981;1822;4040;259295;10060;121512;144568;51026;10233;6660;1108;50865;55500;2998;10599;26127;3736;8302;259294;23012;50813;10867;22914;55359;23710;121504;5545;57097;5149;1911;441631;55907;2984;3375;10219;4257;83445;397;51071;79785;79365;51768;8078;55729;26290;387849;196500;55766;160364;93661;2305;50838;8496;728858;3823;80824;55259;89869;60488;5800;1389;121536;51067;57542;160492;79887;928;144608;5318;3822;55810;283358;2;1027;586;5288;2251;55200;440093;9976;196513;5858;160365;27239;50836;93978;64581;83758;9573;9847;338339;7167;7132;11331;341392;653247;341346;2288;51147;84519;84727;84766;2597;7289;51290;56938;83714;51729;9412;10635;6843;8079;81575;6539;440073;10536;4055;359787;6489;6515;55138;118426;420;11171;8074;55297;29121;3742;51267;57103;2026;387836;51202;51266;11228;2784;3709;51279;57101;3821;2120;5965;171017;50856;5927;920;636;144363;57121;55080;26253;715;894;259296;645177;81029;100431172;84318;55507;3845;259292;3902;85004;6579;5777;196394;4908;55726;53919;4973;283316;55196;5544;28234;100129361;57102;10566;3764;113246;7004;54477;1663;341359;55110;4033;4815;51258;106707243;55885;160518;10162;360030;51348;8076;79602;5554;10526;283420;55846;10436;2059;79912;9332;654429;83461;58516;2012;120939;84920;259289;57379;4074;79923;57613;5763;83695;387837;254013;775;2904;729025;55711;259290;100528032;440087;3820;170482;100287284;259293;9918;7450;57494;196415;8082;9052;3741;80763;338821;5893;5555;79370;6540;54682;93589;5830;939;8798;3824;50835;8531;353164;4256;121506;50839;56341;4839;10059;50837;719;716;341350;50840;9746;144699;11272;5542;25900;65125;969;3945;5744;440077;339;23085;5139,281,0.73075804835069700000
chr15,23699701,28525460,4825759,1,1,2562;7681;23742;8924;7337;6638;2567;4948;8926;57194;54551;4692;2558,13,0.26938767559673000000
chr15,22770421,32439281,9668860,1,1,321;7681;123606;23359;6638;22909;8926;161725;283710;283685;653720;89839;4692;54893;23191;728498;2562;101059918;4948;57194;81614;4308;2558;1139;7082;8924;114791;23742;51621;7337;89832;653073;2567;54551;56160,35,0.36198683195330200000
chr17,4800533,10127737,5327204,1,1,84622;6517;201243;284114;51087;26001;3000;5198;22861;2027;433;643664;10749;6844;57659;5216;23125;728392;6154;37;407977;8402;4927;2256;23302;8711;201232;57555;2811;9526;23399;80169;54739;1366;9851;146849;146852;9423;8742;54785;5187;23746;124637;6665;55135;482;59344;9212;7775;23135;146850;58485;79003;440400;432;1949;388325;162517;239;1742;9098;1140;1107;57048;147040;7157;968;84461;201140;51009;81565;4628;644070;708;388333;23533;643904;388327;124961;9552;9513;9135;26168;374768;51003;1984;1973;9340;5957;388324;124944;22899;10462;84314;55065;284111;83394;162515;6462;84316;124751;23587;124739;399512;5430;9744;146754;92162;84817;1856;100130311;100996842;254863;8522;339168;83659;146845;116840;84268;79142;112483;162387;1145;54478;247;84667;8741;29098;9482;56919;50488;255877;2874;9196;11337;242,136,2.55293395935279000000
chrX,19563240,20597641,1034401,1,1,30011;256714;6197;1964;256643,5,0.48337153579704600000
chr22,25130310,41082043,15951733,1,1,23481;10126;200315;1413;3005;24144;129049;7533;91582;23616;4733;2130;23541;114904;7078;4357;402055;6948;80831;51537;25776;27352;3985;11144;29775;730005;200312;158;57168;550631;23598;646851;25807;8542;6527;3976;8563;4744;440822;129080;150350;6523;57026;9402;113828;5155;6525;140606;4627;23543;79159;23492;6753;3957;8897;23764;80832;1439;51493;150280;54471;9681;55954;85377;23539;10521;23331;80830;23762;150290;164656;25793;4689;9929;25829;27350;255349;8224;80020;4174;162;29796;3956;253143;3761;11200;8398;8508;11015;7494;10738;4151;164633;10369;5816;10633;9215;5880;80115;23761;23544;85379;284898;150274;9145;27128;80833;1417;150275;23780;468;10739;129138;8459;157;83999;4242;8484;23464;91464;50487;56993;1415;164668;105372977;22880;23467;84164;102800317;114794;11135;9463;10043;113791;79734;11078;3560;8664;5008;27124;1414;10042;89781;5988;25775;4330;23466;2847;51386;4248;9567;1454;652968;91445;254240;284904;7263;26088;60489;84645;150297;6663;91355;140564;8911;23760;3162;10454;25770;200316;339665;339669;266629;11020;10634;84700;9514;56478;25828;4771;84133;83874;6122;9814;57591;23551;10291;9582;23112;5435;25777,191,1.19736206718104000000
chr8,311987,4678837,4366850,1,1,64478;9172;9639;157695;26260;9228;9920;157697;2055,9,0.20609821725042100000
chr15,22765628,23300287,534659,1,1,123606;23191;114791;81614,4,0.74814040350952700000
chr8,6084826,6304250,219424,1,1,79648,1,0.45573866122210900000
chr7,89314811,89882647,567836,1,1,79846;26872;261729,3,0.52832155763283800000
chr22,50807316,50976504,169188,1,1,6305;1890;9701;9997;29781;55586;91289;79924;440836,9,5.31952620753245000000
chr18,13871404,13935908,64504,1,1,4158,1,1.55029145479350000000
chr14,59523273,59734511,211238,1,1,23002,1,0.47339967240742700000
chr5,11903988,12350682,446694,1,1,1501,1,0.22386689769730500000
chr17,77210835,77800856,590021,1,1,84733;57332;146713;339221,4,0.67794197155694500000
chr10,126476585,126710910,234325,1,1,23172;399818;1488;54764,4,1.70703083324443000000
chr14,20472548,31139579,10667031,1,1,54930;25983;390433;122665;390442;84962;10038;90809;9985;85446;493901;116173;51310;122748;26534;5720;55644;10379;6038;84502;1053;51016;4624;599;57820;122742;55701;4625;23428;100528064;1241;4860;122664;56339;643382;22985;64184;161247;57523;161424;5693;11035;23351;55072;8906;10901;317749;63874;64806;2290;10876;122704;1511;6035;57447;51222;4857;122651;145553;3002;4901;2999;100529063;57680;390443;10278;10202;29082;161253;115817;390439;60686;11198;728635;9878;10548;23256;84659;26277;64403;57096;338879;390437;90668;341799;6036;4323;56948;84932;4738;55017;283;6039;7011;51292;9362;27141;56413;196883;5106;9056;1215;79178;29091;5721;440163;283629;6037;122706;7051;91875;6297;29986;390445;90673;1603;26686;122740;5018;80344;5875;123103;643866;10419;26687;26020;3183;26533;57594;390436;79711;328;8106;55632;5587;4776;55147;100507650;64745,139,1.30308049165696000000
chr12,125178836,133819092,8640256,1,1,6433;5426;57634;57647;7574;144423;2802;7637;22953;7699;92293;5901;114795;647589;7316;9271;23504;8408;80324;140707;121260;23141;192111;100289635;65985;5827;100507055;101060200;10795;121256;283383;55743;949;4326;11211;317781;2054;79050;7556;50614;57666,41,0.47452297709697500000
chr10,102969369,103454514,485145,1,1,27343;8945;6468;10660;25911,5,1.03061971163260000000
chr12,191041,34854486,34663445,1,1,4704;83857;144195;25977;2842;6337;65981;1822;4040;259295;10060;121512;144568;51026;10233;6660;1108;50865;55500;2998;10599;26127;3736;8302;259294;23012;50813;10867;22914;55359;23710;121504;5545;57097;5149;1911;441631;55907;2984;3375;10219;4257;83445;397;51071;79785;79365;51768;8078;55729;26290;387849;196500;55766;160364;93661;2305;50838;8496;728858;3823;80824;55259;89869;60488;5800;1389;121536;51067;57542;160492;79887;928;144608;5318;3822;55810;283358;2;1027;586;5288;2251;55200;440093;9976;196513;5858;160365;27239;50836;93978;64581;83758;9573;9847;338339;7167;7132;11331;341392;653247;341346;2288;51147;84519;84727;84766;2597;7289;51290;56938;83714;51729;9412;10635;6843;8079;81575;6539;440073;10536;4055;359787;6489;6515;55138;118426;420;11171;8074;55297;29121;3742;51267;57103;2026;387836;51202;51266;11228;2784;3709;51279;57101;3821;2120;5965;171017;50856;5927;920;636;144363;57121;55080;26253;715;894;259296;645177;81029;100431172;84318;55507;3845;259292;3902;85004;6579;5777;196394;4908;55726;53919;4973;283316;55196;5544;28234;100129361;57102;10566;3764;113246;7004;54477;1663;341359;55110;4033;4815;51258;106707243;55885;160518;10162;360030;51348;8076;79602;5554;10526;283420;55846;10436;2059;79912;9332;654429;83461;58516;2012;120939;84920;259289;57379;4074;79923;57613;5763;83695;387837;254013;775;2904;729025;55711;259290;100528032;440087;3820;170482;100287284;259293;9918;7450;57494;196415;8082;9052;3741;80763;338821;5893;5555;79370;6540;54682;93589;5830;939;8798;3824;50835;8531;353164;4256;121506;50839;56341;4839;10059;50837;719;716;341350;50840;9746;144699;11272;5542;25900;65125;969;3945;5744;440077;339;23085;5139,281,0.81065225917389300000
chr16,29673954,30197341,523387,1,1,653808;5531;26470;283897;253980;146378;8479;83719;23475;283899;124446;9344;3835;4150;226;253982;83723;5595;6911;11151;8448;79447;112476;9961;10423;6693;79153,27,5.15870665492265000000
chr4,82125731,85015448,2889717,1,1,51138;113510;132660;51023;51316;22872;84142;79966;441027;153020;9987;3184;10855;84803;5593;27235;58478;79725,18,0.62289836686429800000
chr5,172670374,180764200,8093826,1,1,2916;2324;285679;51428;51491;30832;91522;9260;345462;53917;23138;3182;9945;3187;375484;3274;646019;57179;54825;84321;90249;26262;9794;79908;3101;80758;54732;345456;6940;91272;10399;821;55819;2870;285676;4488;1627;10814;285659;2161;253314;117608;6620;202134;6569;134083;51149;10636;153579;10917;23061;27166;285596;1212;9509;23197;51617;84851;57472;80108;10960;643836;64777;51720;1812;90933;8614;133491;255426;11285;26693;23567;54540;2264;11282;79930;80315;192286;285598;85007;4245;5626;92304;5601;94081;4056;8878;55651;57396;83463;81786;64324;80230;114787;22838,95,1.17373415242680000000
chrX,137476878,155226073,17749195,1,1,4110;2157;50814;541578;2158;2556;139067;4104;494119;139728;8517;3423;4168;6901;474383;92002;4105;57595;266740;2332;6845;389895;84968;64663;9142;246100;100272147;728269;100533997;3149;26576;474382;8273;728695;6535;114824;393;23641;1038;55217;8270;537;3421;100132963;6658;4101;215;91966;4100;55879;2010;4534;6134;101928917;116442;100506164;2652;84548;100133053;100129239;2334;203547;139135;139081;60343;728458;8269;10046;728712;5956;2664;79184;4515;158521;4108;2564;8263;1193;492;1260;9130;3054;7411;9947;10134;79057;84631;30014;30848;441525;554;8266;8776;29944;494118;2539;7739;8260;55559;4204;65991;5365;8277;4354;10838;139735;2316;83692;11219;10251;55558;139716;645188;51438;1736;3654;5973;139065;4109;1852;3897;474384;6748;347487;4103;474381;9248;1069;1485;1774;2258;64648;4107;83740;89885;286410;100130086;633,138,0.77750005000226800000
chr22,18876415,21465835,2589420,1,1,54487;27037;9342;29801;65078;10587;1312;6545;8214;7290;421;2812;6899;5625;7625;79680;64976;6576;3053;8218;5413;80764;23617;400891;1399;7122;150209;128977;8220;388849;84861;7353;51586;2928;128989;5297;9127;9993;54584;91179;85376;8216;85359;8318;728229;5902,46,1.77645959326799000000
chr9,131058067,141006466,9948399,1,1,29952;10422;9328;54863;84960;360203;2889;138151;57109;3933;158067;728489;83543;389799;286257;8636;2220;51148;441478;81605;10444;84628;56654;89958;27158;89891;643596;389792;56262;11253;2733;56904;11094;9919;1056;389812;401563;22845;140459;6838;389813;25;6709;157922;51116;6836;54461;51450;8022;83549;6256;6621;375775;10585;9022;27348;84929;84814;8721;8021;8328;56623;84726;7248;9719;9858;2219;256158;29989;138162;138307;29941;375759;20;401562;6837;84895;1384;23203;91373;727800;142680;92714;347148;10807;2021;51759;28989;10555;85014;64975;10868;29991;64794;57171;774;6834;158062;64170;6418;158055;84885;9329;26012;286336;7186;7270;286262;2902;11092;2529;441476;29882;401565;94107;23048;51490;5524;414332;23511;4851;28;26995;389827;100505993;883;4957;169714;54662;286256;157927;59335;169436;10319;57720;7410;954;6835;11091;10811;8939;1621;25920;23064;254295;51117;5900;51162;733;138311;29085;8019;9442;10999;23413;1289;389816;90120;377841;79813;55684;5047;10439;92715;158056;10383;26301;1757;26086;445;11182;57582;56751;1861;116225;23404;11093;392399;402381;6130;375791;54932;5730;642968;9536,185,1.85959569977039000000
chr17,16822683,20193169,3370486,1,1,2314;55244;125170;55090;11216;79018;79999;10400;54890;254272;9706;400581;92521;8533;22905;729288;5598;218;23164;83450;224;51168;80039;51655;201163;7156;51030;5636;644815;10750;4239;10517;654346;10743;388436;27077;140775;6470;146691;1819;6720;125206;23495;147166;7732;146802;91647;56953;645027;3996;201164,51,1.51313490102021000000
chr6,181563,6145170,5963607,1,1,57128;56940;94234;2296;9425;63027;51299;222826;670;5272;10799;3662;10455;404220;648791;389362;10667;2762;1992;2162;4835;8899;8737;2295;56897;55770;340156;7280;347733;221749;26240;135458;5269,33,0.55335638314194700000
chr6,102266317,102931873,665556,1,1,2898,1,0.15025031702816900000
chr1,146324068,147786706,1462638,1,1,9557;51205;51463;2703;5565;607;2702;2330;200030;149013,10,0.68369617089122500000
chr3,1088205,2185275,1097070,1,1,27255;152330,2,0.18230377277657800000
chr15,31588887,32914140,1325253,1,1,161725;9824;51621;643699;653125;728047;1139,7,0.52820103029383800000
chr15,20102541,31292534,11189993,1,1,321;7681;123606;283694;390538;23359;6638;22909;8926;283685;653720;89839;4692;54893;23191;283767;728498;2562;101059918;727832;100996331;4948;57194;81614;100287399;2558;7082;8924;114791;23742;7337;89832;653073;2567;54551;56160,36,0.32171601894657100000
chr12,163593,14501811,14338218,1,1,387836;51202;4704;51266;144195;25977;2784;2842;51267;51279;57101;6337;3821;2120;1822;171017;50856;5927;920;4040;259295;57121;55080;26253;144568;10233;715;894;1108;259296;50865;81029;100431172;84318;3736;8302;259294;55507;259292;50813;10867;3902;5777;22914;55359;4908;23710;5545;57097;4973;283316;1911;5544;10219;83445;100129361;57102;10566;8078;26290;113246;7004;196500;160364;55110;2305;50838;4815;51258;106707243;10162;360030;3823;80824;51348;8076;79602;5554;1389;283420;55846;10436;9332;654429;83461;928;2012;120939;259289;57379;4074;79923;3822;55810;283358;2;1027;57613;5763;2251;83695;387837;775;2904;259290;100528032;3820;55200;170482;259293;9918;7450;9976;196513;5858;160365;27239;57494;50836;93978;64581;83758;9573;338339;9052;3741;7167;7132;11331;341392;653247;5893;2288;51147;5555;84519;84727;6540;84766;2597;79370;7289;54682;83714;93589;5830;939;8798;3824;50835;8531;353164;10635;6843;8079;50839;81575;6539;440073;56341;10536;4055;4839;359787;50837;6515;719;55138;118426;716;50840;9746;144699;11272;5542;8074;25900;65125;969;440077;339;29121;23085;3742;57103;2026,186,1.29723233389254000000
chrY,11529,8875193,8863664,1,1,4267;207063;293;286530;9189;266;6473;90665;83259;1438;90655;3563;6192;28227;64591;438;64109;7544;6736;8227;8225;55344;8623,23,0.25948637042198400000
chr8,176814,404062,227248,1,1,26260;169270,2,0.88009575441808100000
chr20,57649748,62893189,5243441,1,1,3785;198437;2832;10388;85441;116154;140685;79025;6874;6725;84619;63910;128611;55738;60437;51750;284739;54915;11255;63939;80331;57473;24148;10732;284756;1917;128408;26164;54345;6919;10139;9885;11047;1299;11054;1002;1137;140700;10287;100132911;28231;4987;149986;26039;11083;8771;4923;55251;54994;128414;57642;50861;140701;3911;1908;5753;55257;5688;6227;7165;5509;128826;140893;26205;79444;140628;56731;54963;4661;79144;54923;81928,72,1.37314408610681000000
chr3,191107387,198022430,6915043,1,1,131583;622;80235;200933;57110;728262;84239;5062;5130;151963;6165;55341;255758;116211;93109;152002;131540;200931;375387;22916;23527;7037;165918;54965;84859;2814;79572;84248;255798;1370;344905;152138;10188;89782;26043;4241;347;131578;1739;4976;348793;84984;152137;3280;5504;9711;84223;2257;200958;4585;205564,51,0.73752252878254000000
chr3,178013106,187913161,9900055,1,1,1974;8893;1181;55324;5290;1857;5984;5648;9370;6750;110599564;55486;131408;54165;170572;90407;285242;6480;3273;55669;6657;26998;86;23101;10644;116832;604;23355;10242;57129;8646;5708;1962;84002;2119;7066;9175;64393;27074;200879;51555;1173;55171;79929;197;51193;110599583;105374250;94032;200909;1608;339829;59343;55689;64110;8087;10057;132112;5437;59345;23200;9718;89857;90113;131118;2049;3827;285382;51726;1981;1427;27094;151613;54800;4711;8975;64108;344892;4026;6434;56922;10195,82,0.82827822673712400000
chr15,20686218,32899528,12213310,1,1,321;7681;123606;283694;643699;390538;23359;6638;22909;8926;161725;283710;283685;653720;89839;4692;54893;23191;283767;728498;2562;101059918;727832;100996331;4948;57194;81614;100287399;4308;2558;1139;7082;8924;114791;23742;51621;7337;89832;653125;653073;2567;54551;728047;56160,44,0.36026269700842800000
chr22,18919942,21440514,2520572,1,1,54487;27037;9342;29801;65078;10587;1312;6545;421;7290;2812;6899;5625;7625;79680;64976;6576;3053;8218;5413;80764;23617;400891;1399;7122;150209;128977;8220;388849;84861;7353;51586;2928;128989;5297;9127;9993;54584;91179;85376;8216;85359;8318;728229;5902,45,1.78530904889842000000
chrX,102709377,103223099,513722,1,1,203562;142684;85012;5354;9643;79921;9338;51209;441509;286527,10,1.94657811033983000000
chr5,165402042,180684501,15282459,1,1,2916;2324;51491;30832;91522;6586;30820;51121;53917;23138;3182;9945;375484;3274;30012;285590;84321;54825;90249;644994;26262;9794;79908;3101;80758;345456;10399;23286;133874;1794;2870;55819;285676;4488;1627;10814;8817;285659;253314;6793;6620;10636;153579;27166;2299;1212;9509;23197;57472;643836;51720;1812;90933;133491;255426;11285;26693;54540;11282;285588;64901;1843;80315;4245;5626;92304;5601;64324;8614;114787;153222;285679;51428;101928093;92181;9260;345462;3779;3187;646019;57179;57451;79646;662;54732;6940;91272;821;100131897;57222;3937;2161;54492;117608;202134;6569;134083;51149;10917;23061;285596;1482;51617;84851;80108;23291;10960;64777;23567;2264;79930;5917;2568;192286;285598;85007;94081;8992;4056;55651;54908;57396;8878;83463;81786;4869;80230;22838,128,0.83756154686886500000
chr8,221611,7753583,7531972,1,1,389610;401447;728358;503841;1669;504180;26260;55894;1667;245910;245908;503618;157695;100289462;9228;245909;9920;1672;1668;9172;503614;140596;100133251;653423;645402;100131980;157697;1673;64478;1671;9639;100131608;79648;1670;285;414325;55326;10407;2055,39,0.51779268430631400000
chr16,71229088,90155062,18925974,1,1,56942;11105;2300;763;197320;64779;7571;1535;51693;79007;124044;9914;8720;79786;79152;5336;197257;114780;7567;4157;79583;404550;283927;79791;3294;353;10164;1012;11345;2622;8140;6137;93107;27189;57338;23417;342372;84937;92806;3735;6898;146429;9764;124245;388289;3281;170692;23406;79726;9564;3394;54386;22879;10328;164;27132;197259;10428;51659;440387;57687;124491;1013;54768;146167;124045;161882;22980;2653;2294;81631;93517;23035;55159;54957;123775;4597;115992;51741;10143;161931;794;1504;91862;23563;339145;9605;2303;497190;124359;100506581;23536;83693;54550;85445;4094;123872;9013;83716;83449;333929;1327;92822;390748;9798;54758;863;23174;29948;4166;23199;1723;463;100287036;3250;80790;100129697;342371;83657;8139;5713;55839;348180;9780;53630;81620;5119;54849;55625;3240;29123;55565;57707;440348;197322;2588;23300;100130958;9785;6687;54971;2175;9100;162239;10200;84501;2734;84627;58189;10381;1800;8558;55783,153,0.80841281933495200000
chr8,141415657,146174033,4758376,1,1,65263;1584;340371;84948;11156;93100;225689;203054;84988;22898;111188157;8694;8581;27161;286077;2907;642658;50626;23237;2765;9684;55630;114822;642475;340390;6132;26233;338328;90990;2875;57210;203062;1936;80728;51337;23144;286075;23513;83482;137797;340393;51236;9401;28991;2843;22827;83696;575;389690;2738;7553;7564;5339;414919;375686;90987;51160;4062;389692;5747;81858;26873;727957;84232;79581;1585;57152;58500;8928;340385;8000;4796;116447;83481;84875;29894;4061;54108;8629;79943;23246;1537;113655;100130274;105375787;66004;79792;286128;441381;80778;8733;432355;9831;7264;54512;3297;54742,97,2.03851061790829000000
chr7,146805238,158923949,12118711,1,1,27153;57541;84626;140545;1804;168537;389602;26;22976;11194;155061;392843;57180;6469;3110;116988;168391;51422;349136;55303;155051;63917;113763;155435;55340;83590;28959;3361;64327;168544;136051;7988;10061;9690;55112;6604;285973;26157;55365;7434;285888;8427;54892;285971;10049;57488;54480;58508;65999;5799;474344;643641;8454;9601;155054;1020;6009;23145;2636;26047;2020;100289678;653857;3638;5919;51667;9311;2146;170575;6522;3757;4846;29803;64434;10922;202865;100527949;7516;155066;136371;155038,81,0.66838791683372900000
chr1,233944217,249168732,15224515,1,1,127077;25909;200150;200159;127069;84288;1130;51029;6894;81469;55083;391196;23029;127623;343173;6905;127064;26246;55127;79894;391189;128178;441925;441932;401993;6000;10472;51742;56605;57116;80851;79862;23596;1131;343563;317705;148789;391195;26245;57829;114548;148641;26188;403239;9453;7107;388753;163882;391211;159;284521;359948;343169;4548;6262;128025;84838;391194;9804;3192;9156;93474;1122;127074;8564;81472;127066;127068;646627;391190;64388;388759;441933;403244;343172;25893;7678;284532;10000;88;2271;26696;55657;391191;64754;81466;127059;127062;645745;10806;2786;3964;401992;343171;254879;116228;257044;9859;81470;148823;4811;64216;440738;56776;401994;391192;51097,107,0.70281384989932300000
chr2,235313245,242852625,7539380,1,1,151176;64090;23677;84289;10920;10123;377007;5510;285093;51665;728294;339768;4705;57007;150677;1841;129807;2859;130916;64284;150678;10267;140739;2817;4735;79083;401036;51540;5133;9759;150681;375318;189;51078;547;116987;79781;79919;57140;25992;51052;9208;375316;2637;11132;389090;23192;55502;3069;10494;117581;51281;285193;666;8864;26146;23178;50636;653437;1293;80895;9855,62,0.82234878730081300000
chr15,22880274,28540457,5660183,1,1,2562;7681;123606;4948;57194;81614;2558;8924;23742;7337;6638;2567;8926;283685;54551;4692;23191,17,0.30034364613299600000
chr8,7303187,12241152,4937965,1,1,392197;377630;1508;83650;504180;503841;245940;203076;83648;245910;613209;157285;252969;245908;100132396;503618;54984;392188;613211;4482;203074;245909;90459;503614;140596;83595;100133267;100133251;653423;85002;2626;613210;137075;1673;728957;100131608;640;66036;286046;79660;2222;8658;9258;414325;94137;10407;645836,47,0.95180909544721400000
chr1,145899369,147380390,1481021,1,1,9557;51205;2703;5565;607;2702;2330;149013,8,0.54016789768679800000
chr15,22880274,29331964,6451690,1,1,2562;7681;321;123606;4948;57194;81614;2558;8924;23742;7337;6638;2567;8926;283685;653720;54551;4692;23191,19,0.29449648076705500000
chr1,229662162,249212668,19550506,1,1,127077;25909;200150;200159;57568;10753;1130;51029;55083;127623;26246;55127;441925;401993;9816;80851;1131;148789;26245;79605;183;388753;163882;128061;391211;343169;84451;128025;84838;9804;9156;93474;1122;2590;8564;81472;127066;127068;646627;391190;441933;403244;7678;284532;23456;149373;88;27097;26696;391191;64754;645745;54627;10806;2786;3964;149371;116228;80003;81470;148823;4811;440738;401994;391192;51097;79573;54583;440730;127069;84288;84886;6894;81469;391196;23029;7257;343173;6905;127064;79894;391189;128178;441932;6000;10472;51742;56605;57116;79862;23596;267002;343563;317705;391195;375061;57829;114548;148641;26188;9453;7107;83932;159;284521;4548;359948;6262;27185;84284;391194;3192;127074;64388;388759;343172;25893;64801;10000;2271;55657;8443;81466;127059;127062;401992;343171;254879;257044;3775;9859;64216;403239;56776;22796,135,0.69051921213701600000
chrX,2348192,14548099,12199907,1,1,414;2742;51481;171482;3052;425054;4281;9367;4935;5613;347527;100288814;415;207063;412;51480;1183;9758;6907;357;265;57502;8228;8226;3730;92552;10943;2824;5634;7114;26609;54960;25878;170082;6399;416;4267;7499;51284;51311;25975;9189;395;55841;171484;8481;171483;8908,48,0.39344562216744800000
chr1,187074685,248262713,61188028,1,1,2005;55432;10440;55758;55105;8560;55740;10753;286826;1130;90806;51029;55083;26246;55746;55127;3586;339479;140609;79098;6738;441925;252839;8290;127829;4751;84033;149603;5778;5784;81559;200205;64407;183;388753;163882;10878;89796;6003;23271;5867;64746;5664;84838;1379;127845;149643;79577;3664;9156;93474;128308;8934;259266;9214;4931;79802;391190;284532;647219;149373;88;27097;779;7483;343450;23612;64754;254428;148808;1063;7188;56950;7832;25802;4656;2786;3964;84919;9015;388730;80342;10380;1939;142;148823;4811;127602;27042;5997;51097;64853;56256;360023;54583;1118;467;65094;55220;1604;440730;84288;6894;1116;5208;50604;947;7257;127833;149345;391189;128153;127018;25782;79762;441932;149647;6000;2058;56605;8497;2165;23596;7100;91156;3078;317705;57829;5788;26188;339501;54996;431704;148362;5284;64710;3290;9580;1378;1465;7042;725;64388;4660;2987;388759;25893;8707;26254;553;7044;126731;29089;2271;29949;10638;51133;55765;93273;56956;81466;2848;25778;100381270;9926;59352;29097;5287;56776;375;148304;2104;22796;10765;55705;2331;92815;25909;134;23219;10877;200159;200150;11221;58480;57568;128387;128312;5877;26750;127623;83953;3776;59349;148811;9911;722;6051;3930;10446;9816;55248;5929;1131;83881;3914;2052;148789;28982;2494;79605;9877;128061;58;343169;50486;84451;128025;7399;9804;493;9641;9261;1122;2590;8564;81472;6900;440712;85414;1999;83479;441933;57165;3756;7678;23456;7779;4608;3898;9725;8444;375056;164127;391191;51706;4194;7135;29920;3142;645745;54900;3707;54627;55532;10806;100129094;729533;25896;5129;339500;149371;116228;4179;80003;56997;3080;6635;81470;440738;10637;391192;23418;79573;64757;7139;5362;5317;55509;79805;79169;3075;23528;84886;81469;23029;55224;51127;6905;343035;128178;255928;3020;9928;10472;51742;57116;55061;388722;79862;81788;51022;375057;84976;163859;375061;114548;51377;148641;3814;4139;29937;81494;159;7107;9453;284521;83932;359948;4548;6262;25936;5549;23114;163486;27185;5996;23046;3192;5629;343172;5972;64801;51514;51018;116841;149111;10000;6726;80232;89780;5525;824;11009;8443;51094;7159;92703;115019;23380;1510;388743;83593;343171;400823;9283;257044;57172;3775;55733;9859;1380;127124;8476;64216;22874;84284;55699,368,0.60142484082016800000
chr9,220253,2188525,1968272,1,1,58524;81704;23189;1761;10655;6595,6,0.30483591698708300000
chr9,220253,141102518,140882265,1,1,10171;29952;10422;158293;54863;84960;360203;92014;138240;54886;2220;441478;79937;81605;1164;644019;2800;55064;7743;399665;56654;138241;2395;4686;89891;2315;79695;5991;389792;389761;643596;51510;195828;2733;80709;10488;1056;375748;971;286362;10927;392390;140459;286319;79956;114987;25;79886;6709;100129969;7415;7088;7185;27290;7016;5646;81873;10773;8022;83549;6256;6363;6621;57864;55342;375775;138804;26267;23230;3442;84929;81704;8021;6019;169792;9719;153090;29989;10497;4781;2040;51271;158234;653427;4783;84895;90871;10244;1384;3590;25769;158471;65268;54829;552891;7091;347148;3456;195827;10555;203197;80380;1955;51104;50808;8727;229;5887;259308;3190;51531;392309;158131;114789;23424;5537;10507;9853;158046;8395;7633;286343;548645;286336;7186;11092;441476;3441;94107;445571;5524;55234;169522;883;8518;728747;64855;5774;1029;56254;89882;6835;23137;54881;9380;11064;11091;375704;84270;5069;25920;9925;5900;79048;9615;138311;9827;80142;84302;23413;84131;79813;1761;7357;138429;401546;138805;10439;1757;64768;51280;54875;116225;9833;3293;26130;11093;210;115426;158376;79817;84681;4593;203286;23446;25792;642968;138162;401498;58524;9328;55664;8577;138151;728489;3439;84263;29988;51754;83543;286257;254956;5535;7094;90678;4712;27158;389762;220869;7539;26248;10558;401563;3444;22845;7306;6838;100526694;55958;3443;203328;64922;1515;301;51116;138883;254973;51450;23637;2356;10585;730112;22927;9022;27348;84814;54566;158405;116443;56623;7248;203259;54801;728577;3447;4702;727830;81932;55582;26737;23203;54534;91373;58499;727800;85365;92714;647060;360;169611;768;152006;401548;28989;85014;29991;10912;80010;203260;158399;57171;7295;158062;25934;389730;5079;158358;286204;84641;203238;54107;392392;57706;89853;730098;645961;9329;54840;5568;23731;2649;2902;29126;55312;11046;445815;6887;401565;90865;83744;2844;123;9830;3449;23511;26995;9373;3467;441457;55357;10952;441459;286256;157927;59335;92949;91283;51552;158135;9550;57720;10319;4799;8434;7410;2176;1025;2790;203228;727905;56033;51117;254295;1612;26206;6850;733;441425;29085;5082;7111;9991;53358;90120;3446;5998;100129385;286365;158056;11168;26301;2776;445;56751;57704;54187;570;6013;23245;57589;80173;92400;392399;22954;402381;9933;54932;23196;9314;3371;2218;347273;7099;23071;11217;6136;375743;55151;2889;116224;10592;158067;23299;389799;26578;286380;79269;10210;4915;1759;51148;2189;6461;54796;158248;1842;10444;158326;6096;84688;10541;158431;727;3309;23452;6456;1211;27130;3717;9919;389812;140803;2592;55833;259;23349;320;158219;2731;253650;1271;10280;27090;27240;10020;56656;216;9568;54461;1903;9350;1306;340485;10850;881;100499483;2934;8721;7169;158038;55363;158427;84726;79987;64420;26149;255220;375759;653404;8555;401562;441430;441452;8777;55335;6837;7436;392391;338376;138065;573;25861;10807;55848;23099;2021;51759;55014;64975;10868;158158;27019;30968;2683;54926;9413;22869;774;5695;158055;401494;2650;5711;401505;23189;26735;138802;246184;687;80256;9414;26012;1993;203245;286207;169693;401551;80036;54942;83856;54542;138716;138881;549;100505993;403313;10880;9128;401541;6595;84253;65083;347168;169714;219;442425;84210;27433;138428;50514;10783;10670;26190;954;138255;5005;60560;8939;23064;401535;114299;2022;11224;51162;64078;4969;26147;158297;3440;9442;2619;286205;389816;23670;5047;5727;92715;203;3934;11182;3451;158401;9630;84909;5090;256691;6130;375791;5730;11172;152007;22844;5253;389763;389766;4851;138199;5004;10881;23586;138803;57109;3933;54754;100129669;3376;1317;26219;23307;8636;55071;81689;54769;8013;9355;25853;85301;5239;84628;2801;89958;6812;23392;6366;2516;56262;11253;26953;56904;11094;138799;3641;25822;7507;1318;389813;114991;84267;58493;157922;6836;84720;117531;26165;4300;445577;80318;23287;5742;54914;100505478;4958;169834;11258;8328;3452;257019;23552;55755;347252;4920;347240;9858;6505;2219;138715;256158;138307;20;29941;10044;3448;79670;7464;7046;138639;8818;646962;142680;375757;392376;1620;10655;79109;64794;23081;414328;6834;57462;64170;56832;6418;92399;347169;55035;9649;54586;84885;5789;3301;55667;349334;5125;286262;7270;89846;2529;26740;29968;29882;340481;8789;2304;23048;51490;113220;63951;414332;286234;26468;28;389827;1030;57684;4957;2203;318;54662;7763;3445;169436;1902;79095;4882;4814;22949;10811;1514;4507;364;29979;138882;54836;1621;84904;19;6619;7010;51010;54981;8019;23732;6194;10999;30815;1289;377841;1539;64425;169841;55684;403341;10383;944;26086;392307;57582;1861;138724;138474;286223;257169;4010;23404;48;84186;692094;9966;9536,749,0.53164960117584700000
chr11,8338037,20621056,12283019,1,1,10553;55293;6289;50862;5682;3746;10335;272;23258;797;117195;10527;10196;65975;6157;84867;133;7251;79733;56676;340990;84280;100463486;160287;56674;1315;10083;4654;120227;6833;144108;22800;5140;3948;89797;56673;102724957;26297;113174;2965;259249;100528017;7003;5286;7166;796;27122;6764;84953;55031;54503;3767;283284;374378;6291;55742;9646;7465;3939;9866;6207;4925;6288;644943;84188;9645;117194;55553;440026;9152;56672;144110;406;1982;7702;58486;10944;120237;10894;81846;10418;8048;283106;387755;11234;57758;144100;23075;374383;5741;117196;56675,92,0.74900152804453000000
chr19,277373,6586094,6308721,1,1,566;126259;6294;51298;400668;374291;55111;80032;1943;58492;5605;100131094;51343;8612;26528;8175;56931;55620;55643;1153;2527;84266;84839;116444;148252;4782;23396;4298;1991;113179;4946;22904;9667;8698;83475;92359;4616;56961;5064;374872;79085;79948;23526;513;729359;23217;51690;2525;26517;6449;84939;148022;29128;828;610;5623;126567;56926;1265;970;163154;997;56928;9546;10226;125981;3004;125988;374875;10297;126295;25873;54531;116541;9361;79958;91300;84634;92840;8943;79187;56005;51548;10272;8744;4902;27134;8174;170961;6455;55527;255057;10975;84699;1455;115196;148066;27231;8570;2872;55702;85300;58509;126326;60680;81616;6915;126328;126306;54760;645191;6929;400673;284427;10347;80700;55009;10036;5657;148223;91039;57455;166;84954;5802;91978;6209;399664;126308;257062;2767;1938;284451;10501;339366;100128569;81926;2788;10382;27006;645432;148229;84717;148254;5990;2962;10025;2879;83855;51341;4145;126321;126520;1613;91304;53615;113178;10362;84444;79816;390877;2769;23030;8498;55658;360200;440503;1820;25759;84823;116844;1675;90007;390874;6794;682;29985;7089;57418;2593;284422;268;126282;5442;126353;5434;7064;113177;10148;8192;5725;2528;51588,193,3.05925717748495000000
chr22,18889039,21561514,2672475,1,1,54487;27037;9342;29801;65078;10587;1312;6545;8214;7290;421;2812;6899;5625;7625;79680;64976;6576;3053;8218;5413;80764;23617;400891;1399;7122;150209;128977;8220;388849;84861;7353;51586;2928;128989;5297;9127;9993;54584;91179;85376;8216;85359;8318;728229;5902,46,1.72125090038260000000
chr10,128330086,135372492,7042406,1,1,253738;85442;27287;8433;5791;282974;282973;50632;10570;1793;664;282969;594857;119467;196743;101;1892;1571;399823;642938;84435;10539;503542;10844;80313;256536;3632;4288;93426;92170;84504;118471;170394;55844;54777;4255;118472,37,0.52538862428550700000
chr9,220253,16834952,16614699,1,1,58524;10171;23081;55664;89882;9350;50808;158358;6619;203238;81704;23189;5789;6019;54796;286343;158326;1761;169792;55064;6505;29126;2315;4781;11168;5991;100129385;8777;340481;26953;90865;7436;3717;90871;6013;57589;3641;7306;403313;169522;158219;115426;6595;79956;9933;2731;55848;11172;10655;80380,50,0.30093834381230700000
chr1,75230689,76543764,1313075,1,1,256435;127253;431707;5876;34;127247;204962;4438,8,0.60925689697846700000
chr8,4693679,43055737,38362058,1,1,377630;203102;1508;83650;2053;27257;55806;504180;8756;84513;54793;286097;389643;619373;245910;10671;245908;51669;503618;155;9070;100289462;4482;7976;203074;4747;59339;1960;2137;6570;1135;55246;1672;8754;84197;5533;541565;57509;645402;2626;2515;7994;613210;51125;56154;79698;79648;1670;157855;286;11030;8658;9258;2267;414325;137868;645836;4481;11178;80005;389610;23484;6867;63898;1669;203076;427;1191;83648;55756;56892;55872;79618;1667;2260;613209;81551;137964;157285;2961;252969;1142;100132396;6770;392188;5157;64641;138050;23516;148;84549;114926;5108;6781;5368;64236;25960;140596;100133267;10395;3551;100133251;85002;51435;6440;2936;91694;2185;9108;137970;4023;137075;1846;4017;64478;728957;100131608;27121;5423;286046;79660;2222;8793;29883;84750;661;2039;55174;7991;157313;9;79845;29942;10947;7993;503841;389649;3620;10407;1978;157574;9796;7486;1808;9530;203069;2675;157848;157310;54984;23221;6575;137994;55145;55790;245909;81790;90459;5516;5520;26281;137492;23087;10174;8795;51201;83877;11212;80139;503614;83595;653423;100131980;2339;55124;23362;8797;1673;4824;66036;8794;285;84296;157773;8749;11160;401447;392197;55909;80346;9583;728358;245940;286133;84376;6422;649;55894;10361;57805;91782;2796;55290;169355;80185;10;78986;27299;10863;613211;10687;157570;55140;203100;665;4741;7419;9046;1668;23039;23259;8973;79873;137814;55893;23303;526;203190;100507341;57604;1671;3084;640;137362;80223;6542;5327;8822;653333;55326;94137;51312;54904;64760,244,0.63604512562907900000
chr4,46043192,58469391,12426199,1,1,3815;132946;152518;23142;2555;5471;2557;2560;6691;57205;26511;65997;55763;9662;7006;132954;132671;132299;81608;55858;170712;285527;3791;132949;54940;326340;5156;7294;5431;201780;80157;84273;100288413;54951;1259;339977;100506564;57482;64854;84525;10606;79644;170825;6731;57606;152519;10699;6443;152579;5978;84708;3490;2565;10874;9575,55,0.44261322388286200000
chrX,69722090,152960681,83238591,1,1,392509;51132;8823;23157;55998;541578;2158;55609;2556;23439;494119;55859;331;3423;54830;4168;5358;92002;51442;266740;9075;102723737;389895;7552;100132304;27328;84460;695;56159;389874;56000;340562;644538;79649;51213;57526;728269;51186;3149;100130361;1730;3547;102723680;728656;3358;728695;57826;79921;83844;114824;203413;80823;2986;8862;23641;7512;79979;158763;9737;11013;2833;8450;139599;6658;5716;4101;54457;91966;340526;441519;4100;139804;54470;959;57631;117154;27316;54521;4534;79589;51634;728096;101928917;92129;653282;728072;6567;392490;9363;3920;100506164;827;84548;90293;54413;100529097;55511;100133053;254065;203547;139135;79836;139081;203522;51765;6451;139818;56180;27336;142684;7626;4841;10046;340578;203447;139596;63932;441509;56001;158798;51616;100130613;4108;2564;79868;728075;100132994;5354;11043;340533;56156;79366;1821;22;1260;56062;5303;84631;51260;203562;102723631;170261;340596;441525;29944;57692;1478;50945;7739;100131755;57481;139170;1287;3561;6170;10813;79710;10800;26280;11219;728062;169966;6173;51209;23630;26548;139324;1121;2000;645188;51438;2846;255313;1852;645974;79983;727940;10857;541466;139741;56157;101059915;2182;84707;1069;4674;53336;154796;51309;80712;159090;2258;728343;9823;55285;441531;1046;643311;4107;286499;203523;1831;54967;340542;89885;94121;286410;2491;84187;633;83550;6191;4110;644353;3598;55916;340595;6594;9452;50814;63947;9643;57187;139067;4104;203427;139728;5456;100996648;10479;9016;55026;100528062;90316;93953;10178;4105;100507170;2332;84968;4068;51114;64663;1538;9142;9968;115201;100533997;1741;79576;139212;6535;27330;91851;27334;158866;27286;1038;158800;7224;10761;55796;1288;84061;8471;90167;292;7737;55879;7319;401612;1678;340527;139322;5063;84443;29935;158983;10009;2747;340543;54885;100129407;10495;27018;6872;100129239;140886;2239;2334;441518;4303;55869;26071;8473;59353;728712;84636;55922;2705;28985;54821;441521;728049;728090;8933;10735;158521;9949;4694;84528;282808;492;100129520;728082;90843;347454;29071;9947;79057;6906;340547;30014;5255;680;93380;4435;159091;9338;340529;65109;64860;8776;494118;4675;51566;56271;2892;5230;55559;85012;57529;114928;538;63035;286436;55086;29934;10838;139221;139735;83692;3251;1349;158931;27035;1641;100329135;7105;2717;84295;9459;139065;4109;139760;546;347487;158830;53344;4103;51270;9203;139378;186;139231;2719;3597;9131;9248;7547;402415;203430;11254;90161;64102;728042;56849;2273;728036;64648;54440;140597;4952;5631;84889;3188;100130086;286527;347468;347475,400,0.48054633697487700000
chr3,167090433,185655471,18565038,1,1,8893;1181;5274;5276;26996;55892;55324;5290;1857;110599564;55486;1894;131408;11235;54165;79740;170572;27333;90407;285242;80012;344657;55669;6657;5010;23043;86;23101;10644;6514;151790;23355;10242;57129;8646;5708;1962;344658;84002;200916;57552;7066;9175;64393;27074;6498;51555;1173;79929;200879;51193;110599583;7095;105374250;94032;200909;57709;339829;59343;64110;55689;8087;5584;10057;5437;59345;83893;23200;9718;64778;5337;56922;89857;151827;90113;131118;2049;56648;285382;1981;2693;8743;27094;151613;54800;84517;2122;389177;4711;8975;6434;254827;22871;79718;10195;79782,96,0.51710101536016300000
chr3,193854012,197769619,3915607,1,1,131583;622;80235;200933;5062;5130;6165;55341;255758;116211;93109;152002;131540;200931;375387;22916;23527;7037;165918;54965;84859;2814;79572;84248;255798;1370;10188;89782;26043;4241;347;131578;1739;348793;84984;3280;5504;9711;84223;200958;4585;205564,42,1.07263062917193000000
chr17,52188851,61353389,9164538,1,1,5889;79665;51649;388403;1213;81671;10513;84669;388407;6909;9110;59342;57508;9256;348235;83990;7716;26689;342538;140735;101927581;63897;55273;6827;8161;4353;23531;51651;6426;8288;22843;124773;339210;162333;55771;9496;51136;1353;252983;284083;4591;9969;3131;124535;54828;8165;7706;55181;10040;6198;9902;5414;162282;54903;56155;284161;11011;4025;146779;124540;9241;404093;51174;124538;339175;26115;8526;8493;762;58488;54894,71,0.77472535985993000000
chr22,19010449,21561514,2551065,1,1,54487;27037;9342;29801;65078;10587;1312;6545;421;7290;2812;6899;7625;79680;64976;6576;3053;8218;5413;80764;23617;400891;1399;7122;150209;128977;8220;388849;84861;7353;51586;2928;128989;5297;9127;9993;54584;91179;85376;8216;85359;8318;728229;5902,44,1.72476985102300000000
chr22,16494874,19010448,2515574,1,1,27440;51816;8214;51807;23765;150160;5625;27439;27443;55670;637;529;11274;150165;23786;83733;128954;101929372;57553,19,0.75529481541787300000
chr15,32011562,32515121,503559,1,1,161725;1139,2,0.39717292313313800000
chr8,7302987,12241293,4938306,1,1,392197;377630;1508;83650;504180;503841;245940;203076;83648;245910;613209;157285;252969;245908;100132396;503618;54984;392188;613211;4482;203074;245909;90459;503614;140596;83595;100133267;100133251;653423;85002;2626;613210;137075;1673;728957;100131608;640;66036;286046;79660;2222;8658;9258;414325;94137;10407;645836,47,0.95174337110742000000
chr3,178244271,197769619,19525348,1,1,80235;200933;55324;5290;1857;5062;5984;5648;55341;9370;6750;8626;285386;54165;170572;54965;2814;6657;26998;89782;23101;604;131578;10242;57129;152137;2119;9711;205564;27074;51555;1173;79929;131583;197;51193;105374250;200909;84239;1608;339829;151963;5130;64110;132112;5437;22916;59345;23200;165918;10686;84859;285382;257313;1427;1370;255798;152138;27094;10188;151613;4241;347;1739;84984;4711;8975;344892;5504;200958;10195;1974;8893;622;1181;3556;255758;116211;93109;152002;110599564;55486;200931;131408;344901;7037;90407;9076;285242;6480;131920;84248;3273;55214;55669;86;26043;10644;116832;23355;4976;348793;8646;5708;1962;3280;84002;84223;7066;9175;64393;200879;55171;110599583;57110;94032;59343;6165;55689;8087;131540;10057;375387;9718;23527;89857;90113;131118;2049;3827;79572;51726;1981;344905;54800;647309;64108;4026;6434;2257;4585;56922,142,0.72725976510124200000
chr4,119508607,177331545,57822938,1,1,5393;54726;1182;4889;201799;285533;27236;6999;4086;59350;166752;132851;10733;54798;9693;5188;2266;2549;57575;80817;54969;8654;4887;152756;646603;55132;132612;79960;10424;4258;56884;91351;79625;80854;442117;2247;890;8467;80155;140458;23520;57182;6423;1047;3558;166785;85462;2244;152503;51166;55212;7097;5481;84709;4085;11162;5356;9464;25819;171024;79884;83452;152485;2169;166863;2743;201725;6189;92345;11086;256471;2891;166379;7092;59067;132320;23022;27152;80167;2993;51802;7222;201798;50859;11199;7350;3248;83447;2982;4717;56034;391712;1363;1519;729830;55751;54510;60559;8821;84068;23158;166614;55016;255520;60592;84076;166655;987;3600;84162;1909;100506013;57721;51778;345062;401152;27309;79633;2983;11275;2243;152586;90826;2110;55314;6307;55534;57630;10393;4886;10586;6059;166378;79931;55601;132430;10252;54532;55319;64399;11341;55294;9227;11157;83894;9871;3148;1998;84057;84109;51809;132321;84640;2994;8819;9848;8001;132332;2823;23240;22824;5458;79658;116966;23657;84869;2996;201931;57484;4750;51313;23321;57600;152940;4306;26269;11107;308,178,0.30783631229530400000
chr2,233527432,242852625,9325193,1,1,54658;151176;64090;84289;285093;339768;6694;26058;2859;130916;64284;10267;79083;414061;54579;150681;9759;189;54578;51078;79781;57140;25992;55230;9208;3635;54657;2637;6295;54659;11132;389090;23192;54577;55502;3069;10494;54576;117581;54575;285193;25791;8864;26146;80303;23178;1293;5133;80895;23677;5510;377007;10920;10123;51665;4705;57007;150677;129807;4759;1841;150678;140739;2817;4735;9855;401036;51540;375318;339766;547;55054;116987;79919;8527;3769;375316;51052;55355;79054;54600;51281;666;50636;653437;389084;728294,87,0.93295656186418900000
chr2,39193,4234087,4194894,1,1,7837;23040;51112;54221;26751;285016;7260;78989;55821;55256;6201;642273;728597;7173;246243;129787;52,17,0.40525457854239000000
chr3,193312497,195621772,2309275,1,1,131583;79572;1370;10188;347;131578;55341;4976;93109;152002;3280;5504;23527;200958;4585;2814,16,0.69285814812008100000
chr7,47034222,52175639,5141417,1,1,2887;63979;100130988;3364;7378;154664;401335;64759;80099;1644;136288;23242;11055;10320;256979;375567;168507,17,0.33064814622116800000
chr15,30783615,32539807,1756192,1,1,728498;51621;22909;161725;283710;54893;89839;4308;1139,9,0.51247244037098400000
chr15,20848910,30226187,9377277,1,1,321;7681;2562;100996331;123606;4948;57194;283694;81614;100287399;390538;2558;23359;7082;8924;114791;23742;7337;6638;2567;8926;283685;653720;54551;4692;23191;283767;56160,28,0.29859414412094300000
chr8,12658722,35572807,22914085,1,1,29942;2053;55806;7993;64760;8756;157574;54793;9796;7486;286097;389643;1808;619373;203069;2675;10671;51669;157310;23221;7976;4747;55790;1960;2137;6570;1135;55246;5516;5520;137492;26281;5533;23087;10174;8795;51201;541565;57509;55124;23362;8797;56154;4824;8794;157773;11030;2267;137868;23484;11178;4481;80005;55909;80346;9583;63898;286133;427;1191;55756;649;55872;10361;79618;57805;91782;2796;80185;81551;2961;10;78986;27299;10863;5157;10687;64641;157570;23516;55140;665;4741;148;84549;9046;23039;5108;6781;5368;64236;79873;137814;10395;55893;23303;51435;6440;2936;526;203190;2185;9108;137970;4023;1846;100507341;57604;4017;3084;8793;79845;29883;84750;6542;661;2039;55174;7991;8822;51312;157313;9,123,0.53678774430661300000
chr18,64042620,76055297,12012677,1,1,125704;54495;28513;147381;1528;55628;201456;400658;92126;25914;84735;644041;10194;220158;9306;9658;284273;4155;79839;81832;10666;55748;29090;284274;7776;220164;2587,27,0.22476255708864900000
chr19,56705161,59078072,2372911,1,1,388566;7710;503835;79891;10782;284309;10155;125919;27243;7593;400720;342945;57663;57343;201514;147687;388567;6795;388569;1;79818;23619;65982;116412;55659;10998;90485;147948;284312;7691;5178;57191;7554;9040;147685;10520;58491;374928;100293516;390980;348327;79149;55663;84914;90233;7565;147949;6193;646862;162968;147694;147686;10172;140612;27300;147670;162972;9422;284306;10794;79744;284307;54807;80095;84878;7694;57573;63934;7693;25799;201516;114026;730051;79673;256051,75,3.16067479985554000000
chr16,88782844,90155062,1372218,1,1,863;11105;146429;197320;100287036;51693;79007;100129697;124044;8558;9780;81620;9605;5119;4157;54849;27132;353;197322;2588;2622;6137;6687;2175;1013;124045;84501;22980;92822;92806;390748;10381;1800;29123,34,2.47774041733894000000
chr8,357013,19789534,19432521,1,1,377630;1508;83650;504180;503841;10407;26260;286097;245910;245908;503618;54984;100289462;4482;157695;203074;55790;9228;245909;90459;9920;1672;26281;137492;9172;51201;503614;83595;57509;653423;645402;2626;100131980;613210;23362;1673;79648;1670;66036;285;157773;8658;9258;2267;414325;137868;645836;4481;2055;389610;401447;392197;63898;728358;1669;245940;203076;427;83648;55894;1667;613209;157285;10;252969;100132396;392188;5157;613211;1668;5108;140596;100133267;10395;100133251;85002;91694;9108;137075;157697;57604;64478;728957;9639;100131608;1671;640;286046;79660;2222;29883;6542;55174;7991;653333;55326;94137;9,98,0.50430924531099200000
chr14,86323792,101668862,15345070,1,1,801;3705;9950;327657;8477;9252;79882;122509;5104;1112;51527;79820;9321;11099;388015;283600;8111;317762;440193;57062;51676;866;145270;161176;80017;64112;2581;84193;79446;51156;624;78990;4707;7453;7443;145567;57718;79890;122481;5700;145258;79789;55102;623;51466;3429;64919;161436;54207;9623;55148;10858;123041;256394;341947;51218;55727;56967;12;8788;55775;283598;53981;5265;8115;5641;7528;26175;83982;1113;57578;123016;5267;4287;2009;90141;123099;55051;84520;84439;55671;56659;57596;90050;23405;123096;10516;10914;55812;8812;123036;145264,92,0.59954109039580800000
chr15,75141527,100283019,25141492,1,1,646;10073;57214;145946;2242;51458;64843;123355;1143;100526783;3419;56963;145748;400451;3603;440295;100133220;55466;91433;23336;50810;4122;342125;2184;84894;5780;5923;92912;6218;83640;3658;653643;145873;5045;1136;105376731;4123;390616;7026;26263;26276;123688;9055;145957;390637;64927;643707;3418;11057;192683;9915;55070;5346;374655;653641;1512;161502;56905;123207;5955;9899;374654;10363;49855;10509;23184;84206;26589;28232;23205;55898;57188;55784;348110;91947;64506;646892;8826;400410;1106;1138;84942;58489;53346;4240;55897;23478;54913;9640;64410;10239;57184;145814;79661;59274;10588;23423;9377;51335;57538;145858;5685;79834;8128;176;64963;9455;53339;10099;79631;4205;342132;64784;123722;100505679;1464;123624;597;6457;9154;5151;374659;64782;123720;54993;1381;55215;10933;9051;80349;5428;3480;11214;3669;10519;6017;54939;283726;283777;10518;647042;2108;145864;290;8120;23251;55272;11173;4828;4916;23102;10066;60490;100528021;257364;161753;90381;8800;25942;641;4351;123591;80765;54469;56964,165,0.65628563332677300000
chr15,19108924,26214208,7105284,1,1,7681;727832;100996331;123606;57194;283694;81614;100287399;390538;114791;23742;7337;6638;8926;283685;54551;4692;23191;283767,19,0.26740662301464700000
chr7,503373,11090297,10586924,1,1,30010;3382;9907;79034;9265;84629;155185;2852;55146;221937;55698;3955;100533952;55501;54905;27102;51608;392617;5395;54476;5879;84310;221955;29886;5154;221935;23288;90639;84262;4521;113263;654231;79778;84433;51622;57786;729852;8662;8379;54753;202915;6119;29960;7559;221938;222967;7965;221960;392862;402635;222962;80028;56913;4697;100131017;80727;60;90637;84132;2768;54468;54919;56903;115330;9678;11033;23353;26173;221927;100310846;5575;340260;728194;6624;26100;7975;84792;340267;11014,79,0.74620352427201700000
chr17,12428374,21195790,8767416,1,1,9487;2314;9720;125170;54902;11216;79018;256302;93649;9955;254272;7314;8533;5598;218;224;80039;51655;256223;201163;7156;51030;10750;64518;57335;9912;201158;339184;10743;374286;100129396;10626;140775;8834;51393;57547;1819;147166;91647;201161;3996;201164;4239;1352;23326;55244;60528;9611;55090;645027;5606;146822;79999;284194;10400;54890;9706;9953;92521;400581;22905;25979;100996259;729288;23164;83450;353149;51168;5636;644815;125150;10517;654346;388436;27077;388341;6470;6720;146691;284040;125206;5376;23495;100533496;136;57336;146802;56953;7732,89,1.01512235760229000000
chr17,51922674,56066289,4143615,1,1,3131;162282;51649;101927581;55273;8161;8165;7706;404093;124540;9241;23531;10040;339210;8526;1353;59342;58488;252983;7716,20,0.48267032530773300000
chr15,90633210,98039008,7405798,1,1,3418;145946;2242;8826;342132;64784;56963;1106;55784;51335;10519;400451;5045;9899;145858;10509;374659;641;91433;7026;8128;26276;9055;28232;390637;55898;4122,27,0.36457921212541800000
chr13,101166428,114101585,12935157,1,1,2259;79587;55795;79774;3916;8874;55608;23026;8858;259232;84899;55647;10426;84945;79070;728215;1284;101928841;643677;400165;7174;113622;10673;8660;121793;9358;23263;55739;54841;196541;87769;93081;3621;2073;55082;5095;1282;100129836;6656;23250;1948;3981;2155;2159;100533467;122258;8451;6555;267012,49,0.37881256485715600000
chr15,257649,15992428,15734779,1,1,,0,0.00000000000000000000
chr16,66107553,88651933,22544380,1,1,54920;92154;1783;11060;56942;6560;865;84752;25839;2300;763;64779;23659;146212;54496;7571;64146;100529251;9914;8720;29109;79152;25894;5336;79786;197257;114780;7567;79583;404550;283927;79791;3294;10164;64174;10725;1012;11345;146225;81577;8140;79567;55282;93107;197258;57338;23417;342372;84937;146206;3735;146198;79613;6898;57546;9764;124245;388289;3281;8883;55066;170692;23406;79726;9564;55815;3394;146227;54386;80777;22879;10328;164;6645;197259;10428;51659;440387;57687;124491;51673;10204;84342;16;123920;1014;9057;54768;146167;8717;1003;161882;2653;55512;55336;2294;50855;5681;6483;81631;93517;23035;283848;80262;55159;54957;181;123775;51741;100131303;10143;161931;794;1504;91862;23563;339145;23644;4775;27183;2303;6236;7084;497190;124359;100506581;51647;64180;999;23536;83693;6553;29100;84138;54550;85445;4094;123872;653319;9013;83716;283971;83449;8824;1728;1327;113540;80004;84916;51388;29800;79767;348174;9798;80152;54758;146456;28987;123904;9114;23174;29948;4166;23199;1001;1723;1874;26231;463;3250;80790;342371;83657;8139;5713;55839;766;283847;84080;54921;51192;1506;23450;53630;7014;55625;3240;10664;57610;55794;55697;55565;57707;440348;3038;8996;23300;57215;23491;3299;55308;65057;9785;118460;100130958;54971;9100;11269;162239;10200;3291;146223;388284;283849;3931;146433;2734;58189;84627;5699;55783,221,0.98028865730616700000
chr11,186766,6498758,6311992,1,1,7748;11187;4583;5719;4676;256892;390038;114879;3265;143630;5441;5002;23538;4046;5003;10612;340980;6050;4586;322;54472;7140;51272;390058;160298;1850;23647;119678;57053;120793;119682;171389;1509;90019;8519;390066;401667;401665;387733;338707;119679;3630;112464;6343;53840;4588;390064;390036;282763;445372;119772;10581;3665;390084;53841;101927503;347862;60626;143501;79345;119692;3046;390054;10410;390075;10077;8045;390078;81532;417;79751;119774;283232;10078;977;386746;119694;3043;387748;161;1815;79473;143496;29850;119695;56547;7054;283229;390063;84067;430;23410;6609;66005;101927423;147199;439915;120787;50613;390037;120796;7136;55367;283111;117854;6786;723961;887;833;103344718;3784;402778;390081;6737;143502;391;3047;1262;59307;440023;440021;390067;338440;6888;6150;390079;390083;387266;29125;9024;81285;51286;119687;390072;387264;10346;196335;55128;85363;401666;113746;27315;3263;115399;6181;116534;7106;3048;3045;255725;4928;7262;64787;390059;57661;3481;1028;81282;79339;10522;390077;975;727897;80162;79324;390061;81490;6240;116969;338751;57104;256329;143503,173,2.74081462714148000000
chrX,2781831,154494790,151712959,1,1,23096;64061;392509;10214;170685;23157;727837;55998;23439;729431;10916;158586;55859;331;3423;54830;4168;6901;5358;92002;27344;729447;54328;266740;9075;102723737;7552;729422;54954;84460;389874;56000;340562;644538;92552;254158;79649;56850;2824;100272147;51186;3149;26576;100130361;1730;347541;139425;3547;728695;729408;79921;57826;59272;203413;2986;7512;9737;8544;55634;2857;3421;537;11013;340554;5716;6658;4101;54457;91966;441519;4100;5931;27316;7403;4534;6839;51480;728096;27112;92129;101928917;140462;8241;6567;827;203569;27301;84548;645037;54413;100133053;7355;254065;79836;10084;347442;60343;51765;55593;139818;56180;6303;8269;142684;7626;10046;8409;203447;63932;2710;4515;8406;51248;56001;51616;2925;100130613;2564;100132994;5354;11043;340533;22;3476;84631;26748;11238;203562;102723631;170261;58526;441525;4983;29944;6907;1536;2539;1478;9468;23597;2187;1287;81887;6611;3561;9767;9282;54857;347365;10800;139341;54539;11219;728062;169966;51209;23630;26548;1121;2000;645188;51438;2846;280658;1852;347344;23229;10857;56157;286430;101059915;5277;9758;1069;4674;154796;56548;51309;1184;645073;80712;1774;10245;2258;728343;9823;441531;11141;643311;90121;256643;23676;4114;6758;4107;286499;5009;1654;1831;51284;94121;170302;11230;79135;286410;9210;2491;441490;84187;633;6191;64743;4110;3598;389856;7789;55787;9452;50814;2157;139422;170062;57187;139067;4104;203427;4693;5456;10013;1964;55190;100996648;9016;100528062;30011;90316;93953;10178;6322;28952;24137;2332;4105;94122;84968;64663;1538;9142;2245;5634;9506;79576;3266;139212;5207;6535;393;389852;170626;91851;27334;158866;550643;159013;407;7224;55796;10761;100132963;168400;4281;158835;24140;8471;90167;7737;7319;10149;11279;6134;1678;139322;5063;55906;116442;84443;27197;8233;548313;6872;27018;100129239;139105;7102;10549;26071;2664;59353;8573;28985;79184;728049;728090;158521;139886;282808;8263;9130;728082;778;90843;1756;5422;7317;5935;347454;29071;4112;412;158506;340602;30848;5127;22866;93380;159091;10159;212;139285;9338;85417;8266;100132399;158584;494118;190;7569;89801;2892;1968;5230;57232;55559;57529;8277;63035;80231;286436;25975;51311;8905;55086;139735;395;83692;171484;169981;1349;63904;139716;257397;142689;80258;27035;1641;55613;7105;100329135;84295;9459;4810;404281;4109;367;6748;139760;347487;92745;158830;53344;4103;9203;139378;186;474343;2719;3597;140456;9248;402415;203430;9185;90161;728042;4129;65267;56849;8228;8226;728036;7114;6399;4952;84889;8481;6757;347468;347475;414;6759;9500;51132;8823;541578;2158;55609;2556;494119;6756;9502;158880;8517;8242;57595;51442;389895;100132304;9754;80311;6102;27328;695;56159;51213;90737;60506;10943;100873985;57526;728269;170082;474382;102723680;728656;3358;8273;83844;114824;389840;170067;81557;80823;8862;2002;7216;79979;158763;23641;8270;57477;7592;2833;425054;340526;727866;139599;139804;54470;8450;959;139562;645864;10075;117154;57631;2010;54521;79589;51634;3750;653282;728072;7076;392490;9363;3920;100506164;347411;7454;265;90293;645051;100529097;55511;158724;6197;203547;139135;5355;347516;203522;139081;6451;27336;158787;728458;4841;347517;51360;340578;139596;1896;441509;54466;660;158798;4108;171482;79868;728075;158833;79366;1821;56156;392465;1260;5160;56062;5303;3054;51260;139628;653220;340596;554;28986;23133;57393;2623;4113;57692;50945;3730;7739;100131755;57481;8260;139170;64219;4204;389860;2574;65991;10325;6170;10813;79710;8712;26280;2316;256714;10742;6173;9104;494197;29057;139324;442444;6103;54880;90736;55558;2742;1736;369;255313;3654;170627;645974;3897;79983;727940;541466;347527;8243;4007;139741;29978;2182;7504;60401;84707;53336;1485;159090;94056;57502;55285;653067;1046;11152;641339;1947;8852;7712;23708;203523;54967;340542;89885;2277;83550;644353;55916;340595;6594;139189;63947;9643;9843;4935;139728;100288814;10479;50943;53940;55026;100507170;5638;4478;8239;4068;51114;139411;246100;9968;84679;115201;100533997;1741;416;64840;10682;11326;25763;27330;171483;8908;27286;1038;7543;158800;90060;1288;84061;215;6247;292;55879;401612;1183;340527;29935;158983;357;10009;2747;2652;286514;340543;54885;100129407;10495;6792;79742;140886;2239;2334;4128;441518;139604;4303;55869;25878;4115;11040;8473;6855;84636;55922;728712;5956;2705;55841;54821;729396;441521;8933;10735;729442;9949;4694;84528;51481;492;3028;100129520;795;10389;83604;7411;9947;9367;100463488;10134;79057;54552;6906;340547;30014;415;5255;680;158809;6990;4435;5475;340529;65109;64860;7030;729428;8776;4675;5030;51566;729201;56271;4943;79917;85012;114928;5256;26609;54960;538;6853;5365;4354;286451;29934;10838;139221;347404;3251;286464;158931;139793;100008586;2717;3052;5973;139065;5199;546;5613;51270;139231;9131;7547;257240;11254;27238;64102;2543;158747;2273;56474;5165;64648;54440;140597;5631;728239;3188;100130086;5251;8237;286527;100130302,790,0.52072018448997500000
chr22,20249486,21302053,1052567,1,1,9342;91179;65078;85376;7625;85359;1399;5297;728229;51586;84861;3053,12,1.14006994329102000000
chrX,2781831,8124944,5343113,1,1,414;25878;5613;347527;415;416;51481;412;57502;8228;8226;26609;8908,13,0.24330385675915900000
chrX,151861680,154494790,2633110,1,1,8263;492;9130;2157;50814;3054;7411;10134;139728;8517;30848;554;6901;92002;4105;57595;8266;266740;29944;84968;2539;246100;7739;8260;55559;4204;100272147;65991;5365;8277;26576;4354;474382;10838;139735;2316;8273;6535;114824;11219;393;55558;139716;1736;8270;3654;537;3421;5973;100132963;1852;3897;4101;215;6748;4100;2010;6134;1069;116442;2652;1485;1774;60343;728458;8269;5956;2664;633;79184;4515,71,2.69643121631835000000
chr8,28585067,43175035,14589968,1,1,203102;29942;10947;27257;7993;389649;3620;1978;84513;7486;619373;9530;157848;10671;51669;155;9070;6575;137994;59339;27121;55145;81790;2137;84197;5516;8754;83877;11212;80139;2339;2515;7994;51125;56154;79698;84296;157855;8749;11030;11160;286;340441;23484;6867;84376;6422;55756;56892;79618;55290;2260;169355;80185;137964;2961;78986;1142;6770;138050;203100;7419;84549;114926;25960;23259;8973;3551;23303;2936;137970;100507341;1846;3084;5423;79845;137362;84750;80223;5327;54904,81,0.55517599490279900000
chr14,94190437,106398480,12208043,1,1,23241;23186;327657;283643;122509;91828;5104;9578;207;51527;400258;388015;9112;283600;317762;81693;57062;4140;1396;51676;3831;51550;84334;866;2972;145270;256281;161176;1397;7517;84193;90135;51156;624;79038;79446;91833;78990;9556;115708;7453;7443;57718;26153;122481;145258;79789;55102;7127;623;51466;55778;3429;1735;64919;9623;647286;10858;256394;51218;5527;56967;9529;55038;5891;12;8788;107984640;122402;3714;10572;283598;283638;1983;5265;100128927;8115;7187;9895;1152;7528;122618;83982;80757;374569;1778;113146;388021;647310;3320;5267;2009;123099;122616;64423;84439;57596;90050;23368;23405;123096;122622;10914;29933;8812;145264;122416,107,0.87647135581026400000
chr15,20428261,100212374,79784113,1,1,1445;548596;2242;4058;79875;283694;390538;9399;123228;55505;161725;8483;10017;283685;653720;55055;283767;80031;9824;5923;84978;6692;196951;83640;10002;5045;23005;663;51762;653125;54962;302;197135;145957;9488;390594;4947;3418;653641;1512;56964;145773;57519;9899;400359;29766;10509;49855;643338;80119;23184;4091;348110;10125;400410;1138;54832;10169;4240;51621;56965;246777;64410;619189;10239;6447;90527;84993;59274;23015;10588;100820829;5597;4130;145788;161829;57538;27229;79834;11261;64963;9455;113201;10099;79631;25989;342132;9245;80301;23168;100505679;8482;374659;57722;22801;100137047;7782;440270;29767;9051;146050;196993;161514;254531;56204;5479;197131;342184;161582;9133;290;145781;8120;2200;53905;101059918;55272;4644;25820;2252;54629;1139;161753;90381;405753;80765;283677;646;9768;338949;57214;5604;115752;56963;80381;100133220;1159;6638;64397;50810;1544;54893;4122;55329;728498;5780;117155;5315;101928527;4123;283807;90427;8925;3671;10081;390616;51103;26263;84191;390637;9716;728047;79719;7681;2595;123606;161502;56905;5371;5955;123264;51203;140691;1543;374654;6263;11339;23205;1133;23191;84465;91947;54822;7301;646892;5330;64864;100287399;84942;79664;58472;55897;1198;2038;23742;6642;56851;23604;4649;10302;23741;390595;80208;79661;10681;7090;145645;54617;9990;9153;3175;256586;8926;283710;6727;100131244;79968;9101;161779;8125;145942;55075;2628;9960;27023;123624;9154;5151;123263;123720;440279;85455;57617;5428;51332;10260;3480;79400;11214;10519;145741;283726;79029;54778;647042;145864;26108;64799;4828;50804;57194;51065;10066;2923;84419;79895;348093;257364;594855;8800;25942;23431;4351;123591;123169;123355;9543;100526783;57099;3419;10021;54839;113189;79748;5873;9836;256764;440295;4236;91433;23336;54956;54866;81556;342125;51285;90416;60677;2562;2184;6938;92912;100996331;11001;100505573;6652;145873;84529;1136;105376731;26035;56906;80153;1583;8773;123688;9055;64927;348094;57369;55177;81488;9493;11057;192683;9915;5346;256646;3712;10620;123207;5888;2644;23269;23359;25764;8766;10363;55142;84206;10845;145853;28232;9325;23060;55898;55784;26015;100137049;3067;10391;51324;57082;390598;161835;1106;58489;8924;116179;4734;5607;54982;374618;79856;57184;2585;9236;440275;3706;283652;27079;9377;146059;51335;2553;283659;25963;145858;54878;6095;114294;8128;176;53339;727832;70;90525;56924;55323;4205;64784;64220;1464;771;8681;161823;9677;64782;388135;56160;90417;27020;55215;80349;83660;3669;366;91860;54939;283777;4212;388115;29106;585;4692;6176;342035;11173;10116;9728;54816;4916;9187;89978;1588;161742;23102;146057;83440;100528021;283742;30844;7337;641;26585;9333;644809;6124;10073;23582;145946;51458;64843;1143;8854;400451;83464;3603;373509;55466;102;567;4088;84894;9318;6218;4948;3658;653643;8554;7026;80125;701;26276;2567;388121;643707;92483;7158;55070;255189;374655;79094;53944;55930;171177;1854;644844;10776;26589;51234;57188;64506;55192;51187;4643;3073;8826;22995;26258;79768;84888;4308;4756;53346;7082;23478;54913;89832;9640;4016;84952;145814;11245;161497;23423;8669;643699;55889;5685;22909;825;255252;106821730;3990;54567;7057;123722;2558;597;51495;6457;114791;22893;80237;196996;653073;54989;54993;6557;54551;50506;51496;1381;321;54852;283748;23312;10933;399694;57611;6017;10518;2108;197021;89839;23251;80021;79811;123745;2958;23339;56986;81614;60490;388125;399697;84936;54469;342096;7168,551,0.69061368144808500000
chr20,2415775,57722044,55306269,1,1,4318;1591;5786;6754;1869;10564;128817;6385;284805;79980;3055;5621;6615;23236;7125;64849;83737;8760;9054;100506115;63926;259239;10544;245929;64900;2691;23054;29107;434;100128496;140823;245937;23767;57167;57144;79953;128497;191;57136;140732;55959;51497;6590;128821;10955;280664;64949;22981;80343;23315;245934;51012;7692;128653;56255;81502;55614;10137;128853;55304;9935;140902;11142;55617;4159;128602;4773;22919;5126;54363;5335;149708;51230;25939;10047;11190;84557;51526;140710;79716;8480;140689;23509;22803;128434;60493;22918;55661;1114;55969;140862;1472;6406;25943;1051;81030;140683;57148;140688;140733;51126;90203;10079;8530;140870;1470;11317;7052;84905;22903;10893;245936;84515;26051;2036;51098;6780;8675;116092;81572;57468;140687;3755;8200;100462983;1059;51605;6628;1477;164395;9770;245932;26133;128859;60598;3704;140873;64601;27296;27304;64096;10406;22913;387522;955;55734;28954;90196;128869;56261;116835;6629;80025;128486;9962;149840;1789;90204;140838;1471;24141;3692;514;140880;6640;4826;3397;51604;6431;10528;81610;55902;51654;140832;63916;63925;671;84969;11034;7529;79183;5476;9334;164312;57419;3787;128674;3929;10483;6614;56259;598;100527943;79913;79133;8785;84701;57506;128553;387521;128876;100288797;140690;55905;11122;79175;51575;128861;10110;7150;6789;8904;3642;140730;5326;22974;63908;149685;140731;6676;9762;100303755;8839;6407;551;64412;1469;56937;10904;146;5075;245930;170487;388799;140679;57325;100;57119;631;5332;81031;1473;51282;7022;57091;54453;57446;26013;140876;57644;54976;11264;650;10953;2686;958;149951;5834;128488;55317;10741;60625;57580;55612;6616;55544;8894;140894;56914;51297;4821;23051;57169;5933;2778;55184;140856;1434;22888;29058;51340;63905;9777;81027;655;92747;5360;3745;140711;3420;83658;100526773;90199;55857;6714;65992;128710;58476;57186;92675;84174;58490;55245;994;80341;92086;8537;84612;57593;60436;171023;54498;23626;85449;5105;1522;80332;64773;25980;359710;26074;80336;10816;26152;78997;8813;112858;7056;63935;5020;164237;644524;140836;56265;117532;6185;51614;8195;8202;128506;11237;84181;10005;149699;51507;5203;116151;117285;83959;343578;2139;128864;92667;182;140706;2937;9217;140831;9675;5266;149954;26090;140699;23613;22839;11065;6790;9371;164284;128866;200232;7335;4605;90187;23627;30813;6238;51006;8455;2307;54675;64405;5770;55713;9837;55741;9825;343702;140686;3170;9139;23394;2797;3172;57403;27131;25876;7764;55653;128822;259240;55816;140825;58495;5111;5740;10621;84532;9584;57727;57158;85366;55861;10398;391253;63941,416,0.75217512864590400000
chr16,29563985,30107008,543023,1,1,653808;5531;26470;283897;253980;146378;8479;83719;23475;283899;124446;9344;3835;4150;226;253982;83723;6911;8448;79447;112476;9961;10423;6693,24,4.41970229621950000000
chrX,455566,544731,89165,1,1,,0,0.00000000000000000000
chr8,2462498,19745113,17282615,1,1,377630;1508;83650;504180;503841;10407;286097;245910;245908;503618;54984;100289462;4482;203074;55790;245909;90459;1672;26281;137492;51201;503614;83595;57509;653423;645402;2626;100131980;613210;23362;1673;79648;1670;66036;285;157773;8658;9258;2267;414325;137868;645836;4481;389610;401447;392197;63898;728358;1669;245940;203076;427;83648;55894;1667;613209;157285;10;252969;100132396;392188;5157;613211;1668;5108;140596;100133267;10395;100133251;85002;91694;9108;137075;57604;64478;728957;100131608;1671;640;286046;79660;2222;29883;6542;55174;7991;653333;55326;94137;9,90,0.52075452702036100000
chr2,39193,4234087,4194894,1,1,7837;23040;51112;54221;26751;285016;7260;78989;55821;55256;6201;642273;728597;7173;246243;129787;52,17,0.40525457854239000000
chr22,18255562,21949299,3693737,1,1,54487;27037;7332;9342;29801;65078;10587;1312;6545;8214;7290;421;2812;645426;6899;5625;7625;55670;79680;637;23119;64976;11274;6576;3053;8218;5413;80764;23617;400891;1399;7122;150209;128977;8220;388849;84861;7353;51586;2928;51807;128989;5297;9127;150221;9993;54584;91179;85376;8216;440804;85359;8318;728229;57553;5902,56,1.51607978586456000000
chr17,34817222,36168245,1351023,1,1,26574;284099;9326;284098;11072;6928;79154;79922;3975;11276;79893;11056;6871;31;80179,15,1.11026977334953000000
chr7,114599717,159088636,44488919,1,1,2041;29923;51691;136242;135941;7791;168537;9296;84691;389602;11194;4708;57180;51384;4698;4233;27044;857;346528;168391;6742;26211;6718;23554;51422;154865;349136;9747;55303;155051;26266;27147;346517;168544;26958;10061;100128553;7982;402317;55112;100463482;730130;26157;4232;55365;8427;91584;54480;154790;100507421;6561;64761;389549;155054;154791;7472;57464;2636;9311;100130880;23534;10922;135935;202865;2051;7516;136371;346653;51200;3663;155038;84626;140545;5304;84928;26;155061;392843;6469;5764;54927;55503;23165;8976;155435;55340;83590;64327;3792;7328;231;142685;5078;9715;136051;7988;2861;3751;4899;285973;442721;5420;285971;10049;168433;57488;858;114960;373156;340307;136541;58508;5799;80853;29062;643641;10157;1357;8972;8454;136991;378925;9601;27010;1020;23145;93664;26047;84255;100287482;100289678;653857;23608;50831;57189;2146;78996;170575;401427;4289;338398;100527949;154872;155066;155006;23382;95681;254048;60412;25913;168850;90956;64764;259285;8805;3952;83992;647087;79989;494551;100130705;22797;136263;84912;63917;92092;3361;441294;835;23553;7434;51530;285888;340348;50832;54892;393046;136319;767558;1180;65999;2918;474344;135927;800;346525;93979;442361;136259;5803;56302;135946;1129;3638;3757;51650;29803;64434;259287;135948;5726;64101;79571;392138;100996928;54429;55131;55798;27153;57541;57016;3614;79974;1080;1804;10447;29969;57670;51631;23601;22976;5644;3110;6916;28996;116988;401409;26136;830;6677;346689;381;113763;29999;441282;28959;669;64753;813;9690;6604;136332;55281;673;50617;9162;100507507;93432;346673;389558;401399;56829;56311;6009;1358;7984;100142659;55750;2020;23008;340351;2318;259286;285966;5919;51667;135924;50833;4850;6608;130075;6522;4846;54556;611;135932;136306;445328;375616,279,0.62712245267186700000
chr11,196966,20699612,20502646,1,1,11187;5719;272;4676;23258;117195;114879;3265;23538;390093;340990;4046;10612;120065;6050;4586;160287;54472;1315;1850;119678;4654;57053;120793;5140;171389;1509;102724957;390066;401667;79608;401665;84953;387733;338707;55031;119679;3630;3767;55742;6343;9866;4588;6288;282763;51700;119772;9645;10581;6881;440026;53841;101927503;60626;406;390054;390075;120237;10077;8045;390078;10894;81532;81846;79751;387755;283232;23378;120066;23075;144100;119694;79473;143496;5741;8590;6289;7054;84067;430;23410;10196;6157;390037;120796;7251;283297;56674;6786;723961;887;10083;4745;103344718;390081;402778;6737;143502;1262;59307;390067;338440;6888;390079;387266;29125;259249;119687;81285;390072;387264;10346;55128;85363;374378;9646;401666;7465;6207;113746;115399;117194;116534;7106;3045;255725;4928;64787;10944;1028;79339;120776;390077;283106;727897;11234;80162;143425;81490;7762;374383;6240;116969;81282;117196;338755;256329;26515;10553;4583;341277;3746;120775;256892;390038;10527;143630;8642;65975;338322;84867;5441;5002;56676;79733;5003;340980;84280;322;7140;51272;390058;160298;23647;6833;144108;22800;119682;89797;90019;56673;26297;113174;8519;7275;100528017;796;112464;54503;6291;53840;3939;390064;4925;390036;445372;341276;3665;390084;347862;143501;79345;119692;3046;1200;283298;10410;417;8048;119774;4004;977;10078;386746;3043;3611;387748;161;1815;29850;119695;56675;55293;56547;283229;390063;144125;50862;10335;5682;6609;26496;797;66005;101927423;439915;120787;50613;133;7136;100463486;8495;55367;283111;117854;144124;833;120227;3784;8665;391;3047;3948;27288;440023;440021;2965;6150;63875;390083;9024;7003;51286;5286;7166;27122;6764;196335;144132;283284;27315;3263;644943;84188;6181;55553;3048;338323;9152;56672;144110;1982;7262;390059;7702;58486;57661;3481;10522;10418;975;79324;390061;57758;7761;338751;57104;7748;143503,299,1.45834835172007000000
chr2,95530631,243068396,147537765,1,1,1493;6335;129831;151258;1285;56171;79582;51661;6694;5000;284996;3234;130916;8576;389058;9541;150681;150483;2641;151050;5334;6670;25953;80097;248;1386;91752;9208;64965;10913;408029;64114;79634;10018;1419;7277;6574;81618;80255;54575;285193;80146;84220;130340;80326;100130451;3329;1123;6120;1261;843;8837;5510;150472;29842;79712;55759;375287;255101;4705;9392;150677;6160;9360;4719;23549;1286;26504;646960;55571;22837;200539;80705;7852;547;55054;92104;84524;7141;8527;55686;220988;471;2820;65124;92196;9936;389075;3800;8708;4999;7035;5077;3625;10254;6364;84639;6819;100288695;54842;4780;5798;57590;65065;26525;60482;8828;8809;2888;1674;55289;79781;129880;56475;8324;6295;285180;10056;653275;130399;10787;55183;344148;64844;1134;9595;93349;51719;151230;26225;7535;165215;431705;151011;9448;116093;3431;7130;391475;10123;51665;257407;253782;151112;785;10120;6326;130574;92737;4691;130560;518;375318;10651;3577;729540;65062;65061;51052;55997;151254;1418;285175;10058;164781;84365;58190;55355;11138;130752;79054;3938;2019;22868;343990;23332;5163;3557;284992;65977;1420;7273;7475;151278;9320;11262;9470;79853;25972;54891;4065;285093;3553;130540;5136;84269;129450;580;7857;2863;79083;1412;5624;100144595;54578;4709;376940;3176;84804;10213;25992;91409;29789;3635;3667;1781;2825;66008;55240;23192;56918;10494;150465;84874;129881;55437;7849;659;25791;3631;50649;65080;8886;29926;130940;130132;164832;51776;51141;344558;60491;7520;1593;4759;14;140469;1421;130026;140739;101929926;2817;1615;51455;57405;79828;3336;23020;3549;274;1195;130074;7145;23704;646915;445582;7851;80055;54600;3655;116255;2071;85461;2487;27013;130367;8942;3694;151295;389084;728294;129446;4880;130749;23505;130507;11250;55683;100526664;64708;339768;3238;100526832;26058;84910;3267;2859;64284;10267;26122;389072;731220;6556;189;3237;140738;375298;55619;2181;11132;402117;117583;8436;2043;493911;55041;55137;54577;339761;7247;151242;4664;4430;8604;3357;165100;4249;55777;79901;3300;10920;80219;9427;80704;1841;57730;81615;57703;54520;57695;699;150696;27179;6344;200765;905;56947;11159;2571;113457;1745;55022;653192;92691;130576;150763;6744;65059;5455;4648;10152;841;11069;375248;130617;10290;150590;1281;84289;3623;728378;29798;55660;3760;84812;79065;10316;93010;83879;23363;80034;79800;8808;29994;151188;55230;493753;129531;2274;10170;64320;2335;10190;23550;50485;57520;5270;1933;5757;57471;8575;200407;254773;1385;5903;6323;53353;23677;92;2744;10324;8807;51239;84236;377007;7850;6328;100131211;285190;54910;55843;84084;3236;151313;165257;84417;3987;30061;100996693;22930;150771;10746;9839;2736;4632;58538;339766;129684;33;9111;79919;375316;79137;3231;9330;5746;3579;6741;1803;2840;130888;9874;25843;151306;11249;3235;9262;56300;151176;26003;3417;57683;51602;10314;8685;8647;79411;56886;4760;84620;9669;3232;84281;53938;10109;80775;3899;2591;26010;4036;1329;6168;57669;617;254042;7429;200576;80731;84083;54659;50940;30818;653489;129868;55139;27347;653781;10865;114805;64859;151246;8609;55502;6332;55854;26275;250;79595;9290;26146;79134;5147;114793;5707;55677;142679;80895;79843;25801;51601;23671;4175;285172;91526;57007;129807;151525;23397;129401;79675;51540;92856;54529;200350;10477;51011;80067;389073;11320;57282;6672;7855;1844;80210;653784;8745;84317;57624;3554;6549;83607;389015;7456;9855;54658;7549;9173;344191;26154;5433;90;5899;150737;53632;130827;10010;339745;2995;55825;442038;57574;54579;80856;84128;66037;27148;400986;55627;100131390;23451;151195;285141;51454;151556;57140;114880;8540;2066;8502;54657;2637;389090;92935;91404;29081;23314;1373;1290;54738;3069;129804;10096;117581;3485;1146;29851;3628;22807;3685;79031;1622;9654;129530;151473;80122;150678;8520;151126;4735;401036;9486;79568;165055;112714;27178;390;116987;81562;3769;205327;3233;55339;150864;150786;90134;100529241;116372;150468;51263;5775;6508;9391;5937;51252;10461;94101;401027;7341;54431;5378;8440;4118;3676;666;285025;79586;23190;4867;9125;653437;64090;57628;8452;96626;10716;56910;6775;10203;57404;114790;90342;130612;26505;22925;494513;57679;3552;414061;1144;9759;129563;130013;653269;51078;6772;4703;150709;9394;11227;1746;4862;54576;64135;344561;200373;8864;9689;130535;151531;2660;79840;80309;80303;727851;1293;23178;55654;115677;200726;5133;8941;940;84172;205147;27249;151194;3488;130355;129521;27233;90557;55515;151;23518;7701;79074;27177;4929;316;84826;100652824;251;64969;79809;57818;3239;57181;64682;64172;2191;200403;55679;93082;375307;4133;51281;26469;9648;50636,748,0.50698883773927300000
chr2,39193,89050447,89011254,1,1,307;150684;114818;83439;79833;4084;285148;100526794;729857;9655;375190;51692;6382;388962;84865;54454;11037;3777;200634;51652;4613;9577;9784;57665;92749;11321;3797;129787;8853;1058;200504;84168;51112;165545;130162;339779;51374;8491;23233;78989;4211;5966;84913;84279;338;8291;27302;130271;28951;6546;27248;9014;100271715;8884;10578;129852;52;1788;9781;151393;388969;23160;9581;728819;56603;344018;9736;200734;253558;6233;347730;2034;6869;80304;84140;151516;200558;6936;23177;84226;85465;10890;2646;7837;55622;94097;5342;165082;23040;6432;165530;5443;238;4072;5013;348738;23498;8462;3241;7360;1838;84759;344387;6201;4148;55471;2202;2281;130106;8802;10736;90957;150726;525;6439;50618;9270;5610;5500;4190;25806;84173;9792;388951;10887;9741;84908;10618;9419;9553;151056;129285;55252;7173;7444;79635;5495;2168;100129278;51449;26056;2956;3196;6683;4358;5194;151449;64795;55258;3795;391356;130497;26160;151354;3398;6654;10438;79954;10408;10199;7514;57835;200424;80745;64241;150946;11017;93034;5496;10669;9540;7072;1653;65055;22934;642273;165140;51315;9027;1876;63892;27332;2355;5281;10574;5343;11036;494143;56287;400966;81606;2677;150572;114800;926;55818;55233;57162;822;57539;55821;130733;64080;87178;27429;3754;285126;25780;7498;10797;9381;85474;56660;4144;55006;3030;56888;388939;27436;10575;678;54221;9637;84542;348654;170850;9168;1716;55256;6716;57223;23301;388946;339778;54465;64225;729967;2492;25885;64395;10971;5967;6711;129293;3032;286749;253635;80059;6801;8446;8890;22950;5068;84141;150962;84693;119;100302652;130502;285051;22924;5341;388963;79677;129607;5093;91461;30845;51130;7349;55133;9378;64838;51639;9913;344167;23198;9167;51255;4436;116540;79998;58484;1545;200728;109;5968;54978;84058;83444;23369;5212;6509;150921;72;55704;790;2976;284948;23620;51057;10602;400961;51232;339804;54497;7841;343930;6496;116143;84450;57448;100505876;51002;4528;4052;7260;729475;440854;2673;51646;64240;165324;54980;11117;728597;57159;22848;1496;54867;51542;1961;9938;84661;3790;3099;130814;55577;10678;10322;54812;129303;8673;7781;554251;7840;129642;90411;64342;130120;57504;25927;100526767;165186;55676;64895;55120;60526;81553;56655;56896;84696;10128;51318;22979;113419;130589;130557;26751;285016;805;10936;112942;10097;51594;7039;56902;9475;9687;25940;3973;98;391365;50489;4953;10153;92906;90423;6242;23683;5581;130872;10617;245973;400950;91543;23175;6664;1768;200523;375189;7447;57498;9801;29094;92291;80204;130951;400954;100128731;79745;79823;130813;550;344022;64427;53335;6241;245711;5861;10713;10505;6697;51072;10130;79623;23433;925;54884;29959;23559;2016;246243;6637;25797;388931;57142;192668;653140;84272;10791;51626;388;9451;57217;10989;27247;7844;1639;8648;79172;84695;60509;29841;388960;8869;6519;51277;1796;6868;3344;5534;55037;10113,464,0.52128239874027600000
chr9,220253,141102518,140882265,1,1,10171;29952;10422;158293;54863;84960;360203;92014;138240;54886;2220;441478;79937;81605;1164;644019;2800;55064;7743;399665;56654;138241;2395;4686;89891;2315;79695;5991;389792;389761;643596;51510;195828;2733;80709;10488;1056;375748;971;286362;10927;392390;140459;286319;79956;114987;25;79886;6709;100129969;7415;7088;7185;27290;7016;5646;81873;10773;8022;83549;6256;6363;6621;57864;55342;375775;138804;26267;23230;3442;84929;81704;8021;6019;169792;9719;153090;29989;10497;4781;2040;51271;158234;653427;4783;84895;90871;10244;1384;3590;25769;158471;65268;54829;552891;7091;347148;3456;195827;10555;203197;80380;1955;51104;50808;8727;229;5887;259308;3190;51531;392309;158131;114789;23424;5537;10507;9853;158046;8395;7633;286343;548645;286336;7186;11092;441476;3441;94107;445571;5524;55234;169522;883;8518;728747;64855;5774;1029;56254;89882;6835;23137;54881;9380;11064;11091;375704;84270;5069;25920;9925;5900;79048;9615;138311;9827;80142;84302;23413;84131;79813;1761;7357;138429;401546;138805;10439;1757;64768;51280;54875;116225;9833;3293;26130;11093;210;115426;158376;79817;84681;4593;203286;23446;25792;642968;138162;401498;58524;9328;55664;8577;138151;728489;3439;84263;29988;51754;83543;286257;254956;5535;7094;90678;4712;27158;389762;220869;7539;26248;10558;401563;3444;22845;7306;6838;100526694;55958;3443;203328;64922;1515;301;51116;138883;254973;51450;23637;2356;10585;730112;22927;9022;27348;84814;54566;158405;116443;56623;7248;203259;54801;728577;3447;4702;727830;81932;55582;26737;23203;54534;91373;58499;727800;85365;92714;647060;360;169611;768;152006;401548;28989;85014;29991;10912;80010;203260;158399;57171;7295;158062;25934;389730;5079;158358;286204;84641;203238;54107;392392;57706;89853;730098;645961;9329;54840;5568;23731;2649;2902;29126;55312;11046;445815;6887;401565;90865;83744;2844;123;9830;3449;23511;26995;9373;3467;441457;55357;10952;441459;286256;157927;59335;92949;91283;51552;158135;9550;57720;10319;4799;8434;7410;2176;1025;2790;203228;727905;56033;51117;254295;1612;26206;6850;733;441425;29085;5082;7111;9991;53358;90120;3446;5998;100129385;286365;158056;11168;26301;2776;445;56751;57704;54187;570;6013;23245;57589;80173;92400;392399;22954;402381;9933;54932;23196;9314;3371;2218;347273;7099;23071;11217;6136;375743;55151;2889;116224;10592;158067;23299;389799;26578;286380;79269;10210;4915;1759;51148;2189;6461;54796;158248;1842;10444;158326;6096;84688;10541;158431;727;3309;23452;6456;1211;27130;3717;9919;389812;140803;2592;55833;259;23349;320;158219;2731;253650;1271;10280;27090;27240;10020;56656;216;9568;54461;1903;9350;1306;340485;10850;881;100499483;2934;8721;7169;158038;55363;158427;84726;79987;64420;26149;255220;375759;653404;8555;401562;441430;441452;8777;55335;6837;7436;392391;338376;138065;573;25861;10807;55848;23099;2021;51759;55014;64975;10868;158158;27019;30968;2683;54926;9413;22869;774;5695;158055;401494;2650;5711;401505;23189;26735;138802;246184;687;80256;9414;26012;1993;203245;286207;169693;401551;80036;54942;83856;54542;138716;138881;549;100505993;403313;10880;9128;401541;6595;84253;65083;347168;169714;219;442425;84210;27433;138428;50514;10783;10670;26190;954;138255;5005;60560;8939;23064;401535;114299;2022;11224;51162;64078;4969;26147;158297;3440;9442;2619;286205;389816;23670;5047;5727;92715;203;3934;11182;3451;158401;9630;84909;5090;256691;6130;375791;5730;11172;152007;22844;5253;389763;389766;4851;138199;5004;10881;23586;138803;57109;3933;54754;100129669;3376;1317;26219;23307;8636;55071;81689;54769;8013;9355;25853;85301;5239;84628;2801;89958;6812;23392;6366;2516;56262;11253;26953;56904;11094;138799;3641;25822;7507;1318;389813;114991;84267;58493;157922;6836;84720;117531;26165;4300;445577;80318;23287;5742;54914;100505478;4958;169834;11258;8328;3452;257019;23552;55755;347252;4920;347240;9858;6505;2219;138715;256158;138307;20;29941;10044;3448;79670;7464;7046;138639;8818;646962;142680;375757;392376;1620;10655;79109;64794;23081;414328;6834;57462;64170;56832;6418;92399;347169;55035;9649;54586;84885;5789;3301;55667;349334;5125;286262;7270;89846;2529;26740;29968;29882;340481;8789;2304;23048;51490;113220;63951;414332;286234;26468;28;389827;1030;57684;4957;2203;318;54662;7763;3445;169436;1902;79095;4882;4814;22949;10811;1514;4507;364;29979;138882;54836;1621;84904;19;6619;7010;51010;54981;8019;23732;6194;10999;30815;1289;377841;1539;64425;169841;55684;403341;10383;944;26086;392307;57582;1861;138724;138474;286223;257169;4010;23404;48;84186;692094;9966;9536,749,0.53164960117584700000
chr17,75582654,81060000,5477346,1,1,339231;84733;7077;26502;147111;83882;79058;6904;57674;9021;2194;100141515;80233;339230;332;55036;2642;57332;57690;284184;57521;10966;51181;9146;146713;57597;9267;9144;6182;114897;79643;100130370;2548;79415;3959;100653515;5831;8632;5148;116729;284129;125058;4097;284001;5833;9775;3607;4884;124583;9123;56270;8535;64118;284207;924;71;283999;284004;25794;51547;1468;400629;79092;5881;5034;124565;146712;201254;5986;10458;79755;339229;2873;22994;57602;284186;396;201255;256933;51529;1453;147138;55666;284131;348262;64122;339221;9489;79701;125061;11322;64772;7083;6398;6448;255275;79672;146705;2837;9625;10189,101,1.84395873475950000000
chr8,89175915,146203229,57027314,1,1,1584;114569;4683;51366;9166;137835;84948;11156;225689;286053;25879;169200;51059;2907;23237;25897;55093;642475;862;6132;26233;2875;3788;203062;83988;6482;4982;1936;80728;51337;23144;286075;528;9401;6156;22827;7038;389690;2738;10404;28998;79977;375686;389677;90987;5462;91147;79139;4609;100533106;57152;340385;51105;29894;441376;64798;8629;55529;100130274;105375787;340359;79815;3646;10940;10584;6383;85453;4856;169044;100130742;137735;5168;65263;340371;203111;4715;203054;84988;55039;55074;114907;8694;392255;23414;642658;79666;81034;340419;115111;137209;100127983;57210;157657;1807;26166;23513;286144;83482;137797;93594;9788;51236;22882;575;7553;7564;414919;2131;10656;55656;56169;389692;84955;5747;26873;2669;84232;8928;729330;4796;7534;4061;286148;10247;50807;169166;157769;79943;1537;6674;25788;8840;79792;441381;114;157638;80778;432355;9831;7264;56943;115908;116039;7381;79870;93100;6788;7373;8767;8581;2765;9684;29967;114822;340390;90990;654463;54704;27012;11244;84294;28991;2843;79075;83696;50484;734;7227;64168;4062;7071;92140;81858;25962;55638;6873;51123;793;79581;1585;8000;83481;114788;84875;312;389676;54108;94241;29028;9134;1345;23246;100132813;27085;51571;9897;286128;157567;1666;1015;51001;137392;3786;54742;9699;84985;54845;90390;22898;111188157;27161;286077;137682;50626;286151;157680;55630;338328;23639;169026;11236;340393;8667;55353;8323;51582;6503;5339;5885;84933;51160;4956;10086;727957;4325;100861412;93035;58500;401474;5440;7201;157753;10221;57623;81501;9694;6641;26986;284;3037;83940;6713;113655;4147;157378;66004;8733;10397;54512;23167;51305;9791;51633;3297;116447,265,0.46468960470416000000
chrX,48141491,52825554,4684063,1,1,729442;64743;6759;9500;10214;389856;170685;727837;139189;392465;778;5935;729431;9502;26748;10013;55190;653220;50943;340602;27344;28952;729447;85417;100132399;7030;729428;2623;729422;89801;4943;56850;79917;2574;9506;64840;10682;3266;8712;729408;81557;6757;494197;100008586;57477;280658;90060;24140;92745;4007;6839;3750;1184;7454;27238;645073;645037;10245;645051;2543;548313;653067;7355;11152;10084;5355;55593;8852;23708;728239;11040;6855;11230;9210;729396,75,1.60117402349200000000
chr2,200278502,200310272,31770,1,1,23314,1,3.14762354422411000000
chr3,93749,16120096,16026347,1,1,7476;23473;285367;3708;79188;6538;23066;9797;29995;80852;5468;8536;132001;23225;84522;3269;63924;2177;55287;56852;25917;115795;285368;6533;285362;6854;131965;27255;7862;8292;6161;51738;78987;9922;10093;7508;85403;55845;57633;8553;375323;10533;51185;55831;9901;79885;23243;6396;9695;7428;23609;4968;491;6419;151835;5894;3568;26140;26061;686;7079;859;7182;84077;100526693;55207;64145;9467;2917;51095;64432;401052;100129480;10752;132014;2199;10474;27258;51066;152330;84818;55209;131474;3656;64419;6529;51244;152273;9686;5021;80746,91,0.56781498615997800000
chrX,41520650,41685447,164797,1,1,8573;2857;27197,3,1.82042148825525000000
chrX,141977992,151335231,9357239,1,1,158521;4110;4108;2564;1260;541578;139065;4109;139067;4104;91966;494119;79057;84631;4103;4534;441525;3423;9248;101928917;2332;100506164;8776;494118;84548;9142;100133053;100129239;2334;203547;139135;728269;4107;100533997;3149;89885;10046;83692;100130086,39,0.41678961069606100000
chr8,7753524,10513046,2759522,1,1,157285;100132396;79660;392188;4482;8658;9258;203074;90459;94137;645836;137075;1673,13,0.47109608113289200000
chr8,12583259,17183509,4600250,1,1,51201;26281;157773;10395;29883;137868;286097;7991;91694;9108;137492;4481;57604,13,0.28259333731862400000
chrX,152351507,154929279,2577772,1,1,8263;1193;492;9130;2157;3054;7411;10134;139728;8517;30848;554;6901;474383;92002;57595;8266;2539;246100;8260;55559;4204;100272147;65991;5365;8277;26576;4354;474382;10838;139735;2316;8273;6535;11219;393;10251;55558;139716;1736;55217;8270;3654;537;3421;5973;100132963;1852;3897;215;474384;6748;4100;2010;474381;6134;116442;2652;1485;1774;60343;728458;8269;83740;5956;2664;633;79184;4515,69,2.67673013749858000000
chr6,1,26116359,26116358,1,1,6745;401236;6239;8335;54901;1832;9750;81853;94234;2296;10048;7172;51522;23408;221662;6568;7913;389362;51439;154141;8352;4835;9972;84830;51000;340156;7280;2822;9521;255626;9450;63933;221711;4739;55003;63971;3720;670;6659;10246;51473;9247;5272;10799;7915;3662;404220;648791;353219;6310;100113407;221687;1871;7020;8737;2295;8358;63915;81567;347744;8366;221710;405754;135458;9425;5269;101928603;51256;56940;100130357;3024;29116;654;3018;84062;51299;54438;255488;10590;8364;2766;51567;10475;10050;55856;81688;8359;2762;1992;2162;9308;8899;8350;221692;56897;51406;347733;26240;3400;10786;10667;2651;154007;4117;57128;378884;1906;3006;9856;63027;3096;222826;285782;3010;107080638;10455;54898;10486;221613;3077;51053;5617;140767;221656;55770;57380;221749;154150;83732;55604,130,0.49777231572641200000
chr3,8681387,13906174,5224787,1,1,7476;55831;9901;6396;79885;7428;285367;23609;4968;491;151835;6538;23066;5894;9797;26140;5468;8536;132001;23225;7079;84522;3269;859;63924;100526693;2177;55287;56852;25917;401052;115795;100129480;132014;285368;2199;6854;10474;7862;51066;6161;51738;84818;55209;78987;3656;64419;6529;10093;9922;55845;375323;9686;5021;10533;80746,56,1.07181402801684000000
chr8,122329490,146280020,23950530,1,1,1584;84948;137835;11156;93100;286053;225689;8581;51059;2907;23237;2765;9684;55093;114822;642475;340390;6132;26233;90990;2875;654463;203062;1936;6482;80728;51337;11244;23144;286075;9401;28991;2843;22827;7038;83696;389690;2738;375686;90987;5462;4062;65265;81858;79139;79581;1585;4609;100533106;57152;340385;8000;83481;51105;84875;29894;312;54108;29028;8629;23246;100130274;105375787;51571;9897;286128;340359;169044;54742;3786;65263;340371;4715;84985;203054;84988;55039;22898;111188157;114907;8694;27161;286077;642658;50626;55630;338328;137209;23639;57210;23513;83482;137797;93594;11236;9788;51236;340393;22882;575;6503;7553;7564;5339;414919;84933;51160;10656;56169;389692;10086;5747;26873;727957;84232;58500;8928;729330;4796;4061;10221;57623;50807;157769;79943;1537;3037;83940;6713;113655;157378;8840;66004;79792;441381;114;157638;80778;8733;432355;10397;9831;7264;54512;23167;51305;3297;116447,148,0.61794039630855800000
chrX,100809080,111920761,11111681,1,1,56001;644353;9949;55916;282808;79868;340595;11043;5354;56156;55998;9643;90843;6906;340547;55859;100996648;203562;340596;100528062;54830;9338;9075;64860;51566;56271;84460;56000;85012;1287;57529;114928;115201;51186;286436;55086;139221;79710;139212;26280;79921;51209;23630;80823;91851;2986;158931;9737;1641;100329135;1288;11013;7224;5716;54470;8471;56157;139231;2182;401612;79589;84707;92129;5063;51309;84443;827;158983;80712;340543;54885;728343;56849;9823;27018;55285;140597;5631;1831;142684;340542;84187;203447;286527;441509,85,0.76496076516235500000
chr15,51618901,62102727,10483826,1,1,81488;92483;9236;29767;23312;8854;10681;100820829;283659;366;5597;55930;145788;145773;5873;256764;29766;3175;56204;6095;54778;256586;29106;10017;10776;161582;145781;102;9133;26108;342035;55329;79811;3990;2958;4644;51187;4643;6938;54816;1588;64864;9245;101928527;54629;27023;79664;663;4734;302;123169;440279;9488;84952;374618,55,0.52461763482148600000
chrX,123105427,123743675,638248,1,1,10735;4068;10178,3,0.47003672553615500000
chr8,221611,9819248,9597637,1,1,389610;401447;728358;503841;1669;504180;26260;55894;1667;245910;157285;245908;100132396;503618;392188;157695;100289462;9228;245909;90459;9920;1672;1668;9172;503614;140596;100133251;653423;645402;100131980;137075;157697;1673;64478;1671;9639;100131608;79648;1670;285;79660;8658;9258;414325;55326;10407;645836;2055,48,0.50012310321801100000
chr8,94320302,104241719,9921417,1,1,91147;55656;7071;92140;203111;25962;7381;116039;51366;79870;54845;51123;6788;2669;100861412;392255;137682;79666;286151;5440;157680;286148;10247;25897;94241;169166;26986;9134;1345;3788;83988;54704;6674;157657;4147;26166;25788;528;6156;55353;79815;10940;50484;157567;51582;10404;6383;85453;1015;79977;389677;51001;9791;7534;4956;137392,56,0.56443550351729000000
chrX,146824301,154908471,8084170,1,1,158521;4110;4108;2564;8263;1193;492;1260;2157;50814;541578;9130;2556;3054;4104;7411;10134;79057;139728;8517;30848;3423;554;6901;474383;92002;4105;57595;8266;266740;2332;8776;29944;84968;2539;246100;7739;8260;55559;4204;100272147;728269;100533997;65991;3149;5365;26576;8277;4354;474382;10838;139735;2316;8273;83692;6535;114824;393;11219;10251;55558;139716;1736;55217;8270;3654;537;3421;100132963;5973;4109;1852;3897;4101;215;91966;474384;6748;4100;55879;4103;2010;4534;6134;474381;9248;101928917;1069;116442;100506164;2652;84548;1485;1774;2334;203547;139135;60343;4107;728458;8269;83740;89885;10046;5956;2664;100130086;633;79184;4515,110,1.36068390447009000000
chrY,1,19722246,19722245,1,1,728403;4267;293;286530;9189;90665;83259;90655;3563;6192;7258;8287;8653;353513;64591;728137;22829;7544;6736;8227;8225;8623;207063;100289087;9087;266;6473;1438;28227;7404;728395;438;64109;9084;55344,35,0.17746458377329800000
chr12,72151703,80893781,8742078,1,1,84698;121278;23390;114882;144321;1466;5074;283310;79738;64786;23011;6857;89795;552889;22822;11010;4673;4659;144455;374462;256710;3747;11103;29953,24,0.27453426976972800000
chr7,72726578,74139390,1412812,1,1,5982;51085;9275;84277;7462;135886;83451;1364;135892;6804;7461;155382;3984;26608;8468;9031;155368;2969;8326;7458;9569;2006;1365;114049,24,1.69873981817821000000
chr22,18919942,21440514,2520572,1,1,54487;27037;9342;29801;65078;10587;1312;6545;421;7290;2812;6899;5625;7625;79680;64976;6576;3053;8218;5413;80764;23617;400891;1399;7122;150209;128977;8220;388849;84861;7353;51586;2928;128989;5297;9127;9993;54584;91179;85376;8216;85359;8318;728229;5902,45,1.78530904889842000000
chr16,66653784,90155062,23501278,1,1,54920;92154;1783;11060;56942;6560;865;84752;25839;11105;2300;763;197320;64779;23659;146212;54496;7571;1535;51693;64146;79007;124044;9914;8720;29109;79152;25894;5336;79786;197257;114780;7567;4157;58189;79583;404550;283927;79791;3294;353;10164;64174;10725;1012;11345;81577;2622;8140;6137;79567;55282;93107;27189;197258;57338;23417;342372;84937;146206;92806;3735;146198;79613;6898;57546;146429;9764;124245;388289;3281;8883;55066;170692;23406;79726;9564;55815;3394;54386;22879;80777;10328;164;27132;6645;197259;10428;51659;440387;57687;124491;51673;10204;84342;16;1013;1014;9057;54768;146167;8717;161882;124045;22980;2653;55512;55336;2294;50855;5681;6483;81631;93517;23035;283848;80262;55159;54957;181;123775;4597;115992;51741;100131303;10143;161931;794;1504;91862;23563;339145;23644;4775;27183;9605;2303;6236;497190;84501;124359;100506581;51647;64180;999;23536;83693;6553;29100;84138;54550;85445;4094;123872;653319;9013;83716;283971;83449;8824;1728;333929;1327;80004;92822;84916;51388;390748;29800;79767;348174;9798;80152;54758;863;146456;28987;123904;9114;23174;29948;4166;23199;1001;1723;1874;26231;463;100287036;3250;80790;100129697;5699;342371;83657;8139;5713;55839;348180;766;283847;84080;54921;23450;1506;53630;9780;81620;7014;55625;5119;3240;54849;10664;57610;29123;55794;55697;55565;57707;440348;197322;3038;8996;2588;23300;57215;23491;3299;55308;65057;9785;118460;100130958;54971;6687;2175;9100;11269;162239;10200;3291;146223;388284;3931;283849;146433;2734;84627;10381;1800;8558;55783,253,1.07653719938124000000
chr17,59937184,63662137,3724953,1,1,8787;80774;9969;8313;1443;51204;974;55852;5705;6329;10672;92340;2688;11232;117246;9902;1655;1636;2081;57508;83990;284021;11325;1442;11011;5175;1444;374819;4215;146779;57003;1534;3384;81033;339175;162333;26115;10238;90799;92335;6603;2689;64750;201134,44,1.18122295771249000000
chr7,72221056,74481540,2260484,1,1,5982;84163;378108;51085;84277;55695;135886;441250;135892;6804;7461;155382;3984;26608;8468;9031;81554;2969;8326;7458;1365;9275;7462;653361;83451;9883;1364;155368;9569;2006;729438;114049,32,1.41562603407058000000
chr2,17153,1551481,1534328,1,1,642273;129787;52;7173;54221;26751;285016,7,0.45622578744570900000
chrY,366288,59311389,58945101,1,1,353515;728403;1617;4267;442868;293;6845;286530;9189;140032;378948;57054;90665;83259;90655;3563;6192;7258;159163;8287;8653;353513;64591;728137;22829;159119;9426;7544;6736;86614;57055;8227;9082;8623;9085;442862;8284;207063;100289087;9087;378950;266;6473;1438;5940;442867;100533178;10251;7404;728395;57135;378951;9081;438;64109;9084;9083;378949;9086;203611;253175,61,0.10348612346936200000
chr6,136293579,139978724,3685145,1,1,64065;5191;167826;340146;51696;4217;85021;10370;345930;113115;9774;23593;57221;9053;57224;167838;58527;3459;25901;59351;100507462;27115;116379;7128;53832,25,0.67839935742012900000
chr7,147315103,154131806,6816703,1,1,54480;27153;57541;84626;58508;65999;474344;643641;1804;168537;8454;9601;155054;1020;26;11194;6009;155061;392843;57180;116988;23145;2636;26047;168391;100289678;653857;5919;51667;51422;9311;55303;349136;155051;113763;63917;55340;83590;28959;2146;170575;6522;3757;168544;29803;4846;136051;7988;10922;10061;202865;100527949;6604;285973;7516;155066;26157;55365;136371;8427;285971;155038,62,0.90953060445790300000
chr2,107159481,113098686,5939205,1,1,5903;96626;10913;7851;6819;344558;65124;100288695;64682;285190;84620;27233;10018;84910;10461;699;129804;3987;442038;60482;55289;9648;151011;376940;84220;4867;729540;165055;84524,29,0.48828083893383000000
chr12,34079810,49237952,15158142,1,1,85437;23519;347902;114134;5213;9416;387856;55605;1280;196527;144165;54934;84216;29843;51535;79657;51564;10138;7421;341567;112;225;283463;29951;84920;51135;1272;283461;121274;9169;81539;3906;91523;144402;140461;80070;5756;144245;120892;8909;4753;784;121273;904;440097;341568;79022;55652;54407;121275;196528;283464;10411;55089;83448,55,0.36284130337346100000
chr22,18938160,21441944,2503784,1,1,54487;27037;9342;29801;65078;10587;1312;6545;421;7290;2812;6899;7625;79680;64976;6576;3053;8218;5413;80764;23617;400891;1399;7122;150209;128977;8220;388849;84861;7353;51586;2928;128989;5297;9127;9993;54584;91179;85376;8216;85359;8318;728229;5902,44,1.75734009003972000000
chr6,136934311,170906766,33972455,1,1,83443;79624;340146;11104;4217;55274;39;154043;50508;2911;51534;117289;4216;2853;9749;4301;57492;85313;55005;3834;80328;23345;57480;9590;2099;6582;51696;135250;10370;8871;84946;404672;2519;28514;23328;5071;56895;153918;22828;53832;134637;64065;26575;57583;84918;10846;4142;81706;4018;135138;167838;6993;7432;23118;5134;5191;100130967;167826;51106;57211;6196;79747;25902;5110;116379;29074;1235;83861;6953;340152;154197;10981;6908;257218;26230;5340;387263;345930;7957;8504;57221;116254;57224;55780;285800;6580;79683;113402;401285;5689;26034;3482;253769;100128124;83887;154064;387082;51429;84498;6648;58527;6950;25901;6862;51660;5325;80129;11116;389434;80329;134957;26271;168002;389432;85021;84624;49861;51390;9589;79465;729515;100507462;7128;3097;9113;348995;54516;9444;57621;84947;80177;6581;54346;79981;168090;7058;6991;4988;94120;7430;84085;7402;23593;8635;4829;3459;59351;353091;8676;64094;10090;56995,152,0.44742130058013200000
chr21,10773805,48095807,37322002,1,1,54148;4599;5316;337882;106865373;1409;54101;9875;1826;9073;386679;874;51227;10950;337970;101928147;386681;56245;54943;643812;326;5121;1476;9946;116448;1292;64699;11077;1827;3150;63977;10281;149998;337973;8566;26046;7307;7113;54014;116159;56683;150094;85395;59271;386685;23515;337878;8624;29980;386683;337979;8568;100288323;54149;6450;4731;6493;539;104;54093;5822;6453;4047;54039;337985;7033;353333;23181;3454;25825;23275;2618;337976;2078;3455;1525;140258;56246;64968;49854;89766;754;3460;6647;54065;150051;58494;80781;7327;10785;337879;10841;54033;3753;337972;6782;150084;643803;728299;9992;386672;5211;861;11096;2897;56894;54084;6285;3689;8209;1859;29104;337960;7485;386676;571;386680;7267;53347;7074;5152;10311;150082;3772;3275;54059;8208;9510;10317;5116;84221;29947;337959;4685;6612;337968;85319;755;1291;351;875;10069;7032;100131902;522;53820;9980;337963;337967;353323;7031;3588;6526;10215;7109;140578;386674;386675;23076;6573;3763;2114;353332;3141;4600;337971;54058;8204;386677;89765;30811;337974;337977;5651;337969;388813;57466;140290;54069;2551;757;10600;90625;7179;23562;26285;10694;23308;386678;337975;337880;100288287;54102;317754;6651;8867;8888;94104;64092;25966;54020;337966;9619;386684;388818;337978;386682;254950;54097;56911;873;29761;284827;81543;7226,215,0.57606770397793800000
chr13,19448845,115105655,95656810,1,1,7027;79612;2862;283518;144809;23026;57213;10426;730249;84945;10804;26960;64881;400165;100129307;7174;113622;4081;9882;221154;3839;90634;54841;1602;11215;10631;29079;5457;386618;3621;5983;122011;56163;5925;341640;5994;10257;2155;221143;283537;8451;27253;81550;107303344;6445;100526761;144811;64062;10208;337867;219409;2308;387921;161003;84056;26224;729250;81624;5100;219287;5101;145173;1045;10166;122183;115825;81602;10240;253512;1361;29103;57511;338872;220081;1024;26278;220416;440145;93081;55270;100129836;2159;6144;54602;2262;9365;9107;78988;115207;729240;79774;2841;26586;9724;55647;387496;10160;6541;729420;8428;220108;84078;5412;51761;55213;9818;675;540;23111;729233;9201;23077;51131;79758;93492;8848;3356;3843;6564;57626;4752;10910;10284;2073;90627;9617;23250;3981;496;54737;79596;26747;10253;11166;53342;219402;84935;259232;1997;57105;79866;1102;11278;728215;2963;26512;643677;387911;3651;688;255967;55835;5911;8660;220107;220082;22894;4008;7278;171425;440138;55901;8796;646625;9205;23281;122046;6656;83548;6555;51569;2259;79587;3146;2322;3916;8874;55757;89890;55608;241;8858;646799;22862;122042;7546;51082;65110;10673;55068;26050;55425;9375;9071;196541;10150;8100;122060;253832;8803;266722;27199;140432;4285;55504;170622;1282;1948;542767;122258;51028;267012;7347;221178;10562;10443;84899;83446;479;79070;1284;400120;2098;4093;10186;94240;283489;23263;55269;1203;55739;387923;283514;23483;2835;80209;5611;3936;10808;79024;2321;85416;348013;100533467;54937;160897;51084;55795;8900;22873;341676;7178;1880;101928841;55578;29880;23348;2254;387914;2706;10206;6049;23143;9358;115761;26524;219333;84189;87769;10082;643365;10161;55002;728591;84650;64328;23078;28984;7223;11061;222484;647174;6011;51371;83852;22821;144983;79621;23047;10129;221150;1910;2700;2621;729246;10464;114798;121793;143;81617;160857;11193;160851;10810;7750;55082;5095;9445;5042;1638;8881;8600;55208;23091;2971;80183;11340,317,0.33139302889151300000
chr21,15480359,48095807,32615448,1,1,54148;4599;5316;337882;106865373;1409;54101;9875;1826;9073;386679;874;51227;10950;337970;101928147;386681;56245;54943;643812;326;5121;1476;9946;116448;1292;64699;11077;1827;3150;63977;10281;149998;337973;8566;26046;7307;7113;54014;116159;56683;150094;85395;59271;386685;23515;337878;8624;29980;386683;337979;8568;100288323;54149;6450;4731;6493;539;104;54093;5822;6453;4047;54039;337985;7033;353333;23181;3454;25825;23275;2618;337976;2078;3455;1525;140258;56246;64968;49854;89766;754;3460;6647;54065;150051;58494;80781;7327;10785;337879;10841;54033;3753;337972;6782;150084;643803;728299;9992;386672;5211;861;11096;2897;56894;54084;6285;3689;8209;1859;29104;337960;7485;386676;571;386680;7267;53347;7074;5152;10311;150082;3772;3275;54059;8208;9510;10317;5116;84221;29947;337959;4685;6612;337968;755;1291;351;875;10069;7032;100131902;522;53820;9980;337963;337967;353323;7031;3588;6526;10215;7109;140578;386674;386675;23076;6573;3763;2114;353332;3141;4600;337971;54058;8204;386677;89765;30811;337974;337977;5651;337969;388813;57466;757;54069;2551;140290;10600;90625;23562;23308;26285;10694;386678;337975;337880;100288287;54102;6651;8888;8867;94104;64092;25966;54020;337966;9619;386684;388818;337978;386682;254950;54097;56911;873;29761;284827;81543;7226,212,0.64999873679490800000
chr21,15485038,48090352,32605314,1,1,54148;4599;5316;337882;106865373;1409;54101;9875;1826;9073;386679;874;51227;10950;337970;101928147;386681;56245;54943;643812;326;5121;1476;9946;116448;1292;64699;11077;1827;3150;63977;10281;149998;337973;8566;26046;7307;7113;54014;116159;56683;150094;85395;59271;386685;23515;337878;8624;29980;386683;337979;8568;100288323;54149;6450;4731;6493;539;104;54093;5822;6453;4047;54039;337985;7033;353333;23181;3454;25825;23275;2618;337976;2078;3455;1525;140258;56246;64968;49854;89766;754;3460;6647;54065;150051;58494;80781;7327;10785;337879;10841;54033;3753;337972;6782;150084;643803;728299;9992;386672;5211;861;11096;2897;56894;54084;6285;3689;8209;1859;29104;337960;7485;386676;571;386680;7267;53347;7074;5152;10311;150082;3772;3275;54059;8208;9510;10317;5116;84221;29947;337959;4685;6612;337968;755;1291;351;875;10069;7032;100131902;522;53820;9980;337963;337967;353323;7031;3588;6526;10215;7109;140578;386674;386675;23076;6573;3763;2114;353332;3141;4600;337971;54058;8204;386677;89765;30811;337974;337977;5651;337969;388813;57466;757;54069;2551;140290;10600;90625;23562;23308;26285;10694;386678;337975;337880;100288287;54102;6651;8888;8867;94104;64092;25966;54020;337966;9619;386684;388818;337978;386682;254950;54097;56911;873;29761;284827;81543;7226,212,0.65020076175313000000
chr21,15485038,48090352,32605314,1,1,54148;4599;5316;337882;106865373;1409;54101;9875;1826;9073;386679;874;51227;10950;337970;101928147;386681;56245;54943;643812;326;5121;1476;9946;116448;1292;64699;11077;1827;3150;63977;10281;149998;337973;8566;26046;7307;7113;54014;116159;56683;150094;85395;59271;386685;23515;337878;8624;29980;386683;337979;8568;100288323;54149;6450;4731;6493;539;104;54093;5822;6453;4047;54039;337985;7033;353333;23181;3454;25825;23275;2618;337976;2078;3455;1525;140258;56246;64968;49854;89766;754;3460;6647;54065;150051;58494;80781;7327;10785;337879;10841;54033;3753;337972;6782;150084;643803;728299;9992;386672;5211;861;11096;2897;56894;54084;6285;3689;8209;1859;29104;337960;7485;386676;571;386680;7267;53347;7074;5152;10311;150082;3772;3275;54059;8208;9510;10317;5116;84221;29947;337959;4685;6612;337968;755;1291;351;875;10069;7032;100131902;522;53820;9980;337963;337967;353323;7031;3588;6526;10215;7109;140578;386674;386675;23076;6573;3763;2114;353332;3141;4600;337971;54058;8204;386677;89765;30811;337974;337977;5651;337969;388813;57466;757;54069;2551;140290;10600;90625;23562;23308;26285;10694;386678;337975;337880;100288287;54102;6651;8888;8867;94104;64092;25966;54020;337966;9619;386684;388818;337978;386682;254950;54097;56911;873;29761;284827;81543;7226,212,0.65020076175313000000
chrY,116314,59337360,59221046,1,1,1617;6845;286530;378948;83259;7258;159163;8287;9426;86614;57055;8227;8284;207063;100289087;378950;5940;442867;100533178;10251;28227;7404;728395;57135;378951;9081;438;9084;378949;9086;203611;9085;353515;728403;4267;442868;293;9189;3581;140032;57054;90665;90655;3563;6192;8653;353513;64591;728137;22829;159119;7544;6736;8225;9082;8623;442862;9087;266;6473;1438;9083;64109;55344;253175,65,0.10975827748804000000
chr16,29652360,30199696,547336,1,1,653808;5531;26470;283897;253980;146378;8479;83719;23475;283899;124446;9344;3835;4150;226;253982;83723;5595;6911;11151;8448;79447;112476;9961;10423;6693;79153,27,4.93298449215838000000
chr5,146528261,162446210,15917949,1,1,133522;5159;22993;340075;348938;51164;9685;26762;2890;55696;9337;9232;7265;285643;134353;154;134266;1044;815;1879;79616;147;153830;6208;408263;1436;134510;6690;23120;63920;3593;85027;10569;202374;22885;6534;8728;81545;206358;29093;55568;91937;1809;10146;56923;84651;389337;81789;25929;6678;3360;153201;2561;27190;117156;2760;285641;972;54974;2878;3702;134265;643394;114825;79685;345611;2196;91977;4238;9421;6949;3340;2741;84868;153745;6444;1836;11005;26112;2566;2554;5145;23367;26999;2559;10827;1452;11346;9832;9443;10318;114898;91975;10826;79628;404203;408187;100190949;11063;78991;389336;153218;2172;475;309,105,0.65963272027068300000
chr17,16595418,20294010,3698592,1,1,2314;9720;55244;125170;55090;11216;79018;79999;645027;10400;54890;254272;9706;92521;8533;22905;729288;5598;218;23164;83450;224;51168;80039;51655;201163;7156;51030;5636;644815;10750;10517;654346;10743;388436;27077;100129396;140775;6470;146691;1819;6720;125206;23495;147166;7732;146802;91647;56953;201164;400581;3996;4239,53,1.43297773855565000000
chr2,172679936,180914725,8234789,1,1,3235;1123;129831;344191;51776;150737;3232;3238;51661;57703;3236;4780;3234;8520;151126;83879;494513;9541;518;80856;3237;1745;10651;100131390;6670;92104;151556;3239;1386;114880;254042;29789;3233;8540;220988;50940;79634;91404;1746;3231;3655;11069;1134;5163;8575;285025;8604;65977;7273;7456,50,0.60718009896792700000
chr22,18894820,21722313,2827493,1,1,54487;27037;9342;29801;65078;10587;1312;6545;8214;421;7290;2812;6899;5625;7625;79680;64976;6576;3053;8218;5413;80764;23617;400891;1399;7122;150209;128977;8220;388849;84861;7353;51586;2928;128989;5297;9127;9993;54584;91179;85376;8216;85359;8318;728229;5902,46,1.62688289590814000000
chr16,29652360,30195986,543626,1,1,653808;5531;26470;283897;253980;146378;8479;83719;23475;283899;124446;9344;3835;4150;226;253982;83723;5595;6911;11151;8448;79447;112476;9961;10423;6693;79153,27,4.96664986590045000000
chr6,52558038,74525882,21967844,1,1,2939;23469;135228;54511;81578;51715;79627;100463487;55510;5558;22858;60481;2941;3062;115004;653;221357;80759;26503;389400;441161;135154;56479;667;22999;202559;577;135152;221336;441155;51557;25821;55788;1310;90523;60682;340168;401265;2940;346007;57579;55227;222584;2938;1297;8521;154288;7803;57691;100129128;27283;9532;26036;2729;26268;1915,56,0.25491805204006400000
chrX,51094902,63073549,11978647,1,1,23096;7216;90736;550643;64061;9500;139886;7789;139793;280658;727837;3028;170627;727866;23229;10916;9502;100463488;158880;54552;158586;139628;8243;10075;286430;55190;653220;8242;340602;11279;29978;474343;28986;212;23133;54328;158584;203569;81557;27301;54954;65267;2245;90737;653067;90121;389860;23708;158787;10325;54466;728239;347365;5207;169981;6757;170626;494197;29057,59,0.49254310607867500000
chr10,46405262,51804955,5399693,1,1,5599;644168;267004;8031;195977;100652748;9721;83849;642517;57705;474354;170371;118738;653145;5949;644054;414189;100133093;728113;5540;143162;6572;2662;26095;118461;282966;58504;100287932;8505;2658;1103;2074;170370;4477;196740;55753,36,0.66670457005611200000
chr1,146507649,147825519,1317870,1,1,9557;51205;51463;5565;607;2702;2330;200030;2703,9,0.68292016663252100000
chr13,113749424,115077925,1328501,1,1,7027;55795;79774;23263;3916;22821;8858;643365;55002;101928841;2621;2155;6011;2159;55208;113622;496;348013;8881;65110;8451,21,1.58072895692213000000
chrX,166314,155246643,155080329,1,1,23096;64061;392509;10214;170685;23157;727837;55998;23439;729431;10916;158586;55859;331;3423;54830;4168;6901;5358;92002;27344;729447;54328;266740;9075;102723737;7552;729422;54954;84460;389874;56000;340562;644538;92552;254158;79649;56850;8225;2824;100272147;51186;3149;26576;100130361;1730;347541;139425;3547;728695;729408;79921;57826;59272;203413;2986;7512;9737;8544;55634;2857;3421;537;11013;340554;5716;6658;4101;54457;1438;91966;441519;4100;5931;27316;7403;4534;6839;51480;728096;27112;92129;101928917;140462;8241;6567;827;203569;27301;84548;645037;54413;100133053;7355;254065;79836;10084;347442;60343;51765;55593;139818;56180;6303;8269;142684;7626;10046;8409;203447;63932;2710;4515;8406;51248;56001;51616;2925;100130613;2564;1193;100132994;5354;11043;340533;22;3476;84631;26748;11238;203562;102723631;170261;58526;441525;4983;29944;6907;1536;2539;1478;9468;23597;2187;1287;81887;6611;3561;9767;9282;54857;347365;10800;139341;54539;11219;728062;169966;51209;23630;26548;1121;2000;645188;51438;2846;280658;1852;347344;23229;10857;56157;286430;101059915;438;5277;9758;1069;4674;154796;56548;51309;1184;645073;80712;1774;10245;2258;728343;9823;441531;11141;643311;90121;256643;23676;4114;6758;4107;286499;5009;1654;1831;51284;94121;170302;11230;79135;286410;9210;2491;441490;84187;633;6191;64743;4110;3598;389856;7789;55787;9452;50814;2157;139422;170062;57187;139067;4104;203427;4693;5456;10013;1964;55190;100996648;293;9016;100528062;30011;90316;93953;10178;6322;28952;24137;2332;4105;6845;94122;84968;64663;1538;9142;286530;2245;5634;9506;79576;3266;139212;5207;6535;8227;393;389852;170626;91851;27334;158866;550643;159013;407;7224;55796;10761;100132963;168400;4281;158835;24140;8471;90167;7737;7319;10149;11279;6134;64109;1678;139322;5063;55906;116442;84443;27197;8233;548313;6872;27018;100129239;139105;7102;10549;26071;2664;59353;8573;28985;79184;728049;728090;158521;3581;139886;282808;8263;9130;728082;778;90843;1756;5422;7317;5935;347454;29071;207063;4112;412;158506;340602;30848;5127;22866;93380;159091;10159;212;139285;9338;85417;8266;100132399;158584;494118;190;7569;89801;2892;1968;5230;57232;55559;57529;8277;63035;80231;286436;25975;51311;8905;55086;139735;395;83692;171484;10251;169981;1349;63904;139716;257397;142689;80258;27035;1641;55613;7105;100329135;84295;9459;4810;404281;4109;367;474384;6748;139760;347487;92745;158830;53344;4103;9203;139378;186;474343;2719;3597;140456;9248;402415;203430;9185;90161;728042;4129;65267;56849;8228;8226;728036;7114;6399;4952;83740;84889;8481;6757;347468;347475;414;6759;9500;51132;8823;541578;2158;55609;2556;494119;6756;9502;158880;8517;8242;474383;57595;51442;389895;100132304;9754;80311;6102;27328;695;56159;51213;90737;60506;10943;100873985;57526;728269;170082;474382;102723680;728656;3358;8273;83844;114824;389840;170067;81557;80823;8862;2002;7216;79979;158763;23641;55217;8270;57477;7592;2833;425054;340526;727866;139599;139804;54470;8450;959;139562;645864;10075;117154;57631;2010;54521;79589;51634;3750;653282;728072;7076;392490;9363;8623;3920;347411;7454;100506164;265;90293;645051;100529097;55511;158724;6197;203547;139135;5355;347516;203522;139081;6451;27336;158787;728458;7499;4841;347517;51360;340578;139596;1896;441509;54466;660;158798;4108;171482;79868;728075;158833;79366;1821;56156;392465;1260;5160;56062;5303;3054;51260;139628;653220;340596;554;28986;23133;57393;2623;28227;4113;57692;50945;3730;7739;100131755;57481;8260;139170;64219;4204;389860;2574;3563;65991;10325;6170;10813;79710;8712;26280;2316;256714;10742;6173;9104;494197;29057;139324;442444;6103;54880;90736;55558;2742;1736;369;255313;3654;170627;645974;3897;79983;727940;541466;347527;8243;4007;139741;29978;2182;7504;60401;84707;53336;1485;159090;94056;57502;55285;653067;1046;11152;641339;1947;8852;7712;23708;203523;4267;54967;340542;89885;2277;83550;644353;55916;340595;6594;139189;63947;9643;9843;4935;139728;100288814;10479;50943;53940;55026;100507170;5638;4478;8239;4068;51114;139411;246100;9968;84679;115201;100533997;1741;416;64840;10682;11326;25763;27330;171483;8908;27286;1038;7543;158800;90060;1288;84061;215;6247;292;55879;401612;1183;340527;55344;29935;158983;357;10009;2747;2652;286514;340543;54885;100129407;10495;6792;79742;140886;2239;2334;4128;441518;139604;4303;55869;25878;4115;11040;8473;6855;84636;55922;728712;5956;2705;55841;54821;729396;441521;8933;10735;729442;9949;4694;84528;51481;492;3028;100129520;795;10389;83604;7411;9947;9367;100463488;10134;79057;54552;6906;340547;30014;415;5255;680;158809;6990;4435;5475;340529;65109;64860;7030;729428;8776;4675;5030;51566;729201;56271;4943;79917;85012;114928;5256;26609;54960;538;6853;5365;4354;286451;29934;10838;139221;9189;347404;6473;3251;286464;158931;139793;100008586;2717;3052;5973;139065;5199;546;5613;51270;139231;9131;7547;474381;257240;11254;27238;64102;2543;158747;2273;56474;5165;64648;54440;140597;5631;728239;3188;100130086;5251;8237;286527;100130302,815,0.52553409272171500000
chrX,166314,155198505,155032191,1,1,23096;64061;392509;10214;170685;23157;727837;55998;23439;729431;10916;158586;55859;331;3423;54830;4168;6901;5358;92002;27344;729447;54328;266740;9075;102723737;7552;729422;54954;84460;389874;56000;340562;644538;92552;254158;79649;56850;8225;2824;100272147;51186;3149;26576;100130361;1730;347541;139425;3547;728695;729408;79921;57826;59272;203413;2986;7512;9737;8544;55634;2857;3421;537;11013;340554;5716;6658;4101;54457;1438;91966;441519;4100;5931;27316;7403;4534;6839;51480;728096;27112;92129;101928917;140462;8241;6567;827;203569;27301;84548;645037;54413;100133053;7355;254065;79836;10084;347442;60343;51765;55593;139818;56180;6303;8269;142684;7626;10046;8409;203447;63932;2710;4515;8406;51248;56001;51616;2925;100130613;2564;1193;100132994;5354;11043;340533;22;3476;84631;26748;11238;203562;102723631;170261;58526;441525;4983;29944;6907;1536;2539;1478;9468;23597;2187;1287;81887;6611;3561;9767;9282;54857;347365;10800;139341;54539;11219;728062;169966;51209;23630;26548;1121;2000;645188;51438;2846;280658;1852;347344;23229;10857;56157;286430;101059915;438;5277;9758;1069;4674;154796;56548;51309;1184;645073;80712;1774;10245;2258;728343;9823;441531;11141;643311;90121;256643;23676;4114;6758;4107;286499;5009;1654;1831;51284;94121;170302;11230;79135;286410;9210;2491;441490;84187;633;6191;64743;4110;3598;389856;7789;55787;9452;50814;2157;139422;170062;57187;139067;4104;203427;4693;5456;10013;1964;55190;100996648;293;9016;100528062;30011;90316;93953;10178;6322;28952;24137;2332;4105;6845;94122;84968;64663;1538;9142;286530;2245;5634;9506;79576;3266;139212;5207;6535;8227;393;389852;170626;91851;27334;158866;550643;159013;407;7224;55796;10761;100132963;168400;4281;158835;24140;8471;90167;7737;7319;10149;11279;6134;64109;1678;139322;5063;55906;116442;84443;27197;8233;548313;6872;27018;100129239;139105;7102;10549;26071;2664;59353;8573;28985;79184;728049;728090;158521;139886;282808;8263;9130;728082;778;90843;1756;5422;7317;5935;347454;29071;207063;4112;412;158506;340602;30848;5127;22866;93380;159091;10159;212;139285;9338;85417;8266;100132399;158584;494118;190;7569;89801;2892;1968;5230;57232;55559;57529;8277;63035;80231;286436;25975;51311;8905;55086;139735;395;83692;171484;10251;169981;1349;63904;139716;257397;142689;80258;27035;1641;55613;7105;100329135;84295;9459;4810;404281;4109;367;474384;6748;139760;347487;92745;158830;53344;4103;9203;139378;186;474343;2719;3597;140456;9248;402415;203430;9185;90161;728042;4129;65267;56849;8228;8226;728036;7114;6399;4952;83740;84889;8481;6757;347468;347475;414;6759;9500;51132;8823;541578;2158;55609;2556;494119;6756;9502;158880;8517;8242;474383;57595;51442;389895;100132304;9754;80311;6102;27328;695;56159;51213;90737;60506;10943;100873985;57526;728269;170082;474382;102723680;728656;3358;8273;83844;114824;389840;170067;81557;80823;8862;2002;7216;79979;158763;23641;55217;8270;57477;7592;2833;425054;340526;727866;139599;139804;54470;8450;959;139562;645864;10075;117154;57631;2010;54521;79589;51634;3750;653282;728072;7076;392490;9363;8623;3920;347411;7454;100506164;265;90293;645051;100529097;55511;158724;6197;203547;139135;5355;347516;203522;139081;6451;27336;158787;728458;7499;4841;347517;51360;340578;139596;1896;441509;54466;660;158798;4108;171482;79868;728075;158833;79366;1821;56156;392465;1260;5160;56062;5303;3054;51260;139628;653220;340596;554;28986;23133;57393;2623;28227;4113;57692;50945;3730;7739;100131755;57481;8260;139170;64219;4204;389860;2574;3563;65991;10325;6170;10813;79710;8712;26280;2316;256714;10742;6173;9104;494197;29057;139324;442444;6103;54880;90736;55558;2742;1736;369;255313;3654;170627;645974;3897;79983;727940;541466;347527;8243;4007;139741;29978;2182;7504;60401;84707;53336;1485;159090;94056;57502;55285;653067;1046;11152;641339;1947;8852;7712;23708;203523;4267;54967;340542;89885;2277;83550;644353;55916;340595;6594;139189;63947;9643;9843;4935;139728;100288814;10479;50943;53940;55026;100507170;5638;4478;8239;4068;51114;139411;246100;9968;84679;115201;100533997;1741;416;64840;10682;11326;25763;27330;171483;8908;27286;1038;7543;158800;90060;1288;84061;215;6247;292;55879;401612;1183;340527;55344;29935;158983;357;10009;2747;2652;286514;340543;54885;100129407;10495;6792;79742;140886;2239;2334;4128;441518;139604;4303;55869;25878;4115;11040;8473;6855;84636;55922;728712;5956;2705;55841;54821;729396;441521;8933;10735;729442;9949;4694;84528;51481;492;3028;100129520;795;10389;83604;7411;9947;9367;100463488;10134;79057;54552;6906;340547;30014;415;5255;680;158809;6990;4435;5475;340529;65109;64860;7030;729428;8776;4675;5030;51566;729201;56271;4943;79917;85012;114928;5256;26609;54960;538;6853;5365;4354;286451;29934;10838;139221;9189;347404;6473;3251;286464;158931;139793;100008586;2717;3052;5973;139065;5199;546;5613;51270;139231;9131;7547;474381;257240;11254;27238;64102;2543;158747;2273;56474;5165;64648;54440;140597;5631;728239;3188;100130086;5251;8237;286527;100130302,814,0.52505224543978700000
chr1,146507649,147825519,1317870,1,1,9557;51205;51463;5565;607;2702;2330;200030;2703,9,0.68292016663252100000
chr20,59980369,62952205,2971836,1,1,3785;198437;2832;85441;140685;79025;6874;6725;84619;63910;55738;51750;284739;54915;11255;80331;57473;24148;10732;1917;128408;26164;54345;6919;10139;9885;11047;1299;11054;1002;1137;140700;10287;100132911;28231;4987;149986;26039;11083;8771;4923;55251;54994;128414;57642;50861;140701;3911;5753;55257;5688;6227;7165;128826;140893;26205;79444;140628;56731;54963;4661;79144;54923;81928,64,2.15355086889048000000
chr8,12579094,14797726,2218632,1,1,137868;91694;157773;10395;57604,5,0.22536409823711200000
chr22,16489079,18661758,2172679,1,1,27440;51816;51807;23765;150160;27439;27443;55670;637;529;11274;150165;23786;83733;128954;101929372;57553,17,0.78244416225314500000
chr15,23682019,28559437,4877418,1,1,2562;7681;23742;8924;7337;6638;2567;4948;8926;57194;283685;54551;4692;2558,14,0.28703711676956900000
chr8,56041824,146280167,90238343,1,1,1584;114569;51366;9166;4683;137835;84948;11156;225689;286053;25879;767;169200;137872;51059;2907;157724;137886;23237;4067;25897;55093;11059;642475;862;6132;26233;79776;10565;56704;65986;2875;3788;203062;1936;83988;6482;51101;4982;80728;51337;23144;286075;116328;528;96764;81796;9650;9401;6156;22827;7038;55824;389690;2738;10404;28998;79977;375686;389677;90987;5462;646486;91147;138046;65265;79139;23678;4609;9420;57152;100533106;340385;51105;29894;441376;64798;55636;8629;1581;55529;100130274;105375787;340359;168975;79815;3646;57094;10940;10584;169044;4856;6383;80243;100130742;85453;137735;5168;5150;65263;340371;203111;4715;23643;761;157869;253943;203054;84988;55039;3612;55074;79848;114907;8694;392255;23414;157506;642658;79666;100533105;9312;81034;340419;85444;115111;85479;137209;100127983;8895;57210;157657;1807;26166;83482;286144;55284;8439;286183;93594;23513;137797;9788;84675;619279;51236;64089;5375;22882;2167;575;7553;7564;5324;414919;6129;2131;195814;23471;100130301;10656;55656;54928;138009;56169;389692;84955;5747;26873;23462;10499;2669;84232;79752;8928;729330;4796;7534;759;4061;286148;5569;10247;50807;169166;157769;79943;1537;6674;25788;8840;79792;441381;245972;114;157638;157807;80778;5862;432355;9831;7264;54714;56943;90362;115908;116039;7381;79870;93100;6788;7373;8767;8581;9684;2765;29967;114822;340390;5179;157777;90990;654463;137695;54704;27012;11244;84294;28991;2843;79075;51050;83696;8836;50484;734;7227;27067;64168;4062;54968;6224;1875;7071;92140;81858;25962;55638;6873;51123;793;79581;1585;85481;8000;83481;114788;646480;2138;84875;312;389676;54108;23212;10987;92421;94241;29028;9134;1345;23246;5828;27085;100132813;56260;80124;51571;9897;286128;401466;157567;1666;1015;444;3174;7013;51001;28957;137392;54742;3786;54332;9699;84985;54845;90390;111188157;22898;100129654;7274;27161;286077;137682;50626;286151;157680;55630;389668;7163;9242;83690;338328;23639;169026;55156;11236;23213;286187;340393;8667;55353;8323;6503;51582;3574;11075;5339;254778;5885;84933;51160;2171;51110;63978;4956;4603;79145;10086;727957;4325;100861412;6386;93035;4342;58500;401474;5440;7201;6921;1392;157753;10221;57623;9694;81501;6641;26986;3037;284;347051;83940;6713;113655;4147;157378;66004;51115;760;114786;8733;10397;377677;54512;27319;23167;51305;9791;9760;51633;3297;8989;116447,382,0.42332337596225600000
chr9,204090,14853694,14649604,1,1,58524;10171;23081;55664;89882;9350;50808;158358;81704;23189;5789;6019;286343;158326;1761;169792;55064;6505;29126;2315;4781;5991;8777;340481;26953;90865;7436;3717;90871;6013;57589;157983;3641;7306;403313;169522;115426;6595;79956;9933;2731;55848;11172;10655;80380,45,0.30717553866985100000
chr8,125498075,146280167,20782092,1,1,1584;84948;137835;11156;93100;286053;225689;8581;51059;2907;23237;2765;9684;114822;642475;340390;6132;26233;90990;2875;203062;1936;6482;80728;51337;23144;286075;9401;28991;2843;22827;7038;83696;389690;2738;375686;90987;5462;4062;65265;81858;79581;1585;4609;57152;340385;8000;83481;51105;84875;29894;54108;8629;23246;100130274;105375787;51571;9897;286128;169044;54742;3786;65263;340371;4715;203054;84988;22898;111188157;8694;27161;286077;642658;50626;55630;338328;137209;23639;57210;23513;83482;137797;11236;9788;51236;340393;575;6503;7553;7564;5339;414919;51160;10656;56169;389692;10086;5747;26873;727957;84232;58500;8928;729330;4796;4061;10221;57623;50807;79943;1537;83940;6713;113655;8840;66004;79792;441381;114;157638;80778;8733;432355;10397;9831;7264;54512;23167;51305;3297;116447,131,0.63035039975763800000
chr22,17059296,20312008,3252712,1,1,54487;27037;27440;29801;65078;10587;1312;51816;8214;7290;421;2812;6899;150160;5625;27439;27443;55670;637;64976;79680;529;11274;6576;150165;83733;8218;5413;23617;7122;8220;128977;388849;7353;2928;51807;128989;23765;9993;54584;85359;8318;23786;128954;101929372;57553;5902,47,1.44494809254554000000
chr21,15410475,47959961,32549486,1,1,54148;4599;5316;337882;106865373;1409;54101;9875;1826;9073;386679;874;51227;10950;337970;101928147;386681;56245;54943;643812;326;5121;1476;9946;116448;1292;64699;11077;1827;3150;63977;10281;149998;337973;8566;26046;7307;7113;54014;116159;56683;150094;85395;59271;386685;23515;337878;8624;29980;386683;337979;8568;100288323;54149;6450;4731;6493;539;104;54093;5822;6453;4047;54039;337985;7033;353333;23181;3454;25825;23275;2618;337976;2078;3455;1525;140258;56246;64968;49854;89766;754;3460;6647;54065;150051;58494;80781;7327;10785;337879;10841;54033;3753;337972;6782;150084;643803;728299;9992;386672;5211;861;11096;2897;56894;54084;3689;8209;1859;29104;337960;7485;386676;571;386680;7267;53347;7074;5152;10311;150082;3772;54059;8208;9510;10317;5116;84221;29947;337959;4685;6612;337968;755;1291;351;875;10069;7032;100131902;522;53820;9980;337963;337967;353323;7031;3588;6526;10215;7109;140578;386674;386675;23076;6573;3763;2114;353332;3141;4600;337971;54058;8204;386677;89765;30811;337974;337977;5651;337969;388813;57466;757;54069;2551;140290;10600;90625;23562;23308;26285;10694;386678;337975;337880;100288287;54102;6651;8888;8867;94104;64092;25966;54020;337966;9619;386684;388818;337978;386682;254950;54097;56911;873;29761;284827;81543;7226,210,0.64517147828386600000
chr17,14104811,15442178,1337367,1,1,1352;64518;9953;201158;284040;100533496;5376;146822,8,0.59819032472014000000
chr8,2360584,12700237,10339653,1,1,377630;1508;83650;504180;503841;245910;245908;503618;54984;100289462;4482;203074;245909;90459;1672;503614;83595;653423;645402;100131980;2626;613210;1673;79648;1670;66036;285;8658;9258;414325;645836;389610;401447;392197;728358;1669;245940;203076;83648;55894;1667;613209;157285;252969;100132396;392188;613211;1668;140596;100133267;100133251;85002;91694;137075;64478;728957;1671;100131608;640;286046;79660;2222;653333;55326;94137;10407,66,0.63831929369389900000
chr8,141532950,146280167,4747217,1,1,65263;1584;340371;84948;11156;93100;225689;203054;84988;22898;111188157;8694;8581;27161;286077;2907;642658;50626;23237;2765;9684;55630;114822;642475;340390;6132;26233;338328;90990;2875;57210;203062;1936;80728;51337;23144;286075;23513;83482;137797;340393;51236;9401;28991;2843;22827;575;389690;2738;7553;7564;5339;414919;375686;90987;51160;4062;65265;389692;5747;81858;26873;727957;84232;79581;1585;57152;58500;8928;340385;8000;4796;116447;83481;84875;29894;4061;8629;79943;23246;1537;113655;100130274;105375787;66004;79792;286128;441381;80778;8733;432355;9831;7264;54512;3297;54742,96,2.02223744985746000000
chr18,159555,78012819,77853264,1,1,100526842;1630;23255;57132;125228;642597;84735;284252;5596;7525;84064;284257;1005;83539;6139;101927322;9984;10928;162655;63895;162699;64863;342850;374868;7541;2587;26040;4200;64762;80000;114799;9658;147407;147495;9218;54877;81832;9229;7298;26251;91133;56907;92126;57724;7050;26256;8715;30827;23347;2627;10627;143471;8736;374860;171586;284217;23136;284266;100505549;85019;51046;8774;645369;494470;57045;728929;4152;652991;201501;9097;644041;10650;57565;5268;79822;100101467;8170;1830;23253;5289;54941;6875;201475;3909;125476;7776;374864;83473;10403;54495;1824;388468;115701;79863;8710;6860;25914;7572;114876;1829;147323;23327;28316;6093;1149;5771;57614;79959;6632;252884;57534;51124;7276;80148;81929;56853;6014;5205;125488;284273;284293;84552;55250;9388;220164;5366;116;89778;83876;55628;25941;4645;3998;8780;103910;147372;8792;4772;84617;4155;3613;56984;65258;2235;29919;91768;9663;5273;23239;339291;11201;4087;79839;55748;2589;753;2922;284274;55125;28513;1528;201456;84203;4864;55197;9306;9331;59340;80206;494514;55205;6925;4160;55364;54808;81035;220134;6563;147463;162681;9063;8731;10666;64693;100506888;51320;147381;5874;25925;1828;80323;1823;9480;5275;8932;27164;440498;498;89777;51444;4729;84034;4677;29906;9989;4089;23556;9150;1837;10194;220158;6317;125336;6318;4092;284254;115106;27098;10892;646000;90701;5271;29090;10907;9811;125704;55556;25800;4158;497661;400658;10982;51224;5932;5055;5797;10939;1068;6760;84307;80816;83608;55034;10449;147409;11031;361;55520;4161;30062;4225;23335;596;1000;339302;2774;22850;9050;147339;220136;220441;1825;57536;9525;2531;22878;9352,267,0.34295286579121500000
chr22,29870807,31335160,1464353,1,1,23481;730005;200312;23762;339665;22880;150290;266629;84164;550631;3976;8897;652968;29796;284904;8563;150280;23541;4744;6948;4771;8508;51537;83874;55954;164633;5008;10291;9514,29,1.98039680322982000000
chr21,42850375,46905487,4055112,1,1,386672;5211;5316;54084;56894;3689;8209;1409;54101;386679;386676;386680;386681;326;53347;5152;1476;29947;64699;11077;6612;63977;755;8566;7307;7113;875;7032;150094;85395;386685;353323;7031;7109;386674;386675;386683;8568;4731;23076;104;353332;5822;7033;386677;89765;353333;23275;90625;49854;23308;386678;89766;754;25966;54020;80781;9619;386684;7327;10785;386682;81543;7226,64,1.57825480529268000000
chr1,146155929,147825519,1669590,1,1,9557;51205;51463;2703;5565;607;2702;2330;200030;149013,10,0.59894944267754400000
chr17,16723001,20434771,3711770,1,1,2314;55244;125170;55090;11216;79018;79999;284194;10400;54890;254272;9706;400581;92521;8533;22905;729288;100996259;5598;218;23164;83450;224;51168;80039;51655;201163;7156;51030;5636;644815;10750;4239;10517;654346;10743;388436;27077;140775;6470;146691;1819;6720;125206;23495;147166;7732;146802;91647;56953;645027;3996;201164,53,1.42789019793791000000
chr16,2635862,3845857,1209995,1,1,100463285;146439;7755;84464;9074;54925;54442;1773;114984;124222;197358;146434;6923;84256;7752;646174;10942;10127;79903;9235;91151;4992;9088;83886;84891;9080;260429;4993;10131;7727;79228;7760;64063;1387;360226;4210;64386;54985;124220;23524;23059;51330;5170;79412;7627,45,3.71902363232906000000
chr22,32674605,47095548,14420943,1,1,10126;200315;150383;3005;91582;23616;114904;7078;4357;80831;115650;2033;55267;25813;25776;6942;27352;10478;4668;11144;29775;158;6767;9978;646851;8542;84271;164684;91689;1565;27351;84844;4809;84247;440829;150350;51512;25830;57026;9402;26286;113828;5155;5905;26150;7008;171568;4627;23543;79159;23492;6753;3957;80274;2192;23764;80832;1439;51493;6721;54471;758;150368;85377;23539;10521;4700;5465;80830;150372;164656;9929;25793;4689;50;25829;27350;63929;8224;80020;4174;3956;253190;3761;64098;55020;8398;638;11015;10738;4151;85352;10369;5816;9215;5880;80115;11252;9145;27128;80833;79879;23780;468;79019;129138;23151;4242;8484;10766;1727;23464;79640;91464;150379;56993;55007;55964;164668;553158;23467;7380;102800317;114794;11135;9463;83746;10343;10043;23313;2547;79734;11078;3560;53947;8664;23264;27254;10042;5372;23466;2847;64800;27341;51386;4248;706;9567;1454;254240;7263;27127;26088;60489;84645;6663;150356;140564;25809;8911;3162;10454;9620;267020;150365;200316;64781;112885;339669;29780;11020;23170;150353;23779;7477;25814;80339;10762;27349;55687;25828;6122;57591;55615;23551;9582;23112;5435;25777,189,1.31059390498943000000
chr13,72661222,115105655,42444433,1,1,7027;2259;79587;115207;160897;55795;79774;3916;8874;55757;2841;55608;22873;23026;8858;55647;10426;730249;10160;84945;1880;729420;101928841;400165;8428;100129307;7174;7546;113622;65110;23348;10673;9882;26050;9358;9375;9071;54841;196541;10150;23077;84189;122060;87769;266722;27199;10082;140432;3843;6564;643365;5457;3621;55002;2073;170622;1282;10257;2155;23250;1948;6011;3981;496;122258;8451;79596;10253;267012;7347;64062;11166;22821;337867;84899;259232;26224;79866;1910;79070;1284;11278;728215;643677;2621;688;10464;5911;8660;114798;121793;283489;23263;22894;55739;1203;4008;171425;440145;23483;93081;8796;5611;55082;5095;100129836;85416;1638;348013;2159;6656;8881;54602;2262;100533467;55208;6555,117,0.27565452458747700000
chr20,1649395,25733021,24083626,1,1,3642;5786;63908;6754;9762;100303755;551;5621;64412;1469;23236;343641;146;5075;8760;57325;63926;631;5332;388780;29107;1473;100128496;54453;23767;54976;650;57144;79953;57136;128821;64949;5834;80343;22981;55317;7692;10741;128653;56255;55612;6616;55614;55304;55617;56914;5126;54363;4821;55184;140856;10047;22888;29058;51340;140885;22803;60493;3420;22918;1114;140862;1472;55857;65992;128710;57186;25943;92675;994;92086;140733;51126;57593;8530;54498;1470;80332;64773;26074;26152;22903;7056;84515;5020;644524;140836;56265;117532;1059;8195;51605;6628;11237;9770;3704;64601;64096;83959;955;92667;182;56261;116835;6629;80025;9962;149840;26090;140838;1471;24141;140880;10528;23627;30813;6238;8455;54675;11034;9837;7053;57419;164312;3170;128674;2797;10483;6614;25876;27131;5173;128822;58495;5111;79133;57506;140901;10621;84532;100288797;79175;51575;128817,144,0.59791660940092700000
chr2,242768430,243068402,299972,1,1,285093;5133,2,0.66672889469683800000
chr10,46342290,51826237,5483947,1,1,119016;5599;644168;267004;8031;195977;100652748;9721;83849;642517;57705;474354;170371;118738;653145;5949;644054;414189;100133093;728113;5540;143162;6572;2662;26095;118461;282966;58504;100287932;8505;2658;1103;2074;170370;4477;196740;55753,37,0.67469652788402200000
chr4,71553,3880910,3809357,1,1,10336;7700;521;7469;401115;79155;4636;10417;84286;654254;345222;54872;1609;2261;255403;79441;4043;8602;7884;170960;57732;7468;152877;10296;3064;3083;285489;57654;353497;10460;285464;118;3954;10861;152;92305;285498;339983;10815;2580;53834;84179;5158;402160;3425;10608;6452;152687;1487;6047;54729;2868;6002;10227;8603,55,1.44381322097141000000
chr15,23697168,28559437,4862269,1,1,2562;7681;23742;8924;7337;6638;2567;4948;8926;57194;54551;4692;2558,13,0.26736488664037300000
chr15,20150696,32509932,12359236,1,1,321;7681;123606;283694;390538;23359;6638;22909;8926;161725;283710;283685;653720;89839;4692;54893;23191;283767;728498;2562;101059918;727832;100996331;4948;57194;81614;100287399;4308;2558;1139;7082;8924;114791;23742;51621;7337;89832;653073;2567;54551;56160,41,0.33173571570281500000
chr18,78425,78012819,77934394,1,1,100526842;1630;23255;57132;125228;642597;84735;284252;5596;7525;84064;284257;1005;83539;6139;101927322;9984;10928;162655;63895;162699;64863;342850;374868;7541;2587;26040;4200;64762;80000;114799;9658;147407;147495;9218;54877;81832;9229;7298;26251;91133;56907;92126;57724;7050;26256;8715;30827;23347;2627;10627;143471;8736;374860;171586;284217;23136;284266;100505549;85019;51046;8774;645369;494470;57045;728929;4152;652991;201501;9097;644041;10650;57565;5268;79822;100101467;8170;1830;23253;5289;54941;6875;201475;3909;125476;7776;374864;83473;10403;54495;1824;388468;115701;79863;8710;6860;25914;7572;114876;1829;147323;23327;28316;6093;1149;5771;57614;79959;6632;252884;57534;51124;7276;80148;81929;56853;6014;5205;125488;284273;284293;84552;55250;9388;220164;5366;116;89778;83876;55628;25941;4645;3998;8780;103910;147372;8792;4772;84617;4155;3613;56984;65258;2235;29919;91768;9663;5273;23239;339291;11201;4087;79839;55748;2589;753;2922;284274;55125;28513;1528;201456;84203;4864;55197;9306;9331;59340;80206;494514;55205;6925;4160;55364;54808;81035;220134;6563;147463;162681;9063;8731;10666;64693;100506888;51320;147381;5874;25925;1828;80323;1823;9480;5275;8932;27164;440498;498;89777;51444;4729;84034;4677;29906;9989;4089;23556;9150;1837;10194;220158;6317;125336;6318;4092;284254;115106;27098;10892;646000;90701;5271;29090;10907;9811;125704;55556;25800;4158;497661;400658;10982;51224;5932;5055;5797;10939;1068;6760;84307;80816;83608;55034;10449;147409;11031;361;55520;4161;30062;4225;23335;596;1000;339302;2774;22850;9050;147339;220136;220441;1825;57536;9525;2531;22878;9352,267,0.34259585055604600000
chr3,93527439,197844960,104317521,1,1,7634;29970;55324;5290;1360;5984;170506;26984;56941;56667;403274;3592;1894;8626;170572;51208;8706;79825;151742;4071;11343;55573;6657;64091;253461;23043;131544;604;58477;116931;2119;9666;8856;3693;4638;199221;131583;30849;7095;257144;6565;57709;5130;523;79691;214;10721;29927;59345;285335;7220;151827;84859;285382;1356;2693;57018;1370;151636;200959;10188;151613;347;79295;51319;344805;8975;51068;57501;4690;22871;132243;9435;55840;8833;285313;56650;79718;622;64805;201633;403278;5948;84925;93109;200931;55486;6184;257068;344901;7037;80325;165721;344752;285242;6010;3273;55214;10644;4976;152185;5708;286827;7348;200916;84107;100534599;94032;28976;55;79669;54464;55773;5918;256076;254887;23527;56983;131873;5361;89857;79572;79413;51726;57560;26355;7545;389177;152118;339855;9626;54762;55179;6434;5627;6478;57337;56922;55081;344807;4311;2992;200933;131601;200894;131076;6750;389170;285386;3836;54965;4345;66000;285282;6514;57129;344658;2960;165631;54931;56945;7029;131890;6498;51555;53836;403277;131566;344758;5947;84239;8419;339829;57493;57650;57047;3081;22916;83893;23200;90288;1295;79674;9616;11222;25847;79858;9276;590;1427;1475;255798;50939;84561;1814;63899;4241;26084;347736;4711;11148;254827;200958;152065;53833;344838;200895;25852;28999;205717;5276;1181;5523;166348;2804;110599564;51421;22808;51560;6596;79740;27333;79663;9076;2047;6480;84248;10402;344657;165829;25937;27032;83666;10840;23355;5359;84319;131149;3280;84002;6476;84223;348807;64393;10225;55171;57110;7104;59343;9868;941;6165;5806;131540;10057;23317;846;389151;11167;285315;3827;7401;403273;285220;668;27230;51122;80321;80723;131831;60678;84517;9819;111;26339;27107;64108;1359;2257;6474;4585;23007;29083;257313;83850;54763;5062;131450;22989;80111;653659;5922;5648;10051;55341;7707;55076;9370;389161;29114;286676;8997;56925;401097;25976;80012;91653;26998;339122;8723;81050;4154;8930;54554;100505385;644974;64770;116064;9197;5357;205564;79929;415117;105374250;79310;54625;64747;200909;57092;401089;151963;91775;10342;132112;5437;26341;55764;6578;4710;84129;92369;2122;1739;942;55347;344892;10954;348801;5217;10195;23129;8893;64332;8971;868;131408;11235;51714;84692;64422;131920;185;83939;51365;26043;116832;28990;8646;285195;151871;7018;7066;9175;114112;57088;402135;200879;287015;110599583;7555;4171;13;5584;483;375387;27031;545;11073;131870;9657;56648;3059;8743;23350;54800;647309;3840;79598;8607;79782;7372;389158;131368;80235;2932;26996;8702;4291;1857;26577;84873;51725;54437;165679;25890;54165;57514;5352;2814;10063;6747;5010;56954;89782;23101;131578;152405;151790;10242;152137;152078;92370;151888;9711;25871;50852;961;27074;1173;55254;197;51193;29909;152015;84343;79876;1608;729627;64110;1371;55186;165918;84100;10686;56670;116441;55167;152138;27094;5291;80254;84984;645840;9934;54847;64084;201562;5504;141;2815;349565;7881;55032;9515;5912;10274;2624;1974;200810;22820;5274;55892;57461;80218;89876;5096;114885;3556;255758;116211;152002;152404;84864;11259;6259;90102;90407;56987;55669;86;4045;348793;51554;51146;80117;1962;166012;205428;57577;57552;79364;7200;26137;11342;131669;55211;23023;151887;53829;84666;55689;2596;503582;8087;55779;2838;27136;64778;51163;9718;5337;8403;5028;90113;131118;2049;285311;654502;1981;25945;344905;7879;84303;6152;131034;389152;4026;85476;256356;50512;22865;54946;51300,553,0.53011229053267100000
chr21,10773805,48072996,37299191,1,1,54148;4599;5316;337882;106865373;1409;54101;9875;1826;9073;386679;874;51227;10950;337970;101928147;386681;56245;54943;643812;326;5121;1476;9946;116448;1292;64699;11077;1827;3150;63977;10281;149998;337973;8566;26046;7307;7113;54014;116159;56683;150094;85395;59271;386685;23515;337878;8624;29980;386683;337979;8568;100288323;54149;6450;4731;6493;539;104;54093;5822;6453;4047;54039;337985;7033;353333;23181;3454;25825;23275;2618;337976;2078;3455;1525;140258;56246;64968;49854;89766;754;3460;6647;54065;150051;58494;80781;7327;10785;337879;10841;54033;3753;337972;6782;150084;643803;728299;9992;386672;5211;861;11096;2897;56894;54084;6285;3689;8209;1859;29104;337960;7485;386676;571;386680;7267;53347;7074;5152;10311;150082;3772;3275;54059;8208;9510;10317;5116;84221;29947;337959;4685;6612;337968;85319;755;1291;351;875;10069;7032;100131902;522;53820;9980;337963;337967;353323;7031;3588;6526;10215;7109;140578;386674;386675;23076;6573;3763;2114;353332;3141;4600;337971;54058;8204;386677;89765;30811;337974;337977;5651;337969;388813;57466;140290;54069;2551;757;10600;90625;7179;23562;26285;10694;23308;386678;337975;337880;100288287;54102;317754;6651;8867;8888;94104;64092;25966;54020;337966;9619;386684;388818;337978;386682;254950;54097;56911;873;29761;284827;81543;7226,215,0.57642000868061700000
chr8,40701401,49176393,8474992,1,1,5591;10947;8973;4173;84376;6422;3551;7336;2339;1052;7994;51125;137964;79698;157848;5423;1142;23514;84296;340441;6575;55145;138050;286;27121;81790;84197;7419;5327;114926,30,0.35398263502785600000
chrX,69034183,69253902,219719,1,1,1896,1,0.45512677556333300000
chr4,184560009,190966890,6406881,1,1,285440;205860;25854;55325;7098;60684;836;83891;448831;57587;2160;3818;79682;353322;291;27295;3660;441054;391723;201965;2195;339976;201973;4543;132625;55805;133121;256309;8470;2180;56977;2483,32,0.49946299923472900000
chr5,175714974,180696832,4981858,1,1,2916;2324;285679;51428;51491;30832;91522;9260;345462;53917;23138;3182;9945;3187;375484;646019;57179;54825;90249;26262;9794;79908;3101;80758;54732;345456;6940;10399;821;2870;55819;285676;1627;285659;2161;253314;117608;6620;6569;134083;51149;10636;10917;153579;23061;27166;285596;1212;9509;23197;84851;80108;57472;10960;64777;643836;51720;90933;255426;26693;23567;11285;54540;2264;11282;79930;192286;285598;85007;4245;5626;4056;55651;8878;57396;5601;83463;92304;81786;64324;80230;114787;22838,83,1.66604507796087000000
chr18,78425,27377975,27299550,1,1,116;85019;23255;57132;8774;645369;125228;57045;8780;103910;642597;25925;284252;84617;9097;7525;10650;3613;56984;65258;79822;84034;83539;4729;29919;23253;91768;9663;9989;339291;9984;10928;162655;6875;63895;201475;64863;3909;342850;27098;646000;753;7541;55125;55556;10403;4158;84203;4864;388468;80000;114799;59340;114876;5932;147495;9218;6093;494514;5797;1149;5771;10939;1068;79959;9229;6760;6632;57534;7298;91133;11031;361;56907;55364;7050;81929;4161;26256;1000;81035;125488;2774;23347;147463;2627;10627;8731;143471;8736;374860;171586;284217;23136;64693,95,0.34799108410211900000
chr22,18875830,21441944,2566114,1,1,54487;27037;9342;29801;65078;10587;1312;6545;8214;7290;421;2812;6899;5625;7625;79680;64976;6576;3053;8218;5413;80764;23617;400891;1399;7122;150209;128977;8220;388849;84861;7353;51586;2928;128989;5297;9127;9993;54584;91179;85376;8216;85359;8318;728229;5902,46,1.79259378188187000000
chr22,18661699,21661435,2999736,1,1,54487;27037;9342;29801;65078;10587;1312;6545;8214;7290;421;2812;6899;5625;7625;79680;64976;6576;3053;8218;5413;80764;23617;400891;1399;7122;150209;128977;8220;388849;84861;7353;51586;2928;128989;5297;9127;9993;54584;91179;85376;8216;85359;8318;728229;5902,46,1.53346827854184000000
chr17,34815077,36249799,1434722,1,1,26574;284099;9326;284098;11072;6928;79154;79922;3975;11276;79893;11056;6871;31;80179,15,1.04549870985459000000
chr16,596255,2916088,2319833,1,1,283951;3029;51005;51764;254528;4917;90850;124056;645811;90861;84331;23162;84326;9143;4832;6123;1186;1632;57524;3483;57585;10942;64499;117166;197342;9028;21;390667;260429;65990;899;4913;9742;283871;10232;1877;7329;339123;283948;79006;84219;23430;23524;57465;63922;80178;6755;7177;146310;5170;8938;390664;64223;527;7249;30812;752014;65993;146325;124093;84231;115939;89941;54442;10607;64711;84264;84572;6923;90864;1775;9894;5310;64718;79652;6650;10101;83886;81889;64428;64788;25823;64063;146330;360226;4716;10273;283869;10921;124220;57799;6187;25837;197335;51734;9091;9351;8912;2671;388199;113000;283870,102,4.39686822284190000000
chr8,186785,3235157,3048372,1,1,64478;9172;9639;169270;2055;157695;26260;9228;9920;157697,10,0.32804395264095100000
chr22,18876605,21441944,2565339,1,1,54487;27037;9342;29801;65078;10587;1312;6545;8214;7290;421;2812;6899;5625;7625;79680;64976;6576;3053;8218;5413;80764;23617;400891;1399;7122;150209;128977;8220;388849;84861;7353;51586;2928;128989;5297;9127;9993;54584;91179;85376;8216;85359;8318;728229;5902,46,1.79313533221145000000
chr9,91472,44972472,44881000,1,1,58524;10171;55664;23586;92014;3439;100129669;51754;79269;10210;2189;6461;79937;25853;7094;54796;158326;55064;4712;84688;2315;6366;5991;6456;51510;1211;26953;3717;10488;2592;3444;55833;971;157983;3641;7306;23349;25822;158219;286319;79956;55958;3443;64922;2731;253650;1271;10280;79886;27240;100129969;7415;84720;56656;10020;27290;7016;5646;4300;9350;54914;340485;6363;10850;730112;2298;26267;11258;3442;881;81704;3452;158038;7169;347252;6019;347240;169792;6505;26149;203259;138715;54801;10497;4781;3447;727830;728577;441430;8777;51271;158234;7436;90871;3448;3590;25769;338376;646962;573;647060;360;3456;55848;768;152006;10655;80380;27019;30968;2683;54926;203260;23081;50808;57462;56832;389730;259308;5079;158358;401494;392309;401505;203238;54586;23189;730098;9853;5789;3301;54840;80256;286343;55667;1993;29126;340481;3441;90865;123;63951;138716;3449;55234;403313;169522;1030;9373;6595;3467;65083;441459;219;92949;3445;1029;4882;10670;4799;89882;8434;4507;364;9380;375704;203228;84904;727905;9925;6619;26206;7010;51010;441425;9827;158297;3440;6194;3446;64425;1761;100129385;11168;392307;3451;54875;57704;9833;6013;138724;138474;57589;80173;48;55871;115426;158376;84186;79817;9933;692094;84681;11172;152007;22844;318;401498,208,0.46344778414028200000
chr21,15480359,48095807,32615448,1,1,54148;4599;5316;337882;106865373;1409;54101;9875;1826;9073;386679;874;51227;10950;337970;101928147;386681;56245;54943;643812;326;5121;1476;9946;116448;1292;64699;11077;1827;3150;63977;10281;149998;337973;8566;26046;7307;7113;54014;116159;56683;150094;85395;59271;386685;23515;337878;8624;29980;386683;337979;8568;100288323;54149;6450;4731;6493;539;104;54093;5822;6453;4047;54039;337985;7033;353333;23181;3454;25825;23275;2618;337976;2078;3455;1525;140258;56246;64968;49854;89766;754;3460;6647;54065;150051;58494;80781;7327;10785;337879;10841;54033;3753;337972;6782;150084;643803;728299;9992;386672;5211;861;11096;2897;56894;54084;6285;3689;8209;1859;29104;337960;7485;386676;571;386680;7267;53347;7074;5152;10311;150082;3772;3275;54059;8208;9510;10317;5116;84221;29947;337959;4685;6612;337968;755;1291;351;875;10069;7032;100131902;522;53820;9980;337963;337967;353323;7031;3588;6526;10215;7109;140578;386674;386675;23076;6573;3763;2114;353332;3141;4600;337971;54058;8204;386677;89765;30811;337974;337977;5651;337969;388813;57466;757;54069;2551;140290;10600;90625;23562;23308;26285;10694;386678;337975;337880;100288287;54102;6651;8888;8867;94104;64092;25966;54020;337966;9619;386684;388818;337978;386682;254950;54097;56911;873;29761;284827;81543;7226,212,0.64999873679490800000
chr20,60734,2643003,2582269,1,1,140680;10616;1457;57761;83541;55968;10326;55321;140850;10528;81623;140881;51378;9751;113278;343641;117532;7053;245938;343637;6628;140885;245939;85508;388780;85364;3420;5173;9491;128637;6939;400831;2280;642636;140901;400830;55423;140809;284759;6666;27111;79175;80023;128646,44,1.70392782471540000000
chr22,17096855,21440514,4343659,1,1,54487;27037;27440;9342;29801;65078;10587;1312;51816;6545;7625;8214;7290;421;2812;6899;5625;27439;27443;55670;637;64976;79680;529;11274;6576;150165;83733;3053;8218;5413;80764;23617;400891;1399;7122;150209;8220;128977;388849;84861;7353;51586;2928;51807;128989;23765;5297;9127;9993;54584;91179;85376;8216;85359;8318;23786;728229;128954;101929372;57553;5902,62,1.42736803234324000000
chr3,7713271,9532443,1819172,1,1,2917;55209;5021;56852;29995;9901;25917;859;51066,9,0.49473056973172400000
chr17,735867,2631484,1895617,1,1,10594;286753;63826;5345;146760;114826;9905;124641;1398;23293;727857;64359;6117;23277;55720;29928;124935;727910;29;8578;79066;4641;83547;4335;124997;1801;5176;7531;5306;3090;5048;51763,32,1.68810471735588000000
chrX,53316256,54074258,758002,1,1,23096;158787;10075;8243;23133;3028,6,0.79155463969752100000
chrX,53228169,54133735,905566,1,1,23096;158787;10075;8243;8242;54954;3028;23133,8,0.88342539362122700000
chr1,146564743,149224043,2659300,1,1,9557;728945;284565;644591;51205;645142;51463;5565;607;2702;730262;2330;200030;2703,14,0.52645433008686500000
chr21,40828654,41504446,675792,1,1,10317;6450;150084;1826;106865373;5121,6,0.88784714823496000000
chr18,59195438,64104791,4909353,1,1,89778;5273;23556;23239;2531;8792;8710;5275;596;6317;6318;5055;284293;28316;54877;5268;220441;57614;89777;9525;1005;5271,22,0.44812422329378200000
chr11,64544599,64785731,241132,1,1,23130;4221;5526;283129;55561;116071;5871;402;10938;7536;170589,11,4.56181676426190000000
chr7,72726578,74139331,1412753,1,1,5982;51085;9275;84277;7462;135886;83451;1364;135892;6804;7461;155382;3984;26608;8468;9031;155368;2969;8326;7458;9569;2006;1365;114049,24,1.69881076168304000000
chr2,9731827,10582026,850199,1,1,29841;4953;10971;9014;348738;8462;3241;6241;192668,9,1.05857569816008000000
chr2,1,9217329,9217328,1,1,7837;23040;51112;9781;57498;129642;54221;26751;285016;6664;7260;78989;55821;55256;6201;642273;129607;728597;7173;3398;246243;129787;91543;52,24,0.26037914675489500000
chr1,240538856,249172689,8633833,1,1,127077;25909;200150;200159;127069;84288;51029;81469;391196;55083;127623;343173;127064;26246;391189;79894;441925;441932;401993;6000;10472;57116;80851;79862;23596;343563;317705;391195;26245;114548;440738;26188;159;284521;163882;391211;343169;128025;84838;391194;3192;9156;93474;1122;127074;8564;64388;388759;81472;127066;343172;25893;391190;441933;403244;127068;646627;7678;284532;10000;2271;26696;55657;391191;64754;81466;127059;127062;10806;401992;343171;254879;116228;257044;9859;81470;148823;64216;403239;56776;401994;391192;51097,83,0.96133432277413800000
chr14,94712611,102767995,8055384,1,1,10858;327657;256394;51218;5527;56967;5104;51527;5891;12;8788;388015;317762;283600;283598;5265;8115;7528;9623;866;1778;161176;3320;5267;2009;84193;123099;79446;51156;624;91833;84439;57596;23405;7453;123096;7443;57718;10914;122481;145258;8812;79789;55102;145264;623;51466;1735;64919,49,0.60828881652321000000
chr8,221611,2206217,1984606,1,1,9172;9639;157695;26260;9228;9920;157697;2055,8,0.40310268133826100000
chr1,145740598,149224043,3483445,1,1,9557;728945;284565;2330;653519;149013;5174;644591;51205;645142;51463;5565;607;2702;730262;200030;2703,17,0.48802263276727500000
chr22,18919942,20311763,1391821,1,1,54487;27037;5413;29801;65078;23617;10587;1312;7122;421;7290;128977;8220;2812;388849;7353;2928;128989;6899;9993;54584;5625;79680;85359;64976;8318;5902;6576;8218,29,2.08360126769175000000
chr1,156254590,159338148,3083558,1,1,912;54865;10763;922;9447;391107;128240;391104;10485;3428;2117;164118;57863;4209;79368;4332;149499;909;913;1382;57127;107181291;60484;115350;3068;128360;128229;9826;83417;83416;9047;23381;84283;5546;375033;4914;911;128239;441911;2205;440695;391112;51093;391114;391109;128372;63827;6708;2532;81442;7203;910;55243;81448;128367;112770;79590;149628;128371;128366;128368;81875;3645;343406;115352,65,2.10795451228743000000
chr1,145740598,147786706,2046108,1,1,9557;51205;51463;5565;607;2702;149013;2330;653519;200030;2703;5174,12,0.58647930607768500000
chr9,910389,12772530,11862141,1,1,58524;10171;23081;55664;89882;50808;158358;5789;6019;1761;169792;55064;6505;29126;2315;5991;26953;90865;7436;3717;90871;6013;57589;3641;7306;403313;169522;115426;6595;79956;9933;2731;55848;11172;10655;80380,36,0.30348652911814200000
chr22,17096855,18920001,1823146,1,1,27440;51816;8214;51807;23765;5625;27439;27443;55670;637;529;11274;150165;23786;83733;128954;101929372;57553,18,0.98730436289798000000
chr1,144927778,149224043,4296265,1,1,9557;148738;128077;84265;9659;10628;2330;653519;5174;388677;200035;51205;284615;645142;5565;148741;730262;10623;100132406;9939;728945;27246;284565;11126;8799;149013;10401;644591;8515;51463;607;2702;200030;2703,34,0.79138507517576300000
chr16,29673954,30197341,523387,1,1,653808;5531;26470;283897;253980;146378;8479;83719;23475;283899;124446;9344;3835;4150;226;253982;83723;5595;6911;11151;8448;79447;112476;9961;10423;6693;79153,27,5.15870665492265000000
chr22,18641409,21440514,2799105,1,1,54487;27037;9342;29801;65078;10587;1312;6545;8214;7290;421;2812;6899;5625;7625;79680;64976;11274;6576;3053;8218;5413;80764;23617;400891;1399;7122;150209;128977;8220;388849;84861;7353;51586;2928;128989;5297;9127;9993;54584;91179;85376;8216;85359;8318;728229;5902,47,1.67910814349587000000
chrX,140764094,141157374,393280,1,1,9947;139081;64648,3,0.76281529698942200000
chr8,141542712,146174033,4631321,1,1,65263;1584;340371;84948;11156;93100;225689;203054;84988;22898;111188157;8694;27161;8581;286077;2907;642658;50626;23237;2765;9684;55630;114822;642475;340390;6132;26233;338328;90990;2875;57210;203062;1936;80728;51337;23144;286075;23513;83482;137797;340393;51236;9401;28991;2843;22827;575;389690;2738;7553;7564;5339;414919;375686;90987;51160;4062;389692;5747;81858;26873;727957;84232;79581;1585;57152;58500;8928;340385;8000;4796;116447;83481;84875;29894;4061;8629;79943;23246;1537;113655;100130274;105375787;66004;79792;286128;441381;80778;8733;432355;9831;7264;54512;3297;54742,95,2.05125060430922000000
chr16,2636803,4464653,1827850,1,1,100463285;146439;51025;115;7755;84464;9074;54925;100529144;54442;1773;114984;6345;124222;197358;84662;146434;6923;84256;7752;646174;10942;10127;79585;79903;9235;91151;4992;9088;83886;84891;9080;260429;4993;10131;114990;7727;79228;7760;64063;1387;360226;4210;64386;54985;7023;124220;23524;23059;51330;5170;79412;7627,53,2.89958147550401000000
chr16,86602294,90124279,3521985,1,1,54758;863;81631;23174;11105;115992;4597;146429;2300;763;124245;197320;100287036;1535;51693;79007;100129697;124044;348180;9780;81620;9605;2303;5119;4157;54849;79791;100506581;27132;353;29123;197322;2588;2622;8140;6137;6687;54971;2175;27189;1013;333929;124045;161882;57338;84501;22980;92822;92806;84627;390748;10381;1800;8558,54,1.53322629142373000000
chr15,32076948,32510863,433915,1,1,161725;1139,2,0.46091976539183900000
chr12,179706,33002592,32822886,1,1,4704;83857;144195;25977;2842;6337;65981;1822;4040;259295;10060;121512;144568;51026;10233;6660;1108;50865;55500;2998;10599;26127;3736;8302;259294;23012;50813;10867;22914;55359;23710;121504;5545;57097;5149;1911;441631;55907;2984;3375;10219;4257;83445;397;51071;79785;79365;51768;8078;55729;26290;387849;196500;55766;160364;93661;2305;50838;8496;728858;3823;80824;55259;89869;60488;5800;1389;121536;51067;57542;160492;79887;928;144608;5318;3822;55810;283358;2;1027;586;5288;2251;55200;440093;9976;196513;5858;160365;27239;50836;93978;64581;83758;9573;9847;338339;7167;7132;11331;341392;653247;341346;2288;51147;84519;84727;84766;2597;7289;51290;56938;83714;51729;9412;10635;6843;8079;81575;6539;440073;10536;4055;359787;6489;6515;55138;118426;420;11171;8074;55297;29121;3742;51267;57103;2026;387836;51202;51266;11228;2784;3709;51279;57101;3821;2120;5965;171017;50856;5927;920;636;144363;57121;55080;26253;715;894;259296;645177;81029;100431172;84318;55507;3845;259292;3902;85004;6579;5777;196394;4908;55726;53919;4973;283316;55196;5544;28234;100129361;57102;10566;3764;113246;7004;54477;1663;55110;4033;4815;51258;106707243;55885;160518;10162;360030;51348;8076;79602;5554;10526;283420;55846;10436;2059;79912;9332;654429;83461;58516;2012;120939;259289;57379;4074;79923;57613;5763;83695;387837;254013;775;2904;729025;55711;259290;100528032;440087;3820;170482;100287284;259293;9918;7450;57494;196415;8082;9052;3741;80763;338821;5893;5555;79370;6540;54682;93589;5830;939;8798;3824;50835;8531;353164;4256;121506;50839;56341;4839;10059;50837;719;716;341350;50840;9746;144699;11272;5542;25900;65125;969;3945;5744;440077;339;23085;5139,279,0.85001666215457100000
chr4,927780,12595138,11667358,1,1,728373;257236;7469;401115;79155;644414;728393;133060;728419;55646;6286;53407;166793;114932;1609;55351;9948;2121;79441;100287513;7468;152877;285489;3166;84448;1816;353497;152789;100287205;9778;10861;92305;285498;57537;100287404;728379;8532;27065;53834;116449;402160;728386;3425;4487;6047;54729;6002;54360;728405;27201;7466;10227;57533;9957;10417;152992;93621;84286;93624;345222;56606;2261;4043;8602;7884;100287441;57732;132884;10296;3083;3064;100287238;768239;100287364;57654;10460;85013;728400;100287327;100287478;118;1400;3954;152;100288520;60312;85460;94031;23324;55330;728369;100287178;339983;6452;5522;10608;1487;100287144;8310;80273;2868;54436;389199;285464;8603,105,0.89994667173150900000
chr4,183574006,190884350,7310344,1,1,285440;53842;205860;25854;55325;7098;55714;60684;836;80014;83891;57587;55602;2160;3818;79682;353322;291;100132463;27295;3660;441054;391723;201965;2195;339976;201973;4543;132625;55805;133121;256309;8470;2180;56977;3622;2483;1635,38,0.51981137960128800000
chr7,72700414,74140846,1440432,1,1,5982;51085;9275;84277;7462;55695;135886;83451;1364;135892;6804;7461;155382;3984;26608;8468;9031;155368;2969;8326;7458;9569;2006;1365;114049,25,1.73559043398092000000
chr15,23641200,29331964,5690764,1,1,2562;7681;321;4948;57194;2558;8924;23742;7337;6638;2567;8926;283685;653720;54551;4692,16,0.28115732790887100000
chr9,220253,141102518,140882265,1,1,10171;29952;10422;158293;54863;84960;360203;92014;138240;54886;2220;441478;79937;81605;1164;644019;2800;55064;7743;399665;56654;138241;2395;4686;89891;2315;79695;5991;389792;389761;643596;51510;195828;2733;80709;10488;1056;375748;971;286362;10927;392390;140459;286319;79956;114987;25;79886;6709;100129969;7415;7088;7185;27290;7016;5646;81873;10773;8022;83549;6256;6363;6621;57864;55342;375775;138804;26267;23230;3442;84929;81704;8021;6019;169792;9719;153090;29989;10497;4781;2040;51271;158234;653427;4783;84895;90871;10244;1384;3590;25769;158471;65268;54829;552891;7091;347148;3456;195827;10555;203197;80380;1955;51104;50808;8727;229;5887;259308;3190;51531;392309;158131;114789;23424;5537;10507;9853;158046;8395;7633;286343;548645;286336;7186;11092;441476;3441;94107;445571;5524;55234;169522;883;8518;728747;64855;5774;1029;56254;89882;6835;23137;54881;9380;11064;11091;375704;84270;5069;25920;9925;5900;79048;9615;138311;9827;80142;84302;23413;84131;79813;1761;7357;138429;401546;138805;10439;1757;64768;51280;54875;116225;9833;3293;26130;11093;210;115426;158376;79817;84681;4593;203286;23446;25792;642968;138162;401498;58524;9328;55664;8577;138151;728489;3439;84263;29988;51754;83543;286257;254956;5535;7094;90678;4712;27158;389762;220869;7539;26248;10558;401563;3444;22845;7306;6838;100526694;55958;3443;203328;64922;1515;301;51116;138883;254973;51450;23637;2356;10585;730112;22927;9022;27348;84814;54566;158405;116443;56623;7248;203259;54801;728577;3447;4702;727830;81932;55582;26737;23203;54534;91373;58499;727800;85365;92714;647060;360;169611;768;152006;401548;28989;85014;29991;10912;80010;203260;158399;57171;7295;158062;25934;389730;5079;158358;286204;84641;203238;54107;392392;57706;89853;730098;645961;9329;54840;5568;23731;2649;2902;29126;55312;11046;445815;6887;401565;90865;83744;2844;123;9830;3449;23511;26995;9373;3467;441457;55357;10952;441459;286256;157927;59335;92949;91283;51552;158135;9550;57720;10319;4799;8434;7410;2176;1025;2790;203228;727905;56033;51117;254295;1612;26206;6850;733;441425;29085;5082;7111;9991;53358;90120;3446;5998;100129385;286365;158056;11168;26301;2776;445;56751;57704;54187;570;6013;23245;57589;80173;92400;392399;22954;402381;9933;54932;23196;9314;3371;2218;347273;7099;23071;11217;6136;375743;55151;2889;116224;10592;158067;23299;389799;26578;286380;79269;10210;4915;1759;51148;2189;6461;54796;158248;1842;10444;158326;6096;84688;10541;158431;727;3309;23452;6456;1211;27130;3717;9919;389812;140803;2592;55833;259;23349;320;158219;2731;253650;1271;10280;27090;27240;10020;56656;216;9568;54461;1903;9350;1306;340485;10850;881;100499483;2934;8721;7169;158038;55363;158427;84726;79987;64420;26149;255220;375759;653404;8555;401562;441430;441452;8777;55335;6837;7436;392391;338376;138065;573;25861;10807;55848;23099;2021;51759;55014;64975;10868;158158;27019;30968;2683;54926;9413;22869;774;5695;158055;401494;2650;5711;401505;23189;26735;138802;246184;687;80256;9414;26012;1993;203245;286207;169693;401551;80036;54942;83856;54542;138716;138881;549;100505993;403313;10880;9128;401541;6595;84253;65083;347168;169714;219;442425;84210;27433;138428;50514;10783;10670;26190;954;138255;5005;60560;8939;23064;401535;114299;2022;11224;51162;64078;4969;26147;158297;3440;9442;2619;286205;389816;23670;5047;5727;92715;203;3934;11182;3451;158401;9630;84909;5090;256691;6130;375791;5730;11172;152007;22844;5253;389763;389766;4851;138199;5004;10881;23586;138803;57109;3933;54754;100129669;3376;1317;26219;23307;8636;55071;81689;54769;8013;9355;25853;85301;5239;84628;2801;89958;6812;23392;6366;2516;56262;11253;26953;56904;11094;138799;3641;25822;7507;1318;389813;114991;84267;58493;157922;6836;84720;117531;26165;4300;445577;80318;23287;5742;54914;100505478;4958;169834;11258;8328;3452;257019;23552;55755;347252;4920;347240;9858;6505;2219;138715;256158;138307;20;29941;10044;3448;79670;7464;7046;138639;8818;646962;142680;375757;392376;1620;10655;79109;64794;23081;414328;6834;57462;64170;56832;6418;92399;347169;55035;9649;54586;84885;5789;3301;55667;349334;5125;286262;7270;89846;2529;26740;29968;29882;340481;8789;2304;23048;51490;113220;63951;414332;286234;26468;28;389827;1030;57684;4957;2203;318;54662;7763;3445;169436;1902;79095;4882;4814;22949;10811;1514;4507;364;29979;138882;54836;1621;84904;19;6619;7010;51010;54981;8019;23732;6194;10999;30815;1289;377841;1539;64425;169841;55684;403341;10383;944;26086;392307;57582;1861;138724;138474;286223;257169;4010;23404;48;84186;692094;9966;9536,749,0.53164960117584700000
chr15,23641200,29331964,5690764,1,1,2562;7681;321;4948;57194;2558;8924;23742;7337;6638;2567;8926;283685;653720;54551;4692,16,0.28115732790887100000
chr15,23641200,24833382,1192182,1,1,4692;7681;283685;54551,4,0.33551924118968400000
chr1,224210564,242987796,18777232,1,1,92815;54583;65094;23219;200150;55740;8560;58480;286826;10753;57568;440730;128312;1130;79169;84886;6894;23029;7257;51127;6905;55746;55127;128178;3930;441925;3020;8290;9816;6000;51742;56605;375;84033;23596;1131;83881;149603;375057;2052;148789;163859;375061;81559;200205;57829;148641;79605;339501;9453;183;128061;388753;58;83932;7107;359948;4548;5664;5867;64746;6262;84451;128025;27185;84284;56776;9804;9156;1122;128308;2590;8564;64388;2987;4931;64801;116841;57165;7044;126731;23456;149111;149373;6726;88;80232;89780;2271;9725;27097;10638;7483;29920;8443;645745;3707;54627;100129094;2786;339500;3964;149371;80003;56997;3775;29097;142;127602;4811;8476;440738;10637;22796;79573,115,0.61244383623741800000
chr1,145747214,147786706,2039492,1,1,9557;51205;51463;5565;607;2702;149013;2330;653519;200030;2703;5174,12,0.58838181272591400000
chr19,28272774,28903434,630660,1,1,,0,0.00000000000000000000
chr12,179706,33465991,33286285,1,1,4704;83857;144195;25977;2842;6337;65981;1822;4040;259295;10060;121512;144568;51026;10233;6660;1108;50865;55500;2998;10599;26127;3736;8302;259294;23012;50813;10867;22914;55359;23710;121504;5545;57097;5149;1911;441631;55907;2984;3375;10219;4257;83445;397;51071;79785;79365;51768;8078;55729;26290;387849;196500;55766;160364;93661;2305;50838;8496;728858;3823;80824;55259;89869;60488;5800;1389;121536;51067;57542;160492;79887;928;144608;5318;3822;55810;283358;2;1027;586;5288;2251;55200;440093;9976;196513;5858;160365;27239;50836;93978;64581;83758;9573;9847;338339;7167;7132;11331;341392;653247;341346;2288;51147;84519;84727;84766;2597;7289;51290;56938;83714;51729;9412;10635;6843;8079;81575;6539;440073;10536;4055;359787;6489;6515;55138;118426;420;11171;8074;55297;29121;3742;51267;57103;2026;387836;51202;51266;11228;2784;3709;51279;57101;3821;2120;5965;171017;50856;5927;920;636;144363;57121;55080;26253;715;894;259296;645177;81029;100431172;84318;55507;3845;259292;3902;85004;6579;5777;196394;4908;55726;53919;4973;283316;55196;5544;28234;100129361;57102;10566;3764;113246;7004;54477;1663;55110;4033;4815;51258;106707243;55885;160518;10162;360030;51348;8076;79602;5554;10526;283420;55846;10436;2059;79912;9332;654429;83461;58516;2012;120939;259289;57379;4074;79923;57613;5763;83695;387837;254013;775;2904;729025;55711;259290;100528032;440087;3820;170482;100287284;259293;9918;7450;57494;196415;8082;9052;3741;80763;338821;5893;5555;79370;6540;54682;93589;5830;939;8798;3824;50835;8531;353164;4256;121506;50839;56341;4839;10059;50837;719;716;341350;50840;9746;144699;11272;5542;25900;65125;969;3945;5744;440077;339;23085;5139,279,0.83818305347082100000
chr8,47536057,146174033,98637976,1,1,1584;114569;51366;9166;4683;137835;84948;11156;225689;286053;25879;767;169200;137872;492307;51059;2907;157724;137886;10434;23237;4067;25897;55093;11059;642475;862;6132;26233;79776;10565;56704;65986;2875;3788;203062;1936;83988;6482;51101;4982;80728;51337;6101;23144;6591;116328;528;79645;286075;96764;81796;9650;9401;6156;22827;7038;55824;389690;2738;10404;28998;79977;375686;389677;90987;5462;646486;91147;138046;79139;23678;4609;9420;57152;100533106;340385;54212;51105;29894;4986;441376;64798;55636;8629;1581;55529;100130274;105375787;340359;168975;79815;3646;57094;10940;10584;169044;4856;6383;80243;100130742;85453;137735;5168;5150;65263;340371;203111;4715;23643;761;157869;253943;203054;84988;55039;3612;55074;79848;114907;8694;392255;23414;157506;642658;79666;100533105;9312;81034;340419;85444;115111;85479;137209;100127983;8895;57210;157657;1807;26166;83482;286144;55284;4173;8439;93594;286183;137797;23513;9788;84675;619279;51236;64089;5375;22882;2167;575;7553;7564;5324;414919;6129;2131;195814;23471;100130301;10656;55656;54928;138009;56169;5591;389692;84955;5747;26873;23462;10499;2669;84232;79752;8928;729330;4796;7534;759;4061;29088;5569;286148;10247;50807;64321;169166;157769;79943;1537;6674;25788;8840;79792;441381;245972;114;157638;157807;80778;5862;432355;9831;7264;54714;56943;90362;115908;8601;116039;7381;79870;93100;6788;7373;8767;8581;9705;9684;2765;29967;114822;340390;5179;157777;90990;654463;137695;54704;27012;11244;84294;28991;2843;79075;51050;83696;8836;50484;734;7227;51606;27067;64168;4062;54968;6224;1875;7071;92140;81858;25962;55638;6873;51123;793;7336;79581;1585;85481;8000;83481;114788;646480;2138;84875;312;389676;54108;23212;10987;92421;94241;29028;9134;1345;23246;5828;27085;100132813;56260;80124;51571;9897;286128;401466;1052;157567;1666;1015;444;3174;7013;51001;28957;137392;54742;3786;54332;9699;84985;54845;90390;111188157;22898;100129654;7274;27161;286077;137682;50626;286151;157680;55630;389668;7163;9242;83690;338328;23639;169026;137902;55156;2831;11236;23213;286187;340393;8667;55353;8323;6503;51582;3574;11075;5339;254778;5885;84933;51160;2171;51110;63978;4956;4603;79145;115294;10086;389658;727957;4325;100861412;6386;93035;4342;58500;401474;23514;7201;6921;5440;157753;1392;10221;57623;9694;81501;6641;9821;26986;3037;284;347051;83940;6713;113655;4147;157378;66004;51115;760;114786;8733;10397;6917;377677;54512;27319;23167;51305;9791;9760;51633;3297;8989;116447,404,0.40957855826238800000
chr8,404136,43055737,42651601,1,1,377630;203102;1508;83650;2053;27257;55806;504180;8756;84513;26260;54793;286097;389643;619373;245910;10671;245908;51669;503618;155;9070;100289462;4482;7976;203074;4747;59339;9228;1960;6570;1135;55246;1672;2137;8754;84197;5533;541565;57509;645402;2626;2515;7994;613210;51125;56154;79698;79648;1670;157855;286;11030;8658;9258;2267;414325;137868;645836;4481;2055;11178;389610;80005;23484;6867;63898;1669;203076;427;1191;83648;55756;56892;55872;79618;1667;2260;613209;81551;137964;157285;2961;252969;1142;100132396;6770;392188;5157;64641;138050;23516;148;84549;114926;5108;6781;5368;64236;25960;140596;100133267;10395;3551;100133251;85002;51435;6440;2936;91694;2185;9108;137970;4023;137075;157697;1846;4017;64478;728957;9639;100131608;27121;5423;286046;79660;2222;8793;29883;84750;661;2039;55174;7991;157313;9;79845;29942;10947;7993;503841;389649;3620;10407;1978;157574;9796;7486;1808;9530;203069;2675;157848;157310;54984;23221;157695;137994;6575;55145;55790;245909;81790;90459;5516;9920;5520;26281;137492;23087;10174;9172;51201;8795;11212;80139;503614;83877;83595;653423;100131980;2339;55124;23362;8797;1673;4824;66036;8794;285;84296;157773;8749;11160;401447;392197;55909;80346;9583;728358;245940;286133;84376;6422;649;55894;10361;57805;91782;2796;55290;169355;80185;10;78986;27299;10863;613211;10687;157570;55140;203100;665;4741;7419;9046;1668;23039;23259;8973;79873;137814;55893;23303;526;203190;100507341;57604;1671;3084;640;137362;80223;6542;5327;8822;653333;55326;94137;51312;54904;64760,252,0.59083362427590900000
chr18,1,78077248,78077247,1,1,100526842;1630;23255;57132;125228;642597;84735;284252;5596;7525;84064;284257;1005;83539;6139;101927322;9984;10928;162655;63895;162699;64863;342850;374868;7541;2587;26040;4200;64762;80000;114799;9658;147407;147495;9218;54877;81832;9229;7298;26251;91133;56907;92126;57724;7050;26256;8715;30827;23347;2627;10627;143471;8736;374860;171586;284217;23136;284266;100505549;85019;51046;8774;645369;494470;57045;728929;4152;652991;201501;9097;644041;10650;57565;5268;79822;100101467;8170;1830;23253;5289;54941;6875;201475;3909;125476;7776;374864;83473;10403;54495;1824;388468;115701;79863;8710;6860;25914;7572;114876;1829;147323;23327;28316;6093;1149;5771;57614;79959;6632;252884;57534;51124;7276;80148;81929;56853;6014;5205;125488;284273;284293;84552;55250;9388;220164;5366;116;89778;83876;55628;25941;4645;3998;8780;103910;147372;8792;4772;84617;4155;3613;56984;65258;2235;29919;91768;9663;5273;23239;339291;11201;4087;79839;55748;2589;753;2922;284274;55125;28513;1528;201456;84203;4864;55197;9306;9331;59340;80206;494514;55205;6925;4160;55364;54808;81035;220134;6563;147463;162681;9063;8731;10666;64693;100506888;51320;147381;5874;25925;1828;80323;1823;9480;5275;8932;27164;440498;498;89777;51444;4729;84034;4677;29906;9989;4089;23556;9150;1837;10194;220158;6317;125336;6318;4092;284254;115106;27098;10892;646000;90701;5271;29090;10907;9811;125704;55556;25800;4158;497661;400658;10982;51224;5932;5055;5797;10939;1068;6760;84307;80816;83608;55034;10449;147409;11031;361;55520;4161;30062;4225;23335;596;1000;339302;2774;22850;9050;147339;220136;220441;1825;57536;9525;2531;22878;9352,267,0.34196902459944600000
chr7,150911408,159128529,8217121,1,1,54480;58508;140545;5799;1804;389602;22976;6009;57180;6469;3110;168391;2020;3638;51667;51422;349136;63917;155051;155435;3361;64327;64434;10061;9690;55112;6604;7516;7434;285888;54892;10049;57488,33,0.40160051190678600000
chr16,29707373,30197341,489968,1,1,653808;5531;26470;283897;253980;146378;8479;83719;23475;283899;124446;9344;3835;4150;226;253982;83723;5595;6911;11151;8448;79447;112476;9961;10423;79153,26,5.30646899389348000000
chr15,22318918,32914140,10595222,1,1,321;7681;123606;283694;643699;390538;23359;6638;22909;8926;161725;283710;283685;653720;89839;4692;54893;23191;283767;728498;2562;101059918;9824;4948;57194;81614;4308;2558;1139;7082;8924;114791;23742;51621;7337;89832;653125;653073;2567;54551;728047;56160,42,0.39640509656145000000
chr22,18661524,21561670,2900146,1,1,54487;27037;9342;29801;65078;10587;1312;6545;8214;7290;421;2812;6899;5625;7625;79680;64976;6576;3053;8218;5413;80764;23617;400891;1399;7122;150209;128977;8220;388849;84861;7353;51586;2928;128989;5297;9127;9993;54584;91179;85376;8216;85359;8318;728229;5902,46,1.58612704325920000000
chr17,16822683,20193169,3370486,1,1,2314;55244;125170;55090;11216;79018;79999;10400;54890;254272;9706;400581;92521;8533;22905;729288;5598;218;23164;83450;224;51168;80039;51655;201163;7156;51030;5636;644815;10750;4239;10517;654346;10743;388436;27077;140775;6470;146691;1819;6720;125206;23495;147166;7732;146802;91647;56953;645027;3996;201164,51,1.51313490102021000000
chr7,72745047,74139390,1394343,1,1,5982;51085;9275;84277;7462;135886;83451;1364;6804;7461;155382;3984;26608;8468;9031;155368;2969;8326;7458;9569;2006;1365;114049,23,1.64952239154928000000
chr10,133536778,134924296,1387518,1,1,664;80313;170394;3632;55844;54777;282973;282974;84435;10570;84504,11,0.79278250804674200000
chr22,23739437,24988455,1249018,1,1,4320;3543;7621;2952;66035;388886;391322;400916;150248;266747;51733;2678;653689;4282;83606;23384;135;51233;6598;1652;29802;56241;100037417;2687;23523;6634;91319,27,2.16169823012959000000
chr2,1717940,29814127,28096187,1,1,388939;114818;285148;100526794;375190;348654;51692;55256;6382;54454;339778;3777;4613;200634;10971;9577;9784;57665;92749;11321;3797;8853;3032;1058;51112;339779;8890;22950;51374;130502;78989;22924;338;79677;129607;28951;9014;7349;8884;64838;51639;9913;1788;9781;23160;109;54978;23369;80304;150921;790;85465;2976;84226;10890;23620;2646;7837;23040;165082;343930;5443;84450;238;348738;8462;7260;3241;729475;1838;165324;6201;4148;2281;728597;130106;11117;57159;54867;3790;130814;50618;9270;5500;7781;129642;64342;9741;165186;9553;151056;55252;60526;81553;79635;56896;84696;100129278;22979;130557;51594;4358;9475;151449;9687;3795;391356;130497;4953;151354;26160;3398;79954;10408;245973;91543;23175;6664;375189;7447;57498;150946;93034;100128731;79745;5496;130813;9540;10669;1653;6241;245711;10130;1876;29959;246243;2355;388931;192668;653140;388;79172;8648;57539;55821;64080;60509;29841;3754;285126;9381;51277;6868;55006;10113;3030,156,0.55523548444491800000
chrX,122207989,123357985,1149996,1,1,57187;10735;2892;331,4,0.34782729679059800000
chr8,12583259,31874482,19291223,1,1,29942;2053;55806;7993;64760;8756;157574;54793;9796;7486;286097;389643;1808;619373;203069;2675;10671;51669;157310;23221;7976;4747;55790;1960;2137;6570;1135;55246;5516;5520;137492;26281;5533;23087;10174;8795;51201;541565;57509;55124;23362;8797;56154;4824;8794;157773;11030;2267;137868;23484;11178;4481;80005;55909;80346;9583;63898;286133;427;1191;55756;649;55872;10361;79618;57805;91782;2796;81551;2961;10;27299;10863;5157;10687;64641;157570;23516;55140;665;4741;148;9046;23039;5108;6781;5368;64236;79873;137814;10395;55893;23303;51435;6440;2936;526;203190;91694;2185;9108;4023;1846;100507341;57604;4017;3084;8793;29883;6542;661;2039;55174;7991;8822;51312;157313;9,118,0.61167713420761300000
chr14,43708247,60573876,16865629,1,1,30001;112849;93487;64430;55172;10640;9787;79609;387990;23588;64841;51637;79944;57161;5427;387332;55320;114088;26520;2643;5836;9786;10175;2287;140801;161357;55195;5732;80821;122525;23002;652;23034;283554;6235;6815;57697;5684;3958;3895;23116;9147;51199;5706;10668;122830;5926;8814;51528;122773;54331;81542;60485;57544;11183;22795;22863;1033;51062;145447;382;54813;51339;55745;84075;6252;54916;2764;341880;145407;122769;6655;64582;122786;11169;5729;4247;10979;55030;27109;6166;122809;55015;729665;5015;55860,86,0.50991279364677100000
chrX,153595473,153822717,227244,1,1,55558;2539;1774;246100;8270;9130;537;60343;2010;8517;2664;2316;6134;8273;6901;8266,16,7.04088996849202000000
chrX,122801087,123266951,465864,1,1,57187;10735;331,3,0.64396476224821000000
chr22,18919942,21440514,2520572,1,1,54487;27037;9342;29801;65078;10587;1312;6545;421;7290;2812;6899;5625;7625;79680;64976;6576;3053;8218;5413;80764;23617;400891;1399;7122;150209;128977;8220;388849;84861;7353;51586;2928;128989;5297;9127;9993;54584;91179;85376;8216;85359;8318;728229;5902,45,1.78530904889842000000
chr22,18641409,20311763,1670354,1,1,54487;27037;5413;29801;65078;23617;10587;1312;7122;8214;7290;421;128977;8220;2812;388849;7353;2928;128989;6899;9993;54584;5625;79680;85359;64976;11274;8318;6576;5902;8218,31,1.85589402007000000000
chr1,94402047,108756664,14354617,1,1,9890;277;1266;100527978;54112;148867;101928436;1806;22854;1901;391059;118427;8634;163404;64645;163786;7412;127495;276;10451;24;178;54873;29957;55599;54482;2135;2152;199857;8556;51611;279;1629;1301;58155;55170;148534;126969;23443;51375;278;5825;280;9411;25950,45,0.31348798787177700000
chr2,219713606,221090946,1377340,1,1,130617;10290;29926;8941;3300;3623;79411;255101;80326;23549;55515;114790;79065;130612;5798;8576;100996693;1412;23363;1674;3549;10058;55139;79137;7277;6508;54738;27013;389075;79586;79840;7475;151295,33,2.39592257539896000000
chr22,18641409,21440514,2799105,1,1,54487;27037;9342;29801;65078;10587;1312;6545;8214;7290;421;2812;6899;5625;7625;79680;64976;11274;6576;3053;8218;5413;80764;23617;400891;1399;7122;150209;128977;8220;388849;84861;7353;51586;2928;128989;5297;9127;9993;54584;91179;85376;8216;85359;8318;728229;5902,47,1.67910814349587000000
chr22,17029055,37959706,20930651,1,1,23481;1413;24144;129049;7533;100423062;613;4733;391322;2130;400916;23541;114904;7078;4357;91227;402055;6948;80831;51537;55670;64976;6576;2687;83733;3985;164592;8218;6634;200312;23753;730005;29775;57168;5594;550631;23598;23617;25807;3543;6527;7621;3976;2952;7122;8563;4744;5297;440822;2928;129080;140883;54584;2678;6523;8318;1652;728229;23523;6525;4320;27440;140606;4627;23543;6753;8897;10587;80832;1439;51493;7290;150280;2812;150248;9681;23759;150223;9647;5625;4282;653689;55954;11274;23331;80830;3053;23762;150290;164656;25793;4689;255349;8224;2781;1399;4174;162;29796;80020;253143;11200;84861;7353;51807;266747;8508;51733;9993;7494;10738;85376;440804;85359;4151;164633;10369;5816;10633;9215;5880;23761;5902;91319;7332;85379;23544;284898;150274;9342;65078;27128;80833;1417;150275;1312;51816;6545;23780;8214;421;129025;10739;8459;157;83999;150160;4242;7625;27439;23119;529;29802;91464;50487;1415;105372977;5413;80764;22880;84164;7441;114794;11135;66035;150209;10043;8940;128977;128989;113791;79734;150221;91179;3560;83606;8664;23384;56241;5008;27124;1414;388886;10042;101929372;89781;5988;57553;25775;54487;27037;4330;29801;652968;91445;254240;284904;7263;23532;150297;645426;29799;91355;6899;27156;27443;79680;637;23760;3162;150165;100037417;25770;9609;339665;339669;266629;11020;10634;400891;84700;8220;388849;51586;9127;56478;25828;23765;4771;84133;83874;8216;9814;135;51233;6598;10291;23551;23786;9514;128954;8542,242,1.15619910723274000000
chrX,2651980,153771517,151119537,1,1,23096;64061;392509;10214;170685;23157;727837;55998;23439;729431;10916;158586;55859;331;3423;54830;4168;6901;5358;92002;27344;729447;54328;266740;9075;102723737;7552;729422;54954;84460;389874;56000;340562;644538;92552;254158;79649;56850;2824;51186;3149;26576;100130361;1730;347541;139425;3547;728695;729408;79921;57826;59272;203413;2986;7512;9737;8544;55634;2857;3421;537;11013;340554;5716;6658;4101;54457;91966;441519;4100;5931;27316;7403;4534;6839;51480;728096;27112;92129;101928917;140462;8241;6567;827;203569;27301;84548;645037;54413;100133053;7355;254065;79836;10084;347442;60343;51765;55593;139818;56180;6303;8269;142684;7626;10046;8409;203447;63932;2710;8406;51248;56001;51616;2925;100130613;2564;100132994;5354;11043;340533;22;3476;84631;26748;11238;203562;102723631;170261;58526;441525;4983;29944;6907;1536;2539;1478;9468;23597;2187;1287;81887;6611;3561;9767;9282;54857;347365;10800;139341;54539;11219;728062;169966;51209;23630;26548;1121;2000;645188;51438;2846;280658;1852;347344;23229;10857;56157;286430;101059915;5277;9758;1069;4674;154796;56548;51309;1184;645073;80712;1774;10245;2258;728343;9823;441531;11141;643311;90121;256643;23676;4114;6758;4107;286499;5009;1654;1831;51284;94121;170302;11230;79135;286410;9210;2491;441490;84187;633;6191;64743;4110;3598;389856;7789;55787;9452;50814;139422;170062;57187;139067;4104;203427;4693;5456;10013;1964;55190;100996648;9016;100528062;30011;90316;93953;10178;6322;28952;24137;2332;4105;94122;84968;64663;1538;9142;2245;5634;9506;79576;3266;139212;5207;6535;393;389852;170626;91851;27334;158866;550643;159013;407;7224;55796;10761;168400;4281;158835;24140;8471;90167;7737;7319;10149;11279;6134;1678;139322;5063;55906;84443;27197;8233;548313;6872;27018;100129239;139105;7102;10549;26071;2664;59353;8573;28985;728049;728090;158521;139886;282808;9130;728082;778;90843;1756;5422;7317;5935;347454;29071;4112;412;158506;340602;5127;22866;93380;159091;10159;212;139285;9338;85417;8266;100132399;158584;494118;190;7569;89801;2892;1968;5230;57232;55559;57529;8277;63035;80231;286436;25975;51311;8905;55086;139735;395;83692;171484;169981;1349;63904;257397;142689;80258;27035;1641;55613;7105;100329135;84295;9459;4810;404281;4109;367;6748;139760;347487;92745;158830;53344;4103;9203;139378;186;474343;2719;3597;140456;9248;402415;203430;9185;90161;728042;4129;65267;56849;8228;8226;728036;7114;6399;4952;84889;8481;6757;347468;347475;414;6759;9500;51132;8823;541578;2158;55609;2556;494119;6756;9502;158880;8517;8242;57595;51442;389895;100132304;9754;80311;6102;27328;695;56159;51213;90737;60506;10943;100873985;57526;728269;170082;102723680;728656;3358;8273;83844;114824;389840;170067;81557;80823;8862;2002;7216;79979;158763;23641;8270;57477;7592;2833;425054;340526;727866;139599;139804;54470;8450;959;139562;645864;10075;117154;57631;2010;54521;79589;51634;3750;653282;728072;7076;392490;9363;3920;100506164;347411;7454;265;90293;645051;100529097;55511;158724;6197;203547;139135;5355;347516;203522;139081;6451;27336;158787;728458;7499;4841;347517;51360;340578;139596;1896;441509;54466;660;158798;4108;171482;79868;728075;158833;79366;1821;56156;392465;1260;5160;56062;5303;3054;51260;139628;653220;340596;554;28986;23133;57393;2623;4113;57692;50945;3730;7739;100131755;57481;8260;139170;64219;4204;389860;2574;10325;6170;10813;79710;8712;26280;2316;256714;10742;6173;9104;494197;29057;139324;442444;6103;54880;90736;55558;2742;369;255313;3654;170627;645974;3897;79983;727940;541466;347527;8243;4007;139741;29978;2182;7504;60401;84707;53336;159090;94056;57502;55285;653067;1046;11152;641339;1947;8852;7712;23708;203523;4267;54967;340542;89885;2277;83550;644353;55916;340595;6594;139189;63947;9643;9843;4935;139728;100288814;10479;50943;53940;55026;100507170;5638;4478;8239;4068;51114;139411;9968;84679;115201;100533997;1741;416;64840;10682;11326;25763;27330;171483;8908;27286;1038;7543;158800;90060;1288;84061;215;6247;292;55879;401612;1183;340527;29935;158983;357;10009;2747;2652;286514;340543;54885;100129407;10495;6792;79742;140886;2239;2334;4128;441518;139604;4303;55869;25878;4115;11040;8473;6855;84636;55922;728712;5956;2705;55841;54821;729396;441521;8933;10735;729442;9949;4694;84528;51481;492;3028;100129520;795;10389;83604;9947;9367;100463488;10134;79057;54552;6906;340547;30014;415;5255;680;158809;6990;4435;5475;340529;65109;64860;7030;729428;8776;4675;5030;51566;729201;56271;4943;79917;85012;114928;5256;26609;54960;538;6853;5365;286451;29934;10838;139221;347404;3251;286464;158931;139793;100008586;2717;3052;5973;139065;5199;546;5613;51270;139231;9131;7547;257240;11254;27238;64102;2543;158747;2273;56474;5165;64648;54440;140597;5631;728239;3188;100130086;5251;8237;286527;100130302,776,0.51350077918780300000
chr12,121572578,133767986,12195408,1,1,386653;9612;2967;57647;51433;79676;7637;9735;91574;196383;22953;92293;5901;114795;9026;55206;84876;8843;23504;9271;140707;23141;10645;23457;8099;5715;5827;100507055;101060200;79867;27198;121256;144406;79720;23545;283383;65082;6249;144347;80196;11211;317781;2054;79050;254050;605;3242;22877;57666;79369;56616;6433;5426;57634;338442;7574;144348;144423;2802;5025;7699;7316;8408;80324;5027;84678;8562;121260;65117;192111;100289635;65985;387893;10198;11066;10795;1967;144404;51329;80212;55743;283385;54509;353116;23067;949;57696;84660;57605;55596;4326;10959;7556;196385;50614;100533183,96,0.78718153586989500000
chr5,86519499,91982005,5462506,1,1,57561;5921;153364;116068;84059;10622;4208;1070;153396;902,10,0.18306616047652900000
chr16,29673954,30198600,524646,1,1,653808;5531;26470;283897;253980;146378;8479;83719;23475;283899;124446;9344;3835;4150;226;253982;83723;5595;6911;11151;8448;79447;112476;9961;10423;6693;79153,27,5.14632723779463000000
chr9,271257,39156954,38885697,1,1,58524;10171;55664;23586;92014;3439;100129669;51754;79269;10210;2189;6461;79937;25853;7094;54796;158326;55064;4712;84688;2315;6366;5991;6456;51510;1211;26953;3717;10488;2592;3444;55833;971;23349;3641;7306;25822;158219;286319;79956;55958;3443;64922;2731;253650;1271;10280;79886;27240;100129969;7415;84720;56656;10020;27290;7016;5646;4300;9350;54914;340485;6363;10850;730112;26267;11258;3442;881;81704;3452;158038;7169;347252;6019;347240;169792;6505;203259;138715;54801;10497;4781;3447;8777;51271;158234;7436;90871;3448;3590;25769;338376;646962;573;360;3456;55848;768;152006;10655;80380;27019;30968;2683;54926;203260;23081;50808;57462;56832;259308;5079;158358;401494;392309;401505;203238;54586;23189;730098;9853;5789;3301;54840;80256;286343;55667;1993;29126;340481;3441;90865;123;63951;138716;3449;55234;403313;169522;1030;9373;6595;3467;65083;441459;219;92949;3445;1029;4882;10670;4799;89882;8434;4507;364;9380;375704;203228;84904;9925;6619;26206;7010;51010;9827;158297;3440;6194;3446;64425;1761;100129385;11168;392307;3451;54875;57704;9833;6013;138724;138474;57589;80173;48;115426;158376;84186;79817;9933;692094;84681;11172;152007;22844;318;401498,197,0.50661300991981700000
chr17,16769800,20446820,3677020,1,1,2314;55244;125170;55090;11216;79018;79999;284194;10400;54890;254272;9706;400581;92521;8533;22905;729288;100996259;5598;218;23164;83450;224;51168;80039;51655;201163;7156;51030;5636;644815;10750;4239;10517;654346;10743;388436;27077;140775;6470;146691;1819;6720;125206;23495;147166;7732;146802;91647;56953;645027;3996;201164,53,1.44138459948545000000
chr5,176382009,176832993,450984,1,1,27166;64324;23567;2264;6569;345456;53917;83463;10636;10960;2161;51720,12,2.66084827843116000000
chr15,23699701,28525460,4825759,1,1,2562;7681;23742;8924;7337;6638;2567;4948;8926;57194;54551;4692;2558,13,0.26938767559673000000
chrX,152911941,153595473,683532,1,1,3654;8260;3421;5973;1852;3897;4204;3054;215;6748;10134;5365;139728;8277;26576;728458;8269;5956;2316;554;6535;57595;393;2652,24,3.51117431224873000000
chr7,72766313,74133332,1367019,1,1,5982;51085;9275;84277;7462;135886;83451;1364;6804;7461;155382;3984;26608;8468;9031;155368;2969;8326;7458;9569;2006;1365;114049,23,1.68249307434644000000
chr6,288915,2029906,1740991,1,1,2295;56940;55770;2762;3662;135458;94234;2296,8,0.45950840641910300000
chr1,146324068,147786706,1462638,1,1,9557;51205;51463;2703;5565;607;2702;2330;200030;149013,10,0.68369617089122500000
chr1,231692378,249212666,17520288,1,1,127077;25909;200150;200159;57568;127069;84288;1130;51029;6894;81469;55083;391196;23029;127623;7257;343173;6905;127064;26246;55127;79894;391189;128178;441925;441932;401993;6000;10472;51742;56605;57116;80851;79862;23596;1131;267002;343563;317705;148789;391195;26245;57829;114548;148641;26188;403239;9453;7107;388753;163882;391211;159;284521;4548;343169;359948;6262;84451;128025;27185;84838;391194;9804;3192;9156;93474;1122;127074;8564;81472;127066;127068;646627;391190;64388;388759;441933;403244;343172;25893;7678;284532;10000;88;2271;26696;55657;391191;64754;81466;127059;127062;645745;54627;10806;2786;3964;401992;343171;254879;116228;257044;80003;3775;9859;81470;148823;4811;64216;440738;56776;84284;401994;391192;51097,116,0.66208957295679200000
chr7,72726578,74139390,1412812,1,1,5982;51085;9275;84277;7462;135886;83451;1364;135892;6804;7461;155382;3984;26608;8468;9031;155368;2969;8326;7458;9569;2006;1365;114049,24,1.69873981817821000000
chr16,29673954,30198600,524646,1,1,653808;5531;26470;283897;253980;146378;8479;83719;23475;283899;124446;9344;3835;4150;226;253982;83723;5595;6911;11151;8448;79447;112476;9961;10423;6693;79153,27,5.14632723779463000000
chr16,29673954,30198600,524646,1,1,653808;5531;26470;283897;253980;146378;8479;83719;23475;283899;124446;9344;3835;4150;226;253982;83723;5595;6911;11151;8448;79447;112476;9961;10423;6693;79153,27,5.14632723779463000000
chrX,48317360,52838306,4520946,1,1,729442;64743;9500;389856;170685;727837;139189;392465;778;5935;729431;9502;26748;10013;55190;653220;50943;340602;27344;28952;729447;85417;100132399;7030;729428;2623;729422;89801;4943;56850;79917;2574;9506;64840;10682;3266;8712;729408;81557;6757;494197;100008586;57477;280658;90060;24140;92745;4007;6839;3750;1184;7454;27238;645073;645037;10245;645051;2543;653067;7355;11152;10084;5355;55593;8852;23708;728239;11040;6855;11230;9210;729396,72,1.59258703819953000000
chr8,132979002,146298143,13319141,1,1,65263;1584;340371;84948;137835;11156;93100;225689;203054;84988;22898;111188157;8694;8581;27161;286077;51059;2907;642658;50626;23237;2765;9684;55630;114822;642475;340390;6132;26233;338328;23639;90990;2875;57210;203062;1936;6482;80728;51337;23144;286075;23513;83482;137797;340393;51236;9401;28991;2843;22827;7038;83696;575;389690;2738;6503;7553;7564;5339;414919;375686;90987;3786;51160;4062;10656;65265;389692;10086;81858;5747;26873;727957;84232;79581;1585;57152;58500;8928;340385;8000;729330;4796;83481;116447;51105;84875;29894;4061;54108;57623;8629;79943;23246;1537;113655;100130274;105375787;8840;66004;79792;286128;441381;80778;8733;432355;10397;169044;9831;7264;54512;23167;51305;3297;54742,115,0.86341904481677900000
chr15,23208842,28535051,5326209,1,1,2562;7681;23742;8924;7337;6638;2567;4948;8926;57194;283685;54551;4692;2558,14,0.26285111981148300000
chr10,1885916,12539633,10653717,1,1,3698;57118;83592;79746;3559;2625;8644;1316;114131;51806;26019;54522;84893;80760;55176;11164;810;10276;254427;10659;1109;83860;10531;5214;57713;509;79754;5209;3601;79861;5588;9712;84991;54906;22944;8872;55526;1646;2665;1645,40,0.37545581509251700000
chr18,23738101,27299840,3561739,1,1,143471;6875;284252;361;1000;83539,6,0.16845703741908100000
chr18,14316,14733870,14719554,1,1,116;23255;57132;8774;645369;125228;57045;103910;642597;84617;9097;7525;10650;3613;56984;65258;79822;84034;4729;23253;9663;9989;339291;9984;10928;162655;63895;201475;64863;342850;27098;646000;753;7541;55125;55556;10403;4158;84203;388468;147495;9218;5797;494514;1149;5771;10939;1068;79959;9229;7298;91133;11031;56907;7050;81929;4161;81035;2774;23347;10627;8731;8736;284217;23136,65,0.44158946663737200000
chr16,14968855,16194578,1225723,1,1,4629;100288332;123811;89927;4363;9284;54820;23420;255027;23042;54700;123803;9665,13,1.06059852022031000000
chrX,48434460,51488004,3053544,1,1,729442;64743;389856;100008586;57477;170685;90060;392465;139189;778;5935;729431;26748;10013;4007;55190;50943;340602;6839;3750;27344;28952;729447;85417;100132399;7030;729428;7454;2623;27238;729422;645073;1184;645037;10245;89801;645051;2543;7355;56850;11152;79917;10084;5355;2574;55593;9506;8852;23708;3266;11040;8712;6855;11230;9210;729408;729396,57,1.86668343406874000000
chr16,84341219,90111263,5770044,1,1,2294;81631;115992;4597;2300;763;197320;64779;1535;51693;79007;339145;124044;9914;79786;9605;2303;4157;404550;79791;100506581;353;2622;8140;6137;83716;27189;333929;1327;57338;92822;92806;390748;54758;863;23174;146429;23199;9764;124245;100287036;23406;100129697;3394;348180;9780;81620;10328;5119;54849;55625;27132;29123;57707;51659;197322;2588;6687;54971;2175;1013;9100;124045;161882;84501;22980;84627;58189;10381;1800;8558,71,1.23049321634289000000
chr1,203954724,206305206,2350482,1,1,23114;10446;4194;254428;93273;2005;148808;9580;55220;127845;5929;115019;81788;729533;8934;6900;5129;85414;440712;5972;25778;84919;55224;553;388730;3814;148811;9911;5287;22874;64710,31,1.31887842578671000000
chrX,152916694,153406233,489539,1,1,8260;3654;3421;5973;1852;3897;4204;3054;215;6748;5365;10134;139728;26576;8269;554;6535;57595;393,19,3.88120251910471000000
chrX,153576890,154560375,983485,1,1,55558;139716;1736;8263;1193;8270;9130;537;2157;100132963;7411;2010;8517;30848;6134;6901;8266;116442;2539;1485;1774;246100;100272147;60343;65991;4354;474382;2664;2316;8273;79184;4515,32,3.25373544080489000000
chr7,72766312,74142342,1376030,1,1,5982;51085;9275;84277;7462;135886;83451;1364;6804;7461;155382;3984;26608;8468;9031;155368;2969;8326;7458;9569;2006;1365;114049,23,1.67147518586077000000
chr18,118760,4470508,4351748,1,1,116;55556;10403;9663;103910;7050;9984;9097;7525;81035;23347;10627;494514;64863;1068;8736;27098;9229;84034;7298,20,0.45958543555371300000
chr16,29656012,30143015,487003,1,1,653808;5531;26470;283897;253980;146378;8479;83719;23475;283899;124446;9344;3835;4150;226;253982;83723;5595;6911;8448;79447;112476;9961;10423;6693;79153,26,5.33877614716952000000
chr12,13752264,13786366,34102,1,1,2904,1,2.93237933259046000000
chr16,29656012,30143015,487003,1,1,653808;5531;26470;283897;253980;146378;8479;83719;23475;283899;124446;9344;3835;4150;226;253982;83723;5595;6911;8448;79447;112476;9961;10423;6693;79153,26,5.33877614716952000000
chr16,29415794,30271971,856177,1,1,654483;552900;283897;83719;23475;283899;548593;445329;226;613037;253982;83723;6911;11151;79447;112476;9961;107282092;79153;653808;5531;26470;253980;146378;8479;124446;9344;3835;4150;5595;79008;8448;6818;10423;6693,35,4.08793976011969000000
chr15,23795653,28542402,4746749,1,1,2562;7681;23742;8924;7337;6638;2567;4948;8926;57194;54551;4692;2558,13,0.27387165405206800000
chr13,100457044,109597592,9140548,1,1,2259;9358;54841;196541;171425;23026;87769;259232;84899;93081;84945;2073;55082;5095;79070;728215;643677;85416;1948;7174;7546;3981;100533467;10673;6555;267012,26,0.28444684060518000000
chr16,14886395,16620750,1734355,1,1,100288332;23042;101059938;368;123803;9665;4629;123811;89927;4363;9284;54820;23420;408050;255027;54700,16,0.92253316074275400000
chr6,195438,7403236,7207798,1,1,6745;6239;57128;9450;56940;94234;2296;9425;63027;51299;222826;670;5272;10799;285782;3662;10455;404220;648791;389362;10667;2762;1992;2162;4835;8899;8737;2295;56897;55770;340156;7280;347733;221749;26240;83732;135458;5269,38,0.52720678354193600000
chr18,131935,6987268,6855333,1,1,91133;116;55556;10403;9663;645369;103910;642597;7050;9984;9097;7525;81035;23347;10627;494514;64863;1068;8736;9229;27098;284217;79822;84034;23136;7298;7541,27,0.39385395282767400000
chr16,29656012,30271971,615959,1,1,653808;654483;5531;26470;283897;253980;146378;8479;83719;23475;283899;548593;124446;9344;3835;4150;226;613037;253982;83723;5595;6911;11151;6818;79447;112476;8448;9961;10423;6693;79153,31,5.03280250795913000000
chr4,116643,2617410,2500767,1,1,10336;7700;521;7469;401115;4636;10417;84286;654254;54872;1609;2261;255403;79441;7884;170960;57732;7468;152877;10296;57654;353497;10460;3954;10861;92305;285498;339983;10815;2580;53834;84179;5158;402160;3425;10608;1487;6047;54729;285464,40,1.59950927055579000000
chrX,118869568,123316196,4446628,1,1,10735;4694;158798;84528;255313;728075;158800;728082;8450;23439;57187;347454;29071;727940;7737;331;55026;653282;728072;728096;100507170;65109;3920;10009;2747;728042;2892;643311;728036;728090;79576;6170;28985;728062;728049,35,0.78711329124001400000
chr8,106498414,146280167,39781753,1,1,1584;114569;9166;84948;137835;11156;93100;286053;225689;7373;8581;51059;2907;23237;2765;9684;55093;114822;642475;340390;6132;26233;90990;2875;654463;203062;1936;6482;4982;80728;51337;27012;11244;23144;286075;84294;9401;28991;2843;22827;79075;7038;83696;389690;2738;28998;7227;375686;90987;5462;4062;65265;81858;55638;6873;79139;79581;1585;4609;100533106;57152;340385;8000;83481;114788;51105;84875;29894;312;54108;441376;64798;29028;8629;23246;100132813;27085;100130274;105375787;51571;9897;286128;340359;3646;10584;169044;4856;137735;5168;3786;54742;65263;340371;4715;84985;203054;84988;55039;90390;55074;22898;114907;111188157;8694;27161;286077;23414;642658;50626;55630;340419;338328;137209;23639;57210;169026;23513;83482;137797;93594;11236;9788;51236;8667;340393;22882;575;6503;7553;7564;5339;414919;5885;84933;51160;2131;10656;56169;389692;84955;10086;5747;26873;727957;84232;93035;58500;8928;729330;4796;401474;4061;7201;157753;10221;57623;9694;6641;50807;157769;79943;1537;284;3037;83940;6713;113655;157378;8840;66004;79792;441381;114;157638;80778;8733;432355;10397;9831;7264;54512;23167;51305;3297;56943;116447,186,0.46755104029729400000
chr22,18876605,21441944,2565339,1,1,54487;27037;9342;29801;65078;10587;1312;6545;8214;7290;421;2812;6899;5625;7625;79680;64976;6576;3053;8218;5413;80764;23617;400891;1399;7122;150209;128977;8220;388849;84861;7353;51586;2928;128989;5297;9127;9993;54584;91179;85376;8216;85359;8318;728229;5902,46,1.79313533221145000000
chr15,20172533,28618126,8445593,1,1,2562;7681;727832;100996331;123606;4948;57194;283694;81614;100287399;390538;2558;8924;114791;23742;7337;6638;2567;8926;283685;54551;4692;23191;283767,24,0.28417187520165800000
chr8,8103647,11805820,3702173,1,1,1508;83650;83595;203076;2626;83648;137075;157285;640;66036;252969;286046;79660;2222;54984;4482;8658;203074;9258;90459;94137,21,0.56723443231853300000
chr2,221445156,243068402,21623246,1,1,54658;79853;1285;84289;285093;6694;130916;7857;10316;93010;79083;54579;150681;54578;57140;25992;248;55230;9208;3635;54657;2637;3667;389090;23192;5270;5757;81618;56918;3069;10494;117581;54575;285193;1146;25791;130340;65080;23677;5510;377007;84236;4705;150677;151473;1286;4759;646960;150678;140739;2817;4735;401036;339766;547;55054;116987;79919;8527;23704;3769;375316;54600;116255;130888;666;130367;5077;653437;389084;728294;151176;4880;64090;6364;8452;339768;64708;26058;3267;2859;64284;57590;10267;414061;9759;189;1144;129563;51078;55619;79781;6295;2181;54659;11132;10056;2043;50636;54577;55502;54576;93349;51719;250;9290;8864;26146;5147;80303;5707;80309;1293;23178;80895;5133;3357;165100;79843;3431;10920;10123;9427;80704;51665;257407;57007;129807;1841;92737;4691;130560;51540;200765;56947;375318;55022;251;51052;164781;55355;6672;79054;80210;57624;51281;151278;11262;9470;9320;9855,151,0.69832253677361900000
chr21,10873178,48095807,37222629,1,1,54148;4599;5316;337882;106865373;1409;54101;9875;1826;9073;386679;874;51227;10950;337970;101928147;386681;56245;54943;643812;326;5121;1476;9946;116448;1292;64699;11077;1827;3150;63977;10281;149998;337973;8566;26046;7307;7113;54014;116159;56683;150094;85395;59271;386685;23515;337878;8624;29980;386683;337979;8568;100288323;54149;6450;4731;6493;539;104;54093;5822;6453;4047;54039;337985;7033;353333;23181;3454;25825;23275;2618;337976;2078;3455;1525;140258;56246;64968;49854;89766;754;3460;6647;54065;150051;58494;80781;7327;10785;337879;10841;54033;3753;337972;6782;150084;643803;728299;9992;386672;5211;861;11096;2897;56894;54084;6285;3689;8209;1859;29104;337960;7485;386676;571;386680;7267;53347;7074;5152;10311;150082;3772;3275;54059;8208;9510;10317;5116;84221;29947;337959;4685;6612;337968;85319;755;1291;351;875;10069;7032;100131902;522;53820;9980;337963;337967;353323;7031;3588;6526;10215;7109;140578;386674;386675;23076;6573;3763;2114;353332;3141;4600;337971;54058;8204;386677;89765;30811;337974;337977;5651;337969;388813;57466;140290;54069;2551;757;10600;90625;7179;23562;26285;10694;23308;386678;337975;337880;100288287;54102;317754;6651;8867;8888;94104;64092;25966;54020;337966;9619;386684;388818;337978;386682;254950;54097;56911;873;29761;284827;81543;7226,215,0.57760562801730100000
chr8,12556009,34777508,22221499,1,1,29942;2053;55806;7993;64760;8756;157574;54793;9796;7486;286097;389643;1808;619373;203069;2675;10671;51669;157310;23221;7976;4747;55790;1960;2137;6570;1135;55246;5516;5520;137492;26281;5533;23087;10174;8795;51201;541565;57509;55124;23362;8797;56154;4824;8794;157773;11030;2267;137868;23484;11178;4481;80005;55909;80346;9583;63898;286133;427;1191;55756;649;55872;10361;79618;57805;91782;2796;80185;81551;2961;10;78986;27299;10863;5157;10687;64641;157570;23516;55140;665;4741;148;84549;9046;23039;5108;6781;5368;64236;79873;137814;10395;55893;23303;51435;6440;2936;526;203190;91694;2185;9108;4023;1846;100507341;57604;4017;3084;8793;79845;29883;84750;6542;661;2039;55174;7991;8822;51312;157313;9,123,0.55351801424377400000
chr2,15722801,36640568,20917767,1,1,388939;114818;100526794;375190;348654;6382;6716;54454;339778;3777;4613;200634;9577;9784;57665;92749;11321;3797;3032;1058;339779;8890;22950;51374;130502;22924;338;79677;30845;7349;8884;64838;51639;9913;1788;23160;58484;109;253558;54978;23369;80304;150921;790;85465;2976;84226;10890;51232;2646;55622;165082;343930;5443;84450;238;57448;4052;729475;440854;1838;51646;165324;4148;2281;11117;130106;57159;54867;3790;84661;50618;5500;7781;64342;9741;165186;9553;151056;55676;55252;60526;81553;79635;56896;84696;100129278;22979;130557;6683;4358;151449;25940;3795;391356;130497;26160;10408;375189;92291;7447;150946;93034;100128731;79745;5496;9540;10669;1653;245711;79623;51072;29959;2355;388931;84272;653140;81606;388;8648;79172;57539;64080;60509;285126;25780;7498;9381;51277;55006;10113;3030,132,0.63104250085585100000
chr15,22759875,28681030,5921155,1,1,2562;7681;123606;4948;57194;81614;2558;8924;114791;23742;7337;6638;2567;8926;283685;54551;4692;23191,18,0.30399474426864400000
chr15,23620374,28559437,4939063,1,1,2562;7681;23742;8924;7337;6638;2567;4948;8926;57194;283685;54551;4692;2558,14,0.28345457427856300000
chr17,1656,3853803,3852147,1,1,10594;8388;50628;5023;400566;55178;146760;114826;55421;124641;100506388;84254;83460;8386;8390;23108;55720;1497;29928;727910;29;8578;359845;4641;4335;124997;5176;4995;7531;83903;5026;5048;51763;51031;286753;63826;443;5345;26189;162514;9905;1398;23293;7442;727857;9501;64359;6117;84690;30851;23277;4994;124935;8387;79066;55275;83547;1801;8383;79850;489;8447;8392;23729;5306;3090;4991;3682,68,1.76524935315293000000
chr15,23620374,28343465,4723091,1,1,2562;7681;23742;7337;6638;2567;4948;8926;57194;283685;54551;4692;2558,13,0.27524347932318100000
chr22,18915385,21441944,2526559,1,1,54487;27037;9342;29801;65078;10587;1312;6545;421;7290;2812;6899;5625;7625;79680;64976;6576;3053;8218;5413;80764;23617;400891;1399;7122;150209;128977;8220;388849;84861;7353;51586;2928;128989;5297;9127;9993;54584;91179;85376;8216;85359;8318;728229;5902,45,1.78107853408529000000
chr16,46500511,55797192,9296681,1,1,643802;85320;55027;85407;23594;79190;123970;54947;5934;255919;113;64127;9683;6530;124460;80205;94160;79191;10265;79068;388276;79801;388272;10294;869;23322;1540;84290;6477;643911;29117;81831;27324;23090;6299;5257;64282;84706;91807;81533;64400;4313;83752;55737,44,0.47328718711548800000
chr1,248039903,249212666,1172763,1,1,127077;391194;127069;127074;127066;127068;646627;391196;25893;343172;391190;403244;343173;127064;26246;79894;26696;55657;391191;401993;81466;127059;127062;80851;267002;343563;391195;401992;343171;26245;254879;403239;284521;391211;401994;391192,36,3.06967392388743000000
chr7,72646951,74193397,1546446,1,1,5982;51085;9275;84277;7462;55695;135886;653361;83451;1364;135892;6804;7461;155382;3984;26608;8468;9031;155368;2969;8326;7458;9569;2006;1365;114049,26,1.68127435422899000000
chr22,18818376,21661435,2843059,1,1,54487;27037;9342;29801;65078;10587;1312;6545;8214;7290;421;2812;6899;5625;7625;79680;64976;6576;3053;8218;5413;80764;23617;400891;1399;7122;150209;128977;8220;388849;84861;7353;51586;2928;128989;5297;9127;9993;54584;91179;85376;8216;85359;8318;728229;5902,46,1.61797556786546000000
chr20,60734,2643003,2582269,1,1,140680;10616;1457;57761;83541;55968;10326;55321;140850;10528;81623;140881;51378;9751;113278;343641;117532;7053;245938;343637;6628;140885;245939;85508;388780;85364;3420;5173;9491;128637;6939;400831;2280;642636;140901;400830;55423;140809;284759;6666;27111;79175;80023;128646,44,1.70392782471540000000
chr12,133237077,133773393,536316,1,1,192111;100289635;5426;5827;7574;101060200;10795;2802;7637;7556;23141;7699;55743,13,2.42394409266179000000
chr15,23620374,28526437,4906063,1,1,2562;7681;23742;8924;7337;6638;2567;4948;8926;57194;283685;54551;4692;2558,14,0.28536119491331400000
chr9,77597802,89491368,11893566,1,1,80010;138199;414328;80318;29979;23287;60560;3190;2650;26578;23230;64078;4915;54981;257019;81689;84131;7088;5125;389762;55312;29968;389761;55582;2776;51280;79670;9630;158471;7091;84267;389763;442425;389766;158158,35,0.29427675433927900000
chr18,78425,9146865,9068440,1,1,116;55556;10403;23255;645369;103910;642597;9097;7525;5797;494514;1068;9229;79822;84034;4729;7298;91133;23253;9663;7050;339291;9984;81035;23347;10627;201475;64863;8736;27098;284217;23136;7541,33,0.36389941379112600000
chr10,116829,6811983,6695154,1,1,105;1109;10531;22884;5214;10771;79754;5209;3601;79861;83592;5588;23560;91734;23185;3559;84991;8644;54906;22982;1316;114131;51806;54522;84893;1646;2665;3422;1645;810;10276,31,0.46302146298651200000
chr1,2808931,3284316,475385,1,1,63976;140625,2,0.42071163372845200000
chr7,72721410,74142342,1420932,1,1,5982;51085;9275;84277;7462;55695;135886;83451;1364;135892;6804;7461;155382;3984;26608;8468;9031;155368;2969;8326;7458;9569;2006;1365;114049,25,1.75940861350156000000
chr17,1656,1707842,1706186,1,1,10594;51031;50628;29928;286753;124935;727910;5345;29;400566;8578;359845;55178;4641;55275;83547;114826;124997;5176;100506388;1398;79850;8447;7531;5306;727857;9501;64359;51763,29,1.69969745385321000000
chr11,129161841,134868407,5706566,1,1,8538;170689;120224;29087;399979;334;112936;50863;89944;283171;27034;4978;56980;23310;112937;4798;6768;83700;11095;219938;29068;27087;22997,23,0.40304449295776100000
chr11,117965223,121947796,3982573,1,1,143941;6309;867;196264;6230;2900;10632;7070;7007;283150;23650;4297;5818;9354;2542;114902;79849;83552;338657;372;55823;51399;4162;23187;25988;915;1656;10205;11181;6330;56649;3014;283149;6653;6327;79671;9099;219902;64137;643;79102;10525;219899;917;25833;23365;9854;916;3145;120425;84866;1798;56912;283152;7379;220323,56,1.40612614006071000000
chr22,16888899,20311662,3422763,1,1,54487;27037;27440;29801;65078;10587;1312;51816;8214;7290;421;2812;6899;150160;5625;27439;27443;55670;637;64976;79680;529;11274;6576;150165;83733;8218;5413;23617;7122;8220;128977;388849;7353;2928;51807;128989;23765;9993;54584;85359;8318;23786;128954;101929372;57553;5902,47,1.37315963740405000000
chr11,116681007,134938470,18257463,1,1,143941;196264;6230;53340;63970;9743;10632;26595;7070;7007;23650;283171;5818;9354;403312;114902;83552;338657;219875;55572;6768;56;55823;4162;23187;390261;26493;83480;3014;79684;84000;257160;219858;63876;100169851;283160;390259;390271;64221;23365;9854;916;390265;220296;1111;219844;50937;28960;9159;79864;6309;120224;22897;80071;334;486;23584;84897;219865;23387;372;57453;6876;399968;51399;26492;915;6484;8538;170689;11181;9538;29118;399979;84959;6327;335;4978;64137;338662;23310;112937;219855;120425;84866;283152;338661;220323;219874;2900;84623;283150;219873;89944;2542;56253;79849;3587;219870;56980;83700;399967;79607;3758;100533181;22997;9638;6330;56649;114609;345;641654;112936;6653;84881;50863;27034;55800;90952;219833;10525;283162;219899;917;4900;337;219938;5049;7379;867;390275;219854;7753;29087;2313;57476;219869;4297;4013;390260;414899;79827;54414;283159;116337;4798;27087;25988;1656;10205;23621;54538;283149;3312;390264;6734;79671;9099;219902;51092;3762;2113;643;79102;3703;25833;11095;3145;1798;56912;160065;29068;53826,173,0.94755771927348300000
chr22,18919942,21440514,2520572,1,1,54487;27037;9342;29801;65078;10587;1312;6545;421;7290;2812;6899;5625;7625;79680;64976;6576;3053;8218;5413;80764;23617;400891;1399;7122;150209;128977;8220;388849;84861;7353;51586;2928;128989;5297;9127;9993;54584;91179;85376;8216;85359;8318;728229;5902,45,1.78530904889842000000
chr22,18641409,21440514,2799105,1,1,54487;27037;9342;29801;65078;10587;1312;6545;8214;7290;421;2812;6899;5625;7625;79680;64976;11274;6576;3053;8218;5413;80764;23617;400891;1399;7122;150209;128977;8220;388849;84861;7353;51586;2928;128989;5297;9127;9993;54584;91179;85376;8216;85359;8318;728229;5902,47,1.67910814349587000000
chr22,18953012,21440514,2487502,1,1,54487;27037;9342;29801;65078;10587;1312;6545;421;7290;2812;6899;7625;79680;64976;6576;3053;8218;5413;80764;23617;400891;1399;7122;150209;128977;8220;388849;84861;7353;51586;2928;128989;5297;9127;9993;54584;91179;85376;8216;85359;8318;728229;5902,44,1.76884279892036000000
chr22,18919942,21440514,2520572,1,1,54487;27037;9342;29801;65078;10587;1312;6545;421;7290;2812;6899;5625;7625;79680;64976;6576;3053;8218;5413;80764;23617;400891;1399;7122;150209;128977;8220;388849;84861;7353;51586;2928;128989;5297;9127;9993;54584;91179;85376;8216;85359;8318;728229;5902,45,1.78530904889842000000
chr5,34611534,44873491,10261957,1,1,3977;92255;64417;735;2668;10605;167359;5734;1601;100861519;6167;345557;2255;64902;133686;7690;56477;133688;729;10884;167127;9180;6502;9631;133690;202151;6414;26272;285636;65250;253260;5562;5019;55299;133584;389289;26064;730;6507;2533;23530;2690;23548;153657;133558;100129792;5618;3157;79925;25836;55100;375444;3575;134218;84674;5810,56,0.54570487870880800000
chr3,195740357,197310451,1570094,1,1,622;255798;80235;200933;5062;5130;4241;26043;1739;84984;348793;255758;116211;131540;200931;375387;22916;7037;165918;54965;205564,21,1.33749953824421000000
chr10,47074802,51805020,4730218,1,1,5599;644168;267004;8031;195977;100652748;642517;57705;474354;170371;118738;653145;5949;644054;414189;100133093;728113;5540;143162;6572;2662;26095;118461;282966;58504;100287932;8505;2658;1103;2074;170370;4477;196740;55753,34,0.71878293981376800000
chr17,14111772,15442066,1330294,1,1,1352;64518;9953;201158;284040;100533496;5376;146822,8,0.60137082479512000000
chrX,53186624,53727754,541130,1,1,23096;158787;8243;10075;8242;3028,6,1.10879086356328000000
chr22,18919942,21440514,2520572,1,1,54487;27037;9342;29801;65078;10587;1312;6545;421;7290;2812;6899;5625;7625;79680;64976;6576;3053;8218;5413;80764;23617;400891;1399;7122;150209;128977;8220;388849;84861;7353;51586;2928;128989;5297;9127;9993;54584;91179;85376;8216;85359;8318;728229;5902,45,1.78530904889842000000
chrX,153576890,153822717,245827,1,1,55558;2539;1774;246100;8270;9130;537;60343;2010;8517;2664;6134;2316;8273;6901;8266,16,6.50864225654627000000
chr17,34817422,36168104,1350682,1,1,26574;284099;9326;284098;11072;6928;79154;79922;3975;11276;79893;11056;6871;31;80179,15,1.11055007766447000000
chr15,22784523,28525460,5740937,1,1,2562;7681;123606;4948;57194;81614;2558;8924;114791;23742;7337;6638;2567;8926;283685;54551;4692;23191,18,0.31353766815417100000
chr17,16822683,20193169,3370486,1,1,2314;55244;125170;55090;11216;79018;79999;10400;54890;254272;9706;400581;92521;8533;22905;729288;5598;218;23164;83450;224;51168;80039;51655;201163;7156;51030;5636;644815;10750;4239;10517;654346;10743;388436;27077;140775;6470;146691;1819;6720;125206;23495;147166;7732;146802;91647;56953;645027;3996;201164,51,1.51313490102021000000
chr5,175570677,177227216,1656539,1,1,51428;51491;6620;6569;9260;10636;53917;27166;285596;1212;23197;375484;57179;54825;90249;10960;26262;51720;3101;23567;80758;11285;54540;2264;345456;54732;79930;22838;192286;285598;2870;1627;83463;64324;114787;2161;253314,37,2.23357252681645000000
chr9,204090,12984040,12779950,1,1,58524;10171;23081;55664;89882;50808;158358;81704;23189;5789;6019;286343;1761;169792;55064;6505;29126;2315;5991;26953;90865;7436;3717;90871;6013;57589;157983;3641;7306;403313;169522;115426;6595;79956;9933;2731;55848;11172;10655;80380,40,0.31299026991498400000
chr7,72726578,74139390,1412812,1,1,5982;51085;9275;84277;7462;135886;83451;1364;135892;6804;7461;155382;3984;26608;8468;9031;155368;2969;8326;7458;9569;2006;1365;114049,24,1.69873981817821000000
chrX,61091,21276522,21215431,1,1,414;660;2925;51481;171482;55787;795;10389;5160;9367;4935;100288814;11238;1964;415;207063;293;412;30011;5475;6322;57393;6907;28227;286530;3730;92552;8225;10943;5634;2824;2187;5256;3563;26609;54960;170082;416;25975;51311;8905;9189;395;6473;171484;8227;256714;59272;389840;10742;171483;8908;2742;8544;3052;4810;425054;4281;1438;6247;5613;645864;5931;347527;10149;438;64109;51480;1183;140456;5277;9758;140462;55344;8623;9185;357;8233;265;94056;57502;8228;8226;158747;6792;56474;6197;7114;139105;256643;25878;6399;7499;4267;51284;2277;55841;8481,98,0.46192792406621400000
chr2,111368832,113089106,1720274,1,1,10461;699;129804;55289;64682;84524;376940;10018;84910,9,0.52317247136212000000
chr2,111392223,113102565,1710342,1,1,10461;699;129804;55289;64682;84524;376940;10018;84910,9,0.52621054736421100000
chr16,29674848,30119759,444911,1,1,653808;5531;26470;283897;253980;146378;8479;83719;23475;283899;124446;9344;3835;4150;226;253982;83723;6911;8448;79447;112476;9961;10423;6693;79153,25,5.61910134835956000000
chr3,37479593,62337241,24857648,1,1,10180;9034;51385;200845;56992;132158;7318;25886;7047;7134;440955;55349;6405;4634;51372;5333;285267;389119;259236;79442;7869;54870;5364;285268;64866;9943;7866;11170;54716;51364;11068;54977;131177;1582;79714;389125;7384;51161;54106;51409;22908;25981;285349;91392;4615;9940;4485;729085;152206;4336;339834;23272;51099;30;118442;55540;9045;378;10869;3913;55830;1776;10991;1605;54756;6336;55193;7086;57408;22906;11277;55799;9390;1238;100506243;29890;956;11334;4057;387;9136;25907;23276;93;63891;285331;51188;3680;55888;8927;6599;23166;51447;132228;6159;646450;10039;8314;11070;10425;10675;11102;1499;29122;11280;100287362;6787;7474;377047;201627;339906;327;25994;201626;131375;375346;25915;22937;90226;10803;1524;57406;3700;440957;25924;2771;3615;23218;8372;885;285346;3921;4486;24142;1234;25930;51368;55129;115560;2272;100526772;29072;64925;440956;353274;5576;51246;401067;50650;10641;79443;3373;50853;55152;259173;5580;9730;132141;83597;10663;253639;95;8692;9941;22907;200844;7375;165904;10217;389123;54861;5210;200942;820;84892;6988;7433;151903;4820;56920;9942;8309;64147;64943;9389;26059;79012;7873;80335;54585;51517;1294;84315;8994;1951;57060;5162;4134;92999;6997;54859;353324;2912;8820;7123;65010;84836;201625;776;131616;729230;1849;275;57415;1232;57456;10293;9807;1237;7584;389124;51533;26060;199223;7867;11344;23395;29925;3697;3699;131377;7871;51460;132160;10181;211;55802;84276;1795;23132;2779;5859;10289;54899;375337;64651;2829;25864;51304;84126;26354;100526760;375341;11180;2317;54681;28972;5745;64689;646424;2876;788;100132146;54986;9117;11186;11188;93973;6331;91869;285231;142686;10168;23016;9254;646498;1154;58515;57599;386724;10201;389118;57467;1230;993;285343;5793;389114,288,1.15859714483044000000
chr16,86774639,90163403,3388764,1,1,54758;863;81631;23174;11105;115992;4597;146429;763;124245;197320;100287036;1535;51693;79007;100129697;8558;124044;348180;9780;81620;9605;5119;4157;54849;79791;100506581;27132;353;197322;2588;2622;8140;6137;6687;54971;2175;27189;1013;333929;124045;161882;57338;84501;22980;92822;92806;84627;390748;10381;1800;29123,52,1.53448277897192000000
chr21,40591552,48090317,7498765,1,1,386672;5211;4599;5316;54084;106865373;56894;6285;3689;8209;1409;54101;1826;386679;7485;386676;386680;386681;326;53347;5121;5152;1476;150082;3275;54059;10317;1292;5116;84221;29947;64699;11077;6612;63977;3150;755;8566;1291;7307;7113;875;54014;7032;150094;85395;386685;353323;7031;7109;386674;386675;386683;8568;4731;6450;23076;6573;104;353332;5822;4047;4600;54039;54058;7033;386677;89765;353333;23181;25825;23275;90625;49854;23308;754;89766;386678;8888;25966;54020;80781;386684;7327;9619;10785;386682;54097;10841;81543;7226;150084,92,1.22686869104446000000
chr22,16054713,17879827,1825114,1,1,23765;27440;150160;27439;27443;23784;51816;150165;81061;128954,10,0.54791097980728900000
chr10,102890253,103419682,529429,1,1,27343;3195;8945;6468;10660;25911,6,1.13329643823818000000
chr1,146564743,149224043,2659300,1,1,9557;728945;284565;644591;51205;645142;51463;5565;607;2702;730262;2330;200030;2703,14,0.52645433008686500000
chr15,20102541,28525460,8422919,1,1,2562;7681;727832;100996331;123606;4948;57194;283694;81614;100287399;390538;2558;8924;114791;23742;7337;6638;2567;8926;283685;54551;4692;23191;283767,24,0.28493684908996500000
chr2,111449141,113094793,1645652,1,1,10461;129804;55289;64682;84524;376940;10018;84910,8,0.48612950976269600000
chr16,29673954,30097178,423224,1,1,653808;5531;26470;283897;253980;146378;8479;124446;23475;283899;9344;3835;4150;226;253982;83723;6911;8448;79447;112476;9961;10423;6693,23,5.43447441543958000000
chr15,23699701,28525460,4825759,1,1,2562;7681;23742;8924;7337;6638;2567;4948;8926;57194;54551;4692;2558,13,0.26938767559673000000
chr16,71251249,90111263,18860014,1,1,56942;2300;763;197320;64779;7571;1535;51693;79007;124044;9914;8720;79786;79152;5336;197257;114780;7567;4157;79583;404550;283927;79791;3294;353;10164;1012;11345;2622;8140;6137;93107;27189;57338;23417;342372;84937;92806;3735;6898;146429;9764;124245;388289;3281;170692;23406;79726;9564;3394;54386;22879;10328;164;27132;197259;10428;51659;440387;57687;124491;1013;54768;146167;124045;161882;22980;2653;2294;81631;93517;23035;55159;54957;123775;4597;115992;51741;10143;161931;794;1504;91862;23563;339145;9605;2303;497190;124359;100506581;23536;83693;54550;85445;4094;123872;9013;83716;83449;333929;1327;92822;390748;9798;54758;863;23174;29948;4166;23199;1723;463;100287036;3250;80790;100129697;342371;83657;8139;5713;55839;348180;9780;53630;81620;5119;54849;55625;3240;29123;55565;57707;440348;197322;2588;23300;100130958;9785;6687;54971;2175;9100;162239;10200;84501;2734;84627;58189;10381;1800;8558;55783,152,0.80593789591036300000
chrX,153190661,153609163,418502,1,1,728458;2010;8269;5956;8260;3654;2316;5973;393;4204;3054;8277;2652,13,3.10631729358522000000
chr12,51347169,54349524,3002355,1,1,51350;9802;1990;3851;6895;8620;613227;7786;3889;3892;283337;160622;60314;3854;3695;140807;60673;4891;3856;91;3852;5094;3229;57228;3875;319101;374454;9700;401720;5204;84926;341405;84975;5463;144501;517;11016;286887;1975;57658;121340;3890;3887;3891;3848;3164;283403;338785;3855;3849;8435;3853;51411;196374;23371;269;6334;54458;7024;6667;3888;51380;3850;94;81566;9119;25875;121391;3228;3489;8086;9498;5916;11226;112802,75,2.49803903935411000000
chr4,93090516,100232508,7141992,1,1,27306;658;56916;1977;5161;474;10611;285555;124;5910;128;2895;23173;8633;130;10098;125;127,18,0.25203052593730200000
chr11,79682422,89547851,9865429,1,1,84233;60494;1740;58487;65084;220042;51501;27314;50507;5547;219595;2915;8726;57093;390231;54843;51585;220382;220388;11098;8301;338699;10873;23682;220047;55863;1075;60492;7299;8322,30,0.30409219913295200000
chr8,129505388,144628020,15122632,1,1,1584;56169;389692;10086;5747;137835;11156;22898;111188157;1585;57152;27161;8581;729330;51059;8000;116447;51105;23237;4061;2765;54108;57623;114822;50807;338328;8629;23639;57210;79943;203062;6482;51337;105375787;23144;8840;51571;137797;66004;286128;54742;114;2843;7038;83696;575;6503;389690;10397;432355;169044;2738;23167;3786;51305;4062;10656,57,0.37691851524258500000
chr10,91860336,100377991,8517655,1,1,26509;9849;27291;60495;27063;9124;84171;118788;60370;83742;340665;1559;3087;84287;22849;26287;414157;142827;953;56889;51196;338557;10023;51013;387707;55165;3257;6585;5223;64318;9211;1791;118812;3070;3363;80351;401647;5832;7093;54708;5950;29760;1562;23232;23401;64210;1558;3832;9044;112817;1592;84795;5146;84333;80019;26123;84458;23223;55118;143282;159371;143279;54619;55361;1557;6425;10556;93377;84986;118813;118924;54536;3416;5507;10580,75,0.88052404094789000000
chr1,146564743,149224043,2659300,1,1,9557;728945;284565;644591;51205;645142;51463;5565;607;2702;730262;2330;200030;2703,14,0.52645433008686500000
chr14,96944980,107278770,10333790,1,1,23241;23186;283643;91828;9578;400258;207;388015;9112;317762;283600;81693;4140;1396;3831;51550;84334;2972;256281;1397;84193;7517;79446;91833;90135;79038;9556;115708;7453;7443;26153;122481;7127;55778;51466;1735;64919;647286;10858;5527;9529;5891;55038;8788;107984640;122402;3714;10572;283598;283638;1983;100128927;7187;9895;1152;7528;122618;80757;1778;374569;388021;113146;647310;3320;2009;123099;122616;84439;64423;57596;23368;123096;122622;10914;29933;8812;122416,77,0.74512836045632800000
chr17,15816892,20524013,4707121,1,1,9487;2314;9720;125170;54902;11216;79018;254272;7314;8533;5598;218;224;80039;51655;256223;201163;7156;51030;10750;10743;100129396;140775;51393;57547;1819;147166;7732;91647;201161;3996;4239;201164;55244;9611;55090;645027;79999;284194;10400;54890;9706;92521;22905;729288;100996259;23164;83450;51168;5636;644815;125150;10517;654346;388436;27077;388341;6470;6720;146691;136;23495;57336;125206;146802;56953;400581,67,1.42337534981574000000
chr14,95552502,107278770,11726268,1,1,23241;23186;283643;91828;9578;207;51527;400258;388015;9112;283600;317762;81693;4140;1396;3831;51550;84334;2972;256281;161176;1397;7517;84193;90135;79446;624;79038;91833;9556;115708;7453;7443;26153;122481;79789;55102;7127;623;51466;55778;1735;64919;9623;647286;10858;51218;5527;56967;9529;55038;5891;8788;107984640;122402;3714;10572;283598;283638;1983;100128927;8115;7187;9895;1152;7528;122618;80757;1778;374569;113146;388021;647310;3320;2009;123099;122616;64423;84439;57596;23368;23405;123096;122622;10914;29933;8812;122416,88,0.75045189142871400000
chr7,96189276,104037786,7848510,1,1,24146;6863;221914;4885;221908;51593;375607;100861540;25798;9551;2783;100310812;100526740;375612;7036;10234;5054;101927655;10603;5001;100134938;27000;222865;55971;440;10467;1576;58160;55063;93408;23660;1749;57001;81392;8985;26261;79706;79037;5701;7551;352954;140453;2056;402682;11333;2050;51024;7455;389541;7205;1523;222236;22853;8295;402573;29992;168620;25851;4034;51412;375611;5118;64816;8896;1551;246721;255374;55262;81844;3268;7979;80228;89122;4951;10095;4584;64598;81628;136227;6878;7586;563;7589;9512;1750;285989;222235;5649;7425;10552;1577;100271927;54784;222234;222950;100316904;729597;64599;346606;57154;245812;221785;548644;79027;402569;4176;83787;56257;10156;79690;349149;441272;10071;1174;222229;43;10898;5439;64792;441273;9179;100289561;84124;10734;29990;56996;221786;26024;100289187;10980;10248,131,1.66910662023747000000
chr3,194851175,197803820,2952645,1,1,622;80235;200933;5062;5130;6165;255758;116211;152002;131540;200931;375387;22916;23527;7037;165918;54965;84859;84248;255798;10188;89782;26043;4241;347;1739;84984;348793;5504;9711;84223;200958;4585;205564,34,1.15150991737916000000
chr16,70783301,90111263,19327962,1,1,56942;2300;763;197320;64779;7571;1535;51693;79007;124044;9914;8720;5336;79152;79786;197257;114780;7567;4157;79583;404550;283927;79791;3294;353;10164;1012;11345;2622;8140;6137;93107;27189;57338;23417;342372;84937;92806;3735;6898;146429;9764;124245;388289;3281;170692;23406;79726;9564;3394;54386;22879;10328;164;27132;197259;10428;51659;440387;57687;124491;1013;54768;146167;161882;124045;22980;2653;2294;81631;93517;23035;55159;54957;123775;4597;115992;51741;10143;161931;794;1504;91862;23563;339145;9605;2303;497190;124359;100506581;23536;83693;54550;85445;4094;123872;9013;83716;83449;333929;1327;92822;390748;9798;54758;863;23174;29948;4166;23199;1723;463;100287036;3250;80790;100129697;342371;83657;8139;5713;55839;348180;9780;53630;81620;5119;54849;55625;3240;29123;55697;55565;57707;440348;197322;2588;23300;100130958;9785;6687;54971;2175;9100;162239;10200;84501;2734;84627;58189;10381;1800;8558;55783,153,0.79159923845049000000
chr20,52782340,62904501,10122161,1,1,198437;3785;23626;1591;2832;10388;5105;1522;140731;85441;116154;140685;79025;56937;6874;8675;6725;84619;63910;140687;388799;128611;100462983;55738;1477;60437;51507;5203;51750;116151;284739;7022;57091;54915;11255;63939;80331;24148;57473;9217;10732;284756;1917;128408;26164;51497;54345;6919;10139;9885;1137;51012;140700;10287;11047;1299;11054;514;1002;100132911;6790;55544;164284;28231;4987;4159;149986;128602;26039;11083;4923;200232;8771;55251;54994;2778;128414;57642;50861;140701;3911;5753;1908;55257;5688;6227;79716;8480;140689;7165;5509;128826;81027;140893;655;26205;57403;55816;79444;140628;54963;56731;140690;4661;81030;79144;54923;81928,108,1.06696583861885000000
chr13,29121192,42068190,12946998,1,1,51569;100526761;3146;79612;10208;84935;89890;8900;2308;387921;241;10443;161003;646799;84056;23047;10129;1997;6541;122042;26960;400120;55578;4093;29880;145173;10186;10166;4081;5412;84078;675;10240;90634;11340;57511;23111;9201;10631;11193;728591;80209;5983;23281;122011;10808;7223;90627;28984;341640;9617;122046;5994;283537;51371;9365;54937,57,0.44025649807005500000
chr16,29673954,30198600,524646,1,1,653808;5531;26470;283897;253980;146378;8479;83719;23475;283899;124446;9344;3835;4150;226;253982;83723;5595;6911;11151;8448;79447;112476;9961;10423;6693;79153,27,5.14632723779463000000
chr22,18970561,21464764,2494203,1,1,54487;27037;9342;29801;65078;10587;1312;6545;421;7290;2812;6899;7625;79680;64976;6576;3053;8218;5413;80764;23617;400891;1399;7122;150209;128977;8220;388849;84861;7353;51586;2928;128989;5297;9127;9993;54584;91179;85376;8216;85359;8318;728229;5902,44,1.76409057322119000000
chr9,68418044,88847277,20429233,1,1,80010;9413;138199;51104;414328;375743;116224;138240;3190;2650;26578;286380;4915;55071;687;8395;5239;9414;644019;6096;349334;5568;5125;138241;2395;389762;220869;55312;29968;389761;169693;80036;140803;445571;320;728747;84267;7763;301;442425;7088;216;117531;80318;23137;138255;29979;23287;60560;23230;64078;9615;54981;257019;84131;23670;653404;55582;2776;653427;51280;9630;158471;256691;7091;389763;389766;158158,68,0.33285635344214800000
chr17,16581177,20464343,3883166,1,1,2314;9720;55244;125170;55090;11216;79018;79999;284194;10400;54890;254272;9706;400581;92521;8533;22905;729288;100996259;5598;218;23164;83450;224;51168;80039;51655;201163;7156;51030;5636;644815;10750;4239;10517;654346;10743;388436;27077;100129396;140775;6470;146691;1819;6720;125206;23495;147166;7732;146802;91647;56953;645027;3996;201164,55,1.41637004444312000000
chrX,50674765,54571993,3897228,1,1,23096;64061;9500;170685;280658;727837;3028;170627;727866;9502;54552;8243;10075;55190;653220;8242;340602;23133;54328;81557;54954;65267;2245;653067;90121;23708;158787;728239;6757;170626;494197;29057,32,0.82109643059117900000
chr3,195740387,197404251,1663864,1,1,622;255798;80235;200933;5062;5130;4241;26043;1739;84984;348793;255758;116211;131540;200931;375387;22916;9711;7037;165918;54965;205564,22,1.32222345095513000000
chr7,72723426,74141673,1418247,1,1,5982;51085;9275;84277;7462;135886;83451;1364;135892;6804;7461;155382;3984;26608;8468;9031;155368;2969;8326;7458;9569;2006;1365;114049,24,1.69222991481738000000
chr15,20102541,28525460,8422919,1,1,2562;7681;727832;100996331;123606;4948;57194;283694;81614;100287399;390538;2558;8924;114791;23742;7337;6638;2567;8926;283685;54551;4692;23191;283767,24,0.28493684908996500000
chr11,116723438,134868407,18144969,1,1,143941;196264;6230;53340;63970;9743;10632;26595;7070;7007;23650;283171;5818;9354;403312;114902;83552;338657;219875;55572;6768;56;55823;4162;23187;390261;26493;83480;3014;79684;84000;257160;219858;63876;100169851;283160;390259;390271;64221;23365;9854;916;390265;220296;1111;219844;50937;28960;9159;79864;6309;120224;22897;334;486;23584;84897;219865;23387;372;57453;6876;399968;51399;26492;915;6484;8538;170689;11181;9538;29118;399979;84959;6327;4978;64137;338662;23310;112937;56912;219855;120425;84866;283152;338661;220323;219874;2900;84623;283150;219873;89944;2542;56253;79849;3587;219870;56980;83700;399967;79607;3758;100533181;22997;9638;6330;56649;114609;641654;112936;6653;84881;50863;27034;55800;90952;219833;10525;283162;219899;917;4900;219938;5049;7379;867;390275;219854;7753;29087;2313;57476;219869;4297;4013;390260;414899;79827;54414;283159;116337;4798;27087;25988;1656;10205;23621;54538;283149;3312;390264;6734;79671;9099;219902;51092;3762;2113;643;79102;3703;25833;11095;3145;1798;80071;160065;29068;53826,170,0.93689881751795800000
chr22,17096855,20311763,3214908,1,1,54487;27037;27440;29801;65078;10587;1312;51816;8214;7290;421;2812;6899;5625;27439;27443;55670;637;64976;79680;529;11274;6576;150165;83733;8218;5413;23617;7122;8220;128977;388849;7353;2928;51807;128989;23765;9993;54584;85359;8318;23786;128954;101929372;57553;5902,46,1.43083410162904000000
chrX,52961214,53822101,860887,1,1,23096;158787;8243;64061;10075;8242;3028;54328;29057,9,1.04543337278876000000
chr13,90723669,105167985,14444316,1,1,160897;2259;11166;55757;337867;2841;22873;84899;259232;10160;1880;79070;643677;8428;7174;23348;7546;5911;9358;9375;9071;54841;196541;10150;171425;87769;27199;266722;3843;6564;10082;140432;23483;93081;5611;2073;5095;10257;1638;85416;2262;100533467;6555,43,0.29769495488744500000
chr17,1235754,1492475,256721,1,1,1398;7531;4641;5306;124935;51763,6,2.33716758660180000000
chr18,14316,14928854,14914538,1,1,116;23255;57132;8774;645369;125228;57045;103910;642597;84617;9097;7525;10650;3613;56984;65258;79822;84034;4729;23253;9663;9989;339291;9984;10928;162655;63895;201475;64863;342850;27098;646000;753;7541;55125;55556;10403;4158;84203;388468;147495;9218;5797;494514;1149;5771;10939;1068;79959;9229;7298;91133;11031;56907;7050;81929;4161;81035;2774;23347;10627;8731;8736;374860;284217;23136,66,0.44252125007157500000
chrX,31341715,31986456,644741,1,1,1756,1,0.15510104057288100000
chr22,17096855,18641468,1544613,1,1,27440;51816;51807;23765;27439;27443;55670;637;529;11274;150165;23786;83733;128954;101929372;57553,16,1.03585817288861000000
chr15,20102541,30366124,10263583,1,1,321;7681;2562;727832;100996331;123606;4948;57194;283694;81614;100287399;390538;2558;23359;7082;8924;114791;23742;7337;6638;2567;8926;283685;653720;54551;4692;23191;283767;56160,29,0.28255239909883300000
chr15,30652489,32462701,1810212,1,1,728498;101059918;51621;89832;22909;161725;283710;54893;89839;4308;1139,11,0.60766363276787500000
chrX,102754735,103559770,805035,1,1,158983;80712;644353;5354;9643;85012;286527;203562;142684;286436;139231;401612;79921;9338;51209;441509,16,1.98749122708951000000
chr22,18919942,21798755,2878813,1,1,54487;27037;9342;29801;65078;10587;1312;6545;421;7290;2812;6899;5625;7625;79680;23119;64976;6576;3053;8218;5413;80764;23617;400891;1399;7122;150209;128977;8220;388849;84861;7353;51586;2928;128989;5297;9127;9993;54584;91179;85376;8216;440804;85359;8318;728229;5902,47,1.63261733221296000000
chr8,136092588,136809209,716621,1,1,10656,1,0.13954377558011800000
chr20,121521,9691972,9570451,1,1,140680;57593;10616;1457;54498;57761;10326;140850;5786;80332;9762;64773;84515;551;5621;9751;23236;5020;113278;343641;117532;56265;146;1059;8760;343637;51605;6628;11237;9770;5332;388780;85508;3704;64601;64096;9491;128637;83959;54976;650;400830;57144;140809;80023;56261;116835;128646;64949;80025;9962;149840;55317;83541;55968;24141;128653;55321;55612;56255;54363;10528;81623;23627;140881;51378;8455;54675;22888;29058;7053;164312;140885;128674;2797;60493;245939;6614;85364;3420;25876;1114;5173;65992;400831;6939;2280;25943;5111;642636;57506;140901;55423;100288797;284759;6666;27111;79175;994,99,1.03443400943174000000
chr17,34817422,38545572,3728150,1,1,1440;6928;339287;3975;57125;79893;7153;54883;388381;2064;6871;30837;2886;84311;494188;9572;51755;284098;22806;79154;80179;84152;5691;9326;390790;3927;5914;6143;5409;284106;729873;147179;100505591;5709;22794;84961;51195;4302;79922;11276;5469;782;101060376;84299;342667;284099;4761;26574;8396;9349;55876;57636;94103;80725;990;7067;31;440435;100170841;11072;8557;7703;11056;10948;125111;93210;284110;124626;9862,69,1.85078390086236000000
chrX,15801518,28285948,12484430,1,1,2925;7543;55787;4810;404281;139422;795;10389;5160;168400;5422;6247;11238;645864;5931;1964;10149;158506;158809;30011;22866;5475;6322;257240;9185;389840;8233;80311;286514;94056;139411;9468;1968;6792;23597;254158;56474;6197;5165;139105;5256;256643;23676;6611;347442;10549;6303;347541;8905;139425;170302;79135;256714;51360;5251;10742;170067;100130302,58,0.46457867920281500000
chr22,17096855,28887195,11790340,1,1,1413;24144;129049;100423062;613;391322;400916;91227;402055;55670;64976;6576;2687;83733;164592;8218;6634;23753;57168;5594;23617;3543;7621;2952;7122;5297;440822;2928;140883;54584;2678;8318;1652;728229;23523;4320;27440;10587;7290;2812;150248;23759;150223;9647;5625;4282;653689;11274;23331;3053;255349;2781;1399;84861;7353;51807;266747;51733;9993;85376;440804;85359;5902;91319;7332;85379;23544;284898;9342;65078;1417;1312;51816;6545;8214;421;129025;8459;157;7625;27439;23119;529;29802;1415;105372977;5413;80764;7441;66035;150209;8940;128977;128989;150221;91179;83606;23384;56241;1414;388886;101929372;89781;57553;54487;27037;4330;29801;23532;645426;29799;91355;6899;27156;27443;79680;637;23760;150165;100037417;9609;400891;84700;8220;388849;51586;9127;23765;8216;135;51233;6598;23786;128954,134,1.13652362866550000000
chrX,19855485,20221344,365859,1,1,30011;256714;6197;1964;256643,5,1.36664671362465000000
chr10,103098408,103419682,321274,1,1,8945;6468;27343;25911,4,1.24504317187198000000
chr10,103098408,103419682,321274,1,1,8945;6468;27343;25911,4,1.24504317187198000000
chr10,102880104,103478807,598703,1,1,27343;3195;8945;6468;10660;25911,6,1.00216634959237000000
chr10,102987428,103366970,379542,1,1,10660;27343;8945;25911,4,1.05390180796855000000
chr10,103098408,103419682,321274,1,1,8945;6468;27343;25911,4,1.24504317187198000000
chr10,102975257,103458708,483451,1,1,27343;8945;6468;10660;25911,5,1.03423097687253000000
chr10,102975257,103458708,483451,1,1,27343;8945;6468;10660;25911,5,1.03423097687253000000
chr10,102987428,103419682,432254,1,1,8945;27343;6468;10660;25911,5,1.15672729459993000000
chr10,102987428,103366970,379542,1,1,10660;27343;8945;25911,4,1.05390180796855000000
chr10,102987428,103419682,432254,1,1,8945;27343;6468;10660;25911,5,1.15672729459993000000
chr10,103098408,103419682,321274,1,1,8945;6468;27343;25911,4,1.24504317187198000000
chr16,46441545,62089933,15648388,1,1,643802;64785;2806;1258;4490;6361;85407;23594;79190;4489;4495;84560;23019;55238;255919;64127;92922;79191;57019;57017;94160;1459;583;388276;51090;79801;388272;89970;57567;1006;10294;23322;1540;5432;84290;6477;643911;23568;79650;27324;9289;729159;29105;2775;222487;388282;1071;5257;64282;91807;4313;83752;9688;55737;6559;221188;85320;55027;4504;123970;54947;4499;6367;5934;113;55239;6530;9683;79918;124460;80205;4493;55715;10265;221223;84229;11051;79068;9709;1066;6376;221191;869;4501;84166;10300;80011;4324;267;3801;29117;81831;374739;23090;4494;221184;6299;29070;4496;4502;84706;64400;81533;65009,104,0.66460519767275700000
chr16,75123493,90155062,15031569,1,1,2653;2294;81631;93517;56942;11105;123775;4597;115992;2300;51741;763;10143;161931;197320;64779;1504;1535;51693;79007;124044;23563;339145;9914;8720;5336;79786;197257;114780;4157;9605;2303;79583;404550;283927;79791;124359;3294;100506581;353;1012;23536;83693;11345;2622;54550;85445;8140;4094;6137;123872;93107;9013;27189;83716;333929;1327;57338;23417;92822;84937;92806;390748;3735;54758;863;23174;29948;146429;4166;9764;124245;23199;3281;170692;100287036;23406;80790;100129697;9564;3394;83657;8139;54386;22879;55839;348180;9780;10328;81620;53630;5119;54849;55625;27132;29123;10428;57707;51659;197322;440387;57687;2588;124491;23300;100130958;6687;54971;2175;1013;9100;162239;146167;124045;161882;10200;22980;84501;84627;58189;10381;1800;8558,123,0.81827785243177200000
chr14,20472548,31139579,10667031,1,1,54930;25983;390433;122665;390442;84962;10038;90809;9985;85446;493901;116173;51310;122748;26534;5720;55644;10379;6038;84502;1053;51016;4624;599;57820;122742;55701;4625;23428;100528064;1241;4860;122664;56339;643382;22985;64184;161247;57523;161424;5693;11035;23351;55072;8906;10901;317749;63874;64806;2290;10876;122704;1511;6035;57447;51222;4857;122651;145553;3002;4901;2999;100529063;57680;390443;10278;10202;29082;161253;115817;390439;60686;11198;728635;9878;10548;23256;84659;26277;64403;57096;338879;390437;90668;341799;6036;4323;56948;84932;4738;55017;283;6039;7011;51292;9362;27141;56413;196883;5106;9056;1215;79178;29091;5721;440163;283629;6037;122706;7051;91875;6297;29986;390445;90673;1603;26686;122740;5018;80344;5875;123103;643866;10419;26687;26020;3183;26533;57594;390436;79711;328;8106;55632;5587;4776;55147;100507650;64745,139,1.30308049165696000000
chr2,106604839,107241592,636753,1,1,80146;84417;653489,3,0.47114030087019600000
chr2,89143658,102866253,13722595,1,1,7549;150590;25972;23505;56910;55683;9669;3899;284996;90342;1329;26505;731220;150483;400986;8808;493753;129531;30818;10190;129868;10865;4862;84874;3631;200407;7535;254773;431705;9448;55654;79031;51601;1261;164832;51239;7850;23397;57730;129530;10120;54910;129521;6160;26504;151313;151;55571;150696;200539;51455;80705;9486;23020;150771;51011;64969;653192;81562;11320;150763;51263;11138;9391;200403;93082;51252;1844;375248;3554;4118;343990,72,0.52468210276554800000
chr7,136025097,139491890,3466793,1,1,6718;154790;100130880;92092;50617;9162;64764;8805;79989;57670;136306;154791;51631;56829;100996928;6916;28996;155006;5764;254048;1129;346689,22,0.63459225860903700000
chr7,139492831,158909738,19416907,1,1,2041;90956;136242;259285;135941;7791;168537;494551;389602;11194;4708;57180;346528;168391;6742;26211;51422;349136;9747;55303;155051;63917;27147;3361;346517;168544;441294;10061;100128553;402317;55112;835;100463482;26157;55365;7434;285888;8427;50832;54892;393046;54480;1180;100507421;65999;474344;135927;64761;155054;346525;442361;56302;135946;2636;3638;9311;3757;51650;29803;64434;259287;10922;135935;135948;202865;2051;5726;7516;136371;392138;54429;155038;27153;57541;84626;140545;5304;1804;23601;26;22976;155061;392843;5644;6469;6916;3110;116988;401409;55503;155435;113763;55340;83590;28959;3792;64327;9715;136051;7988;9690;6604;285973;285971;673;10049;57488;373156;340307;136541;58508;5799;80853;643641;8972;8454;100507507;93432;9601;27010;1020;6009;23145;7984;100142659;55750;84255;26047;2020;100289678;653857;23608;285966;259286;5919;51667;135924;50831;130075;57189;2146;170575;6522;401427;4846;135932;338398;100527949;155066;445328,150,0.77252262680147800000
chr15,23689774,28520313,4830539,1,1,2562;7681;23742;8924;7337;6638;2567;4948;8926;57194;283685;54551;4692;2558,14,0.28982272992724000000
chr17,16429920,20193169,3763249,1,1,2314;9720;55244;125170;55090;11216;79018;79999;10400;54890;254272;9706;400581;92521;8533;22905;729288;5598;218;23164;83450;224;51168;80039;51655;201163;7156;51030;5636;644815;10750;4239;10517;654346;10743;388436;27077;100129396;140775;57547;146691;1819;6720;6470;125206;23495;57336;147166;7732;146802;91647;56953;645027;3996;201164,55,1.46150307885553000000
chr15,23310705,28903925,5593220,1,1,2562;7681;23742;8924;7337;6638;2567;4948;8926;57194;283685;54551;4692;2558,14,0.25030304547291200000
chr12,48369803,48369847,44,1,1,1280,1,2272.72727272727000000000
chrX,10457432,10463939,6507,1,1,4281,1,15.36806516059630000000
chrX,53262075,53909450,647375,1,1,23096;158787;10075;8243;3028,5,0.77234987449314500000
chr22,18889432,21464060,2574628,1,1,54487;27037;9342;29801;65078;10587;1312;6545;8214;7290;421;2812;6899;5625;7625;79680;64976;6576;3053;8218;5413;80764;23617;400891;1399;7122;150209;128977;8220;388849;84861;7353;51586;2928;128989;5297;9127;9993;54584;91179;85376;8216;85359;8318;728229;5902,46,1.78666587949793000000
chr2,163044791,170671852,7627061,1,1,115677;6335;129446;6323;25801;151258;10324;8647;6328;253782;100526832;9360;6326;2591;22837;4036;79675;57405;2888;80034;129880;79809;57818;90134;10170;27347;29081;493911;2191;55137;6741;6332;129881;64135;8708;151230,36,0.47200356729807200000
chr17,13693496,15500012,1806516,1,1,64518;1352;9953;201158;284040;100533496;5376;374286;146822,9,0.49819652856658900000
chr8,27865510,39227310,11361800,1,1,6867;203102;29942;27257;7993;389649;1978;157574;84513;7486;55756;389643;79618;619373;55290;9530;2260;80185;2961;78986;10671;51669;6770;155;9070;7976;55140;137994;59339;203100;2137;5516;8754;84549;83877;5368;25960;11212;80139;23259;55893;23303;2936;137970;100507341;1846;56154;54904;3084;157855;137362;11030;84750;11160;80223;79845;23484,57,0.50168107166118000000
chr8,39387857,43755375,4367518,1,1,10947;8973;3620;84376;6422;3551;2339;56892;2515;7994;51125;169355;137964;157848;79698;5423;1142;84296;340441;6575;55145;138050;8749;27121;286;81790;84197;7419;5327;114926,30,0.68688898362868800000
chr22,23822927,25119103,1296176,1,1,4320;3543;7621;2952;66035;388886;391322;400916;150248;440822;266747;51733;2678;653689;4282;83606;23384;135;51233;6598;1652;29802;56241;100037417;2687;23523;6634;91319,28,2.16020046660330000000
chr2,214741497,216512368,1770871,1,1,580;402117;26154;79582;471;2335,6,0.33881632258928000000
chr15,23699701,29213461,5513760,1,1,2562;7681;23742;8924;7337;6638;2567;4948;8926;57194;653720;54551;4692;2558,14,0.25391021734714600000
chr2,2688584,20247845,17559261,1,1,9270;9781;57498;7447;129642;285148;100526794;93034;23175;130813;348654;51692;1653;6241;55256;9741;4613;10130;1876;10971;81553;57665;246243;23620;8853;192668;51112;343930;348738;130502;8462;7260;78989;3241;51594;9475;55821;9687;729475;57539;6201;29841;4148;3754;79677;129607;728597;28951;4953;151354;130497;3398;9014;79954;10408;6868;3790;245973;130814;91543;6664,61,0.34739502989334200000
chr12,51013428,54442965,3429537,1,1,51350;9802;1990;3851;283471;6895;8620;3225;613227;25840;7786;60314;3892;283337;3889;160622;3854;3695;140807;3223;60673;4891;3221;3856;91;3852;5094;3224;3227;3229;57228;3875;319101;374454;9700;57609;401720;5204;84926;341405;84975;144501;5463;517;11016;286887;1975;57658;121340;3887;3890;466;3891;3848;3164;283403;338785;3855;3849;8435;3853;51411;196374;23371;269;3222;6334;54458;7024;6667;3888;51380;3850;94;81566;9119;25875;121391;3228;3489;8086;9498;5916;11226;112802;3226,86,2.50762712284486000000
chr6,170329996,170906796,576800,1,1,28514;5689;84498;5134;6908,5,0.86685159500693500000
chr7,72726578,74139390,1412812,1,1,5982;51085;9275;84277;7462;135886;83451;1364;135892;6804;7461;155382;3984;26608;8468;9031;155368;2969;8326;7458;9569;2006;1365;114049,24,1.69873981817821000000
chr17,16637932,20294009,3656077,1,1,2314;9720;55244;125170;55090;11216;79018;79999;645027;10400;54890;254272;9706;92521;8533;22905;729288;5598;218;23164;83450;224;51168;80039;51655;201163;7156;51030;5636;644815;10750;10517;654346;10743;388436;27077;100129396;140775;6470;146691;1819;6720;125206;23495;147166;7732;146802;91647;56953;201164;400581;3996;4239,53,1.44964124114454000000
chr2,36200,26235994,26199794,1,1,9270;114818;129642;54221;285148;100526794;64342;375190;348654;51692;9741;55256;6382;54454;4613;55252;7173;10971;60526;81553;57665;3797;129787;8853;100129278;51112;22979;26751;285016;130502;78989;51594;9475;151449;9687;391356;338;79677;129607;28951;130497;4953;151354;9014;3398;79954;10408;245973;51639;91543;52;1788;23175;6664;375189;9781;7447;57498;93034;130813;9540;109;1653;6241;642273;23369;80304;10130;1876;246243;23620;388931;192668;653140;7837;23040;388;343930;5443;348738;8462;7260;3241;729475;8648;1838;79172;57539;55821;165324;6201;29841;4148;3754;2281;728597;51277;3790;6868;130814;50618,101,0.38549921423046300000
chrX,24997427,33718817,8721390,1,1,4113;257397;286514;190;11141;139422;1756;5422;347442;4114;80231;347541;139425;4115;4112;53940;158809;170302;2710,19,0.21785518134150600000
chrX,102885179,103135980,250801,1,1,9643;9338;51209;441509;203562;5354,6,2.39233495879203000000
chr18,30110227,61288989,31178762,1,1,284266;100526842;1630;100506888;51320;100505549;5874;51046;83876;25941;4645;494470;3998;147372;8792;80323;728929;4152;652991;201501;5596;9480;5275;8932;84064;57565;5268;284257;498;89777;2235;100101467;8170;4677;29906;6139;23239;23556;5289;4089;1837;11201;101927322;4087;125336;162699;4092;284254;115106;125476;2589;10892;90701;2922;9811;374864;26040;4200;83473;25800;497661;115701;55197;10982;6860;7572;51224;147323;23327;28316;80206;54877;57614;55205;252884;84307;83608;55034;80816;10449;6925;51124;4160;55520;57724;54808;30062;23335;8715;56853;6014;596;339302;220134;30827;5205;6563;162681;9063;9050;147339;220136;220441;57536;9525;2531;55250;9388;5366;9352,110,0.35280425823193400000
chr1,58043100,78131158,20088058,1,1,100526835;431707;148581;57708;57554;6121;3725;4919;5876;1573;10207;127254;84455;3716;9829;400757;3595;57685;51361;4070;127795;1600;29929;114803;1429;55635;127253;5236;55631;9077;4438;79819;205;163782;256435;9295;81849;81573;5733;4774;1647;127247;23169;54741;9406;26009;85440;10022;26135;200132;79971;115209;27329;149233;5142;54596;51086;83941;55970;27022;204962;11147;10026;7398;26289;34;84938;55277;3953;257194;84251;127255;55225;1491;8790;23421,76,0.37833423220900700000
chr3,21279279,22285613,1006334,1,1,79750,1,0.09937058670381800000
chr17,44144904,46103834,1958930,1,1,114881;90507;30009;100506084;284058;79170;90506;7484;388394;80279;55163;9520;51326;7473;4905;9884;474170;3837;9755;996;4635;51226;80320;3690;124995;9570;6668;124989,28,1.42935173793857000000
chr22,18919942,20311763,1391821,1,1,54487;27037;5413;29801;65078;23617;10587;1312;7122;421;7290;128977;8220;2812;388849;7353;2928;128989;6899;9993;54584;5625;79680;85359;64976;8318;5902;6576;8218,29,2.08360126769175000000
chr17,69458883,69823311,364428,1,1,,0,0.00000000000000000000
chr17,69544737,69686379,141642,1,1,,0,0.00000000000000000000
chrX,139504722,145120304,5615582,1,1,494118;64663;645188;51438;1038;9142;139065;64648;6658;139067;494119;9947;139081;84631;30014;728712;441525;728695;23641,19,0.33834427135068100000
chr13,61102644,81138045,20035401,1,1,7347;115207;64062;22894;4008;1203;23077;1602;122060;440145;57626;26224;5457;730249;8796;79866;1910;11278;729420;170622;64881;100129307;5101;688;54602;10464;79596;10253;9882;81550,30,0.14973496163116500000
chr15,22684529,30730543,8046014,1,1,321;7681;2562;101059918;123606;4948;57194;81614;2558;23359;7082;8924;114791;23742;7337;6638;89832;653073;2567;8926;283685;653720;54551;4692;23191;283767;56160,27,0.33556988590872400000
chr22,21440455,22916612,1476157,1,1,7332;23753;5594;7441;8940;23532;129025;645426;29799;150221;140883;23759;150223;9647;440804;23119;164592,17,1.15163901942680000000
chr3,136565617,198022430,61456813,1,1,83850;29970;55324;5290;5062;1360;653659;5984;170506;5922;5648;10051;55341;9370;3592;389161;1894;8626;56925;170572;51208;401097;8706;151742;4071;25976;80012;6657;26998;23043;253461;604;4154;116931;2119;100505385;9197;5357;205564;199221;79929;131583;7095;105374250;64747;200909;57709;5130;401089;151963;132112;5437;59345;7220;151827;84859;285382;1356;2693;57018;1370;10188;151613;92369;2122;347;1739;51319;8975;344892;51068;4690;22871;5217;9435;8833;285313;79718;10195;8893;622;64805;5948;93109;200931;55486;131408;344901;11235;51714;7037;344752;285242;131920;3273;55214;185;83939;26043;10644;116832;4976;8646;5708;286827;200916;285195;7066;9175;57088;200879;287015;84107;110599583;94032;13;5584;54464;483;375387;5918;23527;545;89857;79572;56648;51726;8743;57560;23350;54800;7545;389177;152118;647309;55179;3840;6434;56922;6478;79782;389158;4311;80235;2992;200933;26996;728262;4291;1857;26577;6750;165679;389170;285386;54165;54965;5352;2814;6747;5010;89782;23101;6514;131578;151790;10242;57129;152137;152078;92370;344658;9711;56945;7029;131890;6498;51555;27074;1173;197;51193;29909;53836;84343;344758;5947;84239;1608;339829;729627;64110;57047;55186;22916;83893;23200;165918;79674;9616;10686;56670;9276;590;255798;1427;116441;152138;27094;5291;4241;84984;9934;26084;347736;4711;64084;5504;254827;349565;200958;7881;5912;53833;1974;344838;25852;1181;5276;5274;55892;3556;255758;116211;152002;110599564;22808;6596;79740;27333;90407;9076;6480;84248;344657;25937;55669;86;348793;23355;5359;131149;51146;80117;1962;3280;84002;205428;6476;84223;57552;64393;11342;55171;53829;57110;7104;59343;6165;55689;8087;5806;131540;10057;9718;64778;51163;5337;8403;5028;389151;90113;131118;2049;285315;3827;654502;668;27230;7401;1981;51122;344905;80321;80723;131831;84517;9819;389152;64108;1359;85476;4026;256356;2257;22865;6474;4585;23007;257313,310,0.50441925779652800000
chr10,81392533,89047671,7655138,1,1,657;84332;80195;10718;643161;387695;143241;729262;6441;54462;84293;10974;728118;27069;23063;54537;81619;5995;387694;79812;2746;119385;26103;4143;219348;6623;92211;94233;2894;340745;11155;311,32,0.41801989722458300000
chrX,153287317,153630819,343502,1,1,728458;2010;1774;5956;2316;6134;4204;8277;2652,9,2.62007208109414000000
chr16,29673954,30197341,523387,1,1,653808;5531;26470;283897;253980;146378;8479;83719;23475;283899;124446;9344;3835;4150;226;253982;83723;5595;6911;11151;8448;79447;112476;9961;10423;6693;79153,27,5.15870665492265000000
chr7,72726578,74139390,1412812,1,1,5982;51085;9275;84277;7462;135886;83451;1364;135892;6804;7461;155382;3984;26608;8468;9031;155368;2969;8326;7458;9569;2006;1365;114049,24,1.69873981817821000000
chr15,32076948,32510863,433915,1,1,161725;1139,2,0.46091976539183900000
chr17,2594489,3803832,1209343,1,1,8388;30851;23277;4994;1497;443;8387;5023;26189;162514;55421;8383;4995;8392;84254;23729;83460;7442;83903;4991;8386;8390;5026;23108;3682;84690,26,2.14992768800911000000
chr2,107159481,113098686,5939205,1,1,5903;96626;10913;7851;6819;344558;65124;100288695;64682;285190;84620;27233;10018;84910;10461;699;129804;3987;442038;60482;55289;9648;151011;376940;84220;4867;729540;165055;84524,29,0.48828083893383000000
chr22,18894835,21464060,2569225,1,1,54487;27037;9342;29801;65078;10587;1312;6545;8214;421;7290;2812;6899;5625;7625;79680;64976;6576;3053;8218;5413;80764;23617;400891;1399;7122;150209;128977;8220;388849;84861;7353;51586;2928;128989;5297;9127;9993;54584;91179;85376;8216;85359;8318;728229;5902,46,1.79042318208798000000
chr22,18641409,21440514,2799105,1,1,54487;27037;9342;29801;65078;10587;1312;6545;8214;7290;421;2812;6899;5625;7625;79680;64976;11274;6576;3053;8218;5413;80764;23617;400891;1399;7122;150209;128977;8220;388849;84861;7353;51586;2928;128989;5297;9127;9993;54584;91179;85376;8216;85359;8318;728229;5902,47,1.67910814349587000000
chr16,29673954,30197341,523387,1,1,653808;5531;26470;283897;253980;146378;8479;83719;23475;283899;124446;9344;3835;4150;226;253982;83723;5595;6911;11151;8448;79447;112476;9961;10423;6693;79153,27,5.15870665492265000000
chr2,149002435,149414104,411669,1,1,26122;55777,2,0.48582720583770000000
chr16,29673954,30197341,523387,1,1,653808;5531;26470;283897;253980;146378;8479;83719;23475;283899;124446;9344;3835;4150;226;253982;83723;5595;6911;11151;8448;79447;112476;9961;10423;6693;79153,27,5.15870665492265000000
chr1,146155982,149232451,3076469,1,1,9557;728945;284565;644591;51205;645142;51463;2703;5565;607;2702;730262;2330;200030;149013,15,0.48757195343102800000
chr20,121521,3783829,3662308,1,1,140680;57593;10616;1457;57761;10326;140850;5786;80332;64773;9762;551;9751;5020;113278;343641;117532;56265;1059;343637;6628;85508;388780;3704;64601;64096;9491;128637;83959;54976;400830;140809;80023;116835;128646;64949;83541;55968;128653;55321;10528;81623;140881;51378;8455;22888;7053;140885;2797;60493;245939;6614;85364;3420;25876;5173;65992;400831;6939;2280;25943;642636;140901;55423;100288797;284759;6666;27111;79175;994,70,1.91136299841521000000
chrX,10497507,20092715,9595208,1,1,660;2742;2925;8544;55787;3052;4810;795;10389;5160;4281;9367;6247;11238;645864;5931;10149;140456;30011;5277;9758;5475;6322;140462;57393;9185;8233;265;94056;158747;92552;6792;56474;10943;2824;7114;5634;2187;139105;5256;256643;54960;59272;170082;6399;25975;51311;51284;8905;395;2277;171484;8481;256714;10742;389840,56,0.58362465930910500000
chr12,116497982,116681549,183567,1,1,23389,1,0.54476022378750000000
chr12,115067028,118264352,3197324,1,1,643246;79794;4842;283455;84900;26259;23389;8739;54997;6926;23014,11,0.34403770152790300000
chr15,22765428,30366265,7600837,1,1,321;7681;2562;123606;4948;57194;81614;2558;23359;7082;8924;114791;23742;7337;6638;2567;8926;283685;653720;54551;4692;23191;56160,23,0.30259825332394300000
chr8,12467484,42213568,29746084,1,1,203102;2053;27257;55806;8756;84513;54793;286097;389643;619373;10671;51669;155;9070;7976;59339;4747;1960;2137;6570;1135;55246;8754;5533;541565;51312;57509;2515;7994;51125;56154;79698;157855;286;11030;2267;137868;23484;11178;4481;80005;6867;63898;427;1191;55756;56892;55872;79618;2260;81551;137964;2961;6770;5157;64641;23516;148;84549;5108;6781;5368;64236;25960;10395;3551;51435;6440;2936;91694;2185;9108;137970;4023;1846;4017;5423;8793;29883;84750;661;2039;55174;7991;157313;9;79845;29942;10947;7993;389649;3620;1978;157574;9796;7486;9530;203069;2675;157848;157310;23221;137994;55790;5516;5520;137492;26281;23087;10174;8795;51201;83877;11212;80139;55124;23362;8797;4824;8794;84296;157773;8749;11160;55909;80346;9583;286133;6422;649;10361;57805;91782;2796;55290;169355;80185;10;78986;27299;10863;10687;157570;55140;203100;665;4741;9046;23039;23259;79873;137814;55893;23303;526;203190;100507341;57604;3084;137362;80223;6542;5327;8822;1808;54904;64760,167,0.56141843746558400000
chrX,32437956,32472715,34759,1,1,1756,1,2.87695273166662000000
chr1,145413388,145747269,333881,1,1,148738;128077;10401;200035;27246;84265;284615;9939;11126;8515;148741;10628;10623;8799;5174,15,4.49261862759486000000
chr22,19023824,21440514,2416690,1,1,54487;27037;9342;29801;65078;10587;1312;6545;421;7290;2812;6899;7625;79680;64976;6576;3053;8218;5413;80764;23617;400891;1399;7122;150209;128977;8220;388849;84861;7353;51586;2928;128989;5297;9127;9993;54584;91179;8216;85376;85359;8318;728229;5902,44,1.82067207626961000000
chr7,32871401,39537414,6666013,1,1,54443;387129;64224;353345;445347;23366;51314;6424;273;57057;168667;27072;23333;9844;25948;80820;27241;83930;6100;51251;989;54749;313;11328;11281,25,0.37503677235552900000
chr7,15614415,24621160,9006745,1,1,55536;27075;222894;90693;25928;340277;256130;256227;340273;4223;3569;100506049;84668;51678;221830;56164;221833;8701;4852;346389;54543;729920;196;55975;10457;11097;28969;155465;10551;9771;57037;221823;7291;23161;10643;6671;29896;9734;3696;115416,40,0.44411160746751500000
chr11,61479322,134944006,73464684,1,1,143941;54733;83759;9986;196264;3636;23201;5091;53340;63970;9743;83707;220042;5331;28971;27314;79842;9354;57571;10629;100526737;9702;5450;219875;440050;2526;440068;349633;595;3995;4975;79684;80168;51773;84285;79101;23769;257160;219858;100169851;25858;64221;57830;23365;390265;85463;10888;5436;9159;120224;387601;22897;65084;472;54663;143570;486;390212;102288414;5970;26580;2286;79780;4321;282679;23682;6876;10004;915;6484;5977;11181;85458;91893;84957;1740;54766;399949;84959;64137;338662;5920;2615;6811;7351;100130348;7108;741;3846;10825;24145;26005;54851;60496;89944;2915;2542;7225;9376;4926;256472;85016;55298;726;55531;55199;22997;9638;143684;91801;7704;3338;641654;50507;50863;84447;1737;27034;51585;55800;90952;80227;255239;2197;283162;57562;917;10432;25906;80150;440051;144097;390275;1474;5526;54827;84304;2237;2785;116071;28992;4297;120379;57093;79827;81570;116337;5837;283238;746;2101;6520;50801;10714;10205;4054;220074;116985;414301;2893;10992;143686;4296;79671;9099;25923;79102;25833;120376;80789;89;113130;6712;9177;4135;117245;83875;2249;5031;26011;60494;79081;643037;55690;79829;2950;5241;10632;254263;23650;219595;10003;246330;5883;114902;83552;403312;283234;116085;10809;740;4162;170589;83706;55191;8882;54979;9049;9965;4319;2248;219844;55107;50937;916;1119;1111;7356;120146;79703;341208;10312;2348;390243;7405;387787;9415;4314;143884;55867;23387;4041;219927;5017;51399;79796;254439;2350;8538;170689;387778;9538;254359;8986;7423;747;6327;335;120400;23310;8301;2230;56935;80198;6494;10648;120425;57410;5519;51501;56158;256364;390245;3359;81622;89792;219870;9158;100129216;100532726;399967;253935;26973;91683;9828;7536;7352;834;51475;6330;4837;56649;114609;8722;6094;80975;112936;9789;55231;341152;84881;374407;23130;10524;10525;80194;102724265;55004;154810;4900;337;219938;330;4013;2352;89849;9873;838;79064;402;25988;738;7299;5029;23621;54538;572;7439;9846;3312;55611;10235;25855;390264;221092;6734;10313;26229;399909;54961;643;120103;3703;283208;220064;51503;1798;57804;56912;160065;29068;5790;3606;53826;2017;81544;28970;6230;4246;1410;7070;871;9973;56946;338657;6768;5870;338699;55823;9440;399939;221091;338692;5866;1351;116519;3014;10482;5058;8726;84000;390231;4316;1128;59082;63876;404552;283212;283160;390271;790955;254187;91703;254122;79864;374395;51642;642446;57646;23649;3508;387804;1717;23584;84897;4723;9600;4647;9379;372;329;4312;26521;57010;220032;3177;10897;644672;9092;143888;26492;51083;23086;5138;55291;23235;401;29118;9313;387273;408;84259;4978;79026;7481;143879;9219;4728;254552;219855;84866;51035;64066;65998;60492;338661;26579;2900;84623;58487;219873;8061;10263;5547;2495;143872;57569;114571;3316;78999;64837;51400;3587;10413;10873;4684;29901;1072;387775;9610;80310;30008;8500;6653;10534;5871;79053;220382;219833;120406;57558;219899;26472;11041;7069;56834;5049;221;55216;84153;53942;100506127;219854;10647;399948;120114;22992;23193;2313;38;1521;65003;84441;143903;4544;114769;10938;27087;1656;837;1813;51287;114908;220359;57175;55331;254225;117144;219902;156;11145;54843;54970;51092;91056;91894;283248;3762;23625;11095;2977;80071;8322;266743;9356;26595;7007;283171;5818;341032;245911;55572;83786;143689;220047;56;85329;23187;390261;745;3619;5612;79659;26493;54734;83480;10072;5936;192134;823;4361;25987;220388;1937;11007;390259;220296;9854;6188;6199;28960;219931;116512;64852;51111;23705;283130;8815;6309;84649;334;4863;399947;374403;51504;8898;219865;57453;399968;55863;5499;55693;84233;283129;84437;65987;399979;160140;159989;5805;10179;100131539;10435;4221;112937;254102;283209;29907;642612;283152;283219;440044;1374;116535;84811;220323;729384;10089;219874;222;53838;283150;25824;100507050;11309;57124;642623;1662;79849;56253;58473;10008;56980;9633;83700;23052;79607;3758;100533181;4317;2011;283237;5962;345;4322;10929;29984;11098;64776;582;81876;92105;54494;8690;55561;7379;4718;4250;867;22941;7753;25884;347853;29087;23529;57476;83638;219869;8772;390260;414899;10963;54414;8065;6588;283159;10589;1207;4798;85459;25996;79731;283149;9183;2113;751071;7542;3992;10068;6392;3145;1075;100287896,683,0.92969841128017400000
chr19,2487767,4882351,2394584,1,1,126259;60680;6915;80032;58492;5605;100131094;51343;55620;84839;80700;10036;148252;4782;23396;91039;166;84954;2767;1938;10501;8698;83475;100128569;56961;2788;729359;84717;23217;148254;6449;148022;51341;56926;4145;126321;1613;9546;10226;10362;126295;79816;116541;2769;79187;56005;51548;440503;116844;29985;27134;6455;170961;55527;7089;84699;115196;284422;27231;126282;10148;7064;55702;85300;51588;58509;126326,67,2.79798077661924000000
chr16,29673954,30197341,523387,1,1,653808;5531;26470;283897;253980;146378;8479;83719;23475;283899;124446;9344;3835;4150;226;253982;83723;5595;6911;11151;8448;79447;112476;9961;10423;6693;79153,27,5.15870665492265000000
chr22,42355570,50988545,8632975,1,1,11252;150383;85378;25771;23151;23774;80305;55267;25813;1727;6942;79174;150379;55007;4668;415116;55964;83642;553158;84271;164684;7380;6300;10343;83933;91689;1565;79924;23313;84247;6305;51512;1890;53947;25830;23654;25817;29781;91289;26286;26150;64800;27341;400935;706;2192;9701;80274;56666;5600;27127;9889;414918;758;25809;150368;9997;9620;440836;4700;267020;64781;5465;112885;150372;29780;23170;23779;23209;253190;7477;64098;25814;80339;79087;10762;55020;27349;55687;638;348645;85352;55615;113730;55586;54456,86,0.99618034339263100000
chr1,145415216,145799572,384356,1,1,148738;128077;27246;84265;11126;10628;653519;8799;5174;10401;200035;284615;8515;148741;10623;9939,16,4.16280739730874000000
chr1,125000001,155154961,30154960,1,1,57402;148327;10899;1163;84265;117145;10654;6700;200185;9659;1944;353135;10628;11189;127579;54507;27173;126961;200035;200186;317772;5692;284615;6280;6706;353145;5565;79626;8394;353132;353140;653604;100534012;6275;728833;353137;723790;2029;27246;448834;10456;11126;400818;51686;645922;1520;55891;388695;54460;1942;8349;9129;56957;388701;79005;10401;6698;9900;140576;6273;23126;8515;8370;51027;6274;353134;333932;10262;57592;11022;148738;126637;54964;8337;284485;2330;91181;653519;554282;149018;81611;51177;388677;55204;2312;51205;29765;6701;2209;56882;6283;100131107;6279;11000;25912;4170;728945;284565;126638;7170;6464;84072;353144;388692;54544;8991;58497;338324;3713;57198;51463;5872;2702;4881;81609;2703;9557;26097;9909;10962;57530;7286;90780;163778;3782;388698;353139;353143;4184;6705;26239;49860;51107;574414;149095;51043;5298;65123;126626;339398;6281;730262;65005;353131;6282;254910;448835;644634;6704;57115;199834;6278;57326;54344;80308;9898;5710;6097;6276;8799;126668;149013;284486;55793;3608;6277;3570;100129271;29956;353142;1893;353141;10500;9869;79630;84648;6703;1141;1945;128077;388697;148523;1513;5174;8338;103;554313;5993;645142;10903;148741;6707;653598;10623;55585;80222;100132406;55974;9939;11311;126669;8751;440689;57459;4014;6284;405;6699;644591;8416;6944;100191040;353133;114771;23632;6271;23557;23248;89872;607;101928120;149428;6232;80128;200030;7062,226,0.74946211170567000000
chr20,59082720,62893189,3810469,1,1,3785;198437;2832;85441;140685;79025;6874;6725;84619;63910;55738;51750;284739;54915;11255;80331;57473;24148;10732;1917;128408;26164;54345;6919;10139;9885;11047;1299;11054;1002;1137;140700;10287;100132911;28231;4987;149986;26039;11083;8771;4923;55251;54994;128414;57642;50861;140701;3911;5753;55257;5688;6227;7165;128826;140893;26205;79444;140628;56731;54963;4661;79144;54923;81928,64,1.67958327439483000000
chr16,85256582,90111263,4854681,1,1,54758;2294;863;81631;23174;115992;4597;146429;2300;763;23199;124245;197320;64779;100287036;1535;51693;79007;100129697;8558;124044;3394;348180;9780;81620;9605;2303;10328;5119;4157;404550;54849;79791;100506581;27132;353;51659;197322;2588;2622;8140;6137;6687;54971;2175;27189;1013;333929;1327;124045;161882;57338;84501;22980;92822;92806;84627;390748;10381;1800;29123,61,1.25651922340520000000
chr22,18919942,21440514,2520572,1,1,54487;27037;9342;29801;65078;10587;1312;6545;421;7290;2812;6899;5625;7625;79680;64976;6576;3053;8218;5413;80764;23617;400891;1399;7122;150209;128977;8220;388849;84861;7353;51586;2928;128989;5297;9127;9993;54584;91179;85376;8216;85359;8318;728229;5902,45,1.78530904889842000000
chr14,27441159,31400682,3959523,1,1,29966;1690;2290;55632;23256;5587,6,0.15153340440250000000
chr8,7169520,11908434,4738914,1,1,401447;1508;83650;504180;503841;203076;83648;55894;245910;613209;157285;252969;245908;100132396;503618;54984;392188;100289462;4482;613211;203074;245909;90459;503614;140596;83595;100133251;653423;100131980;645402;2626;613210;137075;1673;100131608;640;66036;286046;79660;2222;8658;9258;414325;94137;10407;645836,46,0.97068653282165500000
chr22,1,18628048,18628047,1,1,27440;51816;51807;23765;150160;27439;27443;55670;637;529;23784;150165;23786;81061;83733;128954;101929372;57553,18,0.09662848714092250000
chr22,18894864,20311733,1416869,1,1,54487;27037;5413;29801;65078;23617;10587;1312;7122;8214;421;7290;128977;8220;2812;388849;7353;2928;128989;6899;9993;54584;5625;79680;85359;64976;8318;5902;6576;8218,30,2.11734465218732000000
chr16,3706248,4134809,428561,1,1,1773;10131;115;1387,4,0.93335604499709500000
chr7,72286151,74481540,2195389,1,1,5982;84163;378108;51085;84277;55695;135886;441250;135892;6804;7461;155382;3984;26608;8468;9031;81554;2969;8326;7458;1365;9275;7462;653361;83451;9883;1364;155368;9569;2006;729438;114049,32,1.45760045258494000000
chr7,72726578,74481540,1754962,1,1,5982;84163;51085;9275;84277;7462;135886;653361;83451;1364;135892;6804;7461;155382;3984;26608;8468;9031;81554;2969;155368;8326;7458;9569;2006;729438;1365;114049,28,1.59547614136374000000
chr16,29673954,30197341,523387,1,1,653808;5531;26470;283897;253980;146378;8479;83719;23475;283899;124446;9344;3835;4150;226;253982;83723;5595;6911;11151;8448;79447;112476;9961;10423;6693;79153,27,5.15870665492265000000
chr10,27133014,37893252,10760238,1,1,8829;119180;79741;220929;84930;283078;3799;55130;91074;84569;1390;8453;100288485;25805;283080;56288;219770;143098;57608;10730;51322;80314;8325;91452;55149;374308;1326;22852;94134;219771;10006;6840;3688;22931;6935,35,0.32527161573935400000
chr22,18706022,21213739,2507717,1,1,54487;27037;9342;29801;65078;10587;1312;8214;7290;421;2812;6899;5625;7625;79680;64976;6576;3053;8218;5413;23617;7122;128977;8220;388849;84861;7353;51586;2928;128989;5297;9993;54584;91179;85376;85359;8318;728229;5902,39,1.55519941045979000000
chr3,17486453,26176359,8689906,1,1,6138;131096;5915;54995;8850;151648;28512;7325;7155;55768;79750;6304;7324;339862;9779;9975;151649;7068;5868;151651,20,0.23015208680047900000
chr16,28837450,29042118,204668,1,1,11273;27040;79874;7284;930;84901;487;83985;25970,9,4.39736548947564000000
chr17,43717703,44159862,442159,1,1,246744;162540;104909134;1394;4137;284058,6,1.35697791970762000000
chr15,23300263,29572394,6272131,1,1,2562;7681;321;4948;57194;2558;23359;8924;23742;7337;6638;2567;8926;283685;653720;54551;4692;56160,18,0.28698380183704700000
chrX,148549213,154908471,6359258,1,1,4110;4108;2564;8263;1193;492;1260;2157;50814;541578;9130;2556;3054;4104;7411;10134;79057;139728;8517;30848;3423;554;6901;474383;92002;4105;57595;8266;266740;8776;29944;84968;2539;246100;7739;8260;55559;4204;100272147;728269;100533997;65991;3149;5365;26576;8277;4354;474382;10838;139735;2316;8273;83692;6535;114824;393;11219;10251;55558;139716;1736;55217;8270;3654;537;3421;100132963;5973;4109;1852;3897;4101;215;91966;474384;6748;4100;55879;4103;2010;4534;6134;474381;9248;101928917;1069;116442;100506164;2652;84548;1485;1774;203547;139135;60343;4107;728458;8269;83740;89885;10046;5956;2664;100130086;633;79184;4515,107,1.68258623883478000000
chr5,25801713,52322105,26520392,1,1,6897;55322;1601;100861519;345557;2255;64902;4883;133688;29102;729;1004;10884;167127;9631;3673;133690;23037;202151;6414;348980;65250;253260;5562;10923;55299;133584;389289;730;79668;51151;6507;2533;23548;153657;133558;100129792;5618;55100;51663;3575;84674;133418;5810;54545;3977;92255;64417;735;2668;3672;10605;5734;6167;1007;133686;7690;53918;56477;3670;51289;9180;6502;114899;26272;285636;81792;5019;23600;26064;23530;2690;3157;79925;25836;375444;134218;167359;64083,79,0.29788398301201600000
chr3,1197623,1337332,139709,1,1,27255,1,0.71577350063346000000
chr2,44773356,45170467,397111,1,1,79823;6496,2,0.50363752200266400000
chr16,21444460,29378450,7933990,1,1,343;162083;6340;23247;146183;487;79728;7385;56061;146177;124454;730094;6338;79874;146395;728734;83985;5579;55718;10368;51451;50615;55114;6799;8663;27040;10261;930;9956;29904;9951;728741;84901;1039;388228;79831;4706;23214;5930;26471;197370;728689;25970;63928;11273;100132247;115584;112869;27327;1201;255762;7284;246778;23062;51108;10595;100507607;55911;440345;3566;5347;84516;57478;91949;2975;6817;342357,67,0.84446791589099600000
chr4,172930618,190896674,17966056,1,1,285440;53842;11341;205860;25854;175;55325;140458;7098;55714;60684;60559;3148;836;80014;83891;51809;57587;132851;9464;8819;55602;8001;2160;80817;2823;3818;79682;353322;11086;116966;291;100132463;27295;3660;441054;391723;442117;201965;2195;339976;55247;201973;4543;132625;55805;3248;133121;256309;8470;2180;26269;7424;56977;3622;2483;1635,57,0.31726495787389300000
chr22,18919942,21275314,2355372,1,1,54487;27037;9342;29801;65078;10587;1312;421;7290;2812;6899;5625;7625;79680;64976;6576;3053;8218;5413;23617;1399;7122;128977;8220;388849;84861;7353;51586;2928;128989;5297;9993;54584;91179;85376;85359;8318;728229;5902,39,1.65578940396676000000
chr18,53068808,77893945,24825137,1,1,100505549;147381;51046;89778;55628;3998;147372;8792;84735;644041;9480;5275;4772;4155;27164;440498;5268;284257;89777;1005;2235;4677;5273;23556;23239;9150;101927322;10194;220158;6317;6318;79839;10892;374868;90701;5271;29090;10907;55748;2922;284274;7776;2587;125704;54495;28513;1528;201456;115701;79863;400658;8710;25914;9306;9658;5055;23327;28316;54877;81832;57614;55205;26251;6925;4160;80148;92126;30062;23335;596;339302;5205;284273;284293;22850;220441;10666;9525;2531;220164;5366;9352,82,0.33031036243626800000
chrY,2654593,19989331,17334738,1,1,728403;100289087;9087;266;90665;83259;90655;6192;7258;7404;8287;728395;8653;353513;64591;728137;22829;9084;7544;6736;9082,21,0.12114402882812500000
chrX,61115,2709057,2647942,1,1,28227;286530;8225;1438;3563;207063;4267;293;7499;9189;438;64109;6473;8227;55344;8623,16,0.60424284217705700000
chr17,1,6519770,6519769,1,1,708;10594;8388;84622;50628;10514;5023;7326;5338;400566;55178;146760;124961;114826;55421;124641;100506388;26001;9552;84254;83460;9135;22861;2027;8386;8390;246;23108;388324;23140;10749;55720;55065;1497;29928;5216;23125;727910;83394;728392;29;359845;8578;4641;124936;8402;4335;124997;5176;124976;4995;4927;51479;23302;7531;83903;2811;5026;9851;400569;5048;51763;51031;286753;443;23746;5345;63826;162514;26189;100130311;9905;7775;388323;1398;124975;23293;79003;7442;727857;9501;409;84268;388325;64359;6117;84690;9098;30851;23277;342527;4994;1145;54478;124935;8387;5694;79066;83547;55275;56919;8383;1801;9032;50488;79850;489;8447;8392;23729;5306;3090;27043;201305;4991;58191;84225;284013;51009;3682,120,1.84055600742910000000
chr22,18919942,20992700,2072758,1,1,54487;27037;29801;65078;10587;1312;421;7290;2812;6899;5625;7625;79680;64976;6576;8218;5413;23617;7122;128977;8220;388849;84861;7353;51586;2928;128989;9993;54584;91179;85376;85359;8318;728229;5902,35,1.68857145889679000000
chr15,20581549,28926148,8344599,1,1,2562;7681;727832;100996331;123606;4948;57194;283694;81614;100287399;390538;2558;8924;114791;23742;7337;6638;2567;8926;283685;54551;4692;23191;283767,24,0.28761118419231400000
chr22,44127601,49286818,5159217,1,1,64800;150383;2192;27127;25771;23151;55267;25813;9620;150379;55007;64781;5465;112885;29780;553158;7380;23779;10343;7477;23313;25814;64098;80339;10762;55020;84247;55687;51512;85352;25830;55615;25817;26150,34,0.65901473033601800000
chr1,224599204,234496486,9897282,1,1,92815;54583;65094;440730;55740;57568;58480;286826;79169;10753;128312;84886;7257;51127;55746;3930;3020;8290;9816;84033;83881;149603;375057;2052;163859;375061;81559;200205;148641;79605;339501;83932;128061;183;58;5664;5867;64746;84451;27185;128308;2590;22796;2987;64801;116841;57165;7044;126731;23456;149111;149373;6726;80232;89780;9725;27097;10638;7483;29920;8443;10637;3707;54627;100129094;339500;149371;80003;56997;3775;142;127602;8476;375;84284;79573,76,0.76788758772357900000
chr17,16637931,20464342,3826411,1,1,2314;9720;55244;125170;55090;11216;79018;79999;284194;645027;10400;54890;254272;9706;92521;8533;22905;729288;100996259;5598;218;23164;83450;224;51168;80039;51655;201163;7156;51030;5636;644815;10750;10517;654346;10743;388436;27077;100129396;140775;6470;146691;1819;6720;125206;23495;147166;7732;146802;91647;56953;201164;400581;3996;4239,55,1.43737826386136000000
chr15,23684655,28535007,4850352,1,1,2562;7681;23742;8924;7337;6638;2567;4948;8926;57194;283685;54551;4692;2558,14,0.28863884518072100000
chr4,72447,16554087,16481640,1,1,728373;7700;521;7469;79155;644414;55646;654254;53407;54872;9948;79441;152877;579;3166;1816;9778;10861;92305;285498;57537;100287404;728379;285550;27065;2580;53834;84179;5158;728386;152687;54360;728405;259282;57533;10417;152992;93624;345222;4043;132864;7884;170960;100287441;57732;10296;3083;100287238;768239;57654;114905;9982;100287327;1400;3954;100288520;728369;1487;100287144;8310;80273;2868;54436;9364;285464;8603;683;257236;401115;728393;133060;4636;728419;202018;6286;166793;114932;1609;55351;2121;9079;100287513;7468;285489;84448;353497;8842;152789;100287205;8532;10815;116449;402160;3425;4487;6047;57545;54729;6002;26234;27201;7466;10227;10336;9957;93621;84286;56606;2261;255403;8602;132884;3064;100287364;10460;85013;728400;100287478;118;152;60312;85460;94031;952;83888;23324;55330;100287178;339983;6452;5522;10608;389199,133,0.80695853082581600000
chr12,28082255,28152554,70299,1,1,5744,1,1.42249534132776000000
chr17,16591714,20380052,3788338,1,1,2314;9720;55244;125170;55090;11216;79018;79999;284194;10400;54890;254272;9706;400581;92521;8533;22905;729288;100996259;5598;218;23164;83450;224;51168;80039;51655;201163;7156;51030;5636;644815;10750;4239;10517;654346;10743;388436;27077;100129396;140775;6470;146691;1819;6720;125206;23495;147166;7732;146802;91647;56953;645027;3996;201164,55,1.45182399247374000000
chr5,1,42573850,42573849,1,1,54463;10299;7204;50834;6897;55322;1601;100861519;345557;64902;50805;4883;11044;133688;29102;729;1004;23194;108;167127;10723;9631;90441;133690;23037;202151;348932;9319;253260;5562;133957;65250;10923;55299;133584;651746;85409;79844;83853;730;51151;6507;2533;57491;4552;23548;153657;6550;133558;5618;1767;170690;55100;441061;6531;90268;51663;3575;84674;5810;134121;84246;54545;389257;55722;3977;92255;1010;735;2668;79192;81037;11336;65980;5734;6167;1007;134147;56172;133686;1501;153571;64979;1016;22948;54491;51289;9180;79888;6502;11076;23379;4651;1611;4726;114899;9037;10016;7015;6389;134145;26272;285636;340024;81792;1008;153572;153478;5019;23600;54888;26064;2690;79072;6715;79925;25836;134111;134218;10409;56979;64083,122,0.28656088858679400000
chr2,235670827,237590836,1920009,1,1,23677;57007;2637;116987;79781;401036,6,0.31249853516311600000
chr7,72726578,74139331,1412753,1,1,5982;51085;9275;84277;7462;135886;83451;1364;135892;6804;7461;155382;3984;26608;8468;9031;155368;2969;8326;7458;9569;2006;1365;114049,24,1.69881076168304000000
chr8,141268759,141387694,118935,1,1,83696,1,0.84079539244124900000
chr7,145949947,159119707,13169760,1,1,27153;57541;84626;140545;1804;168537;389602;26;22976;11194;155061;392843;57180;6469;3110;116988;168391;51422;349136;55303;155051;63917;113763;155435;55340;83590;28959;3361;64327;168544;136051;7988;10061;9690;55112;6604;285973;26157;55365;7434;285888;8427;54892;285971;10049;57488;54480;58508;65999;5799;474344;643641;8454;9601;155054;1020;6009;23145;2636;26047;2020;100289678;653857;3638;5919;51667;9311;2146;170575;6522;3757;4846;29803;64434;10922;202865;100527949;7516;155066;136371;155038,81,0.61504537668112400000
chr17,16723271,20234630,3511359,1,1,2314;55244;125170;55090;11216;79018;79999;10400;54890;254272;9706;400581;92521;8533;22905;729288;5598;218;23164;83450;224;51168;80039;51655;201163;7156;51030;5636;644815;10750;4239;10517;654346;10743;388436;27077;140775;6470;146691;1819;6720;125206;23495;147166;7732;146802;91647;56953;645027;3996;201164,51,1.45242910223648000000
chrX,149962252,154416985,4454733,1,1,2564;8263;492;1260;9130;50814;2157;2556;3054;4104;10134;79057;139728;8517;30848;554;6901;92002;4105;57595;8266;266740;29944;84968;2539;246100;7739;8260;55559;4204;100272147;100533997;5365;3149;8277;26576;65991;4354;474382;10838;139735;2316;83692;8273;6535;114824;11219;393;55558;139716;1736;8270;3654;537;3421;5973;100132963;4109;1852;3897;4101;215;6748;4100;55879;4103;2010;6134;9248;1069;2652;1485;1774;203547;139135;60343;728458;8269;89885;5956;2664;633;79184;4515,84,1.88563489663690000000
chr18,12842,15303932,15291090,1,1,116;23255;57132;8774;645369;125228;57045;103910;642597;84617;9097;7525;10650;3613;56984;65258;79822;84034;4729;23253;9663;9989;339291;9984;10928;162655;63895;201475;64863;342850;27098;646000;753;7541;55125;55556;10403;4158;84203;388468;147495;9218;5797;494514;1149;5771;10939;1068;79959;9229;7298;91133;11031;56907;7050;81929;4161;81035;2774;23347;10627;8731;8736;374860;284217;23136,66,0.43162390647102300000
chr5,35861979,42250628,6388649,1,1,3977;92255;735;2668;5734;1601;100861519;6167;345557;133686;133688;729;167127;9180;6502;9631;133690;202151;26272;285636;65250;253260;5562;5019;133584;730;2533;6507;23548;133558;25836;55100;3575;84674,34,0.53219389576732100000
chrX,152819509,153780138,960629,1,1,55558;8270;492;3654;9130;537;3421;5973;1852;3897;3054;215;6748;10134;139728;2010;8517;6134;554;6901;92002;57595;8266;2652;2539;1774;8260;4204;60343;5365;8277;26576;728458;8269;5956;2664;2316;8273;6535;393,40,4.16393841951471000000
chrX,47932918,52102414,4169496,1,1,729442;64743;6759;9500;10214;389856;170685;139189;392465;778;5935;6756;729431;26748;10013;55190;50943;340602;27344;28952;729447;85417;100132399;7030;729428;2623;729422;729201;89801;4943;56850;79917;2574;9506;64840;10682;3266;8712;729408;81557;100008586;57477;90060;24140;92745;4007;6839;3750;1184;7454;27238;645073;645037;10245;645051;2543;548313;7355;11152;10084;5355;6758;55593;8852;23708;728239;11040;6855;11230;9210;729396,71,1.70284370101326000000
chr17,14087933,15491532,1403599,1,1,1352;64518;9953;201158;284040;100533496;5376;374286;146822,9,0.64120877829066600000
chrX,139308681,139675086,366405,1,1,6658,1,0.27292203981932600000
chr18,148963,12790520,12641557,1,1,116;55556;10403;23255;57132;8774;645369;84203;57045;103910;642597;84617;9097;7525;147495;10650;9218;3613;5797;494514;1149;56984;5771;10939;1068;65258;79959;9229;79822;84034;4729;7298;91133;11031;23253;9663;56907;9989;7050;339291;9984;81035;10928;2774;23347;63895;10627;201475;64863;8736;342850;27098;284217;646000;23136;7541,56,0.44298340781914800000
chr10,102866941,103458708,591767,1,1,27343;3195;8945;6468;10660;25911,6,1.01391257031906000000
chrX,138802717,153690960,14888243,1,1,158521;4110;4108;2564;492;1260;9130;50814;541578;2556;139067;4104;494119;3054;9947;10134;79057;139728;84631;30014;441525;3423;554;6901;92002;4105;57595;266740;2332;389895;8776;29944;84968;494118;64663;9142;7739;8260;55559;4204;728269;100533997;5365;3149;8277;26576;10838;139735;2316;83692;728695;6535;114824;393;11219;23641;55558;645188;51438;1038;3654;537;3421;5973;139065;4109;1852;6658;3897;4101;215;91966;6748;4100;347487;55879;4103;2010;4534;6134;9248;101928917;1069;100506164;2652;84548;1774;100133053;100129239;2334;203547;139135;64648;139081;4107;728458;8269;89885;10046;728712;5956;2664;286410;100130086;633,105,0.70525447495718600000
chr22,18894835,21505417,2610582,1,1,54487;27037;9342;29801;65078;10587;1312;6545;8214;421;7290;2812;6899;5625;7625;79680;64976;6576;3053;8218;5413;80764;23617;400891;1399;7122;150209;128977;8220;388849;84861;7353;51586;2928;128989;5297;9127;9993;54584;91179;85376;8216;85359;8318;728229;5902,46,1.76205918833425000000
chr11,116722111,134927114,18205003,1,1,143941;196264;6230;53340;63970;9743;10632;26595;7070;7007;23650;283171;5818;9354;403312;114902;83552;338657;219875;55572;6768;56;55823;4162;23187;390261;26493;83480;3014;79684;84000;257160;219858;63876;100169851;283160;390259;390271;64221;23365;9854;916;390265;220296;1111;219844;50937;28960;9159;79864;6309;120224;22897;334;486;23584;84897;219865;23387;372;57453;6876;399968;51399;26492;915;6484;8538;170689;11181;9538;29118;399979;84959;6327;4978;64137;338662;23310;112937;56912;219855;120425;84866;283152;338661;220323;219874;2900;84623;283150;219873;89944;2542;56253;79849;3587;219870;56980;83700;399967;79607;3758;100533181;22997;9638;6330;56649;114609;641654;112936;6653;84881;50863;27034;55800;90952;219833;10525;283162;219899;917;4900;219938;5049;7379;867;390275;219854;7753;29087;2313;57476;219869;4297;4013;390260;414899;79827;54414;283159;116337;4798;27087;25988;1656;10205;23621;54538;283149;3312;390264;6734;79671;9099;219902;51092;3762;2113;643;79102;3703;25833;11095;3145;1798;80071;160065;29068;53826,170,0.93380923914157000000
chr9,133737453,136974334,3236881,1,1,64794;10319;9328;7410;6834;6835;2889;83549;1621;57109;23064;158067;10585;83543;5900;389799;84929;84814;8021;8328;8019;9442;9329;84726;286336;7248;84628;9719;7270;29989;11092;26301;1757;6837;11182;56751;11094;1056;6836;28;6838;11093;389827;347148;6130;25;642968;169436,48,1.48290901024783000000
chrX,148094899,155208244,7113345,1,1,4110;4108;2564;8263;1193;492;1260;2157;50814;541578;9130;2556;3054;4104;7411;10134;79057;139728;8517;30848;3423;554;6901;474383;92002;4105;57595;8266;266740;6845;8776;29944;84968;2539;246100;7739;8260;55559;4204;100272147;728269;100533997;65991;3149;5365;26576;8277;4354;474382;10838;139735;2316;8273;83692;6535;114824;393;11219;10251;55558;139716;1736;55217;8270;3654;537;3421;100132963;5973;4109;1852;3897;4101;215;91966;474384;6748;4100;55879;4103;2010;4534;6134;474381;9248;101928917;1069;116442;100506164;2652;84548;1485;1774;203547;139135;60343;4107;728458;8269;83740;89885;10046;5956;2664;100130086;633;79184;4515,108,1.51827304875554000000
chr7,72726578,74139390,1412812,1,1,5982;51085;9275;84277;7462;135886;83451;1364;135892;6804;7461;155382;3984;26608;8468;9031;155368;2969;8326;7458;9569;2006;1365;114049,24,1.69873981817821000000
chr17,5126737,8543973,3417236,1,1,708;6517;201243;643904;388327;284114;51087;9513;3000;5198;9135;22861;433;26168;374768;51003;1984;1973;643664;124944;22899;10462;84314;6844;57659;284111;83394;728392;6154;37;162515;407977;6462;4927;2256;23302;8711;201232;57555;84316;9526;80169;23399;124751;23587;54739;1366;9851;399512;146852;5430;9744;146754;8742;54785;92162;5187;84817;23746;124637;6665;55135;1856;482;59344;9212;100996842;254863;23135;58485;79003;440400;432;339168;83659;116840;1949;84268;388325;162517;239;79142;112483;1742;54478;1140;247;1107;84667;8741;29098;56919;57048;147040;7157;255877;968;2874;9196;11337;84461;51009;81565;4628;242,105,3.07265872184420000000
chr17,6957177,7748514,791337,1,1,146754;6517;201243;8742;1856;6665;55135;482;100996842;284114;51087;254863;23135;432;5430;9513;26168;339168;374768;433;1984;1973;1949;643664;79142;10462;1742;112483;57659;37;1140;8741;407977;57048;147040;6462;7157;2256;2874;8711;968;57555;11337;84461;9526;23399;23587;1366;9744,49,6.19205218509940000000
chrX,51507140,58051765,6544625,1,1,23096;7216;90736;550643;64061;9500;7789;139793;280658;727837;3028;170627;727866;10916;9502;100463488;158880;54552;158586;139628;8243;10075;286430;653220;8242;474343;29978;11279;28986;212;23133;54328;158584;203569;81557;27301;54954;65267;2245;90737;653067;90121;389860;158787;10325;54466;728239;347365;5207;169981;6757;170626;494197;29057,54,0.82510457054453100000
chr10,102964512,103392503,427991,1,1,27343;8945;6468;10660;25911,5,1.16824886504623000000
chr7,129647119,139669026,10021907,1,1,136319;114960;767558;154790;57016;50617;29062;9162;64764;8805;1357;647087;84928;346673;57670;800;389558;79989;51631;154791;56829;93979;136259;6916;1358;28996;5764;54927;136263;1129;23165;23008;340351;6718;84912;254048;346689;100130880;92092;441282;4850;26266;669;78996;231;4289;26958;136306;100996928;4232;51530;136332;155006;55281;95681;5420;91584;51200;60412,59,0.58871031231880300000
chrX,48286796,52693963,4407167,1,1,729442;64743;9500;389856;170685;139189;392465;778;5935;729431;9502;26748;10013;55190;653220;50943;340602;27344;28952;729447;85417;100132399;7030;729428;2623;729422;89801;4943;56850;79917;2574;9506;64840;10682;3266;8712;729408;81557;100008586;57477;280658;90060;24140;92745;4007;6839;3750;1184;7454;27238;645073;645037;10245;645051;2543;653067;7355;11152;10084;5355;55593;8852;23708;728239;11040;6855;11230;9210;729396,69,1.56563161777169000000
chr3,1023906,1558564,534658,1,1,27255,1,0.18703545069932600000
chr1,142811256,149786826,6975570,1,1,9557;148738;128077;84265;9659;10628;2330;653519;554282;5174;388677;200035;51205;284615;645142;5565;2209;148741;730262;653598;10623;653604;728833;100132406;644634;9939;728945;27246;284565;11126;400818;440689;8799;388692;149013;10401;644591;8515;51463;607;2702;200030;2703,43,0.61643707969384600000
chr16,29673954,30198600,524646,1,1,653808;5531;26470;283897;253980;146378;8479;83719;23475;283899;124446;9344;3835;4150;226;253982;83723;5595;6911;11151;8448;79447;112476;9961;10423;6693;79153,27,5.14632723779463000000
chr22,18895227,21460220,2564993,1,1,54487;27037;9342;29801;65078;10587;1312;6545;8214;421;7290;2812;6899;5625;7625;79680;64976;6576;3053;8218;5413;80764;23617;400891;1399;7122;150209;128977;8220;388849;84861;7353;51586;2928;128989;5297;9127;9993;54584;91179;85376;8216;85359;8318;728229;5902,46,1.79337721389493000000
chr20,57820838,62893189,5072351,1,1,3785;198437;2832;10388;85441;116154;140685;79025;6874;6725;84619;63910;128611;55738;60437;51750;284739;54915;11255;63939;80331;57473;24148;10732;284756;1917;128408;26164;54345;6919;10139;9885;11047;1299;11054;1002;1137;140700;10287;100132911;28231;4987;149986;26039;11083;8771;4923;55251;54994;128414;57642;50861;140701;3911;1908;5753;55257;5688;6227;7165;5509;128826;140893;26205;79444;140628;56731;54963;4661;79144;54923;81928,72,1.41946012805502000000
chr17,14336884,15442066,1105182,1,1,64518;201158;284040;100533496;5376,5,0.45241417250733400000
chr1,144927778,149224043,4296265,1,1,9557;148738;128077;84265;9659;10628;2330;653519;5174;388677;200035;51205;284615;645142;5565;148741;730262;10623;100132406;9939;728945;27246;284565;11126;8799;149013;10401;644591;8515;51463;607;2702;200030;2703,34,0.79138507517576300000
chr5,19204238,20893454,1689216,1,1,1016,1,0.05919906039251350000
chr4,1660785,2233647,572862,1,1,7469;7884;401115;3954;7468;152877;92305;353497;10460;2261;79441;339983,12,2.09474533133634000000
chr4,2571825,3759039,1187214,1,1,4043;118;8602;6452;79155;285489;3064;3083;345222;2868;6002;10227;8603,13,1.09500056434644000000
chr8,8100384,11860569,3760185,1,1,1508;83650;83595;203076;2626;83648;613210;137075;613209;157285;640;66036;252969;286046;79660;2222;54984;613211;4482;8658;203074;9258;90459;94137,24,0.63826646827217300000
chr17,34817422,36168104,1350682,1,1,26574;284099;9326;284098;11072;6928;79154;79922;3975;11276;79893;11056;6871;31;80179,15,1.11055007766447000000
chr17,14111772,15442066,1330294,1,1,1352;64518;9953;201158;284040;100533496;5376;146822,8,0.60137082479512000000
chr3,195740357,197310451,1570094,1,1,622;255798;80235;200933;5062;5130;4241;26043;1739;84984;348793;255758;116211;131540;200931;375387;22916;7037;165918;54965;205564,21,1.33749953824421000000
chr16,15579295,16249607,670312,1,1,4363;54820;4629;123811;89927;368;9665,7,1.04428982324649000000
chr1,144612681,149091159,4478478,1,1,9557;148738;128077;84265;9659;10628;2330;653519;5174;388677;200035;51205;284615;645142;5565;148741;730262;10623;100132406;9939;728945;27246;284565;11126;400818;8799;149013;10401;644591;8515;51463;607;2702;200030;2703,35,0.78151550593750800000
chr22,23720181,25066484,1346303,1,1,4320;3543;7621;2952;66035;388886;391322;400916;150248;266747;51733;2678;653689;4282;83606;23384;135;51233;6598;1652;29802;56241;100037417;2687;23523;6634;91319,27,2.00549207719213000000
chr5,6801589,18992827,12191238,1,1,54463;10299;9037;7204;50834;134145;4651;651746;83853;134147;1501;56172;4552;54491;22948;23194;1767;79072;108;441061;90268;10409;134121;90441;1611,25,0.20506531002019600000
chrX,151356116,155233731,3877615,1,1,3581;8263;1193;492;9130;2157;50814;2556;3054;7411;10134;139728;8517;30848;554;6901;474383;92002;4105;57595;8266;266740;6845;29944;84968;2539;246100;7739;8260;55559;4204;100272147;65991;5365;8277;26576;4354;474382;10838;139735;2316;8273;6535;114824;11219;393;10251;55558;139716;1736;55217;8270;3654;537;3421;5973;100132963;1852;3897;4101;215;6748;474384;4100;55879;2010;474381;6134;1069;116442;2652;1485;1774;60343;728458;8269;83740;5956;2664;633;79184;4515,82,2.11470194952310000000
chr17,68849745,80829397,11979652,1,1,6169;10801;350383;84923;339231;283987;7077;26502;124602;283985;91107;439921;124512;147111;2905;83882;29115;57674;201292;60386;201294;332;55036;8811;2642;57332;100131439;57521;284184;10966;51181;64978;57597;79637;9144;57513;6182;51081;79643;100130370;79415;388419;94015;8632;5148;23510;284129;125058;2584;4097;8877;9775;80022;6662;6397;100134934;3607;283991;9121;124583;9123;8535;64118;114804;283999;284004;55808;25794;23580;51547;1468;400629;79092;9400;5881;5034;92736;124565;146723;326624;201254;5986;5635;10458;79902;23163;768206;2873;284186;201266;2302;201255;51529;55666;64122;9772;9489;339221;125061;11322;124590;64772;6448;255275;9625;10189;100130520;84733;55890;342510;55028;3021;85451;100134391;146664;79058;347741;23265;6904;30850;57409;9021;2194;6613;15;100141515;80233;339230;10476;57690;51;9146;146713;9267;100130933;114897;2548;79157;3959;10610;5831;9368;6752;116729;9382;284001;5833;2125;6427;1018;4884;85302;30833;56270;924;71;124599;84074;64446;3691;3993;23210;54868;2885;353174;11314;63893;79755;339229;22994;10871;283989;146722;3396;57602;54549;396;2232;6730;79651;256933;1453;147138;114757;51155;284131;348262;79701;643008;7083;6398;642843;23558;26151;79672;146705;2837;100653515,198,1.65280260227927000000
chr7,122739692,136150625,13410933,1,1,25913;168850;29923;57016;3614;3952;647087;84928;9296;55798;84691;4698;100130705;27044;54927;136263;23165;6677;8976;84912;154865;381;29999;441282;26266;7328;669;231;142685;5078;26958;64753;2861;813;23553;730130;4899;4232;51530;136332;55281;340348;442721;5420;91584;136319;114960;767558;2918;29062;6561;375616;1357;346673;800;389558;401399;93979;57464;136259;1358;55131;100287482;23008;340351;2318;4850;6608;78996;23534;4289;611;154872;64101;79571;23382;346653;95681;51200;60412;3663,81,0.60398482342727400000
chr19,260911,6074347,5813436,1,1,566;126259;6294;51298;400668;374291;55111;80032;1943;58492;5605;100131094;51343;8612;26528;8175;56931;55620;55643;1153;2527;84839;116444;148252;4782;23396;1991;113179;4946;22904;9667;8698;83475;4616;56961;5064;374872;79948;23526;513;729359;23217;51690;2525;26517;6449;84939;148022;29128;828;610;126567;56926;1265;163154;997;56928;9546;10226;3004;125988;374875;10297;126295;25873;54531;116541;9361;91300;84634;92840;8943;79187;56005;51548;10272;4902;27134;8174;170961;6455;55527;255057;10975;84699;1455;115196;148066;27231;2872;55702;85300;58509;126326;60680;6915;126328;126306;54760;645191;6929;400673;10347;80700;55009;10036;5657;148223;91039;57455;166;84954;5802;91978;6209;399664;126308;257062;2767;1938;284451;10501;339366;100128569;81926;2788;27006;645432;148229;84717;148254;5990;10025;2879;83855;51341;4145;126321;126520;1613;91304;53615;113178;10362;84444;79816;2769;23030;8498;55658;360200;440503;1820;25759;84823;116844;1675;90007;390874;6794;682;29985;7089;57418;2593;284422;268;126282;5442;126353;5434;7064;113177;10148;5725;2528;51588,177,3.04467100007637000000
chr2,121388698,131170793,9782095,1,1,728378;29842;5433;56886;84084;2995;101929926;5624;92856;10746;55627;84826;2736;274;112714;129684;9394;80097;91409;55339;84365;4648;55679;339761;2071;7247;2840;84317;26469;79595;23332;83607;55677,33,0.33735104801169900000
chr11,123061964,123062024,60,1,1,79827,1,1666.66666666667000000000
chr10,148206,5250204,5101998,1,1,105;1109;10531;22884;10771;5214;83592;23560;91734;23185;8644;22982;1316;1646;3422;1645,16,0.31360263175328600000
chr10,93510,8644352,8550842,1,1,22884;3698;83592;23560;91734;23185;3559;2625;8644;1316;114131;51806;54522;84893;80760;810;10276;105;1109;83860;10531;5214;10771;57713;79754;5209;3601;509;79861;5588;84991;54906;22944;22982;347688;1646;2665;3422;1645,39,0.45609543481215100000
chr7,122739692,136150625,13410933,1,1,25913;168850;29923;57016;3614;3952;647087;84928;9296;55798;84691;4698;100130705;27044;54927;136263;23165;6677;8976;84912;154865;381;29999;441282;26266;7328;669;231;142685;5078;26958;64753;2861;813;23553;730130;4899;4232;51530;136332;55281;340348;442721;5420;91584;136319;114960;767558;2918;29062;6561;375616;1357;346673;800;389558;401399;93979;57464;136259;1358;55131;100287482;23008;340351;2318;4850;6608;78996;23534;4289;611;154872;64101;79571;23382;346653;95681;51200;60412;3663,81,0.60398482342727400000
chr7,43376,9454786,9411410,1,1,30010;3382;9907;79034;9265;84629;155185;2852;55146;221937;55698;3955;100533952;55501;54905;27102;51608;392617;5395;54476;5879;84310;221955;29886;5154;221935;23288;90639;84262;4521;113263;654231;56975;79778;84433;51622;57786;729852;8662;8379;54753;202915;6119;29960;7559;221938;222967;7965;221960;392862;402635;222962;80028;56913;100131017;80727;60;90637;84132;2768;54468;54919;56903;115330;11033;23353;26173;221927;100310846;5575;340260;728194;6624;26100;7975;84792;340267;11014,78,0.82878123469278300000
chr10,208454,7075724,6867270,1,1,105;1109;10531;22884;10771;5214;79754;5209;3601;79861;83592;5588;23560;91734;23185;3559;84991;8644;54906;22982;1316;114131;51806;54522;84893;1646;2665;3422;1645;810;10276,31,0.45141664737224500000
chr19,260911,2328485,2067574,1,1,566;51298;400668;374291;55111;1943;126306;54760;8612;26528;6929;645191;8175;55643;1153;10347;55009;116444;5657;148223;1991;57455;91978;6209;399664;126308;113179;4946;22904;284451;339366;81926;5064;374872;27006;79948;23526;513;148229;51690;10025;84939;2879;610;83855;126567;1265;126520;91304;997;53615;113178;3004;84444;10297;54531;91300;84634;92840;8943;55658;10272;1820;25759;1675;90007;390874;6794;682;8174;255057;10975;57418;2593;1455;268;5442;126353;5434;2872;113177;5725,82,3.96600073322648000000
chr1,146496425,147814693,1318268,1,1,9557;51205;51463;5565;607;2702;2330;200030;2703,9,0.68271398532013200000
chr3,178907147,197851986,18944839,1,1,80235;200933;55324;5290;1857;5062;5984;5648;55341;9370;6750;8626;285386;54165;170572;54965;2814;6657;26998;89782;23101;604;131578;57129;152137;2119;9711;205564;27074;51555;1173;79929;131583;197;51193;105374250;200909;84239;1608;339829;151963;5130;64110;132112;5437;22916;59345;23200;165918;10686;84859;285382;255798;1427;1370;152138;27094;10188;151613;4241;347;1739;84984;4711;8975;344892;5504;200958;10195;1974;8893;622;1181;3556;255758;116211;93109;152002;110599564;55486;200931;131408;344901;7037;90407;9076;285242;6480;131920;84248;3273;55214;55669;86;26043;10644;116832;23355;4976;348793;8646;5708;1962;3280;84002;84223;7066;9175;200879;55171;110599583;57110;94032;59343;6165;55689;8087;131540;10057;375387;9718;23527;56922;89857;90113;131118;2049;3827;79572;51726;1981;344905;54800;647309;64108;4026;6434;2257;4585;257313,140,0.73898754167295900000
chr12,126502344,128679278,2176934,1,1,,0,0.00000000000000000000
chr17,16612123,20449811,3837688,1,1,2314;9720;55244;125170;55090;11216;79018;79999;284194;645027;10400;54890;254272;9706;92521;8533;22905;729288;100996259;5598;218;23164;83450;224;51168;80039;51655;201163;7156;51030;5636;644815;10750;10517;654346;10743;388436;27077;100129396;140775;6470;146691;1819;6720;125206;23495;147166;7732;146802;91647;56953;201164;400581;3996;4239,55,1.43315454513238000000
chr15,20175623,30369914,10194291,1,1,321;7681;2562;727832;100996331;123606;4948;57194;283694;81614;100287399;390538;2558;23359;7082;8924;114791;23742;7337;6638;2567;8926;283685;653720;54551;4692;23191;283767;56160,29,0.28447294667181900000
chr1,100652530,121322377,20669847,1,1,277;200162;4893;6814;148545;7252;11085;2949;10717;81839;3744;276;3158;79961;4808;254268;128344;126868;653820;127002;8556;26227;1629;127003;80143;55170;5738;284611;113802;79574;7482;5016;284467;3283;84432;343505;57535;343263;4853;388662;10542;54112;148867;1952;845;9122;163259;6301;79084;3321;84722;2948;54879;284612;85369;5906;55119;55791;29957;6272;2780;5686;3752;6913;2135;6566;54855;279;1435;54834;57463;3749;9398;29899;284613;9860;1117;83998;10885;829;101928436;22854;23155;10286;1901;148281;440603;27159;8634;10352;963;271;51592;333926;2210;914;7412;8458;11218;6884;2773;2946;10768;10100;3737;128346;54665;163479;51611;653464;83873;79679;260425;140;515;278;128338;280;64783;64858;3738;653149;270;476;4803;55924;118427;26191;7812;4343;80263;57413;22911;6847;2947;10451;164153;3284;56900;55599;204851;51179;56944;2944;1301;90874;389;55917;257;965;55356;10745;10390;10905,154,0.74504663725861200000
chr12,46168214,46332497,164283,1,1,196528;9169,2,1.21741141810169000000
chr17,73609139,80789628,7180489,1,1,10801;339231;7077;26502;91107;439921;124512;147111;83882;29115;57674;201292;201294;332;55036;8811;2642;57332;284184;57521;10966;51181;64978;57597;9144;6182;79643;100130370;79415;8632;5148;284129;125058;2584;4097;8877;9775;80022;6397;100134934;3607;283991;124583;9123;8535;64118;114804;283999;284004;55808;25794;51547;1468;400629;79092;9400;5881;5034;124565;201254;5986;5635;10458;2873;768206;284186;2302;201255;51529;55666;64122;339221;9489;125061;11322;64772;6448;255275;9625;10189;84733;3021;85451;146664;79058;23265;6904;9021;2194;15;100141515;80233;339230;57690;51;9146;146713;9267;100130933;114897;2548;79157;3959;10610;5831;116729;284001;5833;2125;6427;1018;4884;85302;56270;924;71;84074;3691;23210;353174;63893;79755;339229;22994;57602;396;6730;79651;256933;1453;147138;114757;284131;348262;79701;643008;7083;6398;23558;79672;146705;2837;100653515,143,1.99150782070692000000
chrX,19825290,20930431,1105141,1,1,30011;256714;6197;1964;256643,5,0.45243095677384100000
chr10,81641918,88847443,7205525,1,1,657;27069;84332;23063;81619;5995;387694;79812;2746;119385;80195;10718;643161;26103;4143;387695;219348;6623;143241;92211;6441;54462;94233;2894;84293;340745;10974;11155;311,29,0.40246893876573900000
chr9,46587,23753106,23706519,1,1,58524;10171;23081;55664;50808;3439;158358;401494;203238;23189;5789;54796;286343;55667;158326;55064;1993;29126;2315;5991;6456;340481;26953;3441;3717;90865;123;3444;63951;3449;157983;3641;7306;158219;403313;169522;1030;6595;3467;79956;55958;3443;2731;92949;3445;1029;4300;10670;89882;9350;4507;54914;340485;2298;3442;6619;81704;3452;158297;3440;6194;6019;3446;1761;169792;6505;54801;4781;3447;100129385;11168;8777;3451;7436;90871;3448;54875;6013;25769;338376;57589;55871;115426;3456;9933;55848;11172;10655;80380,89,0.37542416075510700000
chrX,52954520,53742476,787956,1,1,23096;158787;8243;64061;10075;8242;3028;54328;29057,9,1.14219575712349000000
chr16,29652999,30198600,545601,1,1,653808;5531;26470;283897;253980;146378;8479;83719;23475;283899;124446;9344;3835;4150;226;253982;83723;5595;6911;11151;8448;79447;112476;9961;10423;6693;79153,27,4.94867128176085000000
chr22,39481187,51169045,11687858,1,1,150383;91582;115650;2033;55267;25813;6942;79174;27352;10478;4668;415116;83642;158;6767;23542;9978;84271;164684;83933;91689;1565;79924;27351;84844;4809;84247;440829;6305;150350;51512;1890;25830;23654;25817;9402;91289;26286;113828;5905;5155;26150;171568;7008;85358;400935;23492;2192;80274;6721;54471;758;150368;1120;440836;4700;5465;150372;50;63929;253190;64098;79087;55020;638;85352;55586;11252;9145;85378;79879;468;25771;79019;23151;23774;80305;10766;1727;79640;150379;55007;1375;55964;164668;553158;7380;6300;10343;83746;23313;2547;53947;23264;27254;29781;5372;2847;64800;27341;410;4248;706;9701;56666;5600;27127;60489;150356;9889;414918;25809;8911;10454;9997;9620;267020;150365;64781;112885;29780;644186;23170;150353;23779;23209;7477;25814;80339;10762;27349;55687;6122;348645;57591;55615;113730;23112;54456,139,1.18926838433526000000
chr1,146476525,147825661,1349136,1,1,9557;51205;51463;5565;607;2702;2330;200030;2703,9,0.66709360657487500000
chr19,12740112,14627238,1887126,1,1,5989;773;117579;9592;342977;10661;976;439;4125;51398;84292;90379;90378;55621;2193;1777;811;9466;55723;84245;256126;22983;7001;84261;10535;65249;4066;90480;5585;81576;8677;5566;1725;5886;4784;3337;10212;199699;113230;10755;83546;5731;646457;105372280;79883;3726;112939;54831;28974;342979;29911;30000;2639;22859;79173;163049;79002;54862,58,3.07345667432911000000
chr18,12842,15122502,15109660,1,1,116;23255;57132;8774;645369;125228;57045;103910;642597;84617;9097;7525;10650;3613;56984;65258;79822;84034;4729;23253;9663;9989;339291;9984;10928;162655;63895;201475;64863;342850;27098;646000;753;7541;55125;55556;10403;4158;84203;388468;147495;9218;5797;494514;1149;5771;10939;1068;79959;9229;7298;91133;11031;56907;7050;81929;4161;81035;2774;23347;10627;8731;8736;374860;284217;23136,66,0.43680665216821600000
chr13,19305324,34838259,15532935,1,1,51084;3146;2322;241;646799;6541;122042;10804;9107;2254;51082;387914;2706;51761;5412;6049;221154;9818;675;90634;26524;8100;219333;253832;93492;10284;4285;5983;64328;55504;56163;90627;222484;221143;283537;542767;51371;54737;6445;221178;78988;53342;219402;219409;10208;84935;10443;2971;84056;10129;23047;221150;479;2700;219287;387911;3651;145173;1045;255967;55835;143;338872;55269;7278;1024;26278;2835;10810;7750;646625;9205;23281;10808;5042;122046;2321;6144;9365;387496,80,0.51503466666151600000
chrX,154120378,154560375,439997,1,1,7411;1193;2157;79184;100272147;116442;65991;4515,8,1.81819421496056000000
chr14,97910619,107278770,9368151,1,1,23241;23186;283643;91828;9578;400258;207;388015;9112;317762;283600;81693;4140;1396;3831;51550;84334;2972;256281;1397;84193;7517;79446;91833;90135;79038;9556;115708;7453;26153;7127;55778;51466;1735;64919;647286;10858;5527;9529;5891;55038;8788;107984640;122402;3714;10572;283598;283638;1983;100128927;7187;9895;1152;7528;122618;80757;1778;374569;388021;113146;647310;3320;2009;123099;122616;84439;64423;57596;23368;123096;122622;29933;8812;122416,74,0.78991041028266900000
chr5,171445557,180712263,9266706,1,1,2916;2324;285679;51428;51491;30832;91522;101928093;92181;9260;51121;345462;53917;23138;3182;9945;3187;375484;3274;646019;81786;285590;54825;84321;90249;57179;26262;9794;79908;3101;80758;662;54732;345456;6940;91272;10399;821;57222;2870;55819;285676;4488;1627;10814;285659;2161;253314;6793;54492;117608;6620;202134;6569;134083;51149;10636;153579;10917;23061;27166;285596;1212;9509;1482;23197;51617;84851;57472;80108;10960;643836;64777;51720;1812;90933;8614;133491;255426;11285;26693;23567;54540;2264;11282;79930;285588;1843;80315;192286;285598;85007;4245;5626;92304;5601;94081;8992;4056;55651;114787;8878;57396;83463;64324;80230;153222;22838,108,1.16546267897136000000
chr7,65558,6870943,6805385,1,1,9907;79034;9265;84629;155185;2852;55146;221937;55698;3955;100533952;55501;54905;27102;51608;392617;5395;54476;5879;84310;221955;29886;5154;221935;23288;90639;84262;4521;654231;56975;79778;84433;51622;57786;8662;8379;54753;202915;29960;7559;221938;222967;7965;221960;392862;402635;222962;80028;100131017;80727;60;90637;84132;2768;54919;56903;115330;11033;23353;26173;221927;100310846;5575;340260;728194;6624;26100;7975;84792;11014,70,1.02859720647693000000
chr22,18397063,40859134,22462071,1,1,23481;200315;3005;24144;129049;7533;91582;100423062;4733;2130;400916;7078;80831;55670;64976;6576;3985;11144;6634;8218;29775;23753;158;57168;550631;23598;8542;7621;5297;440822;2928;129080;140883;150350;8318;57026;728229;113828;5155;4320;4627;23543;3957;23764;51493;9681;150223;653689;4282;11274;23539;80830;23762;9929;25793;25829;27350;2781;162;253143;84861;7353;51807;8398;8508;51733;11015;9993;85376;440804;4151;5816;5880;91319;7332;85379;284898;150274;9342;65078;80833;1417;150275;1312;6545;468;129025;129138;8459;83999;8484;56993;1415;164668;105372977;5413;80764;22880;7441;102800317;66035;150209;128977;128989;113791;79734;150221;91179;3560;83606;8664;56241;5008;10042;5988;57553;27037;4330;23466;51386;1454;652968;254240;284904;7263;26088;60489;84645;645426;79680;23760;10454;9609;11020;10634;400891;84700;9514;388849;51586;9127;83874;9814;57591;135;6598;23551;10291;25777;10126;1413;23616;613;391322;23541;114904;4357;91227;402055;6948;51537;25776;27352;2687;164592;730005;200312;5594;646851;23617;25807;3543;6527;3976;2952;7122;8563;4744;54584;2678;6523;1652;9402;23523;6525;140606;79159;23492;6753;8897;10587;80832;1439;7290;150280;54471;2812;150248;23759;9647;5625;55954;85377;10521;23331;3053;150290;164656;4689;255349;8224;80020;1399;4174;29796;3956;3761;11200;266747;7494;10738;85359;164633;10369;10633;9215;80115;23761;5902;23544;9145;27128;23780;8214;421;10739;4242;157;7625;23119;29802;23464;91464;50487;23467;84164;114794;11135;9463;10043;8940;11078;23384;27124;1414;388886;89781;25775;54487;29801;4248;9567;91445;23532;150297;6663;29799;91355;6899;140564;27156;8911;3162;25770;100037417;200316;339665;339669;266629;8220;56478;25828;4771;84133;6122;8216;51233;9582;23112;5435,290,1.29106528066802000000
chr16,29652999,30198600,545601,1,1,653808;5531;26470;283897;253980;146378;8479;83719;23475;283899;124446;9344;3835;4150;226;253982;83723;5595;6911;11151;8448;79447;112476;9961;10423;6693;79153,27,4.94867128176085000000
chr17,14111772,15442066,1330294,1,1,1352;64518;9953;201158;284040;100533496;5376;146822,8,0.60137082479512000000
chr17,14111972,15442178,1330206,1,1,1352;64518;9953;201158;284040;100533496;5376;146822,8,0.60141060858243000000
chr17,14111972,15442178,1330206,1,1,1352;64518;9953;201158;284040;100533496;5376;146822,8,0.60141060858243000000
chr15,91952756,102399819,10447063,1,1,145814;390649;145946;123355;204219;80213;79705;390648;56963;3480;145748;400451;220;145858;283777;8128;23336;22856;28232;91947;55784;4205;55829;1106;55180;5046;7026;170691;100128108;64927;140460;6627;123283,33,0.31587825209822100000
chr2,109298362,110783280,1484918,1,1,5903;96626;10913;3987;344558;65124;84220;151011;165055,9,0.60609407388152100000
chr2,133924914,138650318,4725404,1,1,4249;344148;4175;80731;84083;23518;1615;7852;905;22930;23190;130013;81615;3938;80122,15,0.31743317608399200000
chr1,83288652,84890437,1601785,1,1,79739;5567;58511;148418,4,0.24972140455804000000
chr17,51885,1879066,1827181,1,1,10594;51031;50628;29928;286753;124935;727910;5345;29;400566;8578;359845;55178;4641;146760;55275;114826;83547;124997;5176;100506388;1398;79850;7531;5306;727857;9501;64359;6117;51763,30,1.64187346519037000000
chr17,34850785,36248926,1398141,1,1,26574;9326;6928;3975;79893;31;80179;284098;11072;79154;79922;11276;11056;6871;284099,15,1.07285316716983000000
chrX,123056066,123598237,542171,1,1,10735;4068;10178,3,0.55333096015832600000
chrX,154118619,154560375,441756,1,1,7411;1193;2157;79184;100272147;116442;65991;4515,8,1.81095446355001000000
chr3,122505298,130329337,7824039,1,1,2624;23129;200810;22820;28999;8971;84925;54763;166348;57461;131601;26984;114885;56941;54437;56667;7707;6184;8997;80325;165721;79825;79663;6010;11343;339122;8723;10840;8930;166012;644974;3693;64770;79364;4638;7200;348807;10954;114112;23023;131669;152015;7555;100534599;4171;28976;57493;29927;256076;55764;131873;5361;90288;285311;84561;60678;7879;84303;111;645840;201562;2815;57501;50512;54946;8607;132243;152065;7372,69,0.88189744452960900000
chr1,146516199,147828939,1312740,1,1,9557;51205;51463;5565;607;2702;2330;200030;2703,9,0.68558892088303800000
chr8,141344339,141459875,115536,1,1,83696,1,0.86553108987674800000
chr15,22652060,28780204,6128144,1,1,2562;7681;123606;4948;57194;81614;2558;8924;114791;23742;7337;6638;2567;8926;283685;54551;4692;23191;283767,19,0.31004493366996600000
chr9,133931621,141089296,7157675,1,1,29952;10422;9328;54863;84960;360203;2889;138151;57109;3933;158067;728489;83543;389799;286257;8636;2220;441478;84628;56654;89958;27158;643596;11253;9919;11094;389812;1056;401563;6838;389813;157922;51116;6836;54461;8022;83549;6256;6621;375775;10585;9022;84814;8721;8021;8328;56623;84726;7248;9719;9858;2219;20;29989;138307;401562;6837;23203;91373;727800;142680;92714;10807;10555;85014;64975;29991;64794;774;6834;158062;64170;158055;9329;26012;286336;7186;7270;286262;2902;11092;2529;441476;29882;401565;94107;414332;4851;100505993;28;389827;169714;286256;157927;169436;10319;7410;954;6835;11091;10811;1621;25920;23064;5900;51162;733;138311;29085;8019;9442;1289;389816;90120;377841;79813;55684;5047;10439;92715;158056;10383;26301;1757;26086;11182;57582;56751;116225;11093;392399;402381;6130;375791;54932;5730;642968;138162,138,1.92800036324645000000
chr17,34819191,36223325,1404134,1,1,26574;284099;9326;284098;11072;6928;79154;79922;3975;11276;79893;11056;6871;31;80179,15,1.06827411059058000000
chr7,72384160,74338984,1954824,1,1,5982;84163;378108;51085;9275;84277;7462;55695;135886;653361;9883;83451;1364;135892;6804;7461;155382;3984;26608;8468;9031;155368;2969;8326;7458;9569;2006;1365;114049,29,1.48350951287686000000
chrX,153576890,153832724,255834,1,1,55558;2539;1774;246100;8270;9130;537;60343;2010;8517;2664;6134;2316;8273;6901;8266,16,6.25405536402511000000
chr10,102937122,103419622,482500,1,1,27343;8945;6468;10660;25911,5,1.03626943005181000000
chr16,29647342,30174926,527584,1,1,653808;5531;26470;283897;253980;146378;8479;83719;23475;283899;124446;9344;3835;4150;226;253982;83723;5595;6911;8448;79447;112476;9961;10423;6693;79153,26,4.92812518954328000000
chr10,148325,24786291,24637966,1,1,5305;221079;22884;22929;3698;57118;256297;221060;22921;8516;1787;219681;114131;51806;54522;648;11164;783;55691;9200;8029;10659;105;55301;10531;10529;10771;57713;5214;221044;79861;222389;9712;84991;54906;399726;9397;84898;8872;6251;414149;9576;55388;83643;3422;338596;10133;64215;653567;387638;56243;83592;23560;91734;2625;79746;79723;8644;3559;23185;1316;221061;26019;84893;80760;80013;55176;810;23412;10276;254427;389941;256815;387640;7431;51182;340895;221074;1109;10557;83860;221078;509;79754;5209;3601;220213;644890;441549;5588;100532731;22944;8027;5264;22982;8559;4360;55526;9317;83641;1646;8028;2665;340900;1645;64421,106,0.43023032014899300000
chr9,131585873,141044489,9458616,1,1,29952;10422;9328;54863;84960;360203;2889;138151;57109;3933;158067;728489;83543;389799;286257;8636;2220;441478;84628;56654;89958;27158;643596;389792;56262;11253;56904;11094;9919;389812;1056;401563;22845;140459;6838;389813;25;157922;51116;6836;54461;51450;8022;83549;6256;6621;375775;10585;9022;27348;84929;84814;8721;8021;8328;56623;84726;7248;9719;9858;2219;256158;29989;138307;20;138162;375759;401562;6837;84895;1384;23203;91373;727800;142680;92714;347148;10807;51759;28989;10555;85014;64975;10868;29991;64794;57171;774;6834;158062;64170;158055;9329;26012;286336;7186;7270;286262;2902;11092;2529;441476;29882;401565;94107;23048;51490;5524;414332;23511;4851;28;389827;100505993;883;169714;286256;157927;59335;169436;10319;57720;7410;954;6835;11091;10811;8939;1621;25920;23064;254295;5900;51162;733;138311;29085;8019;9442;23413;1289;389816;90120;377841;79813;55684;5047;10439;92715;158056;10383;26301;1757;26086;445;11182;57582;56751;1861;116225;23404;11093;392399;402381;6130;375791;54932;5730;642968;9536,170,1.79730311495889000000
chr7,72726578,74139390,1412812,1,1,5982;51085;9275;84277;7462;135886;83451;1364;135892;6804;7461;155382;3984;26608;8468;9031;155368;2969;8326;7458;9569;2006;1365;114049,24,1.69873981817821000000
chrX,152916694,153595528,678834,1,1,3654;8260;3421;5973;1852;3897;4204;3054;215;6748;10134;5365;139728;8277;26576;728458;8269;5956;2316;554;6535;57595;393;2652,24,3.53547406287841000000
chr17,63455613,66878808,3423195,1,1,55062;786;5718;26207;8313;5578;27091;5573;22901;201134;9931;9120;3838;25926;284018;10351;54757;2186;27092;51321;350,21,0.61346198507534600000
chr7,72299151,74139390,1840239,1,1,5982;378108;51085;9275;84277;7462;55695;135886;83451;9883;1364;135892;6804;7461;155382;3984;26608;8468;9031;155368;2969;8326;7458;9569;2006;1365;114049,27,1.46720072773156000000
chr12,130743650,133770975,3027325,1,1,6433;192111;100289635;5426;5827;57634;100507055;7574;101060200;10795;2802;7637;22953;7699;283383;55743;5901;9271;23504;4326;8408;80324;317781;2054;79050;7556;23141;50614;57666,29,0.95794141692748600000
chr15,22698522,47028952,24330430,1,1,23582;548596;4058;57099;113189;9836;1159;6638;4236;64397;55505;161725;54866;283685;653720;54893;567;283767;90416;728498;2562;9824;84978;6692;4948;117155;100505573;6652;84529;23005;653125;90427;701;51103;2567;8773;197135;9716;57369;728047;55177;7681;2595;7158;255189;256646;3712;123606;79094;5888;2644;23269;23359;25764;57519;51203;171177;140691;400359;6263;644844;643338;11339;55142;1133;51234;23191;26015;100137049;55192;10125;7301;5330;26258;79768;57082;161835;4308;10169;58472;7082;2038;8924;23742;51621;116179;89832;56851;619189;6447;90527;440275;80208;3706;23015;11245;161497;27079;8669;643699;146059;145645;54617;25963;4130;161829;9990;27229;9153;22909;11261;8926;825;283710;113201;6727;100131244;106821730;255252;79968;70;54567;56924;90525;7057;161779;145942;2558;23168;2628;114791;22893;8681;80237;161823;9677;653073;54989;54551;56160;50506;51496;90417;100137047;7782;321;440270;85455;57617;283748;146050;51332;254531;4212;79029;388115;197131;342184;89839;4692;80021;53905;123745;101059918;23339;89978;57194;161742;81614;146057;2923;84419;283742;1139;30844;84936;7337;405753;26585;9333;644809,181,0.74392437782645000000
chr18,11560749,14079519,2518770,1,1,57132;4158;56907;125228;81929;4161;84617;2774;10650;3613;56984;1149;5771;8731;10939;342850;65258;79959;646000;753;55125,21,0.83374027799283000000
chr15,20044342,28616294,8571952,1,1,2562;7681;727832;100996331;123606;4948;57194;283694;81614;100287399;390538;2558;8924;114791;23742;7337;6638;2567;8926;283685;54551;4692;23191;283767,24,0.27998290237742800000
chr15,22765628,29085844,6320216,1,1,2562;7681;123606;4948;57194;81614;2558;8924;114791;23742;7337;6638;2567;8926;283685;653720;54551;4692;23191,19,0.30062263694785100000
chr15,18668297,28441228,9772931,1,1,2562;7681;727832;100996331;123606;4948;57194;283694;81614;100287399;390538;2558;8924;114791;23742;7337;6638;2567;8926;283685;54551;4692;23191;283767,24,0.24557627594014500000
chr15,22669052,28525460,5856408,1,1,2562;7681;123606;4948;57194;81614;2558;8924;114791;23742;7337;6638;2567;8926;283685;54551;4692;23191;283767,19,0.32443094811700300000
chr19,49739516,59092570,9353054,1,1,84798;2204;9437;3276;126129;342931;388566;7710;27338;342933;388561;6237;10782;114823;147807;23547;10155;400720;7137;729767;2359;115653;10859;402665;125893;400713;7376;54776;7138;57343;147687;3904;6795;1;79818;116412;55659;126206;81856;51206;4696;147657;57191;11025;945;9040;29903;255043;23640;29924;25818;100293516;55554;27036;90333;90233;89887;284415;7565;26121;22809;126119;8463;317703;147694;147686;147798;4606;6205;50944;79042;163033;57030;342926;10172;354;91661;84671;100507290;28968;54807;126204;3817;284369;7694;91664;54869;27120;84335;43847;6689;3982;65251;79165;55311;256051;730051;6320;259307;3811;100507003;3748;125919;284366;53635;5518;162963;201514;284297;162966;126133;80199;11027;85569;5653;65982;90317;23636;57333;284312;7691;7576;147685;4818;84446;554235;4849;90338;55663;7728;22870;3802;147949;125875;126208;388558;112703;100529240;3661;51157;946;951;342918;84787;25888;23521;112724;140612;3804;27300;162972;204801;55422;27181;284307;284418;11006;2109;100130827;2217;58506;3589;201516;147650;147658;148170;284417;79735;79143;2357;79891;84258;503835;503834;94030;11284;284370;6158;284371;57663;729974;8778;388567;3812;5424;5655;23619;147744;5178;7554;59284;147808;60385;59283;58491;147945;90353;126017;374928;199713;390980;348327;79149;112401;27180;90321;162967;9668;162962;646862;11202;162968;10990;147645;160;5639;59348;6861;26085;126205;9422;10794;79744;51545;80095;43849;84878;3809;89858;3816;25799;113091;199800;81857;114026;147664;388564;79784;126123;9622;57479;284309;84922;29844;27243;7593;91662;342945;5650;57348;55762;6203;83596;51070;147872;352909;646643;388569;2323;2358;5794;5582;338321;10998;114132;55769;147948;90485;10520;79898;147660;11012;59285;55011;80110;3805;84914;729956;55655;388559;6193;100049587;94059;11338;91663;170958;89790;3036;84436;79788;79763;84765;284361;441864;126014;3903;57106;147670;284306;125965;147646;11024;2854;9476;63934;57573;7693;51231;100271846;55786;317701;93650;79673;100129083;10288,315,3.36788390187847000000
chr10,102955122,103448649,493527,1,1,27343;8945;6468;10660;25911,5,1.01311579710938000000
chr2,185837046,205559897,19722851,1,1,1493;9262;1281;56171;51602;6775;130540;54842;10203;53938;129450;84281;57404;26010;65065;57679;84128;66037;4709;5334;6772;23451;79800;51454;150709;8324;92935;23314;66008;117583;8436;57520;1290;151246;64859;55854;26275;55437;4664;659;29851;4430;9689;130535;2660;3628;165215;3685;3329;130132;23671;116093;940;2744;8837;843;285172;60491;80219;55759;100131211;91526;151112;130026;30061;54529;3336;79568;316;100652824;58538;1195;65062;65061;57181;205327;150864;100529241;65059;151254;64172;10152;9330;80055;841;94101;401027;7341;5378;25843;4999;7035;284992,93,0.47153426246540100000
chr7,72726572,74360689,1634117,1,1,5982;84163;51085;9275;84277;7462;135886;653361;83451;1364;135892;6804;7461;155382;3984;26608;8468;9031;155368;2969;8326;7458;9569;2006;1365;114049,26,1.59107334419751000000
chr8,60487279,79239435,18752156,1,1,54968;54332;23643;157869;10499;253943;767;23678;79848;100129654;7274;137872;9420;157506;2138;100533105;1392;6921;9312;23212;389668;10987;9242;83690;55636;79776;85479;157777;10565;56704;5828;56260;100130301;80124;116328;286183;55284;55156;81796;9650;286187;23213;84675;157807;51050;57094;8836;5862;80243;444;27319;254778;7013;6129;27067;3174;5150;51110;63978;23471;4603;8989,62,0.33062864878043900000
chr9,102365805,102988397,622592,-1,1,8013;23071;27130;55014,4,0.64247532894736800000
chr2,175872504,182492304,6619800,-1,1,3235;129831;344191;150737;3232;3238;51661;57703;3236;4780;3234;151126;494513;518;80856;3237;10651;10477;375298;92104;3239;1386;114880;3233;8540;220988;50940;91404;3231;3676;8575;285025;65977;7273,34,0.51361068310220800000
chr3,71101944,71104403,2459,-1,1,27086,1,40.66693777958520000000
chr15,30384204,32921879,2537675,-1,1,728498;101059918;9824;643699;4308;1139;51621;89832;653125;22909;653073;161725;283710;54893;89839;728047,16,0.63049838927364600000
chr16,21848604,22428364,579760,-1,1,730094;440345;29904;7385;1039;146177;55718;255762,8,1.37988133020560000000
chr17,42920900,42932449,11549,-1,1,9343;51751,2,17.31751666810980000000
chr16,15492317,18112776,2620459,-1,1,4629;123811;64131;89927;4363;54820;408050;255027;101059938;368;9665,11,0.41977378772192200000
chr15,30665145,32921879,2256734,-1,1,728498;101059918;9824;51621;89832;653125;22909;161725;283710;54893;89839;643699;4308;728047;1139,15,0.66467736117770200000
chr4,138380676,143756744,5376068,-1,1,80155;23657;4258;57484;80854;27309;1047;54510;152586;8821;1998;55534;84709;23158;7350;255520;60592;25819;83452;4717;3600,21,0.39062005912127600000
chr6,148736581,151187778,2451197,-1,1,80328;389434;57480;80329;84918;11104;135250;154064;387082;81706;116254;23328;10090;25902;79465;5110;353091;23118;340152;9113;348995;85313,22,0.89752068071232100000
chr1,146155983,147824178,1668195,-1,1,9557;51205;51463;2703;5565;607;2702;2330;200030;149013,10,0.59945030407116700000
chr16,21951379,22380197,428818,-1,1,7385;730094;1039;146177;55718;29904;255762,7,1.63239416255847000000
chr15,30954724,32509932,1555208,-1,1,161725;283710;54893;51621;4308;22909;1139,7,0.45010056532631000000
chr15,30954724,32509932,1555208,-1,1,161725;283710;54893;51621;4308;22909;1139,7,0.45010056532631000000
chr10,81644079,84813142,3169063,-1,1,84332;143241;6441;81619;387694;84293;80195;10718;4143;311;219348,11,0.34710575334097200000
chr3,9724693,9896683,171990,-1,1,64419;26140;10093;8536;285367;4968;10474;7862;151835;100526693,10,5.81429152857724000000
chr3,181384474,182500974,1116500,-1,1,6657,1,0.08956560680698610000
chr14,100397065,101502752,1105687,-1,1,123096;283600;2009;7528;123099;79446;51466;388015;57596;8788;7453,11,0.99485659142234600000
chr22,51142082,51183740,41658,-1,1,49;85358,2,4.80099860771040000000
chr15,22765637,23217513,451876,-1,1,123606;23191;114791;81614,4,0.88519859430463200000
chr22,21759521,22905025,1145504,-1,1,7332;23753;5594;7441;8940;23532;129025;645426;29799;150221;140883;23759;150223;9647;23119;164592,16,1.39676509204682000000
chr15,30892879,32921879,2029000,-1,1,728498;9824;51621;653125;22909;161725;283710;54893;89839;643699;4308;728047;1139,13,0.64070970921636300000
chr4,128899758,129847945,948187,-1,1,55132;132320;79960;10424;80167,5,0.52732214215128400000
chr14,58205713,61299644,3093931,-1,1,112849;64430;51528;317761;387990;23002;64582;51635;5494;145407;4990;5684;51804;51339;6495;26520;4331;729665;6252;9786;341880;55860;5926,23,0.74339085131504200000
chr15,32021733,32510863,489130,-1,1,161725;1139,2,0.40888925234600200000
chr10,53564375,53709954,145579,-1,1,5592,1,0.68691226069694100000
chr15,91084381,95137092,4052711,-1,1,4122;2242;64784;56963;1106;400451;5045;9899;145858;374659;641;91433;8128;26276;9055;28232;55898;55784,18,0.44414714002552900000
chr6,64394528,66536131,2141603,-1,1,441155;346007;23469,3,0.14008198531660600000
chr13,66344469,78046452,11701983,-1,1,7347;115207;22894;4008;1203;23077;1602;440145;57626;26224;730249;79866;11278;729420;170622;5101;688;10464;9882,19,0.16236564349820000000
chr6,62508919,62887222,378303,-1,1,202559,1,0.26433837426613100000
chr1,246428941,246550260,121319,-1,1,64754,1,0.82427319710845000000
chr2,50937444,51382872,445428,-1,1,9378,1,0.22450317447488700000
chr7,110904950,111274663,369713,-1,1,83943,1,0.27048007508526900000
chrX,6451701,8184243,1732542,-1,1,51481;412;8228;26609;8226;51480,6,0.34631195087911300000
chr15,30943903,32438943,1495040,-1,1,161725;283710;54893;51621;4308;22909;1139,7,0.46821489726027400000
chr1,145388355,145833054,444699,-1,1,148738;128077;27246;84265;11126;10628;653519;8799;5174;10401;200035;284615;8515;148741;10623;9939,16,3.59793928027722000000
chr16,49722191,49812039,89848,-1,1,23090,1,1.11299082895557000000
chr2,121379043,123094323,1715280,-1,1,7247;84365;23332;2736;29842,5,0.29149759805979200000
chr22,21798705,24631613,2832908,-1,1,7332;4320;100423062;613;391322;400916;150248;23532;129025;645426;29799;91227;23759;150223;9647;27156;653689;4282;23119;29802;100037417;2687;9609;164592;23753;5594;7441;3543;2781;7621;2952;66035;8940;266747;140883;150221;51233;6598;1652;56241;23523;91319,42,1.48257550192241000000
chr9,71840921,72832013,991092,-1,1,320;9413;9414;256691;375743;138255,6,0.60539283941349500000
chrX,101804551,102097944,293393,-1,1,80823;9737;114928;64860;100528062,5,1.70419880501580000000
chr9,28606661,28745046,138385,-1,1,158038,1,0.72262167142392600000
chr15,30943903,32510863,1566960,-1,1,161725;283710;54893;51621;4308;22909;1139,7,0.44672486853525300000
chr15,30943903,32510863,1566960,-1,1,161725;283710;54893;51621;4308;22909;1139,7,0.44672486853525300000
chr10,133107399,135404523,2297124,-1,1,118472;10844;80313;256536;3632;85442;27287;8433;93426;282973;282974;50632;92170;10570;84504;664;282969;118471;170394;196743;55844;54777;503542;101;1892;1571;84435,27,1.17538278299299000000
chr4,8416549,8607464,190915,-1,1,8532;152992;27201;8310,4,2.09517324463767000000
chr17,29124299,29320671,196372,-1,1,79915;79736;55803;84282;51379,5,2.54618784755464000000
chr7,44944,2361751,2316807,-1,1,392617;79778;90637;84310;54919;29886;115330;8379;5154;202915;90639;84262;29960;23353;4521;2852;26173;5575;340260;54905;7975;11033;51608;56975,24,1.03590847230693000000
chr17,80561130,81029941,468811,-1,1,64122;6904;3607;10966;79672;56270;146712;79755,8,1.70644460134255000000
chr3,3006052,3260941,254889,-1,1,51095;51185;152330;3568,4,1.56931056263707000000
chr16,6754661,7070689,316028,-1,1,54715,1,0.31642765830875700000
chr20,6974518,8575520,1601002,-1,1,56255;23236;54363,3,0.18738265161442600000
chr3,2873996,3067049,193053,-1,1,152330,1,0.51799246838951000000
chr7,69931302,70037666,106364,-1,1,26053,1,0.94016772592230400000
chr1,72207033,72523905,316872,-1,1,257194,1,0.31558484182887700000
chr22,21798705,22963000,1164295,-1,1,7332;23753;5594;7441;8940;23532;129025;645426;29799;150221;140883;23759;150223;9647;23119;164592,16,1.37422216878025000000
chr8,2832422,2966437,134015,-1,1,64478,1,0.74618512853038800000
chr7,111105151,111149166,44015,-1,1,83943,1,2.27195274338294000000
chr6,40564884,44624886,4060002,-1,1,100188893;23304;129685;9436;57510;23113;65989;222642;11131;10591;5754;896;5528;705;2979;221421;55173;4800;4201;116138;107080644;285852;3326;9477;10930;6903;25844;101929726;5190;10817;988;7942;441151;57505;55809;2030;6722;89845;4794;4188;5961;55362;202500;64928;340205;25862;9820;89953;116113;222643;401262;54676;84630;29964;347734;221409;10864;23506;221416;93643;79865;2978;27232;55168;9587;54210;5225;51069;5429;24149;54209;7422;647024;88745;221443;441150;9533;221424;285855;10695;171558,81,1.99507290883108000000
chr20,41961081,45297823,3336742,-1,1,90203;140870;6789;11317;4318;140730;6385;80336;10816;8839;78997;6407;63935;51098;7125;164237;116092;64849;57468;259239;100;128506;57119;10005;149699;60598;27296;10406;26013;90196;10953;140831;128497;958;6590;5266;10955;280664;128486;128488;90204;11065;51604;140902;11142;6431;4605;140832;149708;51006;63925;63916;84969;7529;64405;55713;51526;79183;140686;5476;3787;3172;5360;100526773;6406;90199;259240;140825;8785;57727;57158;55861;391253;10110,74,2.21773214710637000000
chr2,100260926,100898937,638011,-1,1,3899;164832,2,0.31347421909653600000
chr5,23283278,24188509,905231,-1,1,56979,1,0.11046904049905500000
chr1,11688767,11760607,71840,-1,1,10459;26232;93611;26270;374946,5,6.95991091314031000000
chr13,113562990,114297256,734266,-1,1,55002;55795;7027;79774;23263;3916;101928841;2155;2159;55208;113622;8858;8451,13,1.77047554973266000000
chr18,58527052,78014123,19487071,-1,1,125704;54495;28513;147381;89778;1528;55628;201456;79863;400658;8792;8710;25914;644041;5275;84735;4772;9306;9658;5055;4155;28316;54877;81832;5268;27164;440498;57614;89777;10907;1005;26251;5273;80148;23556;23239;92126;9150;10194;596;220158;6317;6318;284273;284293;79839;22850;220441;10666;84552;55748;374868;9525;5271;2531;29090;284274;7776;220164;2587,60,0.30789645093405800000
chr13,29226273,31540272,2313999,-1,1,6541;23281;3146;10208;84935;122046;283537;51371;241;5412;84056,11,0.47536753473100000000
chr7,111105151,111304031,198880,-1,1,83943,1,0.50281576830249400000
chr20,14875711,15041538,165827,-1,1,140733,1,0.60303810597791700000
chr10,47011584,51805020,4793436,-1,1,5599;644168;267004;8031;195977;100652748;642517;57705;474354;170371;118738;653145;5949;644054;414189;100133093;728113;5540;143162;6572;2662;26095;118461;282966;58504;100287932;8505;2658;1103;2074;170370;4477;196740;55753,34,0.70930330560374600000
chr16,21951379,22380197,428818,-1,1,7385;730094;1039;146177;55718;29904;255762,7,1.63239416255847000000
chr1,96530000,107720000,11190000,-1,1,9890;277;54112;148867;101928436;1806;22854;1901;391059;118427;8634;163404;64645;163786;7412;127495;276;178;54873;55599;54482;2135;8556;51611;279;1629;1301;58155;55170;23443;51375;278;280,33,0.29490616621983900000
chr18,136226,4377782,4241556,-1,1,116;55556;10403;9663;103910;7050;9984;9097;7525;81035;23347;10627;494514;64863;1068;8736;27098;9229;84034;7298,20,0.47152507240267500000
chr8,21606704,22986543,1379839,-1,1,23039;10174;55909;8795;64236;80346;55806;541565;79873;9796;649;6440;203190;10361;57805;55124;2675;8794;157310;23221;23516;661;1960;8822;2039;9046;64760;5533,28,2.02922224984219000000
chr16,29673954,30190568,516614,-1,1,653808;5531;26470;283897;253980;146378;8479;83719;23475;283899;124446;9344;3835;4150;226;253982;83723;5595;6911;8448;79447;112476;9961;10423;6693;79153,26,5.03277108247163000000
chr16,14968855,16899676,1930821,-1,1,100288332;23042;101059938;368;123803;9665;4629;123811;89927;4363;9284;54820;23420;408050;255027;54700,16,0.82866304023003700000
chr2,102704398,108579564,5875166,-1,1,8808;9173;64965;2274;8807;653489;11250;5455;285190;84620;9392;130827;84417;79074;3554;8440;8809;80146;6549;84804;389015,21,0.35743670902234900000
chrX,41841241,42721515,880274,-1,1,,0,0.00000000000000000000
chr4,20563947,20620707,56760,-1,1,9353,1,1.76180408738548000000
chr2,50937444,51314430,376986,-1,1,9378,1,0.26526183996222700000
chr8,11036904,11725065,688161,-1,1,1508;83650;66036;640;286046;252969;2222;2626;83648,9,1.30783348664048000000
chr14,103645506,106261806,2616300,-1,1,647286;23241;283643;9529;400258;207;55038;9112;122402;3714;10572;283638;4140;1983;100128927;1396;1152;3831;84334;122618;80757;374569;388021;113146;2972;256281;647310;1397;7517;90135;79038;122616;9556;64423;115708;23368;122622;26153;29933,39,1.49065474142874000000
chr10,68220106,68449231,229125,-1,1,29119,1,0.43644298963447900000
chr15,43851577,43951273,99696,-1,1,117155;9677;161497;1159,4,4.01219707912053000000
chr15,97457409,102465355,5007946,-1,1,145814;390649;4205;123355;204219;80213;79705;390648;55829;26682;3480;55180;145748;220;5046;283777;23336;22856;170691;100128108;64927;140460;6627;123283;91947,25,0.49920666077469700000
chr10,68251535,68383423,131888,-1,1,29119,1,0.75821909498968800000
chrX,67458152,67570167,112015,-1,1,4983,1,0.89273757978842100000
chr2,148815343,148858581,43238,-1,1,55777,1,2.31278042462649000000
chr12,13656611,13749771,93160,-1,1,2904,1,1.07342206955775000000
chr15,25582449,25583525,1076,-1,1,7337,1,92.93680297397770000000
chrX,6896184,7584692,688508,-1,1,412;8226,2,0.29048318973781000000
chr2,63374162,66448006,3073844,-1,1,4190;54812;29094;6509;57162;10097;23177;7360;51542;9792;51057;200734;5861,13,0.42292321926551900000
chr19,3901486,4833181,931695,-1,1,126259;51341;1938;100131094;5605;116844;10501;51588;1613;55620;56961;6455;170961;55527;84699;80700;10036;27231;729359;126282;84717;440503;91039;10148;85300;55702;84954;79187;56005;51548;148022,31,3.32726911703937000000
chr16,15493046,18156351,2663305,-1,1,4629;123811;64131;89927;4363;54820;408050;255027;101059938;368;9665,11,0.41302066417477500000
chr3,1,3969037,3969036,-1,1,27255;51095;57633;51185;3568;10752;152330,7,0.17636524334876300000
chr3,114122192,114513854,391662,-1,1,26137,1,0.25532219107291500000
chr3,78919972,89042195,10122223,-1,1,389136;8545;253559;2632;6091;285237;55279;25978;5449;3355,10,0.09879252808399890000
chr5,84469133,88254499,3785366,-1,1,5921;4208;153396;902;1350,5,0.13208762375949900000
chr15,99049161,101293674,2244513,-1,1,145814;283777;4205;123355;204219;55180;23336;170691;64927;3480;140460;145748,12,0.53463713509344800000
chr8,144846443,145230387,383944,-1,1,340371;26873;23513;81858;727957;84232;51236;22827;2907;83481;8733;84875;5339;54512;375686;340390;1537,17,4.42772904381889000000
chr10,28539963,39057906,10517943,-1,1,219749;55149;1326;7587;8829;119180;79741;220929;94134;3799;219771;91074;84569;1390;6840;8453;3688;100288485;25805;283080;56288;57209;7581;6935;57608;219770;143098;51322;8325;80314,30,0.28522687373377100000
chr1,3161052,5742617,2581565,-1,1,57470;388588;1677;9731;127262;27237;339448;148870;63976;55966;1953;7161;49856,13,0.50357050858684600000
chr5,11378816,11492236,113420,-1,1,1501,1,0.88167871627578900000
chr3,19921164,23530568,3609404,-1,1,8850;151648;79750;7325;151649;5868;151651,7,0.19393783572024600000
chr7,5592436,8416721,2824285,-1,1,5395;3382;54476;51622;84132;5879;729852;54468;79034;9265;84792;221955;54753;6119;7559;222967;7965;55146;221960;654231;392862;100310846;728194;6624;56913;113263;100131017;27102;340267;11014,30,1.06221574664030000000
chr16,29673983,30190538,516555,-1,1,653808;5531;26470;283897;253980;146378;8479;83719;23475;283899;124446;9344;3835;4150;226;253982;83723;5595;6911;8448;79447;112476;9961;10423;6693;79153,26,5.03334591669813000000
chr15,30819486,32509896,1690410,-1,1,728498;51621;22909;161725;283710;54893;89839;4308;1139,9,0.53241521287734900000
chr7,18360905,19616063,1255158,-1,1,7291;9734;222894,3,0.23901373372914000000
chr7,29180484,29478710,298226,-1,1,54504;1124,2,0.67063233923266300000
chr17,14111772,15442066,1330294,-1,1,1352;64518;9953;201158;284040;100533496;5376;146822,8,0.60137082479512000000
chr14,39471773,39895254,423481,-1,1,4253;5411;122553;10484;254170;8487,6,1.41682861804898000000
chr10,28911499,29309599,398100,-1,1,25805;283080;51322,3,0.75357950263752800000
chr7,70115784,70217658,101874,-1,1,26053,1,0.98160472740836700000
chr8,18559625,18719365,159740,-1,1,23362,1,0.62601727807687500000
chr9,28849082,29137041,287959,-1,1,158038,1,0.34727166020162600000
chr16,7087824,7326867,239043,-1,1,54715,1,0.41833477658831300000
chr2,50678025,50892906,214881,-1,1,9378,1,0.46537385808889600000
chr15,30819486,32509896,1690410,-1,1,728498;51621;22909;161725;283710;54893;89839;4308;1139,9,0.53241521287734900000
chr18,67017890,68158862,1140972,-1,1,10666;9306;220164;25914,4,0.35057827887099800000
chr20,14991493,15165480,173987,-1,1,140733,1,0.57475558518739900000
chr4,176270916,190896645,14625729,-1,1,285440;53842;205860;25854;175;55325;140458;7098;55714;60684;60559;836;80014;83891;57587;132851;55602;2160;2823;3818;79682;353322;116966;291;100132463;27295;3660;441054;391723;201965;2195;339976;55247;201973;4543;132625;55805;133121;256309;8470;2180;7424;56977;3622;2483;1635,46,0.31451423720486000000
chr16,29673954,30190568,516614,-1,1,653808;5531;26470;283897;253980;146378;8479;83719;23475;283899;124446;9344;3835;4150;226;253982;83723;5595;6911;8448;79447;112476;9961;10423;6693;79153,26,5.03277108247163000000
chr15,30954726,32509926,1555200,-1,1,161725;283710;54893;51621;4308;22909;1139,7,0.45010288065843600000
chr16,9826491,9864018,37527,-1,1,2903,1,2.66474804807206000000
chr13,20797139,21059969,262830,-1,1,51084;10804,2,0.76094814138416500000
chr2,51083410,51510961,427551,-1,1,9378,1,0.23389022596134700000
chr9,119419472,119457998,38526,-1,1,23245;22954,2,5.19129938223537000000
chr7,155965227,159124141,3158914,-1,1,9690;55112;140545;64327;3110;5799;7434;64434;54892;10049;57488,11,0.34822093922151700000
chr2,72184,1983619,1911435,-1,1,7837;23040;7173;54221;26751;285016;129787;52,8,0.41853371943069000000
chr12,42264141,48750492,6486351,-1,1,85437;347902;5213;387856;1280;196527;144165;84216;29843;51535;79657;51564;10138;7421;341567;51135;121274;9169;81539;91523;140461;80070;5756;8909;4753;440097;79022;55652;54407;121275;196528;283464;10411;55089;83448,35,0.53959460411562700000
chr7,79337679,86790392,7452713,-1,1,222223;781;223117;27445;346562;10512;10371;2913;9723;9988;2770;3082;948,13,0.17443312254208600000
chr16,29674336,30199351,525015,-1,1,653808;5531;26470;283897;253980;146378;8479;83719;23475;283899;124446;9344;3835;4150;226;253982;83723;5595;6911;11151;8448;79447;112476;9961;10423;6693;79153,27,5.14271020827976000000
chr16,22017899,22118484,100585,-1,1,146177;730094,2,1.98836804692549000000
chr2,77883225,78787581,904356,-1,1,,0,0.00000000000000000000
chr17,34891876,36168104,1276228,-1,1,26574;284098;11072;6928;3975;79154;79922;11276;79893;11056;6871;31;284099,13,1.01862676575032000000
chr1,146521698,147735815,1214117,-1,1,9557;51205;51463;5565;607;2702;2330;200030;2703,9,0.74127946482917200000
chr9,132389173,135973347,3584174,-1,1,64794;10319;57720;9328;51450;2889;83549;8939;23064;158067;83543;10585;5900;389799;84929;27348;84814;8021;8328;9442;23413;9329;84726;286336;7248;84628;7270;256158;11092;445;56751;1861;23048;1056;23404;140459;347148;59335;51759;25;28989;10868;9536,43,1.19971854045032000000
chr10,148006,470372,322366,-1,1,22982;10771,2,0.62041282269221900000
chr11,45400761,46839322,1438561,-1,1,9776;9409;2147;143678;9793;4192;51317;8534;79797;9479;283254;1132;1408;8525;120071;55626;392;90993;55343,19,1.32076429153856000000
chr9,28670178,28887418,217240,-1,1,158038,1,0.46032038298655900000
chr17,64529282,65989022,1459740,-1,1,786;25926;5718;26207;284018;5578;27091;27092;2186;9931,10,0.68505350267855900000
chr2,165617506,167042291,1424785,-1,1,6326;79809;2591;6323;151258;22837;6328;80034,8,0.56148822453914100000
chr15,100824329,102440074,1615745,-1,1,390649;220;80213;204219;140460;170691;22856;100128108;79705;55829;390648;55180;6627;123283;5046,15,0.92836431491355400000
chr20,61040773,62893189,1852416,-1,1,54345;6919;10139;3785;198437;1137;1299;11054;140700;10287;2832;100132911;28231;85441;4987;11083;8771;4923;55251;54994;140685;128414;57642;79025;50861;140701;6725;84619;63910;5753;55257;55738;7165;128826;26205;51750;284739;54915;79444;140628;56731;80331;54963;57473;24148;10732;1917;128408;4661;79144;54923,51,2.75316127694859000000
chr13,51380238,51486874,106636,-1,1,79621;220107,2,1.87553921752504000000
chr9,119419472,119576586,157114,-1,1,23245;22954,2,1.27296103466273000000
chr7,111044035,111149166,105131,-1,1,83943,1,0.95119422434867000000
chr7,101790733,102416509,625776,-1,1,729597;246721;5439;548644;1523;441273;10603;100289561;80228;100134938;79706;100271927;54784;10156;222234;100310812;222229,17,2.71662703587226000000
chr22,33669192,33809197,140005,-1,1,9215,1,0.71426020499267900000
chr10,135053398,135404523,351125,-1,1,118472;10844;118471;282969;27287;196743;503542;101;1892;1571;93426;50632;92170,13,3.70238519045924000000
chr9,138518768,139897181,1378413,-1,1,10422;54461;84960;158062;360203;8022;138151;64170;6621;728489;158055;9022;286257;51162;733;10555;8721;138311;29085;56623;90120;55684;7186;138307;158056;401562;26086;157922;57582;23203;9919;389812;414332;392399;389813;402381;169714;10807;5730;286256;85014;4851,42,3.04698229050364000000
chr20,14700040,14824431,124391,-1,1,140733,1,0.80391668207507000000
chr15,95412744,99123529,3710785,-1,1,145946;7026;91947;283777,4,0.10779390344630600000
chr7,4374018,5864851,1490833,-1,1,60;221938;54476;221937;55698;57786;222962;9907;100533952;80028;56903;6624;26100;84629,14,0.93907231728838800000
chr15,36606006,37515525,909519,-1,1,4212;84529,2,0.21989645076133700000
chr11,89998247,102803094,12804847,-1,1,53942;341208;24145;330;28970;120114;54851;643037;390243;387804;5241;4314;143872;390245;84441;7225;8898;10413;9702;79780;85016;4321;253935;329;4312;4544;2526;143689;85459;9440;23052;55693;4317;143684;114908;143686;159989;4316;9313;79101;4361;10929;4319;120103;56935;154810;57562;51503;10888;64066;8690,51,0.39828668003608300000
chr16,21951379,22380197,428818,-1,1,7385;730094;1039;146177;55718;29904;255762,7,1.63239416255847000000
chrX,82716717,84432562,1715845,-1,1,5456;139322;27330;1538;340562;139324,6,0.34968193513982900000
chr2,46739090,46815448,76358,-1,1,23433;90423;5281,3,3.92886141596165000000
chr22,22998284,23627391,629107,-1,1,2781;100423062;613;27156;9609,5,0.79477735901841800000
chr16,86761351,87972139,1210788,-1,1,79791;100506581;54758;81631;57338;23174;8140;763,8,0.66072673333399400000
chr22,21957211,23654363,1697152,-1,1,7332;23753;5594;7441;2781;100423062;613;8940;23532;129025;91227;29799;140883;23759;150223;9647;27156;9609;164592,19,1.11952258843050000000
chrX,41646464,46884342,5237878,-1,1,4693;63904;9767;6102;4129;80258;7403;55634;4128;8573;139341;79742;56548;641339;84679,15,0.28637551313719000000
chr16,28455418,29331326,875908,-1,1,6799;8663;27040;7284;487;26471;246778;25970;100507607;55911;11273;79874;930;84901;112869;728734;83985;6817;1201,19,2.16917758486051000000
chr15,29213402,32510863,3297461,-1,1,728498;321;101059918;4308;23359;1139;7082;51621;89832;22909;653073;161725;283710;54893;89839;56160,16,0.48522181156956800000
chr16,15481920,16388244,906324,-1,1,4629;123811;89927;4363;54820;408050;255027;368;9665,9,0.99302236286361200000
chr2,115649425,117466497,1817072,-1,1,57628,1,0.05503359250486500000
chr10,68251535,68630304,378769,-1,1,29119,1,0.26401315841581500000
chr16,15492317,18112776,2620459,-1,1,4629;123811;64131;89927;4363;54820;408050;255027;101059938;368;9665,11,0.41977378772192200000
chr5,22149,8026308,8004159,-1,1,79192;81037;11336;65980;50805;153571;11044;64979;108;79888;10723;11076;23379;4726;10016;7015;6389;133957;9319;340024;348932;153478;153572;54888;85409;79844;57491;4552;6550;170690;134121;79072;6715;6531;134111;55722;84246;389257,38,0.47475318768655100000
chr3,60055477,60877621,822144,-1,1,2272,1,0.12163319321189500000
chr3,54301840,54452584,150744,-1,1,55799,1,0.66337632011887700000
chr4,138687274,142586686,3899412,-1,1,80155;23657;4258;57484;80854;27309;1047;152586;1998;55534;84709;23158;7350;255520;60592;25819;83452;4717;3600,19,0.48725294993193800000
chr17,14111772,15442066,1330294,-1,1,1352;64518;9953;201158;284040;100533496;5376;146822,8,0.60137082479512000000
chr17,10536069,10942053,405984,-1,1,56985;6341;4621;644139;388335,5,1.23157562859620000000
chr15,22698552,23300263,601711,-1,1,123606;114791;81614;23191;283767,5,0.83096370184357600000
chr6,79859533,85007968,5148435,-1,1,594;4199;7162;25998;5238;90025;6785;112611;83699;23033;134701;9324;112609;7272;167681;9892;51167;55603;167691;22832,20,0.38846756344403700000
chr8,7113683,12309501,5195818,-1,1,401447;392197;1508;377630;83650;504180;503841;245940;203076;83648;55894;245910;613209;157285;252969;245908;100132396;503618;54984;392188;100289462;4482;613211;203074;245909;90459;503614;140596;83595;100133267;100133251;653423;100131980;645402;2626;85002;613210;137075;1673;728957;100131608;640;66036;286046;79660;2222;8658;9258;414325;653333;94137;10407;645836,53,1.02005112573227000000
chr10,103000864,103389882,389018,-1,1,8945;6468;27343;25911,4,1.02823005619277000000
chr4,91369713,91760887,391174,-1,1,401145,1,0.25564071231728100000
chr16,21951379,22380197,428818,-1,1,7385;730094;1039;146177;55718;29904;255762,7,1.63239416255847000000
chr2,109602496,110427254,824758,-1,1,344558;10913;151011;65124,4,0.48499074880146700000
chrX,61529,1217076,1155547,-1,1,55344;6473;28227;8225,4,0.34615640904264400000
chr1,146738716,146920802,182086,-1,1,9557,1,0.54919104159573000000
chr2,16080720,16087043,6323,-1,1,10408;4613,2,31.63055511624230000000
chr20,4211564,10070349,5858785,-1,1,9962;149840;8760;51605;164312;63926;128674;24141;9770;56255;55612;5332;1114;84515;54363;5621;5111;23627;650;23236;29058;57144;54675;56261;146,25,0.42670963348202700000
chr12,129846580,132293356,2446776,-1,1,5901;6433;9271;23504;11211;2054;121256;283383,8,0.32696086605394200000
chr3,181944397,183316787,1372390,-1,1,23200;54165;23101;89857;84002;56922;27074,7,0.51005909398931800000
chr12,4645269,4754289,109020,-1,1,8798;10566;10635;57102,4,3.66905155017428000000
chr3,51141705,55210985,4069280,-1,1,100526760;54106;64943;440956;401067;28972;25981;29890;56920;6787;132158;7873;25886;80335;7134;5580;11188;93973;55349;9730;9136;132141;91869;375346;389124;57060;51533;3697;11344;3699;95;58515;118442;51460;55540;132160;10039;211;55802;55830;3700;389123;23166;440957;2912;84836;1795;776;23132;55193;7086;57408;6159;51368;1849;55799;100526772;8314;389125;25864;26354,61,1.49903668462234000000
chr15,30819487,32635929,1816442,-1,1,728498;51621;22909;161725;283710;54893;89839;4308;1139,9,0.49547411918464800000
chr2,111399243,113098686,1699443,-1,1,10461;699;129804;10018;84910;64682;376940;55289;84524,9,0.52958528176584900000
chr4,83072226,85590900,2518674,-1,1,51138;113510;23001;132660;51023;51316;22872;84142;79966;441027;9987;3184;10855;84803;1040;27235;58478;4825;79725,19,0.75436519374877400000
chr16,15048751,16276115,1227364,-1,1,4629;100288332;123811;89927;4363;54820;368;255027;23042;54700;123803;9665,12,0.97770506548994400000
chr22,34894566,35278567,384001,-1,1,,0,0.00000000000000000000
chr4,88959568,89039179,79611,-1,1,5311;9429,2,2.51221564859128000000
chr7,155870347,159118566,3248219,-1,1,9690;55112;140545;64327;3110;5799;7434;64434;54892;10049;57488,11,0.33864711708169900000
chr2,36798132,40590776,3792644,-1,1,5610;6432;151393;130589;79833;80745;54497;100505876;9637;8491;1545;130733;391365;344387;64225;729967;55471;5212;6546;10153;92906;6654;90957;100271715;23683;25797;10602;253635;6801,29,0.76463807306986900000
chr10,92950376,93392237,441861,-1,1,143279;84333;5507,3,0.67894654653839100000
chr7,110767384,110905009,137625,-1,1,83943,1,0.72661217075386000000
chr11,117015663,117513829,498166,-1,1,257160;23621;22897;57453;6876;5049;9159;51092,8,1.60589040600924000000
chr15,30390043,32899529,2509486,-1,1,728498;101059918;51621;89832;653125;22909;161725;283710;54893;89839;643699;4308;728047;1139,14,0.55788316810693500000
chr3,9394944,9542885,147941,-1,1,55209;375323;25917,3,2.02783542087724000000
chr3,9422487,9793524,371037,-1,1,55209;4968;64419;25917;375323;7862;151835,7,1.88660430091878000000
chr3,8856000,11305600,2449600,-1,1,55831;9901;6396;7428;285367;4968;491;151835;6538;9797;26140;8536;84522;3269;63924;100526693;2177;56852;25917;401052;115795;132014;285368;10474;7862;51738;84818;55209;78987;3656;64419;6529;10093;55845;375323,35,1.42880470280862000000
chr16,14902342,15316713,414371,-1,1,23420;54700;23042;9284;123803,5,1.20664814863975000000
chr16,15449696,16514368,1064672,-1,1,4629;100288332;123811;89927;4363;54820;408050;255027;101059938;368;9665,11,1.03318205043431000000
chr14,103123635,107278770,4155135,-1,1,647286;23241;23186;283643;91828;9578;9529;400258;207;55038;9112;122402;107984640;3714;81693;10572;283638;1983;4140;100128927;1396;7187;1152;3831;84334;122618;80757;374569;388021;113146;2972;256281;647310;1397;7517;90135;79038;122616;9556;64423;115708;23368;122622;26153;29933;7127,46,1.10706391007753000000
chr2,140509156,144980623,4471467,-1,1,79712;8942;55843;53353,4,0.08945610020156700000
chrX,138556249,140557617,2001368,-1,1,64663;1038;286410;4168;2158;728695;23641;6658;389895;347487,10,0.49965823376810300000
chr20,14944155,15268061,323906,-1,1,140733,1,0.30873154557186300000
chr2,135910526,136226458,315932,-1,1,22930;84083,2,0.63304761784181400000
chr16,15131723,15154746,23023,-1,1,23042;54700;123803,3,13.03044781305650000000
chr5,78831641,78973592,141951,-1,1,167153,1,0.70446844333608100000
chr22,20754422,21440514,686092,-1,1,80764;9342;91179;8216;7625;400891;1399;84861;6545;150209;5297;51586;9127;3053,14,2.04054266774718000000
chr8,100290888,100493892,203004,-1,1,157680,1,0.49260113101219700000
chr20,14776880,14875770,98890,-1,1,140733,1,1.01122459298210000000
chr1,176811667,176985996,174329,-1,1,460;60676,2,1.14725605034160000000
chr7,31592602,32190975,598373,-1,1,223075;10842;5137,3,0.50135951989812400000
chr12,52810526,54739060,1928534,-1,1,3848;51350;3851;6895;8620;3225;7786;60314;338785;283337;3854;3695;140807;3223;3849;8435;3221;3856;3852;5094;3853;196374;23371;3224;269;23583;3227;4778;22818;3226;3229;3222;54458;6667;3178;3875;319101;374454;51380;3850;9700;5204;9119;84926;84975;121391;517;3228;3489;8086;11016;286887;23468;5916;1975;121340;112802;57658,58,3.00746577452096000000
chr9,28561981,28745046,183065,-1,1,158038,1,0.54625406276459200000
chr16,21951379,22380197,428818,-1,1,7385;730094;1039;146177;55718;29904;255762,7,1.63239416255847000000
chr22,20754422,21440514,686092,-1,1,80764;9342;91179;8216;7625;400891;1399;84861;6545;150209;5297;51586;9127;3053,14,2.04054266774718000000
chr4,25552218,25725235,173017,-1,1,10568,1,0.57797788656606000000
chr16,15131723,15154746,23023,-1,1,23042;54700;123803,3,13.03044781305650000000
chr3,195740357,197395697,1655340,-1,1,622;255798;80235;200933;5062;5130;4241;26043;1739;84984;348793;255758;116211;131540;200931;375387;22916;7037;165918;54965;205564,21,1.26862155206785000000
chr11,12212426,12888312,675886,-1,1,84953;55742;9645;7003,4,0.59181577958413100000
chr3,156500180,156712650,212470,-1,1,389170,1,0.47065468066079900000
chr20,14700040,14875770,175730,-1,1,140733,1,0.56905479997723800000
chr22,47204326,47393577,189251,-1,1,25771,1,0.52839879313715600000
chr15,30954724,32635957,1681233,-1,1,161725;283710;54893;51621;4308;22909;1139,7,0.41636108736861600000
chr2,51193626,51314430,120804,-1,1,9378,1,0.82778715936558400000
chr1,146521698,147735815,1214117,-1,1,9557;51205;51463;5565;607;2702;2330;200030;2703,9,0.74127946482917200000
chrX,6552712,8115153,1562441,-1,1,412;8228;26609;8226,4,0.25600966692502300000
chr9,9905054,9972076,67022,-1,1,5789,1,1.49204738742502000000
chrX,138281469,139153189,871720,-1,1,4168;2158;2258;286410;347487,5,0.57357867205065800000
chr5,74149,4633601,4559452,-1,1,4726;10016;7015;6389;79192;81037;11336;133957;9319;340024;65980;348932;153478;153572;85409;79844;50805;153571;57491;6550;64979;79888;10723;6531;11076;55722;389257,27,0.59217642821988300000
chr6,20649504,20741013,91509,-1,1,54901,1,1.09278868745151000000
chrX,6552712,8115153,1562441,-1,1,412;8228;26609;8226,4,0.25600966692502300000
chr2,51037104,51122150,85046,-1,1,9378,1,1.17583425440350000000
chr1,146514772,147735815,1221043,-1,1,9557;51205;51463;5565;607;2702;2330;200030;2703,9,0.73707477951227000000
chr18,7877328,8113527,236199,-1,1,5797,1,0.42337181783157400000
chr3,195740357,196230093,489736,-1,1,255758;116211;131540;200931;7037;165918;5130;26043,8,1.63353316889099000000
chr1,231024479,236037015,5012536,-1,1,84451;27185;8443;51742;54583;9804;128061;440730;54627;57568;1130;2786;148789;6894;64801;375061;149371;23029;7257;148641;80003;6905;3775;149373;9453;83932;388753;84284;359948;79573,30,0.59849944219852000000
chr4,178829225,190896768,12067543,-1,1,285440;53842;205860;25854;55325;7098;55714;60684;836;80014;83891;57587;55602;2160;3818;79682;353322;291;100132463;27295;3660;441054;391723;201965;2195;339976;201973;4543;132625;55805;133121;256309;8470;2180;56977;3622;2483;1635,38,0.31489425809379800000
chr19,3289960,4118931,828971,-1,1,60680;51341;6915;1938;5605;4145;126321;1613;83475;51343;27134;100128569;9546;10362;84839;284422;27231;116541;4782;23396;23217;85300;51588;58509;126326,25,3.01578704200750000000
chr19,28290032,31582993,3292961,-1,1,898;342865;10775;7386;9745;83636;8725;79156,8,0.24294244602350300000
chr16,89765758,90002532,236774,-1,1,2175;124044;84501;22980;92822;10381;9605;4157,8,3.37874935592590000000
chr7,111105151,111304031,198880,-1,1,83943,1,0.50281576830249400000
chr4,147830359,151242375,3412016,-1,1,1909;90826;79658;166614;4306;987;83894;55751,8,0.23446548902467000000
chr2,157185021,158179737,994716,-1,1,57471;4929;2820;11227,4,0.40212482758898000000
chr10,57470231,58686145,1215914,-1,1,11130,1,0.08224265860907930000
chr17,38150340,40539162,2388822,-1,1,1440;83900;84951;339287;6776;7153;653240;728318;100132476;83899;83895;125111;162605;8689;3861;3884;83902;147183;3886;3859;147184;81872;85289;125113;1236;8688;3883;7266;85285;9572;3728;728224;390792;730755;342574;3858;85280;3860;23415;100132386;100505753;353288;83755;2520;3872;3060;6605;5878;3882;81851;79132;5914;3866;83897;3880;83896;83901;115024;3487;147179;10209;3857;47;5709;22794;81870;51195;100533177;94086;10609;81850;84514;25984;201181;84616;100505724;125115;6774;3868;60681;100507608;317719;728255;990;9001;28511;7067;81871;85291;83538;8687;55175;85294;728279;3885;3881;85290;6777;1267;192666;2648;54474;85293;9862,104,4.35361027318067000000
chr2,239231436,242852625,3621189,-1,1,64090;84289;5510;285093;51665;4705;150677;1841;129807;2859;130916;150678;2817;4735;9855;9759;150681;375318;189;51078;547;79919;57140;25992;11132;389090;23192;3069;10494;117581;51281;285193;666;26146;23178;50636;653437;5133;728294,39,1.07699432423991000000
chr1,6411511,7630401,1218890,-1,1,83715;8718;90326;11332;9903;79707;23261;80835;55735;57449;54626;3104;148479,13,1.06654415082575000000
chr2,161995981,165404338,3408357,-1,1,10010;1803;25801;10213;10716;57282;64135;90134;2888;2641;2191;55137,12,0.35207579487712100000
chr2,162841619,163361046,519427,-1,1,64135;1803;25801;2641;57282;2191;90134,7,1.34763884049154000000
chr4,29633692,31038783,1405091,-1,1,5099,1,0.07116976765205960000
chr4,4441881,7212894,2771013,-1,1,152789;57533;9778;257236;1400;93621;6286;53407;93624;57537;114932;55351;2121;23324;55330;5522;132884;4487;80273;54360;7466,21,0.75784559653816100000
chr4,157343163,158271008,927845,-1,1,2743;2891;56034,3,0.32332986651865300000
chr10,32095083,32229198,134115,-1,1,94134,1,0.74562875144465600000
chr10,27266067,29975521,2709454,-1,1,84569;91452;6840;374308;22931;25805;283080;143098;84930;22852;283078;10730;51322;55130,14,0.51670927057628600000
chr10,28732970,28968306,235336,-1,1,25805;51322,2,0.84984872692660700000
chr18,32883148,35329908,2446760,-1,1,25800;55250;80206;25941;56853;55197;125476;2589;57536;252884;7572;83608;55034,13,0.53131488172113300000
chr15,22815607,23146103,330496,-1,1,123606;23191;114791;81614,4,1.21030209140201000000
chr1,246261013,246518362,257349,-1,1,64754,1,0.38857737935643800000
chr2,55495866,55679812,183946,-1,1,4528;55704,2,1.08727561349526000000
chr9,119090300,119312402,222102,-1,1,23245;5069,2,0.90048716355548400000
chr2,51083410,51314430,231020,-1,1,9378,1,0.43286295558826100000
chr12,11630354,12619208,988854,-1,1,54682;79370;118426;4040;2120,5,0.50563581681421100000
chr3,67607326,67757938,150612,-1,1,8801,1,0.66395771917244300000
chr14,79328112,79433755,105643,-1,1,9369,1,0.94658425073123600000
chr4,183714625,190896768,7182143,-1,1,285440;53842;205860;25854;55325;7098;55714;60684;836;80014;83891;57587;55602;2160;3818;79682;353322;291;100132463;27295;3660;441054;391723;201965;2195;339976;201973;4543;132625;55805;133121;256309;8470;2180;56977;3622;2483;1635,38,0.52908999444873200000
chr12,450479,786623,336144,-1,1,283358;5927;4815;84318,4,1.18996620495978000000
chr2,165022807,167150915,2128108,-1,1,6326;79809;2591;6335;6323;151258;22837;2888;6328;80034,10,0.46990096367289600000
chr16,21951379,22380197,428818,-1,1,7385;730094;1039;146177;55718;29904;255762,7,1.63239416255847000000
chr2,213054092,213292156,238064,-1,1,2066,1,0.42005511123059300000
chr8,49943676,50932740,989064,-1,1,492307;54212,2,0.20221138369205600000
chr17,61158866,61353248,194382,-1,1,26115,1,0.51445092652611900000
chr2,50892847,51510961,618114,-1,1,9378,1,0.16178245436925900000
chrX,61931716,63863063,1931347,-1,1,142689;139886;23229;55613;139285,5,0.25888667339426800000
chrX,67454314,68197644,743330,-1,1,9754;4983;1947;286451,4,0.53811900501796000000
chr4,179564612,185864741,6300129,-1,1,79682;53842;100132463;3660;55714;201965;60684;836;201973;80014;133121;2180;56977;55602;3622;1635,16,0.25396305377239100000
chr2,10230160,11678681,1448521,-1,1,3754;10130;4953;1876;348738;79954;3241;130813;9475;245973;130814;6241;9687,13,0.89746714062136500000
chr7,146498890,146657940,159050,-1,1,26047,1,0.62873310279786200000
chr15,22784523,23179948,395425,-1,1,123606;23191;114791;81614,4,1.01156982992982000000
chr7,111044035,111274663,230628,-1,1,83943,1,0.43359869573512300000
chr8,104988349,105914699,926350,-1,1,81501;9699;29967;1807,4,0.43180223457656400000
chr14,79388255,79473346,85091,-1,1,9369,1,1.17521241964485000000
chr6,5286298,5431448,145150,-1,1,10667,1,0.68894247330347900000
chr15,22765628,23082821,317193,-1,1,123606;23191;114791;81614,4,1.26106187715366000000
chr6,71071757,82577829,11506072,-1,1,134728;135228;6785;1303;79627;55754;55510;9324;115004;4646;80759;441161;26054;135154;56479;22999;55603;594;1347;135152;25821;60682;340168;83699;57579;101928601;55023;154288;7272;100129128;27145;3617;26503;1915;167691;3351,36,0.31287827852980600000
chr22,51121452,51197838,76386,-1,1,49;85358,2,2.61828083680256000000
chr2,170175251,173038935,2863684,-1,1,79901;26003;254042;10324;130507;1781;29081;1746;493911;100526832;9360;140469;6741;8520;4036;79675;129881;389058;79828;9874;2571;151230;1745;8604;129880;80067;285141,27,0.94284145876430500000
chr20,14244779,14629182,384403,-1,1,140733;23767,2,0.52028730264852300000
chr9,28561981,28745046,183065,-1,1,158038,1,0.54625406276459200000
chr2,181400681,181882412,481731,-1,1,10477,1,0.20758473089753400000
chr16,21951379,22380197,428818,-1,1,7385;730094;1039;146177;55718;29904;255762,7,1.63239416255847000000
chr5,88062523,88348177,285654,-1,1,4208,1,0.35007386558563900000
chr5,13265891,20353755,7087864,-1,1,54463;56172;7204;54491;1016;1767;23194;441061;90268;10409;90441;4651,12,0.16930347422016000000
chr2,50850691,50982172,131481,-1,1,9378,1,0.76056616545356400000
chr7,111044035,111149166,105131,-1,1,83943,1,0.95119422434867000000
chr2,188103179,188276180,173001,-1,1,10203,1,0.57803134085930100000
chr2,51083410,51314430,231020,-1,1,9378,1,0.43286295558826100000
chr12,100127797,100230289,102492,-1,1,56899,1,0.97568590719275600000
chr19,4326221,4851551,525330,-1,1,116844;100131094;10501;55620;10226;6455;55527;80700;10036;729359;126282;84717;91039;84954;56005;440503;148022,17,3.23606114251994000000
chr13,99339814,99395670,55856,-1,1,6564,1,1.79031796046978000000
chr2,200233544,200354059,120515,-1,1,23314,1,0.82977222752354500000
chr17,34817422,36168104,1350682,-1,1,26574;284099;9326;284098;11072;6928;79154;79922;3975;11276;79893;11056;6871;31;80179,15,1.11055007766447000000
chr12,86358388,91643585,5285197,-1,1,100528030;1848;160418;196477;4254;1833;91298;25834;160419;11081;80184;8693;4060;282809;1634;490,16,0.30273232956122500000
chr3,158159182,158375287,216105,-1,1,4291;51319;85476,3,1.38821406260845000000
chr4,71552,8281118,8209566,-1,1,257236;7700;521;7469;79155;401115;133060;4636;55646;6286;654254;53407;54872;166793;114932;1609;55351;2121;79441;7468;152877;285489;84448;353497;152789;9778;10861;92305;285498;57537;10815;27065;2580;53834;84179;5158;402160;3425;152687;4487;6047;54729;6002;54360;7466;10227;57533;10336;10417;93621;93624;345222;84286;2261;255403;4043;8602;7884;170960;57732;132884;10296;3083;3064;768239;57654;10460;85013;118;1400;3954;152;60312;94031;23324;55330;339983;6452;5522;10608;1487;80273;2868;54436;389199;285464;8603,87,1.05973933335818000000
chr7,72726578,74139390,1412812,-1,1,5982;51085;9275;84277;7462;135886;83451;1364;135892;6804;7461;155382;3984;26608;8468;9031;155368;2969;8326;7458;9569;2006;1365;114049,24,1.69873981817821000000
chr22,18919942,21440514,2520572,-1,1,54487;27037;9342;29801;65078;10587;1312;6545;421;7290;2812;6899;5625;7625;79680;64976;6576;3053;8218;5413;80764;23617;400891;1399;7122;150209;128977;8220;388849;84861;7353;51586;2928;128989;5297;9127;9993;54584;91179;85376;8216;85359;8318;728229;5902,45,1.78530904889842000000
chrX,1471879,5307354,3835475,-1,1,414;286530;3563;5613;25878;347527;415;416;207063;4267;293;7499;9189;438;8227;8623;8908,17,0.44323062984376100000
chr20,14700100,14944154,244054,-1,1,140733,1,0.40974538421824700000
chr5,180527067,180712263,185196,-1,1,84851;81786;90933;10399;26693;285659,6,3.23981079504957000000
chr20,70580,743283,672703,-1,1,245938;140680;10616;1457;57761;140850;245939;85508;85364;128637;6939;81623;140881;400830;140809;113278;6666;80023,18,2.67577222043012000000
chrX,168551,1234634,1066083,-1,1,55344;6473;28227;8225,4,0.37520530765428200000
chr2,51166648,51201652,35004,-1,1,9378,1,2.85681636384413000000
chr3,195747856,197339270,1591414,-1,1,622;255798;80235;200933;5062;5130;4241;26043;1739;84984;348793;255758;116211;131540;200931;375387;22916;7037;165918;54965;205564,21,1.31958120262861000000
chr1,153835538,154147267,311729,-1,1,27173;10899;148327;200186;9909;7170;5872;6232;91181;57459,10,3.20791456681926000000
chr2,50869856,50943539,73683,-1,1,9378,1,1.35716515342752000000
chr19,3742030,4470698,728668,-1,1,126259;51341;1938;5605;51588;4145;1613;27134;55620;9546;56961;6455;170961;84699;84839;80700;10036;27231;116541;23217;10148;55702;85300;84954;79187;51548,26,3.56815449560019000000
chr6,39581432,44146933,4565501,-1,1,100188893;23304;129685;9436;57510;23113;65989;222642;11131;10591;5754;896;5528;705;2979;221421;55173;4800;4201;116138;107080644;285852;9477;10930;6903;4337;25844;5190;10817;7942;55809;6722;89845;4188;5961;55362;64928;340205;25862;9820;89953;116113;23500;222643;401262;84630;54676;29964;10864;23506;221416;93643;79865;57497;2978;27232;55168;9587;54210;5225;51069;5429;24149;54209;7422;647024;88745;221443;441150;9533;221424;285855;10695;171558;221458,75,1.64275508865292000000
chr9,131187621,131902717,715096,-1,1,89891;29941;57171;56262;84895;1384;2733;254295;6418;51490;56904;5524;22845;23511;51148;84885;883;4957;54662;10444;2021;6709,22,3.07651000704800000000
chr9,131187621,131902717,715096,-1,1,89891;29941;57171;56262;84895;1384;2733;254295;6418;51490;56904;5524;22845;23511;51148;84885;883;4957;54662;10444;2021;6709,22,3.07651000704800000000
chr4,33174895,37616325,4441430,-1,1,55286;401124;768211;116984;57495,5,0.11257635491272000000
chr4,20435378,26333623,5898245,-1,1,51091;389203;166647;10891;29945;29063;23231;10568;80333;3516;9353;133015;1665;6649;91050;55300;55203,17,0.28822132685230900000
chr1,57349192,64560883,7211691,-1,1,54596;4774;51361;731;83941;4070;127795;27022;3725;85440;732;1600;29929;114803;7398;4919;115209;5236;1573;10207;84455;84938;27329;55277;163782;23421,26,0.36052570749356800000
chr12,74622218,82577347,7955129,-1,1,8825;23390;8499;114882;144321;1466;4618;79611;5074;283310;79738;6857;89795;552889;22822;11010;4673;4659;4617;144455;374462;256710;3747;84698;11103,25,0.31426265997697800000
chr15,22765637,23146102,380465,-1,1,123606;23191;114791;81614,4,1.05134506459201000000
chr16,21899916,22517094,617178,-1,1,7385;730094;1039;146177;55718;29904;255762,7,1.13419467317370000000
chr1,2989895,4629201,1639306,-1,1,57470;388588;1677;9731;127262;27237;339448;148870;63976;1953;7161;49856,12,0.73201708527877000000
chr6,122208963,127763710,5554747,-1,1,5570;10345;387104;154214;51020;7164;23493;135112;2173;387103;57515;154215;9729;135114;3298;55862;134829;84870;60487;81847;10924,21,0.37805502212792000000
chr15,32021733,32510863,489130,-1,1,161725;1139,2,0.40888925234600200000
chr13,31002803,31775898,773095,-1,1,145173;3146;10808;241;10208;84935;122046,7,0.90545146456774400000
chr15,72963970,75535330,2571360,-1,1,57184;1445;192683;84993;10021;9377;5371;10620;56905;79748;80381;161514;9399;57611;1543;1544;585;283677;25989;10066;83440;64220;60490;4756;1198;105376731;594855;8482;80153;3671;1583;54913;80125;4351;388135;342096;4016;27020,38,1.47781718623608000000
chr16,21890413,22408072,517659,-1,1,7385;730094;1039;146177;55718;29904;255762,7,1.35224153351917000000
chr10,92166282,95518049,3351767,-1,1,26509;55165;27063;143282;54708;9211;143279;5950;340665;10556;3087;22849;118924;3832;54536;9044;3416;5507;338557;1592;5146;84333;3363;80351,24,0.71604022594649300000
chr17,34817422,36243028,1425606,-1,1,26574;284099;9326;284098;11072;6928;79154;79922;3975;11276;79893;11056;6871;31;80179,15,1.05218412380419000000
chr16,29673954,30119759,445805,-1,1,653808;5531;26470;283897;253980;146378;8479;83719;23475;283899;124446;9344;3835;4150;226;253982;83723;6911;8448;79447;112476;9961;10423;6693;79153,25,5.60783302116396000000
chr16,6628137,9050170,2422033,-1,1,18;5373;7874;25880;23589;283953;54715;79091,8,0.33030103223201300000
chr2,50850691,51649466,798775,-1,1,9378,1,0.12519169979030400000
chr16,21926361,22467007,540646,-1,1,7385;730094;1039;146177;55718;29904;255762,7,1.29474739478328000000
chr5,172412551,174049757,1637206,-1,1,8614;133491;1482;8992;662;51617;91272;153222;80315,9,0.54971701789512100000
chr7,151664495,159075079,7410584,-1,1,155435;63917;58508;140545;5799;3361;64327;1804;64434;10049;9690;389602;22976;55112;57180;6469;3110;7516;7434;54892;285888;168391;2020;3638;57488,25,0.33735532854090800000
chr13,112168604,115105670,2937066,-1,1,7027;55795;283489;79774;23263;3916;22821;8858;643365;10426;55002;8451;101928841;2621;400165;23250;6656;348013;2155;113622;65110;2159;55208;496;122258;6011;8881,27,0.91928475560304100000
chrX,71648776,72132607,483831,-1,1,55869;63947;5255;728656;100132304,5,1.03341869371743000000
chr3,55768908,58444405,2675497,-1,1,285331;5162;2317;11102;7871;50650;378;26059;57406;1776;353324;201625;8820;54756;201627;54899;201626;142686;23272;26060,20,0.74752466551074400000
chr16,29673954,30198600,524646,-1,1,653808;5531;26470;283897;253980;146378;8479;83719;23475;283899;124446;9344;3835;4150;226;253982;83723;5595;6911;11151;8448;79447;112476;9961;10423;6693;79153,27,5.14632723779463000000
chr2,96779631,98021592,1241961,-1,1,81562;51239;56910;55683;23397;10865;54910;9391;26504;93082;51252;90342;151;151313;1844;26505;200539;375248;23020;150771;431705;55654,22,1.77139217737111000000
chr1,58043100,58170803,127703,-1,1,1600,1,0.78306696005575400000
chr5,76116577,78831700,2715123,-1,1,23440;29958;8546;133746;1393;9456;6902;23743;170591;8622;55109;9522;411;635;55255;84327;10184;2150,18,0.66295339106184100000
chrX,154120738,154490709,369971,-1,1,7411;79184;100272147;116442;65991;4515;2157,7,1.89204018693357000000
chr15,22765628,23146132,380504,-1,1,123606;23191;114791;81614,4,1.05123730630953000000
chr3,93949,7098404,7004455,-1,1,2917;51095;51185;3568;10752;9695;285362;27255;3708;57633;8553;6419;152330;55207,14,0.19987279524245600000
chr5,92911737,93990442,1078705,-1,1,7025;285600;83989;84250;134187,5,0.46351875628647300000
chr10,46976157,51664079,4687922,-1,1,5599;644168;267004;8031;195977;100652748;9721;642517;57705;474354;170371;118738;653145;5949;644054;100133093;728113;5540;143162;6572;2662;26095;118461;282966;58504;100287932;8505;2658;1103;2074;170370;4477;196740;55753,34,0.72526803986926400000
chr10,119375834,122063356,2687522,-1,1,22876;63877;2834;11196;404636;22841;9531;79892;10935;8661;340719;7073;119559;143384;6001;2869,16,0.59534396369592500000
chr7,96407645,97479261,1071616,-1,1,1750;1749;6863;57001,4,0.37326803631151500000
chr16,86804086,87887066,1082980,-1,1,79791;57338;100506581;54758;23174;81631;8140,7,0.64636466047387800000
chr16,29652999,30198600,545601,-1,1,653808;5531;26470;283897;253980;146378;8479;83719;23475;283899;124446;9344;3835;4150;226;253982;83723;5595;6911;11151;8448;79447;112476;9961;10423;6693;79153,27,4.94867128176085000000
chr9,122644972,125520065,2875093,-1,1,7185;138883;254973;727;2040;4702;26740;26190;11064;138882;5742;26737;158135;92399;26219;5711;347169;138881;92400;2934;254956;158131;392390;26468;26735;55755;26147;347168;153090;51552;1955,31,1.07822599129837000000
chrX,153359641,153541289,181648,-1,1,728458;4204;5956;8277;2652,5,2.75257641152118000000
chr7,149415472,153056008,3640536,-1,1,54480;84626;58508;65999;474344;643641;168537;1020;26;11194;6009;392843;57180;116988;23145;2636;168391;653857;5919;51667;51422;9311;55303;349136;155051;113763;63917;55340;83590;28959;170575;6522;3757;168544;29803;4846;10922;10061;100527949;6604;285973;7516;155066;26157;55365;136371;285971;155038,48,1.31848716782364000000
chr7,153904470,159128556,5224086,-1,1,155435;140545;3361;64327;5799;1804;64434;10049;9690;389602;22976;55112;6469;3110;7434;285888;54892;2020;3638;57488,20,0.38284208950618300000
chr12,116468021,116558092,90071,-1,1,23389,1,1.11023525885135000000
chr18,14316,14928854,14914538,-1,1,116;23255;57132;8774;645369;125228;57045;103910;642597;84617;9097;7525;10650;3613;56984;65258;79822;84034;4729;23253;9663;9989;339291;9984;10928;162655;63895;201475;64863;342850;27098;646000;753;7541;55125;55556;10403;4158;84203;388468;147495;9218;5797;494514;1149;5771;10939;1068;79959;9229;7298;91133;11031;56907;7050;81929;4161;81035;2774;23347;10627;8731;8736;374860;284217;23136,66,0.44252125007157500000
chr2,1151167,1589921,438754,-1,1,7173;54221,2,0.45583630006792000000
chr16,29652360,30194215,541855,-1,1,653808;5531;26470;283897;253980;146378;8479;83719;23475;283899;124446;9344;3835;4150;226;253982;83723;5595;6911;8448;79447;112476;9961;10423;6693;79153,26,4.79833165699311000000
chr16,63004697,63307109,302412,-1,1,,0,0.00000000000000000000
chr5,179282758,179587958,305200,-1,1,51149;55819;23061;255426,4,1.31061598951507000000
chr5,20895983,21405056,509073,-1,1,,0,0.00000000000000000000
chr2,17153,310189,293036,-1,1,285016;642273;26751;52,4,1.36501999754296000000
chr22,18661699,21661435,2999736,-1,1,54487;27037;9342;29801;65078;10587;1312;6545;8214;7290;421;2812;6899;5625;7625;79680;64976;6576;3053;8218;5413;80764;23617;400891;1399;7122;150209;128977;8220;388849;84861;7353;51586;2928;128989;5297;9127;9993;54584;91179;85376;8216;85359;8318;728229;5902,46,1.53346827854184000000
chr9,102481115,102814578,333463,-1,1,8013;23071;55014,3,0.89965003613594300000
chr2,153190063,157904947,4714884,-1,1,56475;151188;2820;100144595;4929;55660;114793;114805;3760,9,0.19088486588429300000
chr13,104326247,106287536,1961289,-1,1,267012,1,0.05098687648786080000
chr4,128260348,132247653,3987305,-1,1,22824;256471;132321;10733;80167;55132;10424;83447;79960;132320;27152,11,0.27587556005873600000
chr16,29652360,30199696,547336,-1,1,653808;5531;26470;283897;253980;146378;8479;83719;23475;283899;124446;9344;3835;4150;226;253982;83723;5595;6911;11151;8448;79447;112476;9961;10423;6693;79153,27,4.93298449215838000000
chr9,2602116,2818582,216466,-1,1,7436;169522;9933,3,1.38589894024928000000
chr22,44505317,51220923,6715606,-1,1,150383;85378;25771;23151;23774;80305;11158;55267;79174;55007;1375;415116;83642;23542;553158;7380;6300;10343;83933;79924;23313;84247;6305;51512;1890;23654;25817;29781;91289;26150;85358;410;400935;2192;56666;5600;9701;27127;49;9889;414918;9997;9620;1120;440836;64781;5465;112885;29780;644186;23779;23209;7477;25814;64098;10762;79087;55020;55687;348645;55615;85352;113730;55586;54456,65,0.96789478120068400000
chr16,29592791,30195986,603195,-1,1,653808;5531;26470;283897;253980;146378;8479;83719;23475;283899;124446;9344;3835;4150;226;253982;83723;5595;6911;11151;8448;79447;112476;9961;10423;6693;79153,27,4.47616442443986000000
chr11,3724232,4209349,485117,-1,1,6240;27315;6786;4928;391,5,1.03067919697722000000
chr16,28796368,29076269,279901,-1,1,11273;79874;7284;930;84901;27040;487;83985;25970,9,3.21542259584639000000
chr1,159288837,159673076,384239,-1,1,325;26476;127385,3,0.78076405570491300000
chr13,20761895,20827221,65326,-1,1,2706;10804,2,3.06156813519885000000
chr16,89862149,89869755,7606,-1,1,2175,1,13.14751511964240000000
chr12,858276,1154012,295736,-1,1,5893;65125;23085,3,1.01441826493900000000
chr15,30930422,32509932,1579510,-1,1,51621;22909;161725;283710;54893;89839;4308;1139,8,0.50648618875474000000
chr2,77437370,78080082,642712,-1,1,80059,1,0.15559068447453900000
chr2,51029031,51383493,354462,-1,1,9378,1,0.28211768821481600000
chr8,5794493,6033328,238835,-1,1,,0,0.00000000000000000000
chr15,25092210,25114364,22154,-1,1,6638,1,4.51385754265595000000
chr1,174393168,174656791,263623,-1,1,9910;9293,2,0.75865914582566800000
chr13,23681269,23816380,135111,-1,1,6445,1,0.74013218760870700000
chr10,68381027,68583230,202203,-1,1,29119,1,0.49455250416660500000
chr4,15849631,16932551,1082920,-1,1,9079;952;8842;83888;9982;202018,6,0.55405754811066400000
chr2,155800798,156072149,271351,-1,1,,0,0.00000000000000000000
chr5,161587907,161924770,336863,-1,1,,0,0.00000000000000000000
chr1,2260726,2734332,473606,-1,1,79258;9651;5192;388585;55229;79906;8764;11079;127281;100287898,10,2.11145973657428000000
chr20,7103868,8558204,1454336,-1,1,56255;23236;54363,3,0.20627970427741600000
chr13,82354039,82584721,230682,-1,1,,0,0.00000000000000000000
chr8,5419567,6175513,755946,-1,1,,0,0.00000000000000000000
chr16,29652360,30195608,543248,-1,1,653808;5531;26470;283897;253980;146378;8479;83719;23475;283899;124446;9344;3835;4150;226;253982;83723;5595;6911;11151;8448;79447;112476;9961;10423;6693;79153,27,4.97010573439755000000
chr9,6055502,6706559,651057,-1,1,2731;90865;89882;115426,4,0.61438552999199800000
chr9,90033544,93168265,3134721,-1,1,1903;23552;441452;645961;158046;1514;10507;1612;53358;1164;10927;79048;286223;286234;10912,15,0.47851148475414600000
chr15,22753658,23189431,435773,-1,1,123606;23191;114791;81614,4,0.91790909487278900000
chr8,117702468,118857700,1155232,-1,1,90390;5885;84294;8667;2131;441376;169026,7,0.60593889365945500000
chr4,95944228,96028170,83942,-1,1,658,1,1.19129875390150000000
chr8,12742457,13264839,522382,-1,1,10395;57604,2,0.38286158405151800000
chr14,27838974,28065369,226395,-1,1,,0,0.00000000000000000000
chr12,65097766,65126783,29017,-1,1,2799,1,3.44625564324362000000
chr1,145139207,148545736,3406529,-1,1,9557;148738;128077;27246;84265;11126;10628;2330;653519;8799;149013;5174;388677;10401;200035;644591;51205;284615;645142;8515;51463;5565;148741;607;2702;10623;200030;100132406;2703;9939,30,0.88066181148024900000
chr3,150338040,150983670,645630,-1,1,51714;9934;131831;7401;29909;116931;6478,7,1.08421231974970000000
chr7,145837835,145993893,156058,-1,1,26047,1,0.64078739955657500000
chr6,5286437,5442742,156305,-1,1,10667,1,0.63977479927065700000
chr4,11909503,12198981,289478,-1,1,,0,0.00000000000000000000
chr13,20867199,21099089,231890,-1,1,51084,1,0.43123894950191900000
chr1,97936699,98775355,838656,-1,1,1806,1,0.11923840048840000000
chr12,65097766,65126783,29017,-1,1,2799,1,3.44625564324362000000
chr11,131457371,132015881,558510,-1,1,50863,1,0.17904782367370300000
chr16,29652360,30199696,547336,-1,1,653808;5531;26470;283897;253980;146378;8479;83719;23475;283899;124446;9344;3835;4150;226;253982;83723;5595;6911;11151;8448;79447;112476;9961;10423;6693;79153,27,4.93298449215838000000
chr10,56428308,57782618,1354310,-1,1,65217;100463289,2,0.14767667668406800000
chr8,136775083,136975880,200797,-1,1,,0,0.00000000000000000000
chr1,144380451,148643339,4262888,-1,1,9557;148738;128077;84265;9659;10628;2330;653519;5174;388677;200035;51205;284615;645142;5565;148741;10623;100132406;9939;27246;284565;11126;400818;8799;149013;10401;644591;8515;51463;607;2702;200030;2703,33,0.77412308275516500000
chr13,33647580,34586839,939259,-1,1,90627;5983,2,0.21293381271832400000
chr12,21011584,21403480,391896,-1,1,338821;28234;10599,3,0.76550921673096900000
chr4,114939795,115205417,265622,-1,1,,0,0.00000000000000000000
chr12,78236267,79492908,1256641,-1,1,6857;89795,2,0.15915444426849000000
chr17,34497643,36391100,1893457,-1,1,26574;9326;6928;3975;414060;79893;729877;31;729873;6349;80179;284098;11072;9560;414062;101060321;414059;79922;11276;79154;11056;101060376;6871;284099,24,1.26752284313824000000
chr15,23620374,28526437,4906063,-1,1,2562;7681;23742;8924;7337;6638;2567;4948;8926;57194;283685;54551;4692;2558,14,0.28536119491331400000
chr15,95785466,96256463,470997,-1,1,,0,0.00000000000000000000
chr16,9863891,9935457,71566,-1,1,2903,1,1.39731157253444000000
chr2,78404255,78704298,300043,-1,1,,0,0.00000000000000000000
chr12,1350206,2797486,1447280,-1,1,144699;654429;93589;81029;196513;775;23085;79602,8,0.55276104140180200000
chr1,243669865,249212666,5542801,-1,1,127077;25909;200159;127069;84288;51029;81469;391196;55083;127623;343173;127064;26246;391189;79894;441932;401993;10472;57116;80851;79862;267002;343563;317705;391195;26245;114548;26188;159;284521;163882;391211;343169;84838;391194;3192;93474;127074;81472;127066;388759;127068;646627;343172;25893;391190;441933;403244;7678;284532;10000;26696;55657;391191;64754;81466;127059;127062;401992;343171;254879;116228;257044;81470;148823;64216;403239;401994;391192;51097,70,1.26289938967681000000
chr11,134296399,134939347,642948,-1,1,,0,0.00000000000000000000
chr5,106367056,107873409,1506353,-1,1,1946;64839,2,0.13277100387492200000
chr7,146471575,146549888,78313,-1,1,26047,1,1.27692720238019000000
chr10,116829,647331,530502,-1,1,22982;10771,2,0.37700140621524500000
chr15,30930422,32702923,1772501,-1,1,51621;653125;22909;161725;283710;54893;89839;4308;1139,9,0.50775711833166800000
chr6,84293228,90174426,5881198,-1,1,206412;55122;23036;1081;22881;3354;135293;51465;9096;57150;375519;10957;81833;57231;134701;4907;10492;57038;135295;8732;2570;2569;112609;23595;58528;9892;10559;154313;51167;1268;22832,31,0.52710349149952100000
chr6,99926688,104949848,5023160,-1,1,59336;100130890;84539;2898;892;85015;10973;6492,8,0.15926229704011000000
chr6,82279772,82788944,509172,-1,1,55603,1,0.19639728814624500000
chr6,75467654,77719905,2252251,-1,1,27145;1347;3617;55754;26054;4646;1303,7,0.31080017280489600000
chr2,200194727,200240771,46044,-1,1,23314,1,2.17183563547911000000
chr15,22753658,23084392,330734,-1,1,123606;23191;114791;81614,4,1.20943114406139000000
chr15,22698520,23146102,447582,-1,1,123606;114791;81614;23191;283767,5,1.11711373558365000000
chr7,71272468,71731585,459117,-1,1,83698,1,0.21780940370319500000
chr2,111392195,113094496,1702301,-1,1,10461;699;129804;55289;64682;84524;376940;10018;84910,9,0.52869615890491800000
chr16,67398231,68801053,1402822,-1,1,55512;146198;80152;54920;50855;5681;123904;9114;6560;181;100131303;1001;23659;54496;29800;55815;23644;4775;84080;1506;10664;64174;57610;64180;999;55794;84138;81577;51673;57215;10204;79567;65057;55282;9057;3291;388284;3931;80004;146206;5699,41,2.92268014045973000000
chr22,48517389,51178515,2661126,-1,1,85358;410;400935;85378;9701;56666;5600;49;9889;23774;80305;414918;79174;9997;1120;440836;1375;415116;83642;23542;644186;23209;6300;83933;79924;79087;6305;1890;348645;23654;25817;113730;29781;55586;91289;54456,36,1.35281080264520000000
chr5,60200530,60258284,57754,-1,1,91942;1161,2,3.46296360425252000000
chr2,51128900,51193802,64902,-1,1,9378,1,1.54078456750177000000
chr15,22753658,25360136,2606478,-1,1,7681;114791;23742;6638;123606;8926;81614;283685;54551;4692;23191,11,0.42202543048512200000
chr21,41607168,48095807,6488639,-1,1,386672;5211;4599;5316;54084;56894;6285;3689;8209;1409;54101;1826;386679;386676;386680;386681;326;53347;5152;1476;3275;54059;1292;5116;84221;29947;64699;11077;6612;63977;755;8566;1291;7307;7113;875;7032;150094;85395;386685;353323;7031;7109;386674;386675;386683;8568;4731;23076;6573;104;353332;4600;5822;4047;54039;54058;7033;386677;89765;353333;23181;25825;23275;90625;49854;23308;386678;89766;754;8888;25966;54020;80781;9619;386684;7327;10785;386682;54097;10841;81543;7226,83,1.27915884979886000000
chr15,93673690,94002097,328407,-1,1,,0,0.00000000000000000000
chr15,25092210,25114364,22154,-1,1,6638,1,4.51385754265595000000
chr16,83094008,84115604,1021596,-1,1,3281;8720;23417;54550;29948;1012;146167,7,0.68520236962556600000
chr22,29795295,30348867,553572,-1,1,4771;8508;84164;55954;8897;164633;29796;8563;4744;5988,10,1.80644974818091000000
chr10,81641918,88940418,7298500,-1,1,657;27069;84332;23063;54537;81619;5995;387694;79812;2746;119385;80195;10718;643161;26103;4143;387695;219348;6623;143241;92211;6441;54462;94233;2894;84293;340745;10974;11155;311,30,0.41104336507501500000
chr2,106878061,108439772,1561711,-1,1,84620;653489,2,0.12806466753451800000
chr5,12513599,13007031,493432,-1,1,,0,0.00000000000000000000
chr12,162578,2349320,2186742,-1,1,283358;6539;440073;5893;81029;775;4815;84318;6540;144699;654429;5927;93589;65125;196513;23085;79602,17,0.77741224159045700000
chr16,29652360,30198605,546245,-1,1,653808;5531;26470;283897;253980;146378;8479;83719;23475;283899;124446;9344;3835;4150;226;253982;83723;5595;6911;11151;8448;79447;112476;9961;10423;6693;79153,27,4.94283700537305000000
chr1,146155929,147825519,1669590,-1,1,9557;51205;51463;2703;5565;607;2702;2330;200030;149013,10,0.59894944267754400000
chr3,77188950,77955665,766715,-1,1,6092,1,0.13042656006469200000
chr15,22652047,23146102,494055,-1,1,123606;114791;81614;23191;283767,5,1.01203307324083000000
chr16,89827938,89862208,34270,-1,1,2175,1,2.91800408520572000000
chr11,81218941,88618453,7399512,-1,1,84233;60494;1740;58487;65084;220042;51501;27314;8726;5547;2915;54843;51585;220382;220388;11098;8301;338699;10873;23682;220047;55863;1075;60492;8322,25,0.33786011834293900000
chr16,28824778,29039612,214834,-1,1,11273;79874;7284;930;84901;27040;487;83985;25970,9,4.18928102628076000000
chr7,18454495,18658780,204285,-1,1,9734,1,0.48951220109161200000
chr15,23620374,28526437,4906063,-1,1,2562;7681;23742;8924;7337;6638;2567;4948;8926;57194;283685;54551;4692;2558,14,0.28536119491331400000
chr15,93394966,93454022,59056,-1,1,1106,1,1.69330804659984000000
chr2,219946405,220214707,268302,-1,1,130617;79065;5798;27013;8576;3300;389075;79411;10058;55139;79840;79137;151295;7277,14,5.21800061125150000000
chr16,2226865,2582969,356104,-1,1,64223;51005;527;21;4917;752014;899;84231;283871;1877;10921;57465;1632;80178;57524;1775;283870,17,4.77388628041246000000
chr21,44427596,45349402,921806,-1,1,1476;8566;8568;7307;5316;23076;56894;875;150094;1409;11077,11,1.19330965517690000000
chr21,35096843,35905170,808327,-1,1,9992;6526;101928147;3753;54065;539;1827;6453;64968,9,1.11341078548657000000
chr21,46468854,47143831,674977,-1,1,6573;80781;23275;104,4,0.59261278532453700000
chr10,81641918,82111218,469300,-1,1,80195;4143;311;84332;143241;6441;219348,7,1.49158320903473000000
chr15,22753658,23087552,333894,-1,1,123606;23191;114791;81614,4,1.19798498924808000000
chr2,49197130,50208414,1011284,-1,1,2492;9378,2,0.19776838158222600000
chr15,100729920,102465347,1735427,-1,1,390649;80213;204219;79705;55829;390648;26682;55180;5046;220;170691;22856;100128108;140460;6627;123283,16,0.92196329779356900000
chr15,81838493,82046395,207902,-1,1,,0,0.00000000000000000000
chr12,123917382,124179940,262558,-1,1,353116;57696;11066;2967;79867;1967;10959;196383,8,3.04694581768600000000
chr1,146155929,147825519,1669590,-1,1,9557;51205;51463;2703;5565;607;2702;2330;200030;149013,10,0.59894944267754400000
chr19,12441723,13662245,1220522,-1,1,773;9592;79973;10661;439;4125;163050;51398;84292;10224;55621;1777;2193;811;256126;22983;10535;7001;84261;147837;4066;90480;57474;8677;1725;5886;4784;90576;199699;83546;105372280;3726;112939;54831;29911;30000;2639;163049;79002;163051,40,3.27728627587213000000
chr22,51123497,51220923,97426,-1,1,49;11158;85358,3,3.07926015642642000000
chr1,80256465,80535350,278885,-1,1,,0,0.00000000000000000000
chr12,2561896,2769598,207702,-1,1,775,1,0.48145901339419000000
chr4,188476290,189753405,1277115,-1,1,205860;132625;339976,3,0.23490445261389900000
chr4,108467295,108859497,392202,-1,1,113612;166929;9061,3,0.76491195863356100000
chr7,64160070,64399985,239915,-1,1,7697;10793;51427,3,1.25044286518142000000
chr12,91293633,92964500,1670867,-1,1,574016;574028;11081;196477;694;4060;1833;1634,8,0.47879334501190100000
chr4,173061247,173557390,496143,-1,1,442117,1,0.20155479367843500000
chr2,31783048,31804469,21421,-1,1,6716,1,4.66831613836889000000
chr16,29652360,30190593,538233,-1,1,653808;5531;26470;283897;253980;146378;8479;83719;23475;283899;124446;9344;3835;4150;226;253982;83723;5595;6911;8448;79447;112476;9961;10423;6693;79153,26,4.83062168243121000000
chr1,145412876,145899418,486542,-1,1,148738;128077;27246;84265;11126;10628;653519;8799;5174;10401;200035;284615;8515;148741;10623;9939,16,3.28851363294433000000
chr20,60734,1813779,1753045,-1,1,140680;10616;1457;57761;83541;55968;10326;55321;140850;81623;140881;51378;9751;113278;245938;343637;245939;85508;85364;9491;128637;6939;400831;2280;642636;400830;55423;140809;284759;6666;27111;80023;128646,33,1.88243884212898000000
chr5,53280727,53885344,604617,-1,1,8988;112574;54622,3,0.49618188043009000000
chr10,84031362,84091184,59822,-1,1,10718,1,1.67162582327572000000
chr9,11356040,11659349,303309,-1,1,,0,0.00000000000000000000
chr7,110403670,110822345,418675,-1,1,54674;83943,2,0.47769749805935400000
chr12,116466583,116591447,124864,-1,1,23389,1,0.80087134802665300000
chr5,101478907,101976760,497853,-1,1,353189;133482,2,0.40172500718083400000
chr4,189247603,189571940,324337,-1,1,,0,0.00000000000000000000
chr7,133093359,133678632,585273,-1,1,60412,1,0.17086043607000500000
chr3,180022009,181442488,1420479,-1,1,8087;151613;339829;6657;131118,5,0.35199394007232800000
chr1,10427084,10448278,21194,-1,1,23095,1,4.71831650467113000000
chr16,62903911,63114003,210092,-1,1,,0,0.00000000000000000000
chr9,14853635,15041021,187386,-1,1,158326,1,0.53365779727407600000
chr2,50882091,50949412,67321,-1,1,9378,1,1.48542059684200000000
chr2,96739693,97758045,1018352,-1,1,81562;51239;56910;55683;23397;10865;54910;9391;26504;93082;51252;90342;151;151313;1844;26505;200539;23020;150771;431705;55654,21,2.06215532546703000000
chr4,39622397,47437263,7814866,-1,1,152573;79730;54502;55161;132789;10463;201895;2555;55584;323;285429;2557;2560;23244;22998;7345;8929;55728;389207;285525;399;3093;389206;386617;170712;2565;60558;10396,28,0.35829149213818900000
chr13,56825846,57709577,883731,-1,1,,0,0.00000000000000000000
chr1,41789989,42427921,637932,-1,1,100132074;59269;1907,3,0.47026955851093800000
chr17,34497643,36391100,1893457,-1,1,26574;9326;6928;3975;414060;79893;729877;31;729873;6349;80179;284098;11072;9560;414062;101060321;414059;79922;11276;79154;11056;101060376;6871;284099,24,1.26752284313824000000
chr6,116167330,116626488,459158,-1,1,221294;7259;23270;29940;2444;1300,6,1.30673972793679000000
chr15,64548268,64765786,217518,-1,1,53944;9325;9768,3,1.37919620445205000000
chr21,36576310,36932797,356487,-1,1,,0,0.00000000000000000000
chr3,144515141,144949460,434319,-1,1,,0,0.00000000000000000000
chr16,84929148,85164852,235704,-1,1,55625;9764;339145;83716,4,1.69704374978787000000
chr15,22698520,23146102,447582,-1,1,123606;114791;81614;23191;283767,5,1.11711373558365000000
chr1,43411529,43439009,27480,-1,1,6513,1,3.63901018922853000000
chr15,22652047,23165925,513878,-1,1,123606;114791;81614;23191;283767,5,0.97299358991823000000
chr7,154032328,154257417,225089,-1,1,1804,1,0.44426871148745600000
chr21,45474424,46798207,1323783,-1,1,7109;386674;386675;386683;386672;5211;54084;3689;8209;104;353332;5822;386679;386676;386677;386680;353333;386681;23275;326;23308;386678;754;29947;386684;7327;6612;755;386682;81543;7226;85395;386685;353323,34,2.56839678406506000000
chr15,29031708,30366138,1334430,-1,1,7082;321;23359;56160,4,0.29975345278508400000
chr8,65996961,66801792,804831,-1,1,5150;9650;55156,3,0.37274906160423700000
chr16,6727411,6977874,250463,-1,1,54715,1,0.39926056942542400000
chr1,67628179,67840151,211972,-1,1,149233;3595,2,0.94352084237540800000
chr19,58143557,58358451,214894,-1,1,100293516;79818;10520;90233;79891;7710;201516;54807;284309,9,4.18811134792037000000
chr4,53991822,54329440,337618,-1,1,152579;84708;81608,3,0.88857821561646600000
chr16,29652360,30199696,547336,-1,1,653808;5531;26470;283897;253980;146378;8479;83719;23475;283899;124446;9344;3835;4150;226;253982;83723;5595;6911;11151;8448;79447;112476;9961;10423;6693;79153,27,4.93298449215838000000
chr6,162336827,162602798,265971,-1,1,5071,1,0.37598084001639300000
chr15,22757282,23087552,330270,-1,1,123606;23191;114791;81614,4,1.21113028734066000000
chr15,29031708,30366138,1334430,-1,1,7082;321;23359;56160,4,0.29975345278508400000
chr4,189836620,190322833,486213,-1,1,,0,0.00000000000000000000
chr18,68541379,68873779,332400,-1,1,,0,0.00000000000000000000
chr3,64052,2088468,2024416,-1,1,27255;10752,2,0.09879392377851190000
chr16,34881227,35149159,267932,-1,1,,0,0.00000000000000000000
chr8,100508455,100612075,103620,-1,1,157680,1,0.96506465933217500000
chr1,29779610,30032837,253227,-1,1,,0,0.00000000000000000000
chr21,36381575,37094227,712652,-1,1,861,1,0.14032094205867700000
chr20,54144394,54456357,311963,-1,1,,0,0.00000000000000000000
chr7,111123961,111422268,298307,-1,1,83943;9732,2,0.67045024085924900000
chr19,13734266,14528125,793859,-1,1,5989;5566;117579;976;10212;113230;90379;90378;646457;79883;9466;55723;84245;65249;22859;28974;342979;79173;342977;81576;54862,21,2.64530603041598000000
chr2,50829467,50957527,128060,-1,1,9378,1,0.78088396064344800000
chr20,14357873,14708597,350724,-1,1,140733,1,0.28512448535030400000
chr11,83973938,84498330,524392,-1,1,1740,1,0.19069703580527500000
chr9,86328837,86592487,263650,-1,1,84267;55582;80318;3190,4,1.51716290536696000000
chr7,72721410,74142342,1420932,-1,1,5982;51085;9275;84277;7462;55695;135886;83451;1364;135892;6804;7461;155382;3984;26608;8468;9031;155368;2969;8326;7458;9569;2006;1365;114049,25,1.75940861350156000000
chr22,46234798,46307849,73051,-1,1,25814,1,1.36890665425525000000
chr15,22299419,23191662,892243,-1,1,123606;283694;114791;81614;390538;23191;283767,7,0.78453963774442600000
chr15,99416777,99500966,84189,-1,1,3480,1,1.18780363230351000000
chr2,124194249,124430468,236219,-1,1,,0,0.00000000000000000000
chr13,38262186,40198928,1936742,-1,1,51569;80209;387921;10186;7223;161003;341640,7,0.36143172399834400000
chr3,108500025,108913361,413336,-1,1,9626;27136;50852,3,0.72580176902084500000
chr16,29652360,30199384,547024,-1,1,653808;5531;26470;283897;253980;146378;8479;83719;23475;283899;124446;9344;3835;4150;226;253982;83723;5595;6911;11151;8448;79447;112476;9961;10423;6693;79153,27,4.93579806370470000000
chr19,6097017,7064912,967895,-1,1,653656;81616;8744;5623;970;7409;92359;8740;125981;284427;10045;56927;284428;84266;79085;10382;718;8570;4298;390877;79958;8192;125997;653657;5990;9322;2962;2015,28,2.89287577681463000000
chr13,92065636,92299097,233461,-1,1,2262,1,0.42833706700476700000
chr5,12428102,12699741,271639,-1,1,,0,0.00000000000000000000
chr1,144550532,149275156,4724624,-1,1,9557;148738;128077;84265;9659;10628;2330;653519;5174;388677;200035;51205;284615;645142;5565;148741;730262;10623;100132406;9939;728945;27246;284565;11126;400818;8799;149013;10401;644591;8515;51463;607;2702;200030;2703,35,0.74079969115002600000
chr11,81718390,81942189,223799,-1,1,,0,0.00000000000000000000
chr8,100587444,100742265,154821,-1,1,157680,1,0.64590720897035900000
chr10,19436504,19821969,385465,-1,1,340895,1,0.25942692592064100000
chr11,25673803,27496983,1823180,-1,1,143662;387758;55366;91057;159963;8424;63982,7,0.38394453646924600000
chr9,131298894,131401292,102398,-1,1,89891;2733;6709,3,2.92974472157659000000
chr5,101478907,101976760,497853,-1,1,353189;133482,2,0.40172500718083400000
chr22,28020154,29156292,1136138,-1,1,4330;150274;23760;23331;11200,5,0.44008738375091800000
chr3,3139112,3401595,262483,-1,1,51095;51185;3568,3,1.14293116125616000000
chr16,28824778,29039612,214834,-1,1,11273;79874;7284;930;84901;27040;487;83985;25970,9,4.18928102628076000000
chr18,52908457,53029825,121368,-1,1,6925,1,0.82394041262935900000
chr15,25068901,25082506,13605,-1,1,6638,1,7.35023888276369000000
chr2,131477993,131952001,474008,-1,1,130074;50649;344561;55041;205147,5,1.05483451756089000000
chr6,78438711,78693590,254879,-1,1,101928601,1,0.39234303336092800000
chr7,156656445,159128555,2472110,-1,1,9690;55112;64327;5799;3110;7434;64434;54892;10049;57488,10,0.40451274417400500000
chr16,28824778,29039612,214834,-1,1,11273;79874;7284;930;84901;27040;487;83985;25970,9,4.18928102628076000000
chr8,7225887,8387150,1161263,-1,1,503614;504180;503841;140596;100133251;653423;55894;245910;1673;157285;100131608;245908;100132396;503618;392188;100289462;245909;414325;10407;645836,20,1.72226274323732000000
chr8,12334334,15381999,3047665,-1,1,137868;91694;157773;10395;57604,5,0.16406002628241600000
chr17,1656,444049,442393,-1,1,100506388;400566;359845;8447;9501;55275,6,1.35626015782347000000
chr2,61252823,61319641,66818,-1,1,84542;5194,2,2.99320542368823000000
chr4,52685324,53854966,1169642,-1,1,64854;65997;132671;23142;6443;100288413;152579;339977,8,0.68396996687875400000
chr12,2797367,2835540,38173,-1,1,775,1,2.61965263406072000000
chr1,54377972,58193554,3815582,-1,1,200008;255738;606495;8613;23648;731;127428;388633;25973;115353;26027;163747;732;7268;199920;1600;1718;55001;7809;51668;199964;338094;9528;23358;5563;374977;51253,27,0.70762468215858000000
chr2,224358110,224665852,307742,-1,1,130340;7857,2,0.64989504195072500000
chr16,75875025,76117190,242165,-1,1,,0,0.00000000000000000000
chr14,87970115,88375399,405284,-1,1,,0,0.00000000000000000000
chr10,20102029,20528013,425984,-1,1,84898,1,0.23475060096153800000
chr2,106878061,108439772,1561711,-1,1,84620;653489,2,0.12806466753451800000
chr2,51193743,51266646,72903,-1,1,9378,1,1.37168566451312000000
chr15,30888776,32702923,1814147,-1,1,728498;51621;653125;22909;161725;283710;54893;89839;4308;1139,10,0.55122324706873300000
chr16,89343893,89584394,240501,-1,1,6687;100287036;29123,3,1.24739606072324000000
chr13,110874158,115105655,4231497,-1,1,7027;55795;79587;79774;3916;8874;22821;55608;8858;55647;10426;1284;101928841;2621;400165;113622;65110;121793;283489;23263;55739;643365;55002;3621;1282;100129836;6656;23250;2155;2159;55208;496;6011;122258;348013;8881;8451,37,0.87439504270001800000
chr6,116167330,116626488,459158,-1,1,221294;7259;23270;29940;2444;1300,6,1.30673972793679000000
chr6,91802307,94331240,2528933,-1,1,2045,1,0.03954236826361160000
chr14,27838974,28065369,226395,-1,1,,0,0.00000000000000000000
chr15,30930422,32509932,1579510,-1,1,51621;22909;161725;283710;54893;89839;4308;1139,8,0.50648618875474000000
chr5,21594585,23788673,2194088,-1,1,1010;56979,2,0.09115404669274890000
chr2,240141564,240218348,76784,-1,1,9759,1,1.30235465722025000000
chr15,100696411,102465347,1768936,-1,1,390649;80213;204219;79705;55829;390648;26682;55180;5046;220;170691;22856;100128108;140460;6627;123283,16,0.90449852340616100000
chr3,195684950,197322923,1637973,-1,1,622;255798;80235;200933;5062;5130;4241;26043;1739;84984;348793;255758;116211;131540;200931;375387;22916;7037;165918;54965;205564,21,1.28207241511307000000
chr16,83519857,84850691,1330834,-1,1,1012;83693;57707;54550;29948;161931;3281;123872;9013;93107;23406;9100;146167;9914;8720;23417;79786;58189,18,1.35253532747134000000
chr18,42314546,42555001,240455,-1,1,26040,1,0.41587823085400600000
chr9,204090,254781,50691,-1,1,81704;157983,2,3.94547355546349000000
chr9,182650,254781,72131,-1,1,81704;157983,2,2.77273294422648000000
chr15,22763424,23187811,424387,-1,1,123606;23191;114791;81614,4,0.94253594007356500000
chr1,564426,2085938,1521512,-1,1,85452;83858;126789;5590;81669;728661;29101;339453;643988;9636;126792;219293;8510;163688;84808;64856;26155;81399;6339;55052;254173;80772;65220;339456;375790;984;388581;54587;54973;84069;148398;401934;54998;9906;116983;339451;643965;51150;7293;118424;728642;2563;8784;55210;2782;54991;1855;83756;142678;441869;57801,51,3.35192887075488000000
chr9,78276042,84032536,5756494,-1,1,55312;29968;5125;7091;2776;442425;84131;9630;2650;158471;23230,11,0.19108853409731700000
chr9,84649221,84935187,285966,-1,1,,0,0.00000000000000000000
chr9,88103543,89996973,1893430,-1,1,81689;23287;2619;60560;51280;79670;401535;389766,8,0.42251363926841800000
chr17,3399888,3407599,7711,-1,1,443;84690,2,25.93697315523280000000
chr7,69188234,69974719,786485,-1,1,26053,1,0.12714800663712600000
chr11,126491297,126613878,122581,-1,1,84623,1,0.81578711219520200000
chr12,20944841,21164114,219273,-1,1,28234,1,0.45605250076388800000
chr13,20808567,21099089,290522,-1,1,51084,1,0.34420801178568200000
chr15,30888776,32702923,1814147,-1,1,728498;51621;653125;22909;161725;283710;54893;89839;4308;1139,10,0.55122324706873300000
chr1,146155929,147887713,1731784,-1,1,9557;51205;51463;2703;5565;607;2702;2330;200030;149013,10,0.57743921874783500000
chr2,161967492,162428730,461238,-1,1,10716;10010;10213,3,0.65042342565009800000
chr11,70471956,70537060,65104,-1,1,22941,1,1.53600393217007000000
chr9,11318956,11659349,340393,-1,1,,0,0.00000000000000000000
chr7,91859307,91926887,67580,-1,1,54467;889,2,2.95945546019532000000
chr14,79301363,79505244,203881,-1,1,9369,1,0.49048219304398200000
chr16,14910213,16292304,1382091,-1,1,4629;100288332;123811;89927;4363;9284;54820;23420;368;255027;23042;54700;123803;9665,14,1.01295790219313000000
chr2,106878061,108439772,1561711,-1,1,84620;653489,2,0.12806466753451800000
chr7,145912114,146192904,280790,-1,1,26047,1,0.35613803910395700000
chr6,137188360,137246630,58270,-1,1,340146;5191,2,3.43229792345976000000
chr2,106878061,108439772,1561711,-1,1,84620;653489,2,0.12806466753451800000
chr5,103380689,103770093,389404,-1,1,,0,0.00000000000000000000
chr16,29592791,30198605,605814,-1,1,653808;5531;26470;283897;253980;146378;8479;83719;23475;283899;124446;9344;3835;4150;226;253982;83723;5595;6911;11151;8448;79447;112476;9961;10423;6693;79153,27,4.45681347740396000000
chr14,40990358,41370928,380570,-1,1,,0,0.00000000000000000000
chr7,112637573,113086495,448922,-1,1,54329,1,0.22275584622718400000
chr22,47676232,50072585,2396353,-1,1,25817;348645,2,0.08346015799842510000
chr16,81525086,84564814,3039728,-1,1,3294;93517;1012;83693;57707;29948;54550;161931;3281;123872;9013;80790;93107;10200;146167;9914;8720;5336;23417;58189,20,0.65795360637530700000
chr2,50992226,51067114,74888,-1,1,9378,1,1.33532742228394000000
chr5,138403178,138550751,147573,-1,1,64374,1,0.67763073190895400000
chr3,70734112,71097793,363681,-1,1,27086,1,0.27496624789307100000
chr16,5047437,5274849,227412,-1,1,196483;9717;51172;56052;146556,5,2.19865266564649000000
chr3,147267658,156832953,9565295,-1,1,29909;53836;53829;84343;2992;64805;4311;344758;7104;1360;653659;170506;13;389161;389170;51714;6596;8833;5028;4071;344752;285315;25976;27230;7401;1356;56670;6747;51122;25937;116441;185;83939;131831;9819;152118;4154;9934;26084;116931;1359;23007;6478;9197;7881;5217;11342;5912;285313,49,0.51226857091182200000
chr17,1244153,1935766,691613,-1,1,10594;124935;727910;5345;8578;4641;146760;83547;114826;124997;1801;5176;1398;7531;5306;6117;51763,17,2.45802204412005000000
chr15,22757282,23221732,464450,-1,1,123606;23191;114791;81614,4,0.86123371730003200000
chr15,22753658,23146102,392444,-1,1,123606;23191;114791;81614,4,1.01925370243907000000
chr2,96739693,98202523,1462830,-1,1,81562;51239;56910;55683;23397;57730;10865;54910;9391;26504;93082;51252;90342;151;151313;1844;26505;200539;375248;23020;150771;431705;55654,23,1.57229479843864000000
chr15,25092210,25114364,22154,-1,1,6638,1,4.51385754265595000000
chr6,44975492,45527378,551886,-1,1,8464;860,2,0.36239368275332200000
chr1,109512744,110021158,508414,-1,1,343263;127003;84722;6884;6272;5686;284612;56900;22911;1952;57535;6301,12,2.36028118816555000000
chr16,89827938,89860628,32690,-1,1,2175,1,3.05903946160905000000
chr7,83706850,83771621,64771,-1,1,10371,1,1.54390081981134000000
chr16,29423111,30332569,909458,-1,1,654483;552900;283897;83719;23475;283899;548593;445329;226;613037;253982;83723;6911;11151;79447;112476;9961;107282092;79153;653808;5531;26470;253980;146378;8479;124446;9344;3835;4150;5595;79008;8448;6818;10423;6693,35,3.84844599750621000000
chr22,18646835,21661435,3014600,-1,1,54487;27037;9342;29801;65078;10587;1312;6545;8214;7290;421;2812;6899;5625;7625;79680;64976;11274;6576;3053;8218;5413;80764;23617;400891;1399;7122;150209;128977;8220;388849;84861;7353;51586;2928;128989;5297;9127;9993;54584;91179;85376;8216;85359;8318;728229;5902,47,1.55907914814569000000
chr10,56428308,57782618,1354310,-1,1,65217;100463289,2,0.14767667668406800000
chr2,241697100,241717683,20583,-1,1,547,1,4.85837827333236000000
chr3,3139112,3401595,262483,-1,1,51095;51185;3568,3,1.14293116125616000000
chr2,96725779,98204099,1478320,-1,1,81562;51239;56910;55683;23397;57730;10865;54910;9391;26504;93082;51252;90342;151;151313;1844;26505;200539;375248;23020;150771;431705;55654,23,1.55582012013637000000
chr13,20808567,21099089,290522,-1,1,51084,1,0.34420801178568200000
chr19,1357512,1903536,546024,-1,1,83855;374291;390874;54760;339366;126520;26528;6929;53615;81926;10975;10297;2593;148229;148223;57455;92840;6209;84939;399664,20,3.66284265893074000000
chr1,153852438,153991410,138972,-1,1,27173;10899;148327;200186;9909;5872;6232;91181;57459,9,6.47612468698731000000
chr3,885854,1604645,718791,-1,1,27255,1,0.13912249875137600000
chr15,30930422,32509932,1579510,-1,1,51621;22909;161725;283710;54893;89839;4308;1139,8,0.50648618875474000000
chr1,145379494,145814295,434801,-1,1,148738;128077;27246;84265;11126;10628;653519;8799;5174;10401;200035;284615;8515;148741;10623;9939,16,3.67984434258431000000
chr3,37094151,37189435,95284,-1,1,9209,1,1.04949414382268000000
chr15,22834298,23187967,353669,-1,1,123606;23191;114791;81614,4,1.13100102072842000000
chr12,70346263,73357964,3011701,-1,1,196446;4848;27345;55266;29953;23011;8549;7103;5801;64786;121278;196441;83591;5787,14,0.46485358274277600000
chr12,78941759,79739529,797770,-1,1,6857,1,0.12534941148451300000
chr1,105949860,106729171,779311,-1,1,,0,0.00000000000000000000
chr9,29942591,30364532,421941,-1,1,,0,0.00000000000000000000
chr17,29540004,29704731,164727,-1,1,2123;4974;4763;2124,4,2.42826009093834000000
chr4,53977997,54265558,287561,-1,1,152579;81608,2,0.69550460597925300000
chr8,4076508,4492446,415938,-1,1,64478,1,0.24042044727820000000
chr3,71783136,74676194,2893058,-1,1,5067;2850;727936;151987;317649;60675;55164;23429;55096;23024,10,0.34565501279269200000
chr15,23041321,23187967,146646,-1,1,123606,1,0.68191426973800900000
chr2,110783251,111128847,345596,-1,1,7851;4867,2,0.57871040174076100000
chr1,231834554,231885282,50728,-1,1,27185,1,1.97129790253903000000
chr8,144570919,144915939,345020,-1,1,65263;100130274;23144;286075;340371;84948;23513;93100;79792;225689;286077;22827;9831;7264;642475;1936,16,4.63741232392325000000
chr19,3575041,3858532,283491,-1,1,84839;6915;116541;4145;126326;23396;27134;23217;9546;58509;10362,11,3.88019372749047000000
chr2,1151167,1577713,426546,-1,1,7173;54221,2,0.46888260586197000000
chr8,76182139,79299590,3117451,-1,1,3174;5828;79776,3,0.09623246684550940000
chr16,29652360,30199006,546646,-1,1,653808;5531;26470;283897;253980;146378;8479;83719;23475;283899;124446;9344;3835;4150;226;253982;83723;5595;6911;11151;8448;79447;112476;9961;10423;6693;79153,27,4.93921111651782000000
chr7,118190108,119031806,841698,-1,1,,0,0.00000000000000000000
chr10,111788368,112010991,222623,-1,1,4601;120,2,0.89837977208105200000
chr8,13832152,14087333,255181,-1,1,137868,1,0.39187870570301100000
chr16,6951071,7454813,503742,-1,1,54715,1,0.19851431883781800000
chr2,152389040,152496411,107371,-1,1,4703,1,0.93135017835355900000
chr12,33545294,34096640,551346,-1,1,341359,1,0.18137430941731700000
chr7,110520354,110724718,204364,-1,1,83943,1,0.48932297273492400000
chr17,29526574,33259042,3732468,-1,1,6355;7756;6346;124842;2124;6354;4974;5717;8851;10693;55288;6347;400591;4642;26022;64149;6356;55352;55813;114659;84440;2123;4763;23512;40;162494;6357;124912,28,0.75017387958851900000
chr20,40482273,41813960,1331687,-1,1,11122,1,0.07509272073692990000
chr10,19436504,19821969,385465,-1,1,340895,1,0.25942692592064100000
chr22,21076930,21441944,365014,-1,1,80764;9342;3053;8216;400891;1399;6545;150209;9127;5297,10,2.73962094604591000000
chr1,961395,2397126,1435731,-1,1,85452;83858;126789;5590;81669;728661;29101;199990;339453;6497;643988;126792;219293;8510;163688;64856;55052;6339;80772;254173;65220;339456;11079;375790;984;388581;54587;54973;5192;401934;54998;9906;116983;643965;51150;7293;118424;728642;2563;8784;55210;2782;54991;1855;83756;142678;441869;79906,48,3.34324466073380000000
chr14,27171497,27377616,206119,-1,1,,0,0.00000000000000000000
chr2,212973847,213286482,312635,-1,1,2066,1,0.31986181969389200000
chr10,54998767,55280339,281572,-1,1,,0,0.00000000000000000000
chr1,146155929,147825519,1669590,-1,1,9557;51205;51463;2703;5565;607;2702;2330;200030;149013,10,0.59894944267754400000
chr3,76653526,76950280,296754,-1,1,6092,1,0.33697945099307800000
chr4,182074317,190807379,8733062,-1,1,285440;53842;205860;25854;55325;7098;55714;60684;836;80014;83891;57587;55602;2160;3818;79682;353322;291;100132463;27295;3660;441054;391723;201965;2195;339976;201973;4543;132625;55805;133121;256309;8470;2180;56977;3622;1635,37,0.42367728524084700000
chr5,73982720,73992951,10231,-1,1,3074,1,9.77421561919656000000
chr8,8079853,8353799,273946,-1,1,157285,1,0.36503544494170400000
chr14,27838974,28065369,226395,-1,1,,0,0.00000000000000000000
chr4,71553,541094,469541,-1,1,654254;54872;7700;170960;152687;255403,6,1.27784368138246000000
chr18,55426675,57554915,2128240,-1,1,23327;115701;3998;10892;55205;90701;30062;147372;101927322;2922;339302;5205,12,0.56384618276134300000
chr11,108887703,117343884,8456181,-1,1,5519;1410;56158;3316;341032;57569;3359;5450;4684;349633;8882;116519;4837;7704;5962;80975;345;1737;257160;64776;255239;120406;337;5049;85463;54494;9159;55216;23705;54827;22897;399948;57646;120379;399947;23387;57453;143903;6876;26521;79796;644672;25996;1813;85458;91893;23621;399949;54766;23235;5805;9183;10179;51092;54970;335;91894;120400;2230;6392;120376;9177;83875;84811;3606,65,0.76866850413916200000
chr15,22698520,23189431,490911,-1,1,123606;114791;81614;23191;283767,5,1.01851455762857000000
chr1,74107156,74360383,253227,-1,1,,0,0.00000000000000000000
chr15,33210701,33381383,170682,-1,1,342184,1,0.58588486190693800000
chr13,65640320,65848735,208415,-1,1,,0,0.00000000000000000000
chr1,159288837,159673076,384239,-1,1,325;26476;127385,3,0.78076405570491300000
chr1,98276375,98343122,66747,-1,1,1806,1,1.49819467541612000000
chr5,172461267,175167895,2706628,-1,1,1812;8614;133491;1482;8992;662;94081;51617;4488;91272;3274;153222;80315,13,0.48030242796572000000
chr15,22765637,23146102,380465,-1,1,123606;23191;114791;81614,4,1.05134506459201000000
chr1,222694152,224076368,1382216,-1,1,64853;9015;400823;164127;7159;55061;824;7100;375056;148362;388743;84976;79802,13,0.94051870329962900000
chr2,202506841,202519767,12926,-1,1,58538;65062,2,15.47269070091290000000
chr12,6043676,6220316,176640,-1,1,57101;7450,2,1.13224637681159000000
chr16,29652360,30199384,547024,-1,1,653808;5531;26470;283897;253980;146378;8479;83719;23475;283899;124446;9344;3835;4150;226;253982;83723;5595;6911;11151;8448;79447;112476;9961;10423;6693;79153,27,4.93579806370470000000
chr1,190572013,190946628,374615,-1,1,,0,0.00000000000000000000
chr8,21154011,22611638,1457627,-1,1,23039;10174;55909;64236;80346;55806;541565;79873;9796;649;6440;203190;10361;57805;55124;2675;157310;23516;661;1960;8822;2039;9046;64760;5533,25,1.71511641867227000000
chr17,53699750,55384413,1684663,-1,1,8161;162282;339210;8165;8526;55273;7706;59342;58488;9241;124540,11,0.65294958101412600000
chr14,87970115,88375399,405284,-1,1,,0,0.00000000000000000000
chr2,153568110,155493612,1925502,-1,1,56475;151188;100144595;55660;114805,5,0.25967254253695900000
chr2,129996786,130501440,504654,-1,1,,0,0.00000000000000000000
chr2,84374287,84674508,300221,-1,1,8802,1,0.33308795853721100000
chr10,65600116,69468487,3868371,-1,1,347731;29119,2,0.05170134922426000000
chr15,22753658,23191540,437882,-1,1,123606;23191;114791;81614,4,0.91348810866854500000
chr16,28796368,29076269,279901,-1,1,11273;79874;7284;930;84901;27040;487;83985;25970,9,3.21542259584639000000
chr15,83213997,85723256,2509259,-1,1,646;64506;4828;9640;123722;123207;83640;84942;53346;9455;100505679;6457;57538;23478;9154;5151;123720;50810;54993;8120;53339;57188;643707,23,0.91660526075626300000
chr17,14098298,15442178,1343880,-1,1,1352;64518;9953;201158;284040;100533496;5376;146822,8,0.59529124624222400000
chr18,58504748,68797247,10292499,-1,1,54495;28513;89778;5273;23556;23239;92126;2531;8792;8710;25914;5275;596;220158;9306;6317;6318;5055;284293;28316;54877;79839;5268;220441;57614;10666;89777;9525;1005;5271;220164,31,0.30119021629246700000
chr6,135028496,136934370,1905874,-1,1,64577;4602;9053;10767;54806;27115;4217;113115;9774,9,0.47222429184720500000
chr16,89887518,90036385,148867,-1,1,84501;22980;92806;10381;4157;54849,6,4.03044328158692000000
chr3,3175729,3397478,221749,-1,1,51095;51185,2,0.90192064000288600000
chr1,241212991,241959561,746570,-1,1,6000;128025;2271;1122;8564;23596,6,0.80367547584285500000
chr15,30611102,32927476,2316374,-1,1,728498;101059918;9824;51621;89832;653125;22909;161725;283710;54893;89839;643699;4308;728047;1139,15,0.64756382173172400000
chr20,33898988,34141829,242841,-1,1,11190;8200;55245;51614;140873,5,2.05896038972002000000
chrX,38511328,38676366,165038,-1,1,58526;7102,2,1.21184212120845000000
chr16,29652999,30198600,545601,-1,1,653808;5531;26470;283897;253980;146378;8479;83719;23475;283899;124446;9344;3835;4150;226;253982;83723;5595;6911;11151;8448;79447;112476;9961;10423;6693;79153,27,4.94867128176085000000
chr19,16848440,17871985,1023545,-1,1,284434;684;79709;55201;199786;4650;83878;57719;79575;23149;93343;23309;2063;83483;23025;376497;100130519;9002;115861;79016;79629;64981;27151;29086;55850;93323;84705;126549;25796,29,2.83329018264952000000
chr1,244385407,245706268,1320861,-1,1,55083;116228;257044;200159;3192;159;84288;51029,8,0.60566554694248700000
chr3,52811541,58216177,5404636,-1,1,2317;50650;26059;7474;5580;201627;93973;55349;91869;201626;375346;142686;23272;3697;3699;26060;285331;58515;7871;51460;55540;378;55802;3700;1776;353324;8820;54756;201625;776;7086;57408;55799;100526772;389125,35,0.64759217827065500000
chr20,60734,1935292,1874558,-1,1,140680;10616;1457;57761;83541;55968;10326;55321;140850;81623;140881;51378;9751;113278;245938;343637;140885;245939;85508;85364;9491;128637;6939;400831;2280;642636;400830;55423;140809;284759;6666;27111;80023;128646,34,1.81376089723551000000
chr1,95853659,101685110,5831451,-1,1,9890;178;54873;54112;148867;1806;54482;2135;391059;8556;51611;8634;1629;58155;163404;23443;64645;51375;163786;7412;127495,21,0.36011620435462800000
chr7,69650686,70274285,623599,-1,1,26053,1,0.16035946176950200000
chr16,29595483,30215621,620138,-1,1,653808;654483;5531;26470;283897;253980;146378;8479;83719;23475;283899;548593;124446;9344;3835;4150;226;253982;83723;5595;6911;11151;6818;79447;112476;8448;9961;10423;6693;79153,30,4.83763291396431000000
chr7,24876847,27632249,2755402,-1,1,26031;3181;136895;3201;64111;2128;3199;29887;3198;3204;3200;3207;3209;3206;11112;285941;54205;3202;3203;11335;3205;8935;9603,23,0.83472393501928200000
chr2,51083410,51226229,142819,-1,1,9378,1,0.70018694991562700000
chr7,71273635,71778771,505136,-1,1,83698,1,0.19796648823287200000
chr12,69396710,71660633,2263923,-1,1,5787;11052;376132;196446;4848;27345;8089;144453;7103;5801;117177;10818;10576;4069,14,0.61839559030938800000
chr1,1745834,1786848,41014,-1,1,2782,1,2.43819183693373000000
chr10,62149252,65109177,2959925,-1,1,84890;219790;84159;22891;29982;288;219621;9886;219623;983;1959;221037,12,0.40541567776210500000
chr1,146101791,147385641,1283850,-1,1,9557;51205;2703;5565;607;2702;2330;149013,8,0.62312575456634300000
chr13,49047330,51212889,2165559,-1,1,81617;2862;115761;51131;83852;283518;57213;22862;84650;57105;81602;5925;1102;55213;10206;3839;107303344,17,0.78501670931154500000
chr21,35593742,42076231,6482489,-1,1,8624;9992;6450;861;6493;106865373;3763;2114;1859;54093;3141;1826;874;7485;51227;101928147;7267;2078;5121;23562;10311;150082;3772;8208;54102;10317;54065;1827;3150;10281;873;54014;3753;53820;9980;150084;23515,37,0.57076841935250500000
chr15,26812822,26886114,73292,-1,1,2562,1,1.36440539213011000000
chr16,29652999,30198600,545601,-1,1,653808;5531;26470;283897;253980;146378;8479;83719;23475;283899;124446;9344;3835;4150;226;253982;83723;5595;6911;11151;8448;79447;112476;9961;10423;6693;79153,27,4.94867128176085000000
chr16,15048751,16249607,1200856,-1,1,4629;100288332;123811;89927;4363;54820;368;255027;23042;54700;123803;9665,12,0.99928717514839400000
chr16,21951379,22380197,428818,-1,1,7385;730094;1039;146177;55718;29904;255762,7,1.63239416255847000000
chr22,21101950,24440514,3338564,-1,1,7332;4320;9342;100423062;6545;613;391322;400916;150248;23532;129025;645426;29799;91227;23759;150223;9647;27156;653689;4282;23119;29802;100037417;9609;3053;164592;23753;80764;5594;7441;3543;400891;1399;2781;7621;66035;150209;2952;8940;9127;5297;266747;140883;150221;8216;440804;51233;6598;1652;23523;91319,51,1.52760288555199000000
chr15,22784523,23179948,395425,-1,1,123606;23191;114791;81614,4,1.01156982992982000000
chr1,246051268,249212668,3161400,-1,1,127077;84838;391194;25909;127069;93474;127074;81472;127066;388759;127068;646627;343172;81469;25893;441933;391190;391196;403244;127623;343173;7678;284532;343169;127064;26246;391189;79894;26696;55657;391191;64754;441932;401993;81466;127059;127062;57116;80851;79862;267002;343563;317705;391195;26245;343171;401992;254879;163882;114548;26188;81470;148823;64216;403239;284521;391211;401994;391192;51097,60,1.89789333839438000000
chr6,145947274,146589489,642215,-1,1,2911;84085;257218;7957,4,0.62284437454746500000
chr15,20604598,23300263,2695665,-1,1,727832;114791;100996331;123606;283694;81614;100287399;390538;23191;283767,10,0.37096597685543300000
chr1,145764484,147907892,2143408,-1,1,9557;51205;51463;2703;5565;607;2702;2330;653519;200030;149013,11,0.51320140635847200000
chr15,30509355,32515181,2005826,-1,1,728498;101059918;51621;89832;22909;161725;283710;54893;89839;4308;1139,11,0.54840250350728300000
chr1,145818702,147824207,2005505,-1,1,9557;51205;51463;5565;607;2702;149013;2330;653519;200030;2703,11,0.54849028050291600000
chr15,30652489,32510863,1858374,-1,1,728498;101059918;51621;89832;22909;161725;283710;54893;89839;4308;1139,11,0.59191529799706600000
chr16,29673954,30198600,524646,-1,1,653808;5531;26470;283897;253980;146378;8479;83719;23475;283899;124446;9344;3835;4150;226;253982;83723;5595;6911;11151;8448;79447;112476;9961;10423;6693;79153,27,5.14632723779463000000
chr15,31014508,32510863,1496355,-1,1,161725;283710;54893;51621;4308;22909;1139,7,0.46780342899913500000
chr2,50982113,51314430,332317,-1,1,9378,1,0.30091749744972400000
chr6,99218523,100260987,1042464,-1,1,51805;59336;100130890;84553;892;26235;85015;5454;25957,9,0.86333916566903000000
chr3,175863108,178552811,2689703,-1,1,10242;79718,2,0.07435765212739100000
chr20,61963016,62908674,945658,-1,1,54345;6919;10139;3785;198437;1137;140700;10287;2832;85441;4987;8771;55251;140685;79025;50861;140701;84619;6725;5753;7165;26205;51750;284739;56731;80331;54963;57473;24148;1917;4661;79144;54923,33,3.48963367306151000000
chr6,152664,2764734,2612070,-1,1,2295;56940;55770;340156;2762;3662;135458;94234;2296,9,0.34455431898838900000
chr16,21951379,22380197,428818,-1,1,7385;730094;1039;146177;55718;29904;255762,7,1.63239416255847000000
chr13,102490871,102896266,405395,-1,1,2259,1,0.24667299794028000000
chr1,191590110,201139395,9549285,-1,1,163486;5996;360023;23046;10877;259266;3075;23528;83479;8707;647219;140609;6738;779;252839;343450;23271;9928;55765;56956;6003;2165;388722;2848;23418;51022;3078;64407;51377;5788;2494;3080;127124;81494;79577;10878;5997;431704,38,0.39793555224291700000
chr10,131591468,135427143,3835675,-1,1,118472;10844;80313;256536;253738;85442;3632;27287;8433;93426;282973;282974;50632;92170;10570;84504;664;282969;118471;170394;196743;55844;54777;503542;101;1892;1571;84435;10539,29,0.75605988515711100000
chr16,21926361,22467007,540646,-1,1,7385;730094;1039;146177;55718;29904;255762,7,1.29474739478328000000
chr2,21187567,26038857,4851290,-1,1,375189;114818;22979;5443;375190;8648;79172;9540;109;1838;165324;54454;51639;391356;338;80304;55252;2281;51277;388931;100129278;653140;50618;1788,24,0.49471377716030200000
chr1,19077793,20549013,1471220,-1,1,4681;54896;8659;26279;30814;22977;126917;54546;100532736;5322;127733;391013;64600;3362;5320;23065;832;440574;23252;51154;23352;80834;255104;8574,24,1.63129919386632000000
chr2,17019,2167793,2150774,-1,1,7837;23040;642273;7173;54221;26751;285016;129787;52,9,0.41845400772001200000
chr21,38528931,39048130,519199,-1,1,10311;1859;3763;7267,4,0.77041750850829800000
chr2,171434816,174128517,2693701,-1,1,8604;79901;26003;254042;51776;1781;1746;3655;11069;140469;8520;389058;9874;79828;2571;1745;5163;80067;285141,19,0.70534925739716500000
chr15,22784523,23179948,395425,-1,1,123606;23191;114791;81614,4,1.01156982992982000000
chr3,84957324,89050858,4093534,-1,1,389136;8545;253559;285237;5449;55279;25978;3355,8,0.19543015887983300000
chr7,113907326,114310602,403276,-1,1,93986,1,0.24796913280234900000
chr15,31014508,32510863,1496355,-1,1,161725;283710;54893;51621;4308;22909;1139,7,0.46780342899913500000
chr17,6776676,7163031,386355,-1,1,1742;162515;37;1856;255877;10462;432;440400;201232;433;11337;23399;23587;124944;239;79142,16,4.14126904013149000000
chr1,10715339,12291603,1576264,-1,1,57085;4879;7133;9927;943;148345;57540;374946;54897;60672;284498;93611;4878;10747;5351;1185;55187;6723;90231;10459;26232;2475;10218;23435;26270;29914;4524;5394,28,1.77635218465942000000
chr12,45161827,47383364,2221537,-1,1,54407;196528;196527;4753;55089;9169;81539;440097,8,0.36011104023925800000
chr13,40489318,65000000,24510682,-1,1,729240;79612;2862;89890;26586;9724;283518;144809;57213;22862;341676;7178;64881;220108;84078;55213;10206;3839;55068;23143;55425;115761;540;729233;11215;51131;79758;8848;8803;3356;29079;10910;4752;10161;386618;84650;23078;28984;5925;11061;9617;647174;26747;51028;27253;81550;107303344;83852;144811;10562;144983;2308;79621;83446;729250;81624;1997;57105;1102;5100;2098;2963;26512;729246;10166;122183;115825;81602;94240;10240;253512;1361;220107;81617;220082;29103;220081;160857;387923;283514;55901;440138;11193;160851;220416;55270;3936;79024;9445;8600;23091;83548;80183,93,0.37942640682132000000
chr13,65000000,89589983,24589983,-1,1,7347;115207;114798;26050;64062;22894;4008;1203;23077;1602;84189;122060;440145;57626;26224;5457;730249;8796;79866;1910;11278;729420;170622;100129307;5101;688;54602;10464;79596;10253;9882,31,0.12606759427202500000
chr7,93223809,96162362,2938553,-1,1,1278;51666;64921;2791;2792;5444;7980;7979;5166;10165;10282;1780;55607;5445;5446;8910;23089,17,0.57851602472373300000
chr6,146669045,151048139,4379094,-1,1,80328;389434;57480;80329;134957;84918;389432;11104;135250;154064;387082;81706;79747;2911;116254;23328;10090;79465;5110;353091;23118;340152;9113;10981;348995;85313,26,0.59373011860444200000
chr10,68251535,68443894,192359,-1,1,29119,1,0.51986130100489200000
chr1,113709879,118344568,4634689,-1,1,4893;10905;270;476;4803;7252;10286;845;148281;7812;163259;440603;26191;3321;10717;80263;51592;6847;81839;914;8458;10100;4808;126868;54665;204851;56944;54855;80143;5738;79679;260425;9398;965;55356;10745;64858,37,0.79832756847331100000
chr20,41621525,48648223,7026698,-1,1,90203;140870;6789;4318;11317;140730;10564;6385;80336;10816;8839;78997;6407;112858;63935;6615;51098;6780;7125;164237;116092;64849;57468;259239;100;8202;128506;57119;10005;149699;60598;81031;27296;10406;26013;2139;90196;10953;140831;128497;55959;958;6590;5266;10955;280664;128486;128488;90204;23613;57580;11065;51604;140902;11142;6431;4605;57169;140832;149708;51006;63925;63916;84969;1434;7529;64405;55713;51526;79183;9825;140686;5476;3787;9334;5360;3745;3172;100526773;55661;6406;90199;259240;140825;8785;5740;57727;11122;55905;57158;55861;23315;391253;10110,94,1.33775494549502000000
chr2,163458524,163458834,310,-1,1,90134,1,322.58064516129000000000
chr2,104631780,104631877,97,-1,1,,0,0.00000000000000000000
chr8,158048,6999114,6841066,-1,1,389610;9172;728358;1669;26260;1667;157697;64478;1671;9639;79648;1670;169270;285;157695;9228;55326;9920;1672;1668;2055,21,0.30696970325969700000
chr16,15048751,16249607,1200856,-1,1,4629;100288332;123811;89927;4363;54820;368;255027;23042;54700;123803;9665,12,0.99928717514839400000
chr11,72889018,79803310,6914292,-1,1,5031;81544;10825;26005;26011;23201;100507050;28971;11309;871;56946;51400;58473;10008;100532726;5870;7351;726;9828;7352;5612;4975;5058;9789;341152;192134;80168;51773;374407;79053;80227;25987;57558;283212;6188;7069;92105;4718;100506127;51642;25884;84649;7405;387787;143570;4647;1207;282679;220032;10714;5029;51287;79731;9846;84957;65987;55331;254225;408;2615;7481;283209;283208;4135;283219;100287896,66,0.95454458677764800000
chr10,46984913,51804163,4819250,-1,1,5599;644168;267004;8031;195977;100652748;9721;642517;57705;474354;170371;118738;653145;5949;644054;414189;100133093;728113;5540;143162;6572;2662;26095;118461;282966;58504;100287932;8505;2658;1103;2074;170370;4477;196740;55753,35,0.72625408517922900000
chr20,67778,1171390,1103612,-1,1,140680;245938;10616;1457;343637;57761;83541;55321;140850;245939;85508;85364;9491;128637;6939;81623;140881;51378;400830;140809;113278;6666;80023,23,2.08406577674038000000
chr12,74295523,75278185,982662,-1,1,552889,1,0.10176439101135500000
chr16,29620719,30190539,569820,-1,1,653808;5531;26470;283897;253980;146378;8479;83719;23475;283899;124446;9344;3835;4150;226;253982;83723;5595;6911;8448;79447;112476;9961;10423;6693;79153,26,4.56284440700572000000
chr19,14603821,16577896,1974075,-1,1,4854;114770;4218;84941;58513;102724279;26993;9524;79852;30817;10270;26538;26532;85360;58525;10365;23476;126410;8907;57834;390892;4051;284433;84658;26659;11283;66002;3337;26333;26658;26664;388512;64926;126402;10755;8529;23581;126541;7171;26017;84449;6511;126370;117286;26539;10994;4713,47,2.38086192267264000000
chr16,29592813,30190539,597726,-1,1,653808;5531;26470;283897;253980;146378;8479;83719;23475;283899;124446;9344;3835;4150;226;253982;83723;5595;6911;8448;79447;112476;9961;10423;6693;79153,26,4.34981914790389000000
chr2,63260319,63538255,277936,-1,1,5013;23301;51057,3,1.07938518220022000000
chr20,60770,2146255,2085485,-1,1,140680;10616;1457;57761;83541;55968;10326;55321;140850;81623;140881;51378;9751;113278;245938;343637;140885;245939;85508;85364;5173;9491;128637;6939;400831;2280;642636;140901;400830;55423;140809;284759;6666;27111;80023;128646,36,1.72621716291414000000
chr2,50243374,50501960,258586,-1,1,9378,1,0.38671853851329900000
chr16,29620719,30190539,569820,-1,1,653808;5531;26470;283897;253980;146378;8479;83719;23475;283899;124446;9344;3835;4150;226;253982;83723;5595;6911;8448;79447;112476;9961;10423;6693;79153,26,4.56284440700572000000
chr16,29439299,30197316,758017,-1,1,653808;5531;26470;552900;283897;253980;146378;8479;83719;23475;283899;124446;9344;3835;4150;445329;226;253982;83723;5595;6911;11151;79008;79447;112476;8448;6693;9961;10423;107282092;79153,31,4.08961804286711000000
chr16,29620719,30190539,569820,-1,1,653808;5531;26470;283897;253980;146378;8479;83719;23475;283899;124446;9344;3835;4150;226;253982;83723;5595;6911;8448;79447;112476;9961;10423;6693;79153,26,4.56284440700572000000
chr12,3619040,5221334,1602294,-1,1,26290;3741;56341;894;4704;2251;84766;3736;8074;57097;57102;8798;10566;10635;3742;57103,16,0.99856830269601000000
chr9,76698559,83614583,6916024,-1,1,138199;55312;29968;2776;140803;9630;2650;26578;158471;23230;54981;55071;7091;84131;6096;442425;5125,17,0.24580597175487000000
chr16,14968878,16311041,1342163,-1,1,4629;100288332;123811;89927;4363;9284;54820;23420;123803;255027;23042;54700;368;9665,14,1.04309238147677000000
chr2,50814676,50886446,71770,-1,1,9378,1,1.39333983558590000000
chr21,26581876,32344663,5762787,-1,1,337979;54148;100288323;11096;2897;337882;9073;29104;337960;337971;337985;571;337970;337974;337977;643812;337969;337976;2551;10600;140258;26285;10694;337975;337880;100288287;9510;58494;337959;337966;388818;337968;337978;337973;254950;337879;56911;26046;351;284827;10069;116159;100131902;522;337972;337963;337967;643803;337878,49,0.85028303145682800000
chr15,22765628,23208901,443273,-1,1,123606;23191;114791;81614,4,0.90237844398373000000
chr2,165053775,166519701,1465926,-1,1,6326;2888;6328;151258;22837;80034,6,0.40929760438112200000
chr2,51260553,51649466,388913,-1,1,,0,0.00000000000000000000
chr19,327273,972343,645070,-1,1,566;25759;610;51298;400668;1675;126567;91978;284451;682;997;8174;3004;5064;54531;27006;79948;1820;5442;5657;126353;1991;91300;84634;5725;10025;55658;10272,28,4.34061419690886000000
chr15,22784523,23076420,291897,-1,1,123606;23191;114791;81614,4,1.37034638930856000000
chr5,121279020,124705860,3426840,-1,1,5480;4015;93166;28966;1456;100505841;57507;153241;9627;153443;133923;6643,12,0.35017683930384800000
chr15,22784523,23179948,395425,-1,1,123606;23191;114791;81614,4,1.01156982992982000000
chr10,134289383,135506704,1217321,-1,1,10844;3632;85442;27287;8433;93426;84435;50632;92170;84504;441581;118471;282969;54777;196743;503542;101;1892;1571;118472,20,1.64295202333649000000
chr15,30652489,32510863,1858374,-1,1,728498;101059918;51621;89832;22909;161725;283710;54893;89839;4308;1139,11,0.59191529799706600000
chr21,35821354,35831062,9708,-1,1,3753,1,10.30078285949730000000
chr14,80190271,85448614,5258343,-1,1,6400;145508;1734;2957;9369;7253;85439,7,0.13312178380147500000
chr2,51189339,51540487,351148,-1,1,9378,1,0.28478020663651800000
chr2,51189339,51547046,357707,-1,1,9378,1,0.27955840953629600000
chr12,204084,1685631,1481547,-1,1,144699;283358;6539;440073;5927;4815;5893;65125;6540;23085;84318,11,0.74246716438965500000
chr5,100001989,106461598,6459609,-1,1,353189;5066;133482;7903;83594;90355;23262;54826,8,0.12384650526061300000
chr1,61557457,61770053,212596,-1,1,4774,1,0.47037573613802700000
chr11,33880305,35016897,1136592,-1,1,55226;4005;25841;847;51074;4076;8050;26298;2001,9,0.79184087165843200000
chr14,29829325,30348258,518933,-1,1,5587,1,0.19270310425430600000
chr2,148657041,148790739,133698,-1,1,92;5000;55777,3,2.24386303460037000000
chr2,109205036,109549543,344507,-1,1,10913;5903;3987;165055,4,1.16107945556984000000
chr16,28543104,29133735,590631,-1,1,6799;8663;27040;7284;487;26471;25970;100507607;11273;79874;930;84901;112869;728734;83985;6817,16,2.70896718932802000000
chr14,67137027,67306444,169417,-1,1,10243,1,0.59025953711847100000
chrX,85986472,97538053,11551581,-1,1,4675;286499;1730;117154;27328;140886;90316;56062;53336;29935,10,0.08656823685000350000
chr6,121551339,128594787,7043448,-1,1,5570;10345;387104;154214;51020;7164;23493;135112;2173;387103;57515;387357;154215;9729;135114;3298;55862;60487;10924;134829;84870;352999;221322;81847;5796;2697,26,0.36913738839273000000
chr15,31014508,32510863,1496355,-1,1,161725;283710;54893;51621;4308;22909;1139,7,0.46780342899913500000
chr16,21951379,22380197,428818,-1,1,7385;730094;1039;146177;55718;29904;255762,7,1.63239416255847000000
chr15,22784523,23179948,395425,-1,1,123606;23191;114791;81614,4,1.01156982992982000000
chr5,173767675,180719789,6952114,-1,1,2916;2324;285679;51428;51491;30832;91522;9260;345462;53917;23138;3182;9945;3187;375484;3274;646019;57179;54825;84321;90249;26262;9794;79908;3101;80758;54732;345456;6940;10399;821;55819;2870;285676;4488;1627;10814;285659;2161;253314;117608;6620;202134;6569;134083;51149;10636;153579;10917;23061;27166;285596;1212;9509;23197;84851;57472;80108;10960;643836;64777;51720;1812;90933;255426;26693;11285;23567;54540;2264;11282;79930;192286;285598;85007;4245;5626;92304;5601;94081;4056;8878;55651;57396;83463;81786;64324;80230;114787;22838,90,1.29457025589626000000
chr7,16254552,16293262,38710,-1,1,729920,1,2.58331180573495000000
chr1,77498646,79102770,1604124,-1,1,26289;81849;11080;10964;10026;23032;374986;8880;54810;26009;91624;5737,12,0.74807184481997700000
chr17,2339575,2502610,163035,-1,1,5048;79066,2,1.22673045665041000000
chr22,22321488,22578983,257495,-1,1,8940,1,0.38835705547680500000
chr7,4438042,5895044,1457002,-1,1,60;221938;54476;221937;55698;57786;222962;9907;100533952;80028;56903;6624;26100;84629,14,0.96087719852134700000
chr7,5509127,5569096,59969,-1,1,60;80028,2,3.33505644583035000000
chr6,113106907,115325935,2219028,-1,1,222537;3066;4082,3,0.13519432832753800000
chr5,90194288,94773411,4579123,-1,1,57561;153643;83989;134187;7025;285600;84059;84250;79772,9,0.19654418542589900000
chr9,131349701,131362595,12894,-1,1,6709,1,7.75554521482860000000
chr1,7538304,7760462,222158,-1,1,23261,1,0.45013008759531500000
chrX,107010901,107143737,132836,-1,1,11043;1831,2,1.50561594748412000000
chr2,163704163,166723331,3019168,-1,1,6326;2591;151258;22837;2888;6328;80034;55137,8,0.26497366161803500000
chr16,21314250,21916073,601823,-1,1,440345;1428;23117;51108;10261;146183,6,0.99697087017279200000
chr18,42108088,42275522,167434,-1,1,26040,1,0.59725025980386300000
chr9,204104,8198999,7994895,-1,1,58524;10171;23081;55664;89882;50808;158358;81704;23189;6019;1761;169792;55064;6505;29126;2315;5991;26953;90865;7436;3717;90871;6013;57589;157983;3641;403313;169522;115426;6595;79956;9933;2731;55848;11172;10655;80380,37,0.46279532126438200000
chr9,131342955,131346014,3059,-1,1,6709,1,32.69042170644000000000
chr1,20540741,21049187,508446,-1,1,163933;57576;400745;127731;1650;55450;978;65018;79594,9,1.77009947959075000000
chr1,21050766,22890410,1839644,-1,1,2046;400745;9923;50809;84224;1889;401944;3339;249;998;54361;5909;84196;8672;23436;10136,16,0.86973349191474000000
chr7,70246372,70246976,604,-1,1,26053,1,165.56291390728500000000
chr17,1084040,1887407,803367,-1,1,10594;286753;124935;727910;5345;29;8578;4641;146760;83547;114826;124997;5176;1398;7531;5306;727857;6117;51763,19,2.36504611217538000000
chr12,116318069,116481349,163280,-1,1,23389,1,0.61244487996080400000
chr7,70061783,70206221,144438,-1,1,26053,1,0.69233858125977900000
chr18,3200244,3521862,321618,-1,1,8736;103910;9229;7050;10627,5,1.55463935476248000000
chr4,110601710,113303929,2702219,-1,1,55013;10692;79071;132720;55435;2028;54433;5308;80216;81579;3426;92610;345193;839;1950,15,0.55509934612997700000
chr11,62908346,64319844,1411498,-1,1,144097;387601;84304;79829;83707;28992;5331;25824;114571;10963;51504;283234;2286;85329;283238;2101;50801;387775;2011;83706;1351;54979;572;8986;3338;55611;7423;10313;11145;23769;283248;25923;5920;25858;26472;56834;117245;65998,38,2.69217526344352000000
chr3,93979,290767,196788,-1,1,10752,1,0.50816106673171100000
chr2,50956269,51477922,521653,-1,1,9378,1,0.19169831286314800000
chr15,20686219,23146103,2459884,-1,1,727832;114791;100996331;123606;283694;81614;100287399;390538;23191;283767,10,0.40652323442894100000
chr2,210196177,210472617,276440,-1,1,4133,1,0.36174215019534100000
chr7,68886188,69709432,823244,-1,1,26053,1,0.12147066969209600000
chr2,166230992,166243240,12248,-1,1,6326,1,8.16459830176355000000
chr16,21809010,22448156,639146,-1,1,730094;440345;29904;7385;1039;146177;55718;255762,8,1.25167019741968000000
chr18,60679560,68497696,7818136,-1,1,54495;28513;89778;5273;92126;2531;8710;25914;5275;596;220158;9306;6317;6318;5055;284293;79839;5268;10666;89777;9525;1005;5271;220164,24,0.30697854322309100000
chr11,31561220,31668393,107173,-1,1,26610,1,0.93307082940666000000
chr6,99156238,100644046,1487808,-1,1,51805;59336;100130890;84539;84553;892;26235;85015;5454;25957,10,0.67212973717038800000
chr1,146496005,147828667,1332662,-1,1,9557;51205;51463;5565;607;2702;2330;200030;2703,9,0.67534003370697100000
chr5,88024470,88027543,3073,-1,1,4208,1,32.54149040026030000000
chr6,98342090,103457328,5115238,-1,1,51805;59336;100130890;84539;84553;2898;892;26235;85015;10973;5454;6492;25957,13,0.25414262249381200000
chr15,22508324,23200707,692383,-1,1,123606;114791;81614;23191;283767,5,0.72214366903866800000
chr22,51059157,51193680,134523,-1,1,410;49;85358,3,2.23010191565755000000
chr7,111044035,111149166,105131,-1,1,83943,1,0.95119422434867000000
chrX,152652334,155235833,2583499,-1,1,3581;8263;1193;492;9130;2157;3054;7411;10134;139728;8517;30848;554;6901;474383;92002;57595;8266;6845;2539;246100;8260;55559;4204;100272147;65991;5365;8277;26576;4354;474382;139735;2316;8273;6535;11219;393;10251;55558;139716;1736;55217;8270;3654;537;3421;5973;100132963;1852;3897;215;474384;6748;2010;474381;6134;116442;2652;1485;1774;60343;728458;8269;83740;5956;2664;633;79184;4515,69,2.67079646634274000000
chr12,121886638,122596310,709672,-1,1,3242;54509;23067;5715;84876;144404;144406;84678;605;22877;283385,11,1.55001183645402000000
chr16,89329540,89470908,141368,-1,1,100287036;29123,2,1.41474732612755000000
chr1,144988715,145747269,758554,-1,1,148738;128077;27246;84265;11126;9659;10628;8799;5174;388677;10401;200035;284615;8515;148741;10623;100132406;9939,18,2.37293587536286000000
chr15,22729394,23086281,356887,-1,1,123606;114791;81614;23191;283767,5,1.40100367903566000000
chr16,14910228,16311041,1400813,-1,1,4629;100288332;123811;89927;4363;9284;54820;23420;368;255027;23042;54700;123803;9665,14,0.99941962274764700000
chr1,35771597,38887351,3115754,-1,1,29889;79693;127700;127703;339488;80149;1441;83931;27285;9967;10946;149175;4520;27095;54936;55700;79729;51118;63967;55194;284656;84967;5690;5453;3633;9202;192669;79932;64960;2275;23154;1296;64769;127687;192670;79753;7802;2899;284654;54955;55143;26523,42,1.34798832000216000000
chr13,106544330,114006490,7462160,-1,1,55795;79587;121793;79774;23263;3916;8874;55739;55608;23026;8858;55647;10426;3621;84945;55082;728215;1284;1282;100129836;400165;6656;23250;1948;3981;2155;2159;122258;8451;10673;8660,31,0.41542931269230400000
chr2,218536357,226294994,7758637,-1,1,130617;10290;8452;3623;79411;53632;10109;114790;84812;79065;130612;5798;7857;57590;8576;1412;23363;6556;1674;27148;617;55619;25953;7429;2181;285180;64320;9125;64114;10056;55139;2043;5270;7277;54738;130340;79840;80326;65080;29926;79843;8941;3300;255101;9654;1593;14;23549;55515;57695;7701;100996693;3577;3549;7145;23704;10058;58190;79137;6508;3579;116255;375307;27013;389075;57624;79586;130367;5077;7475;151278;151306;151295,73,0.94088691093551600000
chr16,15404452,18306854,2902402,-1,1,4629;100288332;123811;64131;89927;4363;54820;408050;255027;101059938;368;9665,12,0.41345065225285800000
chr9,77013100,78396926,1383826,-1,1,138199;55071;6096;54981;140803;26578,6,0.43358052240671900000
chr4,77846325,85015418,7169093,-1,1,901;113510;255119;132660;651;55752;51316;2712;152559;56978;9987;3184;10855;84803;58478;10563;65008;51138;246175;51023;2250;10983;22872;84142;79966;84779;55589;80144;441027;118429;153020;306;5593;27235;79725,35,0.48820680663509300000
chr4,83008007,85642725,2634718,-1,1,51138;113510;23001;132660;51023;51316;22872;84142;79966;441027;9987;3184;10855;84803;1040;27235;58478;4825;79725,19,0.72113979560620900000
chr10,55480316,56564594,1084278,-1,1,65217,1,0.09222727012814060000
chr5,59354365,59560052,205687,-1,1,5144,1,0.48617559690208900000
chr9,28670178,28745046,74868,-1,1,158038,1,1.33568413741518000000
chr14,75746308,76061709,315401,-1,1,2353;122953;55640;10538,4,1.26822679699811000000
chr7,31592602,32190975,598373,-1,1,223075;10842;5137,3,0.50135951989812400000
chr18,10377457,10975665,598208,-1,1,8774;63895;147495,3,0.50149780678292500000
chr14,76124060,76438023,313963,-1,1,23093;7043;11161,3,0.95552660663836200000
chr6,102511840,104048555,1536715,-1,1,2898,1,0.06507387511672630000
chr3,175060188,175699047,638859,-1,1,254827,1,0.15652906196829000000
chr16,29592812,30190538,597726,-1,1,653808;5531;26470;283897;253980;146378;8479;83719;23475;283899;124446;9344;3835;4150;226;253982;83723;5595;6911;8448;79447;112476;9961;10423;6693;79153,26,4.34981914790389000000
chr15,29085870,32899529,3813659,-1,1,728498;321;101059918;643699;4308;23359;1139;7082;51621;89832;653125;22909;653073;161725;283710;54893;89839;56160;728047,19,0.49820920014086200000
chr4,2968483,3072568,104085,-1,1,2868,1,0.96075323053273800000
chrX,114242518,114305500,62982,-1,1,3598,1,1.58775523165349000000
chr6,72755803,72970861,215058,-1,1,22999,1,0.46499083968045800000
chr16,83721284,86256142,2534858,-1,1,55625;1012;83693;57707;51659;29948;54550;9764;23199;161931;3281;123872;9013;23406;93107;83716;9100;339145;1327;146167;9914;8720;79786;3394;23417;58189;10328;404550,28,1.10459836408982000000
chr2,240189702,240774609,584907,-1,1,9759,1,0.17096735036510100000
chr14,36347796,39440281,3092485,-1,1,26257;161198;7080;6751;3169;51562;145282;89874;319089;253970;5083,11,0.35570099774129900000
chr8,143577912,144411600,833688,-1,1,1584;51337;137797;66004;286128;111188157;1585;57152;8581;116447;8000;575;23237;432355;4061;2738;2765;338328;8629;4062;79943;54742,22,2.63887689399392000000
chr16,29673983,30190538,516555,-1,1,653808;5531;26470;283897;253980;146378;8479;83719;23475;283899;124446;9344;3835;4150;226;253982;83723;5595;6911;8448;79447;112476;9961;10423;6693;79153,26,5.03334591669813000000
chr15,30419853,32509896,2090043,-1,1,728498;101059918;51621;89832;22909;161725;283710;54893;89839;4308;1139,11,0.52630496118979400000
chr1,168354280,174826764,6472484,-1,1,481;9588;8548;149281;2153;6402;51603;356;92346;57821;2328;91687;7292;730159;10560;80133;339416;8674;462;6401;5396;51430;23215;92344;27252;5279;149041;92342;26052;29922;6403;1805;2329;2326;2327;9293;55732;6375;57147;4653;22920;84614;284525;6846;55157;9910;8995,47,0.72615088735638400000
chr15,29253346,32509896,3256550,-1,1,728498;321;101059918;4308;23359;1139;7082;51621;89832;22909;653073;161725;283710;54893;89839;56160,16,0.49131749857978500000
chr3,112183973,115492920,3308947,-1,1,64422;151887;7634;201633;91653;205717;131450;1814;80218;79691;523;2596;152185;54847;54762;55779;254887;151888;57577;25871;26137;55032;29083;344807,24,0.72530626812699000000
chr17,1251811,1544865,293054,-1,1,8578;1398;7531;4641;5306;124935;51763,7,2.38863827144485000000
chr2,120584760,120726563,141803,-1,1,5775,1,0.70520369808819300000
chr2,120584760,120726563,141803,-1,1,5775,1,0.70520369808819300000
chr3,175125074,175699047,573973,-1,1,254827,1,0.17422422309063300000
chr5,115508329,115804461,296132,-1,1,51397;57556,2,0.67537449515756500000
chr13,23566962,23907017,340055,-1,1,6445;26278,2,0.58814015379865000000
chr22,18894864,21440484,2545620,-1,1,54487;27037;9342;29801;65078;10587;1312;6545;8214;421;7290;2812;6899;5625;7625;79680;64976;6576;3053;8218;5413;80764;23617;400891;1399;7122;150209;128977;8220;388849;84861;7353;51586;2928;128989;5297;9127;9993;54584;91179;85376;8216;85359;8318;728229;5902,46,1.80702540049183000000
chr3,93978,5521869,5427891,-1,1,51095;51185;3568;10752;9695;285362;27255;3708;57633;8553;6419;152330;55207,13,0.23950370410901800000
chr12,122212162,124354904,2142742,-1,1,56616;386653;2967;338442;79676;22877;9735;91574;196383;9026;55206;8843;8562;65117;23457;8099;5715;387893;10198;11066;79867;27198;1967;144404;79720;144406;51329;23545;54509;65082;23067;84660;353116;57696;6249;57605;55596;10959;254050;605;196385;3242;79369,43,2.00677449734966000000
chr16,21959691,22408072,448381,-1,1,7385;730094;1039;146177;55718;29904;255762,7,1.56117230658748000000
chr9,10365083,16601467,6236384,-1,1,7306;203238;4781;158219;100129385;11168;9350;8777;5789;340481;54796;286343;158326;6619,14,0.22448906289285600000
chr9,28606661,28670535,63874,-1,1,158038,1,1.56558224003507000000
chr20,14700040,14875770,175730,-1,1,140733,1,0.56905479997723800000
chr11,64296791,64517209,220418,-1,1,55867;116085;10235;9379;5837,5,2.26841727989547000000
chr7,42980502,53583154,10602652,-1,1,9263;816;23148;100130988;10268;7378;3486;154664;51619;644;27434;64005;58498;64951;80099;136288;165;10652;11055;23386;222068;4967;9238;28988;256979;10320;375567;168507;2887;100534592;83637;63979;5224;29881;5814;3484;285877;107;3364;54606;5478;83605;401335;2645;55744;5425;64759;1644;23242;55665;23072;285955;94239,53,0.49987493694973700000
chr5,60080096,60187882,107786,-1,1,79993;1161,2,1.85552854730670000000
chr3,17300010,17486512,186502,-1,1,9779,1,0.53618727949298100000
chr7,6036431,6202734,166303,-1,1,9265;5395;7965;84132;27102;100310846,6,3.60787237752777000000
chr1,146155982,147824177,1668195,-1,1,9557;51205;51463;2703;5565;607;2702;2330;200030;149013,10,0.59945030407116700000
chr3,112963935,113745013,781078,-1,1,152185;54847;54762;55779;91653;205717;254887;57577;80218;523,10,1.28028186685581000000
chr10,68322619,68535287,212668,-1,1,29119,1,0.47021648767092400000
chrX,95004421,155232894,60228473,-1,1,392509;23157;55998;541578;2158;55609;2556;23439;494119;8517;55859;331;3423;54830;4168;6901;5358;92002;474383;57595;51442;266740;9075;102723737;389895;84460;695;56000;644538;79649;51213;57526;100272147;728269;51186;3149;26576;474382;1730;3547;102723680;3358;8273;728695;57826;79921;83844;114824;203413;80823;2986;8862;23641;7512;79979;158763;9737;55217;8270;537;3421;11013;8450;6658;5716;4101;54457;91966;139804;441519;4100;54470;959;57631;2010;27316;54521;4534;79589;51634;728096;101928917;92129;653282;728072;9363;3920;100506164;827;84548;90293;100529097;55511;100133053;203547;139135;79836;60343;139081;51765;203522;139818;56180;27336;728458;8269;142684;7626;10046;340578;203447;63932;441509;4515;56001;4108;100130613;158798;2564;1193;79868;728075;11043;5354;56156;1260;1821;3054;84631;203562;102723631;170261;340596;441525;554;29944;2539;1478;7739;8260;100131755;57481;139170;1287;4204;65991;6170;10813;79710;26280;2316;11219;728062;6173;51209;23630;55558;2000;645188;51438;1736;255313;3654;1852;3897;727940;10857;541466;139741;56157;2182;84707;1069;154796;51309;80712;1485;159090;1774;2258;728343;9823;55285;643311;4107;203523;1831;54967;340542;89885;94121;286410;2491;84187;633;83550;4110;644353;3598;55916;340595;6594;2157;50814;9643;57187;139067;4104;203427;139728;100996648;10479;9016;55026;100528062;10178;4105;100507170;2332;6845;84968;4068;51114;64663;9142;246100;115201;100533997;79576;139212;6535;393;91851;27286;1038;158800;7224;55796;10761;100132963;1288;215;8471;90167;292;7737;55879;7319;6134;1678;401612;5063;116442;84443;29935;158983;10009;2747;2652;54885;340543;10495;27018;100129239;2239;2334;441518;26071;2664;59353;5956;728712;55922;28985;79184;441521;728049;728090;8933;10735;158521;3581;9949;4694;84528;282808;8263;9130;492;100129520;728082;90843;7411;347454;29071;9947;10134;79057;6906;340547;30014;30848;680;93380;159091;9338;8266;65109;64860;8776;494118;51566;56271;2892;55559;85012;57529;114928;8277;5365;63035;4354;286436;55086;10838;139221;139735;83692;3251;10251;139716;158931;27035;1641;100329135;7105;2717;84295;9459;5973;4109;139065;474384;6748;139760;347487;51270;4103;139378;186;139231;2719;3597;9131;9248;7547;474381;402415;11254;90161;64102;728042;56849;2273;728036;64648;54440;140597;4952;5631;83740;3188;100130086;286527;347468;347475,376,0.62428944529276000000
chr8,83591309,85441680,1850371,-1,1,138046,1,0.05404321619826510000
chr2,138721822,138771527,49705,-1,1,3176,1,2.01187003319586000000
chr12,81049199,81112850,63651,-1,1,4617;374462;4618,3,4.71320167789980000000
chr1,145899368,147824177,1924809,-1,1,9557;51205;51463;2703;5565;607;2702;2330;200030;149013,10,0.51953206785712200000
chr6,40416281,43608471,3192190,-1,1,100188893;23304;129685;9436;57510;23113;65989;222642;10591;5754;896;5528;705;2979;55173;4800;4201;116138;107080644;285852;9477;10930;6903;25844;5190;10817;7942;55809;6722;89845;4188;5961;340205;25862;9820;89953;116113;222643;401262;54676;84630;29964;10864;23506;93643;57497;79865;2978;27232;9587;54210;5225;51069;5429;24149;54209;647024;88745;221443;441150;9533;221424;285855;10695;171558,65,2.03621964857982000000
chr3,45313298,48488735,3175437,-1,1,9034;29072;64147;10675;51385;1232;29122;22908;100287362;5745;646424;79443;100132146;4057;377047;54585;259173;339906;8994;285231;4634;23276;83597;51372;10663;23395;22937;10803;259236;79442;4134;10201;22907;5364;6997;54859;6599;23218;1230;820;993;54716;1234;25930;729230;2829;151903;79714;84126,49,1.54309469846198000000
chr16,14968877,16194548,1225671,-1,1,4629;100288332;123811;89927;4363;9284;54820;23420;255027;23042;54700;123803;9665,13,1.06064351689809000000
chr13,102319131,106734832,4415701,-1,1,2259;2073;9358;79070;643677;196541;54841;7174;100533467;6555;267012;93081,12,0.27175753068425600000
chr2,109300532,109707372,406840,-1,1,10913;5903;3987;165055,4,0.98318749385507800000
chr8,87925926,93707150,5781224,-1,1,138009;55529;4683;4325;793;169200;8767;168975;1666;734;100130742;64168;862;115111;100127983;51633,16,0.27675800141976900000
chr2,190245,3326045,3135800,-1,1,7837;23040;7173;54221;26751;285016;7260;129787;52,9,0.28700810000637800000
chr2,51100412,51446873,346461,-1,1,9378,1,0.28863277540617800000
chr2,50909765,51314430,404665,-1,1,9378,1,0.24711798648264600000
chr16,29673984,30190539,516555,-1,1,653808;5531;26470;283897;253980;146378;8479;83719;23475;283899;124446;9344;3835;4150;226;253982;83723;5595;6911;8448;79447;112476;9961;10423;6693;79153,26,5.03334591669813000000
chr16,7070630,7382963,312333,-1,1,54715,1,0.32017109943553800000
chr15,72930195,75567135,2636940,-1,1,57184;1445;192683;84993;653641;10021;9377;5371;10620;56905;79748;55889;80381;161514;9399;57611;1543;1544;585;283677;25989;10066;83440;64220;60490;4756;1198;105376731;594855;8482;80153;3671;1583;54913;80125;4351;388135;342096;4016;27020,40,1.51690975145434000000
chr18,50291743,50716018,424275,-1,1,1630,1,0.23569618761416500000
chr16,29567295,30177999,610704,-1,1,653808;5531;26470;283897;253980;146378;8479;83719;23475;283899;124446;9344;3835;4150;226;253982;83723;5595;6911;8448;79447;112476;9961;10423;6693;79153,26,4.25738164479028000000
chr15,30419854,32861597,2441743,-1,1,728498;101059918;51621;89832;653125;22909;161725;283710;54893;89839;4308;728047;1139,13,0.53240656367193400000
chr12,3470327,4938979,1468652,-1,1,26290;56341;894;4704;3742;8074;57097;2251;57102;8798;10566;10635;84766;57103,14,0.95325509378668300000
chr10,81641948,88827989,7186041,-1,1,657;27069;84332;23063;81619;5995;387694;79812;2746;119385;80195;10718;643161;26103;4143;387695;219348;6623;143241;92211;6441;54462;94233;2894;84293;340745;10974;11155;311,29,0.40356018007690200000
chr7,155845627,155847652,2025,-1,1,,0,0.00000000000000000000
chr17,58120809,60316690,2195881,-1,1,10513;124773;342538;84669;388407;9969;6909;8493;63897;9496;762;54828;57508;83990,14,0.63755731754134200000
chr22,51123520,51178235,54715,-1,1,49;85358,2,3.65530476103445000000
chr20,14776880,14875770,98890,-1,1,140733,1,1.01122459298210000000
chr7,110980176,111149166,168990,-1,1,83943,1,0.59175099118291000000
chr15,51407592,64015525,12607933,-1,1,9236;8854;10681;100820829;283659;5597;145788;5873;83464;256764;3175;6095;114294;256586;10017;102;55329;3990;6938;9245;101928527;9960;27023;771;663;51762;283807;8925;302;440279;9488;81488;92483;23312;29767;83660;145773;366;55930;29766;145741;56204;54778;29106;10776;161582;9133;145781;26108;342035;79811;2958;4644;51187;4643;54816;1588;51065;64864;54629;54832;79664;388125;4734;123169;7168;84952;374618,68,0.53934296763791500000
chr2,72821730,74089809,1268079,-1,1,94097;8446;26056;7840;51002;23233;344022;84279;388960;9027;6697;2016;150726;10574;1961;10617;10322,17,1.34061048246994000000
chr10,76337573,78015165,1677592,-1,1,118881;142891;23522;51207;338599;132;7417;84858;83938,9,0.53648324503216500000
chr1,145632334,145747269,114935,-1,1,11126;27246;5174,3,2.61017096619829000000
chr1,174606489,174806036,199547,-1,1,9910,1,0.50113507093566900000
chr15,72943184,75567198,2624014,-1,1,57184;1445;192683;84993;653641;10021;9377;5371;10620;56905;79748;55889;80381;161514;9399;57611;1543;1544;585;283677;25989;10066;83440;64220;60490;4756;1198;105376731;594855;8482;80153;3671;1583;54913;80125;4351;388135;342096;4016;27020,40,1.52438211076618000000
chr5,87869570,88193292,323722,-1,1,4208,1,0.30890702516356600000
chr2,107312738,108403252,1090514,-1,1,84620,1,0.09169987730556420000
chrX,97196985,99816109,2619124,-1,1,57526,1,0.03818070469363040000
chr22,20754422,21440514,686092,-1,1,80764;9342;91179;8216;7625;400891;1399;84861;6545;150209;5297;51586;9127;3053,14,2.04054266774718000000
chr3,270649,1125759,855110,-1,1,10752,1,0.11694401889815300000
chr9,139132183,139389773,257590,-1,1,26086;56623;169714;10807;64170;6621;728489;23203;9919;158055;4851,11,4.27035210994216000000
chr9,28561981,28745046,183065,-1,1,158038,1,0.54625406276459200000
chr14,39471773,39561844,90071,-1,1,10484,1,1.11023525885135000000
chr17,14111801,15442036,1330235,-1,1,1352;64518;9953;201158;284040;100533496;5376;146822,8,0.60139749743466400000
chr1,9035049,9692653,657604,-1,1,84275;9563;765;199953;80045;6518;155184;80176,8,1.21653761230163000000
chr4,173320257,179819337,6499080,-1,1,11086;11341;116966;175;140458;442117;60559;3148;55247;51809;132851;3248;9464;26269;8819;7424;8001;80817;2823,19,0.29234907094542600000
chr4,136980110,145345092,8364982,-1,1,80155;23657;4258;2996;57484;80854;27309;1047;54510;2993;152586;8821;1998;166752;55534;84709;23158;84640;255520;7350;60592;25819;2994;83452;4717;3600;8467;2549,28,0.33472875374985900000
chrY,24412490,59293089,34880599,-1,1,10251;1617;57135;442868;9085;378951;9081;6845;9083;57055;57054;442867;253175,13,0.03727000215793310000
chr22,43593374,45096721,1503347,-1,1,84247;29780;64800;758;25813;85352;25830;55615;80274;150379;64098;80339,12,0.79821890754429900000
chr1,243382810,243840526,457716,-1,1,10806;9859;10000,3,0.65542825682300800000
chr13,92345560,92760953,415393,-1,1,2262,1,0.24073588144239300000
chr16,28837450,29042118,204668,-1,1,11273;27040;79874;7284;930;84901;487;83985;25970,9,4.39736548947564000000
chr1,86965512,91477367,4511855,-1,1,101927844;284695;84230;343472;56267;115362;9403;22802;9653;2634;2959;2633;2635;494115;388646;163351;5586;115361;55144;23507;84146;51100;1179;8543,24,0.53193198806256000000
chr5,128733883,133944172,5210289,-1,1,51735;645121;8974;96459;171019;10111;134548;56951;23338;100127206;54819;337876;5515;7320;27125;90624;91368;3596;3659;23176;27089;3308;3567;1437;6584;728637;116842;6583;3565;23105;23305;51128;3094;8572;3562;56990;7416;51265;6500;11127;134549;2661;6932,43,0.82529011346587500000
chr22,28967413,31385775,2418362,-1,1,23481;150274;150275;8897;652968;284904;2130;150280;23541;6948;83999;51537;55954;25770;23331;730005;200312;23762;339665;22880;150290;266629;84164;550631;25807;10634;3976;162;29796;8563;4744;11200;129080;4771;84133;8508;83874;7494;164633;5008;10291;10633;9514;5988,44,1.81941330536950000000
chr19,327273,1425982,1098709,-1,1,566;610;51298;400668;374291;126567;1943;1265;91304;997;26528;1153;3004;10347;55009;54531;116444;5657;1991;91300;84634;55658;91978;10272;1820;25759;22904;1675;284451;90007;6794;682;8174;255057;5064;57418;2593;27006;79948;23526;513;5442;126353;5434;5725;10025;84939;2879,48,4.36876370358302000000
chr3,9632462,9813339,180877,-1,1,4968;64419;7862;151835;8536,5,2.76430944785683000000
chr15,22784523,23179948,395425,-1,1,123606;23191;114791;81614,4,1.01156982992982000000
chr4,82099443,83608796,1509353,-1,1,3184;441027;153020;79966;5593;58478;9987,7,0.46377487572489700000
chr16,21951379,22380197,428818,-1,1,7385;730094;1039;146177;55718;29904;255762,7,1.63239416255847000000
chr1,145899368,147824177,1924809,-1,1,9557;51205;51463;2703;5565;607;2702;2330;200030;149013,10,0.51953206785712200000
chr2,50982113,51193685,211572,-1,1,9378,1,0.47265233584784400000
chr4,110107696,110915872,808176,-1,1,55013;10692;54433;10427;81579;645078;84570;3426;345193;839;1950,11,1.36108966363762000000
chr20,14190532,14524577,334045,-1,1,140733;23767,2,0.59872172910835400000
chr10,47011584,51664079,4652495,-1,1,5599;644168;267004;8031;195977;100652748;642517;57705;474354;170371;118738;653145;5949;644054;100133093;728113;5540;143162;6572;2662;26095;118461;282966;58504;100287932;8505;2658;1103;2074;170370;4477;196740;55753,33,0.70929683965270200000
chr21,39580621,48129895,8549274,-1,1,386672;5211;4599;5316;54084;106865373;56894;6285;3689;8209;1409;54101;1826;386679;7485;386676;386680;386681;326;53347;5121;5152;1476;150082;3772;3275;54059;10317;1292;5116;84221;29947;64699;11077;6612;63977;3150;755;8566;1291;7307;7113;875;54014;7032;150094;85395;386685;353323;8624;7031;7109;386674;386675;386683;8568;4731;6450;23076;6573;2114;104;353332;5822;4047;4600;54039;54058;7033;386677;89765;353333;23181;25825;23275;2078;90625;49854;23308;754;89766;386678;8888;25966;54020;80781;386684;7327;9619;10785;386682;54097;10841;81543;7226;150084,96,1.12290236574474000000
chr16,14916626,16361026,1444400,-1,1,4629;100288332;123811;89927;4363;9284;54820;23420;408050;368;255027;23042;54700;123803;9665,15,1.03849349210745000000
chrX,23411134,23532319,121185,-1,1,139411,1,0.82518463506209500000
chr15,31972675,32509896,537221,-1,1,161725;1139,2,0.37228626580122500000
chr8,139715503,139904073,188570,-1,1,169044,1,0.53030704778066500000
chr8,8760275,9025434,265159,-1,1,79660;90459,2,0.75426442247858800000
chr4,27428239,31020040,3591801,-1,1,5099,1,0.02784118607907290000
chr2,118843930,125952583,7108653,-1,1,3625;8685;51141;1622;29842;84365;130355;5899;5775;55240;80775;7247;165257;2019;200373;6344;79134;140738;23332;2736;57669;129684,22,0.30948197921603400000
chr10,116232768,116344700,111932,-1,1,3983,1,0.89339956402101300000
chr2,100103999,100848899,744900,-1,1,3899;51455,2,0.26849241508927400000
chr1,246778151,249212638,2434487,-1,1,127077;84838;391194;25909;127069;93474;127074;81472;127066;388759;127068;646627;343172;81469;25893;441933;391190;391196;403244;127623;343173;7678;284532;343169;127064;26246;391189;79894;26696;55657;391191;441932;401993;81466;127059;127062;57116;80851;79862;267002;343563;284521;317705;391195;26245;343171;401992;254879;114548;26188;81470;148823;403239;163882;391211;401994;391192;51097,58,2.38243210992706000000
chr3,99728812,99885222,156410,-1,1,84319;11259,2,1.27869062080430000000
chr17,34856084,36248888,1392804,-1,1,26574;284099;284098;11072;6928;79154;79922;3975;11276;79893;11056;6871;31;80179,14,1.00516655609835000000
chr17,14111772,15442066,1330294,-1,1,1352;64518;9953;201158;284040;100533496;5376;146822,8,0.60137082479512000000
chr22,51157524,51183834,26310,-1,1,49;85358,2,7.60167236792094000000
chr17,58172700,60251568,2078868,-1,1,10513;124773;342538;84669;388407;9969;6909;8493;9496;762;54828;57508;83990,13,0.62534032944852700000
chr1,243508931,243616786,107855,-1,1,10806,1,0.92717073849149300000
chr12,100230230,100527562,297332,-1,1,23074;56899,2,0.67264875627245000000
chr22,18739280,19010479,271199,-1,1,5625;8214,2,0.73746584611300200000
chr7,109106802,115147666,6040864,-1,1,5506;83943;286006;64418;93986;3475;54329;154743;54674;11179;29969;9732,12,0.19864708094736100000
chr20,63244,1313762,1250518,-1,1,140680;245938;10616;1457;343637;57761;83541;55321;140850;245939;85508;85364;9491;128637;6939;400831;81623;642636;140881;51378;9751;400830;113278;140809;6666;27111;80023,27,2.15910526677745000000
chr15,99307670,99519849,212179,-1,1,145814;3480,2,0.94260035158993100000
chr2,87374062,88297268,923206,-1,1,729857;5342,2,0.21663637368041400000
chr18,148963,4390986,4242023,-1,1,116;55556;10403;9663;103910;7050;9984;9097;7525;81035;23347;10627;494514;64863;1068;8736;27098;9229;84034;7298,20,0.47147316268676500000
chr17,5280549,5338397,57848,-1,1,708;4927;84268;9135,4,6.91467293597013000000
chr16,29478081,30190539,712458,-1,1,653808;5531;26470;283897;253980;146378;8479;83719;23475;283899;124446;9344;3835;4150;226;253982;83723;5595;6911;8448;79447;112476;9961;10423;6693;79153,26,3.64933792588475000000
chr16,29592812,30190538,597726,-1,1,653808;5531;26470;283897;253980;146378;8479;83719;23475;283899;124446;9344;3835;4150;226;253982;83723;5595;6911;8448;79447;112476;9961;10423;6693;79153,26,4.34981914790389000000
chr11,123938425,128100556,4162131,-1,1,219854;390275;53340;84623;26595;4013;23584;84897;403312;54414;219865;55572;283159;116337;399967;399968;56;79607;26492;26493;6484;9638;83480;54538;9538;114609;79684;29118;641654;6734;84881;90952;219858;63876;283162;3703;283160;4900;390271;64221;220296;100169851;219855;1111;219844;50937;28960;80071;160065,49,1.17728154159492000000
chr3,133143318,137314105,4170787,-1,1,53833;2047;11073;55573;55167;80723;5523;80254;8419;5096;80111;339855;58477;51421;51560;6578;7018;4690;6259;25847;10274,21,0.50350209684647000000
chr7,75063222,77310662,2247440,-1,1,5782;442590;5447;7784;57639;6369;7532;3092;105375355;10875;3315;83862;10344;4191;54103;113878;57414;51657;136853;222183;22932;100101267,22,0.97889153881749900000
chr15,22765657,23260484,494827,-1,1,123606;23191;114791;81614,4,0.80836332698094500000
chr1,145415190,145799602,384412,-1,1,148738;128077;27246;84265;11126;10628;653519;8799;5174;10401;200035;284615;8515;148741;10623;9939,16,4.16220097187393000000
chr7,143952376,147188768,3236392,-1,1,27010;7984;401427;346528;100142659;26047;135935,7,0.21629023925408300000
chr7,144618049,159119486,14501437,-1,1,27153;57541;84626;140545;1804;168537;389602;26;22976;11194;155061;392843;57180;6469;3110;116988;168391;51422;349136;55303;155051;63917;113763;155435;55340;83590;28959;3361;64327;168544;136051;7988;10061;9690;55112;6604;285973;26157;55365;7434;285888;8427;54892;285971;10049;57488;54480;58508;65999;5799;474344;643641;8454;9601;155054;1020;6009;23145;2636;26047;2020;100289678;653857;3638;5919;51667;9311;2146;170575;6522;3757;4846;29803;64434;10922;202865;100527949;7516;155066;136371;155038,81,0.55856533390449500000
chr22,23012042,23654192,642150,-1,1,2781;100423062;613;27156;9609,5,0.77863427548080700000
chr3,2324128,4475410,2151282,-1,1,51095;57633;51185;285362;3568;6419;152330,7,0.32538737366835200000
chr10,124335133,126921855,2586722,-1,1,196792;9679;2849;1755;64376;118672;399818;54764;340784;36;4942;51363;50624;399814;119587;390010;9184;118670;64077;23172;80007;3167;1488,23,0.88915623712173200000
chr16,28689085,29051191,362106,-1,1,100507607;8663;11273;79874;7284;930;84901;27040;487;83985;25970,11,3.03778451613616000000
chr22,40731210,40898910,167700,-1,1,23112;158;27352;57591,4,2.38521168753727000000
chr6,84332578,90401145,6068567,-1,1,57226;55122;22881;3354;135293;57150;134701;4907;10492;2570;2569;58528;154313;51167;375519;1268;9096;206412;23036;1081;51465;10957;81833;57231;57038;135295;8732;112609;23595;9892;10559;23195;22832,33,0.54378570756490000000
chr22,51123519,51304566,181047,-1,1,49;11158;85358,3,1.65702828547283000000
chr6,43538671,46563860,3025189,-1,1,55362;202500;64928;3326;22875;57510;55168;988;101929726;9587;53405;59084;441151;57505;11131;54676;5429;7422;2030;8464;347734;221409;221421;860;51302;10231;4794;221416,28,0.92556200620853800000
chr4,103073190,105502099,2428909,-1,1,4126;64116;4790;493856;1062;6870;80319;56898;7323;150159;133308,11,0.45287822639711900000
chrX,29934774,30026227,91453,-1,1,11141,1,1.09345784173291000000
chr4,131835382,145581078,13745696,-1,1,57575;80155;132430;64399;23657;4258;2996;57484;80854;27309;1047;54510;2993;152586;8821;1998;166752;55534;84709;23158;84640;255520;7350;60592;25819;2994;83452;4717;3600;8467;2549,31,0.22552513892348600000
chr7,101331040,102114142,783102,-1,1,79706;729597;222229;54784;5439;1523;10603;100289561;80228,9,1.14927557329697000000
chr15,30819486,32509896,1690410,-1,1,728498;51621;22909;161725;283710;54893;89839;4308;1139,9,0.53241521287734900000
chr12,101667774,105245865,3578091,-1,1,56994;4604;728568;29915;55332;4801;400;84102;374470;50511;3479;5367;7184;83468;79158;51019;5053;79023;7296;6996;121599;493861;55010;51559;50515;27340;55576;429,28,0.78254018693208200000
chr1,146507518,147824207,1316689,-1,1,9557;51205;51463;5565;607;2702;2330;200030;2703,9,0.68353270969834200000
chr16,29628020,30199805,571785,-1,1,653808;5531;26470;283897;253980;146378;8479;83719;23475;283899;124446;9344;3835;4150;226;253982;83723;5595;6911;11151;8448;79447;112476;9961;10423;6693;79153,27,4.72205461843175000000
chr7,108757362,117602088,8844726,-1,1,858;83943;286006;64418;3475;1080;83992;11179;136991;29969;9732;7982;7472;5506;93986;4233;22797;857;54329;154743;54674;26136;830,23,0.26004197303568300000
chr1,145115780,145888926,773146,-1,1,148738;128077;27246;84265;11126;10628;653519;8799;5174;388677;10401;200035;284615;8515;148741;10623;100132406;9939,18,2.32815018120769000000
chr1,779756,2234693,1454937,-1,1,85452;83858;126789;5590;81669;728661;29101;199990;339453;6497;643988;9636;126792;219293;8510;163688;84808;64856;26155;6339;55052;254173;80772;65220;339456;375790;984;388581;54587;54973;84069;148398;401934;54998;9906;116983;339451;643965;51150;7293;118424;728642;2563;8784;55210;2782;54991;1855;83756;142678;441869;57801,52,3.57403791366911000000
chr1,222571625,224069983,1498358,-1,1,64853;9015;400823;164127;7159;55061;824;7100;375056;148362;388743;84976;79802,13,0.86761641743828900000
chr5,132458925,137735620,5276695,-1,1,3950;9555;347732;4090;56951;5307;23338;2676;51306;10802;51307;140947;5515;10949;7320;819;91368;26223;27039;3578;10902;9879;51780;79770;9499;10112;23105;57113;7478;9547;51128;7045;8697;134553;153328;84105;7416;51265;6695;497189;6500;26249;100996485;4762;8382;995;6932,47,0.89070905178336100000
chr6,145664452,155966517,10302065,-1,1,389434;79624;80329;257218;134957;26271;26575;84918;389432;11104;26230;7957;81706;154043;50508;49861;2911;116254;79465;7432;23118;9113;348995;54516;85313;55005;80328;57621;23345;80177;26034;57480;9590;2099;51106;135250;4988;154064;387082;79747;84085;23328;25902;5110;353091;80129;22828;10090;340152;10981,50,0.48533958968420400000
chr16,1,1271680,1271679,-1,1,51764;3040;64285;30812;146325;84331;124093;3039;4833;8312;64714;89941;8131;388199;84264;58986;84326;79622;10573;51728;26063;9727;117166;6650;9028;4350;65990;64428;64788;10232;25823;3042;146330;339123;398;83986;8786;283948;79006;10273;84219;3049;57799;63922;3050;6755;9091;8912;197335;113000;390664;55692,52,4.08908222908454000000
chr16,29478080,30190538,712458,-1,1,653808;5531;26470;283897;253980;146378;8479;83719;23475;283899;124446;9344;3835;4150;226;253982;83723;5595;6911;8448;79447;112476;9961;10423;6693;79153,26,3.64933792588475000000
chr11,131000095,134868377,3868282,-1,1,4978;23310;112937;29087;83700;112936;219938;50863;89944;27034;27087;22997,12,0.31021523249856100000
chr15,22394059,23648792,1254733,-1,1,123606;114791;81614;23191;283767,5,0.39849115309791000000
chr3,132345576,134876575,2530999,-1,1,2047;66000;11073;55573;79876;84129;80254;8419;80111;339855;58477;27031;51421;51560;6578;7018;6259;25847,18,0.71118163223296400000
chr8,176818,8101641,7924823,-1,1,389610;401447;728358;503841;1669;504180;26260;55894;1667;245910;245908;100132396;503618;392188;157695;100289462;9228;245909;9920;1672;1668;9172;503614;140596;100133251;653423;645402;100131980;157697;1673;64478;1671;9639;100131608;79648;1670;169270;285;414325;55326;10407;645836;2055,43,0.54259886940061600000
chr1,243734763,243827143,92380,-1,1,10000,1,1.08248538644728000000
chr21,47179245,48108188,928943,-1,1,54039;54058;3275;10841;1291;54059;6285;23181;8888;1292;5116;84221;4047,13,1.39944000869806000000
chr21,44000000,48108188,4108188,-1,1,386672;5211;5316;54084;56894;6285;3689;8209;1409;386679;386676;386680;386681;326;5152;1476;3275;54059;1292;5116;84221;29947;11077;6612;755;8566;1291;7307;875;150094;85395;386685;353323;7109;386674;386675;386683;8568;4731;23076;6573;104;353332;5822;4047;54039;54058;386677;353333;23181;23275;23308;90625;386678;754;8888;54020;386684;80781;7327;10785;386682;10841;81543;7226,65,1.58220607236086000000
chr5,132651990,134517106,1865116,-1,1,23105;347732;51128;56951;5307;23338;134553;10802;5515;7320;819;84105;7416;51265;91368;6500;9879;100996485;79770;6932,20,1.07231936244180000000
chrX,62881678,62892238,10560,-1,1,23229,1,9.46969696969697000000
chr16,29651575,30177240,525665,-1,1,653808;5531;26470;283897;253980;146378;8479;83719;23475;283899;124446;9344;3835;4150;226;253982;83723;5595;6911;8448;79447;112476;9961;10423;6693;79153,26,4.94611587227607000000
chr1,146507518,147824207,1316689,-1,1,9557;51205;51463;5565;607;2702;2330;200030;2703,9,0.68353270969834200000
chr3,182374816,184236952,1862136,-1,1,8893;110599583;1181;105374250;94032;200909;55324;1857;55689;10057;55486;110599564;131408;5437;23200;54165;170572;9718;89857;90113;285242;1981;54800;23101;79929;27074;8646;5708;84002;7066;56922;10195;1173,33,1.77215842451894000000
chr7,111134591,111333930,199339,-1,1,83943,1,0.50165797962265300000
chr2,233021920,233036850,14930,-1,1,129563,1,6.69792364367046000000
chr2,169965237,172772568,2807331,-1,1,79901;26003;10324;130507;1781;29081;493911;100526832;9360;140469;6741;79675;4036;129881;389058;79828;9874;2571;151230;8604;129880;80067;285141,23,0.81928351163436000000
chr16,21837492,22645765,808273,-1,1,730094;440345;100132247;29904;7385;1039;146177;55718;255762,9,1.11348517147053000000
chr2,77886126,87131321,9245195,-1,1,56888;129303;8673;83439;388969;51255;84173;130120;9168;100526767;5968;10618;10713;347730;65055;51652;25885;54884;284948;5967;925;129293;2677;51318;10791;926;55818;5068;822;10989;7844;84913;64795;1496;8802;8869;4144;10578;55037;6439;1768,41,0.44347360980487700000
chr17,43622196,44212416,590220,-1,1,246744;162540;104909134;1394;4137;284058,6,1.01657009250788000000
chr7,146264584,146593413,328829,-1,1,26047,1,0.30410943073755700000
chrX,31743060,31864864,121804,-1,1,1756,1,0.82099110045647100000
chr4,22324464,24776373,2451909,-1,1,166647;10891;1665,3,0.12235364363033000000
chr4,72647749,74208199,1560450,-1,1,2638;285521;26057;10886;9508,5,0.32042039155371800000
chr16,87219866,89561087,2341221,-1,1,54758;863;81631;23174;115992;4597;146429;763;124245;197320;100287036;1535;51693;100129697;348180;9780;81620;79791;100506581;353;197322;2588;8140;54971;27189;1013;333929;161882;57338;84627;390748;29123,32,1.36680817402543000000
chr15,99366173,102461141,3094968,-1,1,145814;390649;4205;123355;204219;80213;79705;390648;55829;3480;55180;145748;220;5046;23336;22856;170691;100128108;64927;140460;6627;123283,22,0.71083125899847800000
chr9,11775361,14110242,2334881,-1,1,7306;8777;4781;286343,4,0.17131494067577700000
chr7,101759560,101893297,133737,-1,1,1523,1,0.74773622856801000000
chrX,32543770,32984400,440630,-1,1,1756,1,0.22694777931597900000
chrX,47341781,47378063,36282,-1,1,7592,1,2.75618764125462000000
chr15,96835722,98741095,1905373,-1,1,145946;7026;91947,3,0.15744948626856800000
chr1,57349192,64560883,7211691,-1,1,54596;4774;51361;731;83941;4070;127795;27022;3725;85440;732;1600;29929;114803;7398;4919;115209;5236;1573;10207;84455;84938;27329;55277;163782;23421,26,0.36052570749356800000
chr12,126794370,127561060,766690,-1,1,,0,0.00000000000000000000
chr5,151737,10390486,10238749,-1,1,84246;10299;50834;79192;81037;11336;65980;50805;134147;153571;11044;64979;22948;108;79888;10723;11076;23379;4726;9037;10016;7015;6389;134145;133957;9319;340024;348932;153478;153572;85409;79844;57491;4552;6550;170690;79072;6715;6531;54888;134111;55722;134121;389257,44,0.42974000046294700000
chr16,15048751,16276115,1227364,-1,1,4629;100288332;123811;89927;4363;54820;368;255027;23042;54700;123803;9665,12,0.97770506548994400000
chr16,82132097,82738733,606636,-1,1,3294;1012;10200,3,0.49453049275018300000
chr12,70149399,71670676,1521277,-1,1,117177;196446;4848;27345;5787;7103;5801,7,0.46013973786496500000
chr10,127120633,135427143,8306510,-1,1,253738;85442;387718;27287;8433;5791;55760;282973;282974;10570;50632;1793;664;282969;7390;594857;56647;119467;196743;118856;101;1892;1571;399823;642938;84435;10539;503542;10844;80313;256536;3632;8038;4288;93426;92170;84504;26098;118471;170394;92565;55844;54777;4255;118472;118611,46,0.55378251515979600000
chr12,1,3288886,3288885,-1,1,283358;6539;440073;7004;55846;5893;81029;83695;2288;775;2305;4815;6540;84318;7289;144699;654429;10867;5927;83714;93589;65125;196513;23085;79602,25,0.76013603394463500000
chr4,111774551,115284551,3510000,-1,1,55435;132720;79642;80216;287;817;55345;92610;51574;63973,10,0.28490028490028500000
chr3,171986865,174350923,2364058,-1,1,64778;57552;2693;22871;1894;8743;83893,7,0.29610102628615700000
chr1,146106723,147830830,1724107,-1,1,9557;51205;51463;2703;5565;607;2702;2330;200030;149013,10,0.58001040538667300000
chr1,191297696,203481588,12183892,-1,1,2331;360023;7139;1118;10440;134;10877;5317;5877;3075;23528;1116;127833;149345;59349;140609;6051;6738;252839;9928;127829;8497;2165;388722;91156;51022;3078;5778;64407;51377;5788;2494;81494;431704;6003;10878;89796;23271;5549;163486;5996;23046;1465;4660;259266;1999;83479;8707;26254;647219;29089;4608;3898;779;343450;23612;51706;55765;7135;56956;51094;92703;2848;7832;25802;4656;9283;59352;3080;127124;79577;10765;55705;5997;23418,75,0.61556684842577400000
chr1,220314892,220399243,84351,-1,1,25782;55699,2,2.37104480089151000000
chr7,69882310,70188336,306026,-1,1,26053,1,0.32676962088188600000
chr8,9578305,10065347,487042,-1,1,4482;8658,2,0.41064220334180600000
chr15,31014508,32510863,1496355,-1,1,161725;283710;54893;51621;4308;22909;1139,7,0.46780342899913500000
chr19,3898968,4853624,954656,-1,1,126259;51341;100131094;5605;1613;55620;10226;80700;10036;91039;84954;79187;56005;51548;440503;1938;116844;10501;56961;6455;170961;55527;84699;27231;729359;126282;84717;10148;55702;85300;51588;148022,32,3.35199275969564000000
chr12,23955681,24209282,253601,-1,1,6660,1,0.39432021167109000000
chr6,165074611,170919482,5844871,-1,1,168002;10846;387263;55274;55780;285800;2853;4301;113402;5134;401285;3834;5689;54346;253769;100128124;168090;79981;7058;83887;6991;6196;8635;28514;84498;6953;6862;51660;64094;1235;11116;6908,32,0.54748855877229800000
chr17,87009,1551720,1464711,-1,1,51031;50628;29928;286753;124935;29;400566;8578;359845;55178;4641;55275;83547;100506388;1398;79850;7531;5306;727857;9501;64359;51763,22,1.50200278416698000000
chr1,22375673,24074319,1698646,-1,1,2048;646262;2046;6924;729059;6135;9923;713;714;23028;80818;7798;10236;998;54361;1870;3352;259283;6920;55616;3399;712,22,1.29514919530026000000
chr9,93301497,95959417,2657920,-1,1,89846;4814;64768;4783;83744;84270;23299;10558;4958;3376;65268;6850;55035;549;4969;401541;54829;54769;203328;4920;1842,21,0.79009150012039500000
chr6,73831133,86072154,12241021,-1,1,4199;7162;134728;135228;90025;6785;1303;55754;55510;134701;9324;115004;4646;167681;80759;26503;441161;26054;51167;56479;9096;594;1347;25998;5238;25821;112611;340168;83699;23033;101928601;55023;112609;154288;7272;100129128;27145;3617;9892;55603;1915;167691;3351;22832,44,0.35944714088800300000
chr2,72268158,73158176,890018,-1,1,2016;23233;56603;6697,4,0.44942911266963100000
chr17,41521548,42732146,1210598,-1,1,1659;4356;10900;10014;92579;92591;3674;50964;2535;1845;2896;5539;56970;5697;84336;23131;2118;78995;4222;6521;284067;79089;4355;7343;162417;51629;124801;284069;146894,29,2.39551031804117000000
chr5,175775326,177047120,1271794,-1,1,51428;51491;6620;6569;9260;10636;53917;253314;27166;1212;23197;57179;54825;90249;10960;26262;51720;3101;23567;80758;11285;54540;2264;345456;54732;79930;192286;285598;2870;1627;83463;64324;114787;2161;22838,35,2.75201801549622000000
chr1,10374259,11945068,1570809,-1,1,100526739;57085;4879;148345;57540;374946;1325;5195;54897;284498;93611;4878;10747;5226;1676;1185;6723;378708;23095;2475;10459;26232;10218;23435;26270;29914;4524;5394,28,1.78252098122687000000
chr15,22784523,23179948,395425,-1,1,123606;23191;114791;81614,4,1.01156982992982000000
chr17,43717703,44210822,493119,-1,1,246744;162540;104909134;1394;4137;284058,6,1.21674484252280000000
chr22,20659547,21505417,845870,-1,1,80764;9342;3053;91179;8216;7625;400891;1399;6545;150209;51586;9127;84861;5297,14,1.65510066558691000000
chr16,29673954,30198600,524646,-1,1,653808;5531;26470;283897;253980;146378;8479;83719;23475;283899;124446;9344;3835;4150;226;253982;83723;5595;6911;11151;8448;79447;112476;9961;10423;6693;79153,27,5.14632723779463000000
chr16,15048751,16276115,1227364,-1,1,4629;100288332;123811;89927;4363;54820;368;255027;23042;54700;123803;9665,12,0.97770506548994400000
chr9,76792356,77124539,332183,-1,1,6096,1,0.30103888519280000000
chr16,28837450,29042118,204668,-1,1,11273;27040;79874;7284;930;84901;487;83985;25970,9,4.39736548947564000000
chr2,61180163,65523986,4343823,-1,1,4190;150684;54812;29094;10575;57162;150962;5013;10097;130872;7360;9792;84542;200728;5194;9736;23301;5861;84140;6509;23177;51542;51057;7514;10678;339804,26,0.59855109197589300000
chr2,51083410,51226229,142819,-1,1,9378,1,0.70018694991562700000
chr15,22784523,23179948,395425,-1,1,123606;23191;114791;81614,4,1.01156982992982000000
chr10,49390457,51047667,1657210,-1,1,143162;5599;6572;644168;267004;118461;282966;58504;8505;57705;474354;170371;1103;2074;170370;196740;55753,17,1.02582050554848000000
chr10,298729,412134,113405,-1,1,22982;10771,2,1.76359067060535000000
chr5,151737,18997054,18845317,-1,1,54463;10299;84246;7204;50834;79192;81037;11336;65980;50805;134147;153571;1501;56172;11044;64979;54491;22948;23194;108;79888;10723;11076;23379;90441;1611;4651;4726;9037;10016;7015;6389;134145;133957;9319;340024;348932;153478;153572;651746;85409;79844;83853;57491;4552;6550;90268;170690;1767;79072;6715;441061;6531;54888;134111;10409;55722;134121;389257,59,0.31307512630326100000
chr19,35608666,36233508,624842,-1,1,51599;26330;79171;2867;1340;53822;4099;2116;388533;199746;5348;7392;23354;53827;27033;57817;2864;79713;5349;2865;495;93099;374897;10430;11045;163175;933;148109;9757,29,4.64117328860736000000
chr5,124846125,126253930,1407805,-1,1,4001;51808;389320;501;115123;65983,6,0.42619538927621400000
chr16,29673954,30198600,524646,-1,1,653808;5531;26470;283897;253980;146378;8479;83719;23475;283899;124446;9344;3835;4150;226;253982;83723;5595;6911;11151;8448;79447;112476;9961;10423;6693;79153,27,5.14632723779463000000
chr2,149106702,149198502,91800,-1,1,55777,1,1.08932461873638000000
chr15,22765628,23217514,451886,-1,1,123606;23191;114791;81614,4,0.88517900532435200000
chr10,46287821,51861466,5573645,-1,1,119016;5599;253725;644168;267004;8031;195977;100652748;9721;83849;642517;57705;474354;170371;118738;653145;5949;644054;414189;100133093;728113;5540;143162;6572;2662;26095;118461;282966;58504;100287932;8505;2658;1103;2074;170370;4477;196740;55753;387680,39,0.69972163637978400000
chrX,291285,8508592,8217307,-1,1,414;28227;51481;286530;57502;8226;8228;3730;425054;1438;3563;26609;5613;25878;347527;415;416;207063;4267;293;412;7499;9189;438;64109;51480;6473;8227;8623;8908,30,0.36508311056164700000
chr15,22765628,23165915,400287,-1,1,123606;23191;114791;81614,4,0.99928301443714100000
chr15,30954726,32509926,1555200,-1,1,161725;283710;54893;51621;4308;22909;1139,7,0.45010288065843600000
chr10,88517374,92680511,4163137,-1,1,657;9060;142910;84896;27063;3433;643161;3437;8513;57559;340654;55328;10974;728118;355;387700;24138;643414;3434;54537;9023;79812;2746;119385;643418;9585;5728;53354;10556;118932;6623;439996;9562;59;100144748;3988;3363,37,0.88875288033999400000
chr2,96600559,98024837,1424278,-1,1,81562;150763;51239;56910;55683;23397;10865;54910;9391;26504;93082;51252;90342;151;151313;1844;26505;200539;375248;23020;150771;400986;431705;55654,24,1.68506429222385000000
chrX,605776,819243,213467,-1,1,6473,1,0.46845648273503600000
chr8,65482369,68704986,3222617,-1,1,56260;80124;55156;9650;23678;286187;79848;100129654;84675;137872;9420;10565;5150;57094;100533105;1392;23212;10987;27319;254778;85479;157777;4603,23,0.71370566219938600000
chr16,30361048,33660219,3299171,-1,1,100862671;146547;22928;26000;730183;112755;24150;3681;1489;29108;90835;10847;79724;6810;51333;493829;79798;729355;9810;197407;79759;93129;339105;115509;10295;78994;79077;54620;9739;5652;260434;7041;64319;9726;51327;146542;729264;1731;3687;80270;3684;9274;5261;2521;10308;23361;65988;3683;146540;1339;6524;92595;653550;84148;79001;283933;29895;124411;10421;64755,60,1.81863868226291000000
chr21,36753919,48090317,11336398,-1,1,386672;5211;4599;5316;54084;106865373;56894;6285;3689;8209;1409;54101;1859;1826;386679;874;7485;386676;51227;386680;386681;7267;326;53347;5121;5152;10311;1476;150082;3772;3275;54059;8208;10317;1292;5116;84221;29947;64699;11077;6612;3150;63977;10281;755;8566;1291;7307;7113;875;54014;7032;150094;53820;85395;9980;386685;23515;353323;8624;7031;7109;386674;386675;386683;8568;4731;6450;23076;6493;6573;3763;2114;104;54093;353332;3141;5822;4047;4600;54039;54058;7033;386677;89765;353333;23181;25825;23275;2078;90625;49854;386678;754;89766;23562;23308;8888;25966;54020;80781;386684;7327;9619;10785;386682;54097;10841;873;81543;7226;150084,112,0.98796813591054200000
chr15,98596519,102480888,3884369,-1,1,145814;390649;4205;123355;204219;80213;79705;390648;55829;26682;3480;55180;145748;220;5046;283777;23336;22856;170691;100128108;64927;140460;6627;123283,24,0.61786097046907800000
chr1,146506310,147824207,1317897,-1,1,9557;51205;51463;5565;607;2702;2330;200030;2703,9,0.68290617552054500000
chr1,146506311,147824207,1317896,-1,1,9557;51205;51463;5565;607;2702;2330;200030;2703,9,0.68290669369965500000
chr1,146506311,147824207,1317896,-1,1,9557;51205;51463;5565;607;2702;2330;200030;2703,9,0.68290669369965500000
chr4,166034214,190114926,24080712,-1,1,1363;53842;205860;1182;25854;7098;55714;60684;60559;80014;83891;132851;55602;80817;3818;54969;291;100132463;27295;91351;441054;2195;442117;201965;11275;6307;57630;133121;56977;3622;1635;55601;285440;11341;175;55325;140458;3148;51166;836;51809;57587;9464;8819;9848;8001;2160;2823;79682;353322;11086;116966;7092;23022;84869;3660;4750;391723;339976;55247;201973;50859;4543;11199;55805;132625;3248;256309;8470;2180;26269;7424,72,0.29899448155851900000
chr17,72493591,73958308,1464717,-1,1,100130520;80022;342510;283987;9121;85302;30833;124599;283985;91107;3691;3021;85451;2905;347741;29115;3993;30850;201292;57409;60386;9400;54868;92736;146723;6613;2885;201294;326624;10476;79902;23163;10871;283989;146722;3396;100131439;51;2232;64978;79637;57513;51155;100130933;51081;9772;643008;124590;23558;9368;26151;23510;2584,53,3.61844643026605000000
chr7,134104659,136768417,2663758,-1,1,136319;767558;57016;441282;4850;26266;669;78996;231;29062;647087;346673;800;389558;55281;1129;23165;340351,18,0.67573706019841100000
chr15,72963962,73350363,386401,-1,1,4756;83440;585,3,0.77639550622281000000
chr1,163574086,165092429,1518343,-1,1,5087,1,0.06586127113570520000
chr1,146347096,147786706,1439610,-1,1,9557;51205;51463;2703;5565;607;2702;2330;200030;149013,10,0.69463257409993000000
chr16,15048751,16249607,1200856,-1,1,4629;100288332;123811;89927;4363;54820;368;255027;23042;54700;123803;9665,12,0.99928717514839400000
chr16,29673954,30198600,524646,-1,1,653808;5531;26470;283897;253980;146378;8479;83719;23475;283899;124446;9344;3835;4150;226;253982;83723;5595;6911;11151;8448;79447;112476;9961;10423;6693;79153,27,5.14632723779463000000
chr16,28837450,29042118,204668,-1,1,11273;27040;79874;7284;930;84901;487;83985;25970,9,4.39736548947564000000
chr1,146507518,147824207,1316689,-1,1,9557;51205;51463;5565;607;2702;2330;200030;2703,9,0.68353270969834200000
chr7,87609823,91976630,4366807,-1,1,889;219557;54467;5218;261729;7978;85865;79689;79846;9069;8321;53616;1595;219578;10142;401387;26872;6717,18,0.41220049340399100000
chr17,34630969,36462752,1831783,-1,1,26574;9326;84311;6928;3975;79893;729877;31;729873;80179;284098;11072;79154;101060321;79922;11276;11056;101060376;6871;284099,20,1.09183238407606000000
chr1,246640287,246805417,165130,-1,1,163882;64216;64754,3,1.81675043904802000000
chr6,140101753,148610448,8508695,-1,1,134637;83443;257218;134957;389432;57211;7957;8504;84946;79747;84085;2519;7402;51390;2911;51534;23328;4829;153918;5325;8676;9749;3097;10981,24,0.28206440588127800000
chr22,20708912,21561492,852580,-1,1,80764;9342;3053;91179;8216;7625;400891;1399;6545;150209;51586;9127;84861;5297,14,1.64207464402168000000
chr22,50918687,51186189,267502,-1,1,23542;85358;644186;1890;410;113730;9997;29781;55586;79924;91289;440836;1120;1375;49,15,5.60743471076852000000
chr1,146155983,149275102,3119119,-1,1,9557;728945;284565;644591;51205;645142;51463;2703;5565;607;2702;730262;2330;200030;149013,15,0.48090502478424200000
chr8,9653350,9785591,132241,-1,1,,0,0.00000000000000000000
chr2,118086228,128074140,9987912,-1,1,8886;3625;51141;8685;1622;29842;84365;130355;5899;5775;55240;80775;54520;339761;2071;7247;165257;2995;101929926;2019;200373;6344;23332;79134;140738;10746;2736;57669;274;129684,30,0.30036307888976200000
chr7,142230096,142460460,230364,-1,1,100463482;5644,2,0.86819121043218500000
chr15,49716395,60143976,10427581,-1,1,9236;8854;10681;100820829;2553;283659;5597;145788;5873;256764;373509;3175;256586;10017;102;55329;3990;6938;9101;11001;9245;196951;101928527;663;388121;440279;9488;81488;92483;23312;29767;145773;366;55930;29766;56204;54778;29106;10776;161582;9133;145781;26108;342035;79811;2958;54822;3067;4644;51187;56986;54816;4643;1588;84888;64864;2252;54629;79895;23431;4734;123169;84952;374618,64,0.61375692022915000000
chr3,196599079,197177523,578444,-1,1,80235;205564;22916;1739;4241,5,0.86438790963343000000
chr5,173907668,174550786,643118,-1,1,4488,1,0.15549246017060600000
chr14,89388949,98550490,9161541,-1,1,801;3705;9950;327657;9252;122509;5104;1112;51527;9321;79820;8111;440193;57062;51676;866;145270;161176;80017;64112;51156;624;78990;4707;7443;145567;57718;79890;122481;5700;145258;79789;55102;623;3429;9623;55148;123041;256394;341947;51218;55727;56967;12;55775;53981;5265;8115;5641;26175;83982;1113;57578;5267;4287;90141;55051;84520;55671;56659;90050;23405;10516;10914;123036;145264,66,0.72040282306219000000
chr8,76069471,83405958,7336487,-1,1,347051;51101;23462;3612;619279;79752;64089;5375;55824;2167;646480;3574;5569;11075;7163;3174;92421;2171;79776;65986;28957;646486;5828,23,0.31350154372249300000
chr9,73307216,80890936,7583720,-1,1,138199;51104;55312;2776;442425;80036;216;140803;138240;9630;2650;26578;158471;23230;9615;55071;54981;117531;84131;7763;6096;301;23670;5125;138241,25,0.32965352096332700000
chr20,2800800,4010802,1210002,-1,1,64949;80025;1059;55317;11237;2797;5786;80332;60493;6614;9762;64773;25876;3704;64096;64601;116835;65992;83959;25943;551;57506;54976;100288797;5020;8455;994;22888,28,2.31404576190783000000
chr3,56890500,70765444,13874944,-1,1,8309;55079;57415;6314;2317;11102;200845;50650;8618;8801;26018;131177;84541;201627;80145;407738;56203;2272;23150;201626;4286;7110;166336;142686;26060;9861;285203;5162;7871;378;9039;57406;200844;115286;1776;132204;353324;201625;8820;54756;10550;11170;132203;54899;56999;9223;5793;151647,48,0.34594734220188600000
chr17,34450463,36347393,1896930,-1,1,26574;9326;6928;3975;414060;79893;729877;31;729873;6349;80179;284098;11072;9560;414062;101060321;414059;79922;11276;79154;11056;101060376;6871;284099,24,1.26520219512581000000
chr2,111399243,113098686,1699443,-1,1,10461;699;129804;10018;84910;64682;376940;55289;84524,9,0.52958528176584900000
chr2,111399243,113098686,1699443,-1,1,10461;699;129804;10018;84910;64682;376940;55289;84524,9,0.52958528176584900000
chr2,111399243,113098686,1699443,-1,1,10461;699;129804;10018;84910;64682;376940;55289;84524,9,0.52958528176584900000
chr2,111399243,113098686,1699443,-1,1,10461;699;129804;10018;84910;64682;376940;55289;84524,9,0.52958528176584900000
chr15,31014508,32438943,1424435,-1,1,161725;283710;54893;51621;4308;22909;1139,7,0.49142291505052900000
chr1,11816673,19201956,7385283,-1,1,93190;440567;63036;11223;391004;353238;4878;51032;5081;440560;842;10630;11330;441871;388595;51702;127707;11240;7133;943;60672;284498;23400;391002;440561;23013;391003;653619;5351;343066;23341;79363;55160;6390;1185;284723;55920;343069;6248;4524;23569;1969;81569;114827;8659;645382;79814;440563;400736;55092;374955;9696;55672;26099;126767;55187;84966;645425;80834;23254;343071;400735;27129;4879;79180;128272;126755;9927;729528;4237;7709;65122;29943;645414;441873;9249;1188;23207;54751;149563;90231;727684;390999;84301;348487;343068;1187;55707;54455;65121;7799,91,1.23218026986914000000
chr3,66894,7883440,7816546,-1,1,2917;51095;51185;3568;10752;9695;285362;27255;3708;57633;8553;6419;152330;55207,14,0.17910724250839200000
chr13,23567089,24910774,1343685,-1,1,6445;4285;55504;221178;338872;387911;542767;26278,8,0.59537763687173700000
chr5,149439390,149439404,14,-1,1,1436,1,7142.85714285714000000000
chr8,974820,2067679,1092859,-1,1,9172;9228;9639;9920;2055,5,0.45751556239185500000
chr10,119613228,121983218,2369990,-1,1,22876;63877;2834;11196;404636;22841;9531;79892;10935;8661;340719;7073;119559;143384;6001;2869,16,0.67510833379043800000
chr7,194258,6844888,6650630,-1,1,9907;79034;9265;84629;155185;2852;55146;221937;55698;3955;100533952;55501;54905;27102;51608;392617;5395;54476;5879;84310;221955;29886;5154;221935;23288;90639;84262;4521;654231;79778;84433;51622;57786;8662;8379;54753;202915;29960;7559;221938;222967;7965;221960;392862;402635;222962;80028;100131017;80727;60;90637;84132;2768;54919;56903;115330;11033;23353;26173;221927;100310846;5575;340260;728194;6624;26100;11014;7975;84792;56975,70,1.05253186540222000000
chr6,163747722,170898549,7150827,-1,1,168002;10846;387263;55274;55780;285800;2853;4301;113402;5134;9444;401285;3834;5689;54346;253769;100128124;168090;79981;7058;83887;6991;6196;8635;28514;84498;6953;6862;51660;64094;1235;11116;6908,33,0.46148508417278200000
chr10,11315301,11429653,114352,-1,1,10659,1,0.87449279417937600000
chr2,65142684,65523986,381302,-1,1,6509;5861;10097;23177,4,1.04903724606742000000
chr16,21837492,22407931,570439,-1,1,730094;440345;29904;7385;1039;146177;55718;255762,8,1.40242865582472000000
chr7,101247250,101747677,500427,-1,1,1523;93408,2,0.39965869147747800000
chr15,22765637,23217513,451876,-1,1,123606;23191;114791;81614,4,0.88519859430463200000
chr16,117194,717828,600634,-1,1,6650;3040;64285;4350;146325;84331;3039;4833;8312;64714;3042;8131;398;283948;58986;84326;8786;83986;3049;57799;3050;10573;9091;26063;197335;9727;117166;55692,28,4.66174076059630000000
chr15,22765628,23208901,443273,-1,1,123606;23191;114791;81614,4,0.90237844398373000000
chr2,167100687,172443432,5342745,-1,1,115677;6335;129446;79901;26003;10324;130507;8647;253782;100526832;9360;140469;4036;79675;57405;389058;79828;2571;129880;80067;285141;57818;10170;27347;29081;493911;6741;6332;129881;9874;8708;151230,32,0.59894305268172100000
chr10,74611240,79107376,4496136,-1,1,11319;9632;5328;118881;25961;310;5532;5033;51207;23234;170384;90550;159195;3778;84858;84647;142891;79933;23522;26985;51021;58529;23053;338599;118490;118487;7414;414236;729092;83938;317662;170392;8509;818;132;7417;118491,37,0.82292884378942300000
chr16,28824794,29042118,217324,-1,1,11273;79874;7284;930;84901;27040;487;83985;25970,9,4.14128214095084000000
chr9,138229500,138918245,688745,-1,1,392399;10422;360203;402381;138151;3933;57582;157927;157922;9858;51116;5047;138162;29991,14,2.03268263290478000000
chr22,51123491,51178264,54773,-1,1,49;85358,2,3.65143410074307000000
chr16,53690422,55778979,2088557,-1,1,79191;23322;10265;79068;79190;84290;54947;643911;4313;6530,10,0.47879947734249100000
chr18,136226,10039133,9902907,-1,1,116;55556;10403;23255;645369;84203;57045;103910;642597;9097;7525;9218;5797;494514;1068;9229;79822;84034;4729;7298;91133;11031;23253;9663;9989;7050;339291;9984;81035;10928;23347;10627;201475;64863;8736;27098;284217;23136;7541,39,0.39382375296466000000
chr4,189470492,190963766,1493274,-1,1,2483;448831,2,0.13393389290913800000
chr5,77523318,80254203,2730885,-1,1,9765;133746;29958;8546;9456;256987;167555;340120;4437;411;9522;1719;635;7060;167153;84654;10184;202333;345778;100462981;23743,21,0.76898148402441000000
chr13,23566962,24827740,1260778,-1,1,6445;4285;387911;55504;221178;542767;26278,7,0.55521273372473200000
chr16,21728367,22407931,679564,-1,1,730094;440345;29904;146183;7385;1039;146177;55718;255762,9,1.32437857214332000000
chr17,49434098,53666417,4232319,-1,1,10040;3131;84643;1353;56934;100506650;252983;23531,8,0.18902166873527300000
chr16,15255663,16727361,1471698,-1,1,4629;100288332;123811;89927;4363;54820;408050;255027;101059938;368;9665,11,0.74743595493097100000
chr1,204006345,207756937,3750592,-1,1,23114;2005;55432;9580;55220;1604;9641;127845;1378;9261;725;8934;6900;9214;85414;440712;5972;5208;50604;55224;83953;553;3586;148811;9911;722;29949;8444;79098;10446;4194;254428;93273;11009;148808;5929;115019;23380;81788;729533;1510;5129;25778;83593;84919;388730;3814;1939;1380;5287;22874;5284;64710,53,1.41311025032848000000
chr1,146507649,147381479,873830,-1,1,9557;607;2702;2330;51205;2703;5565,7,0.80107114656168800000
chr9,130368237,130396435,28198,-1,1,6812,1,3.54635080502163000000
chr15,22754322,23222284,467962,-1,1,123606;23191;114791;81614,4,0.85477025912360400000
chr3,181944397,183316787,1372390,-1,1,23200;54165;23101;89857;84002;56922;27074,7,0.51005909398931800000
chr2,165355527,166510365,1154838,-1,1,2888;6326;6328;151258;22837;80034,6,0.51955339190431900000
chr16,106271,462400,356129,-1,1,3040;64285;4350;3039;4833;8312;64714;3042;398;83986;8786;58986;8131;79622;3049;3050;10573;26063;55692,19,5.33514541079216000000
chr20,36676752,37800270,1123518,-1,1,343578;140679;79913;26051;81610;85449;3929;60625;7052;149685;58490;671;57148,13,1.15707981536566000000
chr16,96766,1065651,968885,-1,1,51764;3040;64285;30812;146325;84331;124093;3039;4833;8312;64714;89941;8131;388199;84264;58986;84326;79622;10573;51728;26063;9727;117166;6650;9028;4350;65990;64428;64788;10232;3042;146330;339123;398;83986;8786;283948;79006;10273;84219;3049;57799;63922;3050;9091;197335;113000;55692,48,4.95414832513663000000
chr7,87576407,87737435,161028,-1,1,53616,1,0.62101001068137200000
chr2,159238900,164495079,5256179,-1,1,29994;130940;25801;10716;57282;4065;8502;90134;100526664;151525;2191;92196;55137;5937;10010;1803;85461;64135;64844;9936;22925;2641;3694;10213,24,0.45660545426630300000
chr12,192511,3513507,3320996,-1,1,283358;6539;440073;7004;56341;55846;5893;81029;83695;2288;775;2305;4815;6540;84318;7289;144699;654429;10867;5927;83714;93589;65125;196513;23085;79602,26,0.78289766082223500000
chr16,21837492,22430592,593100,-1,1,730094;440345;29904;7385;1039;146177;55718;255762,8,1.34884505142472000000
chr16,21951415,22632138,680723,-1,1,730094;100132247;29904;7385;1039;146177;55718;255762,8,1.17522105173470000000
chr20,14799098,15041538,242440,-1,1,140733,1,0.41247318924269900000
chr4,182214915,190880409,8665494,-1,1,285440;53842;205860;25854;55325;7098;55714;60684;836;80014;83891;57587;55602;2160;3818;79682;353322;291;100132463;27295;3660;441054;391723;201965;2195;339976;201973;4543;132625;55805;133121;256309;8470;2180;56977;3622;2483;1635,38,0.43852087370898900000
chr5,88163771,88392641,228870,-1,1,4208,1,0.43692926115261900000
chr17,34822465,36307773,1485308,-1,1,26574;9326;6928;3975;79893;31;80179;284098;11072;79154;79922;11276;11056;101060376;6871;284099,16,1.07721765452014000000
chr18,63125705,78010032,14884327,-1,1,125704;54495;28513;147381;1528;55628;201456;79863;400658;4772;25914;84735;644041;9306;9658;4155;27164;440498;81832;1005;26251;80148;92126;9150;10194;220158;284273;79839;22850;10666;84552;55748;374868;29090;10907;284274;7776;220164;2587,39,0.26202058044008300000
chr4,39909985,42050575,2140590,-1,1,55728;79730;54502;55161;399;55584;10463;323;285429;23244;22998;8929;7345,13,0.60730919980005500000
chr16,28342496,30199805,1857309,-1,1,552900;283897;83719;23475;283899;487;26471;445329;728689;25970;226;253982;83723;11273;79874;6911;79447;112476;112869;728734;11151;9961;83985;107282092;1201;79153;653808;6799;5531;26470;8663;27040;253980;7284;146378;8479;124446;9344;3835;4150;246778;728888;100507607;55911;5595;79008;8448;930;728741;84901;10423;6817;6693,53,2.85359086721703000000
chr16,21837492,22430592,593100,-1,1,730094;440345;29904;7385;1039;146177;55718;255762,8,1.34884505142472000000
chr21,29967217,34997077,5029860,-1,1,2897;337882;9875;337960;9073;29104;571;337970;56245;54943;643812;7074;9946;116448;337959;337968;337973;26046;10069;56683;100131902;59271;337963;337967;337878;29980;3588;10215;337979;100288323;337971;337985;30811;3454;337974;337977;337969;57466;140290;337976;54069;757;2618;10600;3455;140258;56246;26285;10694;337975;337880;100288287;3460;6651;6647;8867;94104;150051;337966;388818;337978;337879;254950;56911;284827;337972;643803;728299,68,1.35192629615934000000
chr15,20591187,23648792,3057605,-1,1,727832;114791;100996331;123606;283694;81614;100287399;390538;23191;283767,10,0.32705336366208200000
chr6,103556603,120358642,16802039,-1,1,221264;441168;64780;25842;84816;256380;51175;221303;51389;28962;8528;8724;221302;619208;254394;221301;5350;202;728464;222545;222553;57107;2444;85413;79632;27244;262;8763;84071;285755;11149;8936;112495;84154;5980;11231;1300;51250;9474;4082;55278;10758;8838;6610;639;7101;23097;117247;2534;345895;57673;254228;442247;222546;57531;91749;7259;285761;3066;2830;9841;23270;116150;100128327;246269;6098;221294;3841;2309;51362;389421;29940;55084;245806;57120;3910;5550;4121;64208;221262;387119;9896;222537;285753,84,0.49993932284052000000
chr4,33574,3794624,3761050,-1,1,10336;7700;521;7469;401115;79155;4636;10417;84286;654254;345222;54872;1609;2261;255403;79441;4043;10227;8602;7884;170960;57732;7468;152877;10296;3064;3083;285489;57654;353497;10460;118;3954;10861;152;92305;285498;339983;10815;2580;53834;84179;5158;402160;3425;10608;6452;152687;1487;6047;54729;2868;6002;285464;8603,55,1.46235758631233000000
chr14,103689307,107287505,3598198,-1,1,647286;23241;283643;9529;400258;207;55038;9112;122402;3714;10572;283638;4140;1983;100128927;1396;1152;3831;84334;122618;80757;374569;388021;113146;2972;256281;647310;1397;7517;90135;79038;122616;9556;64423;115708;23368;122622;26153;29933,39,1.08387587342331000000
chr4,73722743,75896272,2173529,-1,1,5196;5197;6374;174;213;2920;374;255324;26057;173;685;441024;166824;2921;3576;5473;2919;285521;25849;6372;2069,21,0.96617068371298500000
chr16,29567295,30226930,659635,-1,1,653808;654483;5531;26470;283897;253980;146378;8479;83719;23475;283899;548593;124446;9344;3835;4150;226;253982;83723;5595;6911;11151;6818;79447;112476;8448;9961;10423;6693;79153,30,4.54796971052173000000
chr7,14810269,16207858,1397589,-1,1,4223;729920;1607;392636,4,0.28620717535699000000
chr7,73150511,73405560,255049,-1,1,1365;135886;83451;155368;1364,5,1.96040760794984000000
chrX,6489877,8107259,1617382,-1,1,412;8228;26609;8226,4,0.24731325067300100000
chr15,22765637,23217513,451876,-1,1,123606;23191;114791;81614,4,0.88519859430463200000
chr14,75926791,76716244,789453,-1,1,55640;7043;10538;122953;112752;23093;55668;11161,8,1.01335988336228000000
chr1,243590990,243897442,306452,-1,1,10806;10000,2,0.65263075457167800000
chr3,4181339,4324381,143042,-1,1,,0,0.00000000000000000000
chr16,15048732,16400833,1352101,-1,1,4629;100288332;123811;89927;4363;54820;408050;368;255027;23042;54700;123803;9665,13,0.96146663599834600000
chr13,30172494,32870963,2698469,-1,1,122042;3146;10808;10208;84935;122046;145173;241;5412;84056;10129,11,0.40763855356500300000
chr22,51128324,51197766,69442,-1,1,49;85358,2,2.88010137956856000000
chr15,44048315,47999009,3950694,-1,1,90527;90525;7782;84978;80208;26258;8669;145645;50506;2923;6652;25764;10169;2628;84419;58472;140691;9153;80237;405753;4236;79029;197135;567;619189;113201;51496;53905;80031;79968,30,0.75936025417306400000
chr3,110678307,113652487,2974180,-1,1,10225;151887;64422;79413;29083;25945;91653;205717;257144;131450;55032;80218;523;79669;152185;54847;54762;344805;55779;55347;257068;29114;151888;25871;285335;90102;4345;344807,28,0.94143595881890100000
chr2,111399243,113102594,1703351,-1,1,10461;699;129804;10018;84910;64682;376940;55289;84524,9,0.52837025369404200000
chr7,69210294,69433076,222782,-1,1,26053,1,0.44886929823773900000
chr12,1916192,3300000,1383808,-1,1,654429;7004;10867;83714;55846;93589;196513;83695;2288;775;2305;7289,12,0.86717232448432100000
chr15,98942943,102399819,3456876,-1,1,145814;390649;4205;123355;204219;80213;79705;390648;55829;3480;55180;145748;220;5046;283777;23336;22856;170691;100128108;64927;140460;6627;123283,23,0.66534061389532100000
chr16,15126890,16303388,1176498,-1,1,4629;100288332;123811;89927;4363;54820;123803;255027;23042;54700;368;9665,12,1.01997623455373000000
chr22,21798705,24631613,2832908,-1,1,7332;4320;100423062;613;391322;400916;150248;23532;129025;645426;29799;91227;23759;150223;9647;27156;653689;4282;23119;29802;100037417;2687;9609;164592;23753;5594;7441;3543;2781;7621;2952;66035;8940;266747;140883;150221;51233;6598;1652;56241;23523;91319,42,1.48257550192241000000
chr16,15325072,18172468,2847396,-1,1,4629;100288332;123811;64131;89927;4363;54820;408050;255027;101059938;368;9665,12,0.42143769254434600000
chr7,80595547,91076473,10480926,-1,1,222223;781;223117;154661;2913;219557;9723;5218;261729;54677;85865;79689;9988;3082;55972;10926;79846;5243;8321;9069;5244;53616;219578;27445;10371;79161;26872;6717,28,0.26715196729754600000
chr16,29634212,30199805,565593,-1,1,653808;5531;26470;283897;253980;146378;8479;83719;23475;283899;124446;9344;3835;4150;226;253982;83723;5595;6911;11151;8448;79447;112476;9961;10423;6693;79153,27,4.77375073595324000000
chr1,146506310,147824207,1317897,-1,1,9557;51205;51463;5565;607;2702;2330;200030;2703,9,0.68290617552054500000
chr16,9549686,9934830,385144,-1,1,2903,1,0.25964314645950600000
chr18,41705973,42881124,1175151,-1,1,8170;26040,2,0.17019089461694700000
chr18,74021926,78013728,3991802,-1,1,26251;79863;80148;400658;9150;4772;9658;4155;27164;440498;22850;84552;374868;10907;7776;2587,16,0.40082148363070100000
chr16,78022830,78216167,193337,-1,1,51741;10143,2,1.03446313949218000000
chr20,344820,810327,465507,-1,1,10616;128637;6939;1457;57761;140809;113278;85508,8,1.71855632675771000000
chr16,29318906,30347731,1028825,-1,1,654483;552900;283897;83719;23475;283899;548593;445329;226;613037;253982;83723;6911;11151;79447;112476;9961;107282092;79153;653808;5531;26470;253980;146378;8479;124446;9344;3835;4150;728888;5595;79008;8448;6818;10423;6693,36,3.49913736544116000000
chrX,80061081,80255657,194576,-1,1,254065,1,0.51393799851985900000
chr10,134878594,135430043,551449,-1,1,10844;85442;27287;8433;93426;84435;50632;92170;118471;282969;196743;503542;101;1892;1571;118472,16,2.90144691530858000000
chr2,62430164,69465290,7035126,-1,1,4190;54812;554251;29094;9792;200728;10887;200734;23301;5861;25927;54465;6509;200558;23177;51057;56287;84168;200504;116143;57162;5013;10097;7360;4211;5341;56902;27302;10438;51542;9938;5534;10678,33,0.46907475431143700000
chr14,100051939,101645661,1593722,-1,1,317762;123096;283600;10858;2009;123099;7528;79446;51466;84439;388015;57596;8788;7453,14,0.87844680565368400000
chr2,111392259,113192136,1799877,-1,1,10461;699;129804;55289;64682;84524;376940;10018;727851;84910,10,0.55559352111283200000
chr1,247200511,249212668,2012157,-1,1,127077;84838;391194;127069;93474;127074;81472;127066;388759;127068;646627;343172;25893;81469;441933;391190;391196;403244;127623;343173;7678;284532;343169;127064;26246;391189;79894;26696;55657;391191;441932;401993;81466;127059;127062;80851;79862;267002;343563;317705;391195;26245;343171;401992;254879;114548;26188;81470;148823;403239;284521;391211;401994;391192,54,2.68368720731036000000
chrX,109389143,109459782,70639,-1,1,9949;84187,2,2.83129715879330000000
chr1,146324068,147356634,1032566,-1,1,9557;607;2702;2330;51205;149013;5565,7,0.67792276716452000000
chr4,156710981,158670491,1959510,-1,1,51802;2743;2891;2983;6999;1519;56034,7,0.35723216518415300000
chr16,29673954,30197341,523387,-1,1,653808;5531;26470;283897;253980;146378;8479;83719;23475;283899;124446;9344;3835;4150;226;253982;83723;5595;6911;11151;8448;79447;112476;9961;10423;6693;79153,27,5.15870665492265000000
chr2,121394787,124203637,2808850,-1,1,7247;84365;23332;2736;29842,5,0.17800879363440600000
chr16,29673954,30198600,524646,-1,1,653808;5531;26470;283897;253980;146378;8479;83719;23475;283899;124446;9344;3835;4150;226;253982;83723;5595;6911;11151;8448;79447;112476;9961;10423;6693;79153,27,5.14632723779463000000
chr10,148206,498167,349961,-1,1,22982;10771,2,0.57149225199379400000
chr18,61264996,78014123,16749127,-1,1,125704;54495;28513;147381;89778;1528;55628;201456;79863;400658;8710;25914;84735;644041;5275;4772;9306;9658;5055;4155;27164;440498;81832;1005;26251;5273;80148;92126;9150;10194;220158;6317;6318;284273;284293;79839;22850;10666;84552;55748;374868;5271;29090;10907;284274;7776;220164;2587,48,0.28658210066709700000
chr11,42732599,47671024,4938425,-1,1,10062;5913;8539;55709;9776;9409;2147;221120;51317;4722;399888;9479;283254;1132;60529;1408;8567;390110;120071;55626;79096;55343;29763;5702;4607;51144;57586;91252;387763;84364;23788;2132;114971;114900;143678;9793;4192;90139;8534;79797;55761;8525;1643;53;3732;9537;84680;392;4038;90993;10658;56981;6688,53,1.07321666320740000000
chr7,103362757,103462575,99818,-1,1,5649,1,1.00182331843956000000
chr2,799288,1071839,272551,-1,1,54221,1,0.36690380882843900000
chr13,47240527,48096722,856195,-1,1,2098;23143;3356,3,0.35038747014406800000
chr11,56059838,60012839,3953001,-1,1,932;1270;219541;219981;26519;10978;219972;9246;64231;390174;390168;8501;280636;25921;219983;283189;219990;5553;390201;390190;6809;219479;710;219956;390191;219986;219484;219952;349667;63901;219968;2206;441608;390199;9404;219957;10394;6749;219982;219988;219493;51075;219482;219958;81341;5007;92292;219527;5024;219959;54948;2694;390157;80829;374393;219965;219473;29015;390195;390162;390181;219954;219960;187;219537;219970;23220;219487;219417;1500;643376;338675;85456;6947;390167;219539;10249;219477;390197,79,1.99848165988321000000
chr18,43480960,43481132,172,-1,1,57724,1,581.39534883720900000000
chrX,585090,588350,3260,-1,1,6473,1,30.67484662576690000000
chr7,69168540,69198438,29898,-1,1,26053,1,3.34470533146030000000
chr1,69712055,72124154,2412099,-1,1,9295;81573;5733;55631;9406;257194;57554;11147;1491,9,0.37311901377182300000
chr6,17675795,18225524,549729,-1,1,63971;221656;9972;7172;378884;7913,6,1.09144687655190000000
chr5,91402678,107559969,16157291,-1,1,51752;5066;153643;285600;285704;83989;55781;1946;345757;9652;90355;134187;317671;2745;7903;7025;83594;84250;83890;79772;54826;64167;1105;4012;353189;285601;831;22936;133482;64839;22836;23262;153642;167410;5122,35,0.21662047183528500000
chr1,154687479,156014014,1326535,-1,1,1945;90780;1163;10654;200185;1944;3782;127579;23208;55154;149095;51043;54856;339403;1196;4582;4580;7059;6746;7818;55974;2629;6464;22889;57326;54344;80308;8751;10067;55891;57657;1942;10712;5313;23623;101928120;2224;80128;55870;9181;56893;6016;55249,43,3.24152773956209000000
chr16,85768265,86590430,822165,-1,1,64779;3394;2294;10328;1327;404550,6,0.72978051850905800000
chr7,145912108,145993913,81805,-1,1,26047,1,1.22241916753255000000
chr15,100375374,102397836,2022462,-1,1,5046;390649;80213;204219;140460;170691;22856;79705;55829;100128108;390648;55180;6627;123283;220,15,0.74167030085114100000
chrX,122322561,122509691,187130,-1,1,2892,1,0.53438785870785000000
chr9,103959862,109999680,6039818,-1,1,286365;55151;25934;55335;6887;10592;229;138803;54534;83856;19;570;58499;138804;138799;286362;54886;5535;138802;116443;84302;392376;23446;1539;2218;7743;138805;56254,28,0.46359012804690500000
chr16,29432212,30177916,745704,-1,1,653808;5531;26470;552900;283897;253980;146378;8479;83719;23475;283899;124446;9344;3835;4150;445329;226;253982;83723;5595;6911;79008;8448;79447;112476;6693;9961;10423;107282092;79153,30,4.02304399600914000000
chr7,129507758,133286241,3778483,-1,1,114960;7328;4289;26958;1357;91584;54927;84928;93979;136259;4232;1358;51530;95681;5420;136263;51200;60412;23008,19,0.50284730671012700000
chr16,87257185,87845882,588697,-1,1,79791;57338;100506581;54758;23174;81631,6,1.01920002989653000000
chr15,22765628,23082821,317193,-1,1,123606;23191;114791;81614,4,1.26106187715366000000
chr16,84263449,84310078,46629,-1,1,93107,1,2.14458813184928000000
chr6,16846787,18057673,1210886,-1,1,63971;51439;401236;221662;9972;10486,6,0.49550494431350300000
chr6,16846787,18057673,1210886,-1,1,63971;51439;401236;221662;9972;10486,6,0.49550494431350300000
chr4,10001,1729495,1719494,-1,1,10336;7700;521;4636;10417;10861;84286;654254;92305;54872;285498;1609;255403;10815;2580;53834;84179;7884;170960;5158;3425;152877;10296;152687;1487;54729;57654;10460;285464,29,1.68654266894796000000
chrX,60814,1809510,1748696,-1,1,28227;293;286530;438;64109;6473;8227;8225;8623;55344;1438;3563,12,0.68622562183478400000
chr8,191605,6880346,6688741,-1,1,389610;9172;728358;1669;26260;1667;157697;64478;1671;9639;79648;169270;285;157695;9228;55326;9920;1672;1668;2055,20,0.29900993325948800000
chr2,65539596,69597209,4057613,-1,1,554251;116143;4211;5341;10887;56902;2673;200734;25927;54465;27302;200558;10438;9938;5534;56287;84168;200504,18,0.44361056611362400000
chr16,6520292,9656507,3136215,-1,1,18;5373;29035;7874;25880;23589;283953;54715;79091,9,0.28697012162750300000
chr10,28767543,28847577,80034,-1,1,51322,1,1.24946897568533000000
chr9,85816513,88092881,2276368,-1,1,80010;64078;4915;414328;257019;55582;80318;29979;84267;3190,10,0.43929628249913900000
chr1,66793706,69004328,2210622,-1,1,5142;3595;1647;57708;23169;55970;6121;10022;26135;55635;200132;79971;149233;9077;79819;84251;400757,17,0.76901433171297500000
chr10,34353285,38900673,4547388,-1,1,1390;219749;8453;7587;8325;100288485;57209;56288;7581;219770;219771;91074,12,0.26388775270550900000
chr4,88836002,89167407,331405,-1,1,5311;6696;9429,3,0.90523679485825500000
chr6,156974,2236926,2079952,-1,1,2295;56940;55770;2762;3662;135458;94234;2296,8,0.38462426055985900000
chr16,15049829,16287899,1238070,-1,1,4629;100288332;123811;89927;4363;54820;368;255027;23042;54700;123803;9665,12,0.96925052702997400000
chr1,61752118,61775813,23695,-1,1,4774,1,4.22029964127453000000
chr15,54713558,58011886,3298328,-1,1,81488;9236;51187;55329;6938;54816;64864;100820829;101928527;283659;145788;5873;4734;161582;145781;440279;26108;9488;84952;374618,20,0.60636783242903700000
chr16,60064996,63555913,3490917,-1,1,729159;1006,2,0.05729153686552850000
chr16,29656684,30190568,533884,-1,1,653808;5531;26470;283897;253980;146378;8479;83719;23475;283899;124446;9344;3835;4150;226;253982;83723;5595;6911;8448;79447;112476;9961;10423;6693;79153,26,4.86997175416383000000
chr7,156560498,159124131,2563633,-1,1,9690;55112;64327;5799;3110;7434;64434;54892;10049;57488,10,0.39007143378166800000
chr19,32294016,35456588,3162572,-1,1,26065;85415;284402;90075;148103;84306;147991;64377;388531;11136;91442;10054;9141;84079;9710;126248;1054;84902;22847;79047;390916;55094;126375;1050;339318;126374;4037;56301;55900;91646;5184;2821,32,1.01183467127389000000
chr8,8119295,11892064,3772769,-1,1,1508;83650;83595;203076;2626;83648;613210;137075;613209;157285;640;66036;252969;286046;79660;2222;54984;613211;4482;8658;203074;9258;90459;94137,24,0.63613754247874700000
chr5,86170311,90103610,3933299,-1,1,5921;153364;116068;84059;10622;4208;1070;153396;902,9,0.22881555661036700000
chr2,146875164,152278298,5403134,-1,1,9111;130576;130574;55183;55777;7130;92;26122;3800;27249;375287;5000;390,13,0.24060110298948700000
chr9,2146330,9663533,7517203,-1,1,10171;23081;55664;89882;50808;158358;5789;6019;169792;55064;6505;29126;2315;5991;26953;90865;7436;3717;90871;6013;57589;3641;403313;169522;115426;6595;79956;9933;2731;55848;11172;80380,32,0.42569024675800300000
chr16,29673954,30198600,524646,-1,1,653808;5531;26470;283897;253980;146378;8479;83719;23475;283899;124446;9344;3835;4150;226;253982;83723;5595;6911;11151;8448;79447;112476;9961;10423;6693;79153,27,5.14632723779463000000
chr21,38865151,38885792,20641,-1,1,1859,1,4.84472651518822000000
chr6,70157311,98953422,28796111,-1,1,4199;253714;135228;90025;55122;1303;22881;3354;79627;55510;57150;60468;29078;9324;10492;58528;1268;22999;55603;10690;1347;25998;5238;206412;25821;9457;112611;1310;60682;340168;83699;9994;23033;57579;10957;101928601;81833;135295;2045;154288;23595;3617;10559;26503;167691;375519;7162;84694;134728;6785;57226;135293;55754;134701;4907;115004;2570;2569;4646;167681;80759;154313;441161;26054;135154;56479;51167;9096;594;135152;23376;23036;1081;55788;114792;81491;51465;57231;57038;55023;79694;8732;1297;112609;7272;27145;9892;100129128;23195;1915;6885;3351;22832,93,0.32296027751803000000
chr1,27786502,30630253,2843751,-1,1,10163;51441;27293;2140;2035;2268;4985;6429;65979;399474;23673;10076;199870;5511;51102;10691;9473;115273;83667;54952;93974;6883;54797;5724;2537;22826;6118;1104;55113;27245,30,1.05494468397550000000
chr17,6995687,7232432,236745,-1,1,1742;6517;432;2874;433;11337;84461;1984;1856;37;23399;23587;1366;51087;79142,15,6.33593106507001000000
chr19,259395,1144343,884948,-1,1,566;610;51298;400668;126567;1265;8612;997;91304;3004;10347;54531;116444;5657;1991;91300;84634;55658;91978;10272;1820;25759;22904;1675;284451;682;8174;5064;57418;27006;79948;23526;5442;126353;5434;5725;10025;2879,38,4.29403761576951000000
chr10,75971593,78526861,2555268,-1,1,118881;142891;23522;51207;338599;132;7417;84858;83938,9,0.35221354472407600000
chr9,131371492,131375954,4462,-1,1,6709,1,22.41147467503360000000
chrX,41646323,43741871,2095548,-1,1,8573;4129;4128,3,0.14316064342119600000
chr1,97000749,99813665,2812916,-1,1,9890;1806;51375;58155;163404,5,0.17775148635792900000
chr22,19023163,19165516,142353,-1,1,2928;6576;9993;8220;23617,5,3.51239524281188000000
chr22,19166795,20296201,1129406,-1,1,54487;27037;5413;29801;65078;10587;1312;7122;421;7290;388849;128977;2812;7353;128989;6899;54584;79680;64976;8318;5902;8218,22,1.94792660920873000000
chr22,20721856,21464119,742263,-1,1,80764;9342;3053;91179;8216;7625;400891;1399;6545;150209;51586;9127;84861;5297,14,1.88612392103607000000
chr8,100111821,100115556,3735,-1,1,157680,1,26.77376171352080000000
chr5,10973414,15937446,4964032,-1,1,1767;1501;56172;23194;7204;90268;54491,7,0.14101440119644700000
chr2,4529191,5181388,652197,-1,1,,0,0.00000000000000000000
chr22,18893563,20311922,1418359,-1,1,54487;27037;5413;29801;65078;23617;10587;1312;7122;8214;7290;421;128977;8220;2812;388849;7353;2928;128989;6899;9993;54584;5625;79680;85359;64976;8318;5902;6576;8218,30,2.11512036092414000000
chr22,20721856,21464119,742263,-1,1,80764;9342;3053;91179;8216;7625;400891;1399;6545;150209;51586;9127;84861;5297,14,1.88612392103607000000
chr6,73709065,76815249,3106184,-1,1,1347;135228;25821;1303;340168;55754;55510;115004;4646;154288;100129128;80759;27145;3617;441161;26054;26503;1915;56479,19,0.61168301684639400000
chrX,71710644,72095450,384806,-1,1,55869;63947;5255;728656;100132304,5,1.29935603914700000000
chrX,133497871,133839836,341965,-1,1,84295;3251;10761,3,0.87728276285584800000
chr1,162005098,172130663,10125565,-1,1,9095;84944;149281;6402;4259;57821;2328;51478;7371;5451;83540;10223;10560;80133;4009;9722;5999;23215;339512;26052;1805;2326;55732;4653;261726;22920;5087;6846;6258;149297;481;375035;8548;2153;51603;54499;92235;440699;127933;9019;25874;8674;6401;5396;117143;8490;92344;57645;6675;4921;8804;55827;92342;29922;6403;55811;2329;919;2327;117157;284680;223;6375;57147;92241;400793;387597;23432,68,0.67156746314897000000
chr15,22784523,23179948,395425,-1,1,123606;23191;114791;81614,4,1.01156982992982000000
chr7,72718242,74166535,1448293,-1,1,5982;51085;9275;84277;7462;55695;135886;83451;1364;135892;6804;7461;155382;3984;26608;8468;9031;155368;2969;8326;7458;9569;2006;1365;114049,25,1.72617004984489000000
chr4,71552,3375637,3304085,-1,1,10336;7700;521;7469;401115;79155;4636;10417;84286;654254;345222;54872;1609;2261;255403;79441;8602;7884;170960;57732;7468;152877;10296;3064;57654;353497;10460;285464;118;3954;10861;92305;285498;339983;10815;2580;53834;84179;5158;402160;3425;10608;6452;152687;1487;6047;54729;2868;6002;10227;8603,51,1.54354382529505000000
chr16,50277158,52626188,2349030,-1,1,124460;1540;85407;6299;388276;27324;113;29117;64127,9,0.38313686926092900000
chr2,155818224,163350648,7532424,-1,1,29994;130940;25801;10716;57282;4065;8502;90134;2820;151531;90;100526664;151525;2191;92196;130399;5937;10010;1803;85461;64135;64844;9936;57471;9595;22925;4929;2641;3694;10213;11227,31,0.41155410263681400000
chr16,29673954,30198600,524646,-1,1,653808;5531;26470;283897;253980;146378;8479;83719;23475;283899;124446;9344;3835;4150;226;253982;83723;5595;6911;11151;8448;79447;112476;9961;10423;6693;79153,27,5.14632723779463000000
chr1,170007769,179314374,9306605,-1,1,9588;149281;9674;51603;27101;356;64222;92346;84066;2328;91687;7292;460;730159;64326;63923;80133;339416;8674;462;51430;5396;57795;23215;9068;92344;63931;27252;5279;6646;149041;26052;89866;2329;2326;2327;9293;55103;27;4653;22920;60676;84614;284525;7143;9462;55157;9917;9910;8995,50,0.53725284354498800000
chr9,130444480,130454203,9723,-1,1,6812,1,10.28489149439470000000
chr15,22784523,23179948,395425,-1,1,123606;23191;114791;81614,4,1.01156982992982000000
chr19,12745203,13376358,631155,-1,1,773;9592;10661;439;4125;51398;84292;55621;2193;1777;811;256126;22983;7001;84261;10535;4066;90480;8677;1725;5886;4784;199699;83546;105372280;112939;54831;79002;29911;30000;2639;3726,32,5.07006995112136000000
chr17,34817422,36168104,1350682,-1,1,26574;284099;9326;284098;11072;6928;79154;79922;3975;11276;79893;11056;6871;31;80179,15,1.11055007766447000000
chr8,66775148,72857497,6082349,-1,1,56260;80124;116328;10499;81796;23678;286187;79848;100129654;23213;84675;137872;85479;57094;2138;100533105;1392;80243;23212;389668;10987;254778;9242;10565;157777;51110;63978;23471;4603,29,0.47678947722335600000
chr8,176818,6974050,6797232,-1,1,389610;9172;728358;1669;26260;1667;157697;64478;1671;9639;79648;1670;169270;285;157695;9228;55326;9920;1672;1668;2055,21,0.30894928994626000000
chr15,22784523,23179948,395425,-1,1,123606;23191;114791;81614,4,1.01156982992982000000
chrX,71549257,71553109,3852,-1,1,55869,1,25.96053997923160000000
chr15,31014508,32510863,1496355,-1,1,161725;283710;54893;51621;4308;22909;1139,7,0.46780342899913500000
chr12,21296706,29349651,8052945,-1,1,80763;341346;11228;3709;55907;79912;57542;3375;5965;160492;56938;144363;9412;3764;10060;79365;51768;51026;6660;387849;55500;586;2998;645177;10599;6489;4033;26127;23012;55711;8496;3845;100287284;728858;6579;55259;3945;5744;55297;55726;196415;8082;60488;9847,44,0.54638396263727100000
chr13,90274910,92202934,1928024,-1,1,2262,1,0.05186657427500900000
chr6,99082418,100565466,1483048,-1,1,51805;59336;100130890;84539;84553;892;26235;85015;5454;25957,10,0.67428700891677100000
chr18,597754,2190664,1592910,-1,1,116;27098;55556;7298;494514;7525,6,0.37666911501591400000
chr6,61971245,82159421,20188176,-1,1,134728;23469;135228;6785;1303;79627;55754;100463487;55510;9324;115004;4646;80759;441161;26054;135154;56479;22999;202559;594;577;1347;135152;441155;51557;25821;55788;1310;60682;340168;83699;346007;57579;101928601;55023;1297;154288;7272;7803;100129128;27145;3617;26503;1915;167691;3351,46,0.22785614708332200000
chr6,104668815,111286981,6618166,-1,1,221264;639;7101;23097;64780;84816;256380;57673;28962;8528;8724;57531;202;728464;57107;2830;9841;85413;246269;27244;262;8763;84071;285755;11149;2309;8936;51362;389421;55084;112495;5550;64208;221262;11231;51250;9474;9896;55278;285753;6610,41,0.61950697519524300000
chrY,19226776,59293089,40066313,-1,1,353515;1617;442862;8284;442868;6845;378950;140032;378948;57054;5940;442867;100533178;159163;10251;57135;378951;9081;159119;9083;9426;86614;57055;378949;9086;9082;253175;203611;9085,29,0.07238000661553260000
chr8,8100384,11860569,3760185,-1,1,1508;83650;83595;203076;2626;83648;613210;137075;613209;157285;640;66036;252969;286046;79660;2222;54984;613211;4482;8658;203074;9258;90459;94137,24,0.63826646827217300000
chr7,155686857,158384574,2697717,-1,1,9690;389602;140545;64327;3110;5799;64434;10049,8,0.29654704329623900000
chr7,72726578,74139390,1412812,-1,1,5982;51085;9275;84277;7462;135886;83451;1364;135892;6804;7461;155382;3984;26608;8468;9031;155368;2969;8326;7458;9569;2006;1365;114049,24,1.69873981817821000000
chr5,109389639,118900077,9510438,-1,1,642987;56929;51014;167227;353376;1176;644100;285605;91137;64848;9315;3295;83942;134430;6728;100302736;1657;25816;153733;9140;814;324;5229;64097;1036;4163;51397;3781;55521;134429;206338;7905;57556;85480,34,0.35750193629357600000
chr12,116420188,116466802,46614,-1,1,23389,1,2.14527824258806000000
chr20,62724392,62904501,180109,-1,1,55251;2832;4661;4987,4,2.22087735760012000000
chr8,193250,6939296,6746046,-1,1,389610;9172;728358;1669;26260;1667;157697;64478;1671;9639;79648;1670;169270;285;157695;9228;55326;9920;1672;1668;2055,21,0.31129345990228900000
chr21,18894835,20311763,1416928,-1,1,5651;140578;10950;54149;1525,5,0.35287608121231300000
chr2,50657269,51037163,379894,-1,1,9378,1,0.26323132242151800000
chr16,88766953,89343947,576994,-1,1,353;863;1013;51693;81620;100129697;197322;348180;2588;115992;9780;390748;29123;146429;197320,15,2.59968041262128000000
chr11,124452935,124909868,456933,-1,1,84897;90952;54414;54538;53340;116337;4900;79684;64221;220296;641654;80071;23584,13,2.84505605854688000000
chrX,115007250,116707313,1700063,-1,1,186;203413;11254,3,0.17646404868525500000
chr2,84184014,86294535,2110521,-1,1,56888;129303;8673;10791;83439;388969;51255;84173;822;1768;9168;84913;10618;10713;25885;8802;54884;284948;8869;4144;10578;129293;6439;2677,24,1.13715997140043000000
chr2,104773264,112004760,7231496,-1,1,5903;96626;11250;6819;344558;100288695;285190;84620;9392;27233;699;84417;3987;79074;60482;442038;729540;165055;55289;64965;10913;2274;7851;653489;65124;5455;10018;8440;80146;9648;84220;4867;151011,33,0.45633711198899900000
chrX,61091,155232907,155171816,-1,1,23096;64061;392509;10214;170685;23157;727837;55998;23439;729431;10916;158586;55859;331;3423;54830;4168;6901;5358;92002;27344;729447;54328;266740;9075;102723737;7552;729422;54954;84460;389874;56000;340562;644538;92552;254158;79649;56850;8225;2824;100272147;51186;3149;26576;100130361;1730;347541;139425;3547;728695;729408;79921;57826;59272;203413;2986;7512;9737;8544;55634;2857;3421;537;11013;340554;5716;6658;4101;54457;1438;91966;441519;4100;5931;27316;7403;4534;6839;51480;728096;27112;92129;101928917;140462;8241;6567;827;203569;27301;84548;645037;54413;100133053;7355;254065;79836;10084;347442;60343;51765;55593;139818;56180;6303;8269;142684;7626;10046;8409;203447;63932;2710;4515;8406;51248;56001;51616;2925;100130613;2564;1193;100132994;5354;11043;340533;22;3476;84631;26748;11238;203562;102723631;170261;58526;441525;4983;29944;6907;1536;2539;1478;9468;23597;2187;1287;81887;6611;3561;9767;9282;54857;347365;10800;139341;54539;11219;728062;169966;51209;23630;26548;1121;2000;645188;51438;2846;280658;1852;347344;23229;10857;56157;286430;101059915;438;5277;9758;1069;4674;154796;56548;51309;1184;645073;80712;1774;10245;2258;728343;9823;441531;11141;643311;90121;256643;23676;4114;6758;4107;286499;5009;1654;1831;51284;94121;170302;11230;79135;286410;9210;2491;441490;84187;633;6191;64743;4110;3598;389856;7789;55787;9452;50814;2157;139422;170062;57187;139067;4104;203427;4693;5456;10013;1964;55190;100996648;293;9016;100528062;30011;90316;93953;10178;6322;28952;24137;2332;4105;6845;94122;84968;64663;1538;9142;286530;2245;5634;9506;79576;3266;139212;5207;6535;8227;393;389852;170626;91851;27334;158866;550643;159013;407;7224;55796;10761;100132963;168400;4281;158835;24140;8471;90167;7737;7319;10149;11279;6134;64109;1678;139322;5063;55906;116442;84443;27197;8233;548313;6872;27018;100129239;139105;7102;10549;26071;2664;59353;8573;28985;79184;728049;728090;158521;3581;139886;282808;8263;9130;728082;778;90843;1756;5422;7317;5935;347454;29071;207063;4112;412;158506;340602;30848;5127;22866;93380;159091;10159;212;139285;9338;85417;8266;100132399;158584;494118;190;7569;89801;2892;1968;5230;57232;55559;57529;8277;63035;80231;286436;25975;51311;8905;55086;139735;395;83692;171484;10251;169981;1349;63904;139716;257397;142689;80258;27035;1641;55613;7105;100329135;84295;9459;4810;404281;4109;367;474384;6748;139760;347487;92745;158830;53344;4103;9203;139378;186;474343;2719;3597;140456;9248;402415;203430;9185;90161;728042;4129;65267;56849;8228;8226;728036;7114;6399;4952;83740;84889;8481;6757;347468;347475;414;6759;9500;51132;8823;541578;2158;55609;2556;494119;6756;9502;158880;8517;8242;474383;57595;51442;389895;100132304;9754;80311;6102;27328;695;56159;51213;90737;60506;10943;100873985;57526;728269;170082;474382;102723680;728656;3358;8273;83844;114824;389840;170067;81557;80823;8862;2002;7216;79979;158763;23641;55217;8270;57477;7592;2833;425054;340526;727866;139599;139804;54470;8450;959;139562;645864;10075;117154;57631;2010;54521;79589;51634;3750;653282;728072;7076;392490;9363;8623;3920;347411;7454;100506164;265;90293;645051;100529097;55511;158724;6197;203547;139135;5355;347516;203522;139081;6451;27336;158787;728458;7499;4841;347517;51360;340578;139596;1896;441509;54466;660;158798;4108;171482;79868;728075;158833;79366;1821;56156;392465;1260;5160;56062;5303;3054;51260;139628;653220;340596;554;28986;23133;57393;2623;28227;4113;57692;50945;3730;7739;100131755;57481;8260;139170;64219;4204;389860;2574;3563;65991;10325;6170;10813;79710;8712;26280;2316;256714;10742;6173;9104;494197;29057;139324;442444;6103;54880;90736;55558;2742;1736;369;255313;3654;170627;645974;3897;79983;727940;541466;347527;8243;4007;139741;29978;2182;7504;60401;84707;53336;1485;159090;94056;57502;55285;653067;1046;11152;641339;1947;8852;7712;23708;203523;4267;54967;340542;89885;2277;83550;644353;55916;340595;6594;139189;63947;9643;9843;4935;139728;100288814;10479;50943;53940;55026;100507170;5638;4478;8239;4068;51114;139411;246100;9968;84679;115201;100533997;1741;416;64840;10682;11326;25763;27330;171483;8908;27286;1038;7543;158800;90060;1288;84061;215;6247;292;55879;401612;1183;340527;55344;29935;158983;357;10009;2747;2652;286514;340543;54885;100129407;10495;6792;79742;140886;2239;2334;4128;441518;139604;4303;55869;25878;4115;11040;8473;6855;84636;55922;728712;5956;2705;55841;54821;729396;441521;8933;10735;729442;9949;4694;84528;51481;492;3028;100129520;795;10389;83604;7411;9947;9367;100463488;10134;79057;54552;6906;340547;30014;415;5255;680;158809;6990;4435;5475;340529;65109;64860;7030;729428;8776;4675;5030;51566;729201;56271;4943;79917;85012;114928;5256;26609;54960;538;6853;5365;4354;286451;29934;10838;139221;9189;347404;6473;3251;286464;158931;139793;100008586;2717;3052;5973;139065;5199;546;5613;51270;139231;9131;7547;474381;257240;11254;27238;64102;2543;158747;2273;56474;5165;64648;54440;140597;5631;728239;3188;100130086;5251;8237;286527;100130302,815,0.52522424561944900000
chr13,75648644,93608927,17960283,-1,1,7347;115207;114798;26050;64062;4008;1203;23077;84189;122060;26224;5457;730249;8796;1910;729420;170622;100129307;54602;2262;79596;10253;9882,23,0.12806034292444100000
chrX,36449924,37787309,1337385,-1,1,347404;442444;6990;1536;441490;5638;7504,7,0.52340948941404300000
chr3,73914,2599012,2525098,-1,1,27255;10752;152330,3,0.11880727005446900000
chr22,18894635,21464260,2569625,-1,1,54487;27037;9342;29801;65078;10587;1312;6545;8214;421;7290;2812;6899;5625;7625;79680;64976;6576;3053;8218;5413;80764;23617;400891;1399;7122;150209;128977;8220;388849;84861;7353;51586;2928;128989;5297;9127;9993;54584;91179;85376;8216;85359;8318;728229;5902,46,1.79014447633410000000
chr10,107747784,111957187,4209403,-1,1,114815;7511;120,3,0.07126901368198770000
chr22,50883397,51178264,294867,-1,1,23542;85358;644186;410;9701;79924;49;6305;1890;113730;9997;29781;55586;91289;440836;1120;1375,17,5.76531114027680000000
chrX,68716578,68893546,176968,-1,1,27112;1896,2,1.13014782333529000000
chrX,68716578,68893546,176968,-1,1,27112;1896,2,1.13014782333529000000
chr8,12556004,22816586,10260582,-1,1,55909;80346;64760;63898;55806;427;649;9796;286097;10361;57805;2675;10;157310;5157;23516;55790;1960;6570;9046;137492;26281;5533;23039;5108;10174;51201;64236;541565;79873;10395;57509;6440;526;11178;203190;91694;9108;23362;4023;55124;57604;157773;29883;6542;2267;661;137868;55174;7991;8822;2039;9;4481,54,0.52628593582703200000
chr13,79618555,82959164,3340609,-1,1,54602;10253;64062,3,0.08980398484228470000
chr15,56547697,60188065,3640368,-1,1,81488;92483;3990;2958;4643;6938;54816;8854;100820829;9245;54629;145773;366;663;84952;54778;9133;102;145781;79811;55329;374618,22,0.60433450684106700000
chr3,152110414,164792394,12681980,-1,1,4311;64747;29970;344758;4291;170506;10051;165679;5806;3592;389170;5918;56925;8833;401097;5028;8706;79674;151742;285315;25976;654502;6747;57018;57560;152118;4154;131149;51319;26084;152078;3840;286827;80117;100505385;85476;51068;6476;6474;23007;7881;9197;5912,43,0.33906377395327900000
chr18,53007161,53120817,113656,-1,1,6925,1,0.87984796227211900000
chr3,195740357,197446501,1706144,-1,1,622;255798;80235;200933;5062;5130;4241;26043;1739;84984;348793;255758;116211;131540;200931;375387;22916;9711;7037;165918;54965;205564,22,1.28945739632763000000
chr1,4533688,7836835,3303147,-1,1,26038;6146;8514;90326;9903;80835;390992;57449;55735;55966;23463;3104;387509;83715;8718;388591;9341;11332;23261;79707;261734;54626;148479,23,0.69630567455823200000
chr3,195777965,197395697,1617732,-1,1,622;255798;80235;200933;5062;5130;4241;26043;1739;84984;348793;255758;116211;131540;200931;375387;22916;7037;165918;54965;205564,21,1.29811365541388000000
chr1,144927778,149079806,4152028,-1,1,9557;148738;128077;84265;9659;10628;2330;653519;5174;388677;200035;51205;284615;645142;5565;148741;730262;10623;100132406;9939;728945;27246;284565;11126;8799;149013;10401;644591;8515;51463;607;2702;200030;2703,34,0.81887694398978100000
chr16,29673954,30119759,445805,-1,1,653808;5531;26470;283897;253980;146378;8479;83719;23475;283899;124446;9344;3835;4150;226;253982;83723;6911;8448;79447;112476;9961;10423;6693;79153,25,5.60783302116396000000
chr19,30901054,34916931,4015877,-1,1,26065;57616;85415;84902;22847;79047;2821;84306;390916;55094;1050;147991;64377;388531;11136;100507527;91442;4037;9141;56301;84079;91646;9710;9745;5184;126248;1054,27,0.67233134879380000000
chr3,150876508,151167962,291454,-1,1,9934;29909;53836;53829;116931;64805;285313,7,2.40175121974651000000
chr15,20603042,23179948,2576906,-1,1,727832;114791;100996331;123606;283694;81614;100287399;390538;23191;283767,10,0.38806227312909400000
chr19,35414997,37579142,2164145,-1,1,2867;53822;84807;5438;4099;388536;90075;55957;25999;644096;126393;57817;2865;495;57677;374897;148109;79171;55851;728361;101927572;388533;5348;53827;27033;93099;147923;728485;339324;51599;26330;284406;1340;79414;374900;2116;163183;374899;57711;84063;933;333;6324;115703;826;147929;284403;79713;5349;7705;163175;84924;57655;199745;1155;7305;58510;163081;9757;1346;84964;199746;126375;7392;23354;3249;4868;84911;342892;10870;25850;2864;10430;11045;148137;92283,76,3.51177947873179000000
chr13,102864674,109548530,6683856,-1,1,2259;54841;196541;23026;93081;2073;55082;84945;79070;728215;643677;1948;7174;3981;100533467;10673;6555;267012,18,0.26930562238324700000
chr2,170871312,174506129,3634817,-1,1,8604;79901;26003;254042;51776;130507;1781;1746;3655;11069;140469;8520;83879;389058;9874;79828;2571;1745;5163;80067;285141,21,0.57774572970248600000
chr1,226172907,226465640,292733,-1,1,83881;64746;286826;3020;163859,5,1.70804111596574000000
chr12,230421,4077613,3847192,-1,1,283358;6539;440073;7004;56341;55846;5893;81029;83695;2288;775;2305;4815;6540;84766;84318;7289;144699;654429;10867;5927;83714;93589;65125;196513;23085;57097;79602,28,0.72780355126544200000
chr17,16782546,18122719,1340173,-1,1,10743;55090;79018;10400;54890;146691;1819;6720;8533;23495;23164;83450;51168;51655;56953;201163;91647;201164,18,1.34311018055132000000
chr17,34817422,36168104,1350682,-1,1,26574;284099;9326;284098;11072;6928;79154;79922;3975;11276;79893;11056;6871;31;80179,15,1.11055007766447000000
chr17,16000001,22200000,6199999,-1,1,9487;2314;9720;125170;11216;79018;256302;254272;7314;8533;5598;218;224;339263;80039;51655;256223;201163;7156;51030;10750;339184;10743;100129396;140775;8834;51393;57547;1819;147166;7732;100462977;91647;201161;3996;4239;201164;23326;55244;9611;55090;645027;79999;284194;5606;10400;54890;9706;3768;92521;22905;25979;729288;100996259;23164;83450;51168;5636;644815;10517;654346;388436;27077;388341;6470;146691;6720;125206;23495;57336;146802;56953;400581,73,1.17741954474509000000
chr22,17370127,19084594,1714467,-1,1,27440;51816;8214;51807;23765;9993;5625;27439;27443;55670;637;529;11274;23786;83733;128954;101929372;57553,18,1.04988897424097000000
chr22,49974766,51176283,1201517,-1,1,85358;410;400935;85378;9701;56666;5600;9889;23774;80305;414918;79174;9997;1120;440836;1375;415116;83642;23542;644186;23209;6300;83933;79924;79087;6305;1890;348645;23654;113730;29781;55586;91289;54456,34,2.82975605006005000000
chr17,2177669,2829615,651946,-1,1,4335;23277;55720;23293;63826;79066;9905;23108;5048,9,1.38048243259411000000
chr15,23636820,28527171,4890351,-1,1,2562;7681;23742;8924;7337;6638;2567;4948;8926;57194;283685;54551;4692;2558,14,0.28627801971678500000
chr17,43703252,44208312,505060,-1,1,246744;162540;104909134;1394;4137;284058,6,1.18797766601988000000
chr22,18644790,21798907,3154117,-1,1,54487;27037;9342;29801;65078;10587;1312;6545;8214;7290;421;2812;6899;5625;7625;79680;23119;64976;11274;6576;3053;8218;5413;80764;23617;400891;1399;7122;150209;128977;8220;388849;84861;7353;51586;2928;128989;5297;9127;9993;54584;91179;85376;8216;440804;85359;8318;728229;5902,49,1.55352512287908000000
chr16,29628661,30177916,549255,-1,1,653808;5531;26470;283897;253980;146378;8479;83719;23475;283899;124446;9344;3835;4150;226;253982;83723;5595;6911;8448;79447;112476;9961;10423;6693;79153,26,4.73368471839128000000
chr22,18916842,20717655,1800813,-1,1,54487;27037;5413;29801;65078;23617;10587;1312;7122;421;7290;128977;8220;2812;388849;7353;2928;128989;6899;9993;54584;5625;85376;79680;85359;64976;8318;5902;6576;728229;8218,31,1.72144470303135000000
chr22,18644790,21465662,2820872,-1,1,54487;27037;9342;29801;65078;10587;1312;6545;8214;7290;421;2812;6899;5625;7625;79680;64976;11274;6576;3053;8218;5413;80764;23617;400891;1399;7122;150209;128977;8220;388849;84861;7353;51586;2928;128989;5297;9127;9993;54584;91179;85376;8216;85359;8318;728229;5902,47,1.66615145954868000000
chr9,13106806,14639971,1533165,-1,1,4781;8777;340481,3,0.19567365547739500000
chr15,22784523,23076420,291897,-1,1,123606;23191;114791;81614,4,1.37034638930856000000
chrX,140557558,147806510,7248952,-1,1,494118;158521;645188;51438;9142;100133053;100129239;139065;64648;2334;139067;494119;9947;139081;84631;30014;728712;441525;2332,19,0.26210685351482500000
chr10,47011584,51664079,4652495,-1,1,5599;644168;267004;8031;195977;100652748;642517;57705;474354;170371;118738;653145;5949;644054;100133093;728113;5540;143162;6572;2662;26095;118461;282966;58504;100287932;8505;2658;1103;2074;170370;4477;196740;55753,33,0.70929683965270200000
chr15,31014508,32510863,1496355,-1,1,161725;283710;54893;51621;4308;22909;1139,7,0.46780342899913500000
chr7,72290998,72903353,612355,-1,1,378108;8468;9031;8326;55695;441250;9883;135892,8,1.30643172669448000000
chr16,28833436,29046284,212848,-1,1,11273;79874;7284;930;84901;27040;487;83985;25970,9,4.22836954070510000000
chr16,29694991,30190676,495685,-1,1,653808;5531;26470;283897;253980;146378;8479;83719;23475;283899;124446;9344;3835;4150;226;253982;83723;5595;6911;8448;79447;112476;9961;10423;79153,25,5.04352562615371000000
chr15,31014508,32510863,1496355,-1,1,161725;283710;54893;51621;4308;22909;1139,7,0.46780342899913500000
chr3,180678656,181472237,793581,-1,1,8087;6657;131118,3,0.37803324424349900000
chr17,43655747,44210822,555075,-1,1,246744;162540;104909134;1394;4137;284058,6,1.08093500878260000000
chr15,22765628,23179948,414320,-1,1,123606;23191;114791;81614,4,0.96543734311643200000
chr19,13933021,16320073,2387052,-1,1,5989;114770;117579;976;26993;30817;90379;10270;58525;8907;57834;4051;284433;66002;3337;10212;26658;26664;64926;126402;10755;5731;8529;23581;126541;84449;6511;26539;10994;4713;54862;4854;4218;84941;102724279;9524;79852;26538;90378;26532;85360;9466;55723;23476;126410;65249;22859;5585;390892;5566;84658;26659;11283;26333;388512;113230;646457;79883;7171;26017;126370;117286;342979;79173;342977,65,2.72302404807269000000
chr16,29673954,30198600,524646,-1,1,653808;5531;26470;283897;253980;146378;8479;83719;23475;283899;124446;9344;3835;4150;226;253982;83723;5595;6911;11151;8448;79447;112476;9961;10423;6693;79153,27,5.14632723779463000000
chr22,21465661,22750132,1284471,-1,1,7332;645426;150221;23753;23759;150223;29799;5594;9647;7441;440804;23119;8940;164592,14,1.08994286363803000000
chr10,89686508,90701032,1014524,-1,1,118932;643414;142910;57559;59;340654;643418;55328;8513;5728,10,0.98568392664934500000
chr10,89686508,90701032,1014524,-1,1,118932;643414;142910;57559;59;340654;643418;55328;8513;5728,10,0.98568392664934500000
chr10,89686508,90701032,1014524,-1,1,118932;643414;142910;57559;59;340654;643418;55328;8513;5728,10,0.98568392664934500000
chr16,29622757,30177916,555159,-1,1,653808;5531;26470;283897;253980;146378;8479;83719;23475;283899;124446;9344;3835;4150;226;253982;83723;5595;6911;8448;79447;112476;9961;10423;6693;79153,26,4.68334297021214000000
chr17,43706915,44351122,644207,-1,1,246744;162540;104909134;1394;4137;284058,6,0.93137764724692500000
chr5,1,22246041,22246040,-1,1,54463;10299;7204;1010;50834;79192;81037;11336;65980;50805;134147;153571;1501;56172;11044;64979;54491;22948;23194;1016;108;79888;10723;11076;23379;90441;1611;4651;4726;9037;10016;7015;6389;134145;133957;9319;340024;348932;153478;153572;54888;651746;85409;79844;83853;57491;4552;6550;90268;170690;134121;79072;1767;6715;441061;6531;134111;10409;55722;84246;389257,61,0.27420610589570100000
chr4,43922811,44674448,751637,-1,1,285525;386617,2,0.26608588986438900000
chr12,21017576,21404166,386590,-1,1,338821;28234;10599,3,0.77601593419384900000
chr17,17163674,17168181,4507,-1,1,8533,1,22.18770800976260000000
chr5,101735294,101735429,135,-1,1,133482,1,740.74074074074100000000
chr17,7206144,73956430,66750286,-1,1,83900;91608;2896;55040;83899;9931;9955;2688;91107;146853;5598;8678;201292;147183;7343;51655;57508;348235;10750;1394;7448;1659;786;6844;1442;2793;6154;85285;65264;113235;3728;54757;84440;100132386;80169;100462977;91647;51629;80179;3872;64750;201164;9020;9423;55244;8742;54785;80022;3131;28958;5606;7473;55731;55181;81558;400591;146850;22905;117246;100996259;284067;9400;1949;353149;9094;3690;7756;90507;92579;100506084;146909;317719;6388;728255;284071;1444;374819;388341;8687;8851;25926;84313;4222;3213;8631;125206;23495;201140;11056;2689;4628;54894;9570;9703;284021;10493;10615;672;6928;84951;51649;388403;284119;342510;974;54883;2064;1277;23131;10513;3216;347741;84669;6521;9513;22834;6909;388336;1655;246744;2081;57409;147007;5957;6613;83990;64518;9912;201158;80755;8834;516;474170;730755;6426;22843;7126;3858;3219;79154;124751;26073;6752;399512;4239;3292;124912;5691;4591;60528;81851;5573;5914;3866;752;6368;79999;3487;30833;8165;124599;79877;26284;22794;81870;162466;3691;84961;51195;3993;9618;79922;10609;8714;4620;644815;112483;84616;100505724;6774;3868;10871;27091;94103;29893;80725;8741;5175;85291;2232;124540;6470;10693;440435;26022;2874;9196;10197;8557;3211;2670;124872;125111;242;7732;54474;4137;11143;8153;9720;201243;6169;92591;125170;57125;54902;79170;81671;728318;100506650;5705;283985;6349;7314;2905;5198;218;101060321;9110;60386;80039;1411;6358;350;255061;360205;125113;9058;57659;339184;4843;10266;90506;642;51326;4215;57003;284086;57547;23531;79637;91607;64149;6356;6945;10349;162333;388419;94015;84643;9526;353288;1353;252983;8639;3996;124801;51321;2584;146852;146894;1352;23326;8313;5187;11248;124637;6354;55135;3880;7484;54799;51204;59344;7706;9212;9706;54890;10209;92340;100505591;9953;23135;3838;25979;284018;8148;11276;92736;342667;25984;8456;284076;5414;11325;654346;9349;55876;2826;1140;56970;146779;6720;10350;7157;728279;26115;5376;85290;6777;2145;10948;147011;81565;56953;644070;2648;146956;64847;9862;5889;5718;55106;80221;100130520;201191;23533;50964;643904;6416;51379;3980;3021;100134391;84940;26168;162605;30850;83902;388364;6871;124923;9256;7716;57335;1236;4804;140735;51;9572;85464;2319;51225;100130933;124773;27092;9368;9382;84282;84152;146754;9326;390790;3927;4836;30009;6143;9611;55090;85302;28964;284194;388394;162461;100996842;4779;254863;374786;3837;9755;4830;116840;2538;51701;5636;284099;6532;8396;3675;60681;27077;84667;4974;9482;7067;81871;83538;80347;284161;404093;388335;3215;26118;54752;4635;11072;136;535;388389;1267;100885850;11267;92335;51747;3430;4626;84687;9487;91603;9842;654364;26207;350383;653240;11216;57151;124602;83895;84336;6362;339263;6352;146862;201294;256223;51030;5245;399687;342538;124925;100131439;3674;7266;101927581;407977;64978;8161;57513;51651;51755;2256;78995;51081;57555;10614;1362;100505753;124995;9496;4763;124842;83755;2520;6357;8735;3882;124783;6662;9121;6665;5409;1443;146822;6351;83901;482;124817;147179;3857;55379;92521;58485;6198;163;5469;84514;57551;782;51168;8844;23512;162417;3212;146723;6668;201181;26574;4619;6830;7283;54903;57649;23098;28511;26083;56934;201266;57048;55175;4642;81033;2695;55316;84461;146802;8405;342618;201134;113026;5164;388333;1747;9527;79148;55890;256302;51751;55028;93649;254272;11232;6347;85451;8533;10351;3884;414059;1984;1973;2123;10140;2186;3886;7156;162494;22899;113277;6155;10476;6346;10743;5578;9520;5717;10237;4353;728224;390792;5697;2118;85280;22806;339210;84316;23415;55771;6348;51268;84081;4355;40;6605;124739;3060;5608;116238;9744;5430;79915;8787;92162;9969;230;7566;6359;124535;1845;47;3768;124857;4621;996;8522;339168;146845;729288;100533177;51264;83871;101060376;84299;2885;11314;8506;4761;80174;124930;146722;3396;56155;124808;10052;5539;11011;31;3384;51155;85294;100170841;284040;100533496;8526;57336;642843;3885;3881;8493;762;23558;26151;58488;192666;645027;379;10241;55062;10900;100885848;339287;3975;84366;84923;79893;7153;10882;1213;283987;388381;55852;284114;10672;9120;56985;116236;29115;388407;55813;3000;8689;146923;55803;59342;54475;643664;30837;2886;3859;81872;26689;162427;2124;3883;2535;8913;57532;63897;55273;6827;51393;1534;8288;284098;8711;3860;9343;9560;91369;147166;10642;645832;5892;51136;23461;23510;65266;9884;146849;79736;201299;5878;4669;10014;84073;27346;83897;729877;83896;54828;115024;729873;10400;5709;29916;10040;9902;4302;23580;146861;1636;81850;79089;100506736;94005;90313;644139;326624;162540;4831;79902;3773;23163;57636;201176;201229;100507608;990;1107;4905;147040;146691;51174;55288;9772;55352;968;339175;147015;124590;3965;9220;314;10238;90799;6603;93210;85293;5193;124626;117584;2314;284069;1440;79665;6776;90410;10481;79018;100132476;6329;146857;6341;79990;374768;3861;224;9340;201163;147184;85289;84314;124989;6355;84311;8688;494188;9043;4622;374286;51096;100129396;10626;140775;4185;6462;1819;342574;114659;414062;79777;6147;201161;3214;3759;284083;114881;80774;79132;284058;22901;284106;80279;3218;64446;124790;80320;94086;64132;6360;23164;83450;54868;125150;10517;125115;4356;1748;162387;283989;388436;162282;54549;414060;9001;3217;247;29098;256957;55163;23460;4025;9241;729220;124538;1770;643008;51226;4077;27175;10951;7703;162394;104909134;6442;400581;284110;246176;1101,867,1.29887083929498000000
chr1,234973514,239011061,4037547,-1,1,51742;56605;645745;9804;2786;1130;148789;3964;23029;57829;6905;55127;88;128178;4811;9453;7107;4548;6262,19,0.47058275730288700000
chr2,184350744,186657201,2306457,-1,1,91752,1,0.04335654209031430000
chr9,140426922,140878861,451939,-1,1,92715;92714;79813;116225;375775;64975;774,7,1.54888159685267000000
chr12,23155220,29617642,6462422,-1,1,6660;387849;341346;645177;586;11228;4033;26127;3709;57542;23012;160492;55711;8496;341350;51290;3845;100287284;728858;56938;144363;55259;9412;5744;55297;55726;196415;8082;51768;60488;79365,31,0.47969631200190900000
chr1,1,4944170,4944169,-1,1,57470;388588;85452;1677;83858;5590;127262;728661;199990;9636;100287898;79501;8510;64856;26155;81399;140625;55229;8764;65220;339456;375790;388581;148398;401934;643965;51150;8784;2782;9651;1855;9731;27237;57801;126789;81669;29101;339453;6497;643988;7161;126792;219293;163688;84808;388585;63976;6339;55052;254173;80772;11079;79258;984;54587;5192;54973;84069;339448;54998;9906;148870;116983;339451;55966;7293;118424;728642;2563;127281;55210;54991;83756;142678;441869;729759;1953;79906;49856,79,1.59784182134551000000
chr16,2828888,3817850,988962,-1,1,100463285;7755;84464;9074;54925;1773;114984;124222;197358;146434;84256;7752;646174;10942;10127;79903;7627;9235;91151;9088;84891;9080;260429;4993;10131;7727;79228;7760;64063;1387;360226;4210;64386;54985;124220;23059;51330;4992;79412;146439,40,4.04464478918300000000
chr15,23699760,30322138,6622378,-1,1,2562;7681;321;4948;57194;2558;23359;7082;8924;23742;7337;6638;2567;8926;653720;54551;4692;56160,18,0.27180568671857800000
chr17,29385382,30214286,828904,-1,1,2123;4974;55352;4763;55813;2124;84440,7,0.84448862594462100000
chr6,151432506,159277280,7844774,-1,1,79624;26575;26230;26271;57583;154043;50508;49861;729515;6993;7432;79683;54516;55005;57621;23345;80177;26034;84947;9590;2099;51106;4988;94120;8871;7430;404672;51429;56995;80129;22828;57492,32,0.40791487428446000000
chr15,20102541,35758169,15655628,-1,1,23015;57099;283694;643699;390538;9990;6638;22909;55505;8926;161725;283710;283685;653720;54893;283767;728498;2562;727832;9824;70;100996331;161779;4948;2558;114791;653125;653073;2567;54989;54551;56160;9716;57369;728047;321;7681;440270;256646;123606;23359;6263;254531;342184;89839;4692;1133;51234;23191;101059918;79768;89978;57194;81614;100287399;4308;1139;7082;8924;23742;51621;7337;89832;26585;56851;6447,66,0.42157363473378400000
chr10,124500982,135404471,10903489,-1,1,196792;253738;8433;399818;5791;282973;50632;10570;1793;340784;4942;7390;594857;119467;196743;9184;1571;84435;503542;10844;80313;256536;8038;4288;92170;36;118471;51363;170394;55844;54777;118670;4255;399823;1488;118611;2849;85442;387718;27287;118672;55760;282974;54764;664;282969;56647;119587;118856;101;1892;23172;80007;3167;642938;10539;118472;9679;3632;64376;84504;26098;50624;92565;390010;64077;93426,67,0.61448220840136600000
chr17,43717703,44159862,442159,-1,1,246744;162540;104909134;1394;4137;284058,6,1.35697791970762000000
chr2,199245541,208631364,9385823,-1,1,1493;940;130749;54891;57683;843;8837;285172;51602;60491;391475;151194;55759;130540;53938;129450;4719;57404;26010;130026;65065;57679;8828;79568;316;4709;100652824;58538;1195;65062;65061;79800;151195;205327;8324;150864;65059;151254;2825;23314;66008;117583;10152;130752;841;151246;1933;1385;7855;8609;55437;7341;8745;22868;659;29851;9689;130535;4999;200726,60,0.63926200185109000000
chrX,6446509,8128749,1682240,-1,1,51481;412;8228;26609;8226,5,0.29722275061822300000
chr12,116619704,116685582,65878,-1,1,23389,1,1.51795743647348000000
chr1,13804405,19441844,5637439,-1,1,1969;114827;81569;440567;8659;63036;11223;79814;353238;126917;55092;51032;7799;374955;5081;9696;842;10630;11330;388595;26099;55672;84966;51702;127707;80834;23254;11240;23352;27129;79180;128272;126755;4237;7709;23400;23013;29943;23341;1188;79363;6390;23207;54751;149563;55160;284723;55920;727684;84301;6248;348487;1187;55707;54455;23569,56,0.99335886383870400000
chr5,10001,22825583,22815582,-1,1,54463;10299;7204;1010;50834;79192;81037;11336;65980;50805;134147;153571;1501;56172;11044;64979;54491;22948;23194;1016;108;79888;10723;11076;23379;90441;1611;4651;4726;9037;10016;7015;6389;134145;133957;9319;340024;348932;153478;153572;54888;651746;85409;79844;83853;57491;4552;6550;90268;170690;134121;79072;1767;6715;441061;6531;134111;10409;55722;84246;389257,61,0.26736113941778900000
chrX,60814,7736547,7675733,-1,1,414;28227;51481;286530;57502;8226;8225;1438;3563;5613;25878;347527;415;416;207063;4267;293;412;7499;9189;438;64109;6473;8227;55344;8623;8908,27,0.35175793634301800000
chr3,93949,6007771,5913822,-1,1,51095;51185;3568;10752;9695;285362;27255;3708;57633;8553;6419;152330;55207,13,0.21982399876086900000
chr16,28837450,29042118,204668,-1,1,11273;27040;79874;7284;930;84901;487;83985;25970,9,4.39736548947564000000
chr22,18919942,20942862,2022920,-1,1,54487;27037;29801;65078;10587;1312;421;7290;2812;6899;5625;7625;79680;64976;6576;8218;5413;23617;7122;128977;8220;388849;84861;7353;51586;2928;128989;9993;54584;91179;85376;85359;8318;728229;5902,35,1.73017222628675000000
chr22,43206844,51178264,7971420,-1,1,11252;150383;85378;25771;23151;23774;80305;55267;25813;79174;150379;55007;1375;415116;83642;23542;553158;7380;6300;10343;83933;79924;23313;84247;6305;51512;1890;25830;23654;25817;29781;91289;26286;26150;85358;64800;410;400935;706;2192;56666;80274;5600;9701;27127;49;9889;414918;25809;758;9997;9620;1120;440836;64781;5465;112885;29780;644186;23170;23779;23209;7477;64098;25814;80339;10762;79087;55020;27349;55687;638;348645;85352;55615;113730;55586;54456,78,0.97849567580180200000
chr3,136141380,148247003,12105623,-1,1,53833;287015;344838;5948;25852;84107;83850;5947;26577;401089;729627;5922;54464;483;57047;55186;22808;51163;51208;545;8403;7220;9616;389151;5352;668;9276;80321;80723;23350;5291;253461;92369;57088;7545;5359;389152;51146;55179;347736;92370;64084;205428;256356;199221;349565;285195;4690;56945;5357;9435;7029;131890;10274;389158,55,0.45433432050543800000
chrX,139527393,155226073,15698680,-1,1,4110;2157;50814;541578;2556;139067;4104;494119;139728;8517;3423;6901;474383;92002;4105;57595;266740;2332;6845;84968;64663;9142;246100;100272147;728269;100533997;3149;26576;474382;8273;728695;6535;114824;393;23641;1038;55217;8270;537;3421;100132963;6658;4101;215;91966;4100;55879;2010;4534;6134;101928917;116442;100506164;2652;84548;100133053;100129239;2334;203547;139135;139081;60343;728458;8269;10046;728712;5956;2664;79184;4515;158521;4108;2564;8263;1193;492;1260;9130;3054;7411;9947;10134;79057;84631;30014;30848;441525;554;8266;8776;29944;494118;2539;7739;8260;55559;4204;65991;5365;8277;4354;10838;139735;2316;83692;11219;10251;55558;139716;645188;51438;1736;3654;5973;139065;4109;1852;3897;474384;6748;4103;474381;9248;1069;1485;1774;64648;4107;83740;89885;100130086;633,132,0.84083502561998800000
chr1,146155983,147824178,1668195,-1,1,9557;51205;51463;2703;5565;607;2702;2330;200030;149013,10,0.59945030407116700000
chr3,46852723,50824570,3971847,-1,1,10180;29072;64925;51385;5576;51246;10641;7318;11334;3373;55152;10293;440955;9807;387;6405;4634;23276;51372;7867;63891;29925;389119;8692;7869;54870;22907;10181;5364;7375;8927;84276;6599;5210;51447;1795;2779;200942;820;7866;5859;132228;6988;51364;11068;151903;646450;79714;84126;11070;7384;51161;375341;64147;11180;10425;10675;51409;54681;5745;2876;646424;788;79012;11186;339906;51517;327;4485;1294;84315;285231;1951;25915;339834;22937;90226;9254;646498;1154;4134;386724;10201;10869;3913;54859;10991;1605;389118;65010;2771;3615;23218;8372;993;4486;24142;11277;25930;275,100,2.51772034521974000000
chr22,18661748,21808979,3147231,-1,1,54487;27037;9342;29801;65078;10587;1312;6545;8214;7290;421;2812;6899;5625;7625;79680;23119;64976;6576;3053;8218;5413;80764;23617;400891;1399;7122;150209;128977;8220;388849;84861;7353;51586;2928;128989;5297;9127;9993;54584;91179;85376;8216;440804;85359;8318;728229;5902,48,1.52515020346457000000
chrX,60814,49489272,49428458,-1,1,414;6759;10214;729431;6756;27344;729447;729422;80311;6102;92552;254158;60506;56850;8225;10943;2824;100873985;170082;347541;139425;729408;59272;389840;170067;2002;8544;55634;2857;7592;425054;1438;645864;5931;7403;6839;51480;3750;7076;140462;8241;8623;347411;7454;265;645037;645051;158724;7355;6197;10084;347442;5355;55593;6303;7499;8409;51360;2710;8406;660;2925;171482;392465;5160;26748;11238;58526;57393;2623;6907;28227;4113;1536;3730;9468;23597;2187;6611;3563;2574;9767;9282;8712;139341;54539;256714;10742;9104;442444;6103;54880;2742;369;347344;347527;4007;438;7504;5277;9758;56548;645073;94056;10245;57502;11141;11152;641339;256643;23676;4114;6758;7712;5009;1654;4267;51284;2277;170302;79135;11230;441490;64743;55787;139422;170062;4935;4693;100288814;10013;1964;293;50943;53940;30011;6322;5638;28952;8239;94122;139411;286530;5634;84679;416;64840;10682;3266;25763;8227;389852;171483;8908;159013;7543;90060;168400;4281;24140;6247;10149;64109;1183;55344;27197;357;8233;286514;548313;6792;79742;4128;139105;139604;7102;10549;25878;4115;11040;6855;8573;55841;729396;729442;51481;795;10389;83604;1756;778;5422;9367;7317;5935;415;207063;4112;412;158506;158809;6990;5127;22866;5475;10159;100132399;7030;729428;190;7569;729201;89801;1968;57232;4943;79917;5256;26609;54960;6853;80231;25975;51311;8905;9189;395;347404;6473;171484;286464;63904;257397;80258;100008586;3052;4810;404281;5199;92745;5613;140456;257240;9185;27238;4129;2543;8228;158747;8226;56474;5165;7114;6399;5251;8481;8237;100130302,258,0.52196651572662900000
chr4,75677,7897940,7822263,-1,1,257236;7700;521;7469;401115;79155;4636;133060;55646;6286;654254;166793;54872;53407;114932;1609;55351;2121;79441;7468;152877;285489;353497;152789;9778;10861;92305;285498;57537;10815;27065;2580;53834;84179;5158;402160;3425;152687;4487;6047;54729;6002;54360;7466;10227;10336;57533;10417;93621;84286;345222;93624;2261;255403;4043;8602;7884;170960;57732;132884;10296;3064;3083;768239;57654;10460;85013;118;1400;3954;152;60312;23324;55330;339983;6452;5522;10608;1487;80273;2868;285464;8603,83,1.06107401400336000000
chr16,28543104,30119759,1576655,-1,1,552900;283897;83719;23475;283899;487;26471;445329;25970;226;253982;83723;11273;79874;6911;79447;112476;112869;728734;9961;83985;107282092;79153;653808;6799;5531;26470;8663;27040;253980;7284;146378;8479;124446;9344;3835;4150;728888;100507607;79008;8448;930;84901;10423;6817;6693,46,2.91756915748848000000
chr17,43659413,44219555,560142,-1,1,246744;162540;104909134;1394;4137;284058,6,1.07115695662885000000
chr1,180640058,186173009,5532951,-1,1,6041;6045;3140;116461;81626;80896;85397;51278;83872;23179;4688;1660;3918;127670;9887;127665;9213;116496;6004;23057;777;3915;81627;10625;10228;10092;23127;403314;54823;353299;80267;57710;81563;2752,34,0.61450029107432900000
chr17,34817422,36168104,1350682,-1,1,26574;284099;9326;284098;11072;6928;79154;79922;3975;11276;79893;11056;6871;31;80179,15,1.11055007766447000000
chr5,130723296,136659781,5936485,-1,1,51735;9555;3950;645121;347732;4090;8974;96459;10111;134548;56951;23338;5307;10802;54819;140947;5515;7320;819;27125;91368;3596;26223;3659;23176;27089;3308;3578;9879;3567;1437;6584;79770;728637;116842;6583;3565;23105;9547;23305;51128;7045;134553;8572;3562;153328;4762;84105;56990;7416;51265;6695;497189;6500;11127;134549;100996485;57113;2661;6932,60,1.01069909213954000000
chr16,29674336,30199351,525015,-1,1,653808;5531;26470;283897;253980;146378;8479;83719;23475;283899;124446;9344;3835;4150;226;253982;83723;5595;6911;11151;8448;79447;112476;9961;10423;6693;79153,27,5.14271020827976000000
chr17,34817422,36168104,1350682,-1,1,26574;284099;9326;284098;11072;6928;79154;79922;3975;11276;79893;11056;6871;31;80179,15,1.11055007766447000000
chr15,52851404,65115971,12264567,-1,1,79856;9236;9768;8854;100820829;283659;145788;5873;83464;256764;3175;6095;114294;102;55329;3990;6938;9245;101928527;9960;27023;771;663;51762;283807;8925;302;84191;440279;9488;4947;81488;92483;83660;145773;366;53944;145741;56204;5479;80119;54778;10776;161582;9133;145781;26108;9325;79811;23060;2958;51187;4643;54816;51065;64864;54629;54832;79664;388125;348093;6642;4734;23604;7168;84952;374618,67,0.54628915965806200000
chr12,98094511,105623025,7528514,-1,1,728568;55332;400;196472;84102;120863;50511;23325;3479;23074;9971;121601;55681;83468;51019;121457;79023;7296;121599;317;56899;27340;55576;429;5250;4604;56994;7112;29915;4801;283431;160728;374470;55198;5367;64431;7184;79158;5053;121053;160428;6996;493861;55010;246213;51559;50515,47,0.62429318720799400000
chrX,6552712,7964736,1412024,-1,1,412;8228;26609;8226,4,0.28328130400049900000
chr13,91927724,100462292,8534568,-1,1,160897;9375;11166;9071;55757;337867;2841;10150;22873;171425;27199;266722;3843;6564;10082;140432;23483;10160;5611;1880;10257;1638;8428;23348;2262;5911,26,0.30464342190489300000
chr16,29673954,30198600,524646,-1,1,653808;5531;26470;283897;253980;146378;8479;83719;23475;283899;124446;9344;3835;4150;226;253982;83723;5595;6911;11151;8448;79447;112476;9961;10423;6693;79153,27,5.14632723779463000000
chr11,100501475,106558195,6056720,-1,1,330;60496;5241;4314;143872;7225;838;10413;85016;4321;253935;329;4312;114769;440068;79659;4317;834;837;84437;2893;414301;80310;114908;4316;9313;4322;84259;59082;4319;57562;143879;2977;64066,34,0.56135994399609000000
chr15,72963770,75434301,2470531,-1,1,57184;1445;192683;84993;10021;9377;5371;10620;79748;80381;161514;9399;57611;1543;1544;585;283677;25989;10066;83440;64220;60490;4756;1198;594855;8482;80153;3671;1583;54913;80125;4351;388135;342096;4016;27020,36,1.45717661506777000000
chr7,63249650,69650886,6401236,-1,1,51351;55069;154807;730291;55253;442319;26053;168374;51119;168417;154881;27342;109504726;2990;51427;2086;435;27297;340252;10793;728927;8460;7697,23,0.35930560910424200000
chr7,95614141,95786507,172366,-1,1,1780;10165,2,1.16032164115893000000
chr7,95625198,96132805,507607,-1,1,1780;7979;10165,3,0.59100839822933900000
chr7,95667046,95872044,204998,-1,1,1780;10165,2,0.97561927433438400000
chrX,3223859,13798048,10574189,-1,1,51481;171482;3052;425054;4281;9367;4935;5613;100288814;412;51480;1183;9758;6907;357;265;57502;8228;8226;3730;92552;10943;2824;5634;7114;26609;25878;170082;6399;25975;51311;51284;395;55841;171484;8481;171483,37,0.34990863129077800000
chrY,14061053,24507417,10446364,-1,1,353515;442862;8284;9087;378950;140032;378948;5940;100533178;159163;7404;8287;8653;353513;22829;159119;9426;9084;86614;378949;9086;9082;203611,23,0.22017230109921500000
chr16,6754986,7238665,483679,-1,1,54715,1,0.20674869076391600000
chr18,131700,7842179,7710479,-1,1,91133;116;55556;10403;9663;645369;103910;642597;7050;339291;9984;9097;7525;81035;23347;10627;5797;494514;64863;1068;8736;9229;27098;284217;79822;84034;23136;7298;7541,29,0.37611152303248600000
chr7,95693340,95862369,169029,-1,1,1780;10165,2,1.18322891338173000000
chr21,14597008,29284970,14687962,-1,1,140578;54148;54149;11096;9510;317754;64092;58494;6782;4685;149998;8204;10950;54033;29761;351;116159;5651;522;388813;2551;1525,22,0.14978252258550200000
chr22,18661748,21440484,2778736,-1,1,54487;27037;9342;29801;65078;10587;1312;6545;8214;7290;421;2812;6899;5625;7625;79680;64976;6576;3053;8218;5413;80764;23617;400891;1399;7122;150209;128977;8220;388849;84861;7353;51586;2928;128989;5297;9127;9993;54584;91179;85376;8216;85359;8318;728229;5902,46,1.65542894323174000000
chr18,71021383,78012800,6991417,-1,1,125704;26251;1528;55628;201456;79863;80148;400658;9150;4772;84735;644041;10194;9658;284273;4155;27164;440498;22850;84552;55748;374868;29090;10907;284274;7776;2587,27,0.38618780713552100000
chr16,28833436,29046284,212848,-1,1,11273;79874;7284;930;84901;27040;487;83985;25970,9,4.22836954070510000000
chr15,30583437,32655227,2071790,-1,1,728498;101059918;51621;89832;22909;161725;283710;54893;89839;4308;1139,11,0.53094184256126300000
chr17,48539,1806001,1757462,-1,1,10594;51031;50628;29928;286753;124935;727910;5345;29;400566;8578;359845;55178;4641;55275;83547;114826;124997;5176;100506388;1398;79850;7531;5306;727857;9501;64359;6117;51763,29,1.65010680174024000000
chr22,18661748,21540317,2878569,-1,1,54487;27037;9342;29801;65078;10587;1312;6545;8214;7290;421;2812;6899;5625;7625;79680;64976;6576;3053;8218;5413;80764;23617;400891;1399;7122;150209;128977;8220;388849;84861;7353;51586;2928;128989;5297;9127;9993;54584;91179;85376;8216;85359;8318;728229;5902,46,1.59801623653975000000
chr15,25257217,25375376,118159,-1,1,,0,0.00000000000000000000
chr19,11338618,13327698,1989080,-1,1,773;126074;9592;79973;2057;439;84337;374882;10224;163059;811;9545;256126;7001;84261;10535;147837;90480;7620;115948;90594;57474;388507;5886;90576;55552;90589;126075;105372280;51710;7568;54831;30000;2639;163049;79002;126070;126069;1264;10661;7695;4125;163050;51398;84292;90592;199692;51295;55621;1777;2193;57572;22983;729747;5589;4066;57139;64748;1995;115950;1725;8677;126068;4784;199699;284390;83546;284391;54;112939;26526;29911;55908;3726;163051,75,3.77058740724355000000
chr18,142096,7730720,7588624,-1,1,91133;116;55556;10403;9663;645369;103910;642597;7050;339291;9984;9097;7525;81035;23347;10627;5797;494514;64863;1068;8736;9229;27098;284217;79822;84034;23136;7298;7541,29,0.38215096702643300000
chr15,22784523,23076420,291897,-1,1,123606;23191;114791;81614,4,1.37034638930856000000
chr15,31014508,32510863,1496355,-1,1,161725;283710;54893;51621;4308;22909;1139,7,0.46780342899913500000
chr12,116422515,116591442,168927,-1,1,23389,1,0.59197168007482500000
chr3,195731986,197339300,1607314,-1,1,622;255798;80235;200933;5062;5130;4241;26043;1739;84984;348793;255758;116211;131540;200931;375387;22916;7037;165918;54965;205564,21,1.30652753600106000000
chr5,38129,6257996,6219867,-1,1,4726;10016;7015;6389;79192;81037;11336;133957;9319;340024;65980;348932;153478;153572;85409;79844;50805;153571;57491;55722;6550;64979;170690;79888;10723;6531;11076;23379;389257,29,0.46624791173187500000
chr16,29673954,30198600,524646,-1,1,653808;5531;26470;283897;253980;146378;8479;83719;23475;283899;124446;9344;3835;4150;226;253982;83723;5595;6911;11151;8448;79447;112476;9961;10423;6693;79153,27,5.14632723779463000000
chr18,74251345,77982126,3730781,-1,1,26251;4155;27164;440498;22850;79863;80148;9150;84552;374868;4772;10907;7776;2587,14,0.37525654815975500000
chr4,71552,3845097,3773545,-1,1,10336;7700;521;7469;401115;79155;4636;10417;84286;654254;345222;54872;1609;2261;255403;79441;4043;8602;7884;170960;57732;7468;152877;10296;3064;3083;285489;57654;353497;10460;285464;118;3954;10861;152;92305;285498;339983;10815;2580;53834;84179;5158;402160;3425;10608;6452;152687;1487;6047;54729;2868;6002;10227;8603,55,1.45751541322549000000
chr15,31014508,32914140,1899632,-1,1,9824;51621;653125;22909;161725;283710;54893;643699;4308;728047;1139,11,0.57905952310763400000
chr18,70990530,78013728,7023198,-1,1,125704;26251;1528;55628;201456;79863;80148;400658;9150;4772;84735;644041;10194;9658;284273;4155;27164;440498;22850;84552;55748;374868;29090;10907;284274;7776;2587,27,0.38444025072338800000
chr19,3932785,4523183,590398,-1,1,126259;51341;1938;5605;51588;1613;55620;56961;6455;170961;84699;80700;10036;27231;729359;84717;440503;10148;55702;84954;79187;51548,22,3.72629988583972000000
chr16,86011033,87846920,1835887,-1,1,79791;64779;100506581;54758;2294;81631;57338;23174;2300;2303,10,0.54469583367603800000
chr3,56846587,64376680,7530093,-1,1,8309;55079;57415;6314;2317;11102;200845;50650;8618;131177;201627;80145;201626;166336;142686;26060;9861;5162;7871;378;57406;200844;1776;132204;353324;201625;8820;54756;11170;132203;54899;2272;5793,33,0.43824159940654100000
chr19,260911,665883,404972,-1,1,25759;54531;610;51298;27006;126567;284451;55658;5442;682;8612;997;8174;91978;3004,15,3.70395977993540000000
chr17,43706886,44345038,638152,-1,1,246744;162540;104909134;1394;4137;284058,6,0.94021487043839100000
chr14,53854446,56266748,2412302,-1,1,10668;93487;9787;652;23034;11169;387332;22863;1033;55030;3958;3895;122809;2643;10175;2764,16,0.66326687122922400000
chr10,134001731,135372492,1370761,-1,1,118472;10844;80313;3632;85442;27287;8433;93426;282974;50632;84435;10570;92170;84504;282969;118471;170394;196743;54777;101;1892;1571;503542,23,1.67790008615652000000
chr8,330897,10788241,10457344,-1,1,389610;401447;728358;503841;1669;504180;26260;203076;55894;1667;245910;157285;245908;100132396;503618;54984;392188;157695;100289462;4482;203074;9228;245909;90459;9920;1672;1668;9172;503614;140596;83595;100133251;653423;645402;100131980;137075;157697;1673;64478;1671;9639;100131608;79648;1670;286046;285;79660;8658;9258;414325;55326;94137;10407;645836;2055,55,0.52594616759284200000
chr6,18596430,22732054,4135624,-1,1,1871;54901;6659;5617;3400;154150;154141,7,0.16926103533590100000
chr9,220253,12772530,12552277,-1,1,58524;10171;23081;55664;89882;50808;158358;81704;23189;5789;6019;1761;169792;55064;6505;29126;2315;5991;26953;90865;7436;3717;90871;6013;57589;3641;7306;403313;169522;115426;6595;79956;9933;2731;55848;11172;10655;80380,38,0.30273391831617500000
chr7,94996761,100304901,5308140,-1,1,64816;6863;8896;1551;255374;221914;4885;55262;3268;221908;7979;10980;10165;89122;4951;10095;64598;81628;100861540;25798;9551;6878;2783;7586;100526740;563;7589;7036;1750;101927655;285989;222865;55971;10552;440;5445;1577;1576;55063;222950;100316904;23660;1749;51666;57001;64599;57154;81392;245812;221785;79027;26261;402569;4176;79037;1780;7551;56257;352954;79690;349149;441272;11333;10898;389541;9179;22853;8295;5166;84124;10734;402573;29992;29990;168620;25851;221786;4034;26024;5446;100289187;51412;5118;10248,84,1.58247521730776000000
chr11,125232584,134446160,9213576,-1,1,120224;9743;63970;2313;29087;84623;334;89944;283171;403312;56980;55572;4798;399967;6768;83700;399968;56;79607;27087;3758;22997;6484;9638;8538;170689;83480;9538;114609;29118;399979;112936;6734;84881;50863;27034;3762;4978;2113;219833;23310;63876;112937;100169851;3703;219844;50937;11095;1111;28960;219938;160065;29068,53,0.57523810516134000000
chr10,122761628,135372492,12610864,-1,1,196792;253738;1755;8433;399818;5791;282973;50632;10570;1793;340784;4942;54780;7390;594857;119467;196743;118663;9184;1571;84435;503542;10844;80313;256536;8038;4288;5654;92170;36;118471;51363;170394;55844;54777;118670;4255;399823;1488;118611;11101;2849;85442;387718;27287;118672;59338;2263;55760;282974;54764;664;282969;56647;119587;118856;101;1892;23172;80007;3167;642938;387715;10579;10539;118472;9679;3632;64376;84504;26098;50624;92565;399814;390010;64077;93426,77,0.61058465145607800000
chr21,14417523,34894625,20477102,-1,1,54148;337882;11096;2897;9875;9073;29104;337960;571;10950;337970;56245;54943;643812;7074;9510;116448;337959;4685;337968;149998;337973;26046;351;10069;116159;56683;100131902;522;59271;337963;337967;337878;3588;10215;337979;140578;100288323;54149;337971;337985;8204;30811;3454;337974;337977;5651;337969;388813;2618;337976;57466;757;54069;2551;3455;1525;140258;56246;10600;26285;10694;337975;337880;100288287;3460;317754;6647;8867;94104;150051;64092;58494;337966;388818;337978;337879;254950;56911;54033;140290;29761;284827;337972;6782;643803;728299,87,0.42486480752989400000
chr11,102960249,108811599,5851350,-1,1,54733;837;23086;54734;84437;91801;2893;414301;80310;60496;38;472;160140;4863;84259;1662;143884;79659;838;8065;6588;59082;143879;2977;114769;440068;55531;834;143888,29,0.49561212369795000000
chr11,88087211,89399954,1312743,-1,1,219595;2915;7299;50507,4,0.30470549071676600000
chr11,119446095,134446160,15000065,-1,1,219874;53340;63970;9743;2900;84623;26595;7007;219873;23650;89944;283171;5818;56253;403312;219870;56980;219875;55572;83700;6768;399967;56;79607;390261;3758;26493;22997;9638;83480;114609;79684;641654;112936;6653;84881;50863;27034;55800;90952;219858;219833;63876;100169851;283162;283160;390259;390271;219844;23365;64221;390265;220296;1111;50937;28960;219938;4900;79864;6309;219854;390275;120224;7753;29087;2313;219899;57476;334;219869;4013;23584;390260;414899;84897;79827;54414;219865;283159;116337;4798;399968;27087;26492;6484;8538;170689;54538;9538;29118;399979;3312;390264;6734;84959;219902;3762;4978;2113;338662;23310;112937;3703;25833;11095;219855;80071;160065;338661;29068;220323,111,0.73999679334722900000
chr1,167238254,173490508,6252254,-1,1,481;9588;375035;9095;8548;149281;2153;6402;51603;356;92346;57821;2328;7292;5451;9019;10560;25874;80133;8674;6401;5396;51430;23215;92344;5279;8804;55827;92342;26052;29922;6403;1805;55811;2329;2326;919;2327;55732;6375;261726;57147;22920;4653;92241;284525;6846;23432;8995,49,0.78371736017122800000
chr17,16720871,20254254,3533383,-1,1,2314;55244;125170;55090;11216;79018;79999;10400;54890;254272;9706;400581;92521;8533;22905;729288;5598;218;23164;83450;224;51168;80039;51655;201163;7156;51030;5636;644815;10750;4239;10517;654346;10743;388436;27077;140775;6470;146691;1819;6720;125206;23495;147166;7732;146802;91647;56953;645027;3996;201164,51,1.44337593745145000000
chr1,746608,5407101,4660493,-1,1,57470;388588;85452;1677;83858;5590;127262;728661;199990;9636;100287898;8510;64856;26155;140625;55229;8764;65220;339456;375790;388581;148398;401934;643965;51150;8784;2782;9651;1855;9731;27237;57801;126789;81669;29101;339453;6497;643988;7161;126792;219293;163688;84808;388585;63976;6339;55052;254173;80772;11079;79258;984;54587;5192;54973;84069;339448;54998;9906;148870;116983;339451;55966;7293;118424;728642;2563;127281;55210;54991;83756;142678;441869;1953;79906;49856,76,1.63072876624855000000
chr9,140240417,141018984,778567,-1,1,92715;92714;774;10811;54932;377841;26012;79813;116225;375775;64975,11,1.41285207310354000000
chr9,204193,13069583,12865390,-1,1,58524;10171;23081;55664;89882;50808;158358;81704;23189;5789;6019;286343;1761;169792;55064;6505;29126;2315;5991;26953;90865;7436;3717;90871;6013;57589;157983;3641;7306;403313;169522;115426;6595;79956;9933;2731;55848;11172;10655;80380,40,0.31091167854219700000
chr16,72125903,80637770,8511867,-1,1,55159;54957;4166;51741;10143;388289;463;1504;170692;79726;23563;9564;83657;79152;5713;54386;22879;197257;497190;79583;283927;124359;197259;23536;10428;440348;440387;11345;57687;124491;85445;4094;100130958;9785;83449;162239;2734;84937;3735,39,0.45818385085199300000
chr14,48375843,50801420,2425577,-1,1,8814;55172;6655;122773;382;79609;27109;6166;23588;9147;6235;79944;5427;4247;122769,15,0.61840955780830700000
chr6,10181231,11244604,1063373,-1,1,4117;51522;54898;347744;7020;221711;221710;4739;9247;405754;55003;81853;2651,13,1.22252492775348000000
chr22,21803362,22959729,1156367,-1,1,7332;23753;5594;7441;8940;23532;129025;645426;29799;150221;140883;23759;150223;9647;23119;164592,16,1.38364377399217000000
chr16,29675312,30199351,524039,-1,1,653808;5531;26470;283897;253980;146378;8479;83719;23475;283899;124446;9344;3835;4150;226;253982;83723;5595;6911;11151;8448;79447;112476;9961;10423;6693;79153,27,5.15228828388727000000
chr22,43415599,51208042,7792443,-1,1,150383;85378;25771;23151;23774;80305;11158;55267;25813;79174;150379;55007;1375;415116;83642;23542;553158;7380;6300;10343;83933;79924;23313;84247;6305;51512;1890;25830;23654;25817;29781;91289;26150;85358;64800;410;400935;706;2192;56666;80274;5600;9701;27127;49;9889;414918;25809;758;9997;9620;1120;440836;64781;5465;112885;29780;644186;23170;23779;23209;7477;64098;25814;80339;10762;79087;55020;27349;55687;638;348645;85352;55615;113730;55586;54456,77,0.98813683975615900000
chr22,50058563,51244566,1186003,-1,1,85358;410;400935;85378;9701;56666;5600;49;9889;23774;80305;11158;414918;79174;9997;1120;440836;1375;415116;83642;23542;644186;23209;6300;83933;79924;79087;6305;1890;23654;113730;29781;55586;91289;54456,35,2.95108865660542000000
chr2,162836450,165053834,2217384,-1,1,1803;25801;57282;64135;90134;2641;2191;55137,8,0.36078550219538000000
chr19,13933021,16320073,2387052,-1,1,5989;114770;117579;976;26993;30817;90379;10270;58525;8907;57834;4051;284433;66002;3337;10212;26658;26664;64926;126402;10755;5731;8529;23581;126541;84449;6511;26539;10994;4713;54862;4854;4218;84941;102724279;9524;79852;26538;90378;26532;85360;9466;55723;23476;126410;65249;22859;5585;390892;5566;84658;26659;11283;26333;388512;113230;646457;79883;7171;26017;126370;117286;342979;79173;342977,65,2.72302404807269000000
chrY,19048559,24874466,5825907,-1,1,353515;442862;8284;378950;140032;378948;5940;100533178;159163;378951;9081;159119;9426;86614;378949;9086;9082;203611,18,0.30896476720277200000
chr22,18894835,20246876,1352041,-1,1,54487;27037;5413;29801;65078;23617;10587;1312;7122;8214;421;7290;128977;8220;2812;388849;7353;2928;128989;6899;9993;54584;5625;79680;64976;8318;5902;6576;8218,29,2.14490536899399000000
chr9,33755689,38536886,4781197,-1,1,54926;203260;57462;92014;259308;5079;51754;392309;401505;79269;2189;730098;9853;6461;25853;7094;80256;84688;6366;1211;10488;2592;138716;55833;971;23349;25822;1271;10280;219;27240;7415;100129969;10020;84720;56656;7016;5646;4882;8434;9380;375704;6363;84904;10850;9925;730112;26267;11258;26206;881;51010;7169;9827;347252;347240;64425;203259;138715;10497;51271;392307;158234;57704;3590;9833;138724;646962;27019;158376;84186;692094;84681;768;152007;22844;152006;318;30968,79,1.65230589745622000000
chr22,18894835,21032422,2137587,-1,1,54487;27037;29801;65078;10587;1312;8214;421;7290;2812;6899;5625;7625;79680;64976;6576;8218;5413;23617;7122;128977;8220;388849;84861;7353;51586;2928;128989;9993;54584;91179;85376;85359;8318;728229;5902,36,1.68414197878262000000
chr5,112197427,125960868,13763441,-1,1,4015;93166;501;28966;56929;51014;167227;57507;353376;1176;644100;285605;9627;64848;3295;51808;51334;100505841;83942;153241;1657;6728;100302736;25816;153443;153733;9140;5229;94033;65983;1036;340069;6643;4163;51397;5480;1456;3781;55521;206338;7905;57556;133923,43,0.31242187182696500000
chrX,2669425,10046907,7377482,-1,1,414;6907;357;51481;171482;57502;8228;8226;3730;425054;26609;4935;5613;25878;347527;100288814;415;416;7499;412;51480;55841;171483;8908,24,0.32531424678501400000
chrX,61931689,71653424,9721735,-1,1,51248;142689;139886;55613;407;158833;100132994;2833;340554;340526;158835;367;5303;23229;9843;139562;3476;158830;9203;101059915;60401;340527;27112;4435;93953;139285;24137;4478;4983;55906;392490;9754;5030;54413;56159;6872;9968;64219;81887;347516;1947;4303;1741;3561;55869;286451;100130361;29934;54857;11326;84889;4841;8473;2705;347517;54821;6191;1896;26548,59,0.60688755659355000000
chrX,2687082,55247851,52560769,-1,1,23096;414;64061;6759;9500;10214;170685;727837;729431;6756;9502;10916;8242;27344;729447;54328;729422;80311;6102;54954;90737;92552;254158;60506;56850;10943;2824;100873985;170082;347541;139425;729408;59272;389840;170067;81557;2002;7216;8544;55634;2857;7592;57477;425054;727866;645864;5931;10075;7403;6839;51480;3750;7076;140462;8241;347411;7454;203569;27301;265;645037;645051;158724;7355;6197;10084;347442;5355;55593;158787;6303;7499;8409;51360;2710;8406;660;2925;171482;392465;5160;26748;11238;653220;58526;23133;57393;2623;6907;4113;1536;3730;9468;23597;2187;389860;6611;2574;9767;9282;8712;347365;139341;54539;256714;10742;9104;494197;29057;442444;6103;54880;90736;2742;369;280658;170627;347344;347527;8243;4007;7504;5277;9758;56548;1184;645073;94056;10245;57502;11141;653067;11152;90121;641339;256643;23676;4114;6758;8852;7712;23708;5009;1654;51284;2277;170302;79135;11230;9210;441490;64743;389856;55787;139189;139422;170062;4935;4693;100288814;10013;1964;55190;50943;53940;30011;6322;5638;28952;8239;94122;139411;2245;5634;84679;9506;416;64840;10682;3266;5207;25763;389852;170626;171483;8908;159013;7543;90060;168400;4281;24140;6247;10149;1183;27197;357;8233;286514;548313;6792;79742;4128;139105;139604;7102;10549;25878;4115;11040;6855;8573;55841;729396;729442;51481;3028;795;10389;83604;1756;778;5422;9367;7317;5935;100463488;54552;415;4112;412;158506;340602;158809;6990;5127;22866;5475;10159;212;85417;100132399;7030;729428;190;7569;729201;89801;1968;57232;4943;79917;5256;26609;54960;6853;80231;25975;51311;8905;395;347404;171484;286464;63904;257397;80258;100008586;3052;4810;404281;5199;92745;5613;140456;257240;9185;27238;4129;2543;65267;8228;158747;8226;56474;5165;7114;6399;728239;5251;8481;8237;6757;100130302,294,0.55935254676353800000
chrX,55479427,58051765,2572338,-1,1,10325;139628;550643;286430;7789;474343;29978;11279;158584;28986;169981;158586;158880;54466,14,0.54425196066768800000
chr2,183291363,188498365,5207002,-1,1,91752;55854;2487;165215;54431;142679;5136;7035;10203;151112;3685;129401;10787,13,0.24966381806651900000
chr2,174230303,182123207,7892904,-1,1,3235;1123;129831;344191;150737;3232;3238;51661;57703;3236;4780;3234;151126;83879;494513;9541;518;80856;3237;10651;10477;6670;100131390;92104;151556;3239;1386;114880;3233;29789;8540;220988;50940;79634;91404;3231;1134;8575;285025;65977;7273;7456,42,0.53212353780053600000
chr12,299773,3907929,3608156,-1,1,283358;6539;7004;56341;55846;5893;81029;83695;2288;775;2305;4815;6540;84766;84318;7289;144699;654429;10867;5927;83714;93589;65125;196513;23085;79602,26,0.72058968625525100000
chr22,47950091,51208042,3257951,-1,1,85358;410;400935;85378;9701;56666;5600;49;9889;23774;80305;11158;414918;79174;9997;1120;440836;1375;415116;83642;23542;644186;23209;6300;83933;79924;79087;6305;1890;348645;23654;25817;113730;29781;55586;91289;54456,37,1.13568313335590000000
chr1,165623553,165696996,73443,-1,1,4259;54499;223,3,4.08480045749765000000
chr16,22720290,25519775,2799485,-1,1,55114;5930;343;6340;79728;56061;4706;10595;23062;124454;63928;6338;115584;9956;5347;84516;5579;57478;91949;27327;51451;10368;342357,23,0.82157968340605500000
chr2,162836450,165053834,2217384,-1,1,1803;25801;57282;64135;90134;2641;2191;55137,8,0.36078550219538000000
chr22,51116128,51208017,91889,-1,1,49;11158;85358,3,3.26480862780093000000
chr1,144007866,147735815,3727949,-1,1,9557;148738;128077;27246;84265;11126;400818;9659;10628;2330;653519;8799;149013;5174;388677;10401;200035;51205;284615;8515;51463;5565;148741;607;2702;10623;200030;100132406;2703;9939,30,0.80473203898443900000
chrX,1,8097652,8097651,-1,1,414;28227;51481;286530;57502;8226;8228;8225;1438;3563;26609;5613;25878;347527;415;416;207063;4267;293;412;7499;9189;438;64109;6473;8227;55344;8623;8908,29,0.35812854863712900000
chr5,112197427,125960868,13763441,-1,1,4015;93166;501;28966;56929;51014;167227;57507;353376;1176;644100;285605;9627;64848;3295;51808;51334;100505841;83942;153241;1657;6728;100302736;25816;153443;153733;9140;5229;94033;65983;1036;340069;6643;4163;51397;5480;1456;3781;55521;206338;7905;57556;133923,43,0.31242187182696500000
chr22,43264598,51219009,7954411,-1,1,11252;150383;85378;25771;23151;23774;80305;11158;55267;25813;79174;150379;55007;1375;415116;83642;23542;553158;7380;6300;10343;83933;79924;23313;84247;6305;51512;1890;25830;23654;25817;29781;91289;26150;85358;64800;410;400935;706;2192;56666;80274;5600;9701;27127;49;9889;414918;25809;758;9997;9620;1120;440836;64781;5465;112885;29780;644186;23170;23779;23209;7477;64098;25814;80339;10762;79087;55020;27349;55687;638;348645;85352;55615;113730;55586;54456,78,0.98058800331036500000
chr6,163911310,170892907,6981597,-1,1,168002;10846;387263;55274;55780;285800;2853;4301;113402;5134;9444;401285;3834;5689;54346;253769;100128124;168090;79981;7058;83887;6991;6196;11116;8635;28514;84498;6862;51660;64094;1235;6953;6908,33,0.47267122407666900000
chr10,127967525,135372492,7404967,-1,1,253738;85442;27287;8433;5791;282974;282973;50632;10570;1793;664;282969;594857;119467;196743;101;1892;1571;642938;84435;503542;10539;118472;10844;80313;256536;3632;8038;4288;92170;84504;118471;170394;4255;55844;54777;399823;93426;118611,39,0.52667351522295800000
chrX,102754735,105202282,2447547,-1,1,158983;80712;644353;5354;9643;85012;286527;56157;203562;142684;286436;139231;401612;26280;79921;203447;9338;51209;441509,19,0.77628744207976400000
chrX,2669425,10046907,7377482,-1,1,414;6907;357;51481;171482;57502;8228;8226;3730;425054;26609;4935;5613;25878;347527;100288814;415;416;7499;412;51480;55841;171483;8908,24,0.32531424678501400000
chrX,149814131,150521716,707585,-1,1,83692;8776;4534;3149;9248,5,0.70662888557558500000
chrX,139585235,140828985,1243750,-1,1,30014;64663;645188;1038;728712;728695;64648;6658;23641,9,0.72361809045226100000
chrX,112424746,117817202,5392456,-1,1,139818;57631;90293;3598;186;54521;3358;51213;5358;139804;203413;11254,12,0.22253310921776600000
chr10,124785795,135372492,10586697,-1,1,2849;253738;85442;387718;27287;8433;399818;55760;5791;282973;10570;54764;282974;1793;664;50632;340784;282969;4942;7390;594857;56647;119467;196743;119587;118856;9184;101;1892;23172;1571;3167;642938;84435;503542;10539;399823;118472;10844;9679;80313;256536;3632;8038;4288;92170;84504;26098;36;118471;51363;170394;92565;55844;390010;54777;64077;4255;1488;93426;118611,61,0.57619482261559000000
chr21,40887141,48056450,7169309,-1,1,386672;5211;4599;5316;54084;106865373;56894;6285;3689;8209;1409;54101;1826;386679;386676;386680;386681;326;53347;5121;5152;1476;3275;54059;10317;1292;5116;84221;29947;64699;11077;6612;63977;755;8566;1291;7307;7113;875;7032;150094;85395;386685;353323;7031;7109;386674;386675;386683;8568;4731;6450;23076;6573;104;353332;5822;4047;4600;54039;54058;7033;386677;89765;353333;23181;25825;23275;90625;49854;23308;754;89766;386678;8888;25966;54020;80781;386684;7327;9619;10785;386682;54097;10841;81543;7226;150084,88,1.22745441715513000000
chr10,48381471,51593795,3212324,-1,1,143162;5599;6572;2662;644168;267004;26095;8031;118461;282966;58504;100652748;100287932;8505;2658;57705;474354;170371;1103;2074;170370;5949;4477;644054;196740;55753,26,0.80938286424408000000
chr4,71552,11934107,11862555,-1,1,728373;257236;7700;521;7469;79155;644414;401115;728393;133060;4636;728419;55646;6286;654254;53407;54872;166793;114932;1609;55351;9948;2121;79441;100287513;7468;152877;285489;3166;84448;1816;353497;152789;100287205;9778;10861;92305;285498;57537;100287404;728379;8532;10815;27065;2580;53834;84179;5158;116449;728386;402160;3425;152687;4487;6047;54729;6002;54360;728405;27201;7466;10227;57533;10336;9957;10417;152992;93621;93624;345222;84286;56606;2261;255403;4043;8602;7884;170960;100287441;57732;132884;10296;3083;3064;100287238;768239;100287364;57654;10460;85013;728400;100287327;100287478;118;1400;3954;152;100288520;60312;85460;94031;23324;55330;728369;100287178;339983;6452;5522;10608;1487;100287144;8310;80273;2868;54436;389199;285464;8603,118,0.99472668409124300000
chr10,124347712,135372492,11024780,-1,1,196792;253738;1755;8433;399818;5791;282973;50632;10570;1793;340784;4942;7390;594857;119467;196743;9184;1571;84435;503542;10844;80313;256536;8038;4288;92170;36;118471;51363;170394;55844;54777;118670;4255;399823;1488;118611;2849;85442;387718;27287;118672;55760;282974;54764;664;282969;56647;119587;118856;101;1892;23172;80007;3167;642938;10539;118472;9679;3632;64376;84504;26098;50624;92565;399814;390010;64077;93426,69,0.62586282900883300000
chr8,77202489,81908442,4705953,-1,1,51101;55824;3574;23462;5569;11075;7163;79776;619279;65986;28957;5828,12,0.25499617186997000000
chr17,7468348,9739959,2271611,-1,1,146754;388333;9423;54785;92162;5187;23533;643904;124637;6665;55135;482;59344;100996842;9212;23135;146850;58485;9513;26168;3000;5198;146845;242;1973;116840;1949;9340;399512;22899;112483;84314;6844;162387;6154;247;84667;1107;29098;9482;6462;7157;968;9196;84316;201140;9526;80169;124751;81565;4628;644070;124739;146849;146852,55,2.42118919128319000000
chr1,61090783,75230948,14140165,-1,1,100526835;9295;163782;81573;4774;1647;148581;5733;57708;23169;54741;9406;57554;6121;85440;10022;26135;4919;200132;79971;10207;127254;84455;27329;149233;3716;9829;400757;5142;54596;3595;127255;57685;51086;83941;55970;27022;11147;29929;1429;7398;55635;127253;5236;84938;3953;55631;9077;257194;84251;79819;205;55225;1491;8790;23421,56,0.39603498261866100000
chr11,121578616,134266032,12687416,-1,1,219874;53340;63970;9743;84623;26595;219873;89944;283171;56253;403312;219870;56980;219875;55572;83700;6768;399967;56;79607;390261;3758;26493;22997;9638;83480;114609;79684;641654;112936;50863;84881;27034;55800;90952;219858;219833;63876;100169851;283162;283160;390259;390271;64221;220296;219844;390265;1111;50937;28960;219938;4900;79864;219854;390275;120224;7753;29087;2313;57476;334;219869;4013;23584;390260;414899;84897;79827;54414;219865;283159;116337;4798;399968;27087;26492;6484;8538;170689;54538;9538;29118;399979;3312;390264;6734;84959;3762;4978;2113;338662;23310;112937;3703;11095;219855;80071;160065;338661;29068,100,0.78818255821358700000
chr13,33963658,58206132,24242474,-1,1,51569;729240;79612;2862;89890;26586;8900;9724;283518;144809;57213;22862;26960;341676;7178;55578;29880;220108;84078;4081;55213;10206;3839;55068;23143;55425;11340;115761;540;23111;729233;9201;11215;51131;79758;10631;8803;8848;3356;29079;4752;10910;10161;386618;84650;5983;122011;728591;23078;5925;90627;28984;7223;341640;11061;5994;9617;647174;26747;51028;27253;83852;107303344;100526761;144811;10562;144983;2308;387921;79621;161003;83446;729250;1997;57105;1102;5100;400120;2098;2963;26512;4093;729246;10186;10166;122183;115825;81602;94240;10240;253512;1361;220107;81617;220082;29103;57511;220081;160857;387923;283514;440138;55901;11193;160851;220416;55270;80209;3936;79024;9445;8600;23091;83548;80183;54937,116,0.47849901788076600000
chr1,167238254,173490508,6252254,-1,1,481;9588;375035;9095;8548;149281;2153;6402;51603;356;92346;57821;2328;7292;5451;9019;10560;25874;80133;8674;6401;5396;51430;23215;92344;5279;8804;55827;92342;26052;29922;6403;1805;55811;2329;2326;919;2327;55732;6375;261726;57147;22920;4653;92241;284525;6846;23432;8995,49,0.78371736017122800000
chr1,157073444,161155567,4082123,-1,1,912;9447;922;391107;23385;3428;4817;2117;114836;480;8832;51744;89886;57863;79368;4332;909;913;54935;127385;107181291;115350;128360;57823;83417;100131187;83416;81607;1314;8407;57216;911;7391;50717;27005;325;343413;55600;50848;441911;8682;142683;8703;2205;56833;391112;1401;391114;3766;391109;5824;128372;6504;93183;257106;4807;284677;25790;477;6708;2532;126823;81442;910;962;51506;55243;81448;128367;391123;149628;57549;5498;128371;5202;128366;128368;844;93185;3765;343406;9191;4063;26476;115352,85,2.08224984891440000000
chr4,95619779,101429256,5809477,-1,1,658;115265;8649;1977;27071;51705;93587;131;285555;124;4547;79982;3015;5910;128;23173;8633;130;126;10098;84103;5161;125;127,24,0.41311808274651900000
chr4,82722961,86152968,3430007,-1,1,51138;113510;23001;132660;51023;51316;22872;84142;79966;441027;9987;3184;10855;84803;1040;27235;58478;4825;79725,19,0.55393472957926900000
chr17,34817222,36168245,1351023,-1,1,26574;284099;9326;284098;11072;6928;79154;79922;3975;11276;79893;11056;6871;31;80179,15,1.11026977334953000000
chr17,34891676,36168245,1276569,-1,1,26574;284098;11072;6928;3975;79154;79922;11276;79893;11056;6871;31;284099,13,1.01835466786363000000
chr7,86574084,94631377,8057293,-1,1,222223;1278;154661;219557;54467;5218;79689;5243;8321;1021;10282;30816;53616;55610;257415;57798;55607;10142;401387;105375396;8910;6717;54809;219285;889;799;64921;2791;253012;2792;261729;54677;85865;9988;7978;55972;7980;10926;79846;9069;5244;1595;219578;84060;79161;26872;5189;23089,48,0.59573357950368700000
chr7,98717972,107002949,8284977,-1,1,24146;221914;221908;51593;5577;60561;375607;100861540;9551;2783;100310812;100526740;375612;7036;10234;5054;101927655;10603;5001;100134938;27000;10467;1576;58160;55063;93408;23660;222256;6733;81392;10466;8985;26261;79706;79037;5701;7551;352954;140453;2056;402682;11333;2050;51024;7455;389541;7205;1523;222236;10135;6856;402573;29992;168455;4034;51412;375611;5118;64816;222255;8896;1551;246721;255374;55262;81844;3268;80228;89122;10095;4584;64598;81628;136227;55904;6878;7586;563;7589;9512;285989;222235;5649;7425;10552;1577;100271927;54784;222234;222950;100316904;729597;64599;346606;57154;245812;221785;548644;79027;402569;4176;5294;83787;26959;56257;10156;79690;349149;441272;10071;1174;222229;43;10898;5439;64792;441273;9179;100289561;84124;10734;29990;54517;56996;221786;26024;100289187;10980;10248,129,1.55703510100269000000
chr1,1627699,1663901,36202,-1,1,728642;9906,2,5.52455665432849000000
chr6,6222342,12296224,6073882,-1,1,6745;154007;6239;9450;4117;1906;54898;100113407;1832;221711;4739;2162;654;55003;81853;7020;3096;9521;51522;84830;63915;81567;285782;51000;347744;221710;9247;405754;83732;2651,30,0.49391805767711700000
chr4,178408798,190114926,11706128,-1,1,285440;53842;205860;25854;55325;7098;55714;60684;836;80014;83891;57587;55602;2160;3818;79682;353322;291;100132463;27295;3660;441054;391723;201965;2195;339976;201973;4543;132625;55805;133121;256309;8470;2180;56977;3622;1635,37,0.31607376922582800000
chr2,219731765,228789024,9057259,-1,1,130617;10290;29926;79843;8941;79853;8452;1285;6364;3300;3623;79411;255101;84236;80704;1286;23549;55515;3267;114790;80326;79065;130612;5798;7857;57590;8576;100996693;1412;23363;56947;1674;3549;55619;23704;2181;3667;79840;10056;10058;55139;164781;2043;79137;5270;7277;6508;116255;54738;56918;27013;389075;57624;79586;130367;130340;5077;7475;151278;151295;65080,61,0.67349294085550600000
chr9,112482995,125873712,13390717,-1,1,158399;5004;7099;11217;7295;84263;1317;92399;26219;5711;347169;23307;254956;158131;54107;392392;26735;246184;85301;548645;727;23392;26740;445815;2844;7539;26248;80709;113220;54542;259;138881;392390;26468;9128;57684;1318;114991;347168;114987;58493;1902;51552;158135;7185;9550;138883;254973;50514;22949;23637;26190;10773;11064;5005;138882;5742;2790;54836;100505478;5069;57864;114299;169834;2934;158405;55755;26147;5082;9991;79987;64420;7357;153090;401546;5998;2040;255220;4702;81932;944;26737;392391;158401;23245;257169;138065;92400;210;22954;552891;25861;4593;1620;3371;401548;9966;203197;1955,99,0.73931814106742800000
chr9,140419439,140519724,100285,-1,1,92715;92714;79813;116225;375775;64975,6,5.98294859649998000000
chr5,204849,3876457,3671608,-1,1,4726;10016;7015;6389;79192;81037;11336;133957;9319;340024;65980;348932;153572;85409;79844;50805;153571;57491;6550;64979;79888;10723;6531;11076;55722,25,0.68090057544269400000
chr14,52895807,55890406,2994599,-1,1,30001;10668;93487;9787;80821;652;64841;23034;57544;283554;11169;6815;387332;22863;1033;10979;55030;3958;122809;2643;5706;10175;2764,23,0.76804941162406100000
chr2,219687077,224899607,5212530,-1,1,130617;10290;29926;8941;3300;3623;79411;255101;53632;5077;80326;23549;55515;114790;79065;130612;5798;7857;57590;8576;100996693;1412;23363;1674;3549;23704;2181;10056;10058;55139;2043;79137;5270;7277;6508;116255;54738;27013;389075;79586;130367;130340;79840;7475;151278;151295;65080,47,0.90167346758675700000
chr13,79303696,96927854,17624158,-1,1,114798;160897;26050;64062;11166;9071;55757;84189;22873;266722;10082;23483;5611;10257;1638;54602;2262;10253,18,0.10213253875731300000
chr10,127967525,135372492,7404967,-1,1,253738;85442;27287;8433;5791;282974;282973;50632;10570;1793;664;282969;594857;119467;196743;101;1892;1571;642938;84435;503542;10539;118472;10844;80313;256536;3632;8038;4288;92170;84504;118471;170394;4255;55844;54777;399823;93426;118611,39,0.52667351522295800000
chr1,146521698,147735815,1214117,-1,1,9557;51205;51463;5565;607;2702;2330;200030;2703,9,0.74127946482917200000
chr1,144679875,147735815,3055940,-1,1,9557;148738;128077;27246;84265;11126;400818;9659;10628;2330;653519;8799;149013;5174;388677;10401;200035;51205;284615;8515;51463;5565;148741;607;2702;10623;200030;100132406;2703;9939,30,0.98169466678010700000
chr9,140436568,141025921,589353,-1,1,92715;92714;79813;116225;375775;64975;774,7,1.18774316920420000000
chr18,52940728,53180419,239691,-1,1,6925,1,0.41720381658051400000
chr15,74460995,78121394,3660399,-1,1,57184;1445;192683;10073;84993;79661;64843;653641;9051;9377;10620;56905;79748;5955;1543;54939;10363;49855;79834;2108;1544;55272;10099;84894;5780;25989;92912;10066;64220;60490;653643;1464;257364;1198;161753;105376731;594855;8482;80153;3671;1583;54913;80125;4351;4123;25942;26263;123591;145957,49,1.33865187920770000000
chr13,105620286,115083483,9463197,-1,1,7027;55795;79587;79774;3916;8874;22821;55608;23026;8858;55647;10426;84945;728215;1284;101928841;2621;400165;113622;65110;10673;8660;121793;283489;23263;55739;643365;55002;3621;55082;1282;100129836;6656;23250;1948;3981;2155;2159;55208;122258;496;6011;8451;348013;8881;267012,46,0.48609365312800700000
chr16,29652799,30199507,546708,-1,1,653808;5531;26470;283897;253980;146378;8479;83719;23475;283899;124446;9344;3835;4150;226;253982;83723;5595;6911;11151;8448;79447;112476;9961;10423;6693;79153,27,4.93865098004785000000
chr9,88896077,95027914,6131837,-1,1,1903;441452;1514;4783;79670;10558;3376;79048;401535;286223;1612;286234;6850;10927;549;81689;23552;10507;645961;158046;54769;2619;4920;53358;1164;10912,26,0.42401648967511700000
chr21,39817518,43904783,4087265,-1,1,8624;7031;49854;150082;89766;4599;6450;106865373;10317;2114;54101;25966;64699;9619;1826;4600;63977;3150;7485;7033;54097;89765;7113;150084;54014;7032;25825;53347;2078;5121,30,0.73398715277820200000
chr21,15004007,36658483,21654476,-1,1,9992;54148;861;337882;11096;2897;9875;9073;29104;337960;571;10950;337970;101928147;56245;54943;643812;7074;9946;9510;116448;337959;1827;4685;337968;149998;337973;26046;351;10069;116159;56683;100131902;522;59271;337963;337967;337878;29980;3588;6526;10215;337979;140578;100288323;54149;539;6453;337971;337985;8204;30811;3454;337974;337977;5651;337969;388813;2618;337976;57466;757;54069;2551;3455;1525;140258;56246;64968;10600;26285;10694;337975;337880;100288287;54102;3460;317754;6647;6651;54065;8867;94104;150051;64092;58494;337966;388818;337978;337879;254950;56911;54033;140290;29761;284827;3753;337972;6782;643803;728299,101,0.46641627347620900000
chr3,129504394,148552563,19048169,-1,1,53833;344838;5948;25852;83850;5523;26577;1360;80111;5096;5922;51421;22808;51560;51208;6259;5352;2047;66000;55573;185;27032;253461;28990;5359;51554;51146;92370;58477;644974;205428;285195;7018;56945;7200;5357;23023;7029;199221;131890;57088;287015;84107;30849;79876;5947;8419;401089;729627;55;54464;483;57047;55186;27031;256076;6578;23317;131873;51163;545;8403;7220;11073;9616;11222;389151;25847;131870;668;79858;9276;55167;80321;80723;23350;84129;80254;5291;92369;7545;339855;131034;389152;55179;347736;64084;256356;349565;4690;9435;10274;389158,93,0.48823590340887900000
chr8,8159791,12285664,4125873,-1,1,392197;377630;1508;83650;245940;83595;100133267;85002;203076;2626;83648;613210;137075;613209;157285;728957;640;66036;252969;286046;79660;2222;54984;613211;4482;8658;203074;9258;90459;653333;94137,31,0.75135613723447100000
chr2,238615140,242701179,4086039,-1,1,151176;84289;5510;377007;51665;339768;4705;150677;1841;2859;130916;150678;10267;140739;2817;4735;9855;51540;9759;150681;375318;189;51078;547;79919;57140;25992;375316;9208;11132;389090;23192;55502;3069;10494;117581;51281;285193;666;8864;26146;23178;50636;653437;80895;728294,46,1.12578465354834000000
chr2,236078312,242701179,6622867,-1,1,151176;84289;10920;377007;5510;51665;728294;339768;4705;57007;150677;1841;2859;130916;64284;150678;10267;140739;2817;4735;79083;401036;51540;9759;150681;375318;189;51078;547;116987;79781;79919;57140;25992;51052;9208;375316;2637;11132;389090;23192;55502;3069;10494;117581;51281;285193;666;8864;26146;23178;50636;653437;1293;80895;9855,56,0.84555525575253100000
chr6,126350,6452045,6325695,-1,1,57128;56940;94234;2296;9425;63027;51299;222826;670;5272;10799;3662;10455;404220;648791;389362;10667;2762;1992;2162;4835;8899;8737;2295;56897;55770;340156;7280;347733;221749;26240;135458;5269,33,0.52168180729548300000
chr8,320697,7290797,6970100,-1,1,389610;401447;9172;728358;1669;26260;645402;100131980;55894;1667;157697;64478;1671;9639;79648;1670;285;157695;100289462;9228;55326;9920;1672;1668;2055,25,0.35867491140729700000
chr9,267853,14260625,13992772,-1,1,58524;10171;23081;55664;89882;50808;158358;81704;23189;5789;6019;286343;1761;169792;55064;6505;29126;2315;4781;5991;8777;26953;90865;7436;3717;90871;6013;57589;3641;7306;403313;169522;115426;6595;79956;9933;2731;55848;11172;10655;80380,41,0.29300841891799600000
chr12,30946782,132246215,101299433,-1,1,113251;11197;9802;9612;29902;79676;326625;283349;7296;55206;23504;3852;403282;8739;121665;3224;1634;91523;160762;390326;4048;29915;28981;1840;5781;22895;27198;23389;9700;55884;6171;91298;283383;3678;84872;196446;5908;196385;54407;55010;1975;5037;254050;51134;85437;728568;55530;3848;121355;11108;55332;4666;10154;196477;9880;8445;121642;84216;83591;5025;53831;89910;41;55967;112;140465;53373;256710;55508;7480;4778;9169;27289;283446;4604;121129;967;23316;144577;120892;338809;283377;6778;144404;283459;11113;51329;253827;54509;23067;64211;3458;23426;5992;55596;51347;9498;5916;3226;84915;8655;4938;4842;574016;84102;552;50511;613227;25840;7786;3889;377;341567;114795;341416;4673;3223;11260;574028;121599;3856;51303;5318;29953;55576;1431;140461;85406;27165;10540;6926;50616;3626;89795;1610;217;160777;6927;319;80184;23468;10445;5630;23390;6404;1280;5959;84900;57458;3034;341418;55681;8738;390327;488;121227;196374;22818;54621;429;160760;55266;84747;7024;3178;1368;54434;10019;7846;81566;359;1019;387890;80212;1649;4848;84101;4617;57605;11213;64333;50515;112802;9958;2967;6895;79837;55785;3225;196527;9735;51535;91574;60314;4069;283337;121601;84329;3695;283463;4637;3221;5036;6311;9840;4234;9194;283461;2735;362;23583;1337;55703;283431;319101;55117;121273;84926;341568;341405;23014;65082;144501;196394;23416;4659;517;5153;11211;26259;121340;196441;3242;121549;254786;65244;196410;283365;10961;338442;144165;283375;3679;35;25834;121457;7334;144453;29951;84190;23479;23371;56899;55188;55832;6334;1663;4801;59341;51380;8437;8411;10106;79039;283385;84934;22822;144717;91012;121275;93058;121214;51228;23409;83448;254783;100533183;51350;10024;1990;3851;23306;79611;5319;338811;59277;376132;58516;25895;387885;84920;50846;11081;10956;29127;5094;2799;8638;89894;5250;3229;10970;2647;254013;6602;374454;5204;79720;4035;144448;11010;144347;11016;283464;23344;84324;390321;84070;23519;6433;8089;4141;283403;10576;83892;8435;51474;196403;8085;7112;79794;390323;10198;10059;84298;9119;55198;79035;115749;91010;64431;1240;5053;353116;949;118430;10193;493861;196528;6821;10411;80018;10329;51499;160418;10988;10102;283471;400;8620;8092;23074;3892;113675;9921;5901;57701;9026;4891;120935;1272;121274;9924;140707;121512;90070;23457;8099;144321;51367;440107;6231;9478;117159;440097;57522;8550;84975;55652;9891;80196;56901;8693;2054;85478;144193;121551;56616;2065;7181;3891;115557;160335;441631;117177;54997;144423;11153;1833;29843;121643;7471;51564;121006;51019;552889;246329;3855;7103;441639;51411;11103;317;10677;121278;269;11247;7009;4633;54458;387893;80070;5756;144245;7374;694;363;374470;11137;92979;6866;144535;92797;3489;282809;1594;84749;114134;51067;121364;116986;9761;4640;7421;64375;225;60673;9271;28977;10645;9671;25946;3906;8825;11021;57228;3875;2819;3071;5801;5128;4939;784;401720;23011;88455;400073;80024;23545;1407;440093;9904;6472;5463;6249;83729;246213;5564;6128;57658;57122;5985;3887;3890;6302;22877;79369;100129940;29110;55801;347902;1017;403284;26353;64786;3479;3798;32;10138;7316;23603;3747;5027;84698;2583;84125;1848;115811;58158;91419;8499;6667;114882;3888;11066;283455;4254;3850;10818;94;79738;4753;338761;5787;92558;121053;84660;144455;374462;55716;10959;1466;29095;23329;386653;6601;10330;5213;9416;10993;1606;5557;23592;196383;64897;56890;79023;10094;140807;5869;84876;636;8843;91;121130;81539;55591;5715;506;114785;57609;84274;283417;144406;6857;121256;5502;80724;6636;10728;286887;84305;51561;55089;605;466;121441;8315;55196;144233;54934;23041;3849;8683;9815;3853;84678;8562;51184;121260;65117;9182;65012;22864;121268;341359;11318;5367;904;387882;160518;7184;79022;79158;57460;57696;160428;10985;6996;8549;23017;3228;10220;255394;4440;5571;490;29080;11052;84530;6490;51434;57647;387856;55605;196472;51433;79962;120863;23325;92293;79657;9971;160622;3854;27345;80298;8835;160419;4665;51135;6910;5829;51699;283373;27340;3227;8608;11163;2004;8091;144402;5939;79600;79867;90488;8909;8630;4284;5501;64426;6175;4940;8914;51559;4618;338773;100528030;6773;144348;84790;11176;3164;338785;10906;83468;25766;4327;283450;10376;56994;4922;65985;3222;196463;84260;4598;5074;283310;160728;1967;9733;23109;25875;4193;643246;121391;84987;51643;8086;4060;144715;11226,713,0.70385389027794500000
chr16,85800,2124458,2038658,-1,1,283951;3029;51764;254528;90850;124056;645811;90861;84331;3039;64714;23162;84326;9143;4832;6123;1186;10573;3483;57585;64499;9727;117166;197342;9028;390667;9742;65990;4913;10232;3042;7329;339123;398;283948;8786;79006;84219;23430;63922;3050;6755;7177;146310;8938;390664;55692;3040;7249;30812;64285;65993;146325;124093;4833;115939;8312;89941;10607;8131;64711;84264;58986;79622;84572;90864;51728;26063;9894;64718;79652;6650;10101;81889;4350;64428;64788;25823;146330;83986;4716;10273;283869;3049;57799;6187;197335;51734;9091;9351;8912;2671;388199;113000,94,4.61087637063205000000
chr17,16698089,20324359,3626270,-1,1,2314;55244;125170;55090;11216;79018;79999;10400;54890;254272;9706;400581;92521;8533;22905;729288;100996259;5598;218;23164;83450;224;51168;80039;51655;201163;7156;51030;5636;644815;10750;4239;10517;654346;10743;388436;27077;140775;6470;146691;1819;6720;125206;23495;147166;7732;146802;91647;56953;645027;3996;201164,52,1.43398037101484000000
chr14,106222937,106353120,130183,-1,1,,0,0.00000000000000000000
chr11,31284214,46421789,15137575,-1,1,79832;341019;5896;221120;7189;4076;847;25758;1408;6506;55343;51144;960;387763;7490;2132;143678;196294;26273;4192;8050;8534;55761;8525;5897;10114;9537;90993;120526;10480;2001;8539;9409;966;4005;5080;51317;51074;9479;119710;1132;91614;60529;25891;390110;1479;120071;55226;55626;5954;25841;29099;57689;55346;57586;493860;24147;143458;79899;90139;26610;79056;26298;3732;100131378;84680;54765;56981,68,0.44921329869546500000
chr10,133929772,135222624,1292852,-1,1,10844;80313;3632;85442;27287;8433;282973;282974;50632;92170;84435;10570;84504;118471;282969;170394;54777;196743;101;1892;118472,21,1.62431585363213000000
chr18,66458684,76055297,9596613,-1,1,125704;147381;1528;55628;201456;400658;25914;84735;644041;10194;220158;9306;9658;284273;4155;79839;81832;10666;55748;29090;284274;7776;220164;2587,24,0.25008823425514800000
chr18,149350,7934823,7785473,-1,1,91133;116;55556;10403;9663;645369;103910;642597;7050;339291;9984;9097;7525;81035;23347;10627;5797;494514;64863;1068;8736;9229;27098;284217;79822;84034;23136;7298;7541,29,0.37248860794970300000
chr1,554087,4230414,3676327,-1,1,57470;388588;85452;1677;83858;5590;127262;728661;199990;9636;100287898;8510;64856;26155;81399;140625;55229;8764;65220;339456;375790;388581;148398;401934;643965;51150;8784;2782;9651;1855;9731;27237;57801;126789;81669;29101;339453;6497;643988;7161;126792;219293;163688;84808;388585;63976;6339;55052;254173;80772;11079;79258;984;54587;5192;54973;84069;339448;54998;9906;148870;116983;339451;7293;118424;728642;2563;127281;55210;54991;83756;142678;441869;1953;79906;49856,76,2.06728073971657000000
chr18,67205975,76055297,8849322,-1,1,125704;147381;1528;55628;201456;400658;25914;84735;644041;10194;220158;9306;9658;284273;4155;81832;10666;55748;29090;284274;7776;220164;2587,23,0.25990691716269300000
chr18,149350,7764321,7614971,-1,1,91133;116;55556;10403;9663;645369;103910;642597;7050;339291;9984;9097;7525;81035;23347;10627;5797;494514;64863;1068;8736;9229;27098;284217;79822;84034;23136;7298;7541,29,0.38082876481079200000
chr17,14040643,15432614,1391971,-1,1,1352;64518;9953;201158;284040;100533496;5376;146822,8,0.57472461710768400000
chr5,257649,14064732,13807083,-1,1,10299;50834;79192;81037;11336;65980;50805;134147;153571;1501;11044;64979;22948;108;79888;10723;11076;23379;1611;4726;9037;10016;7015;134145;340024;9319;348932;153572;54888;651746;85409;79844;83853;57491;4552;6550;170690;134121;79072;1767;6715;6531;134111;55722;84246,45,0.32591967470609100000
chr15,21235896,26199196,4963300,-1,1,7681;100996331;123606;57194;283694;81614;390538;114791;23742;7337;6638;8926;283685;54551;4692;23191;283767,17,0.34251405315012200000
chr4,62247,1370333,1308086,-1,1,10336;7700;521;4636;10417;10861;84286;654254;285498;54872;1609;255403;10815;2580;53834;84179;5158;170960;3425;152687;10296;1487;57654,23,1.75829417943469000000
chr15,98053000,100209043,2156043,-1,1,145814;283777;4205;123355;23336;3480;64927;91947,8,0.37105011356452500000
chr22,17270071,19835558,2565487,-1,1,27440;51816;8214;7290;2812;6899;5625;27439;27443;55670;637;64976;79680;529;11274;6576;150165;83733;8218;5413;23617;7122;8220;128977;7353;2928;51807;23765;9993;54584;8318;23786;128954;101929372;57553,35,1.36426339326607000000
chr15,70788924,73322524,2533600,-1,1,338949;55323;3073;25820;5315;79875;54839;83440;55075;55889;10002;196993;56906;196996;123228;56965;585;4649;60677,19,0.74992106094095400000
chr13,38813477,83209025,44395548,-1,1,51569;79612;2862;89890;283518;144809;57213;22862;730249;64881;100129307;9882;3839;55068;55425;1602;11215;122060;8803;29079;5457;386618;5925;341640;170622;51028;27253;81550;107303344;7347;144811;10562;64062;2308;387921;161003;83446;26224;729250;81624;5100;2098;5101;10186;10166;122183;115825;81602;94240;10240;253512;1361;29103;57511;1203;220081;387923;283514;440145;220416;80209;55270;3936;79024;54602;115207;729240;26586;9724;341676;7178;729420;220108;84078;55213;10206;23143;115761;540;729233;23077;51131;79758;8848;3356;57626;4752;10910;10161;84650;23078;28984;11061;9617;647174;79596;26747;10253;83852;144983;79621;1997;57105;79866;1910;1102;11278;2963;26512;729246;688;10464;220107;81617;220082;22894;4008;160857;55901;440138;11193;160851;8796;9445;8600;23091;83548;80183,128,0.28831719793164800000
chr22,17343106,19835558,2492452,-1,1,27440;51816;8214;7290;2812;6899;5625;27439;27443;55670;637;64976;79680;529;11274;6576;83733;8218;5413;23617;7122;8220;128977;7353;2928;51807;23765;9993;54584;8318;23786;128954;101929372;57553,34,1.36411854671625000000
chr7,72338150,73780404,1442254,-1,1,5982;378108;51085;9275;84277;7462;55695;135886;83451;9883;1364;135892;6804;7461;155382;3984;26608;8468;9031;155368;8326;7458;2006;1365;114049,25,1.73339786195774000000
chr15,25506566,28530359,3023793,-1,1,2567;4948;2562;8924;57194;2558;7337,7,0.23149732802476900000
chr15,23641501,25410870,1769369,-1,1,8926;7681;23742;283685;54551;4692;6638,7,0.39562126385168900000
chr16,2038810,2220411,181601,-1,1,9143;283869;7249;90850;25837;4913;84231;9351;5310,9,4.95591984625635000000
chr20,8720187,13564059,4843872,-1,1,55617;128710;22903;8195;63926;24141;182;23236;5332;57144;6616;55304;140862,13,0.26838033705267200000
chr10,184585,5031869,4847284,-1,1,22982;1316;105;10531;22884;10771;5214;1646;3422;1645;83592;23560;91734;23185,14,0.28882153387340200000
chr20,18380,1922338,1903958,-1,1,140680;10616;1457;57761;83541;55968;10326;55321;140850;81623;140881;51378;9751;113278;245938;343637;140885;245939;85508;85364;9491;128637;6939;400831;2280;642636;400830;55423;140809;284759;6666;27111;80023;128646,34,1.78575367733952000000
chr7,157878491,158621119,742628,-1,1,54892;5799;57488,3,0.40397076328929200000
chrX,455566,544731,89165,-1,1,,0,0.00000000000000000000
chr5,175491749,177360462,1868713,-1,1,51428;51491;6620;202134;6569;9260;10636;53917;253314;27166;285596;1212;23197;375484;57179;54825;90249;10960;26262;51720;3101;23567;80758;11285;54540;2264;345456;54732;79930;192286;285598;2870;1627;83463;64324;114787;2161;22838,38,2.03348507769786000000
chr18,74781239,76055297,1274058,-1,1,4155;2587,2,0.15697872467344500000
chr10,82242610,93614902,11372292,-1,1,657;9060;142910;84896;27063;3433;10718;643161;3437;8513;387695;57559;54462;340654;55328;10974;728118;355;84333;387700;24138;643414;27069;23063;3434;54537;81619;5995;9023;387694;79812;2746;119385;26103;643418;9585;143279;5728;53354;10556;118932;6623;439996;92211;9562;59;94233;2894;340745;11155;100144748;5507;3988;3363;80351,55,0.48363161972977800000
chr21,13925878,46881029,32955151,-1,1,54148;4599;5316;337882;106865373;1409;54101;9875;1826;9073;386679;874;51227;10950;337970;101928147;386681;56245;54943;643812;326;5121;1476;9946;116448;64699;11077;1827;3150;63977;10281;149998;337973;8566;26046;7307;7113;54014;116159;56683;150094;85395;59271;386685;23515;337878;8624;29980;386683;337979;8568;100288323;54149;6450;4731;6493;539;104;54093;5822;6453;337985;7033;353333;3454;25825;23275;2618;337976;2078;3455;1525;140258;56246;64968;49854;89766;754;3460;6647;54065;150051;58494;80781;7327;10785;337879;54033;3753;337972;6782;150084;643803;728299;9992;386672;5211;861;11096;2897;56894;54084;3689;8209;1859;29104;337960;7485;386676;571;386680;7267;53347;7074;5152;10311;150082;3772;8208;9510;10317;29947;337959;4685;6612;337968;755;351;875;10069;7032;100131902;522;53820;9980;337963;337967;353323;7031;3588;6526;10215;7109;140578;386674;386675;23076;3763;2114;353332;3141;4600;337971;8204;386677;89765;30811;337974;337977;5651;337969;388813;57466;757;54069;2551;140290;10600;90625;23562;23308;26285;10694;386678;337975;337880;100288287;54102;317754;6651;8867;94104;64092;25966;54020;337966;9619;386684;388818;337978;386682;254950;54097;56911;873;29761;284827;81543;7226,199,0.60385097309977400000
chr22,19405375,19792642,387267,-1,1,5413;6899;54584;64976;8318;7122;7290;128977;2812;7353,10,2.58219781184557000000
chr19,8387603,8468748,81145,-1,1,256949;51129;9230,3,3.69708546429232000000
chr13,104418287,114101585,9683298,-1,1,55795;79587;79774;3916;8874;55608;23026;8858;55647;10426;84945;728215;1284;101928841;400165;113622;10673;8660;121793;23263;55739;3621;55082;1282;100129836;6656;23250;1948;3981;2155;2159;122258;8451;267012,34,0.35112004195264900000
chr18,149350,487056,337706,-1,1,9984;9097;81035,3,0.88834666840387800000
chr8,320697,6408358,6087661,-1,1,64478;9172;9639;79648;285;157695;26260;9228;9920;157697;2055,11,0.18069337303769100000
chr3,240876,6640879,6400003,-1,1,51095;51185;3568;10752;9695;285362;27255;3708;57633;8553;6419;152330;55207,13,0.20312490478520100000
chr8,330897,2088785,1757888,-1,1,9172;9639;157695;26260;9228;9920;157697;2055,8,0.45509156442276200000
chr18,28354894,41068920,12714026,-1,1,25800;64762;25941;1824;10982;1828;55197;6860;1823;7572;9331;1829;147407;57565;80206;51444;252884;84307;80816;83608;55034;147409;100101467;1830;7276;5289;1837;4225;8715;56853;6014;54941;1825;125476;2589;57536;55250;22878;374864,39,0.30674783896147500000
chr21,40176486,48056450,7879964,-1,1,386672;5211;4599;5316;54084;106865373;56894;6285;3689;8209;1409;54101;1826;386679;7485;386676;386680;386681;326;53347;5121;5152;1476;150082;3275;54059;10317;1292;5116;84221;29947;64699;11077;6612;63977;3150;755;8566;1291;7307;7113;875;54014;7032;150094;85395;386685;353323;8624;7031;7109;386674;386675;386683;8568;4731;6450;23076;6573;2114;104;353332;5822;4047;4600;54039;54058;7033;386677;89765;353333;23181;25825;23275;90625;49854;23308;754;89766;386678;8888;25966;54020;80781;386684;7327;9619;10785;386682;54097;10841;81543;7226;150084,94,1.19289885080693000000
chr22,48388703,51219009,2830306,-1,1,85358;410;400935;85378;9701;56666;5600;49;9889;23774;80305;11158;414918;79174;9997;1120;440836;1375;415116;83642;23542;644186;23209;6300;83933;79924;79087;6305;1890;348645;23654;25817;113730;29781;55586;91289;54456,37,1.30727914225529000000
chr9,104162177,113046642,8884465,-1,1,11217;7295;55151;25934;10881;8727;10592;229;138803;5887;19;138804;114299;5535;54566;138802;116443;84302;23732;1539;7743;23731;401546;138805;286365;445815;55335;6887;54942;83856;58499;138799;286362;10880;8518;392376;9314;2218;5774;23446;56254,41,0.46147967266458900000
chr11,212739,134267121,134054382,-1,1,83759;23201;11187;5091;63970;5719;272;83707;220042;5331;28971;27314;79842;10629;25921;100526737;9702;219875;23538;440050;2526;4586;7490;54472;1315;4975;219479;80168;51773;256148;25858;219968;57830;401667;390265;401665;10888;5436;119679;6343;387601;22897;966;219482;65084;6288;282763;54663;102288414;5970;26580;6881;2286;101927503;25841;23682;390181;11181;390075;91893;84957;219954;8045;84959;387755;283232;338662;144100;23075;81300;5920;4038;143496;100130348;741;3846;26005;6289;54851;221120;430;4722;89944;2915;25758;2542;390037;3739;256472;85016;9638;54949;10083;5222;3338;50507;641654;402778;50863;8050;55327;51585;55800;80227;6888;255239;2197;283162;119687;10432;25906;80150;10346;144097;390154;1474;401666;2785;6207;4297;92292;79827;2694;81570;283092;1479;5837;80829;390113;91252;6520;2101;10205;57084;220074;219960;79339;143686;120776;727897;25923;81490;7762;89;6712;113130;9177;4135;2249;26515;60494;159963;643037;3746;503497;2950;79829;10632;5241;399888;9246;219595;390168;10003;246330;5883;8642;403312;114902;83552;338322;84867;116085;79733;10809;5003;4162;7140;390058;160298;8882;144108;90019;26297;9965;8519;220004;728588;219844;796;120526;7356;120146;6749;9409;390243;196074;9415;4314;119710;55867;23387;2620;120071;219469;5017;51399;79345;79796;3046;254439;2350;1200;170689;10410;387778;254359;8986;747;4004;219487;26298;335;977;23310;386746;8301;2230;80198;6494;120425;64232;55293;6609;56158;101927423;390174;256364;120787;390245;89792;219870;9158;100129216;100532726;6506;253935;8495;7352;4837;56649;114609;144124;26273;8665;26007;55231;84881;3047;3948;440021;10524;81309;80194;7166;337;219938;144132;283284;5007;27339;4013;84188;9066;9873;338323;402;56672;25988;7299;24147;84364;1982;58486;23621;572;9846;10418;25855;221092;975;79841;26229;79324;3703;283093;85456;283208;51503;1798;57804;56912;29068;7748;5790;53826;2017;81544;28970;1410;4676;4076;117195;114879;871;338657;390093;338699;10612;9440;338692;116519;63982;403253;57053;8726;84000;1128;59082;63876;120586;283212;390271;390199;390152;254187;84953;91703;387733;3630;254122;55742;23649;3508;1717;51700;119772;10581;283254;84897;2346;4723;390157;390110;9600;4647;26521;57010;29099;219965;3177;55346;219473;10897;220032;143888;51083;5138;55291;120237;23235;401;10894;9313;219432;387273;84259;79026;100131378;9219;219855;79473;84866;8424;64066;65998;60492;84767;283116;26579;84623;58487;219873;8061;10263;5547;2495;143872;114571;10196;1408;64837;6157;120796;10413;921;1072;387775;9610;6786;723961;80310;30008;6737;5871;79053;390067;220382;219833;120406;387266;259249;53;119765;7069;387264;6688;55216;85363;100506127;399948;120114;219464;38;84441;143903;114769;57586;837;219436;79073;57175;219537;254225;11145;54970;3762;80162;283248;219429;91894;23625;10658;374383;2977;80071;338755;219527;219477;120775;143662;91057;10978;283171;64231;10527;55572;56676;143689;220047;283189;56;340980;322;219431;745;3619;390190;23647;4192;10072;6833;5936;823;282775;1937;100528017;390259;23360;9854;6188;64852;112464;54503;219988;8539;8815;23705;6309;3939;390064;390036;51317;334;374403;60529;25891;399968;5702;5499;143501;114971;84437;65987;2188;417;399979;26610;79056;10179;58475;10435;10078;1500;254102;79869;3611;387748;161;642612;29850;119695;440044;283219;220323;1270;341019;26496;100507050;66005;439915;11309;642623;1662;219983;23052;100463486;117854;283237;143678;345;3784;27288;4322;440023;29984;219952;390083;582;81876;27122;54494;196335;4718;4250;867;22941;2147;51075;5795;23529;51296;347853;29087;83638;219869;3263;8772;414899;55553;10963;8065;283159;3048;5954;374393;85459;57689;7262;7702;79731;283149;10522;9183;57758;751071;3992;7761;6392;3145;54765;1075;390151;100287896;143503;390197;79832;54733;55709;143941;9986;196264;3636;53340;9743;7189;23258;9354;57571;3265;54972;5450;440068;6050;349633;960;595;3995;79684;4654;120793;219986;84285;79101;219484;23769;257160;55761;219858;100169851;64221;2206;441608;23365;85463;338707;9159;120224;9866;4588;5080;472;143570;486;100500938;9645;390212;440026;55226;79780;4321;282679;6876;10004;256144;390195;915;6484;390054;5977;85458;399949;10077;1740;54766;390078;81532;79751;79097;64137;1643;120066;2615;6811;5741;7351;7108;10825;24145;60496;219972;8501;7225;9376;4926;55298;283297;726;55531;51144;282770;55199;22997;143684;91801;7704;103344718;710;84447;1737;27034;90952;338440;8525;63901;57562;917;440051;55128;390275;5526;54827;84304;2237;79080;116071;4005;81341;28992;120379;57093;115399;117194;119749;8567;116337;283238;746;4928;50801;646754;10714;64787;10944;4054;116985;414301;143458;2893;203859;219447;10992;220001;283106;4296;79671;9099;51259;79102;84680;341116;51524;80789;25833;120376;116969;219539;117245;117196;83875;26338;5031;26011;79081;55690;256892;254263;26519;23650;390038;219453;143630;65975;283234;5441;740;170589;83706;55191;114900;54979;22917;9049;81930;56673;7275;4319;81318;2248;9537;219428;55107;50937;916;1119;1111;10480;79703;219493;341208;6291;10312;53840;4925;2348;7405;387787;445372;54948;3665;390084;143884;4041;55626;219927;219437;8538;9538;10798;7423;90139;219970;81327;6327;120400;3043;56935;3732;338675;10648;1815;57410;56675;932;56547;283229;390063;50862;5682;390144;5519;51501;3359;50613;81622;133;399967;923;26973;91683;9828;7536;834;283111;5553;51475;6330;338645;8722;833;120227;6094;80975;112936;9789;341152;79797;391;374407;2965;6150;23130;10525;55004;102724265;7003;5286;23279;154810;4900;6764;219982;330;27315;644943;2352;89849;838;79064;4607;738;390059;5029;54538;57661;7439;187;3312;55611;219995;10235;390264;6734;10313;399909;54961;390061;643;120103;6947;220064;338751;57104;160065;3606;6230;4246;219541;7070;219981;55048;847;9973;56946;6768;5870;340990;4046;55823;744;120065;399939;221091;387763;81328;160287;5866;23788;390148;1351;3014;1850;10482;5058;119678;5140;338674;390231;4316;171389;1509;102724957;404552;390066;10114;283160;79608;790955;55031;219957;79864;374395;3767;220002;51642;642446;57646;387804;51074;23584;9479;245802;9379;372;53841;329;4312;60626;644672;26492;9092;406;23086;29118;79899;81846;408;4978;23378;119694;7481;143879;390167;4728;254552;56981;1642;51035;338661;8590;219417;5913;643847;7054;2900;84067;23410;3316;57569;84689;280636;78999;51400;3587;7251;79096;10873;4684;55343;29763;219990;29901;56674;887;4745;6809;196294;390081;219956;8500;6653;10534;390191;143502;1262;59307;390079;349667;5897;57558;29125;219899;26472;81285;11041;56834;5049;390072;221;2001;10394;84153;53942;219854;374378;9776;9646;10647;7465;22992;23193;2313;83661;627;1521;65003;116534;7106;2488;3045;255725;390142;4544;29015;10938;27087;1656;1813;51287;1028;643834;114908;220359;55331;390077;117144;219902;156;54843;51092;11234;91056;143425;11095;6240;81282;256329;8322;10553;266743;4583;341277;5896;9356;26595;7007;5818;341032;245911;5002;119764;83786;85329;84280;23187;390261;79659;26493;5612;54734;83480;2132;22800;119682;192134;89797;4361;113174;25987;220388;11007;220296;6199;28960;219931;116512;81168;51111;10062;283130;84649;4863;341276;931;399947;1132;51504;8898;219865;11251;57453;347862;55863;119692;55693;493860;84233;283298;283129;54860;160140;159989;5805;8048;119774;23220;100131539;55366;4221;112937;283209;29907;283152;10249;84811;1374;390205;116535;390155;258010;729384;10089;219874;144125;10335;222;53838;283150;120534;797;25824;57124;56253;79849;58473;10008;56980;9633;83700;7136;79607;3758;100533181;4317;55367;2011;390201;5962;8534;10929;63875;11098;64776;9024;392;51286;90993;9404;92105;8690;55561;7379;7753;25884;219958;57476;5024;219959;390260;6181;91614;54414;6588;10589;1207;4798;9152;51338;25996;144110;390162;3481;9793;387758;2113;7542;643376;10068;219438,1259,0.93917108953588700000
chr17,34911952,36510799,1598847,-1,1,26574;84311;6928;3975;79893;31;729873;440435;11072;79154;79922;11276;11056;101060376;6871;30837;284099,17,1.06326621621706000000
chr17,43717703,44210822,493119,-1,1,246744;162540;104909134;1394;4137;284058,6,1.21674484252280000000
chr11,120897973,134266032,13368059,-1,1,219874;53340;63970;9743;84623;26595;7007;219873;89944;283171;56253;403312;219870;56980;219875;55572;83700;6768;399967;56;79607;390261;3758;26493;22997;9638;83480;114609;79684;641654;112936;6653;84881;50863;27034;55800;90952;219858;219833;63876;100169851;283162;219899;283160;390259;390271;64221;220296;219844;390265;1111;50937;28960;219938;4900;79864;6309;219854;390275;120224;7753;29087;2313;57476;334;219869;4013;23584;390260;414899;84897;79827;54414;219865;283159;116337;4798;399968;27087;26492;6484;8538;170689;54538;9538;29118;399979;3312;390264;6734;84959;3762;4978;2113;338662;23310;112937;3703;11095;219855;80071;160065;338661;29068,104,0.77797382551947100000
chr7,72746168,74140846,1394678,-1,1,5982;51085;9275;84277;7462;135886;83451;1364;6804;7461;155382;3984;26608;8468;9031;155368;2969;8326;7458;9569;2006;1365;114049,23,1.64912617822895000000
chr4,189457938,190884350,1426412,-1,1,2483,1,0.07010597218755870000
chr7,150217955,158923949,8705994,-1,1,54480;58508;140545;5799;474344;1804;168537;1020;26;22976;11194;6009;392843;57180;6469;389602;3110;116988;2636;168391;2020;3638;51667;51422;9311;55303;349136;155051;63917;155435;55340;83590;28959;3361;170575;6522;64327;3757;4846;64434;10922;10061;9690;100527949;55112;6604;285973;7516;26157;55365;136371;7434;285888;54892;10049;57488,56,0.64323499418906100000
chr18,159550,7244642,7085092,-1,1,91133;116;55556;10403;9663;645369;103910;642597;7050;339291;9984;9097;7525;81035;23347;10627;494514;64863;1068;8736;9229;27098;284217;79822;84034;23136;7298;7541,28,0.39519599745493800000
chr13,30096478,115083342,84986864,-1,1,7027;79612;2862;283518;144809;23026;57213;10426;730249;84945;26960;64881;400165;100129307;7174;113622;4081;9882;3839;90634;54841;1602;11215;10631;29079;5457;386618;3621;5983;122011;5925;341640;5994;10257;2155;8451;27253;81550;107303344;100526761;144811;64062;10208;337867;2308;387921;161003;84056;26224;729250;81624;5100;5101;145173;10166;122183;115825;81602;10240;253512;1361;29103;57511;220081;440145;220416;93081;55270;100129836;2159;54602;2262;9365;115207;729240;79774;2841;26586;9724;55647;10160;6541;729420;8428;220108;84078;5412;55213;675;540;23111;729233;9201;23077;51131;79758;8848;3356;3843;6564;57626;4752;10910;2073;90627;9617;23250;3981;496;79596;26747;10253;11166;84935;259232;1997;57105;79866;1102;11278;728215;2963;26512;643677;688;5911;8660;220107;220082;22894;4008;171425;440138;55901;8796;122046;6656;83548;6555;51569;2259;79587;3146;3916;8874;55757;89890;55608;241;8858;646799;22862;122042;7546;65110;10673;55068;26050;55425;9375;9071;196541;10150;122060;8803;266722;27199;140432;170622;1282;1948;122258;51028;267012;7347;10562;10443;84899;83446;79070;1284;400120;2098;4093;10186;94240;283489;23263;55739;1203;387923;283514;23483;80209;5611;3936;10808;79024;85416;348013;100533467;54937;160897;55795;8900;22873;341676;7178;1880;101928841;55578;29880;23348;10206;23143;9358;115761;84189;87769;10082;643365;10161;55002;728591;84650;23078;28984;7223;11061;647174;6011;83852;22821;144983;79621;23047;10129;1910;2621;729246;10464;114798;121793;81617;160857;11193;160851;55082;5095;9445;1638;8881;8600;55208;23091;80183;11340,257,0.30239967437791300000
chrY,3450182,28556936,25106754,-1,1,353515;728403;1617;442868;140032;378948;57054;90665;83259;7258;159163;8287;8653;353513;64591;728137;22829;159119;9426;86614;57055;9082;9085;442862;8284;100289087;9087;378950;266;5940;442867;100533178;7404;728395;57135;378951;9081;9083;9084;378949;9086;203611;253175,43,0.17126865543829400000
chr10,27018135,29035183,2017048,-1,1,91452;374308;22931;25805;84930;23590;22852;283078;10730;143098;51322;55130;10006,13,0.64450622890481500000
chr10,28130978,30595337,2464359,-1,1,84569;6840;25805;283080;143098;57608;51322;55130,8,0.32462802700418200000
chr17,43693537,44166270,472733,-1,1,246744;162540;104909134;1394;4137;284058,6,1.26921539219813000000
chr17,43703800,44163085,459285,-1,1,246744;162540;104909134;1394;4137;284058,6,1.30637839250139000000
chr16,3788867,3935836,146969,-1,1,1387,1,0.68041559784716500000
chr7,69595266,69602905,7639,-1,1,26053,1,13.09071868045560000000
chrX,41339667,41811516,471849,-1,1,8573;2857;27197,3,0.63579662137675400000
chr17,2572364,2576530,4166,-1,1,5048,1,24.00384061449830000000
chr2,44582170,44666108,83938,-1,1,79823;9581,2,2.38271104863113000000
chr15,83283503,84812693,1529190,-1,1,646;6457;64506;123720;50810;123722;83640;8120;123207;53339;57188;9455;53346,13,0.85012326787384200000
chr11,42334416,50378802,8044386,-1,1,5913;55709;283116;221120;4722;399888;1408;119764;79096;55343;29763;51144;387763;23788;2132;114900;143678;403253;4192;8534;79797;55761;8525;256148;53;9537;392;23360;23279;90993;119765;6688;10062;8539;9776;9409;2147;5795;51317;9479;283254;1132;60529;2346;8567;390110;120071;283092;55626;390113;5702;4607;256144;91252;57586;84364;646754;114971;9793;90139;79841;1643;283093;3732;84680;4038;10658;56981,68,0.84531000874398600000
chr11,130495295,134868548,4373253,-1,1,4978;23310;112937;29087;83700;399979;112936;219938;50863;89944;283171;27034;27087;22997,14,0.32012783161641900000
chr16,29673954,30119759,445805,-1,1,653808;5531;26470;283897;253980;146378;8479;83719;23475;283899;124446;9344;3835;4150;226;253982;83723;6911;8448;79447;112476;9961;10423;6693;79153,25,5.60783302116396000000
chr15,22784523,23179948,395425,-1,1,123606;23191;114791;81614,4,1.01156982992982000000
chr16,29673954,30198600,524646,-1,1,653808;5531;26470;283897;253980;146378;8479;83719;23475;283899;124446;9344;3835;4150;226;253982;83723;5595;6911;11151;8448;79447;112476;9961;10423;6693;79153,27,5.14632723779463000000
chr15,23739358,28525460,4786102,-1,1,2562;7681;23742;8924;7337;6638;2567;4948;8926;57194;54551;4692;2558,13,0.27161978578810100000
chr8,77334645,86358501,9023856,-1,1,347051;138046;51101;23462;761;3612;401466;619279;79752;64089;5375;55824;2167;646480;759;3574;5569;1875;11075;377677;7163;92421;85444;2171;79776;65986;28957;646486;5828,29,0.32137037647763900000
chrX,41615300,45595243,3979943,-1,1,4693;63904;4129;80258;7403;8573;139341;79742;4128,9,0.22613389186729600000
chrX,41124933,44215557,3090624,-1,1,27197;4693;1654;4129;80258;60506;8573;2857;4128,9,0.29120332981300900000
chrX,41452852,42583069,1130217,-1,1,8573;2857;27197,3,0.26543575260326100000
chrX,41733955,43870531,2136576,-1,1,8573;4693;4129;4128,4,0.18721543254253500000
chr18,63665028,78002405,14337377,-1,1,125704;54495;28513;147381;1528;55628;201456;79863;400658;4772;25914;84735;644041;9306;9658;4155;27164;440498;81832;26251;80148;92126;9150;10194;220158;284273;79839;22850;10666;84552;55748;374868;29090;10907;284274;7776;220164;2587,38,0.26504150654614200000
chr18,6005208,6284243,279035,-1,1,91133,1,0.35837798125683200000
chr18,6366235,9360102,2993867,-1,1,91133;23253;23255;79822;5797;201475;57045;339291;284217;4729,10,0.33401617373116400000
chr22,18919942,21440514,2520572,-1,1,54487;27037;9342;29801;65078;10587;1312;6545;421;7290;2812;6899;5625;7625;79680;64976;6576;3053;8218;5413;80764;23617;400891;1399;7122;150209;128977;8220;388849;84861;7353;51586;2928;128989;5297;9127;9993;54584;91179;85376;8216;85359;8318;728229;5902,45,1.78530904889842000000
chr16,29673954,30119759,445805,-1,1,653808;5531;26470;283897;253980;146378;8479;83719;23475;283899;124446;9344;3835;4150;226;253982;83723;6911;8448;79447;112476;9961;10423;6693;79153,25,5.60783302116396000000
chr18,14316,12309678,12295362,-1,1,116;55556;10403;23255;57132;8774;645369;84203;57045;103910;642597;84617;9097;7525;147495;9218;3613;5797;494514;1149;1068;65258;9229;79822;84034;4729;7298;91133;11031;23253;9663;9989;7050;339291;9984;81035;10928;2774;23347;63895;10627;201475;64863;8736;342850;27098;284217;646000;23136;7541,50,0.40665740463761900000
chr4,162307495,180001540,17694045,-1,1,391712;55601;1363;55319;11341;1182;4889;175;140458;23520;60559;3148;51166;51809;132851;55016;9464;84076;166655;8819;9848;8001;80817;2823;100506013;54969;92345;11086;116966;152756;7092;91351;56884;23022;84869;201931;4750;442117;11275;55247;6307;50859;57630;11199;3248;26269;4886;7424,48,0.27127770953447900000
chr14,29639741,35604711,5964970,-1,1,25831;6729;55012;23256;58533;11154;171546;55837;112487;112399;9472;80224;55632;29966;64067;283635;5587;9692;2856;11177;1690;25938;1073;394,24,0.40234904785774300000
chrX,67346604,67519031,172427,-1,1,4983,1,0.57995557540292400000
chrX,110828029,155159533,44331504,-1,1,23157;541578;2158;55609;2556;23439;494119;8517;331;3423;4168;6901;474383;5358;92002;57595;51442;266740;102723737;389895;644538;51213;79649;100272147;728269;3149;26576;474382;3547;102723680;3358;8273;728695;57826;83844;114824;203413;8862;23641;7512;158763;55217;8270;537;3421;8450;6658;139804;4101;959;91966;441519;4100;57631;2010;27316;54521;4534;51634;653282;728072;728096;101928917;9363;3920;100506164;84548;90293;55511;100133053;203547;139135;79836;139081;203522;51765;60343;139818;56180;27336;728458;8269;7626;10046;340578;63932;4515;158798;100130613;4108;79868;728075;2564;1193;1260;3054;84631;102723631;170261;340596;441525;554;29944;2539;7739;8260;57481;139170;4204;65991;6170;10813;2316;11219;728062;55558;2000;645188;51438;1736;255313;3654;1852;3897;727940;10857;541466;139741;1069;154796;1485;159090;1774;2258;643311;4107;203523;54967;89885;286410;633;83550;4110;3598;340595;6594;2157;50814;57187;139067;4104;203427;139728;10479;9016;55026;100507170;10178;4105;2332;6845;84968;4068;51114;64663;9142;246100;100533997;79576;6535;393;1038;158800;7224;55796;10761;100132963;215;90167;292;7737;55879;7319;6134;116442;2652;10009;2747;10495;100129239;2239;2334;441518;26071;5956;728712;2664;55922;28985;79184;441521;728090;728049;8933;10735;158521;4694;84528;8263;492;9130;100129520;728082;7411;347454;29071;9947;10134;79057;30014;680;30848;93380;159091;8266;65109;8776;494118;2892;55559;5365;8277;63035;4354;10838;139735;83692;3251;10251;139716;100329135;84295;9459;139065;4109;5973;474384;6748;139760;347487;51270;4103;139378;186;9131;3597;2719;7547;9248;474381;11254;90161;728042;2273;728036;64648;54440;4952;83740;100130086;347468;347475,272,0.61355915197463200000
chr11,104111953,116680918,12568965,-1,1,54733;60496;5519;1410;56158;3316;341032;57569;3359;1662;5450;4684;440068;55531;349633;834;54734;8882;116519;4837;91801;7704;5962;80975;1737;59082;64776;255239;120406;85463;54494;55216;23705;54827;399948;57646;38;472;4863;120379;399947;143884;838;8065;6588;143903;26521;114769;79796;644672;25996;143888;837;23086;1813;85458;84437;91893;2893;399949;54766;23235;160140;5805;9183;10179;54970;91894;120400;2230;6392;143879;120376;2977;9177;83875;84811;3606,78,0.62057615722535600000
chrX,6896214,7960089,1063875,-1,1,412;8228;26609;8226,4,0.37598402067912100000
chr3,195740357,197395697,1655340,-1,1,622;255798;80235;200933;5062;5130;4241;26043;1739;84984;348793;255758;116211;131540;200931;375387;22916;7037;165918;54965;205564,21,1.26862155206785000000
chr22,50172917,51178264,1005347,-1,1,85358;410;400935;85378;9701;56666;5600;49;9889;23774;80305;414918;79174;9997;1120;440836;1375;415116;83642;23542;644186;23209;6300;83933;79924;79087;6305;1890;23654;113730;29781;55586;91289;54456,34,3.38191689038710000000
chr3,1,8615225,8615224,-1,1,2917;51095;51185;3568;29995;10752;9695;285362;27255;3708;57633;8553;6419;152330;55207,15,0.17411038877224800000
chr12,15908518,26491122,10582604,-1,1,80763;338821;2059;121536;11228;3709;55907;79912;3375;5965;160492;4257;28234;144363;3764;51071;10060;79785;79365;51026;6660;54477;55500;586;5288;2998;645177;10599;6489;4033;93661;729025;55885;3845;6579;11171;55259;3945;89869;53919;196415;8082;9847;5139,44,0.41577668407511000000
chrX,149669522,155190083,5520561,-1,1,2564;8263;1193;492;1260;2157;50814;9130;2556;3054;4104;7411;10134;79057;139728;8517;30848;554;6901;474383;92002;4105;57595;8266;266740;6845;8776;29944;84968;2539;246100;7739;8260;55559;4204;100272147;100533997;65991;3149;5365;26576;8277;4354;474382;10838;139735;2316;8273;83692;6535;114824;393;11219;10251;55558;139716;1736;55217;8270;3654;537;3421;100132963;5973;4109;1852;3897;4101;215;474384;6748;4100;55879;4103;2010;4534;6134;474381;9248;1069;116442;2652;1485;1774;203547;139135;60343;728458;8269;83740;89885;10046;5956;2664;633;79184;4515,97,1.75706780524660000000
chr7,72726578,74139390,1412812,-1,1,5982;51085;9275;84277;7462;135886;83451;1364;135892;6804;7461;155382;3984;26608;8468;9031;155368;2969;8326;7458;9569;2006;1365;114049,24,1.69873981817821000000
chr15,23699701,28525460,4825759,-1,1,2562;7681;23742;8924;7337;6638;2567;4948;8926;57194;54551;4692;2558,13,0.26938767559673000000
chr22,18919942,21379958,2460016,-1,1,54487;27037;9342;29801;65078;10587;1312;421;7290;2812;6899;5625;7625;79680;64976;6576;3053;8218;5413;80764;23617;1399;7122;150209;128977;8220;388849;84861;7353;51586;2928;128989;5297;9127;9993;54584;91179;85376;8216;85359;8318;728229;5902,43,1.74795611085456000000
chrX,46363189,46736124,372935,-1,1,641339;84679;56548;6102,4,1.07257296847976000000
chr12,75415458,92699266,17283808,-1,1,29080;100528030;23390;160335;160418;196477;79611;1833;8092;25834;4673;84190;160419;11081;256710;3747;84698;11103;1634;8825;84125;9182;4922;1848;8499;114882;144321;4254;5074;283310;55117;79738;694;6857;91298;89795;144448;22822;11010;4659;4617;144455;374462;80184;8693;4060;282809;4618;1466;490,50,0.28928810132581900000
chr12,19381219,25826909,6445690,-1,1,80763;6660;54477;338821;55500;586;2998;121536;645177;10599;6489;4033;5139;55907;79912;3375;5965;160492;3845;28234;6579;144363;55259;3945;3764;53919;10060;196415;9847;51026,30,0.46542728551947100000
chr16,28843803,30332552,1488749,-1,1,654483;283897;552900;83719;23475;283899;487;548593;445329;25970;226;613037;253982;83723;11273;6911;79874;11151;79447;112476;9961;83985;107282092;79153;653808;5531;26470;253980;27040;7284;146378;8479;124446;9344;3835;4150;728888;5595;79008;8448;6818;930;84901;10423;6693,45,3.02267205553119000000
chr9,271257,7141996,6870739,-1,1,58524;10171;23081;55664;89882;50808;158358;81704;23189;6019;1761;169792;55064;6505;29126;2315;5991;26953;90865;7436;3717;6013;57589;3641;403313;169522;115426;6595;79956;9933;2731;55848;11172;10655;80380,35,0.50940663005828000000
chr19,2215856,3935239,1719383,-1,1,60680;55111;80032;58492;6915;56926;4145;126306;126321;51343;8175;645191;56928;9546;10362;84444;126295;84839;79816;116541;148252;4782;23396;2769;166;360200;4946;84823;2767;8698;83475;29985;27134;100128569;4616;2788;7089;374872;115196;284422;27231;268;23217;7064;51690;148254;26517;85300;6449;58509;126326,51,2.96618031002982000000
chr4,110056590,133051703,22995113,-1,1,5393;133022;5308;3426;1950;63973;9348;8492;10733;84162;55013;79071;57721;8654;2028;51778;80216;10427;55132;132612;79960;10424;401152;79625;79633;2247;55435;166378;890;79931;10252;54532;79642;817;7368;57182;3558;9871;55212;84109;64579;4085;81579;287;11162;132321;92610;171024;132332;2169;839;22824;132720;256471;166379;59067;132320;55345;345193;27152;80167;10692;7222;54433;645078;84570;83447;11107;51574;308,70,0.30441250712705800000
chr22,18919942,21801661,2881719,-1,1,54487;27037;9342;29801;65078;10587;1312;6545;421;7290;2812;6899;5625;7625;79680;23119;64976;6576;3053;8218;5413;80764;23617;400891;1399;7122;150209;128977;8220;388849;84861;7353;51586;2928;128989;5297;9127;9993;54584;91179;85376;8216;440804;85359;8318;728229;5902,47,1.63097095865350000000
chr17,16822683,20193169,3370486,-1,1,2314;55244;125170;55090;11216;79018;79999;10400;54890;254272;9706;400581;92521;8533;22905;729288;5598;218;23164;83450;224;51168;80039;51655;201163;7156;51030;5636;644815;10750;4239;10517;654346;10743;388436;27077;140775;6470;146691;1819;6720;125206;23495;147166;7732;146802;91647;56953;645027;3996;201164,51,1.51313490102021000000
chrY,19829164,59373566,39544402,-1,1,353515;1617;442862;8284;442868;6845;378950;3581;140032;378948;57054;5940;442867;100533178;159163;10251;57135;378951;9081;159119;9083;9426;86614;57055;378949;9086;9082;253175;203611;9085,30,0.07586408817106400000
chr5,108788944,117715854,8926910,-1,1,642987;153733;9140;814;324;5229;56929;51014;167227;64097;353376;1176;644100;4124;91137;64848;1036;9315;4163;51397;3781;55521;134429;83942;206338;134430;6728;7905;57556;85480;100302736,31,0.34726461900030400000
chr5,85338858,91705071,6366213,-1,1,57561;5921;153364;116068;84059;10622;4208;1070;153396;902;1350,11,0.17278718132742300000
chr5,108849800,115973756,7123956,-1,1,642987;153733;9140;814;324;5229;56929;51014;167227;64097;353376;1176;644100;4124;91137;64848;1036;9315;4163;51397;3781;55521;134429;83942;206338;134430;6728;7905;57556;85480;100302736,31,0.43515148044148500000
chr1,146564743,147786706,1221963,-1,1,9557;51205;51463;5565;607;2702;2330;200030;2703,9,0.73651984552723800000
chr22,18919942,21440514,2520572,-1,1,54487;27037;9342;29801;65078;10587;1312;6545;421;7290;2812;6899;5625;7625;79680;64976;6576;3053;8218;5413;80764;23617;400891;1399;7122;150209;128977;8220;388849;84861;7353;51586;2928;128989;5297;9127;9993;54584;91179;85376;8216;85359;8318;728229;5902,45,1.78530904889842000000
chr2,166096116,169225805,3129689,-1,1,6326;79809;2591;6335;6323;129446;6332;8708;27347;80034,10,0.31952056578145600000
chr15,22784523,23179948,395425,-1,1,123606;23191;114791;81614,4,1.01156982992982000000
chr17,43655747,44297143,641396,-1,1,246744;162540;104909134;1394;4137;284058,6,0.93545952890258100000
chr17,34817422,36168104,1350682,-1,1,26574;284099;9326;284098;11072;6928;79154;79922;3975;11276;79893;11056;6871;31;80179,15,1.11055007766447000000
chr16,28837450,29042118,204668,-1,1,11273;27040;79874;7284;930;84901;487;83985;25970,9,4.39736548947564000000
chr2,135686207,135749060,62853,-1,1,905;80122,2,3.18202790638474000000
chr4,182074317,190791091,8716774,-1,1,285440;53842;205860;25854;55325;7098;55714;60684;836;80014;83891;57587;55602;2160;3818;79682;353322;291;100132463;27295;3660;441054;391723;201965;2195;339976;201973;4543;132625;55805;133121;256309;8470;2180;56977;3622;1635,37,0.42446896064989200000
chr7,152351643,159128555,6776912,-1,1,155435;140545;5799;3361;64327;1804;64434;10049;9690;389602;22976;55112;57180;7516;6469;3110;7434;285888;54892;2020;3638;57488,22,0.32463163163399500000
chr4,71553,8732736,8661183,-1,1,257236;7700;521;7469;79155;401115;133060;4636;55646;6286;654254;53407;54872;166793;114932;1609;55351;2121;79441;7468;152877;285489;84448;353497;152789;9778;10861;92305;285498;57537;8532;10815;27065;2580;53834;84179;5158;402160;3425;152687;4487;6047;54729;6002;54360;27201;7466;10227;57533;10336;10417;152992;93621;93624;345222;84286;2261;255403;4043;8602;7884;170960;57732;132884;10296;3083;3064;768239;57654;10460;85013;118;1400;3954;152;60312;94031;23324;55330;339983;6452;5522;10608;1487;8310;80273;2868;54436;389199;285464;8603,91,1.05066478793948000000
chrX,31852509,37238968,5386459,-1,1,442444;83604;158724;441490;170062;286464;5638;1756;139604,9,0.16708564940343900000
chr14,55287523,55386951,99428,-1,1,2643,1,1.00575290662590000000
chr22,18661699,21661435,2999736,-1,1,54487;27037;9342;29801;65078;10587;1312;6545;8214;7290;421;2812;6899;5625;7625;79680;64976;6576;3053;8218;5413;80764;23617;400891;1399;7122;150209;128977;8220;388849;84861;7353;51586;2928;128989;5297;9127;9993;54584;91179;85376;8216;85359;8318;728229;5902,46,1.53346827854184000000
chr7,154182144,159128555,4946411,-1,1,155435;140545;3361;64327;5799;1804;64434;10049;9690;389602;22976;55112;6469;3110;7434;285888;54892;2020;3638;57488,20,0.40433356629685600000
chr15,30930422,32509932,1579510,-1,1,51621;22909;161725;283710;54893;89839;4308;1139,8,0.50648618875474000000
chr4,71553,6124891,6053338,-1,1,7700;521;7469;401115;79155;4636;133060;55646;654254;166793;54872;53407;1609;55351;2121;79441;7468;152877;285489;353497;152789;10861;92305;285498;10815;27065;2580;53834;84179;5158;402160;3425;152687;4487;6047;54729;6002;54360;10227;10336;10417;84286;345222;2261;255403;4043;8602;7884;170960;57732;132884;10296;3064;3083;57654;10460;85013;118;1400;3954;152;339983;6452;10608;1487;2868;285464;8603,68,1.12334715160462000000
chr22,18890162,21540347,2650185,-1,1,54487;27037;9342;29801;65078;10587;1312;6545;8214;7290;421;2812;6899;5625;7625;79680;64976;6576;3053;8218;5413;80764;23617;400891;1399;7122;150209;128977;8220;388849;84861;7353;51586;2928;128989;5297;9127;9993;54584;91179;85376;8216;85359;8318;728229;5902,46,1.73572788314778000000
chr2,161496484,165495966,3999482,-1,1,10010;1803;25801;10716;57282;64135;90134;2888;55137;2641;2191;10213,12,0.30003885503172700000
chrX,41580449,48204099,6623650,-1,1,2002;63904;80258;369;55634;7592;5199;347344;7317;6756;4693;7403;5127;7076;8241;56548;27197;6102;4129;7569;729201;79742;57232;641339;4128;84679;6758;6853;9767;7712;8573;139341;54539;8409;8237;389852;9104,37,0.55860439485782000000
chr16,14910213,16292304,1382091,-1,1,4629;100288332;123811;89927;4363;9284;54820;23420;368;255027;23042;54700;123803;9665,14,1.01295790219313000000
chr3,112038282,123477568,11439286,-1,1,7634;201633;205717;2932;8702;84925;131450;80218;89876;51725;26984;2804;131076;54437;152404;286676;3836;57514;79663;4345;64422;10063;91653;165829;285282;64091;51365;4045;83666;152405;152185;2960;7348;54554;8856;151888;57577;165631;25871;116064;4638;26137;151887;55254;54625;6565;9515;941;79691;523;2596;503582;10721;55779;3081;254887;56983;846;11167;9657;4710;3059;1475;151636;26355;1814;111;942;54847;54762;201562;141;10954;55032;55840;29083;51300;344807,78,0.68186073851112700000
chr6,101791695,111469351,9677656,-1,1,221264;639;7101;23097;117247;64780;84816;256380;57673;28962;8528;8724;57531;2898;202;728464;57107;2830;9841;85413;246269;27244;262;8763;84071;285755;11149;2309;8936;51362;389421;55084;112495;5550;84154;64208;221262;11231;51250;9474;9896;55278;285753;6610,44,0.45465554882297900000
chr3,64052,2222681,2158629,-1,1,27255;10752;152330,3,0.13897710074311100000
chr22,18646835,21661435,3014600,-1,1,54487;27037;9342;29801;65078;10587;1312;6545;8214;7290;421;2812;6899;5625;7625;79680;64976;11274;6576;3053;8218;5413;80764;23617;400891;1399;7122;150209;128977;8220;388849;84861;7353;51586;2928;128989;5297;9127;9993;54584;91179;85376;8216;85359;8318;728229;5902,47,1.55907914814569000000
chr22,18890162,21441944,2551782,-1,1,54487;27037;9342;29801;65078;10587;1312;6545;8214;7290;421;2812;6899;5625;7625;79680;64976;6576;3053;8218;5413;80764;23617;400891;1399;7122;150209;128977;8220;388849;84861;7353;51586;2928;128989;5297;9127;9993;54584;91179;85376;8216;85359;8318;728229;5902,46,1.80266182612778000000
chr16,14910213,16516111,1605898,-1,1,100288332;23042;101059938;368;123803;9665;4629;123811;89927;4363;9284;54820;23420;408050;255027;54700,16,0.99632728853264700000
chr15,74410915,78203975,3793060,-1,1,57184;1445;192683;10073;84993;79661;64843;653641;9051;9377;10620;56905;79748;5955;57611;1543;54939;10363;49855;79834;2108;1544;55272;10099;84894;5780;25989;92912;10066;64220;60490;653643;1464;257364;1198;161753;105376731;594855;8482;80153;3671;1583;54913;80125;4351;4123;25942;26263;123591;145957,50,1.31819691752833000000
chr8,186785,8436603,8249818,-1,1,389610;401447;728358;503841;1669;504180;26260;55894;1667;245910;157285;245908;100132396;503618;392188;157695;100289462;9228;245909;9920;1672;1668;9172;503614;140596;100133251;653423;645402;100131980;157697;1673;64478;1671;9639;100131608;79648;1670;169270;285;414325;55326;10407;645836;2055,44,0.53334509924946200000
chr15,24826468,25342534,516066,-1,1,6638;8926;23742,3,0.58132099382637100000
chr16,29652360,30199696,547336,-1,1,653808;5531;26470;283897;253980;146378;8479;83719;23475;283899;124446;9344;3835;4150;226;253982;83723;5595;6911;11151;8448;79447;112476;9961;10423;6693;79153,27,4.93298449215838000000
chrX,6451638,8138990,1687352,-1,1,51481;412;8228;26609;8226;51480,6,0.35558674182980200000
chr22,50937280,51154705,217425,-1,1,23542;85358;644186;1890;410;113730;9997;29781;91289;440836;1120;1375,12,5.51914453259745000000
chr15,23696641,28559437,4862796,-1,1,2562;7681;23742;8924;7337;6638;2567;4948;8926;57194;54551;4692;2558,13,0.26733591127409000000
chr8,8103647,11852988,3749341,-1,1,1508;83650;83595;203076;2626;83648;613210;137075;613209;157285;640;66036;252969;286046;79660;2222;54984;613211;4482;8658;203074;9258;90459;94137,24,0.64011248910141800000
chr8,7113656,12240731,5127075,-1,1,401447;392197;1508;377630;83650;504180;503841;245940;203076;83648;55894;245910;613209;157285;252969;245908;100132396;503618;54984;392188;100289462;4482;613211;203074;245909;90459;503614;140596;83595;100133267;100133251;653423;100131980;645402;2626;85002;613210;137075;1673;728957;100131608;640;66036;286046;79660;2222;8658;9258;414325;94137;10407;645836,52,1.01422350950591000000
chr15,30888776,32509932,1621156,-1,1,728498;51621;22909;161725;283710;54893;89839;4308;1139,9,0.55515940477042300000
chr14,51635254,54427815,2792561,-1,1,30001;5732;80821;54331;652;64841;51637;81542;122786;57544;283554;5729;6815;22795;10979;5706,16,0.57295077887287000000
chr5,101520750,118921525,17400775,-1,1,642987;5066;1946;56929;51014;167227;353376;1176;644100;90355;285605;91137;64848;9315;3295;83942;9867;134430;6728;100302736;1657;25816;54826;153733;9140;814;324;2241;5229;64097;4124;1036;353189;4163;51397;3781;55521;133482;134429;206338;64839;7905;23262;57556;85480;83594,46,0.26435604161308900000
chr15,30888776,32509932,1621156,-1,1,728498;51621;22909;161725;283710;54893;89839;4308;1139,9,0.55515940477042300000
chr15,22652047,28940068,6288021,-1,1,2562;7681;123606;4948;57194;81614;2558;8924;114791;23742;7337;6638;2567;8926;283685;54551;4692;23191;283767,19,0.30216184074448900000
chr17,2540435,2826082,285647,-1,1,23108;5048;23277,3,1.05024733324698000000
chr15,23620374,28526437,4906063,-1,1,2562;7681;23742;8924;7337;6638;2567;4948;8926;57194;283685;54551;4692;2558,14,0.28536119491331400000
chr16,29652360,30198605,546245,-1,1,653808;5531;26470;283897;253980;146378;8479;83719;23475;283899;124446;9344;3835;4150;226;253982;83723;5595;6911;11151;8448;79447;112476;9961;10423;6693;79153,27,4.94283700537305000000
chr1,237254402,247846290,10591888,-1,1,128025;84838;25909;200159;200150;3192;9156;93474;1122;84288;8564;64388;388759;81472;51029;81469;55083;441933;127623;7678;10000;2271;441925;64754;441932;6000;10472;57116;79862;23596;1131;10806;317705;116228;57829;114548;257044;9859;81470;148823;159;440738;56776;163882;64216;6262;51097,47,0.44373580989527100000
chr3,10182775,10184790,2015,-1,1,7428,1,49.62779156327540000000
chr1,244290422,245441429,1151007,-1,1,55083;116228;257044;200159;3192;159;84288;51029,8,0.69504355751094500000
chr6,132025,5875603,5743578,-1,1,10455;404220;57128;648791;56940;389362;10667;2762;1992;4835;94234;2296;8899;8737;63027;2295;56897;5269;222826;55770;670;340156;7280;347733;221749;5272;26240;10799;3662;135458;9425,31,0.53973324641887000000
chr5,1217536,15421246,14203710,-1,1,10299;7204;50834;79192;81037;50805;134147;153571;1501;56172;11044;64979;54491;22948;108;79888;23379;1611;4726;9037;7015;134145;340024;348932;153572;54888;651746;83853;4552;170690;1767;79072;134121;6715;6531;90268;134111;84246,38,0.26753573538181200000
chr15,20172533,35168233,14995700,-1,1,23015;57099;283694;643699;390538;9990;6638;22909;55505;8926;161725;283710;283685;653720;54893;283767;728498;2562;727832;9824;70;100996331;161779;4948;2558;114791;653125;653073;2567;54551;56160;9716;57369;728047;321;7681;440270;256646;123606;23359;6263;254531;342184;89839;4692;1133;51234;23191;101059918;79768;57194;81614;100287399;4308;1139;7082;8924;23742;51621;7337;89832;26585;56851;6447,64,0.42678901285035000000
chr8,186785,6918105,6731320,-1,1,389610;9172;728358;1669;26260;1667;157697;64478;1671;9639;79648;1670;169270;285;157695;9228;55326;9920;1672;1668;2055,21,0.31197447157466900000
chr17,29060343,30326952,1266609,-1,1,79915;79736;55352;55813;2124;84440;2123;55803;4974;4763;23512;84282;51379,13,1.02636251597770000000
chr9,76474486,81651005,5176519,-1,1,138199;55312;29968;2776;140803;9630;2650;26578;158471;23230;54981;55071;84131;6096;442425;5125,16,0.30908801841546400000
chr4,62334399,83811097,21476698,-1,1,100129583;6779;4589;255119;651;55752;9508;8999;213;339965;27163;26057;2712;22902;1060;4283;10720;10879;100631383;58503;389208;26952;54490;23284;2919;3346;54959;3184;79799;7367;8615;58478;419;10117;9908;2798;6374;246175;174;2920;7365;8671;10983;255324;339967;152815;27284;173;7364;401137;55236;118429;153020;3576;1448;5473;85438;285521;6373;152816;5593;6783;1447;1633;2069;901;5196;5197;7363;1446;25898;57619;574537;92597;57050;152559;345079;685;9407;3347;401138;441024;2926;3627;253017;10886;56978;260436;9987;28983;55153;25849;6372;10563;65008;5470;7366;10941;258;374;2250;22872;8987;79966;91746;132724;55589;2638;80144;2044;166824;441027;26228;3512;306;950;2921;84779;53371,119,0.55408890137580700000
chr3,73071599,85957329,12885730,-1,1,5067;100131827;100288801;151987;6092;253559;2632;6091;55096;23024,10,0.07760522686724000000
chr11,130863801,134939347,4075546,-1,1,4978;23310;112937;29087;83700;112936;219938;50863;89944;27034;27087;22997,12,0.29443907638387600000
chrX,119574233,147831962,28257729,-1,1,10735;158521;100130613;728075;6594;100129520;2158;728082;55609;57187;139067;494119;9947;29071;347475;84631;30014;102723631;10479;9016;331;680;441525;4168;93380;100507170;10178;51442;159091;2332;102723737;389895;494118;4068;51114;64663;9142;2892;644538;79649;139170;63035;10813;3547;102723680;728695;3251;57826;83844;728062;8862;23641;7512;158763;2000;645188;51438;1038;255313;84295;55796;10761;8450;9459;139065;6658;959;90167;441519;139760;347487;51270;541466;139741;139378;27316;9131;2719;51634;7547;728096;653282;728072;728049;9363;3920;2747;90161;347468;728042;159090;2258;10495;55511;2273;100133053;100129239;2239;643311;2334;728036;441518;64648;139081;203522;51765;27336;56180;54440;4952;203523;26071;7626;54967;728712;286410;28985;340578;83550;441521;728090;8933,122,0.43174028599396600000
chr15,22373311,28559437,6186126,-1,1,2562;7681;123606;4948;57194;283694;81614;2558;8924;114791;23742;7337;6638;2567;8926;283685;54551;4692;23191;283767,20,0.32330411634034000000
chr8,186785,5025388,4838603,-1,1,64478;9172;9639;169270;2055;157695;26260;9228;9920;157697,10,0.20667122307823100000
chr6,70579948,86204960,15625012,-1,1,4199;7162;134728;135228;90025;6785;1303;79627;55754;55510;134701;4907;9324;115004;4646;167681;80759;26503;441161;26054;135154;51167;56479;9096;22999;594;1347;135152;25998;5238;25821;112611;1310;60682;340168;83699;23033;57579;101928601;55023;1297;112609;154288;7272;100129128;27145;3617;9892;55603;1915;167691;3351;22832,53,0.33919973949460000000
chr16,21475044,29182200,7707156,-1,1,343;162083;6340;23247;146183;487;79728;7385;56061;146177;124454;730094;6338;79874;146395;728734;83985;5579;55718;10368;51451;50615;55114;6799;8663;27040;10261;930;9956;29904;9951;728741;84901;1039;388228;79831;4706;23214;5930;26471;197370;728689;25970;63928;11273;100132247;115584;112869;27327;1201;255762;7284;246778;23062;51108;10595;100507607;55911;440345;3566;5347;84516;57478;91949;2975;6817;342357,67,0.86932196519701900000
chr1,155983589,156495518,511929,-1,1,632;64218;391104;7203;128239;100527963;10485;128229;56893;79957;9673;112770;4000;11243;23381;84283;4209;28956;57111;92312;6746;57127,22,4.29747093835278000000
chr9,99579950,102989222,3409272,-1,1,10541;9568;4686;158431;23071;79695;27130;1306;2304;54187;7046;7464;9830;51531;100499483;23424;85365;7507;55357;441457;10952;55363;8013;1515;158427;7111;55014;203286,28,0.82128970642412800000
chr10,84137793,84181073,43280,-1,1,10718,1,2.31053604436229000000
chr8,186785,2144735,1957950,-1,1,9172;9639;169270;2055;157695;26260;9228;9920;157697,9,0.45966444495518300000
chr2,223460504,228457903,4997399,-1,1,23704;79843;79853;8452;1285;2181;3667;84236;10056;5270;1286;3267;116255;7857;57590;57624;56947;130340;55619;65080,20,0.40020818829955300000
chr22,18890162,20312008,1421846,-1,1,54487;27037;5413;29801;65078;23617;10587;1312;7122;8214;7290;421;128977;8220;2812;388849;7353;2928;128989;6899;9993;54584;5625;79680;85359;64976;8318;5902;6576;8218,30,2.10993314325180000000
chr15,48435837,49490547,1054710,-1,1,399697;2585;23741;9318;9728;1854;22995;50804;6557;399694;2200,11,1.04294071356107000000
chr16,14910213,16586941,1676728,-1,1,100288332;23042;101059938;368;123803;9665;4629;123811;89927;4363;9284;54820;23420;408050;255027;54700,16,0.95423944730451200000
chr16,46500511,54518059,8017548,-1,1,643802;85320;55027;85407;23594;123970;5934;255919;113;64127;9683;124460;80205;94160;79191;79068;388276;79801;388272;10294;869;23322;1540;6477;29117;81831;27324;23090;6299;5257;64282;84706;91807;81533;64400;83752;55737,37,0.46148772667154600000
chr3,20194328,22157970,1963642,-1,1,8850;151648;79750,3,0.15277733925023000000
chrX,42059852,44047687,1987835,-1,1,4128;4693;80258;4129,4,0.20122394464329300000
chr22,18890162,21441944,2551782,-1,1,54487;27037;9342;29801;65078;10587;1312;6545;8214;7290;421;2812;6899;5625;7625;79680;64976;6576;3053;8218;5413;80764;23617;400891;1399;7122;150209;128977;8220;388849;84861;7353;51586;2928;128989;5297;9127;9993;54584;91179;85376;8216;85359;8318;728229;5902,46,1.80266182612778000000
chr7,91997684,97905676,5907992,-1,1,1278;1749;6863;51666;57001;54467;5444;7979;10165;1021;10282;30816;55610;257415;57798;55607;1780;4951;105375396;8910;54809;219285;799;64921;2791;253012;1750;2792;7980;5166;22853;168620;25851;440;5445;84060;5189;5446;23089,39,0.66012276252236000000
chr11,31742075,31870603,128528,-1,1,26610;5080,2,1.55608116519358000000
chr5,6414434,22975587,16561153,-1,1,54463;10299;9037;7204;1010;50834;134145;4651;54888;651746;83853;134147;1501;56172;4552;11044;54491;22948;23194;1016;1767;108;79072;6715;441061;90268;134111;10409;134121;90441;1611,31,0.18718503476177100000
chr15,30888776,32509932,1621156,-1,1,728498;51621;22909;161725;283710;54893;89839;4308;1139,9,0.55515940477042300000
chr22,49416199,51220923,1804724,-1,1,85358;410;400935;85378;9701;56666;5600;49;9889;23774;80305;11158;414918;79174;9997;1120;440836;1375;415116;83642;23542;644186;23209;6300;83933;79924;79087;6305;1890;348645;23654;113730;29781;55586;91289;54456,36,1.99476485047021000000
chr15,30941542,32509932,1568390,-1,1,161725;283710;54893;51621;4308;22909;1139,7,0.44631756132084500000
chr10,129907496,135435737,5528241,-1,1,118472;10844;80313;256536;253738;85442;3632;27287;8433;4288;93426;282973;282974;50632;92170;10570;84504;664;282969;118471;170394;196743;55844;54777;503542;101;1892;1571;4255;84435;10539,31,0.56075702922502800000
chr6,132025,4320789,4188764,-1,1,10455;404220;56940;389362;2762;1992;4835;94234;2296;8899;8737;63027;2295;56897;222826;55770;670;340156;7280;347733;221749;5272;26240;3662;135458;5269,26,0.62070816116639700000
chr20,60734,1611781,1551047,-1,1,140680;10616;1457;57761;83541;55968;10326;55321;140850;81623;140881;51378;9751;113278;245938;343637;245939;85508;85364;9491;128637;6939;400831;2280;642636;400830;55423;140809;284759;6666;27111;80023;128646,33,2.12759510188924000000
chr7,5048743,6146825,1098082,-1,1,60;5395;54476;51622;57786;84132;84629;222967;7965;222962;100310846;100533952;80028;6624;26100;654231;27102,17,1.54815396300094000000
chr15,23586243,28559437,4973194,-1,1,2562;7681;23742;8924;7337;6638;2567;4948;8926;57194;283685;54551;4692;2558,14,0.28150922726923600000
chr2,51128900,51640875,511975,-1,1,9378,1,0.19532203720884800000
chr6,163310635,170911237,7600602,-1,1,168002;10846;387263;55274;135138;55780;285800;2853;4301;113402;5134;9444;401285;3834;5689;54346;253769;100128124;168090;79981;7058;83887;6991;6196;11116;8635;28514;84498;6862;51660;64094;1235;6953;6908,34,0.44733298757124800000
chr13,102333248,115105655,12772407,-1,1,7027;2259;79587;55795;79774;3916;8874;22821;55608;23026;8858;55647;10426;8451;84945;79070;728215;1284;101928841;643677;2621;400165;7174;113622;65110;10673;8660;121793;283489;9358;23263;55739;54841;196541;643365;93081;55002;3621;2073;55082;1282;100129836;6656;23250;348013;1948;3981;2155;2159;100533467;122258;55208;496;6011;8881;6555;267012,57,0.44627453541059300000
chr18,78425,11858181,11779756,-1,1,116;55556;10403;23255;57132;8774;645369;84203;57045;103910;642597;9097;7525;147495;9218;5797;494514;1068;9229;79822;84034;4729;7298;91133;11031;23253;9663;9989;7050;339291;9984;81035;10928;2774;23347;63895;10627;201475;64863;8736;27098;284217;646000;23136;7541,45,0.38201130821385400000
chr7,155436322,159128555,3692233,-1,1,9690;155435;389602;55112;140545;6469;64327;3110;5799;7434;64434;54892;10049;57488,14,0.37917433704752700000
chr4,182074317,190807379,8733062,-1,1,285440;53842;205860;25854;55325;7098;55714;60684;836;80014;83891;57587;55602;2160;3818;79682;353322;291;100132463;27295;3660;441054;391723;201965;2195;339976;201973;4543;132625;55805;133121;256309;8470;2180;56977;3622;1635,37,0.42367728524084700000
chr12,8691730,14215925,5524195,-1,1,387836;51202;5554;1389;51266;283420;2842;2120;3821;2012;120939;4040;259295;57379;4074;259289;26253;144568;3822;259296;2;1027;50865;57613;387837;100431172;2904;8302;259294;259290;55507;100528032;259292;3820;259293;9976;22914;55359;160365;5858;57494;50836;23710;64581;5545;9052;4973;653247;1911;5544;5555;79370;10219;54682;83445;100129361;3824;50835;8531;353164;50839;81575;160364;55110;50837;50838;118426;50840;106707243;11272;5542;3823;80824;969;51348;29121;51267;8076,78,1.41197043189098000000
chrX,93755155,100251980,6496825,-1,1,27286;64102;1730;1478;392509;27035;7105;94121;402415;57526;29935,11,0.16931347234995600000
chrX,168992,155190160,155021168,-1,1,23096;64061;392509;10214;170685;23157;727837;55998;23439;729431;10916;158586;55859;331;3423;54830;4168;6901;5358;92002;27344;729447;54328;266740;9075;102723737;7552;729422;54954;84460;389874;56000;340562;644538;92552;254158;79649;56850;8225;2824;100272147;51186;3149;26576;100130361;1730;347541;139425;3547;728695;729408;79921;57826;59272;203413;2986;7512;9737;8544;55634;2857;3421;537;11013;340554;5716;6658;4101;54457;1438;91966;441519;4100;5931;27316;7403;4534;6839;51480;728096;27112;92129;101928917;140462;8241;6567;827;203569;27301;84548;645037;54413;100133053;7355;254065;79836;10084;347442;60343;51765;55593;139818;56180;6303;8269;142684;7626;10046;8409;203447;63932;2710;4515;8406;51248;56001;51616;2925;100130613;2564;1193;100132994;5354;11043;340533;22;3476;84631;26748;11238;203562;102723631;170261;58526;441525;4983;29944;6907;1536;2539;1478;9468;23597;2187;1287;81887;6611;3561;9767;9282;54857;347365;10800;139341;54539;11219;728062;169966;51209;23630;26548;1121;2000;645188;51438;2846;280658;1852;347344;23229;10857;56157;286430;101059915;438;5277;9758;1069;4674;154796;56548;51309;1184;645073;80712;1774;10245;2258;728343;9823;441531;11141;643311;90121;256643;23676;4114;6758;4107;286499;5009;1654;1831;51284;94121;170302;11230;79135;286410;9210;2491;441490;84187;633;6191;64743;4110;3598;389856;7789;55787;9452;50814;2157;139422;170062;57187;139067;4104;203427;4693;5456;10013;1964;55190;100996648;293;9016;100528062;30011;90316;93953;10178;6322;28952;24137;2332;4105;6845;94122;84968;64663;1538;9142;286530;2245;5634;9506;79576;3266;139212;5207;6535;8227;393;389852;170626;91851;27334;158866;550643;159013;407;7224;55796;10761;100132963;168400;4281;158835;24140;8471;90167;7737;7319;10149;11279;6134;64109;1678;139322;5063;55906;116442;84443;27197;8233;548313;6872;27018;100129239;139105;7102;10549;26071;2664;59353;8573;28985;79184;728049;728090;158521;139886;282808;8263;9130;728082;778;90843;1756;5422;7317;5935;347454;29071;207063;4112;412;158506;340602;30848;5127;22866;93380;159091;10159;212;139285;9338;85417;8266;100132399;158584;494118;190;7569;89801;2892;1968;5230;57232;55559;57529;8277;63035;80231;286436;25975;51311;8905;55086;139735;395;83692;171484;10251;169981;1349;63904;139716;257397;142689;80258;27035;1641;55613;7105;100329135;84295;9459;4810;404281;4109;367;474384;6748;139760;347487;92745;158830;53344;4103;9203;139378;186;474343;2719;3597;140456;9248;402415;203430;9185;90161;728042;4129;65267;56849;8228;8226;728036;7114;6399;4952;83740;84889;8481;6757;347468;347475;414;6759;9500;51132;8823;541578;2158;55609;2556;494119;6756;9502;158880;8517;8242;474383;57595;51442;389895;100132304;9754;80311;6102;27328;695;56159;51213;90737;60506;10943;100873985;57526;728269;170082;474382;102723680;728656;3358;8273;83844;114824;389840;170067;81557;80823;8862;2002;7216;79979;158763;23641;55217;8270;57477;7592;2833;425054;340526;727866;139599;139804;54470;8450;959;139562;645864;10075;117154;57631;2010;54521;79589;51634;3750;653282;728072;7076;392490;9363;8623;3920;347411;7454;100506164;265;90293;645051;100529097;55511;158724;6197;203547;139135;5355;347516;203522;139081;6451;27336;158787;728458;7499;4841;347517;51360;340578;139596;1896;441509;54466;660;158798;4108;171482;79868;728075;158833;79366;1821;56156;392465;1260;5160;56062;5303;3054;51260;139628;653220;340596;554;28986;23133;57393;2623;28227;4113;57692;50945;3730;7739;100131755;57481;8260;139170;64219;4204;389860;2574;3563;65991;10325;6170;10813;79710;8712;26280;2316;256714;10742;6173;9104;494197;29057;139324;442444;6103;54880;90736;55558;2742;1736;369;255313;3654;170627;645974;3897;79983;727940;541466;347527;8243;4007;139741;29978;2182;7504;60401;84707;53336;1485;159090;94056;57502;55285;653067;1046;11152;641339;1947;8852;7712;23708;203523;4267;54967;340542;89885;2277;83550;644353;55916;340595;6594;139189;63947;9643;9843;4935;139728;100288814;10479;50943;53940;55026;100507170;5638;4478;8239;4068;51114;139411;246100;9968;84679;115201;100533997;1741;416;64840;10682;11326;25763;27330;171483;8908;27286;1038;7543;158800;90060;1288;84061;215;6247;292;55879;401612;1183;340527;55344;29935;158983;357;10009;2747;2652;286514;340543;54885;100129407;10495;6792;79742;140886;2239;2334;4128;441518;139604;4303;55869;25878;4115;11040;8473;6855;84636;55922;728712;5956;2705;55841;54821;729396;441521;8933;10735;729442;9949;4694;84528;51481;492;3028;100129520;795;10389;83604;7411;9947;9367;100463488;10134;79057;54552;6906;340547;30014;415;5255;680;158809;6990;4435;5475;340529;65109;64860;7030;729428;8776;4675;5030;51566;729201;56271;4943;79917;85012;114928;5256;26609;54960;538;6853;5365;4354;286451;29934;10838;139221;9189;347404;6473;3251;286464;158931;139793;100008586;2717;3052;5973;139065;5199;546;5613;51270;139231;9131;7547;474381;257240;11254;27238;64102;2543;158747;2273;56474;5165;64648;54440;140597;5631;728239;3188;100130086;5251;8237;286527;100130302,814,0.52508958002432300000
chr9,110587580,124469529,13881949,-1,1,158399;5004;7099;11217;7295;10881;8727;84263;1317;5711;23307;54107;246184;85301;548645;23731;727;23392;445815;54942;7539;26248;80709;113220;259;10880;9128;1318;8518;114991;114987;58493;5774;1902;51552;7185;9550;50514;22949;26190;11064;5005;2790;54836;100505478;5069;57864;114299;169834;2934;54566;158405;55755;26147;23732;9991;79987;64420;7357;401546;153090;5998;2040;255220;81932;944;158401;23245;257169;138065;210;22954;552891;25861;4593;1620;3371;401548;9966;203197;1955,81,0.58349155439196600000
chrX,6453072,8126494,1673422,-1,1,51481;412;8228;26609;8226,5,0.29878894863339900000
chr4,9705671,38016846,28311175,-1,1,401124;9957;683;768211;51091;389203;202018;5860;166647;886;5099;56606;10891;29945;29063;9948;116984;9079;51056;254251;132864;579;9353;133015;6649;57495;55296;1816;114905;8842;55276;9982;55300;57620;80306;27146;55203;10568;10744;64151;85460;952;83888;645104;285550;23231;54876;80333;55286;23216;116449;3516;1665;57545;91050;26234;9364;259282,58,0.20486609969384900000
chr11,77251652,79935751,2684099,-1,1,4718;26011;79731;100532726;57558;9846;65987;1207;282679;7069;92105;28971;51773;283219;79053,15,0.55884674894629400000
chr12,162578,4109244,3946666,-1,1,283358;6539;440073;7004;56341;55846;5893;81029;83695;2288;775;2305;4815;6540;84766;84318;7289;144699;654429;10867;5927;83714;93589;65125;196513;23085;57097;79602,28,0.70945957930060500000
chrX,60701,155246643,155185942,-1,1,23096;64061;392509;10214;170685;23157;727837;55998;23439;729431;10916;158586;55859;331;3423;54830;4168;6901;5358;92002;27344;729447;54328;266740;9075;102723737;7552;729422;54954;84460;389874;56000;340562;644538;92552;254158;79649;56850;8225;2824;100272147;51186;3149;26576;100130361;1730;347541;139425;3547;728695;729408;79921;57826;59272;203413;2986;7512;9737;8544;55634;2857;3421;537;11013;340554;5716;6658;4101;54457;1438;91966;441519;4100;5931;27316;7403;4534;6839;51480;728096;27112;92129;101928917;140462;8241;6567;827;203569;27301;84548;645037;54413;100133053;7355;254065;79836;10084;347442;60343;51765;55593;139818;56180;6303;8269;142684;7626;10046;8409;203447;63932;2710;4515;8406;51248;56001;51616;2925;100130613;2564;1193;100132994;5354;11043;340533;22;3476;84631;26748;11238;203562;102723631;170261;58526;441525;4983;29944;6907;1536;2539;1478;9468;23597;2187;1287;81887;6611;3561;9767;9282;54857;347365;10800;139341;54539;11219;728062;169966;51209;23630;26548;1121;2000;645188;51438;2846;280658;1852;347344;23229;10857;56157;286430;101059915;438;5277;9758;1069;4674;154796;56548;51309;1184;645073;80712;1774;10245;2258;728343;9823;441531;11141;643311;90121;256643;23676;4114;6758;4107;286499;5009;1654;1831;51284;94121;170302;11230;79135;286410;9210;2491;441490;84187;633;6191;64743;4110;3598;389856;7789;55787;9452;50814;2157;139422;170062;57187;139067;4104;203427;4693;5456;10013;1964;55190;100996648;293;9016;100528062;30011;90316;93953;10178;6322;28952;24137;2332;4105;6845;94122;84968;64663;1538;9142;286530;2245;5634;9506;79576;3266;139212;5207;6535;8227;393;389852;170626;91851;27334;158866;550643;159013;407;7224;55796;10761;100132963;168400;4281;158835;24140;8471;90167;7737;7319;10149;11279;6134;64109;1678;139322;5063;55906;116442;84443;27197;8233;548313;6872;27018;100129239;139105;7102;10549;26071;2664;59353;8573;28985;79184;728049;728090;158521;3581;139886;282808;8263;9130;728082;778;90843;1756;5422;7317;5935;347454;29071;207063;4112;412;158506;340602;30848;5127;22866;93380;159091;10159;212;139285;9338;85417;8266;100132399;158584;494118;190;7569;89801;2892;1968;5230;57232;55559;57529;8277;63035;80231;286436;25975;51311;8905;55086;139735;395;83692;171484;10251;169981;1349;63904;139716;257397;142689;80258;27035;1641;55613;7105;100329135;84295;9459;4810;404281;4109;367;474384;6748;139760;347487;92745;158830;53344;4103;9203;139378;186;474343;2719;3597;140456;9248;402415;203430;9185;90161;728042;4129;65267;56849;8228;8226;728036;7114;6399;4952;83740;84889;8481;6757;347468;347475;414;6759;9500;51132;8823;541578;2158;55609;2556;494119;6756;9502;158880;8517;8242;474383;57595;51442;389895;100132304;9754;80311;6102;27328;695;56159;51213;90737;60506;10943;100873985;57526;728269;170082;474382;102723680;728656;3358;8273;83844;114824;389840;170067;81557;80823;8862;2002;7216;79979;158763;23641;55217;8270;57477;7592;2833;425054;340526;727866;139599;139804;54470;8450;959;139562;645864;10075;117154;57631;2010;54521;79589;51634;3750;653282;728072;7076;392490;9363;8623;3920;347411;7454;100506164;265;90293;645051;100529097;55511;158724;6197;203547;139135;5355;347516;203522;139081;6451;27336;158787;728458;7499;4841;347517;51360;340578;139596;1896;441509;54466;660;158798;4108;171482;79868;728075;158833;79366;1821;56156;392465;1260;5160;56062;5303;3054;51260;139628;653220;340596;554;28986;23133;57393;2623;28227;4113;57692;50945;3730;7739;100131755;57481;8260;139170;64219;4204;389860;2574;3563;65991;10325;6170;10813;79710;8712;26280;2316;256714;10742;6173;9104;494197;29057;139324;442444;6103;54880;90736;55558;2742;1736;369;255313;3654;170627;645974;3897;79983;727940;541466;347527;8243;4007;139741;29978;2182;7504;60401;84707;53336;1485;159090;94056;57502;55285;653067;1046;11152;641339;1947;8852;7712;23708;203523;4267;54967;340542;89885;2277;83550;644353;55916;340595;6594;139189;63947;9643;9843;4935;139728;100288814;10479;50943;53940;55026;100507170;5638;4478;8239;4068;51114;139411;246100;9968;84679;115201;100533997;1741;416;64840;10682;11326;25763;27330;171483;8908;27286;1038;7543;158800;90060;1288;84061;215;6247;292;55879;401612;1183;340527;55344;29935;158983;357;10009;2747;2652;286514;340543;54885;100129407;10495;6792;79742;140886;2239;2334;4128;441518;139604;4303;55869;25878;4115;11040;8473;6855;84636;55922;728712;5956;2705;55841;54821;729396;441521;8933;10735;729442;9949;4694;84528;51481;492;3028;100129520;795;10389;83604;7411;9947;9367;100463488;10134;79057;54552;6906;340547;30014;415;5255;680;158809;6990;4435;5475;340529;65109;64860;7030;729428;8776;4675;5030;51566;729201;56271;4943;79917;85012;114928;5256;26609;54960;538;6853;5365;4354;286451;29934;10838;139221;9189;347404;6473;3251;286464;158931;139793;100008586;2717;3052;5973;139065;5199;546;5613;51270;139231;9131;7547;474381;257240;11254;27238;64102;2543;158747;2273;56474;5165;64648;54440;140597;5631;728239;3188;100130086;5251;8237;286527;100130302,815,0.52517643640684900000
chr15,30930422,32509932,1579510,-1,1,51621;22909;161725;283710;54893;89839;4308;1139,8,0.50648618875474000000
chr1,228085541,232560406,4474865,-1,1,5867;92815;27185;54583;128061;440730;57568;58480;79169;10753;128308;2590;128312;2987;84886;64801;57165;7257;51127;126731;23456;55746;149373;89780;27097;10638;7483;8290;9816;8443;84033;83932;149603;100129094;375061;149371;81559;200205;79605;183;375;58;22796;79573,44,0.98326988635411300000
chr22,18875830,21441944,2566114,-1,1,54487;27037;9342;29801;65078;10587;1312;6545;8214;7290;421;2812;6899;5625;7625;79680;64976;6576;3053;8218;5413;80764;23617;400891;1399;7122;150209;128977;8220;388849;84861;7353;51586;2928;128989;5297;9127;9993;54584;91179;85376;8216;85359;8318;728229;5902,46,1.79259378188187000000
chr6,113787802,125496868,11709066,-1,1,441168;25842;221303;51389;345895;2173;221302;254228;222546;57515;7259;285761;254394;221301;154215;5350;3066;222553;222545;116150;23270;2444;100128327;3298;6098;5570;79632;221294;10345;3841;154214;7164;245806;29940;57120;4121;1300;387119;134829;4082;222537;221322;10924;2697,44,0.37577719691732900000
chr4,71553,1554763,1483210,-1,1,10336;7700;521;4636;10417;10861;84286;654254;285498;54872;1609;255403;10815;2580;53834;84179;5158;170960;3425;152687;10296;1487;54729;57654;285464,25,1.68553340390100000000
chr22,18875830,21441944,2566114,-1,1,54487;27037;9342;29801;65078;10587;1312;6545;8214;7290;421;2812;6899;5625;7625;79680;64976;6576;3053;8218;5413;80764;23617;400891;1399;7122;150209;128977;8220;388849;84861;7353;51586;2928;128989;5297;9127;9993;54584;91179;85376;8216;85359;8318;728229;5902,46,1.79259378188187000000
chr2,168102669,181853134,13750465,-1,1,3235;129446;129831;26003;344191;130507;8647;150737;3232;3238;100526832;51661;4780;3234;4036;83879;389058;494513;9541;80856;3237;6670;100131390;129880;285141;151556;1386;114880;254042;29789;8540;10170;50940;79634;1781;91404;27347;29081;1746;493911;129881;1134;8575;151230;8604;115677;1123;79901;10324;51776;253782;9360;57703;3236;140469;8520;79675;151126;57405;79828;518;2571;1745;10651;10477;92104;80067;57818;3239;3233;220988;3231;3655;11069;6741;9874;8708;285025;5163;65977;7273;7456,82,0.59634346911177200000
chrX,60701,155232894,155172193,-1,1,23096;64061;392509;10214;170685;23157;727837;55998;23439;729431;10916;158586;55859;331;3423;54830;4168;6901;5358;92002;27344;729447;54328;266740;9075;102723737;7552;729422;54954;84460;389874;56000;340562;644538;92552;254158;79649;56850;8225;2824;100272147;51186;3149;26576;100130361;1730;347541;139425;3547;728695;729408;79921;57826;59272;203413;2986;7512;9737;8544;55634;2857;3421;537;11013;340554;5716;6658;4101;54457;1438;91966;441519;4100;5931;27316;7403;4534;6839;51480;728096;27112;92129;101928917;140462;8241;6567;827;203569;27301;84548;645037;54413;100133053;7355;254065;79836;10084;347442;60343;51765;55593;139818;56180;6303;8269;142684;7626;10046;8409;203447;63932;2710;4515;8406;51248;56001;51616;2925;100130613;2564;1193;100132994;5354;11043;340533;22;3476;84631;26748;11238;203562;102723631;170261;58526;441525;4983;29944;6907;1536;2539;1478;9468;23597;2187;1287;81887;6611;3561;9767;9282;54857;347365;10800;139341;54539;11219;728062;169966;51209;23630;26548;1121;2000;645188;51438;2846;280658;1852;347344;23229;10857;56157;286430;101059915;438;5277;9758;1069;4674;154796;56548;51309;1184;645073;80712;1774;10245;2258;728343;9823;441531;11141;643311;90121;256643;23676;4114;6758;4107;286499;5009;1654;1831;51284;94121;170302;11230;79135;286410;9210;2491;441490;84187;633;6191;64743;4110;3598;389856;7789;55787;9452;50814;2157;139422;170062;57187;139067;4104;203427;4693;5456;10013;1964;55190;100996648;293;9016;100528062;30011;90316;93953;10178;6322;28952;24137;2332;4105;6845;94122;84968;64663;1538;9142;286530;2245;5634;9506;79576;3266;139212;5207;6535;8227;393;389852;170626;91851;27334;158866;550643;159013;407;7224;55796;10761;100132963;168400;4281;158835;24140;8471;90167;7737;7319;10149;11279;6134;64109;1678;139322;5063;55906;116442;84443;27197;8233;548313;6872;27018;100129239;139105;7102;10549;26071;2664;59353;8573;28985;79184;728049;728090;158521;3581;139886;282808;8263;9130;728082;778;90843;1756;5422;7317;5935;347454;29071;207063;4112;412;158506;340602;30848;5127;22866;93380;159091;10159;212;139285;9338;85417;8266;100132399;158584;494118;190;7569;89801;2892;1968;5230;57232;55559;57529;8277;63035;80231;286436;25975;51311;8905;55086;139735;395;83692;171484;10251;169981;1349;63904;139716;257397;142689;80258;27035;1641;55613;7105;100329135;84295;9459;4810;404281;4109;367;474384;6748;139760;347487;92745;158830;53344;4103;9203;139378;186;474343;2719;3597;140456;9248;402415;203430;9185;90161;728042;4129;65267;56849;8228;8226;728036;7114;6399;4952;83740;84889;8481;6757;347468;347475;414;6759;9500;51132;8823;541578;2158;55609;2556;494119;6756;9502;158880;8517;8242;474383;57595;51442;389895;100132304;9754;80311;6102;27328;695;56159;51213;90737;60506;10943;100873985;57526;728269;170082;474382;102723680;728656;3358;8273;83844;114824;389840;170067;81557;80823;8862;2002;7216;79979;158763;23641;55217;8270;57477;7592;2833;425054;340526;727866;139599;139804;54470;8450;959;139562;645864;10075;117154;57631;2010;54521;79589;51634;3750;653282;728072;7076;392490;9363;8623;3920;347411;7454;100506164;265;90293;645051;100529097;55511;158724;6197;203547;139135;5355;347516;203522;139081;6451;27336;158787;728458;7499;4841;347517;51360;340578;139596;1896;441509;54466;660;158798;4108;171482;79868;728075;158833;79366;1821;56156;392465;1260;5160;56062;5303;3054;51260;139628;653220;340596;554;28986;23133;57393;2623;28227;4113;57692;50945;3730;7739;100131755;57481;8260;139170;64219;4204;389860;2574;3563;65991;10325;6170;10813;79710;8712;26280;2316;256714;10742;6173;9104;494197;29057;139324;442444;6103;54880;90736;55558;2742;1736;369;255313;3654;170627;645974;3897;79983;727940;541466;347527;8243;4007;139741;29978;2182;7504;60401;84707;53336;1485;159090;94056;57502;55285;653067;1046;11152;641339;1947;8852;7712;23708;203523;4267;54967;340542;89885;2277;83550;644353;55916;340595;6594;139189;63947;9643;9843;4935;139728;100288814;10479;50943;53940;55026;100507170;5638;4478;8239;4068;51114;139411;246100;9968;84679;115201;100533997;1741;416;64840;10682;11326;25763;27330;171483;8908;27286;1038;7543;158800;90060;1288;84061;215;6247;292;55879;401612;1183;340527;55344;29935;158983;357;10009;2747;2652;286514;340543;54885;100129407;10495;6792;79742;140886;2239;2334;4128;441518;139604;4303;55869;25878;4115;11040;8473;6855;84636;55922;728712;5956;2705;55841;54821;729396;441521;8933;10735;729442;9949;4694;84528;51481;492;3028;100129520;795;10389;83604;7411;9947;9367;100463488;10134;79057;54552;6906;340547;30014;415;5255;680;158809;6990;4435;5475;340529;65109;64860;7030;729428;8776;4675;5030;51566;729201;56271;4943;79917;85012;114928;5256;26609;54960;538;6853;5365;4354;286451;29934;10838;139221;9189;347404;6473;3251;286464;158931;139793;100008586;2717;3052;5973;139065;5199;546;5613;51270;139231;9131;7547;474381;257240;11254;27238;64102;2543;158747;2273;56474;5165;64648;54440;140597;5631;728239;3188;100130086;5251;8237;286527;100130302,815,0.52522296955615000000
chrX,168992,155190160,155021168,-1,1,23096;64061;392509;10214;170685;23157;727837;55998;23439;729431;10916;158586;55859;331;3423;54830;4168;6901;5358;92002;27344;729447;54328;266740;9075;102723737;7552;729422;54954;84460;389874;56000;340562;644538;92552;254158;79649;56850;8225;2824;100272147;51186;3149;26576;100130361;1730;347541;139425;3547;728695;729408;79921;57826;59272;203413;2986;7512;9737;8544;55634;2857;3421;537;11013;340554;5716;6658;4101;54457;1438;91966;441519;4100;5931;27316;7403;4534;6839;51480;728096;27112;92129;101928917;140462;8241;6567;827;203569;27301;84548;645037;54413;100133053;7355;254065;79836;10084;347442;60343;51765;55593;139818;56180;6303;8269;142684;7626;10046;8409;203447;63932;2710;4515;8406;51248;56001;51616;2925;100130613;2564;1193;100132994;5354;11043;340533;22;3476;84631;26748;11238;203562;102723631;170261;58526;441525;4983;29944;6907;1536;2539;1478;9468;23597;2187;1287;81887;6611;3561;9767;9282;54857;347365;10800;139341;54539;11219;728062;169966;51209;23630;26548;1121;2000;645188;51438;2846;280658;1852;347344;23229;10857;56157;286430;101059915;438;5277;9758;1069;4674;154796;56548;51309;1184;645073;80712;1774;10245;2258;728343;9823;441531;11141;643311;90121;256643;23676;4114;6758;4107;286499;5009;1654;1831;51284;94121;170302;11230;79135;286410;9210;2491;441490;84187;633;6191;64743;4110;3598;389856;7789;55787;9452;50814;2157;139422;170062;57187;139067;4104;203427;4693;5456;10013;1964;55190;100996648;293;9016;100528062;30011;90316;93953;10178;6322;28952;24137;2332;4105;6845;94122;84968;64663;1538;9142;286530;2245;5634;9506;79576;3266;139212;5207;6535;8227;393;389852;170626;91851;27334;158866;550643;159013;407;7224;55796;10761;100132963;168400;4281;158835;24140;8471;90167;7737;7319;10149;11279;6134;64109;1678;139322;5063;55906;116442;84443;27197;8233;548313;6872;27018;100129239;139105;7102;10549;26071;2664;59353;8573;28985;79184;728049;728090;158521;139886;282808;8263;9130;728082;778;90843;1756;5422;7317;5935;347454;29071;207063;4112;412;158506;340602;30848;5127;22866;93380;159091;10159;212;139285;9338;85417;8266;100132399;158584;494118;190;7569;89801;2892;1968;5230;57232;55559;57529;8277;63035;80231;286436;25975;51311;8905;55086;139735;395;83692;171484;10251;169981;1349;63904;139716;257397;142689;80258;27035;1641;55613;7105;100329135;84295;9459;4810;404281;4109;367;474384;6748;139760;347487;92745;158830;53344;4103;9203;139378;186;474343;2719;3597;140456;9248;402415;203430;9185;90161;728042;4129;65267;56849;8228;8226;728036;7114;6399;4952;83740;84889;8481;6757;347468;347475;414;6759;9500;51132;8823;541578;2158;55609;2556;494119;6756;9502;158880;8517;8242;474383;57595;51442;389895;100132304;9754;80311;6102;27328;695;56159;51213;90737;60506;10943;100873985;57526;728269;170082;474382;102723680;728656;3358;8273;83844;114824;389840;170067;81557;80823;8862;2002;7216;79979;158763;23641;55217;8270;57477;7592;2833;425054;340526;727866;139599;139804;54470;8450;959;139562;645864;10075;117154;57631;2010;54521;79589;51634;3750;653282;728072;7076;392490;9363;8623;3920;347411;7454;100506164;265;90293;645051;100529097;55511;158724;6197;203547;139135;5355;347516;203522;139081;6451;27336;158787;728458;7499;4841;347517;51360;340578;139596;1896;441509;54466;660;158798;4108;171482;79868;728075;158833;79366;1821;56156;392465;1260;5160;56062;5303;3054;51260;139628;653220;340596;554;28986;23133;57393;2623;28227;4113;57692;50945;3730;7739;100131755;57481;8260;139170;64219;4204;389860;2574;3563;65991;10325;6170;10813;79710;8712;26280;2316;256714;10742;6173;9104;494197;29057;139324;442444;6103;54880;90736;55558;2742;1736;369;255313;3654;170627;645974;3897;79983;727940;541466;347527;8243;4007;139741;29978;2182;7504;60401;84707;53336;1485;159090;94056;57502;55285;653067;1046;11152;641339;1947;8852;7712;23708;203523;4267;54967;340542;89885;2277;83550;644353;55916;340595;6594;139189;63947;9643;9843;4935;139728;100288814;10479;50943;53940;55026;100507170;5638;4478;8239;4068;51114;139411;246100;9968;84679;115201;100533997;1741;416;64840;10682;11326;25763;27330;171483;8908;27286;1038;7543;158800;90060;1288;84061;215;6247;292;55879;401612;1183;340527;55344;29935;158983;357;10009;2747;2652;286514;340543;54885;100129407;10495;6792;79742;140886;2239;2334;4128;441518;139604;4303;55869;25878;4115;11040;8473;6855;84636;55922;728712;5956;2705;55841;54821;729396;441521;8933;10735;729442;9949;4694;84528;51481;492;3028;100129520;795;10389;83604;7411;9947;9367;100463488;10134;79057;54552;6906;340547;30014;415;5255;680;158809;6990;4435;5475;340529;65109;64860;7030;729428;8776;4675;5030;51566;729201;56271;4943;79917;85012;114928;5256;26609;54960;538;6853;5365;4354;286451;29934;10838;139221;9189;347404;6473;3251;286464;158931;139793;100008586;2717;3052;5973;139065;5199;546;5613;51270;139231;9131;7547;474381;257240;11254;27238;64102;2543;158747;2273;56474;5165;64648;54440;140597;5631;728239;3188;100130086;5251;8237;286527;100130302,814,0.52508958002432300000
chr10,116829,6739705,6622876,-1,1,105;1109;10531;22884;5214;10771;79754;5209;3601;79861;83592;5588;23560;91734;23185;3559;84991;8644;54906;22982;1316;114131;51806;54522;84893;1646;2665;3422;1645;810;10276,31,0.46807459478329400000
chrX,60701,155246643,155185942,-1,1,23096;64061;392509;10214;170685;23157;727837;55998;23439;729431;10916;158586;55859;331;3423;54830;4168;6901;5358;92002;27344;729447;54328;266740;9075;102723737;7552;729422;54954;84460;389874;56000;340562;644538;92552;254158;79649;56850;8225;2824;100272147;51186;3149;26576;100130361;1730;347541;139425;3547;728695;729408;79921;57826;59272;203413;2986;7512;9737;8544;55634;2857;3421;537;11013;340554;5716;6658;4101;54457;1438;91966;441519;4100;5931;27316;7403;4534;6839;51480;728096;27112;92129;101928917;140462;8241;6567;827;203569;27301;84548;645037;54413;100133053;7355;254065;79836;10084;347442;60343;51765;55593;139818;56180;6303;8269;142684;7626;10046;8409;203447;63932;2710;4515;8406;51248;56001;51616;2925;100130613;2564;1193;100132994;5354;11043;340533;22;3476;84631;26748;11238;203562;102723631;170261;58526;441525;4983;29944;6907;1536;2539;1478;9468;23597;2187;1287;81887;6611;3561;9767;9282;54857;347365;10800;139341;54539;11219;728062;169966;51209;23630;26548;1121;2000;645188;51438;2846;280658;1852;347344;23229;10857;56157;286430;101059915;438;5277;9758;1069;4674;154796;56548;51309;1184;645073;80712;1774;10245;2258;728343;9823;441531;11141;643311;90121;256643;23676;4114;6758;4107;286499;5009;1654;1831;51284;94121;170302;11230;79135;286410;9210;2491;441490;84187;633;6191;64743;4110;3598;389856;7789;55787;9452;50814;2157;139422;170062;57187;139067;4104;203427;4693;5456;10013;1964;55190;100996648;293;9016;100528062;30011;90316;93953;10178;6322;28952;24137;2332;4105;6845;94122;84968;64663;1538;9142;286530;2245;5634;9506;79576;3266;139212;5207;6535;8227;393;389852;170626;91851;27334;158866;550643;159013;407;7224;55796;10761;100132963;168400;4281;158835;24140;8471;90167;7737;7319;10149;11279;6134;64109;1678;139322;5063;55906;116442;84443;27197;8233;548313;6872;27018;100129239;139105;7102;10549;26071;2664;59353;8573;28985;79184;728049;728090;158521;3581;139886;282808;8263;9130;728082;778;90843;1756;5422;7317;5935;347454;29071;207063;4112;412;158506;340602;30848;5127;22866;93380;159091;10159;212;139285;9338;85417;8266;100132399;158584;494118;190;7569;89801;2892;1968;5230;57232;55559;57529;8277;63035;80231;286436;25975;51311;8905;55086;139735;395;83692;171484;10251;169981;1349;63904;139716;257397;142689;80258;27035;1641;55613;7105;100329135;84295;9459;4810;404281;4109;367;474384;6748;139760;347487;92745;158830;53344;4103;9203;139378;186;474343;2719;3597;140456;9248;402415;203430;9185;90161;728042;4129;65267;56849;8228;8226;728036;7114;6399;4952;83740;84889;8481;6757;347468;347475;414;6759;9500;51132;8823;541578;2158;55609;2556;494119;6756;9502;158880;8517;8242;474383;57595;51442;389895;100132304;9754;80311;6102;27328;695;56159;51213;90737;60506;10943;100873985;57526;728269;170082;474382;102723680;728656;3358;8273;83844;114824;389840;170067;81557;80823;8862;2002;7216;79979;158763;23641;55217;8270;57477;7592;2833;425054;340526;727866;139599;139804;54470;8450;959;139562;645864;10075;117154;57631;2010;54521;79589;51634;3750;653282;728072;7076;392490;9363;8623;3920;347411;7454;100506164;265;90293;645051;100529097;55511;158724;6197;203547;139135;5355;347516;203522;139081;6451;27336;158787;728458;7499;4841;347517;51360;340578;139596;1896;441509;54466;660;158798;4108;171482;79868;728075;158833;79366;1821;56156;392465;1260;5160;56062;5303;3054;51260;139628;653220;340596;554;28986;23133;57393;2623;28227;4113;57692;50945;3730;7739;100131755;57481;8260;139170;64219;4204;389860;2574;3563;65991;10325;6170;10813;79710;8712;26280;2316;256714;10742;6173;9104;494197;29057;139324;442444;6103;54880;90736;55558;2742;1736;369;255313;3654;170627;645974;3897;79983;727940;541466;347527;8243;4007;139741;29978;2182;7504;60401;84707;53336;1485;159090;94056;57502;55285;653067;1046;11152;641339;1947;8852;7712;23708;203523;4267;54967;340542;89885;2277;83550;644353;55916;340595;6594;139189;63947;9643;9843;4935;139728;100288814;10479;50943;53940;55026;100507170;5638;4478;8239;4068;51114;139411;246100;9968;84679;115201;100533997;1741;416;64840;10682;11326;25763;27330;171483;8908;27286;1038;7543;158800;90060;1288;84061;215;6247;292;55879;401612;1183;340527;55344;29935;158983;357;10009;2747;2652;286514;340543;54885;100129407;10495;6792;79742;140886;2239;2334;4128;441518;139604;4303;55869;25878;4115;11040;8473;6855;84636;55922;728712;5956;2705;55841;54821;729396;441521;8933;10735;729442;9949;4694;84528;51481;492;3028;100129520;795;10389;83604;7411;9947;9367;100463488;10134;79057;54552;6906;340547;30014;415;5255;680;158809;6990;4435;5475;340529;65109;64860;7030;729428;8776;4675;5030;51566;729201;56271;4943;79917;85012;114928;5256;26609;54960;538;6853;5365;4354;286451;29934;10838;139221;9189;347404;6473;3251;286464;158931;139793;100008586;2717;3052;5973;139065;5199;546;5613;51270;139231;9131;7547;474381;257240;11254;27238;64102;2543;158747;2273;56474;5165;64648;54440;140597;5631;728239;3188;100130086;5251;8237;286527;100130302,815,0.52517643640684900000
chr14,35007710,44901392,9893682,-1,1,4253;26257;161198;55012;7080;6751;6729;84684;3169;10484;58533;122553;55837;253970;254170;253959;5083;8487;145581;5411;5687;51562;283635;145282;9692;89874;319089;84312;11177;1073;4792,31,0.31333127545437600000
chr7,149330299,159124478,9794179,-1,1,84626;140545;1804;168537;389602;26;22976;11194;392843;57180;6469;3110;116988;168391;51422;349136;55303;155051;63917;113763;155435;55340;83590;28959;3361;64327;168544;10061;9690;55112;6604;285973;26157;55365;7434;285888;54892;285971;10049;57488;54480;58508;65999;5799;474344;643641;1020;6009;23145;2636;2020;653857;3638;5919;51667;9311;170575;6522;3757;4846;29803;64434;10922;100527949;7516;155066;136371;155038,68,0.69428994507860200000
chr22,51123497,51220923,97426,-1,1,49;11158;85358,3,3.07926015642642000000
chr15,30930422,32539670,1609248,-1,1,51621;22909;161725;283710;54893;89839;4308;1139,8,0.49712660820457700000
chr16,14910213,16292304,1382091,-1,1,4629;100288332;123811;89927;4363;9284;54820;23420;368;255027;23042;54700;123803;9665,14,1.01295790219313000000
chr2,162547702,167910910,5363208,-1,1,79809;6335;129446;6323;25801;151258;57282;90134;6328;2191;55137;6326;2591;1803;6332;22837;64135;2888;2641;80034,20,0.37291113825904200000
chr17,34815077,36304040,1488963,-1,1,26574;9326;6928;3975;79893;31;80179;284098;11072;79154;79922;11276;11056;101060376;6871;284099,16,1.07457337757889000000
chr16,76970282,77533839,563557,-1,1,170692;22879;100130958,3,0.53233302043981400000
chr15,30888776,32509932,1621156,-1,1,728498;51621;22909;161725;283710;54893;89839;4308;1139,9,0.55515940477042300000
chrX,60701,155190160,155129459,-1,1,23096;64061;392509;10214;170685;23157;727837;55998;23439;729431;10916;158586;55859;331;3423;54830;4168;6901;5358;92002;27344;729447;54328;266740;9075;102723737;7552;729422;54954;84460;389874;56000;340562;644538;92552;254158;79649;56850;8225;2824;100272147;51186;3149;26576;100130361;1730;347541;139425;3547;728695;729408;79921;57826;59272;203413;2986;7512;9737;8544;55634;2857;3421;537;11013;340554;5716;6658;4101;54457;1438;91966;441519;4100;5931;27316;7403;4534;6839;51480;728096;27112;92129;101928917;140462;8241;6567;827;203569;27301;84548;645037;54413;100133053;7355;254065;79836;10084;347442;60343;51765;55593;139818;56180;6303;8269;142684;7626;10046;8409;203447;63932;2710;4515;8406;51248;56001;51616;2925;100130613;2564;1193;100132994;5354;11043;340533;22;3476;84631;26748;11238;203562;102723631;170261;58526;441525;4983;29944;6907;1536;2539;1478;9468;23597;2187;1287;81887;6611;3561;9767;9282;54857;347365;10800;139341;54539;11219;728062;169966;51209;23630;26548;1121;2000;645188;51438;2846;280658;1852;347344;23229;10857;56157;286430;101059915;438;5277;9758;1069;4674;154796;56548;51309;1184;645073;80712;1774;10245;2258;728343;9823;441531;11141;643311;90121;256643;23676;4114;6758;4107;286499;5009;1654;1831;51284;94121;170302;11230;79135;286410;9210;2491;441490;84187;633;6191;64743;4110;3598;389856;7789;55787;9452;50814;2157;139422;170062;57187;139067;4104;203427;4693;5456;10013;1964;55190;100996648;293;9016;100528062;30011;90316;93953;10178;6322;28952;24137;2332;4105;6845;94122;84968;64663;1538;9142;286530;2245;5634;9506;79576;3266;139212;5207;6535;8227;393;389852;170626;91851;27334;158866;550643;159013;407;7224;55796;10761;100132963;168400;4281;158835;24140;8471;90167;7737;7319;10149;11279;6134;64109;1678;139322;5063;55906;116442;84443;27197;8233;548313;6872;27018;100129239;139105;7102;10549;26071;2664;59353;8573;28985;79184;728049;728090;158521;139886;282808;8263;9130;728082;778;90843;1756;5422;7317;5935;347454;29071;207063;4112;412;158506;340602;30848;5127;22866;93380;159091;10159;212;139285;9338;85417;8266;100132399;158584;494118;190;7569;89801;2892;1968;5230;57232;55559;57529;8277;63035;80231;286436;25975;51311;8905;55086;139735;395;83692;171484;10251;169981;1349;63904;139716;257397;142689;80258;27035;1641;55613;7105;100329135;84295;9459;4810;404281;4109;367;474384;6748;139760;347487;92745;158830;53344;4103;9203;139378;186;474343;2719;3597;140456;9248;402415;203430;9185;90161;728042;4129;65267;56849;8228;8226;728036;7114;6399;4952;83740;84889;8481;6757;347468;347475;414;6759;9500;51132;8823;541578;2158;55609;2556;494119;6756;9502;158880;8517;8242;474383;57595;51442;389895;100132304;9754;80311;6102;27328;695;56159;51213;90737;60506;10943;100873985;57526;728269;170082;474382;102723680;728656;3358;8273;83844;114824;389840;170067;81557;80823;8862;2002;7216;79979;158763;23641;55217;8270;57477;7592;2833;425054;340526;727866;139599;139804;54470;8450;959;139562;645864;10075;117154;57631;2010;54521;79589;51634;3750;653282;728072;7076;392490;9363;8623;3920;347411;7454;100506164;265;90293;645051;100529097;55511;158724;6197;203547;139135;5355;347516;203522;139081;6451;27336;158787;728458;7499;4841;347517;51360;340578;139596;1896;441509;54466;660;158798;4108;171482;79868;728075;158833;79366;1821;56156;392465;1260;5160;56062;5303;3054;51260;139628;653220;340596;554;28986;23133;57393;2623;28227;4113;57692;50945;3730;7739;100131755;57481;8260;139170;64219;4204;389860;2574;3563;65991;10325;6170;10813;79710;8712;26280;2316;256714;10742;6173;9104;494197;29057;139324;442444;6103;54880;90736;55558;2742;1736;369;255313;3654;170627;645974;3897;79983;727940;541466;347527;8243;4007;139741;29978;2182;7504;60401;84707;53336;1485;159090;94056;57502;55285;653067;1046;11152;641339;1947;8852;7712;23708;203523;4267;54967;340542;89885;2277;83550;644353;55916;340595;6594;139189;63947;9643;9843;4935;139728;100288814;10479;50943;53940;55026;100507170;5638;4478;8239;4068;51114;139411;246100;9968;84679;115201;100533997;1741;416;64840;10682;11326;25763;27330;171483;8908;27286;1038;7543;158800;90060;1288;84061;215;6247;292;55879;401612;1183;340527;55344;29935;158983;357;10009;2747;2652;286514;340543;54885;100129407;10495;6792;79742;140886;2239;2334;4128;441518;139604;4303;55869;25878;4115;11040;8473;6855;84636;55922;728712;5956;2705;55841;54821;729396;441521;8933;10735;729442;9949;4694;84528;51481;492;3028;100129520;795;10389;83604;7411;9947;9367;100463488;10134;79057;54552;6906;340547;30014;415;5255;680;158809;6990;4435;5475;340529;65109;64860;7030;729428;8776;4675;5030;51566;729201;56271;4943;79917;85012;114928;5256;26609;54960;538;6853;5365;4354;286451;29934;10838;139221;9189;347404;6473;3251;286464;158931;139793;100008586;2717;3052;5973;139065;5199;546;5613;51270;139231;9131;7547;474381;257240;11254;27238;64102;2543;158747;2273;56474;5165;64648;54440;140597;5631;728239;3188;100130086;5251;8237;286527;100130302,814,0.52472303149075000000
chr22,18876605,21499494,2622889,-1,1,54487;27037;9342;29801;65078;10587;1312;6545;8214;7290;421;2812;6899;5625;7625;79680;64976;6576;3053;8218;5413;80764;23617;400891;1399;7122;150209;128977;8220;388849;84861;7353;51586;2928;128989;5297;9127;9993;54584;91179;85376;8216;85359;8318;728229;5902,46,1.75379133466952000000
chr16,2187331,2188797,1466,-1,1,,0,0.00000000000000000000
chr16,2126112,2129188,3076,-1,1,7249,1,32.50975292587780000000
chr16,2144545,2146111,1566,-1,1,5310,1,63.85696040868460000000
chr16,2139238,2139521,283,-1,1,5310,1,353.35689045936400000000
chr17,30085744,31065319,979575,-1,1,55288;4642;7756;64149;55352;114659;55813;23512;5717;162494;8851,11,1.12293596712860000000
chr13,105792672,114323599,8530927,-1,1,7027;55795;79587;79774;3916;8874;55608;23026;8858;55647;10426;84945;728215;1284;101928841;400165;113622;10673;8660;121793;23263;55739;55002;3621;55082;1282;100129836;6656;23250;1948;3981;2155;2159;55208;122258;496;6011;8451;267012,39,0.45716016559513400000
chr16,29652360,30199168,546808,-1,1,653808;5531;26470;283897;253980;146378;8479;83719;23475;283899;124446;9344;3835;4150;226;253982;83723;5595;6911;11151;8448;79447;112476;9961;10423;6693;79153,27,4.93774780178783000000
chrX,27231866,31949255,4717389,-1,1,4113;80231;257397;139425;4115;4112;190;53940;11141;139422;1756;2710;347442;4114,14,0.29677433851649700000
chr3,64052,11004116,10940064,-1,1,51185;55831;9901;6396;9695;7428;285367;3708;4968;491;6419;151835;6538;9797;3568;29995;26140;8536;84522;859;63924;100526693;55207;2177;2917;51095;56852;25917;401052;115795;10752;132014;285368;285362;27255;10474;7862;51066;152330;51738;84818;55209;78987;3656;64419;10093;55845;57633;8553;375323;5021,51,0.46617643187462200000
chr9,140435487,141018976,583489,-1,1,92715;92714;79813;116225;375775;64975;774,7,1.19967985686105000000
chr10,116829,3822976,3706147,-1,1,22982;1316;105;10531;22884;10771;5214;3422;23560;91734;23185,11,0.29680420123648600000
chr16,72768,562227,489459,-1,1,3040;64285;4350;3039;4833;8312;64714;3042;8131;398;83986;58986;8786;79622;3049;3050;10573;51728;26063;9727;55692,21,4.29045129418399000000
chr22,21798813,23654237,1855424,-1,1,7332;23753;5594;7441;2781;100423062;613;8940;23532;129025;645426;29799;91227;140883;23759;150223;9647;27156;150221;23119;9609;164592,22,1.18571280742299000000
chr22,18847961,21441944,2593983,-1,1,54487;27037;9342;29801;65078;10587;1312;6545;8214;7290;421;2812;6899;5625;7625;79680;64976;6576;3053;8218;5413;80764;23617;400891;1399;7122;150209;128977;8220;388849;84861;7353;51586;2928;128989;5297;9127;9993;54584;91179;85376;8216;85359;8318;728229;5902,46,1.77333467489957000000
chr22,50890078,51149209,259131,-1,1,6305;23542;85358;644186;1890;410;113730;9997;29781;55586;79924;91289;440836;1120;1375,15,5.78857797793394000000
chr17,29425306,29488097,62791,-1,1,4763,1,1.59258492459110000000
chr15,89817565,91737061,1919496,-1,1,55215;3418;5346;374655;51458;2242;5428;100526783;51335;10519;9899;374654;10509;91433;290;55898;4122;348110;8826;342132;64784;145873;55897;5045;90381;8800;374659;641;26276;9055;390637;56964;10239,33,1.71920129033871000000
chr22,18890162,21441944,2551782,-1,1,54487;27037;9342;29801;65078;10587;1312;6545;8214;7290;421;2812;6899;5625;7625;79680;64976;6576;3053;8218;5413;80764;23617;400891;1399;7122;150209;128977;8220;388849;84861;7353;51586;2928;128989;5297;9127;9993;54584;91179;85376;8216;85359;8318;728229;5902,46,1.80266182612778000000
chr9,71031677,76816695,5785018,-1,1,9413;51104;375743;23137;138255;169693;80036;116224;138240;9615;320;256691;117531;687;8395;5239;9414;7763;301;23670;5568;216;138241;2395,24,0.41486474199388800000
chrX,168992,8434433,8265441,-1,1,414;28227;51481;286530;57502;8226;8228;425054;8225;1438;3563;26609;5613;25878;347527;415;416;207063;4267;293;412;7499;9189;438;64109;51480;6473;8227;55344;8623;8908,31,0.37505560804317600000
chr1,111100045,113201374,2101329,-1,1,1117;11218;829;3738;55791;3752;79961;3737;128344;128346;55924;79084;27159;963;54879;7482;57413;5016;55917;140;515;128338;5906;10390,24,1.14213433498515000000
chr18,6357711,15380676,9022965,-1,1,23255;57132;4158;8774;84203;388468;125228;57045;84617;147495;10650;9218;3613;5797;1149;56984;5771;10939;65258;79959;4729;79822;91133;11031;23253;56907;9989;81929;339291;4161;10928;162655;2774;63895;8731;201475;342850;374860;284217;646000;753;55125,42,0.46547891962342800000
chr4,37336,2170683,2133347,-1,1,10336;7700;521;7469;401115;4636;10417;84286;654254;54872;1609;2261;255403;7884;170960;7468;152877;10296;57654;353497;10460;3954;10861;92305;285498;339983;10815;2580;53834;84179;5158;3425;152687;1487;54729;285464,36,1.68748918952238000000
chr16,29652360,30199696,547336,-1,1,653808;5531;26470;283897;253980;146378;8479;83719;23475;283899;124446;9344;3835;4150;226;253982;83723;5595;6911;11151;8448;79447;112476;9961;10423;6693;79153,27,4.93298449215838000000
chr11,31238006,44682015,13444009,-1,1,79832;8539;341019;5896;966;221120;4005;5080;7189;51074;4076;847;119710;25758;91614;60529;25891;390110;1479;55226;6506;5954;25841;29099;57689;55346;51144;960;387763;493860;24147;7490;2132;143458;196294;26273;79899;8050;26610;79056;26298;55761;5897;10114;3732;100131378;84680;54765;120526;10480;2001,51,0.37935112956261800000
chr15,97931592,102465347,4533755,-1,1,145814;390649;4205;123355;204219;80213;79705;390648;55829;26682;3480;55180;145748;220;5046;283777;23336;22856;170691;100128108;64927;140460;6627;123283;91947,25,0.55141929813146100000
chr18,78425,8860680,8782255,-1,1,91133;116;55556;10403;23255;9663;645369;103910;642597;7050;339291;9984;9097;7525;81035;23347;10627;5797;494514;201475;64863;1068;8736;9229;27098;284217;79822;84034;23136;7298;7541,31,0.35298451251984800000
chr7,72721410,74142342,1420932,-1,1,5982;51085;9275;84277;7462;55695;135886;83451;1364;135892;6804;7461;155382;3984;26608;8468;9031;155368;2969;8326;7458;9569;2006;1365;114049,25,1.75940861350156000000
chrY,361508,581797,220289,-1,1,6473,1,0.45394913046044100000
chrX,411508,631797,220289,-1,1,6473,1,0.45394913046044100000
chr1,759762,2239497,1479735,-1,1,85452;83858;126789;5590;81669;728661;29101;199990;339453;6497;643988;9636;126792;219293;8510;163688;84808;64856;26155;6339;55052;254173;80772;65220;339456;375790;984;388581;54587;54973;84069;148398;401934;54998;9906;116983;339451;643965;51150;7293;118424;728642;2563;8784;55210;2782;54991;1855;83756;142678;441869;57801,52,3.51414273501674000000
chr17,16822683,20193169,3370486,-1,1,2314;55244;125170;55090;11216;79018;79999;10400;54890;254272;9706;400581;92521;8533;22905;729288;5598;218;23164;83450;224;51168;80039;51655;201163;7156;51030;5636;644815;10750;4239;10517;654346;10743;388436;27077;140775;6470;146691;1819;6720;125206;23495;147166;7732;146802;91647;56953;645027;3996;201164,51,1.51313490102021000000
chr16,88335976,89603390,1267414,-1,1,863;353;197322;2588;115992;4597;146429;124245;197320;6687;100287036;27189;1013;1535;51693;333929;100129697;161882;348180;9780;84627;81620;390748;29123,24,1.89361960653741000000
chr15,23739358,28119374,4380016,-1,1,2562;7681;23742;7337;6638;2567;4948;8926;57194;54551;4692;2558,12,0.27397160193022100000
chr13,34957072,65732539,30775467,-1,1,51569;729240;79612;2862;89890;26586;8900;9724;283518;144809;57213;22862;26960;341676;7178;55578;64881;29880;220108;84078;4081;55213;10206;3839;55068;23143;55425;11340;115761;540;23111;729233;9201;11215;51131;79758;10631;8803;8848;3356;29079;4752;10910;10161;386618;84650;728591;122011;23078;28984;5925;7223;11061;341640;9617;5994;647174;26747;51028;27253;81550;107303344;83852;100526761;144811;10562;144983;2308;387921;79621;161003;83446;729250;81624;1997;57105;1102;5100;400120;2098;2963;26512;4093;729246;10186;10166;122183;115825;81602;94240;10240;253512;1361;220107;81617;220082;29103;57511;220081;160857;387923;283514;440138;55901;11193;160851;220416;80209;55270;3936;79024;9445;8600;23091;83548;80183;54937,117,0.38017294749743400000
chr18,61916672,78077248,16160576,-1,1,125704;54495;28513;147381;1528;55628;201456;79863;400658;4772;25914;84735;644041;9306;9658;4155;27164;440498;81832;1005;26251;80148;92126;9150;10194;220158;284273;79839;22850;10666;84552;55748;374868;29090;10907;284274;7776;220164;2587,39,0.24132803187213100000
chr18,1,14081857,14081856,-1,1,116;55556;10403;23255;57132;4158;8774;645369;84203;125228;57045;103910;642597;84617;9097;7525;147495;10650;9218;3613;5797;494514;1149;56984;5771;10939;1068;65258;79959;9229;79822;84034;4729;7298;91133;11031;23253;9663;56907;9989;7050;339291;81929;4161;9984;81035;10928;2774;23347;63895;10627;8731;201475;64863;8736;342850;27098;284217;646000;753;23136;7541;55125,63,0.44738420844525000000
chr22,26980074,30016888,3036814,-1,1,4330;284898;150274;105372977;1413;25807;10634;150275;162;2130;8563;4744;11200;129080;4771;8459;83999;84133;8508;7494;23760;25770;10633;1414;23331;5988,26,0.85616043656279300000
chr2,157141280,157315748,174468,-1,1,4929;2820,2,1.14634202260586000000
chr22,26166280,29537992,3371712,-1,1,23544;284898;105372977;4330;150274;57168;1413;24144;150275;84700;11200;402055;8459;84133;83999;7494;23760;25770;1414;23331;89781,21,0.62282899607083900000
chr19,213080,1322552,1109472,-1,1,566;610;51298;400668;126567;1943;1265;8612;997;91304;1153;3004;10347;55009;54531;116444;5657;1991;91300;84634;55658;91978;10272;1820;25759;22904;1675;284451;90007;6794;682;8174;255057;5064;57418;27006;79948;23526;513;5442;126353;5434;5725;10025;2879,45,4.05598338669205000000
chr16,29567295,30177999,610704,-1,1,653808;5531;26470;283897;253980;146378;8479;83719;23475;283899;124446;9344;3835;4150;226;253982;83723;5595;6911;8448;79447;112476;9961;10423;6693;79153,26,4.25738164479028000000
chr15,23620191,28560803,4940612,-1,1,2562;7681;23742;8924;7337;6638;2567;4948;8926;57194;283685;54551;4692;2558,14,0.28336570449167000000
chr22,18919942,20311763,1391821,-1,1,54487;27037;5413;29801;65078;23617;10587;1312;7122;421;7290;128977;8220;2812;388849;7353;2928;128989;6899;9993;54584;5625;79680;85359;64976;8318;5902;6576;8218,29,2.08360126769175000000
chr1,145899368,147824177,1924809,-1,1,9557;51205;51463;2703;5565;607;2702;2330;200030;149013,10,0.51953206785712200000
chr18,64316333,78012829,13696496,-1,1,125704;54495;147381;1528;55628;201456;79863;400658;4772;25914;84735;644041;9306;9658;4155;27164;440498;81832;26251;80148;92126;9150;10194;220158;284273;79839;22850;10666;84552;55748;374868;29090;10907;284274;7776;220164;2587,37,0.27014208597585800000
chr10,81273507,89047672,7774165,-1,1,657;84332;80195;10718;643161;387695;143241;729262;6441;54462;84293;10974;728118;729238;27069;23063;54537;81619;5995;387694;79812;2746;119385;26103;4143;219348;6623;92211;143244;653509;94233;2894;340745;11155;311,35,0.45020912213723300000
chr17,29084332,30326958,1242626,-1,1,79915;79736;55352;55813;2124;84440;2123;55803;4974;4763;23512;84282;51379,13,1.04617157535735000000
chr7,72726578,74139390,1412812,-1,1,5982;51085;9275;84277;7462;135886;83451;1364;135892;6804;7461;155382;3984;26608;8468;9031;155368;2969;8326;7458;9569;2006;1365;114049,24,1.69873981817821000000
chr5,51714304,58778222,7063918,-1,1,115827;4338;10769;3672;4724;8611;493869;112574;11082;3003;54622;5144;53918;65056;345651;8988;3673;133396;54514;153129;10468;79722;10309;202309;4214;166979;3001;54505;3572;133383;345643;101928448;23517;166968,34,0.48131929051271500000
chr3,109748316,119344163,9595847,-1,1,10225;151887;7634;55254;201633;205717;257144;8702;131450;80218;941;523;79691;2596;79669;55779;152404;257068;254887;29114;56983;57514;285335;90102;4345;64422;79413;25945;91653;1814;51365;4045;152405;152185;54847;54762;344805;55347;7348;141;151888;57577;25871;26137;55032;29083;51300;344807,48,0.50021639569701300000
chr3,24516600,33539563,9022963,-1,1,25827;344787;9497;201595;7155;54918;152100;131405;116135;8320;27303;51143;25904;643853;26032;112616;152110;23122;114884;10491;5915;54995;64343;152098;55768;7048;23171;2720;7068;7342;339896;152189;1233,33,0.36573351791423700000
chr13,68377788,83877985,15500197,-1,1,7347;115207;64062;22894;4008;1203;23077;1602;122060;440145;57626;26224;5457;730249;8796;79866;1910;11278;729420;170622;100129307;688;54602;10464;79596;10253;9882,27,0.17419133447142600000
chr18,14316,704574,690258,-1,1,55556;494514;1068;27098;9984;9097;7298;81035,8,1.15898692952490000000
chr21,15412671,28315834,12903163,-1,1,140578;54148;54149;11096;9510;64092;58494;6782;4685;149998;8204;10950;54033;29761;351;116159;5651;522;388813;2551;1525,21,0.16275079218948100000
chr15,22784523,23179948,395425,-1,1,123606;23191;114791;81614,4,1.01156982992982000000
chr1,244945734,245280086,334352,-1,1,116228;3192;84288,3,0.89725797961429900000
chr11,30504467,36571916,6067449,-1,1,79832;341019;966;4005;5080;7189;51074;4076;847;25758;91614;25891;1479;55226;6506;5954;25841;744;29099;55346;960;493860;24147;7490;143458;196294;26273;79899;8050;26610;79056;26298;10114;100131378;54765;120526;10480;2001,38,0.62629286212376900000
chr2,217860965,242783384,24922419,-1,1,130617;10290;54658;79853;1285;84289;3623;53632;6694;84812;79065;7857;130916;10316;93010;8576;79083;1412;23363;54579;150681;54578;27148;25953;57140;25992;248;55230;9208;3635;54657;64320;2637;64114;3667;389090;23192;5270;5757;7277;81618;54738;56918;3069;10494;117581;54575;285193;1146;25791;130340;80326;65080;29926;23677;5510;377007;255101;84236;9654;1593;4705;150677;151473;1286;14;23549;4759;646960;150678;140739;2817;4735;100996693;401036;3549;339766;547;55054;116987;79919;8527;7145;23704;3769;375316;79137;54600;6508;3579;116255;27013;130888;389075;666;79586;130367;5077;9125;653437;151306;151295;389084;728294;151176;4880;64090;6364;8452;79411;339768;64708;26058;10109;3267;114790;2859;130612;64284;5798;57590;10267;6556;414061;9759;1674;1144;9470;129563;189;51078;617;55619;79781;7429;6295;2181;285180;54659;11132;10056;55139;2043;50636;54577;55502;54576;93349;51719;250;9290;8864;26146;5147;79840;80303;80309;5707;1293;23178;80895;3357;165100;79843;8941;3431;3300;10920;10123;9427;80704;51665;257407;57007;129807;1841;55515;57695;92737;4691;7701;130560;51540;200765;56947;375318;3577;55022;251;51052;10058;164781;6672;58190;55355;79054;375307;80210;57624;51281;7475;11262;151278;9320;9855,205,0.82255257806234600000
chr6,164617352,170919482,6302130,-1,1,168002;10846;387263;55274;55780;285800;2853;4301;113402;5134;401285;3834;5689;54346;253769;100128124;168090;79981;7058;83887;6991;6196;8635;28514;84498;6953;6862;51660;64094;1235;11116;6908,32,0.50776483506370100000
chr22,18894835,21464119,2569284,-1,1,54487;27037;9342;29801;65078;10587;1312;6545;8214;421;7290;2812;6899;5625;7625;79680;64976;6576;3053;8218;5413;80764;23617;400891;1399;7122;150209;128977;8220;388849;84861;7353;51586;2928;128989;5297;9127;9993;54584;91179;85376;8216;85359;8318;728229;5902,46,1.79038206753321000000
chr22,18919942,21798755,2878813,-1,1,54487;27037;9342;29801;65078;10587;1312;6545;421;7290;2812;6899;5625;7625;79680;23119;64976;6576;3053;8218;5413;80764;23617;400891;1399;7122;150209;128977;8220;388849;84861;7353;51586;2928;128989;5297;9127;9993;54584;91179;85376;8216;440804;85359;8318;728229;5902,47,1.63261733221296000000
chr1,170104367,177328801,7224434,-1,1,9588;149281;9674;51603;27101;356;92346;2328;91687;7292;460;730159;64326;63923;80133;339416;8674;462;51430;5396;57795;23215;92344;63931;27252;5279;149041;26052;2329;2326;2327;9293;4653;60676;84614;284525;7143;55157;9910;8995,40,0.55367659251922000000
chr2,192822474,213829688,21007214,-1,1,1493;9262;130749;56171;54891;3417;57683;51602;10314;130540;53938;129450;57404;26010;65065;389072;57679;8828;66037;4709;5334;151050;23451;79800;151195;8324;200576;2066;2825;92935;23314;66008;117583;57520;1419;1933;1373;151246;8609;55437;659;29851;9689;130535;3329;1385;200726;6120;23671;130132;940;843;8837;391475;285172;60491;80219;151194;55759;91526;4719;1421;130026;3336;79568;316;4632;100652824;58538;1195;65062;33;389073;65061;57181;205327;150864;100529241;65059;151254;1418;285175;10152;130752;9330;80055;5746;841;7855;4133;401027;8745;7341;22868;25843;4999;1420;284992,98,0.46650641060732800000
chr1,244464118,245441279,977161,-1,1,55083;116228;257044;200159;3192;159;84288;51029,8,0.81869824931613100000
chr15,22784523,23179948,395425,-1,1,123606;23191;114791;81614,4,1.01156982992982000000
chr16,29673954,30198600,524646,-1,1,653808;5531;26470;283897;253980;146378;8479;83719;23475;283899;124446;9344;3835;4150;226;253982;83723;5595;6911;11151;8448;79447;112476;9961;10423;6693;79153,27,5.14632723779463000000
chr10,68211551,68443894,232343,-1,1,29119,1,0.43039816133905500000
chr22,41999974,51203704,9203730,-1,1,11252;150383;85378;79879;25771;79019;23151;23774;80305;115650;55267;25813;1727;6942;79174;79640;150379;55007;1375;4668;415116;55964;83642;23542;553158;84271;164684;7380;6300;10343;83933;91689;1565;79924;23313;2547;27351;4809;84247;440829;6305;51512;1890;53947;25830;23654;25817;29781;91289;26286;26150;85358;64800;27341;410;400935;706;2192;9701;80274;56666;5600;27127;6721;49;9889;414918;758;25809;150368;9997;9620;1120;440836;4700;267020;150365;5465;64781;112885;150372;29780;644186;23170;23779;23209;253190;7477;64098;25814;80339;79087;10762;55020;27349;55687;638;348645;85352;55615;113730;55586;54456,103,1.11911149066737000000
chr4,169088100,179139609,10051509,-1,1,54969;55601;11086;11341;116966;1182;175;91351;140458;23022;84869;4750;442117;60559;3148;51166;55247;51809;11199;57630;132851;3248;9464;26269;8819;9848;8001;7424;80817;2823,30,0.29846264874259200000
chr15,31972646,32510863,538217,-1,1,161725;1139,2,0.37159732970158900000
chr15,31972646,32510863,538217,-1,1,161725;1139,2,0.37159732970158900000
chr22,46204739,51219009,5014270,-1,1,85358;150383;410;400935;85378;9701;56666;5600;49;25771;23151;23774;9889;80305;11158;414918;55267;79174;9997;9620;1120;440836;64781;5465;1375;415116;83642;23542;644186;23209;6300;10343;83933;79924;7477;25814;79087;55020;55687;6305;51512;1890;348645;23654;25817;113730;29781;55586;91289;54456,50,0.99715412213542500000
chr17,14090300,15491748,1401448,-1,1,1352;64518;9953;201158;284040;100533496;5376;374286;146822,9,0.64219293188188200000
chr22,50901467,51178405,276938,-1,1,23542;85358;644186;410;79924;49;6305;1890;113730;9997;29781;55586;91289;440836;1120;1375,16,5.77746643653092000000
chr10,131122271,135403591,4281320,-1,1,118472;10844;80313;256536;253738;85442;3632;27287;8433;93426;282973;282974;50632;92170;10570;84504;664;282969;118471;170394;196743;55844;54777;503542;101;1892;1571;4255;84435;10539,30,0.70071847000457800000
chr15,23707494,28525454,4817960,-1,1,2562;7681;23742;8924;7337;6638;2567;4948;8926;57194;54551;4692;2558,13,0.26982374282891500000
chr7,8764526,21091678,12327152,-1,1,30010;2115;392636;27075;222894;25928;256130;340273;4223;100506049;221830;221833;346389;4697;729920;196;54664;1607;28969;9678;155465;85477;10551;10124;57037;221823;7291;23161;221981;9734;221806;3696,32,0.25958956294203200000
chr22,21798705,23603489,1804784,-1,1,7332;23753;5594;7441;2781;100423062;613;8940;23532;129025;645426;29799;91227;140883;23759;150223;9647;27156;150221;23119;9609;164592,22,1.21898243778757000000
chr22,18919942,21440514,2520572,-1,1,54487;27037;9342;29801;65078;10587;1312;6545;421;7290;2812;6899;5625;7625;79680;64976;6576;3053;8218;5413;80764;23617;400891;1399;7122;150209;128977;8220;388849;84861;7353;51586;2928;128989;5297;9127;9993;54584;91179;85376;8216;85359;8318;728229;5902,45,1.78530904889842000000
chr13,86192962,111165148,24972186,-1,1,160897;2259;11166;55757;337867;2841;22873;23026;84899;259232;10160;84945;1880;79070;728215;1284;643677;8428;7174;23348;7546;10673;5911;8660;26050;9358;9375;9071;54841;196541;10150;84189;171425;87769;27199;266722;3843;10082;140432;23483;6564;93081;5611;2073;55082;5095;1282;10257;100129836;1638;85416;1948;3981;2262;100533467;6555;267012,57,0.22825394621039600000
chr2,200040072,200373511,333439,-1,1,23314,1,0.29990493013714700000
chr22,18894835,21505417,2610582,-1,1,54487;27037;9342;29801;65078;10587;1312;6545;8214;421;7290;2812;6899;5625;7625;79680;64976;6576;3053;8218;5413;80764;23617;400891;1399;7122;150209;128977;8220;388849;84861;7353;51586;2928;128989;5297;9127;9993;54584;91179;85376;8216;85359;8318;728229;5902,46,1.76205918833425000000
chr19,277373,1018631,741258,-1,1,566;610;51298;400668;126567;8612;997;91304;3004;54531;116444;5657;1991;91300;84634;55658;91978;10272;1820;25759;1675;284451;682;8174;5064;57418;27006;79948;5442;126353;5725;10025,32,4.31698544906092000000
chr21,39580621,48056450,8475829,-1,1,386672;5211;4599;5316;54084;106865373;56894;6285;3689;8209;1409;54101;1826;386679;7485;386676;386680;386681;326;53347;5121;5152;1476;150082;3772;3275;54059;10317;1292;5116;84221;29947;64699;11077;6612;63977;3150;755;8566;1291;7307;7113;875;54014;7032;150094;85395;386685;353323;8624;7031;7109;386674;386675;386683;8568;4731;6450;23076;6573;2114;104;353332;5822;4047;4600;54039;54058;7033;386677;89765;353333;23181;25825;23275;2078;90625;49854;23308;754;89766;386678;8888;25966;54020;80781;386684;7327;9619;10785;386682;54097;10841;81543;7226;150084,96,1.13263257198794000000
chr2,236959860,242852625,5892765,-1,1,151176;64090;84289;10920;377007;5510;285093;51665;339768;4705;57007;150677;1841;129807;2859;130916;64284;150678;10267;140739;2817;4735;79083;401036;51540;9855;9759;150681;375318;189;51078;547;116987;79781;79919;57140;25992;51052;9208;375316;2637;11132;389090;23192;80895;55502;3069;10494;117581;51281;285193;666;8864;26146;23178;50636;653437;1293;5133;728294,60,1.01819773909192000000
chr22,8388703,51208042,42819339,-1,1,23481;200315;150383;3005;24144;129049;7533;91582;100423062;4733;2130;400916;7078;80831;55670;64976;6942;79174;6576;3985;83733;415116;6634;11144;29775;8218;23753;23542;158;57168;550631;23598;8542;84271;7621;83933;79924;91689;27351;5297;440822;2928;129080;140883;440829;150350;51512;1890;23654;25817;8318;57026;91289;728229;113828;5155;5905;26150;171568;4320;27440;85358;4627;23543;3957;80274;23764;51493;9681;150223;653689;4282;150368;11274;1120;440836;23539;5465;80830;23762;150372;9929;25793;50;27350;25829;63929;2781;162;253143;79087;84861;7353;51807;8398;638;8508;51733;11015;9993;85376;440804;4151;5816;5880;91319;7332;85379;284898;150274;9342;65078;80833;150275;1417;1312;6545;468;129025;23151;129138;83999;8459;8484;10766;1727;150379;56993;1375;1415;164668;105372977;5413;80764;22880;7441;102800317;7380;66035;150209;2547;128977;128989;113791;79734;150221;91179;3560;53947;83606;8664;23264;27254;56241;5008;10042;5988;57553;27037;4330;23466;2847;27341;51386;706;1454;5600;652968;254240;284904;7263;27127;26088;60489;84645;150356;645426;9889;414918;79680;23760;10454;9620;150165;81061;64781;9609;644186;11020;10634;23779;23209;400891;84700;9582;388849;51586;9127;23765;83874;348645;9814;55615;57591;135;6598;23551;10291;23786;25777;10126;1413;23616;613;391322;23541;114904;4357;91227;402055;6948;51537;115650;2033;55267;25813;25776;23784;27352;2687;10478;4668;164592;730005;200312;83642;6767;5594;646851;9978;23617;25807;3543;164684;6527;3976;2952;7122;1565;8563;4744;84844;4809;84247;6305;54584;2678;25830;6523;1652;9402;26286;23523;7008;6525;140606;79159;400935;23492;2192;6753;8897;10587;80832;1439;7290;54471;6721;150280;49;2812;150248;23759;9647;758;5625;55954;85377;10521;4700;23331;3053;150290;164656;4689;255349;8224;80020;1399;4174;29796;3956;253190;64098;3761;11200;55020;266747;7494;10738;85352;85359;164633;10369;10633;9215;55586;80115;23761;5902;11252;23544;9145;27128;85378;79879;51816;23780;8214;421;25771;79019;10739;23774;80305;4242;11158;157;150160;27439;7625;23119;529;29802;23464;79640;91464;55007;50487;55964;553158;23467;84164;114794;6300;11135;9463;83746;10343;10043;8940;23313;11078;23384;29781;27124;1414;388886;5372;101929372;89781;25775;54487;64800;410;4248;29801;9567;9701;56666;91445;23532;150297;6663;29799;91355;140564;6899;27156;25809;8911;27443;637;3162;9997;25770;100037417;150365;200316;267020;112885;339665;339669;29780;266629;23170;150353;7477;25814;80339;10762;8220;27349;56478;55687;25828;4771;84133;6122;8216;51233;113730;9514;128954;23112;5435;54456,427,0.99721296491755800000
chr2,235904758,242852625,6947867,-1,1,151176;64090;23677;84289;10920;377007;5510;285093;51665;339768;4705;57007;150677;1841;129807;2859;130916;64284;150678;10267;140739;2817;4735;79083;401036;51540;9855;9759;150681;375318;189;51078;547;116987;79781;79919;57140;25992;51052;9208;375316;2637;11132;389090;23192;80895;55502;3069;10494;117581;51281;285193;666;8864;26146;23178;50636;653437;1293;5133;728294,61,0.87796729557431100000
chr22,46204739,51219009,5014270,-1,1,85358;150383;410;400935;85378;9701;56666;5600;49;25771;23151;23774;9889;80305;11158;414918;55267;79174;9997;9620;1120;440836;64781;5465;1375;415116;83642;23542;644186;23209;6300;10343;83933;79924;7477;25814;79087;55020;55687;6305;51512;1890;348645;23654;25817;113730;29781;55586;91289;54456,50,0.99715412213542500000
chr4,71552,919291,847739,-1,1,10815;10336;2580;7700;5158;170960;521;84179;4636;152687;654254;54872;255403,13,1.53349085036786000000
chr19,3714942,4863944,1149002,-1,1,126259;51341;100131094;5605;4145;1613;55620;9546;10226;84839;80700;10036;116541;91039;84954;79187;56005;51548;440503;1938;116844;10501;27134;56961;6455;170961;55527;84699;27231;729359;126282;84717;23217;10148;55702;85300;51588;148022,38,3.30721791606977000000
chr17,66950710,67538052,587342,-1,1,23461;10349;23460;10351;5608;10350,6,1.02155132784647000000
chr22,48654563,51178264,2523701,-1,1,85358;410;400935;85378;9701;56666;5600;49;9889;23774;80305;414918;79174;9997;1120;440836;1375;415116;83642;23542;644186;23209;6300;83933;79924;79087;6305;1890;348645;23654;25817;113730;29781;55586;91289;54456,36,1.42647643282623000000
chr16,29674336,30199351,525015,-1,1,653808;5531;26470;283897;253980;146378;8479;83719;23475;283899;124446;9344;3835;4150;226;253982;83723;5595;6911;11151;8448;79447;112476;9961;10423;6693;79153,27,5.14271020827976000000
chr2,77946629,87325331,9378702,-1,1,56888;129303;8673;83439;388969;51255;84173;130120;9168;100526767;5968;10618;10713;347730;65055;51652;25885;54884;284948;5967;925;5343;129293;400966;2677;51318;10791;926;55818;5068;822;10989;7844;84913;64795;1496;8802;8869;4144;10578;55037;6439;1768,43,0.45848561986509400000
chr11,122026758,129256036,7229278,-1,1,219874;53340;63970;9743;84623;26595;219873;56253;403312;219870;219875;55572;399967;56;79607;390261;3758;26493;9638;83480;114609;79684;641654;84881;55800;90952;219858;219833;63876;100169851;283162;283160;390259;390271;4900;64221;220296;390265;1111;219844;50937;28960;79864;219854;390275;7753;2313;57476;219869;4013;23584;390260;84897;79827;54414;219865;283159;116337;399968;26492;6484;8538;54538;9538;29118;3312;390264;6734;84959;3762;2113;338662;3703;219855;80071;160065;338661,77,1.06511327963871000000
chr2,50725729,51260612,534883,-1,1,9378,1,0.18695677372434700000
chr8,7753524,11841901,4088377,-1,1,1508;83650;83595;203076;2626;83648;613210;137075;1673;613209;157285;640;66036;252969;286046;100132396;79660;54984;2222;392188;4482;8658;203074;9258;90459;94137;645836,27,0.66040876367321300000
chr8,118816775,118894264,77489,-1,1,2131,1,1.29050574920311000000
chr7,150911408,159128529,8217121,-1,1,54480;58508;140545;5799;1804;389602;22976;6009;57180;6469;3110;168391;2020;3638;51667;51422;349136;63917;155051;155435;3361;64327;64434;10061;9690;55112;6604;7516;7434;285888;54892;10049;57488,33,0.40160051190678600000
chr16,76180903,82314260,6133357,-1,1,2653;283927;124359;3294;93517;56942;57687;123775;23300;85445;4094;51741;10143;100130958;170692;80790;10200;5336;83657;22879;55839;8139;53630;114780,24,0.39130283790752800000
chr9,90781756,97476204,6694448,-1,1,158293;1903;4814;445577;84270;23299;56033;54754;4958;3376;79048;84641;6850;55035;4969;10507;158046;54769;4920;53358;1164;1842;169841;89846;64768;4783;8789;83744;10558;138639;286223;10927;65268;549;401541;54829;203328;2203;23196;5253;10912,41,0.61244780749660000000
chr13,75178928,85044248,9865320,-1,1,7347;115207;114798;64062;4008;1203;23077;122060;26224;5457;730249;8796;1910;729420;170622;100129307;54602;79596;10253;9882,20,0.20273037265897100000
chr22,18919942,20992700,2072758,-1,1,54487;27037;29801;65078;10587;1312;421;7290;2812;6899;5625;7625;79680;64976;6576;8218;5413;23617;7122;128977;8220;388849;84861;7353;51586;2928;128989;9993;54584;91179;85376;85359;8318;728229;5902,35,1.68857145889679000000
chr19,12433780,13419259,985479,-1,1,773;9592;79973;10661;439;4125;163050;51398;84292;10224;55621;1777;2193;811;256126;22983;10535;7001;84261;147837;4066;90480;57474;8677;1725;5886;4784;90576;199699;83546;105372280;3726;112939;54831;29911;30000;2639;163049;79002;163051,40,4.05893986579115000000
chr3,1337273,2113702,776429,-1,1,27255,1,0.12879477711419800000
chr15,31014508,32510863,1496355,-1,1,161725;283710;54893;51621;4308;22909;1139,7,0.46780342899913500000
chr16,88697738,89363602,665864,-1,1,353;863;197322;2588;115992;4597;146429;124245;197320;27189;1013;1535;333929;51693;100129697;348180;9780;390748;81620;29123,20,3.00361635409032000000
chr1,852863,6586972,5734109,-1,1,57470;388588;1677;85452;83858;6146;5590;127262;728661;199990;23463;9636;100287898;8510;64856;26155;140625;55229;8764;65220;339456;261734;375790;388581;148398;401934;57449;643965;51150;8784;2782;9651;1855;9731;27237;57801;387509;26038;126789;81669;29101;6497;339453;643988;7161;126792;8718;388591;83715;219293;163688;84808;11332;388585;63976;54626;6339;11079;80772;55052;254173;79258;984;54587;8514;5192;54973;339448;84069;54998;9906;148870;116983;339451;390992;55966;7293;118424;728642;127281;2563;55210;54991;83756;142678;441869;79707;1953;79906;49856,90,1.56955509565654000000
chr5,174961216,178038146,3076930,-1,1,51428;51491;6620;202134;6569;91522;9260;10636;53917;23138;3182;27166;285596;1212;23197;375484;3274;57179;54825;84321;90249;10960;64777;26262;51720;3101;23567;80758;11285;54540;2264;345456;54732;79930;22838;192286;285598;85007;2870;5626;55651;1627;57396;83463;10814;64324;114787;2161;253314,49,1.59249641688306000000
chr7,72726578,74139390,1412812,-1,1,5982;51085;9275;84277;7462;135886;83451;1364;135892;6804;7461;155382;3984;26608;8468;9031;155368;2969;8326;7458;9569;2006;1365;114049,24,1.69873981817821000000
chr15,85152748,85871205,718457,-1,1,23478;57538;9154;5151;4828;100133220;54993;9640;84942,9,1.25268457263274000000
chr1,145413388,145747269,333881,-1,1,148738;128077;10401;200035;27246;84265;284615;9939;11126;8515;148741;10628;10623;8799;5174,15,4.49261862759486000000
chr9,2924712,18467006,15542294,-1,1,10171;23081;55664;89882;9350;50808;158358;6619;203238;5789;6019;54796;286343;158326;169792;55064;6505;29126;2315;4781;11168;5991;100129385;8777;6456;340481;26953;90865;3717;90871;54875;6013;57589;3641;7306;403313;158219;115426;79956;2731;55848;11172;80380,43,0.27666443576475900000
chr15,22784523,23179948,395425,-1,1,123606;23191;114791;81614,4,1.01156982992982000000
chr15,22784523,23179948,395425,-1,1,123606;23191;114791;81614,4,1.01156982992982000000
chr16,15048751,16249607,1200856,-1,1,4629;100288332;123811;89927;4363;54820;368;255027;23042;54700;123803;9665,12,0.99928717514839400000
chrX,30162186,31375215,1213029,-1,1,4113;80231;257397;190;4115;4112;53940;1756;2710;4114,10,0.82438259926184800000
chr16,29673954,30198600,524646,-1,1,653808;5531;26470;283897;253980;146378;8479;83719;23475;283899;124446;9344;3835;4150;226;253982;83723;5595;6911;11151;8448;79447;112476;9961;10423;6693;79153,27,5.14632723779463000000
chr16,29673954,30119759,445805,-1,1,653808;5531;26470;283897;253980;146378;8479;83719;23475;283899;124446;9344;3835;4150;226;253982;83723;6911;8448;79447;112476;9961;10423;6693;79153,25,5.60783302116396000000
chr17,16822683,20193169,3370486,-1,1,2314;55244;125170;55090;11216;79018;79999;10400;54890;254272;9706;400581;92521;8533;22905;729288;5598;218;23164;83450;224;51168;80039;51655;201163;7156;51030;5636;644815;10750;4239;10517;654346;10743;388436;27077;140775;6470;146691;1819;6720;125206;23495;147166;7732;146802;91647;56953;645027;3996;201164,51,1.51313490102021000000
chr17,43717703,44159862,442159,-1,1,246744;162540;104909134;1394;4137;284058,6,1.35697791970762000000
chr3,195777965,197280451,1502486,-1,1,622;255798;80235;200933;5062;5130;4241;26043;1739;84984;348793;255758;116211;131540;200931;375387;22916;7037;165918;54965;205564,21,1.39768357242597000000
chr22,50313804,51178264,864460,-1,1,83642;23542;85358;644186;410;400935;85378;9701;56666;5600;23209;6300;83933;79924;49;80305;6305;414918;1890;23654;54456;79174;9997;113730;1120;440836;29781;55586;91289;1375;415116,31,3.58605372139833000000
chr7,72726578,74139390,1412812,-1,1,5982;51085;9275;84277;7462;135886;83451;1364;135892;6804;7461;155382;3984;26608;8468;9031;155368;2969;8326;7458;9569;2006;1365;114049,24,1.69873981817821000000
chr5,175890496,177383832,1493336,-1,1,3101;64324;51428;6620;23567;80758;11285;54540;2264;6569;345456;54732;79930;9260;10636;53917;22838;27166;285596;2870;23197;1627;51720;83463;54825;90249;10960;114787;26262;2161;253314,31,2.07588915019795000000
chr10,22262334,29065580,6803246,-1,1,64215;5305;57512;53904;56243;84930;54518;256297;283078;55130;22921;219681;25805;648;57584;23412;10730;143098;51322;256815;91452;374308;2572;220213;23590;22852;100532731;10006;9576;22931;56952;79896;340900;219670,34,0.49976143740796700000
chr2,1,1668446,1668445,-1,1,7837;642273;7173;54221;26751;285016;129787;52,8,0.47948838589225300000
chr16,28837390,29042178,204788,-1,1,11273;27040;79874;7284;930;84901;487;83985;25970,9,4.39478875715374000000
chr1,224576449,227071152,2494703,-1,1,64746;29920;83881;55740;3707;286826;375057;2052;163859;3930;7044;149111;142;6726;80232;127602;9725;10637;3020;5664,20,0.80169863907647500000
chr1,146564743,147735011,1170268,-1,1,9557;51205;51463;5565;607;2702;2330;200030;2703,9,0.76905460971333100000
chr1,243308051,249212668,5904617,-1,1,127077;25909;200159;127069;84288;51029;81469;391196;55083;127623;343173;127064;26246;391189;79894;441932;401993;10472;57116;80851;79862;267002;343563;317705;391195;26245;114548;26188;159;284521;163882;391211;343169;84838;391194;3192;93474;127074;81472;127066;388759;127068;646627;343172;25893;391190;441933;403244;7678;284532;10000;26696;55657;391191;64754;81466;127059;127062;10806;401992;343171;254879;116228;257044;9859;81470;148823;64216;403239;401994;391192;51097,72,1.21938476280511000000
chr1,242404099,249212668,6808569,-1,1,127077;25909;200150;200159;127069;84288;51029;81469;391196;55083;127623;343173;127064;26246;391189;79894;441932;401993;10472;57116;80851;79862;267002;343563;317705;391195;26245;114548;26188;159;284521;163882;391211;343169;84838;391194;3192;93474;127074;81472;127066;388759;127068;646627;343172;25893;391190;441933;403244;7678;284532;10000;26696;55657;391191;64754;81466;127059;127062;10806;401992;343171;254879;116228;257044;9859;81470;148823;64216;403239;401994;391192;51097,73,1.07217830942155000000
chr15,23699701,28525460,4825759,-1,1,2562;7681;23742;8924;7337;6638;2567;4948;8926;57194;54551;4692;2558,13,0.26938767559673000000
chr8,221611,6914076,6692465,-1,1,389610;9172;728358;1669;26260;1667;157697;64478;1671;9639;79648;1670;285;157695;9228;55326;9920;1672;1668;2055,20,0.29884355017172300000
chr17,64529223,65720329,1191106,-1,1,786;25926;5718;26207;5578;27091;27092;9931,8,0.67164467310214200000
chr1,1,2553982,2553981,-1,1,85452;83858;5590;728661;199990;9636;79501;8510;64856;26155;81399;55229;8764;65220;339456;375790;388581;148398;401934;643965;51150;8784;2782;9651;1855;57801;126789;81669;29101;339453;6497;643988;126792;219293;163688;84808;388585;6339;55052;254173;80772;11079;79258;984;54587;5192;54973;84069;54998;9906;116983;339451;7293;118424;728642;2563;127281;55210;54991;83756;142678;441869;729759;79906,64,2.50589178228029000000
chr7,72365957,74139390,1773433,-1,1,5982;378108;51085;9275;84277;7462;55695;135886;9883;83451;1364;135892;6804;7461;155382;3984;26608;8468;9031;155368;2969;8326;7458;9569;2006;1365;114049,27,1.52247082353830000000
chr2,174506070,181400740,6894670,-1,1,3235;1123;129831;344191;150737;3232;3238;51661;57703;3236;4780;3234;151126;494513;9541;518;80856;3237;10651;6670;100131390;92104;151556;3239;1386;114880;3233;29789;8540;220988;50940;79634;91404;3231;1134;8575;285025;65977;7273;7456,40,0.58015829619111600000
chr1,759762,4533747,3773985,-1,1,57470;388588;85452;1677;83858;5590;127262;728661;199990;9636;100287898;8510;64856;26155;140625;55229;8764;65220;339456;375790;388581;148398;401934;643965;51150;8784;2782;9651;1855;9731;27237;57801;126789;81669;29101;339453;6497;643988;7161;126792;219293;163688;84808;388585;63976;6339;55052;254173;80772;11079;79258;984;54587;5192;54973;84069;339448;54998;9906;148870;116983;339451;7293;118424;728642;2563;127281;55210;54991;83756;142678;441869;1953;79906;49856,75,1.98728929765222000000
chr1,146564743,149224043,2659300,-1,1,9557;728945;284565;644591;51205;645142;51463;5565;607;2702;730262;2330;200030;2703,14,0.52645433008686500000
chr2,232981279,243007359,10026080,-1,1,54658;151176;64090;84289;285093;339768;6694;26058;2859;130916;64284;10267;79083;414061;54579;150681;9759;189;129563;54578;1144;51078;9470;79781;57140;25992;248;55230;9208;3635;54657;2637;6295;54659;11132;389090;23192;50636;54577;55502;3069;10494;54576;117581;54575;285193;1146;25791;8864;26146;23178;80303;1293;80895;5133;23677;5510;377007;10920;10123;9427;51665;4705;57007;150677;129807;4759;1841;646960;150678;140739;2817;4735;9855;401036;51540;200765;375318;339766;547;55054;116987;79919;8527;251;3769;375316;51052;55355;79054;54600;51281;666;250;653437;389084;728294,97,0.96747682045226100000
chr22,18919942,21440514,2520572,-1,1,54487;27037;9342;29801;65078;10587;1312;6545;421;7290;2812;6899;5625;7625;79680;64976;6576;3053;8218;5413;80764;23617;400891;1399;7122;150209;128977;8220;388849;84861;7353;51586;2928;128989;5297;9127;9993;54584;91179;85376;8216;85359;8318;728229;5902,45,1.78530904889842000000
chr1,145413388,145747269,333881,-1,1,148738;128077;10401;200035;27246;84265;284615;9939;11126;8515;148741;10628;10623;8799;5174,15,4.49261862759486000000
chr1,146347096,147786706,1439610,-1,1,9557;51205;51463;2703;5565;607;2702;2330;200030;149013,10,0.69463257409993000000
chr6,158076922,170890108,12813186,-1,1,5340;387263;55274;39;55780;117289;4216;285800;2853;6580;79683;4301;113402;401285;3834;5689;3482;6582;253769;100128124;83887;8871;404672;51429;28514;5071;84498;6648;6950;56895;6862;51660;11116;168002;57583;10846;4142;84624;4018;9589;135138;6993;5134;9444;84947;100130967;6581;54346;79981;168090;7058;6991;94120;7430;6196;8635;64094;29074;1235;83861;6953;154197;56995;6908,64,0.49948545193990000000
chr16,29628661,30177999,549338,-1,1,653808;5531;26470;283897;253980;146378;8479;83719;23475;283899;124446;9344;3835;4150;226;253982;83723;5595;6911;8448;79447;112476;9961;10423;6693;79153,26,4.73296950147268000000
chr7,153055949,159118566,6062617,-1,1,155435;140545;3361;64327;5799;1804;64434;10049;9690;389602;22976;55112;6469;3110;7434;285888;54892;2020;3638;57488,20,0.32989054066915300000
chr10,65140184,66638200,1498016,-1,1,221035;221037,2,0.13350992245743700000
chr1,146564743,149192104,2627361,-1,1,9557;728945;284565;644591;51205;645142;51463;5565;607;2702;730262;2330;200030;2703,14,0.53285406915913000000
chr15,22784523,23179948,395425,-1,1,123606;23191;114791;81614,4,1.01156982992982000000
chr2,62385687,67091446,4705759,-1,1,4190;54812;29094;57162;5013;10097;7360;9792;200728;4211;200734;23301;5861;6509;23177;51542;51057;10678,18,0.38251002654407100000
chr2,176812232,186094608,9282376,-1,1,3235;129831;344191;4760;5136;150737;3232;3238;51661;57703;3236;129401;4780;3234;151126;494513;80856;3237;10651;10477;375298;92104;3239;114880;91752;3233;8540;220988;50940;6744;91404;3231;10787;151242;2487;54431;3676;8575;285025;65977;142679;7273,42,0.45247035888225200000
chr16,28837450,29042118,204668,-1,1,11273;27040;79874;7284;930;84901;487;83985;25970,9,4.39736548947564000000
chr15,22784523,23179948,395425,-1,1,123606;23191;114791;81614,4,1.01156982992982000000
chr22,18877787,21462353,2584566,-1,1,54487;27037;9342;29801;65078;10587;1312;6545;8214;7290;421;2812;6899;5625;7625;79680;64976;6576;3053;8218;5413;80764;23617;400891;1399;7122;150209;128977;8220;388849;84861;7353;51586;2928;128989;5297;9127;9993;54584;91179;85376;8216;85359;8318;728229;5902,46,1.77979591157664000000
chr2,221278232,223014332,1736100,-1,1,2043,1,0.05760036864235930000
chr2,221092287,222920847,1828560,-1,1,2043,1,0.05468784179901120000
chr6,19964281,22008341,2044060,-1,1,154141;54901;6659;1871,4,0.19568897194798600000
chr6,19974194,22013061,2038867,-1,1,154141;54901;6659;1871,4,0.19618739231151400000
chr6,19849280,21604600,1755320,-1,1,154141;54901;6659;1871,4,0.22787867739215600000
chr22,20754422,21440514,686092,-1,1,80764;9342;91179;8216;7625;400891;1399;84861;6545;150209;5297;51586;9127;3053,14,2.04054266774718000000
chr15,20575646,23179948,2604302,-1,1,727832;114791;100996331;123606;283694;81614;100287399;390538;23191;283767,10,0.38398004532500500000
chr16,29673954,30198600,524646,-1,1,653808;5531;26470;283897;253980;146378;8479;83719;23475;283899;124446;9344;3835;4150;226;253982;83723;5595;6911;11151;8448;79447;112476;9961;10423;6693;79153,27,5.14632723779463000000
chr15,32021733,32510863,489130,-1,1,161725;1139,2,0.40888925234600200000
chr16,28796368,29182200,385832,-1,1,11273;79874;7284;930;84901;27040;487;83985;25970,9,2.33262145182359000000
chr15,31014508,32510863,1496355,-1,1,161725;283710;54893;51621;4308;22909;1139,7,0.46780342899913500000
chr16,29673954,30198600,524646,-1,1,653808;5531;26470;283897;253980;146378;8479;83719;23475;283899;124446;9344;3835;4150;226;253982;83723;5595;6911;11151;8448;79447;112476;9961;10423;6693;79153,27,5.14632723779463000000
chr22,44599511,51066262,6466751,-1,1,150383;410;400935;85378;2192;56666;5600;9701;27127;25771;23151;23774;9889;80305;414918;55267;79174;9997;9620;1120;440836;55007;64781;5465;1375;112885;415116;83642;23542;553158;644186;7380;23779;23209;6300;10343;83933;79924;7477;64098;25814;23313;10762;79087;55020;84247;55687;6305;51512;1890;348645;55615;85352;23654;25817;113730;29781;55586;91289;54456;26150,61,0.94328666744706900000
chr10,148206,12211671,12063465,-1,1,22884;3698;83592;23560;91734;23185;3559;2625;8644;79746;1316;114131;51806;26019;54522;84893;80760;55176;11164;810;10276;254427;10659;105;1109;83860;10531;5214;10771;57713;79754;5209;3601;509;79861;5588;9712;84991;54906;22944;22982;55526;1646;2665;3422;1645,46,0.38131664492747300000
chr22,50357262,51219009,861747,-1,1,83642;23542;85358;644186;410;400935;85378;9701;56666;5600;23209;6300;83933;79924;49;80305;6305;11158;414918;1890;23654;54456;113730;9997;29781;1120;440836;55586;91289;1375;415116,31,3.59734353586377000000
chr3,187178783,191819880,4641097,-1,1,9076;131920;55214;152138;604;10686;3556;6750;647309;152137;8626;344892;4026;344901;285386;257313,16,0.34474608050639700000
chr5,88193292,88852795,659503,-1,1,4208,1,0.15162933299772700000
chrX,144580614,148757072,4176458,-1,1,84631;158521;84548;9142;728269;3423;100129239;100133053;101928917;100130086;2334;2332;91966,13,0.31126854382349800000
chr22,18916842,21800797,2883955,-1,1,54487;27037;9342;29801;65078;10587;1312;6545;421;7290;2812;6899;5625;7625;79680;23119;64976;6576;3053;8218;5413;80764;23617;400891;1399;7122;150209;128977;8220;388849;84861;7353;51586;2928;128989;5297;9127;9993;54584;91179;85376;8216;440804;85359;8318;728229;5902,47,1.62970642745813000000
chr6,162708065,170919482,8211417,-1,1,168002;10846;387263;55274;135138;55780;285800;2853;4301;113402;5134;9444;401285;3834;5689;54346;253769;100128124;168090;79981;7058;83887;6991;6196;11116;8635;28514;5071;84498;6862;51660;64094;1235;6953;6908,35,0.42623581289319500000
chr17,43648662,44212416,563754,-1,1,246744;162540;104909134;1394;4137;284058,6,1.06429400057472000000
chr17,43703801,44212416,508615,-1,1,246744;162540;104909134;1394;4137;284058,6,1.17967421330476000000
chr16,29673954,30198600,524646,-1,1,653808;5531;26470;283897;253980;146378;8479;83719;23475;283899;124446;9344;3835;4150;226;253982;83723;5595;6911;11151;8448;79447;112476;9961;10423;6693;79153,27,5.14632723779463000000
chr4,72320,3848756,3776436,-1,1,10336;7700;521;7469;401115;79155;4636;10417;84286;654254;345222;54872;1609;2261;255403;79441;4043;8602;7884;170960;57732;7468;152877;10296;3064;3083;285489;57654;353497;10460;285464;118;3954;10861;152;92305;285498;339983;10815;2580;53834;84179;5158;402160;3425;10608;6452;152687;1487;6047;54729;2868;6002;10227;8603,55,1.45639963182217000000
chr3,195684950,197317103,1632153,-1,1,622;255798;80235;200933;5062;5130;4241;26043;1739;84984;348793;255758;116211;131540;200931;375387;22916;7037;165918;54965;205564,21,1.28664408299957000000
chr12,86358388,91643585,5285197,-1,1,100528030;1848;160418;196477;4254;1833;91298;25834;160419;11081;80184;8693;4060;282809;1634;490,16,0.30273232956122500000
chr12,86358388,91643585,5285197,-1,1,100528030;1848;160418;196477;4254;1833;91298;25834;160419;11081;80184;8693;4060;282809;1634;490,16,0.30273232956122500000
chr3,69243110,72176814,2933704,-1,1,317649;23150;4286;2850;60675;27086,6,0.20451961070373800000
chr22,21798705,22916612,1117907,-1,1,7332;23753;5594;7441;8940;23532;129025;645426;29799;150221;140883;23759;150223;9647;23119;164592,16,1.43124606966411000000
chr15,23699701,28524460,4824759,-1,1,2562;7681;23742;8924;7337;6638;2567;4948;8926;57194;54551;4692;2558,13,0.26944351002816900000
chr17,43717703,44159862,442159,-1,1,246744;162540;104909134;1394;4137;284058,6,1.35697791970762000000
chr6,160710303,170919482,10209179,-1,1,168002;10846;5340;387263;55274;4018;135138;55780;4216;285800;2853;4301;113402;5134;9444;401285;3834;5689;6581;54346;253769;100128124;168090;79981;7058;83887;6991;6196;8635;28514;5071;6953;84498;56895;6862;51660;64094;1235;11116;6908,40,0.39180427730770500000
chr22,18919942,20311763,1391821,-1,1,54487;27037;5413;29801;65078;23617;10587;1312;7122;421;7290;128977;8220;2812;388849;7353;2928;128989;6899;9993;54584;5625;79680;85359;64976;8318;5902;6576;8218,29,2.08360126769175000000
chr13,110626209,115108385,4482176,-1,1,7027;55795;79587;79774;3916;8874;22821;55608;8858;55647;10426;1284;101928841;2621;400165;113622;65110;121793;283489;23263;55739;643365;55002;3621;1282;100129836;6656;23250;2155;2159;55208;496;6011;122258;348013;8881;8451,37,0.82549190393237600000
chr16,28503803,30190568,1686765,-1,1,552900;283897;83719;23475;283899;487;26471;445329;25970;226;253982;83723;11273;79874;6911;79447;112476;112869;728734;9961;83985;107282092;79153;653808;6799;5531;26470;8663;27040;253980;7284;146378;8479;124446;9344;3835;4150;246778;728888;100507607;55911;5595;79008;8448;930;84901;10423;6817;6693,49,2.90496897908126000000
chr6,94091098,107244162,13153064,-1,1,253714;639;100130890;84539;84816;6492;29078;51805;57531;2898;202;892;85015;10973;5454;25957;10690;59336;23376;84553;11149;9457;114792;389421;81491;2045;79694;5550;64208;9474;26235;55278,32,0.24328932026788600000
chr6,80938034,94091098,13153064,-1,1,4199;7162;84694;90025;57226;55122;22881;3354;135293;57150;60468;134701;4907;10492;2570;2569;167681;58528;154313;51167;9096;1268;55603;594;22832;25998;5238;206412;23036;1081;112611;51465;9994;23033;10957;81833;57231;57038;135295;2045;8732;112609;23595;9892;10559;23195;6885;375519,48,0.36493398040182900000
chr10,136391,1818132,1681741,-1,1,22982;105;22884;10771;3422;23560;91734;23185,8,0.47569750633421000000
chrX,31735863,31780185,44322,-1,1,1756,1,2.25621587473489000000
chr18,131700,5670657,5538957,-1,1,116;55556;10403;9663;103910;642597;7050;9984;9097;7525;81035;23347;10627;494514;64863;1068;8736;9229;27098;84034;23136;7298;7541,23,0.41524063104299200000
chr10,104752664,116131723,11379059,-1,1,3026;8036;840;159686;143187;153;54805;22986;114815;10285;79949;7511;22984;9126;4601;64429;55088;340706;4892;729020;6877;92482;9748;6934;9937;85450;150;1308;1847;9148;9446;80217;51703;119391;51063;255022;6975;84632;22978;119392;27250;9118;9644;282996;56165;374354;119395;120;79991;57678;84108;84833,52,0.45697979068392200000
chr18,59842079,77982126,18140047,-1,1,125704;54495;28513;147381;89778;1528;55628;201456;79863;400658;8792;8710;25914;644041;5275;84735;4772;9306;9658;5055;4155;27164;54877;81832;5268;440498;57614;89777;1005;26251;5273;80148;23556;23239;92126;9150;10194;596;220158;6317;6318;284273;284293;79839;22850;10666;84552;55748;374868;9525;5271;2531;10907;29090;284274;7776;220164;2587,58,0.31973456298101100000
chr17,43717703,44277006,559303,-1,1,246744;162540;104909134;1394;4137;284058,6,1.07276377920376000000
chr2,174091272,174103154,11882,-1,1,51776,1,8.41609156707625000000
chr2,50909765,51382872,473107,-1,1,9378,1,0.21136867558501600000
chr7,151716918,156484739,4767821,-1,1,155435;63917;58508;140545;3361;64327;1804;389602;22976;57180;7516;6469;285888;168391;2020;3638,16,0.33558306824018800000
chr17,29124299,30214286,1089987,-1,1,79915;79736;55352;55813;2124;84440;2123;55803;4974;4763;84282;51379,12,1.10093056155716000000
chr22,21798705,22916612,1117907,-1,1,7332;23753;5594;7441;8940;23532;129025;645426;29799;150221;140883;23759;150223;9647;23119;164592,16,1.43124606966411000000
chr8,113630232,116710527,3080295,-1,1,114788;7227,2,0.06492884610077930000
chr16,29673954,30198600,524646,-1,1,653808;5531;26470;283897;253980;146378;8479;83719;23475;283899;124446;9344;3835;4150;226;253982;83723;5595;6911;11151;8448;79447;112476;9961;10423;6693;79153,27,5.14632723779463000000
chr9,140164421,140954147,789726,-1,1,92715;54863;92714;774;441478;10811;54932;377841;25920;26012;79813;116225;375775;64975,14,1.77276675707777000000
chr2,163513067,168986256,5473189,-1,1,79809;6335;129446;6323;151258;90134;6328;27347;55137;6326;2591;6332;22837;2888;8708;80034,16,0.29233414011465700000
chr22,51122452,51178264,55812,-1,1,49;85358,2,3.58345875438974000000
chr17,43717703,44210822,493119,-1,1,246744;162540;104909134;1394;4137;284058,6,1.21674484252280000000
chr1,155583172,157014484,1431312,-1,1,54865;632;10763;128240;391104;128239;100527963;10485;79957;23208;55154;4000;51093;164118;54856;339403;63827;4209;149499;6746;7818;1382;92312;57127;22889;60484;64218;3068;7203;128229;9673;112770;79590;9826;11243;9047;23381;84283;5546;375033;28956;81875;57111;4914;3645;9181;56893;6016;55249,49,3.42343248711672000000
chr16,15404476,18306841,2902365,-1,1,4629;100288332;123811;64131;89927;4363;54820;408050;255027;101059938;368;9665,12,0.41345592301450700000
chr7,155356959,155672955,315996,-1,1,6469;155435,2,0.63291940404308900000
chr16,29673967,30190593,516626,-1,1,653808;5531;26470;283897;253980;146378;8479;83719;23475;283899;124446;9344;3835;4150;226;253982;83723;5595;6911;8448;79447;112476;9961;10423;6693;79153,26,5.03265418310344000000
chr18,5353538,10930924,5577386,-1,1,91133;11031;23253;23255;8774;645369;84203;9989;57045;339291;10928;63895;147495;9218;79822;5797;201475;284217;4729;23136,20,0.35859092413542800000
chrX,64182392,64450156,267764,-1,1,55906,1,0.37346319893637700000
chr8,22938085,32022342,9084257,-1,1,29942;2053;9583;7993;286133;8756;157574;54793;1191;55756;7486;55872;389643;1808;91782;2796;79618;619373;203069;81551;2961;10671;27299;51669;10863;10687;64641;157570;55140;4747;665;7976;4741;1135;55246;2137;5516;5520;148;23087;6781;5368;137814;55893;23303;51435;2936;2185;8797;1846;100507341;56154;4017;3084;4824;8794;8793;11030;51312;157313;23484;80005,62,0.68249940528983300000
chr9,91047879,96585567,5537688,-1,1,158293;1903;4814;445577;84270;23299;4958;3376;79048;6850;55035;4969;10507;158046;54769;4920;1164;53358;1842;89846;64768;4783;83744;10558;286223;10927;65268;549;401541;54829;203328;23196;5253;10912,34,0.61397464068037100000
chr12,86650365,94793764,8143399,-1,1,11163;100528030;1848;574016;160418;10154;196477;4254;694;338809;440107;1833;91298;25834;8411;8738;7334;8835;574028;160419;11081;80184;8693;4060;282809;28977;1634;490;51134,29,0.35611665350058400000
chr3,3488531,12112401,8623870,-1,1,55831;9901;6396;9695;7428;285367;3708;4968;491;6419;151835;6538;9797;29995;26140;8536;132001;84522;3269;859;63924;100526693;55207;2177;2917;56852;25917;401052;115795;132014;285368;285362;6854;10474;7862;51066;51738;84818;55209;78987;3656;64419;6529;10093;55845;57633;8553;375323;9686;5021;10533,51,0.59138182741623000000
chr2,238216063,243041364,4825301,-1,1,151176;64090;84289;5510;377007;285093;51665;728294;339768;4705;150677;1841;129807;2859;130916;64284;150678;10267;140739;2817;4735;79083;51540;5133;9759;150681;375318;189;51078;547;79919;57140;25992;51052;9208;375316;11132;389090;23192;55502;3069;10494;117581;51281;285193;666;8864;26146;23178;50636;653437;1293;80895;9855,54,1.11910117109793000000
chr17,28712406,33065919,4353513,-1,1,79736;79915;9527;6354;51379;6347;400591;55813;2123;55803;23512;162494;6355;7756;6346;2124;4974;26083;5717;8851;55288;4642;26022;64149;6356;55352;114659;84440;1362;4763;124842;40;84282;6357;124912,35,0.80394844347541900000
chr15,26450510,29579654,3129144,-1,1,2562;8924;321;2567;4948;653720;56160;2558;23359,9,0.28761859473389500000
chr12,79507572,84566536,5058964,-1,1,29080;8825;4659;4617;8499;84190;160335;374462;5074;283310;79611;4618;6857,13,0.25696960879737400000
chr15,23576906,28542402,4965496,-1,1,2562;7681;23742;8924;7337;6638;2567;4948;8926;57194;283685;54551;4692;2558,14,0.28194565054528300000
chr15,22744206,23110491,366285,-1,1,123606;114791;81614;23191;283767,5,1.36505726415223000000
chr19,45713182,47288638,1575456,-1,1,6633;4858;57469;5536;147920;8189;80207;729440;2828;147700;147906;25865;444882;90332;57787;1762;388553;1760;26145;2354;808;81492;2068;8993;100506012;10848;5739;6253;54814;147699;2067;2696;10849;339344;1158;64344;7408;29888;147912;24139;374918;3171;55228;339345;388555;79147;94235;83987;6510;23403,50,3.17368431742937000000
chr17,29045842,30370378,1324536,-1,1,79915;79736;55352;114659;55813;2124;84440;2123;55803;4974;4763;23512;84282;51379,14,1.05697391388381000000
chr16,29656012,30271971,615959,-1,1,653808;654483;5531;26470;283897;253980;146378;8479;83719;23475;283899;548593;124446;9344;3835;4150;226;613037;253982;83723;5595;6911;11151;6818;79447;112476;8448;9961;10423;6693;79153,31,5.03280250795913000000
chr2,111368748,113108624,1739876,-1,1,10461;699;129804;55289;64682;84524;376940;10018;84910,9,0.51727824281730400000
chr15,30409433,32855508,2446075,-1,1,728498;101059918;51621;89832;653125;22909;161725;283710;54893;89839;4308;728047;1139,13,0.53146367139192400000
chr2,51162064,51825760,663696,-1,1,9378,1,0.15067139172151100000
chr15,30919735,32509926,1590191,-1,1,51621;22909;161725;283710;54893;89839;4308;1139,8,0.50308422070053200000
chr16,29673954,30198600,524646,-1,1,653808;5531;26470;283897;253980;146378;8479;83719;23475;283899;124446;9344;3835;4150;226;253982;83723;5595;6911;11151;8448;79447;112476;9961;10423;6693;79153,27,5.14632723779463000000
chr22,18661724,21025713,2363989,-1,1,54487;27037;29801;65078;10587;1312;8214;7290;421;2812;6899;5625;7625;79680;64976;6576;8218;5413;23617;7122;128977;8220;388849;84861;7353;51586;2928;128989;9993;54584;91179;85376;85359;8318;728229;5902,36,1.52284972561209000000
chr17,16778475,20340396,3561921,-1,1,2314;55244;125170;55090;11216;79018;79999;10400;54890;254272;9706;400581;92521;8533;22905;729288;100996259;5598;218;23164;83450;224;51168;80039;51655;201163;7156;51030;5636;644815;10750;4239;10517;654346;10743;388436;27077;140775;6470;146691;1819;6720;125206;23495;147166;7732;146802;91647;56953;645027;3996;201164,52,1.45988639276390000000
chr10,81654864,88940418,7285554,-1,1,657;27069;84332;23063;54537;81619;5995;387694;79812;2746;119385;80195;10718;643161;26103;4143;387695;219348;6623;143241;92211;6441;54462;94233;2894;84293;340745;10974;11155;311,30,0.41177376490518100000
chr16,15048660,16292304,1243644,-1,1,4629;100288332;123811;89927;4363;54820;368;255027;23042;54700;123803;9665,12,0.96490635583816600000
chr17,16595418,20294010,3698592,-1,1,2314;9720;55244;125170;55090;11216;79018;79999;645027;10400;54890;254272;9706;92521;8533;22905;729288;5598;218;23164;83450;224;51168;80039;51655;201163;7156;51030;5636;644815;10750;10517;654346;10743;388436;27077;100129396;140775;6470;146691;1819;6720;125206;23495;147166;7732;146802;91647;56953;201164;400581;3996;4239,53,1.43297773855565000000
chr16,89462070,89618378,156308,-1,1,6687;29123,2,1.27952504030504000000
chr15,30941542,32443124,1501582,-1,1,161725;283710;54893;51621;4308;22909;1139,7,0.46617500742550200000
chr7,72721410,74142342,1420932,-1,1,5982;51085;9275;84277;7462;55695;135886;83451;1364;135892;6804;7461;155382;3984;26608;8468;9031;155368;2969;8326;7458;9569;2006;1365;114049,25,1.75940861350156000000
chr2,233944065,243040072,9096007,-1,1,54658;151176;64090;84289;285093;339768;6694;2859;130916;64284;10267;79083;414061;54579;9759;150681;189;54578;51078;79781;57140;25992;55230;9208;3635;6295;54657;2637;54659;11132;389090;23192;54577;55502;3069;10494;54576;117581;54575;285193;8864;26146;23178;1293;5133;80895;23677;10920;10123;377007;5510;51665;4705;57007;150677;1841;129807;150678;140739;2817;4735;9855;401036;51540;375318;339766;547;116987;55054;79919;8527;51052;375316;55355;79054;54600;51281;666;50636;653437;728294,81,0.89050063395949400000
chr17,16778475,20340396,3561921,-1,1,2314;55244;125170;55090;11216;79018;79999;10400;54890;254272;9706;400581;92521;8533;22905;729288;100996259;5598;218;23164;83450;224;51168;80039;51655;201163;7156;51030;5636;644815;10750;4239;10517;654346;10743;388436;27077;140775;6470;146691;1819;6720;125206;23495;147166;7732;146802;91647;56953;645027;3996;201164,52,1.45988639276390000000
chr1,752671,2260785,1508114,-1,1,85452;83858;126789;5590;81669;728661;29101;199990;339453;6497;643988;9636;126792;219293;8510;163688;84808;64856;26155;6339;55052;254173;80772;65220;339456;375790;984;388581;54587;54973;84069;148398;401934;54998;9906;116983;339451;643965;51150;7293;118424;728642;2563;8784;55210;2782;54991;1855;83756;142678;441869;57801;79906,53,3.51432318776962000000
chr4,37336,335770,298434,-1,1,654254;7700;152687;255403,4,1.34032985517736000000
chr15,21199944,28795723,7595779,-1,1,2562;7681;100996331;123606;4948;57194;283694;81614;390538;2558;8924;114791;23742;7337;6638;2567;8926;283685;54551;4692;23191;283767,22,0.28963454571282300000
chr15,30888776,32509932,1621156,-1,1,728498;51621;22909;161725;283710;54893;89839;4308;1139,9,0.55515940477042300000
chr8,186785,6886156,6699371,-1,1,389610;9172;728358;1669;26260;1667;157697;64478;1671;9639;79648;169270;285;157695;9228;55326;9920;1672;1668;2055,20,0.29853548937654000000
chr22,18661699,21722313,3060614,-1,1,54487;27037;9342;29801;65078;10587;1312;6545;8214;7290;421;2812;6899;5625;7625;79680;64976;6576;3053;8218;5413;80764;23617;400891;1399;7122;150209;128977;8220;388849;84861;7353;51586;2928;128989;5297;9127;9993;54584;91179;85376;8216;85359;8318;728229;5902,46,1.50296639824558000000
chr22,18875830,21441944,2566114,-1,1,54487;27037;9342;29801;65078;10587;1312;6545;8214;7290;421;2812;6899;5625;7625;79680;64976;6576;3053;8218;5413;80764;23617;400891;1399;7122;150209;128977;8220;388849;84861;7353;51586;2928;128989;5297;9127;9993;54584;91179;85376;8216;85359;8318;728229;5902,46,1.79259378188187000000
chr22,19171528,19920858,749330,-1,1,5413;6899;54584;79680;64976;8318;10587;7122;7290;128977;2812;7353;8218,13,1.73488316229165000000
chr7,72721410,74142342,1420932,-1,1,5982;51085;9275;84277;7462;55695;135886;83451;1364;135892;6804;7461;155382;3984;26608;8468;9031;155368;2969;8326;7458;9569;2006;1365;114049,25,1.75940861350156000000
chr18,65585979,78012819,12426840,-1,1,125704;54495;147381;1528;55628;201456;79863;400658;4772;25914;84735;644041;9306;9658;4155;27164;440498;81832;26251;80148;9150;10194;220158;284273;79839;22850;10666;84552;55748;374868;29090;10907;284274;7776;220164;2587,36,0.28969552999797200000
chr22,18646835,21661435,3014600,-1,1,54487;27037;9342;29801;65078;10587;1312;6545;8214;7290;421;2812;6899;5625;7625;79680;64976;11274;6576;3053;8218;5413;80764;23617;400891;1399;7122;150209;128977;8220;388849;84861;7353;51586;2928;128989;5297;9127;9993;54584;91179;85376;8216;85359;8318;728229;5902,47,1.55907914814569000000
chr1,146155929,147825519,1669590,-1,1,9557;51205;51463;2703;5565;607;2702;2330;200030;149013,10,0.59894944267754400000
chr15,22652047,28859765,6207718,-1,1,2562;7681;123606;4948;57194;81614;2558;8924;114791;23742;7337;6638;2567;8926;283685;54551;4692;23191;283767,19,0.30607060436701500000
chr15,30930422,32509932,1579510,-1,1,51621;22909;161725;283710;54893;89839;4308;1139,8,0.50648618875474000000
chr1,769072,6537534,5768462,-1,1,57470;388588;1677;85452;83858;6146;5590;127262;728661;199990;23463;9636;100287898;8510;64856;26155;140625;55229;8764;65220;339456;261734;375790;388581;148398;401934;57449;643965;51150;8784;2782;9651;1855;9731;27237;57801;387509;26038;126789;81669;29101;6497;339453;643988;7161;126792;8718;388591;83715;219293;163688;84808;11332;388585;63976;54626;6339;11079;80772;55052;254173;79258;984;54587;8514;5192;54973;339448;84069;54998;9906;148870;116983;339451;390992;55966;7293;118424;728642;127281;2563;55210;54991;83756;142678;441869;1953;79906;49856,89,1.54287225953816000000
chr22,18890162,21441944,2551782,-1,1,54487;27037;9342;29801;65078;10587;1312;6545;8214;7290;421;2812;6899;5625;7625;79680;64976;6576;3053;8218;5413;80764;23617;400891;1399;7122;150209;128977;8220;388849;84861;7353;51586;2928;128989;5297;9127;9993;54584;91179;85376;8216;85359;8318;728229;5902,46,1.80266182612778000000
chr22,18661699,21661435,2999736,-1,1,54487;27037;9342;29801;65078;10587;1312;6545;8214;7290;421;2812;6899;5625;7625;79680;64976;6576;3053;8218;5413;80764;23617;400891;1399;7122;150209;128977;8220;388849;84861;7353;51586;2928;128989;5297;9127;9993;54584;91179;85376;8216;85359;8318;728229;5902,46,1.53346827854184000000
chr4,64134818,76216290,12081472,-1,1,6779;4589;9508;213;26057;1060;22902;10720;10879;58503;389208;26952;54490;2919;3346;54959;79799;7367;10117;2798;6374;174;2920;7365;8671;339967;255324;27284;173;7364;55236;401137;3576;1448;5473;85438;285521;6783;1633;2069;5196;5197;7363;1446;574537;92597;57050;685;9407;3347;401138;441024;2926;253017;10886;260436;28983;25849;6372;7366;10941;258;374;91746;132724;2638;2044;166824;26228;3512;2921;1447,72,0.59595387052173800000
chr22,18847961,21499494,2651533,-1,1,54487;27037;9342;29801;65078;10587;1312;6545;8214;7290;421;2812;6899;5625;7625;79680;64976;6576;3053;8218;5413;80764;23617;400891;1399;7122;150209;128977;8220;388849;84861;7353;51586;2928;128989;5297;9127;9993;54584;91179;85376;8216;85359;8318;728229;5902,46,1.73484546486881000000
chr15,30930422,32509932,1579510,-1,1,51621;22909;161725;283710;54893;89839;4308;1139,8,0.50648618875474000000
chr22,18661699,21661435,2999736,-1,1,54487;27037;9342;29801;65078;10587;1312;6545;8214;7290;421;2812;6899;5625;7625;79680;64976;6576;3053;8218;5413;80764;23617;400891;1399;7122;150209;128977;8220;388849;84861;7353;51586;2928;128989;5297;9127;9993;54584;91179;85376;8216;85359;8318;728229;5902,46,1.53346827854184000000
chr6,158715431,170906766,12191335,-1,1,168002;57583;10846;5340;4142;84624;387263;55274;39;4018;9589;135138;55780;6993;117289;4216;285800;2853;6580;4301;113402;5134;9444;401285;3834;5689;100130967;6581;3482;6582;54346;100128124;168090;79981;7058;83887;94120;253769;6991;7430;6196;8635;28514;5071;6953;84498;6648;6950;56895;6862;51660;64094;29074;1235;83861;11116;154197;56995;6908,59,0.48395028108078400000
chr16,14910213,16516111,1605898,-1,1,100288332;23042;101059938;368;123803;9665;4629;123811;89927;4363;9284;54820;23420;408050;255027;54700,16,0.99632728853264700000
chr15,23620374,28559437,4939063,-1,1,2562;7681;23742;8924;7337;6638;2567;4948;8926;57194;283685;54551;4692;2558,14,0.28345457427856300000
chr1,146155929,147825519,1669590,-1,1,9557;51205;51463;2703;5565;607;2702;2330;200030;149013,10,0.59894944267754400000
chr22,18661699,21661435,2999736,-1,1,54487;27037;9342;29801;65078;10587;1312;6545;8214;7290;421;2812;6899;5625;7625;79680;64976;6576;3053;8218;5413;80764;23617;400891;1399;7122;150209;128977;8220;388849;84861;7353;51586;2928;128989;5297;9127;9993;54584;91179;85376;8216;85359;8318;728229;5902,46,1.53346827854184000000
chr22,18890162,21441944,2551782,-1,1,54487;27037;9342;29801;65078;10587;1312;6545;8214;7290;421;2812;6899;5625;7625;79680;64976;6576;3053;8218;5413;80764;23617;400891;1399;7122;150209;128977;8220;388849;84861;7353;51586;2928;128989;5297;9127;9993;54584;91179;85376;8216;85359;8318;728229;5902,46,1.80266182612778000000
chr15,30930422,32509932,1579510,-1,1,51621;22909;161725;283710;54893;89839;4308;1139,8,0.50648618875474000000
chr15,22746230,28795723,6049493,-1,1,2562;7681;123606;4948;57194;81614;2558;8924;114791;23742;7337;6638;2567;8926;283685;54551;4692;23191,18,0.29754559596977800000
chr15,23586243,28795723,5209480,-1,1,2562;7681;23742;8924;7337;6638;2567;4948;8926;57194;283685;54551;4692;2558,14,0.26874083401798300000
chr1,219786904,229910859,10123955,-1,1,64853;92815;64757;65094;23219;55740;8560;11221;286826;79169;58480;128312;51127;55746;3930;25782;79762;3020;8290;9816;2058;55061;84033;7100;83881;149603;375057;84976;2052;163859;81559;200205;4139;339501;54996;58;148362;5664;5867;64746;128308;2987;4931;79802;116841;57165;7044;126731;23456;149111;6726;80232;89780;9725;27097;375056;7483;10638;164127;824;29920;7159;3142;10637;55532;3707;100129094;388743;339500;9015;400823;10380;56997;29097;142;127602;8476;375;55699,79,0.78032745108013600000
chr11,120440646,134939347,14498701,-1,1,219874;53340;2900;63970;9743;84623;26595;7007;219873;89944;283171;56253;403312;219870;56980;219875;55572;83700;6768;399967;56;79607;390261;3758;26493;22997;9638;83480;114609;79684;641654;112936;6653;84881;50863;27034;55800;90952;219858;219833;63876;100169851;283162;283160;390259;390271;64221;220296;219844;390265;1111;50937;28960;219938;4900;79864;6309;219854;390275;120224;7753;29087;2313;219899;57476;334;219869;4013;23584;390260;414899;84897;79827;54414;219865;283159;116337;4798;399968;27087;26492;6484;8538;170689;54538;9538;29118;399979;3312;390264;6734;84959;3762;4978;2113;338662;23310;112937;3703;11095;219855;80071;160065;338661;29068,105,0.72420280961722000000
chr4,31855158,38981418,7126260,-1,1,55286;401124;768211;81793;80008;10744;10333;57495;92689;7096;55276;51274;116984;23216,14,0.19645648629154700000
chr22,18876605,21441944,2565339,-1,1,54487;27037;9342;29801;65078;10587;1312;6545;8214;7290;421;2812;6899;5625;7625;79680;64976;6576;3053;8218;5413;80764;23617;400891;1399;7122;150209;128977;8220;388849;84861;7353;51586;2928;128989;5297;9127;9993;54584;91179;85376;8216;85359;8318;728229;5902,46,1.79313533221145000000
chr18,78425,8860680,8782255,-1,1,91133;116;55556;10403;23255;9663;645369;103910;642597;7050;339291;9984;9097;7525;81035;23347;10627;5797;494514;201475;64863;1068;8736;9229;27098;284217;79822;84034;23136;7298;7541,31,0.35298451251984800000
chr1,227083904,243103603,16019699,-1,1,92815;54583;65094;440730;200150;57568;58480;10753;79169;128312;1130;84886;6894;23029;7257;51127;6905;55746;55127;128178;441925;8290;9816;6000;51742;56605;84033;23596;1131;149603;148789;375061;81559;200205;57829;148641;79605;339501;9453;183;128061;388753;58;7107;83932;4548;359948;6262;5867;84451;128025;27185;84284;56776;9804;9156;1122;128308;2590;8564;64388;2987;64801;116841;57165;126731;23456;149373;88;2271;89780;27097;10638;7483;8443;645745;54627;100129094;2786;339500;3964;149371;80003;56997;3775;8476;4811;440738;375;22796;79573,91,0.56805062317338200000
chr15,30419801,32829421,2409620,-1,1,728498;101059918;51621;89832;653125;22909;161725;283710;54893;89839;4308;728047;1139,13,0.53950415418198700000
chr15,30930422,32509932,1579510,-1,1,51621;22909;161725;283710;54893;89839;4308;1139,8,0.50648618875474000000
chr2,24400,3391355,3366955,-1,1,7837;23040;642273;51112;7173;54221;26751;285016;7260;129787;52,11,0.32670469311291700000
chr1,723318,3252858,2529540,-1,1,85452;83858;5590;728661;199990;9636;100287898;8510;64856;26155;140625;55229;8764;65220;339456;375790;388581;148398;401934;643965;51150;8784;2782;9651;1855;57801;126789;81669;29101;339453;6497;643988;126792;219293;163688;84808;388585;63976;6339;55052;254173;80772;11079;79258;984;54587;5192;54973;84069;54998;9906;116983;339451;7293;118424;728642;2563;127281;55210;54991;83756;142678;441869;79906,64,2.53010428773611000000
chr22,49456297,51220923,1764626,-1,1,85358;410;400935;85378;9701;56666;5600;49;9889;23774;80305;11158;414918;79174;9997;1120;440836;1375;415116;83642;23542;644186;23209;6300;83933;79924;79087;6305;1890;348645;23654;113730;29781;55586;91289;54456,36,2.04009234818029000000
chr18,70708772,78012819,7304047,-1,1,125704;26251;1528;55628;201456;79863;80148;400658;9150;4772;84735;644041;10194;9658;284273;4155;27164;440498;22850;84552;55748;374868;29090;10907;284274;7776;2587,27,0.36965808133490900000
chr22,18890162,21441944,2551782,-1,1,54487;27037;9342;29801;65078;10587;1312;6545;8214;7290;421;2812;6899;5625;7625;79680;64976;6576;3053;8218;5413;80764;23617;400891;1399;7122;150209;128977;8220;388849;84861;7353;51586;2928;128989;5297;9127;9993;54584;91179;85376;8216;85359;8318;728229;5902,46,1.80266182612778000000
chr7,72721410,74142342,1420932,-1,1,5982;51085;9275;84277;7462;55695;135886;83451;1364;135892;6804;7461;155382;3984;26608;8468;9031;155368;2969;8326;7458;9569;2006;1365;114049,25,1.75940861350156000000
chr2,195689686,205166711,9477025,-1,1,1493;9262;130132;940;56171;843;8837;285172;80219;60491;51602;55759;91526;130540;53938;129450;57404;26010;130026;65065;57679;3336;79568;66037;316;4709;5334;100652824;58538;23451;1195;65062;65061;79800;57181;205327;8324;150864;100529241;151254;65059;92935;23314;66008;10152;57520;9330;80055;151246;841;401027;55437;7341;659;29851;25843;9689;130535;4999;284992;3329,61,0.64366190866859600000
chr17,1656,1707842,1706186,-1,1,10594;51031;50628;29928;286753;124935;727910;5345;29;400566;8578;359845;55178;4641;55275;83547;114826;124997;5176;100506388;1398;79850;8447;7531;5306;727857;9501;64359;51763,29,1.69969745385321000000
chr17,34815077,36290313,1475236,-1,1,26574;9326;6928;3975;79893;31;80179;284098;11072;79154;79922;11276;11056;101060376;6871;284099,16,1.08457223115488000000
chr7,72721410,74142342,1420932,-1,1,5982;51085;9275;84277;7462;55695;135886;83451;1364;135892;6804;7461;155382;3984;26608;8468;9031;155368;2969;8326;7458;9569;2006;1365;114049,25,1.75940861350156000000
chr13,109847503,115105655,5258152,-1,1,7027;55795;79587;79774;3916;8874;22821;55608;23026;8858;55647;10426;1284;101928841;2621;400165;113622;65110;8660;121793;283489;23263;55739;643365;55002;3621;1282;100129836;6656;23250;2155;2159;55208;496;6011;122258;348013;8881;8451,39,0.74170545088844900000
chr18,71638423,78012819,6374396,-1,1,125704;26251;1528;55628;201456;79863;80148;400658;9150;4772;84735;644041;10194;9658;284273;4155;27164;440498;22850;84552;55748;374868;29090;10907;284274;7776;2587,27,0.42356954290257500000
chr7,101737503,110125167,8387664,-1,1,222255;222256;729597;154907;246721;50640;6733;548644;10466;22798;80228;5294;1738;5577;79706;1811;83787;5701;26959;60561;10156;5172;55904;100310812;79872;222229;375612;3912;9512;5439;10234;11062;4189;1523;441273;222236;10135;10603;100289561;6856;2845;5001;100134938;27000;4897;222235;5649;100271927;54517;55973;54784;168455;58160;168451;222234;375611,56,0.66764715420169400000
chr2,127034782,130092918,3058136,-1,1,274;55339;5433;56886;4648;55679;339761;2071;84826;2840;2995;101929926;5624;79595;10746;83607;55677;9394,18,0.58859383624534700000
chr22,19023804,21540347,2516543,-1,1,54487;27037;9342;29801;65078;10587;1312;6545;421;7290;2812;6899;7625;79680;64976;6576;3053;8218;5413;80764;23617;400891;1399;7122;150209;128977;8220;388849;84861;7353;51586;2928;128989;5297;9127;9993;54584;91179;8216;85376;85359;8318;728229;5902,44,1.74843028710417000000
chr22,19749930,19857375,107445,-1,1,54584;79680;6899,3,2.79212620410443000000
chr2,163875901,169590100,5714199,-1,1,79809;6335;129446;6323;151258;6328;27347;253782;55137;6326;2591;6332;22837;2888;8708;80034,16,0.28000424906448000000
chr18,71021271,78012819,6991548,-1,1,125704;26251;1528;55628;201456;79863;80148;400658;9150;4772;84735;644041;10194;9658;284273;4155;27164;440498;22850;84552;55748;374868;29090;10907;284274;7776;2587,27,0.38618057116964700000
chr1,120840,2734332,2613492,-1,1,85452;83858;5590;728661;199990;9636;100287898;8510;64856;26155;81399;55229;8764;65220;339456;375790;388581;148398;401934;643965;51150;8784;2782;9651;1855;57801;126789;81669;29101;339453;6497;643988;126792;219293;163688;84808;388585;6339;55052;254173;80772;11079;79258;984;54587;5192;54973;84069;54998;9906;116983;339451;7293;118424;728642;2563;127281;55210;54991;83756;142678;441869;729759;79906,64,2.44883091281703000000
chr18,78425,9146865,9068440,-1,1,116;55556;10403;23255;645369;103910;642597;9097;7525;5797;494514;1068;9229;79822;84034;4729;7298;91133;23253;9663;7050;339291;9984;81035;23347;10627;201475;64863;8736;27098;284217;23136;7541,33,0.36389941379112600000
chr10,10435139,17259567,6824428,-1,1,22929;57118;221060;79746;79723;8516;1787;221061;26019;80013;55176;11164;389941;55691;254427;8029;51182;10659;55301;10557;221044;644890;441549;222389;9712;5264;9397;8872;8559;6251;414149;55388;83643;55526;9317;83641;10133;64421,38,0.55682322386579500000
chr15,23620191,28635058,5014867,-1,1,2562;7681;23742;8924;7337;6638;2567;4948;8926;57194;283685;54551;4692;2558,14,0.27916991617125600000
chr22,18894835,19010508,115673,-1,1,5625;8214,2,1.72901195611768000000
chr11,122053151,129113480,7060329,-1,1,219874;53340;63970;9743;84623;26595;219873;56253;403312;219870;219875;55572;399967;56;79607;390261;3758;26493;9638;83480;114609;79684;641654;84881;55800;90952;219858;219833;63876;100169851;283162;283160;390259;390271;4900;64221;220296;390265;1111;219844;50937;28960;79864;219854;390275;7753;2313;57476;219869;4013;23584;390260;84897;79827;54414;219865;283159;116337;399968;26492;6484;54538;9538;29118;3312;390264;6734;84959;3762;2113;338662;3703;219855;80071;160065;338661,76,1.07643708954639000000
chr22,18877523,21505417,2627894,-1,1,54487;27037;9342;29801;65078;10587;1312;6545;8214;7290;421;2812;6899;5625;7625;79680;64976;6576;3053;8218;5413;80764;23617;400891;1399;7122;150209;128977;8220;388849;84861;7353;51586;2928;128989;5297;9127;9993;54584;91179;85376;8216;85359;8318;728229;5902,46,1.75045112169669000000
chr8,107104087,118261026,11156939,-1,1,84955;27012;9166;55638;169026;55074;93035;84294;8667;114788;3646;7201;7227;157753;441376;137735;340419;9694;5885;284;56943;100132813,22,0.19718670147788700000
chr2,51083410,51314430,231020,-1,1,9378,1,0.43286295558826100000
chr18,1,14966054,14966053,-1,1,116;23255;57132;8774;645369;125228;57045;103910;642597;84617;9097;7525;10650;3613;56984;65258;79822;84034;4729;23253;9663;9989;339291;9984;10928;162655;63895;201475;64863;342850;27098;646000;753;7541;55125;55556;10403;4158;84203;388468;147495;9218;5797;494514;1149;5771;10939;1068;79959;9229;7298;91133;11031;56907;7050;81929;4161;81035;2774;23347;10627;8731;8736;374860;284217;23136,66,0.44099803735828000000
chr7,72726578,74139390,1412812,-1,1,5982;51085;9275;84277;7462;135886;83451;1364;135892;6804;7461;155382;3984;26608;8468;9031;155368;2969;8326;7458;9569;2006;1365;114049,24,1.69873981817821000000
chr7,25917947,30370742,4452795,-1,1,54504;222171;2128;84725;3199;29887;3198;1124;644150;3207;3209;11112;55033;3202;3203;8887;11335;9586;3205;222166;8935;9865;3181;3201;221895;3204;3200;3206;285941;223082;9805;9603,32,0.71864974695668700000
chr16,15492317,16249607,757290,-1,1,4629;123811;89927;4363;54820;255027;368;9665,8,1.05639847350421000000
chr16,29673954,30198600,524646,-1,1,653808;5531;26470;283897;253980;146378;8479;83719;23475;283899;124446;9344;3835;4150;226;253982;83723;5595;6911;11151;8448;79447;112476;9961;10423;6693;79153,27,5.14632723779463000000
chr10,47011548,51805020,4793472,-1,1,5599;644168;267004;8031;195977;100652748;642517;57705;474354;170371;118738;653145;5949;644054;414189;100133093;728113;5540;143162;6572;2662;26095;118461;282966;58504;100287932;8505;2658;1103;2074;170370;4477;196740;55753,34,0.70929797858420800000
chr15,31014508,32914140,1899632,-1,1,9824;51621;653125;22909;161725;283710;54893;643699;4308;728047;1139,11,0.57905952310763400000
chr16,15048751,16276115,1227364,-1,1,4629;100288332;123811;89927;4363;54820;368;255027;23042;54700;123803;9665,12,0.97770506548994400000
chr15,31014508,32510863,1496355,-1,1,161725;283710;54893;51621;4308;22909;1139,7,0.46780342899913500000
chr15,20575646,23179948,2604302,-1,1,727832;114791;100996331;123606;283694;81614;100287399;390538;23191;283767,10,0.38398004532500500000
chr16,15048751,16276115,1227364,-1,1,4629;100288332;123811;89927;4363;54820;368;255027;23042;54700;123803;9665,12,0.97770506548994400000
chr15,32021733,32510863,489130,-1,1,161725;1139,2,0.40888925234600200000
chr2,50678025,52750571,2072546,-1,1,9378,1,0.04824983377932260000
chr14,33086546,44485372,11398826,-1,1,4253;55012;7080;6751;84684;3169;171546;122553;55837;253970;253959;5083;112399;8487;145581;5687;64067;283635;319089;84312;1073;26257;161198;6729;10484;58533;254170;9472;5411;51562;145282;9692;89874;11177;4792,35,0.30704916453676900000
chr7,18637858,19335410,697552,-1,1,7291;9734;222894,3,0.43007546390806700000
chrX,32235027,32472715,237688,-1,1,1756,1,0.42071959880179100000
chr15,22784523,23179948,395425,-1,1,123606;23191;114791;81614,4,1.01156982992982000000
chr15,47333806,52046582,4712776,-1,1,2585;23741;283652;23312;29767;2553;399694;373509;1854;256586;29106;2200;80031;342035;54822;3067;9318;9728;56986;22995;9101;1588;50804;11001;84888;196951;2252;79895;399697;23431;388121;6557,32,0.67900532509926200000
chr1,146564743,149155055,2590312,-1,1,9557;728945;284565;644591;51205;645142;51463;5565;607;2702;730262;2330;200030;2703,14,0.54047543307524300000
chr16,21951379,22380197,428818,-1,1,7385;730094;1039;146177;55718;29904;255762,7,1.63239416255847000000
chr1,144927778,147786706,2858928,-1,1,9557;148738;128077;27246;84265;11126;9659;10628;2330;653519;8799;149013;5174;388677;10401;200035;51205;284615;8515;51463;5565;148741;607;2702;10623;200030;100132406;2703;9939,29,1.01436622398326000000
chr16,29673954,30198600,524646,-1,1,653808;5531;26470;283897;253980;146378;8479;83719;23475;283899;124446;9344;3835;4150;226;253982;83723;5595;6911;11151;8448;79447;112476;9961;10423;6693;79153,27,5.14632723779463000000
chr15,31014508,32510863,1496355,-1,1,161725;283710;54893;51621;4308;22909;1139,7,0.46780342899913500000
chr18,63857253,77982126,14124873,-1,1,125704;54495;28513;147381;1528;55628;201456;79863;400658;4772;25914;84735;644041;9306;9658;4155;27164;440498;81832;26251;80148;92126;9150;10194;220158;284273;79839;22850;10666;84552;55748;374868;29090;10907;284274;7776;220164;2587,38,0.26902896755248700000
chr2,12354033,18532689,6178656,-1,1,7447;79677;4613;343930;28951;151354;81553;51594;10408;729475;348654;3790;1653,13,0.21040174432756900000
chr1,146564743,147786706,1221963,-1,1,9557;51205;51463;5565;607;2702;2330;200030;2703,9,0.73651984552723800000
chr18,71091915,77982126,6890211,-1,1,125704;26251;1528;55628;201456;79863;80148;400658;9150;4772;84735;644041;10194;9658;284273;4155;27164;440498;22850;84552;55748;374868;29090;10907;284274;7776;2587,27,0.39186027829917000000
chr15,22784523,23179948,395425,-1,1,123606;23191;114791;81614,4,1.01156982992982000000
chr19,29946716,33791974,3845258,-1,1,57616;85415;84902;898;22847;83636;390916;55094;1050;147991;388531;11136;100507527;91442;342865;10775;9141;4037;84079;56301;91646;9745;126248;8725;79156,25,0.65015143327183800000
chr16,21951379,22380197,428818,-1,1,7385;730094;1039;146177;55718;29904;255762,7,1.63239416255847000000
chrX,61091,2393547,2332456,-1,1,28227;207063;293;286530;438;64109;6473;8227;8225;8623;55344;1438;3563,13,0.55735242165339900000
chr21,33519193,37307907,3788714,-1,1,29980;3588;6526;10215;9992;861;539;9875;6453;101928147;3454;56245;54943;140290;757;2618;54069;3455;64968;56246;9946;54102;3460;6651;8867;116448;54065;94104;1827;3753;56683;59271,32,0.84461376604304300000
chr16,29673954,30198600,524646,-1,1,653808;5531;26470;283897;253980;146378;8479;83719;23475;283899;124446;9344;3835;4150;226;253982;83723;5595;6911;11151;8448;79447;112476;9961;10423;6693;79153,27,5.14632723779463000000
chr13,48612857,48974143,361286,-1,1,55270;9445;29079;5925,4,1.10715610347481000000
chr16,15048751,16276115,1227364,-1,1,4629;100288332;123811;89927;4363;54820;368;255027;23042;54700;123803;9665,12,0.97770506548994400000
chr16,29673954,30197341,523387,-1,1,653808;5531;26470;283897;253980;146378;8479;83719;23475;283899;124446;9344;3835;4150;226;253982;83723;5595;6911;11151;8448;79447;112476;9961;10423;6693;79153,27,5.15870665492265000000
chr1,146564743,147786706,1221963,-1,1,9557;51205;51463;5565;607;2702;2330;200030;2703,9,0.73651984552723800000
chr17,7119830,8019071,899241,-1,1,146754;6517;201243;8742;92162;124637;1856;6665;55135;482;59344;100996842;284114;51087;254863;23135;58485;9513;26168;339168;374768;3000;1984;1973;116840;1949;643664;79142;112483;1742;57659;37;1140;8741;1107;407977;247;57048;147040;6462;7157;2256;9744;2874;8711;968;57555;84316;11337;9196;84461;9526;23399;23587;1366;242;5430,57,6.33867895258335000000
chr2,148186210,149060763,874553,-1,1,92;5000;55777,3,0.34303238340043400000
chr11,125449960,134868407,9418447,-1,1,120224;9743;63970;2313;29087;84623;334;89944;283171;56980;55572;4798;399967;6768;83700;399968;56;79607;27087;3758;22997;6484;8538;170689;83480;9538;114609;29118;399979;112936;6734;84881;50863;27034;3762;4978;2113;219833;23310;112937;100169851;3703;219844;50937;11095;1111;28960;219938;160065;29068,50,0.53087308342872200000
chr15,22784523,28525460,5740937,-1,1,2562;7681;123606;4948;57194;81614;2558;8924;114791;23742;7337;6638;2567;8926;283685;54551;4692;23191,18,0.31353766815417100000
chr1,759762,10869155,10109393,-1,1,10277;100526739;1677;83858;6146;5590;728661;23463;9636;8510;64856;765;26155;140625;6518;54206;8764;65220;339456;261734;375790;388581;148398;9563;80835;57449;80045;643965;5195;2023;2782;9651;1855;84328;57801;387509;26038;81669;6497;643988;7161;22883;126792;8718;388591;11315;63976;6339;11079;80772;50651;148479;79258;8514;339448;9903;118424;55210;54991;473;142678;441869;79707;49856;57470;388588;85452;56998;127262;199990;100287898;80176;1676;378708;55229;10911;90326;401934;55735;54897;51150;8784;9731;27237;23095;155184;3604;8863;84275;126789;199953;29101;1325;339453;83715;219293;163688;5226;84808;11332;388585;54626;55052;254173;984;54587;5192;54973;84069;54998;9906;148870;116983;339451;390992;55966;3104;7293;728642;127281;2563;64802;116362;9341;83756;23261;1953;79906;5293,129,1.27604100463796000000
chr15,31014508,32510863,1496355,-1,1,161725;283710;54893;51621;4308;22909;1139,7,0.46780342899913500000
chr15,23286226,29021034,5734808,-1,1,2562;7681;23742;8924;7337;6638;2567;4948;8926;57194;283685;653720;54551;4692;2558,15,0.26156063114929000000
chr22,18919942,20992700,2072758,-1,1,54487;27037;29801;65078;10587;1312;421;7290;2812;6899;5625;7625;79680;64976;6576;8218;5413;23617;7122;128977;8220;388849;84861;7353;51586;2928;128989;9993;54584;91179;85376;85359;8318;728229;5902,35,1.68857145889679000000
chr16,21951379,22380197,428818,-1,1,7385;730094;1039;146177;55718;29904;255762,7,1.63239416255847000000
chr2,131481984,132115888,633904,-1,1,130074;50649;445582;344561;55041;205147,6,0.94651556071581800000
chr16,29673954,30198600,524646,-1,1,653808;5531;26470;283897;253980;146378;8479;83719;23475;283899;124446;9344;3835;4150;226;253982;83723;5595;6911;11151;8448;79447;112476;9961;10423;6693;79153,27,5.14632723779463000000
chr1,146641601,147786706,1145105,-1,1,9557;51205;51463;5565;607;2702;2330;200030;2703,9,0.78595412647748500000
chr22,18919942,21440514,2520572,-1,1,54487;27037;9342;29801;65078;10587;1312;6545;421;7290;2812;6899;5625;7625;79680;64976;6576;3053;8218;5413;80764;23617;400891;1399;7122;150209;128977;8220;388849;84861;7353;51586;2928;128989;5297;9127;9993;54584;91179;85376;8216;85359;8318;728229;5902,45,1.78530904889842000000
chr2,111399243,113102594,1703351,-1,1,10461;699;129804;10018;84910;64682;376940;55289;84524,9,0.52837025369404200000
chr7,72726572,74133332,1406760,-1,1,5982;51085;9275;84277;7462;135886;83451;1364;135892;6804;7461;155382;3984;26608;8468;9031;155368;2969;8326;7458;9569;2006;1365;114049,24,1.70604793994711000000
chr22,18919942,21440514,2520572,-1,1,54487;27037;9342;29801;65078;10587;1312;6545;421;7290;2812;6899;5625;7625;79680;64976;6576;3053;8218;5413;80764;23617;400891;1399;7122;150209;128977;8220;388849;84861;7353;51586;2928;128989;5297;9127;9993;54584;91179;85376;8216;85359;8318;728229;5902,45,1.78530904889842000000
chr16,28837450,29042118,204668,-1,1,11273;27040;79874;7284;930;84901;487;83985;25970,9,4.39736548947564000000
chr22,20754422,21440514,686092,-1,1,80764;9342;91179;8216;7625;400891;1399;84861;6545;150209;5297;51586;9127;3053,14,2.04054266774718000000
chr15,31014508,32510863,1496355,-1,1,161725;283710;54893;51621;4308;22909;1139,7,0.46780342899913500000
chr10,28732970,30620425,1887455,-1,1,84569;6840;55149;25805;283080;57608;51322,7,0.37086976908058700000
chr5,130215805,136080355,5864550,-1,1,51735;9555;3950;645121;347732;4090;8974;96459;10111;134548;56951;23338;5307;100996485;10802;54819;140947;5515;7320;819;27125;90624;91368;3596;26223;3659;23176;27089;3308;3578;3567;1437;6584;79770;728637;116842;6583;3565;23105;57113;9547;23305;51128;3094;7045;134553;8572;3562;153328;84105;56990;7416;51265;497189;6500;11127;134549;9879;4762;2661;6932,61,1.04014800794605000000
chr22,18641744,21561492,2919748,-1,1,54487;27037;9342;29801;65078;10587;1312;6545;8214;7290;421;2812;6899;5625;7625;79680;64976;11274;6576;3053;8218;5413;80764;23617;400891;1399;7122;150209;128977;8220;388849;84861;7353;51586;2928;128989;5297;9127;9993;54584;91179;85376;8216;85359;8318;728229;5902,47,1.60972796282419000000
chr2,11279826,21475834,10196008,-1,1,7447;100526794;64342;93034;130813;348654;1653;9741;6382;23369;4613;1876;60526;81553;57665;23620;100129278;388;343930;130502;51594;729475;9475;57539;9687;151449;4148;338;79677;28951;151354;130497;10408;3790;130814;23175,36,0.35307936204051600000
chr11,131161909,134945165,3783256,-1,1,4978;23310;112937;29087;83700;112936;219938;50863;89944;27034;27087;22997,12,0.31718710021209200000
chr21,15354923,33729735,18374812,-1,1,54148;11096;2897;337882;9875;29104;9073;337960;571;10950;337970;643812;7074;9510;337959;4685;337968;149998;337973;26046;351;10069;116159;100131902;522;337963;337967;337878;140578;337979;100288323;54149;337971;337985;8204;30811;337974;337977;5651;337969;388813;57466;337976;54069;2551;10600;1525;140258;56246;26285;10694;337975;337880;100288287;6647;64092;150051;58494;337966;388818;337978;337879;254950;56911;54033;29761;284827;337972;6782;643803;728299,71,0.38639851117932500000
chr19,35096860,36494247,1397387,-1,1,51599;26330;2867;1340;53822;84807;148137;79414;4099;2116;163183;90075;55957;148103;84063;333;6324;115703;644096;126393;57817;79713;5349;2865;495;374897;163175;148109;79171;57655;7305;55851;58510;388533;199746;5348;126375;7392;53827;3249;339318;23354;27033;4868;10870;2864;93099;10430;55900;11045;933;9757,52,3.72123112638088000000
chr15,31073735,32446830,1373095,-1,1,161725;283710;54893;51621;4308;22909;1139,7,0.50979720995269800000
chr16,28837450,29042118,204668,-1,1,11273;27040;79874;7284;930;84901;487;83985;25970,9,4.39736548947564000000
chrX,23301682,23411163,109481,-1,1,139411,1,0.91340049871667200000
chrX,61091,8295650,8234559,-1,1,414;28227;51481;286530;57502;8226;8228;8225;1438;3563;26609;5613;25878;347527;415;416;207063;4267;293;412;7499;9189;438;64109;51480;6473;8227;55344;8623;8908,30,0.36431823489272500000
chr22,18919942,21440514,2520572,-1,1,54487;27037;9342;29801;65078;10587;1312;6545;421;7290;2812;6899;5625;7625;79680;64976;6576;3053;8218;5413;80764;23617;400891;1399;7122;150209;128977;8220;388849;84861;7353;51586;2928;128989;5297;9127;9993;54584;91179;85376;8216;85359;8318;728229;5902,45,1.78530904889842000000
chr18,65467626,78010032,12542406,-1,1,125704;54495;147381;1528;55628;201456;79863;400658;4772;25914;84735;644041;9306;9658;4155;27164;440498;81832;26251;80148;9150;10194;220158;284273;79839;22850;10666;84552;55748;374868;29090;10907;284274;7776;220164;2587,36,0.28702626912252700000
chr3,6480428,11271139,4790711,-1,1,55831;9901;6396;7428;285367;4968;491;151835;6538;9797;29995;26140;8536;84522;3269;859;63924;100526693;2177;2917;56852;25917;401052;115795;132014;285368;10474;7862;51066;51738;84818;55209;78987;3656;64419;6529;10093;55845;375323;5021,40,0.83494913385507900000
chr16,29673954,30198600,524646,-1,1,653808;5531;26470;283897;253980;146378;8479;83719;23475;283899;124446;9344;3835;4150;226;253982;83723;5595;6911;11151;8448;79447;112476;9961;10423;6693;79153,27,5.14632723779463000000
chr22,20754422,21440514,686092,-1,1,80764;9342;91179;8216;7625;400891;1399;84861;6545;150209;5297;51586;9127;3053,14,2.04054266774718000000
chr22,18919942,21440514,2520572,-1,1,54487;27037;9342;29801;65078;10587;1312;6545;421;7290;2812;6899;5625;7625;79680;64976;6576;3053;8218;5413;80764;23617;400891;1399;7122;150209;128977;8220;388849;84861;7353;51586;2928;128989;5297;9127;9993;54584;91179;85376;8216;85359;8318;728229;5902,45,1.78530904889842000000
chrX,61139,10125133,10063994,-1,1,414;51481;171482;425054;1438;4935;5613;347527;100288814;415;207063;293;412;438;64109;51480;1183;55344;8623;6907;28227;357;286530;57502;8226;8228;3730;8225;3563;26609;25878;416;4267;7499;9189;6473;55841;8227;171483;8908,40,0.39745651676660400000
chr15,31014508,32510863,1496355,-1,1,161725;283710;54893;51621;4308;22909;1139,7,0.46780342899913500000
chr15,23739358,28525460,4786102,-1,1,2562;7681;23742;8924;7337;6638;2567;4948;8926;57194;54551;4692;2558,13,0.27161978578810100000
chr5,87249953,88860277,1610324,-1,1,4208;153396,2,0.12419860847879100000
chr16,29673954,30198600,524646,-1,1,653808;5531;26470;283897;253980;146378;8479;83719;23475;283899;124446;9344;3835;4150;226;253982;83723;5595;6911;11151;8448;79447;112476;9961;10423;6693;79153,27,5.14632723779463000000
chr13,93879390,115059020,21179630,-1,1,7027;2259;79587;160897;55795;79774;3916;8874;55757;2841;55608;22873;23026;8858;55647;10426;10160;84945;1880;101928841;400165;8428;7174;7546;113622;65110;23348;10673;9358;9375;9071;54841;196541;10150;87769;27199;266722;10082;140432;3843;6564;643365;55002;3621;2073;1282;10257;2155;23250;1948;6011;3981;496;122258;8451;267012;11166;22821;337867;84899;259232;79070;1284;728215;643677;2621;5911;8660;121793;23263;55739;171425;23483;93081;5611;55082;5095;100129836;85416;1638;348013;2159;6656;8881;100533467;55208;6555,87,0.41077204842577500000
chr15,74909384,77117357,2207973,-1,1,57184;1445;192683;10073;79661;64843;653641;9377;56905;79748;1543;54939;49855;2108;1544;55272;5780;25989;92912;10066;60490;653643;1464;257364;1198;161753;105376731;594855;80153;54913;4123;25942;4351;26263;123591;145957,36,1.63045472023435000000
chr18,60215400,77982126,17766726,-1,1,125704;54495;28513;147381;89778;1528;55628;201456;79863;400658;8710;25914;84735;644041;5275;4772;9306;9658;5055;4155;27164;54877;440498;81832;5268;89777;1005;26251;5273;80148;23239;92126;9150;10194;596;220158;6317;6318;284273;284293;79839;22850;10666;84552;55748;374868;9525;5271;2531;10907;29090;284274;7776;220164;2587,55,0.30956744647269300000
chr2,148790680,148879681,89001,-1,1,55777,1,1.12358288109122000000
chr16,15492317,18012461,2520144,-1,1,4629;123811;64131;89927;4363;54820;408050;255027;101059938;368;9665,11,0.43648299462252900000
chr15,21951379,22380197,428818,-1,1,390538;100996331,2,0.46639833215956400000
chr16,15048751,16276115,1227364,-1,1,4629;100288332;123811;89927;4363;54820;368;255027;23042;54700;123803;9665,12,0.97770506548994400000
chr2,50850691,51083469,232778,-1,1,9378,1,0.42959386196290000000
chr16,28837450,29042118,204668,-1,1,11273;27040;79874;7284;930;84901;487;83985;25970,9,4.39736548947564000000
chr22,18919942,21440514,2520572,-1,1,54487;27037;9342;29801;65078;10587;1312;6545;421;7290;2812;6899;5625;7625;79680;64976;6576;3053;8218;5413;80764;23617;400891;1399;7122;150209;128977;8220;388849;84861;7353;51586;2928;128989;5297;9127;9993;54584;91179;85376;8216;85359;8318;728229;5902,45,1.78530904889842000000
chr2,51037104,51314430,277326,-1,1,9378,1,0.36058645781499000000
chr5,175839681,176591515,751834,-1,1,3101;1212;6620;23567;23197;2264;51720;54825;90249;64324;22838;114787;26262;253314,14,1.86211317923903000000
chr22,21798705,24631613,2832908,-1,1,7332;4320;100423062;613;391322;400916;150248;23532;129025;645426;29799;91227;23759;150223;9647;27156;653689;4282;23119;29802;100037417;2687;9609;164592;23753;5594;7441;3543;2781;7621;2952;66035;8940;266747;140883;150221;51233;6598;1652;56241;23523;91319,42,1.48257550192241000000
chr8,221611,17741198,17519587,-1,1,377630;1508;83650;504180;503841;10407;26260;286097;245910;245908;503618;54984;100289462;4482;157695;203074;9228;245909;90459;9920;1672;26281;137492;9172;51201;503614;83595;57509;653423;645402;2626;100131980;613210;1673;79648;1670;66036;285;157773;8658;9258;2267;414325;137868;645836;4481;2055;389610;401447;392197;728358;1669;245940;203076;83648;55894;1667;613209;157285;252969;100132396;392188;5157;613211;1668;140596;100133267;10395;100133251;85002;91694;9108;137075;157697;57604;64478;728957;9639;100131608;1671;640;286046;79660;2222;29883;6542;653333;7991;55326;94137,90,0.51371073987075200000
chr22,50706851,51178264,471413,-1,1,23542;85358;644186;410;9701;5600;79924;49;6305;414918;1890;23654;113730;9997;29781;55586;91289;440836;1120;1375,20,4.24256437561119000000
chr2,149106702,149198502,91800,-1,1,55777,1,1.08932461873638000000
chr10,314639,556934,242295,-1,1,22982,1,0.41272003136672200000
chr2,30341,2859209,2828868,-1,1,7837;23040;642273;7173;54221;26751;285016;129787;52,9,0.31814846079774700000
chr16,29427215,30240227,813012,-1,1,654483;552900;283897;83719;23475;283899;548593;445329;226;613037;253982;83723;6911;11151;79447;112476;9961;107282092;79153;653808;5531;26470;253980;146378;8479;124446;9344;3835;4150;5595;79008;8448;6818;10423;6693,35,4.30497950829754000000
chr10,28017244,29941118,1923874,-1,1,84569;6840;25805;283080;283078;143098;51322;55130,8,0.41582764775655800000
chr1,168888764,176882023,7993259,-1,1,481;9588;8548;149281;2153;6402;9674;51603;27101;356;92346;57821;2328;91687;7292;460;730159;64326;63923;10560;80133;339416;8674;462;6401;5396;51430;23215;92344;63931;27252;5279;149041;92342;26052;29922;6403;2329;2326;2327;9293;55732;4653;57147;22920;60676;84614;284525;7143;55157;9910;8995,52,0.65054816815018800000
chr5,151737,11460236,11308499,-1,1,84246;10299;50834;79192;81037;11336;65980;50805;134147;153571;1501;11044;64979;22948;108;79888;10723;11076;23379;1611;4726;9037;10016;7015;6389;134145;133957;9319;340024;348932;153478;153572;651746;85409;79844;83853;57491;4552;6550;170690;79072;6715;6531;54888;134111;55722;134121;389257,48,0.42445951491882300000
chr22,18919942,21440514,2520572,-1,1,54487;27037;9342;29801;65078;10587;1312;6545;421;7290;2812;6899;5625;7625;79680;64976;6576;3053;8218;5413;80764;23617;400891;1399;7122;150209;128977;8220;388849;84861;7353;51586;2928;128989;5297;9127;9993;54584;91179;85376;8216;85359;8318;728229;5902,45,1.78530904889842000000
chr18,68207067,78010032,9802965,-1,1,125704;26251;147381;1528;55628;201456;79863;80148;400658;9150;4772;84735;644041;10194;220158;9658;284273;4155;27164;440498;81832;22850;84552;55748;374868;29090;10907;284274;7776;2587,30,0.30602985933337500000
chr2,110895981,110980401,84420,-1,1,4867,1,1.18455342335939000000
chr15,31014508,32438943,1424435,-1,1,161725;283710;54893;51621;4308;22909;1139,7,0.49142291505052900000
chr16,29673954,30197341,523387,-1,1,653808;5531;26470;283897;253980;146378;8479;83719;23475;283899;124446;9344;3835;4150;226;253982;83723;5595;6911;11151;8448;79447;112476;9961;10423;6693;79153,27,5.15870665492265000000
chr16,29673954,30197341,523387,-1,1,653808;5531;26470;283897;253980;146378;8479;83719;23475;283899;124446;9344;3835;4150;226;253982;83723;5595;6911;11151;8448;79447;112476;9961;10423;6693;79153,27,5.15870665492265000000
chr15,31014508,32438943,1424435,-1,1,161725;283710;54893;51621;4308;22909;1139,7,0.49142291505052900000
chr15,22784523,28525460,5740937,-1,1,2562;7681;123606;4948;57194;81614;2558;8924;114791;23742;7337;6638;2567;8926;283685;54551;4692;23191,18,0.31353766815417100000
chr17,14111772,15442066,1330294,-1,1,1352;64518;9953;201158;284040;100533496;5376;146822,8,0.60137082479512000000
chr15,22699701,28525460,5825759,-1,1,2562;7681;123606;4948;57194;81614;2558;8924;114791;23742;7337;6638;2567;8926;283685;54551;4692;23191;283767,19,0.32613776162041700000
chr3,138633814,143559133,4925319,-1,1,287015;668;344838;5948;9276;5947;23350;253461;26577;729627;401089;92369;5922;389152;54464;483;92370;64084;55186;9435;256356;349565;545;285195;56945;7220;5357;9616;389151;7029;131890,31,0.62940085708154100000
chr22,18919942,21440514,2520572,-1,1,54487;27037;9342;29801;65078;10587;1312;6545;421;7290;2812;6899;5625;7625;79680;64976;6576;3053;8218;5413;80764;23617;400891;1399;7122;150209;128977;8220;388849;84861;7353;51586;2928;128989;5297;9127;9993;54584;91179;85376;8216;85359;8318;728229;5902,45,1.78530904889842000000
chr18,63857253,73388988,9531735,-1,1,125704;54495;28513;147381;1528;55628;201456;92126;25914;84735;644041;10194;220158;9306;284273;79839;81832;10666;55748;29090;284274;220164,22,0.23080792741300500000
chr15,31123186,32510863,1387677,-1,1,161725;283710;54893;51621;4308;22909;1139,7,0.50444015430103700000
chr22,51123491,51219009,95518,-1,1,49;11158;85358,3,3.14076927908876000000
chr22,48457317,51219009,2761692,-1,1,85358;410;400935;85378;9701;56666;5600;49;9889;23774;80305;11158;414918;79174;9997;1120;440836;1375;415116;83642;23542;644186;23209;6300;83933;79924;79087;6305;1890;348645;23654;25817;113730;29781;55586;91289;54456,37,1.33975838000762000000
chr7,73150418,74485826,1335408,-1,1,5982;84163;7462;135886;653361;83451;1364;7461;3984;155368;81554;2969;7458;9569;2006;729438;1365,17,1.27301918215257000000
chr3,93949,6517900,6423951,-1,1,51095;51185;3568;10752;9695;285362;27255;3708;57633;8553;6419;152330;55207,13,0.20236767061268100000
chr3,73914,9689592,9615678,-1,1,2917;51095;51185;56852;9901;25917;10752;9695;285362;3708;27255;6419;51066;152330;55209;3568;29995;57633;8553;375323;859;5021;55207,23,0.23919270175228400000
chr21,47045013,48090317,1045304,-1,1,54039;54058;3275;10841;1291;54059;6285;23181;8888;1292;5116;84221;4047,13,1.24365734752761000000
chr11,120745875,129992355,9246480,-1,1,219874;53340;2900;63970;9743;84623;26595;7007;219873;56253;403312;219870;56980;219875;55572;399967;56;79607;390261;3758;26493;9638;83480;114609;79684;641654;6653;84881;55800;90952;219858;219833;63876;100169851;283162;283160;390259;390271;64221;220296;219844;390265;1111;50937;28960;4900;79864;6309;219854;390275;120224;7753;2313;219899;57476;334;219869;4013;23584;390260;414899;84897;79827;54414;219865;283159;116337;4798;399968;26492;6484;8538;54538;9538;29118;3312;390264;6734;84959;3762;2113;338662;3703;219855;80071;160065;338661,87,0.94089859059880100000
chr2,239966964,240096806,129842,-1,1,9759,1,0.77016681813280800000
chr1,849466,8343869,7494403,-1,1,57470;388588;1677;85452;83858;6146;5590;127262;728661;199990;23463;9636;100287898;8510;64856;26155;140625;55229;10911;54206;8764;65220;339456;261734;375790;388581;90326;148398;401934;80835;55735;57449;643965;51150;8784;2782;9651;1855;9731;27237;57801;3604;387509;8863;26038;126789;81669;29101;6497;339453;643988;7161;126792;8718;388591;83715;219293;163688;84808;11332;11315;388585;63976;54626;6339;11079;80772;55052;254173;148479;79258;984;54587;8514;5192;54973;339448;84069;9903;54998;9906;148870;116983;339451;390992;55966;3104;7293;118424;728642;127281;2563;55210;54991;9341;83756;142678;441869;79707;23261;1953;79906;49856,103,1.37435897162189000000
chr16,29673954,30197341,523387,-1,1,653808;5531;26470;283897;253980;146378;8479;83719;23475;283899;124446;9344;3835;4150;226;253982;83723;5595;6911;11151;8448;79447;112476;9961;10423;6693;79153,27,5.15870665492265000000
chr16,29673954,30197341,523387,-1,1,653808;5531;26470;283897;253980;146378;8479;83719;23475;283899;124446;9344;3835;4150;226;253982;83723;5595;6911;11151;8448;79447;112476;9961;10423;6693;79153,27,5.15870665492265000000
chr3,167159761,167491255,331494,-1,1,5274;5276;151790;11235,4,1.20665834072412000000
chr2,75347692,90234023,14886331,-1,1,56888;129303;8673;83439;9801;388969;51255;84173;729857;1768;130120;9168;100526767;5968;10618;10713;347730;65055;51315;22934;6869;51652;25885;6936;54884;284948;5967;925;5343;129293;2168;400966;80059;2677;10791;51318;926;5342;55818;150572;9451;84141;5068;822;10989;7844;84913;64795;55258;1496;8802;8869;4144;10578;55037;6439;344167;200523,58,0.38961917479867900000
chr16,21599687,21739885,140198,-1,1,51108;10261;146183,3,2.13983081071057000000
chr22,18919942,21440514,2520572,-1,1,54487;27037;9342;29801;65078;10587;1312;6545;421;7290;2812;6899;5625;7625;79680;64976;6576;3053;8218;5413;80764;23617;400891;1399;7122;150209;128977;8220;388849;84861;7353;51586;2928;128989;5297;9127;9993;54584;91179;85376;8216;85359;8318;728229;5902,45,1.78530904889842000000
chr2,195799327,201866832,6067505,-1,1,9262;130132;56171;285172;80219;60491;91526;53938;129450;26010;3336;79568;66037;316;5334;23451;1195;57181;205327;100529241;92935;23314;57520;9330;80055;151246;401027;25843;9689;130535;4999;284992;3329,33,0.54388088678954500000
chr2,238972972,243041364,4068392,-1,1,151176;64090;84289;5510;377007;285093;51665;339768;4705;150677;1841;129807;2859;130916;150678;2817;4735;9855;51540;9759;150681;375318;189;51078;547;79919;57140;25992;11132;389090;23192;80895;55502;3069;10494;117581;51281;285193;666;8864;26146;23178;50636;653437;5133;728294,46,1.13066784125030000000
chr15,22765628,23082821,317193,-1,1,123606;23191;114791;81614,4,1.26106187715366000000
chr7,39537355,42308129,2770774,-1,1,5898;57002;8621;136647;79783;3624;2737,7,0.25263698879807600000
chr4,130204489,141781182,11576693,-1,1,57575;80155;132430;23657;4258;80854;1047;54510;152586;1998;55534;84709;23158;7350;255520;60592;25819;83452;4717,19,0.16412286306633500000
chr2,148372337,154773465,6401128,-1,1,9111;56475;130576;151188;55777;7130;92;27249;375287;55660;785;5000;114805;130574;55183;26122;3800;26225;114793;4703;390;10254,22,0.34368942473889000000
chr11,95675329,103270554,7595225,-1,1,53942;330;114908;5241;4314;4316;143872;9313;4322;84441;7225;84259;79659;10413;4319;79780;85016;4321;57562;253935;329;4312;64066;8690;4317,25,0.32915417252286800000
chr1,16610467,21501038,4890571,-1,1,81569;4681;163933;8659;26279;11223;50809;22977;353238;126917;127733;374955;5081;9696;391013;64600;3362;55672;26099;23065;127731;84966;1650;51702;127707;978;80834;23352;11240;8574;54896;57576;30814;4237;400745;55450;54546;23400;100532736;29943;5322;79594;6390;55160;5320;55920;832;440574;23252;51154;65018;8672;255104;55707;54455;23569,56,1.14506056654734000000
chr19,3685051,4134398,449347,-1,1,84839;51341;27231;1938;5605;116541;4145;1613;23396;23217;27134;85300;9546;51588,14,3.11563223967224000000
chr1,757093,7982351,7225258,-1,1,57470;388588;1677;85452;83858;6146;5590;127262;728661;199990;23463;9636;100287898;8510;64856;26155;140625;55229;10911;8764;65220;339456;261734;375790;388581;90326;148398;401934;80835;55735;57449;643965;51150;8784;2782;9651;1855;9731;27237;57801;3604;387509;8863;26038;126789;81669;29101;6497;339453;643988;7161;126792;8718;388591;83715;219293;163688;84808;11332;388585;63976;54626;6339;11079;80772;55052;254173;148479;79258;984;54587;8514;5192;54973;339448;84069;9903;54998;9906;148870;116983;339451;390992;55966;3104;7293;118424;728642;127281;2563;55210;54991;9341;83756;142678;441869;79707;23261;1953;79906;49856,101,1.39787395827249000000
chr16,29653029,30190539,537510,-1,1,653808;5531;26470;283897;253980;146378;8479;83719;23475;283899;124446;9344;3835;4150;226;253982;83723;5595;6911;8448;79447;112476;9961;10423;6693;79153,26,4.83711930940820000000
chr16,28824857,29051191,226334,-1,1,11273;79874;7284;930;84901;27040;487;83985;25970,9,3.97642422260906000000
chr4,71552,15970500,15898948,-1,1,728373;7700;521;7469;79155;644414;55646;654254;53407;54872;9948;79441;152877;579;3166;1816;9778;10861;92305;285498;57537;100287404;728379;285550;27065;2580;53834;84179;5158;728386;152687;54360;728405;259282;57533;10417;152992;93624;345222;4043;132864;7884;170960;100287441;57732;10296;3083;100287238;768239;57654;114905;9982;100287327;1400;3954;100288520;728369;1487;100287144;8310;80273;2868;54436;9364;285464;8603;683;257236;401115;728393;133060;4636;728419;6286;166793;114932;1609;55351;2121;100287513;7468;285489;84448;353497;8842;152789;100287205;8532;10815;116449;402160;3425;4487;6047;57545;54729;6002;26234;27201;7466;10227;10336;9957;93621;84286;56606;2261;255403;8602;132884;3064;100287364;10460;85013;728400;100287478;118;152;60312;85460;94031;952;83888;23324;55330;100287178;339983;6452;5522;10608;389199,131,0.82395388676030600000
chr17,34817422,36168104,1350682,-1,1,26574;284099;9326;284098;11072;6928;79154;79922;3975;11276;79893;11056;6871;31;80179,15,1.11055007766447000000
chr3,73893353,87056706,13163353,-1,1,5067;100131827;389136;100288801;6092;253559;2632;6091,8,0.06077478891586360000
chr17,1756367,3469907,1713540,-1,1,8388;23277;55720;4994;443;63826;8387;26189;162514;79066;146760;4335;9905;8383;1801;124641;4995;8392;23293;7442;3090;4991;8386;8390;23108;5048;6117;84690,28,1.63404414253534000000
chr22,18919942,21440514,2520572,-1,1,54487;27037;9342;29801;65078;10587;1312;6545;421;7290;2812;6899;5625;7625;79680;64976;6576;3053;8218;5413;80764;23617;400891;1399;7122;150209;128977;8220;388849;84861;7353;51586;2928;128989;5297;9127;9993;54584;91179;85376;8216;85359;8318;728229;5902,45,1.78530904889842000000
chr16,29673954,30198600,524646,-1,1,653808;5531;26470;283897;253980;146378;8479;83719;23475;283899;124446;9344;3835;4150;226;253982;83723;5595;6911;11151;8448;79447;112476;9961;10423;6693;79153,27,5.14632723779463000000
chr7,75160961,76139340,978379,-1,1,83862;5447;7784;10344;6369;4191;3092;7532;113878;57414;51657;136853;222183;3315,14,1.43093831735963000000
chr10,148206,412134,263928,-1,1,22982;10771,2,0.75778242550998800000
chrX,32613846,33007664,393818,-1,1,1756,1,0.25392440162714800000
chr13,32950800,33101688,150888,-1,1,675;10443;90634,3,1.98822968029267000000
chr16,29673954,30119759,445805,-1,1,653808;5531;26470;283897;253980;146378;8479;83719;23475;283899;124446;9344;3835;4150;226;253982;83723;6911;8448;79447;112476;9961;10423;6693;79153,25,5.60783302116396000000
chr17,14111772,15442066,1330294,-1,1,1352;64518;9953;201158;284040;100533496;5376;146822,8,0.60137082479512000000
chr15,31014508,32510863,1496355,-1,1,161725;283710;54893;51621;4308;22909;1139,7,0.46780342899913500000
chr22,21798705,22916612,1117907,-1,1,7332;23753;5594;7441;8940;23532;129025;645426;29799;150221;140883;23759;150223;9647;23119;164592,16,1.43124606966411000000
chr1,68851558,72732146,3880588,-1,1,55635;9295;81573;5733;55631;9406;257194;57554;6121;11147;1491,11,0.28346219696602700000
chrX,23411104,23530035,118931,-1,1,139411,1,0.84082367086798200000
chr16,21951379,22380197,428818,-1,1,7385;730094;1039;146177;55718;29904;255762,7,1.63239416255847000000
chr6,149690745,151785667,2094922,-1,1,80328;57621;389434;79624;80329;57480;9590;84918;11104;135250;154064;387082;81706;55005;116254;25902;79465;5110;353091;23118;340152;9113;348995;85313,24,1.14562737896685000000
chr2,86592838,87105253,512415,-1,1,7844;926;55818;51652;64795;100526767;925,7,1.36608022794024000000
chr16,3363349,3879467,516118,-1,1,1773;197358;100463285;146434;23059;4993;646174;10131;7727;84464;54925;1387;79903;7627,14,2.71255798092684000000
chr16,3602421,3803649,201228,-1,1,1773;10131;84464;197358;1387,5,2.48474367384261000000
chr18,49458748,62299932,12841184,-1,1,1630;100505549;5874;51046;89778;115701;3998;80323;147372;8792;8710;9480;5275;8932;147323;5055;23327;28316;54877;5268;57614;284257;89777;55205;2235;4677;6925;5273;4160;23556;23239;30062;11201;23335;101927322;596;339302;6317;5205;6318;162681;284293;284254;220441;10892;90701;9525;5271;2531;2922;5366;9352,52,0.40494708276121600000
chr6,170426,2246781,2076355,-1,1,2295;56940;55770;2762;3662;135458;94234;2296,8,0.38529056929089700000
chr11,2604665,2606537,1872,-1,1,3784,1,53.41880341880340000000
chr11,2604665,2606537,1872,-1,1,3784,1,53.41880341880340000000
chr11,2604665,2606537,1872,-1,1,3784,1,53.41880341880340000000
chr7,150643965,150674926,30961,-1,1,3757,1,3.22986983624560000000
chr6,7578012,7581802,3790,-1,1,1832,1,26.38522427440630000000
chr6,7578012,7581802,3790,-1,1,1832,1,26.38522427440630000000
chr6,118879988,118881893,1905,-1,1,5350;387119,2,104.98687664042000000000
chr6,118879988,118881893,1905,-1,1,5350;387119,2,104.98687664042000000000
chr11,47356593,47356760,167,-1,1,4607,1,598.80239520958100000000
chr11,47367758,47371663,3905,-1,1,4607,1,25.60819462227910000000
chr12,33049443,33049690,247,-1,1,5318,1,404.85829959514200000000
chr6,7567587,7586950,19363,-1,1,1832,1,5.16448897381604000000
chr12,33049443,33049690,247,-1,1,5318,1,404.85829959514200000000
chr16,82032533,86589737,4557204,-1,1,2294;93517;29948;9764;23199;161931;3281;64779;23406;339145;9914;8720;79786;3394;10328;404550;55625;3294;1012;83693;57707;51659;54550;123872;9013;93107;83716;9100;1327;10200;146167;23417;58189,33,0.72412821545842600000
chr16,29673954,30198600,524646,-1,1,653808;5531;26470;283897;253980;146378;8479;83719;23475;283899;124446;9344;3835;4150;226;253982;83723;5595;6911;11151;8448;79447;112476;9961;10423;6693;79153,27,5.14632723779463000000
chr4,71552,3845097,3773545,-1,1,10336;7700;521;7469;401115;79155;4636;10417;84286;654254;345222;54872;1609;2261;255403;79441;4043;8602;7884;170960;57732;7468;152877;10296;3064;3083;285489;57654;353497;10460;285464;118;3954;10861;152;92305;285498;339983;10815;2580;53834;84179;5158;402160;3425;10608;6452;152687;1487;6047;54729;2868;6002;10227;8603,55,1.45751541322549000000
chr1,564424,2290021,1725597,-1,1,85452;83858;126789;5590;81669;728661;29101;199990;339453;6497;643988;9636;126792;219293;8510;163688;84808;64856;26155;81399;6339;55052;254173;80772;65220;339456;375790;984;388581;54587;54973;84069;148398;401934;54998;9906;116983;339451;643965;51150;7293;118424;728642;2563;8784;55210;2782;54991;1855;83756;142678;441869;57801;79906,54,3.12935175478400000000
chr17,29109733,30262956,1153223,-1,1,79915;79736;55352;55813;2124;84440;2123;55803;4974;4763;84282;51379,12,1.04056197283613000000
chr12,162848,6097716,5934868,-1,1,3741;4704;55846;5893;2288;57103;6540;84766;57101;7289;654429;5927;83714;93589;57102;8798;10566;10635;26290;283358;6539;440073;7004;56341;894;81029;2251;83695;775;2305;4815;84318;3736;144699;10867;7450;8074;65125;196513;4908;23085;3742;57097;79602,44,0.74138127419177600000
chr16,28824794,29042059,217265,-1,1,11273;79874;7284;930;84901;27040;487;83985;25970,9,4.14240673831496000000
chr10,148206,972654,824448,-1,1,22982;10771;23185,3,0.36387983232417300000
chrX,139531883,155190083,15658200,-1,1,4110;2157;50814;541578;2556;139067;4104;494119;139728;8517;3423;6901;474383;92002;4105;57595;266740;2332;6845;84968;64663;9142;246100;100272147;728269;100533997;3149;26576;474382;8273;728695;6535;114824;393;23641;1038;55217;8270;537;3421;100132963;6658;4101;215;91966;4100;55879;2010;4534;6134;101928917;116442;100506164;2652;84548;100133053;100129239;2334;203547;139135;139081;60343;728458;8269;10046;728712;5956;2664;79184;4515;158521;4108;2564;8263;1193;492;1260;9130;3054;7411;9947;10134;79057;84631;30014;30848;441525;554;8266;8776;29944;494118;2539;7739;8260;55559;4204;65991;5365;8277;4354;10838;139735;2316;83692;11219;10251;55558;139716;645188;51438;1736;3654;5973;139065;4109;1852;3897;474384;6748;4103;474381;9248;1069;1485;1774;64648;4107;83740;89885;100130086;633,132,0.84300877495497600000
chr16,29673954,30197341,523387,-1,1,653808;5531;26470;283897;253980;146378;8479;83719;23475;283899;124446;9344;3835;4150;226;253982;83723;5595;6911;11151;8448;79447;112476;9961;10423;6693;79153,27,5.15870665492265000000
chr16,29673954,30197341,523387,-1,1,653808;5531;26470;283897;253980;146378;8479;83719;23475;283899;124446;9344;3835;4150;226;253982;83723;5595;6911;11151;8448;79447;112476;9961;10423;6693;79153,27,5.15870665492265000000
chr22,18919942,21440514,2520572,-1,1,54487;27037;9342;29801;65078;10587;1312;6545;421;7290;2812;6899;5625;7625;79680;64976;6576;3053;8218;5413;80764;23617;400891;1399;7122;150209;128977;8220;388849;84861;7353;51586;2928;128989;5297;9127;9993;54584;91179;85376;8216;85359;8318;728229;5902,45,1.78530904889842000000
chr18,72436928,74409926,1972998,-1,1,400658;9658;284273;10194;55628;284274,6,0.30410573148072100000
chr18,74725553,74872811,147258,-1,1,4155,1,0.67908025370438300000
chr2,111399243,112777032,1377789,-1,1,55289;10461;699;64682;10018,5,0.36290026992522100000
chr22,18919942,21440514,2520572,-1,1,54487;27037;9342;29801;65078;10587;1312;6545;421;7290;2812;6899;5625;7625;79680;64976;6576;3053;8218;5413;80764;23617;400891;1399;7122;150209;128977;8220;388849;84861;7353;51586;2928;128989;5297;9127;9993;54584;91179;85376;8216;85359;8318;728229;5902,45,1.78530904889842000000
chr11,118380740,118404906,24166,-1,1,143941;84866;4297,3,12.41413556236030000000
chr16,29673954,30198600,524646,-1,1,653808;5531;26470;283897;253980;146378;8479;83719;23475;283899;124446;9344;3835;4150;226;253982;83723;5595;6911;11151;8448;79447;112476;9961;10423;6693;79153,27,5.14632723779463000000
chr21,36028883,38854467,2825584,-1,1,23562;10311;861;8208;54102;6493;1859;54093;3141;874;51227;873;7267;53820;9980;23515,16,0.56625462205335300000
chr15,34616375,37401551,2785176,-1,1,440270;9990;70;254531;256646;23015;4212;89978;55505;54989;9716;57369;84529,13,0.46675685845346900000
chr15,36794841,41016404,4221563,-1,1,90416;85455;10125;440275;56924;5330;7057;11245;3712;161742;27079;145942;57082;161835;100505573;5888;113189;283742;84529;400359;22893;4212;644844;90427;701;388115;644809;6727;90417;100131244;106821730,31,0.73432517766523900000
chr15,33707609,39190567,5482958,-1,1,440270;70;10125;256646;23015;79768;161779;89978;57099;161742;145942;283742;84529;9990;400359;6263;254531;4212;1133;55505;54989;56851;51234;9716;57369,25,0.45595826194546800000
chr15,32260104,38338675,6078571,-1,1,728047;440270;9824;70;256646;23015;79768;161779;89978;57099;145942;643699;1139;84529;9990;6263;254531;4212;653125;26585;1133;342184;55505;54989;56851;51234;9716;57369;6447,29,0.47708581507068000000
chr15,34962033,41938462,6976429,-1,1,85455;57617;440275;3706;4058;11245;3712;79094;27079;5888;2644;113189;54617;161829;51203;171177;400359;4212;644844;643338;11339;388115;11261;54866;6727;100131244;106821730;90416;26015;55192;70;10125;56924;54567;7301;5330;7057;89978;6692;55177;161742;145942;57082;161835;100505573;23168;283742;84529;22893;84936;90427;701;51103;54989;644809;9716;57369;90417,58,0.83137089189899300000
chr20,31235782,38774289,7538507,-1,1,60436;8904;85449;7052;149685;6676;25980;1869;359710;84905;284805;79980;10893;26051;2036;10904;6185;170487;8200;83737;140679;9054;51614;10544;26133;128859;23054;2691;140873;434;51282;22913;140823;57446;57644;343578;128864;11264;57148;2937;140732;2686;191;128869;9675;149951;1789;149954;10398;140699;60625;3692;22839;10137;6640;4826;128866;8894;140894;51297;22919;81610;55902;51654;5933;51230;25939;671;11190;84557;55741;140710;63905;9139;3929;128434;92747;140711;56259;83658;55969;58476;6714;100527943;79913;9584;128876;84174;58490;55245;80341;140683;128861;63941,94,1.24693125575130000000
chrX,101751021,103040701,1289680,-1,1,9737;282808;56271;340543;56849;56000;5354;27018;11013;9643;80823;90843;85012;114928;51186;55859;203562;142684;100528062;84707;79921;9338;441509;64860,24,1.86092674151728000000
chr7,69293697,70070355,776658,-1,1,26053,1,0.12875680157804300000
chr2,62362952,66353450,3990498,-1,1,4190;150684;54812;29094;57162;5013;10097;7360;9792;200728;200734;23301;5861;6509;23177;51542;51057;10678,18,0.45107152039670200000
chr15,32021733,32510863,489130,-1,1,161725;1139,2,0.40888925234600200000
chr2,138485012,145271130,6786118,-1,1,11249;339745;53353;79712;3176;9839;8942;55843,8,0.11788772314304000000
chr15,70766177,73316581,2550404,-1,1,338949;55323;3073;25820;5315;79875;54839;83440;55075;55889;10002;196993;56906;196996;123228;56965;585;4649;60677,19,0.74498001101002000000
chr1,852863,1218032,365169,-1,1,375790;388581;84069;148398;401934;339451;9636;7293;51150;118424;8784;126792;84808;54991;26155;57801;6339;254173,18,4.92922455082441000000
chr8,116508219,119696794,3188575,-1,1,401474;169026;84294;7227;441376;90390;5885;8667;2131,9,0.28225774836721700000
chr2,234285433,242782258,8496825,-1,1,54658;151176;64090;84289;339768;6694;2859;130916;64284;10267;79083;414061;54579;9759;150681;189;54578;51078;79781;57140;25992;55230;9208;54657;2637;54659;11132;389090;23192;54577;55502;3069;10494;54576;117581;54575;285193;8864;26146;23178;1293;80895;23677;10920;10123;377007;5510;51665;4705;57007;150677;1841;129807;150678;140739;2817;4735;9855;401036;51540;375318;339766;547;116987;79919;8527;51052;375316;55355;79054;54600;51281;666;50636;653437;728294,76,0.89445175109526200000
chr8,75978468,94351061,18372593,-1,1,138009;138046;4683;23462;761;3612;4325;793;169200;79752;8767;85481;157724;646480;759;389676;5569;7163;11059;92421;862;85444;79776;115111;100127983;65986;8895;51633;5828;347051;51101;55529;286144;51115;401466;245972;619279;760;64089;5375;168975;55824;2167;3574;734;1666;11075;377677;100130742;3174;54714;64168;2171;28957;646486;1875,56,0.30480183172837900000
chr22,43106282,51219009,8112727,-1,1,11252;150383;85378;25771;23151;23774;80305;11158;55267;25813;79174;150379;55007;1375;415116;83642;23542;553158;7380;6300;10343;83933;79924;23313;84247;6305;51512;1890;53947;25830;23654;25817;29781;91289;26286;26150;85358;64800;410;400935;706;2192;56666;80274;5600;9701;27127;49;9889;414918;25809;758;9997;9620;1120;440836;64781;5465;112885;29780;644186;23170;23779;23209;7477;64098;25814;80339;10762;79087;55020;27349;55687;638;348645;85352;55615;113730;55586;54456,80,0.98610491885157700000
chr15,20102541,35758169,15655628,-1,1,23015;57099;283694;643699;390538;9990;6638;22909;55505;8926;161725;283710;283685;653720;54893;283767;728498;2562;727832;9824;70;100996331;161779;4948;2558;114791;653125;653073;2567;54989;54551;56160;9716;57369;728047;321;7681;440270;256646;123606;23359;6263;254531;342184;89839;4692;1133;51234;23191;101059918;79768;89978;57194;81614;100287399;4308;1139;7082;8924;23742;51621;7337;89832;26585;56851;6447,66,0.42157363473378400000
chr15,20416244,23082821,2666577,-1,1,727832;114791;100996331;123606;283694;81614;100287399;390538;23191;283767,10,0.37501260979900400000
chr5,140955797,140958763,2966,-1,1,1729,1,33.71544167228590000000
chr10,89136373,101570391,12434018,-1,1,26509;9849;27291;142910;60495;84896;27063;9124;84171;3437;159296;8513;60370;118788;83742;340665;1559;3087;26287;84287;22849;414157;340654;953;56889;142827;51196;338557;10023;26507;51013;387707;55165;3257;6585;5223;64318;3434;9023;9211;643418;1791;1244;9562;118812;100144748;3070;3988;1355;3363;80351;81894;9060;401647;5832;7093;3433;54708;5950;29760;1562;23232;23401;64210;1558;57559;3832;9044;55328;112817;1592;84795;5146;355;84333;80019;387700;23223;26123;84458;24138;55118;643414;2805;143282;159371;143279;54619;55361;9585;5728;53354;1557;6425;10556;118932;93377;57089;84986;118813;118924;51076;439996;59;54536;3416;5507;10580,108,0.86858487739039800000
chr16,71711934,72900379,1188445,-1,1,9785;463;3240;3250;83449;164;23035;55565;342371;342372;54957;1723;9798,13,1.09386635477452000000
chr19,9186282,12166978,2980696,-1,1,7087;54850;126074;55908;79088;147741;2057;78992;81890;84337;374882;163059;53637;9545;125963;54811;10053;7620;6597;115948;90594;100529215;125958;11140;7297;390882;55552;126075;50509;8666;51073;50700;57693;162993;3949;147841;90580;390883;10498;112812;126070;126069;3609;1264;84971;162998;1785;90592;25959;9294;51295;3386;199692;692312;59286;55337;57572;125962;1786;1032;729747;93145;56342;5589;5300;57139;64748;1995;5141;115950;126068;65095;83854;9817;93134;11018;284390;57153;374879;26648;7675;125950;84527;54;26526;100125288;255809;7730;3383;10781;5032;3385,92,3.08652744191290000000
chr11,3174176,5407297,2233121,-1,1,55128;56547;7748;401666;390036;256892;27315;282763;390038;114879;119772;116534;390037;23538;3048;3045;143501;4928;119692;79345;3046;283111;390054;390058;6786;119678;79339;417;57053;6737;119682;143502;391;119774;3047;401665;79324;386746;119694;3043;119687;81285;401667;6240;116969;143496;81282;119695;119679;143503,50,2.23901884403040000000
chr22,21799773,23654237,1854464,-1,1,7332;23753;5594;7441;2781;100423062;613;8940;23532;129025;645426;29799;91227;140883;23759;150223;9647;27156;150221;23119;9609;164592,22,1.18632661512976000000
chr3,8749500,9696040,946540,-1,1,55209;56852;25917;9901;64419;375323;859;5021,8,0.84518351046971100000
chr7,29883911,51805320,21921409,-1,1,64983;9263;1395;816;358;100130988;84725;445347;2692;154664;27072;644;80820;27241;80099;223075;136288;165;11185;23386;10320;222068;5137;9238;11281;28988;256979;222166;375567;168507;2617;64224;5224;29881;3624;3484;5814;3364;273;117;57057;54606;5478;23333;9844;401335;223082;8621;55744;5425;989;2737;100534592;94239;285955;9805;387129;23148;10392;5683;353345;10268;57002;7378;79783;3486;168667;644150;51619;27434;64005;58498;55033;83930;64951;6100;313;10652;11055;4967;11328;84182;54443;2887;83637;63979;63974;51314;5898;23366;23080;107;6424;136647;10842;79020;83605;25948;2645;64759;51251;1644;23242;54749;55665;23658;23072;79017,108,0.49266906155530400000
chr3,123633665,128506246,4872581,-1,1,2624;200810;152015;28999;4171;54763;166348;131601;57493;114885;7707;56667;29927;131669;6184;8997;80325;165721;5361;285311;11343;84561;60678;8723;10840;7879;84303;645840;166012;3693;64770;79364;50512;54946;8607;348807;114112;152065;7372,39,0.80039716117597600000
chr16,89351798,89412086,60288,-1,1,100287036;29123,2,3.31740976645435000000
chr15,34363958,37792285,3428327,-1,1,440270;70;256646;23015;79768;161779;89978;84529;9990;254531;4212;55505;54989;56851;51234;9716;57369,17,0.49586868463830900000
chr2,200136988,200137077,89,-1,1,23314,1,1123.59550561798000000000
chr2,165578422,167108554,1530132,-1,1,6326;79809;2591;6335;6323;151258;22837;6328;80034,9,0.58818454878402600000
chr11,119535331,126343427,6808096,-1,1,219874;53340;2900;84623;26595;7007;219873;23650;5818;56253;403312;219870;219875;55572;399967;56;79607;390261;26493;9638;83480;114609;79684;641654;6653;84881;55800;90952;219858;63876;100169851;283162;219899;390259;283160;219844;23365;390271;390265;4900;64221;220296;1111;50937;28960;79864;6309;219854;390275;7753;57476;219869;4013;23584;390260;414899;84897;79827;54414;219865;283159;116337;399968;26492;6484;54538;9538;29118;3312;390264;6734;84959;219902;338662;3703;25833;219855;80071;160065;338661;220323,81,1.18975995638134000000
chr18,52845153,52913848,68695,-1,1,6925,1,1.45571002256351000000
chr5,124622096,135437935,10815839,-1,1,3950;9555;645121;347732;8974;56951;100127206;54819;90624;51808;91368;3596;3659;3308;133619;389320;6584;79770;116842;6583;3565;23305;65983;7045;84466;84105;497189;6500;11127;4001;134549;100996485;9879;6932;51735;401207;501;96459;171019;10111;134548;5307;23338;6558;10802;337876;28965;140947;5515;728586;7320;819;27125;115123;26223;23176;27089;3578;1437;3567;728637;23105;9547;2201;3094;51128;134553;8572;3562;51015;153328;56990;7416;51265;613212;4762;2661,77,0.71191888118896700000
chr12,116680342,117237457,557115,-1,1,84900;23389;643246;79794,4,0.71798461717957700000
chr1,244982781,245837910,855129,-1,1,55083;116228;3192;84288,4,0.46776568213684700000
chr11,118354782,118362888,8106,-1,1,4297,1,12.33654083395020000000
chr1,93811483,98850435,5038952,-1,1,8412;2730;24;1266;100527978;1806;30836;2152;199857;58155;1810;148534;126969;54874;5825;9411;25950,17,0.33737173920291400000
chr6,98966910,101858361,2891451,-1,1,51805;59336;100130890;84539;84553;2898;892;26235;85015;10973;5454;6492;25957,13,0.44960125556338300000
chr15,38574924,38591720,16796,-1,1,161742,1,5.95379852345797000000
chr8,119827449,120540076,712627,-1,1,10584;4982;4856;114569,4,0.56130345889224000000
chr5,88133089,88427361,294272,-1,1,4208,1,0.33982166159199700000
chr1,1887005,7581058,5694053,-1,1,57470;388588;85452;1677;26038;6146;5590;127262;199990;6497;23463;7161;100287898;83715;8718;388591;11332;140625;388585;63976;55229;54626;8764;11079;261734;79258;148479;5192;8514;90326;339448;9903;148870;80835;390992;57449;55735;55966;3104;127281;2563;9651;9731;27237;79707;23261;1953;79906;49856;387509,50,0.87810914299533200000
chr14,105133696,107287708,2154012,-1,1,647310;23241;1397;283643;90135;122616;207;64423;55038;9112;122622;3714;10572;283638;100128927;1396;29933;122618;80757;113146;2972;256281,22,1.02134992748416000000
chr6,156653087,157968773,1315686,-1,1,57492;79683;729515,3,0.22801793133012000000
chr3,10672936,12182018,1509082,-1,1,10533;3269;9686;6538;6529;132001;6854,7,0.46385816012648800000
chr12,116460066,116463879,3813,-1,1,23389,1,26.22606871230000000000
chr17,43618006,44408089,790083,-1,1,162540;100506084;284058;246744;104909134;9884;1394;4137,8,1.01255184581873000000
chr15,74399212,78211538,3812326,-1,1,57184;1445;192683;10073;84993;79661;64843;653641;9051;9377;10620;56905;79748;5955;57611;1543;54939;10363;49855;79834;2108;1544;55272;10099;84894;5780;25989;92912;10066;64220;60490;653643;1464;257364;1198;161753;105376731;594855;8482;80153;3671;1583;54913;80125;4351;4123;25942;26263;123591;145957,50,1.31153526744565000000
chrX,153296088,153296272,184,-1,1,4204,1,543.47826086956500000000
chr1,19085152,22542549,3457397,-1,1,4681;163933;8659;26279;50809;22977;126917;127733;1889;391013;64600;3362;5909;84196;23065;127731;1650;978;23352;80834;8574;10136;54896;57576;30814;400745;55450;54546;100532736;5322;79594;84224;401944;3339;998;54361;5320;832;440574;23252;51154;65018;8672;255104;23436;249,46,1.33048070557127000000
chr2,223092734,223100189,7455,-1,1,5077,1,13.41381623071760000000
chr1,27835713,28494006,658293,-1,1,9473;27293;2140;2268;5724;2537;6118;23673;199870;5511;55113;27245,12,1.82289649137998000000
chr1,145752382,148936712,3184330,-1,1,9557;728945;284565;2330;653519;149013;5174;644591;51205;645142;51463;5565;607;2702;730262;200030;2703,17,0.53386426658041100000
chr16,21907936,22448233,540297,-1,1,7385;730094;1039;146177;55718;29904;255762,7,1.29558372524741000000
chr7,5151474,6296948,1145474,-1,1,60;5395;54476;51622;84132;9265;84629;222967;7965;222962;100310846;80028;6624;26100;654231;27102,16,1.39680167336840000000
chr6,146463096,150217447,3754351,-1,1,134957;84918;389432;11104;135250;387082;79747;2911;116254;23328;10090;5110;23118;340152;9113;10981;348995;85313,18,0.47944371743611600000
chr22,44735500,51169045,6433545,-1,1,85358;150383;410;400935;85378;2192;56666;5600;9701;27127;25771;23151;23774;9889;80305;414918;55267;79174;9997;9620;1120;440836;55007;64781;5465;1375;112885;415116;83642;23542;553158;644186;7380;23779;23209;6300;10343;83933;79924;7477;25814;23313;10762;79087;55020;84247;55687;6305;51512;1890;348645;55615;23654;25817;113730;29781;55586;91289;54456;26150,60,0.93261180266866900000
chrX,27546636,37473937,9927301,-1,1,442444;4113;257397;190;11141;158724;139422;170062;83604;1756;347442;139604;4114;80231;139425;4112;4115;53940;347404;441490;286464;5638;2710,23,0.23168432185142800000
chr3,195684950,197317103,1632153,-1,1,622;255798;80235;200933;5062;5130;4241;26043;1739;84984;348793;255758;116211;131540;200931;375387;22916;7037;165918;54965;205564,21,1.28664408299957000000
chr16,29473252,30215624,742372,-1,1,653808;654483;5531;26470;283897;253980;146378;8479;83719;23475;283899;548593;124446;9344;3835;4150;445329;226;253982;83723;5595;6911;11151;6818;79447;112476;8448;9961;10423;6693;79153,31,4.17580404433357000000
chr3,41177103,41614509,437406,-1,1,1499;54986,2,0.45724109865891200000
chr17,42811217,42980665,169448,-1,1,10052;80174;51751;9343;4185;388389,6,3.54090930550965000000
chr17,42953106,42961328,8222,-1,1,9343,1,12.16249087813180000000
chr18,142096,12715473,12573377,-1,1,116;55556;10403;23255;57132;8774;645369;84203;57045;103910;642597;84617;9097;7525;147495;10650;9218;3613;5797;494514;1149;56984;10939;1068;65258;79959;9229;79822;84034;4729;7298;91133;11031;23253;9663;56907;9989;7050;339291;9984;81035;10928;2774;23347;63895;10627;201475;64863;8736;342850;27098;284217;646000;23136;7541,55,0.43743220297935900000
chr5,88123099,88220350,97251,-1,1,4208,1,1.02826706152122000000
chrX,71791885,71793157,1272,-1,1,55869,1,78.61635220125790000000
chr22,18844632,21091640,2247008,-1,1,54487;27037;29801;65078;10587;1312;8214;7290;421;2812;6899;5625;7625;79680;64976;6576;8218;5413;23617;7122;128977;8220;388849;84861;7353;51586;2928;128989;5297;9993;54584;91179;85376;85359;8318;728229;5902,37,1.64663410188126000000
chr16,29673954,30197341,523387,-1,1,653808;5531;26470;283897;253980;146378;8479;83719;23475;283899;124446;9344;3835;4150;226;253982;83723;5595;6911;11151;8448;79447;112476;9961;10423;6693;79153,27,5.15870665492265000000
chr10,93660359,96058433,2398074,-1,1,26509;55165;143282;159371;54708;9211;5950;340665;3087;22849;118924;3832;54536;9044;3416;51196;338557;1592;5146,19,0.79230248941442200000
chrX,6552712,8097511,1544799,-1,1,412;8228;26609;8226,4,0.25893336285173700000
chr8,131439067,137394091,5955024,-1,1,6482;10086;8840;137835;114;729330;7038;51105;6503;10397;57623;23167;3786;50807;23639;10656,16,0.26868069717267300000
chr22,18919942,21798755,2878813,-1,1,54487;27037;9342;29801;65078;10587;1312;6545;421;7290;2812;6899;5625;7625;79680;23119;64976;6576;3053;8218;5413;80764;23617;400891;1399;7122;150209;128977;8220;388849;84861;7353;51586;2928;128989;5297;9127;9993;54584;91179;85376;8216;440804;85359;8318;728229;5902,47,1.63261733221296000000
chr18,51304204,54324177,3019973,-1,1,8932;147323;5874;162681;6925;284254;80323;11201;23335;9352,10,0.33112878823751100000
chr6,1612710,2435118,822408,-1,1,2762;2296,2,0.24318829583369800000
chr15,20481702,23076420,2594718,-1,1,727832;114791;100996331;123606;283694;81614;100287399;390538;23191;283767,10,0.38539833615830300000
chr15,36989551,37184183,194632,-1,1,4212;84529,2,1.02758025401784000000
chr22,21134126,21440514,306388,-1,1,80764;9342;3053;8216;400891;1399;6545;150209;9127;5297,10,3.26383539825320000000
chr15,23573296,28903925,5330629,-1,1,2562;7681;23742;8924;7337;6638;2567;4948;8926;57194;283685;54551;4692;2558,14,0.26263317143248900000
chr8,84544461,88493918,3949457,-1,1,138046;761;51115;401466;245972;760;85481;168975;157724;759;377677;11059;85444;54714;8895;1875,16,0.40511898217906900000
chr16,29673954,30119759,445805,-1,1,653808;5531;26470;283897;253980;146378;8479;83719;23475;283899;124446;9344;3835;4150;226;253982;83723;6911;8448;79447;112476;9961;10423;6693;79153,25,5.60783302116396000000
chr15,22784523,23179948,395425,-1,1,123606;23191;114791;81614,4,1.01156982992982000000
chr22,18889039,21464119,2575080,-1,1,54487;27037;9342;29801;65078;10587;1312;6545;8214;7290;421;2812;6899;5625;7625;79680;64976;6576;3053;8218;5413;80764;23617;400891;1399;7122;150209;128977;8220;388849;84861;7353;51586;2928;128989;5297;9127;9993;54584;91179;85376;8216;85359;8318;728229;5902,46,1.78635226866738000000
chr2,42444,2606073,2563629,-1,1,7837;23040;642273;7173;54221;26751;285016;129787;52,9,0.35106483816496100000
chr8,8101641,11898209,3796568,-1,1,1508;83650;83595;203076;2626;83648;613210;137075;613209;157285;640;66036;252969;286046;79660;2222;54984;613211;4482;8658;203074;9258;90459;94137,24,0.63214987852186500000
chr16,89299887,89534655,234768,-1,1,100287036;29123,2,0.85190485926531700000
chr10,148206,1232090,1083884,-1,1,22982;105;22884;10771;3422;23560;91734;23185,8,0.73808636348539100000
chr16,28543104,30198600,1655496,-1,1,552900;283897;83719;23475;283899;487;26471;445329;25970;226;253982;83723;11273;79874;6911;79447;112476;112869;728734;11151;9961;83985;107282092;79153;653808;6799;5531;26470;8663;27040;253980;7284;146378;8479;124446;9344;3835;4150;728888;100507607;5595;79008;8448;930;84901;10423;6817;6693,48,2.89943316081706000000
chr16,2117089,2145976,28887,-1,1,5310;7249,2,6.92352961539793000000
chr2,198591896,204324671,5732775,-1,1,843;8837;285172;51602;60491;55759;130540;53938;129450;57404;26010;130026;65065;57679;79568;66037;316;4709;5334;100652824;58538;1195;65062;65061;79800;205327;8324;150864;65059;151254;23314;66008;10152;841;151246;55437;7341;659;9689;130535;4999,41,0.71518592653645000000
chr16,26746122,31394579,4648457,-1,1,100862671;146547;654483;162083;552900;23247;26000;83719;23475;487;29108;613037;10847;79724;83723;6810;6911;79874;11151;146395;79447;728734;83985;197407;339105;93129;78994;9739;50615;54620;653808;64319;9726;6799;146542;8663;27040;253980;146378;8479;124446;1731;3687;728888;5261;2521;23361;3683;5595;930;728741;84901;84148;79001;10423;29895;388228;6693;79831;10421;23214;283897;22928;730183;112755;283899;548593;26471;197370;445329;728689;25970;226;1489;90835;253982;51333;493829;11273;112476;112869;9961;9810;79759;10295;115509;107282092;79077;1201;79153;5652;260434;5531;26470;7284;9344;3835;80270;4150;246778;3684;9274;100507607;65988;55911;146540;3566;79008;8448;6818;92595;6817;2975,113,2.43091417216509000000
chr22,47456239,51182534,3726295,-1,1,85358;410;400935;85378;9701;56666;5600;49;25771;9889;23774;80305;414918;79174;9997;1120;440836;1375;415116;83642;23542;644186;23209;6300;83933;79924;79087;6305;1890;348645;23654;25817;113730;29781;55586;91289;54456,37,0.99294339283390100000
chr6,113381924,129540205,16158281,-1,1,441168;25842;221303;51389;345895;51020;23493;2173;221302;254228;222546;57515;7259;285761;254394;221301;154215;5350;3066;222553;387357;222545;116150;23270;84870;352999;60487;2444;100128327;3298;81847;6098;5570;79632;221294;10345;387104;3841;154214;7164;135112;245806;29940;5796;387103;57120;4121;9729;135114;55862;1300;387119;134829;4082;222537;221322;3908;10924;2697,59,0.36513785098798600000
chr16,29159416,33286258,4126842,-1,1,100862671;146547;654483;552900;26000;83719;23475;3681;29108;613037;10847;79724;83723;6810;6911;11151;79447;197407;339105;93129;78994;7041;9739;54620;653808;64319;9726;146542;253980;146378;8479;124446;1731;3687;728888;5261;2521;10308;23361;3683;5595;1339;653550;84148;79001;283933;10423;29895;124411;6693;10421;283897;22928;730183;112755;283899;548593;445329;1489;226;90835;253982;51333;493829;79798;112476;9961;9810;79759;24150;729355;10295;115509;107282092;79077;79153;5652;260434;51327;5531;26470;729264;9344;3835;80270;4150;3684;9274;65988;146540;6524;79008;8448;6818;92595;64755,96,2.32623395807254000000
chr1,218125595,224931361,6805766,-1,1,64853;64757;23219;8560;11221;7042;4931;79802;51018;149111;80232;375056;127018;25782;79762;164127;824;2058;7159;3142;55061;7100;55532;84976;388743;9015;400823;10380;29097;4139;54996;148362;55699,33,0.48488296541491400000
chr1,8633117,10926462,2293345,-1,1,10277;100526739;56998;84275;199953;9563;80045;1325;5195;54897;22883;2023;80176;64802;116362;5226;1676;473;765;84328;378708;23095;6518;155184;5293,25,1.09011073344830000000
chr16,28399998,30226024,1826026,-1,1,654483;552900;283897;83719;23475;283899;487;548593;26471;445329;728689;25970;226;253982;83723;11273;79874;6911;79447;112476;112869;728734;11151;9961;83985;107282092;1201;79153;653808;6799;5531;26470;8663;27040;253980;7284;146378;8479;124446;9344;3835;4150;246778;728888;100507607;55911;5595;79008;8448;6818;930;84901;10423;6817;6693,55,3.01200530551044000000
chr2,147969189,150146866,2177677,-1,1,130576;55777;92;26122;5000;3800,6,0.27552295404690400000
chr6,96200844,99629252,3428408,-1,1,29078;253714;23376;9457;26235;114792;81491;5454;10690,9,0.26251251309645800000
chr3,61865579,68646642,6781063,-1,1,9861;55079;57415;6314;115286;8618;132204;8801;26018;84541;80145;407738;132203;56999;166336;9223;5793,17,0.25069815750126500000
chr6,156974,4143585,3986611,-1,1,10455;404220;56940;389362;2762;1992;4835;94234;2296;8899;8737;63027;2295;56897;222826;55770;670;340156;7280;347733;221749;5272;26240;3662;135458;5269,26,0.65218301961239800000
chr17,1075201,2034207,959006,-1,1,10594;286753;124935;727910;5345;29;8578;4641;146760;83547;114826;124997;1801;5176;124641;1398;7531;23293;5306;3090;727857;6117;51763,23,2.39831659030288000000
chr7,36023150,45096115,9072965,-1,1,64983;9263;816;353345;445347;5683;57002;79783;27072;51619;644;27434;80820;58498;64005;83930;64951;165;313;10652;23386;222068;4967;28988;11281;54443;83637;5224;29881;3624;23366;51314;5898;5814;6424;273;136647;79020;54606;5478;9844;83605;8621;2645;55744;5425;285955;2737;54749;55665;23072;100534592;94239,53,0.58415303045917200000
chr2,200400265,209942199,9541934,-1,1,1493;130749;54891;57683;3417;51602;130540;53938;129450;57404;26010;65065;389072;57679;8828;4709;79800;151195;8324;200576;2825;117583;66008;1419;151246;1933;8609;55437;659;29851;9689;130535;1385;200726;940;843;8837;285172;391475;60491;151194;55759;4719;1421;130026;79568;316;100652824;58538;1195;65062;65061;389073;205327;150864;65059;151254;1418;10152;130752;841;7855;5746;8745;7341;22868;4999;1420,68,0.71264378898449700000
chr2,44507915,44556286,48371,-1,1,9581;6519,2,4.13470881313184000000
chr3,192229515,197532175,5302660,-1,1,131583;622;80235;200933;57110;84239;5062;5130;151963;55341;255758;116211;93109;152002;131540;200931;375387;22916;23527;7037;165918;54965;84859;2814;79572;84248;255798;1370;344905;10188;26043;4241;347;131578;1739;4976;348793;84984;3280;5504;9711;2257;200958;4585;205564,45,0.84863068723998900000
chr16,54965673,60340122,5374449,-1,1,64785;2806;1258;4490;6361;79190;4489;4495;84560;23019;55238;92922;57017;57019;1459;583;51090;89970;57567;5432;84290;23568;79650;9289;29105;2775;222487;388282;1071;4313;9688;6559;221188;4504;54947;4499;6367;55239;6530;79918;4493;55715;10265;84229;221223;11051;1066;9709;6376;221191;4501;84166;10300;80011;4324;267;3801;374739;4494;221184;29070;4502;4496;65009,64,1.19081974728944000000
chr6,92138719,106099894,13961175,-1,1,253714;59336;100130890;23376;84539;84553;11149;9457;114792;389421;81491;6492;29078;51805;57531;2045;79694;5550;64208;2898;892;85015;10973;26235;5454;25957;10690,27,0.19339346437531200000
chrX,32514287,32642460,128173,-1,1,1756,1,0.78019551699655900000
chr1,8430508,11435036,3004528,-1,1,10277;100526739;56998;84275;199953;1325;22883;10747;80176;5226;1676;765;378708;6518;9563;148345;80045;5195;54897;2023;64802;116362;473;84328;6723;23095;2475;10218;23435;29914;155184;5293;5394,33,1.09834223545262000000
chr22,21926261,23603489,1677228,-1,1,7332;23753;5594;7441;2781;100423062;613;8940;23532;129025;91227;29799;140883;23759;150223;9647;27156;9609;164592,19,1.13282153648759000000
chr17,1251812,2339591,1087779,-1,1,10594;55720;124935;63826;727910;5345;8578;79066;4641;146760;83547;114826;9905;4335;124997;1801;5176;124641;1398;7531;23293;5306;3090;6117;51763,25,2.29826095190291000000
chr15,23739358,28525460,4786102,-1,1,2562;7681;23742;8924;7337;6638;2567;4948;8926;57194;54551;4692;2558,13,0.27161978578810100000
chr16,29673954,30198600,524646,-1,1,653808;5531;26470;283897;253980;146378;8479;83719;23475;283899;124446;9344;3835;4150;226;253982;83723;5595;6911;11151;8448;79447;112476;9961;10423;6693;79153,27,5.14632723779463000000
chr15,22784523,23179948,395425,-1,1,123606;23191;114791;81614,4,1.01156982992982000000
chr16,29673954,30198600,524646,-1,1,653808;5531;26470;283897;253980;146378;8479;83719;23475;283899;124446;9344;3835;4150;226;253982;83723;5595;6911;11151;8448;79447;112476;9961;10423;6693;79153,27,5.14632723779463000000
chr16,29592783,30190568,597785,-1,1,653808;5531;26470;283897;253980;146378;8479;83719;23475;283899;124446;9344;3835;4150;226;253982;83723;5595;6911;8448;79447;112476;9961;10423;6693;79153,26,4.34938983079201000000
chr7,72726578,74139390,1412812,-1,1,5982;51085;9275;84277;7462;135886;83451;1364;135892;6804;7461;155382;3984;26608;8468;9031;155368;2969;8326;7458;9569;2006;1365;114049,24,1.69873981817821000000
chr16,28837450,29042118,204668,-1,1,11273;27040;79874;7284;930;84901;487;83985;25970,9,4.39736548947564000000
chr15,31014508,32914140,1899632,-1,1,9824;51621;653125;22909;161725;283710;54893;643699;4308;728047;1139,11,0.57905952310763400000
chr15,31014508,32510863,1496355,-1,1,161725;283710;54893;51621;4308;22909;1139,7,0.46780342899913500000
chr15,22784523,23179948,395425,-1,1,123606;23191;114791;81614,4,1.01156982992982000000
chr16,28837450,29042118,204668,-1,1,11273;27040;79874;7284;930;84901;487;83985;25970,9,4.39736548947564000000
chr4,22422757,30839629,8416872,-1,1,51091;389203;166647;886;5099;10891;29945;55203;29063;23231;3516;1665;6649;91050;55300;55296;57620;10568,18,0.21385616889504800000
chr22,18894864,21440484,2545620,-1,1,54487;27037;9342;29801;65078;10587;1312;6545;8214;421;7290;2812;6899;5625;7625;79680;64976;6576;3053;8218;5413;80764;23617;400891;1399;7122;150209;128977;8220;388849;84861;7353;51586;2928;128989;5297;9127;9993;54584;91179;85376;8216;85359;8318;728229;5902,46,1.80702540049183000000
chr1,145899368,147824177,1924809,-1,1,9557;51205;51463;2703;5565;607;2702;2330;200030;149013,10,0.51953206785712200000
chr6,97764445,101805148,4040703,-1,1,51805;59336;100130890;84539;84553;892;26235;85015;10973;5454;6492;25957,12,0.29697802585342200000
chr3,42167061,46303826,4136765,-1,1,1238;1232;353274;100506243;22908;285349;57456;91392;56992;79443;7047;54585;9117;25994;131375;152206;729085;25907;8994;7584;10168;23016;51099;23395;10663;10803;131377;51188;55888;92999;64866;54861;7123;57467;1230;131616;885;285346;22906;285343;84892;54716;7433;55129;375337;4820;115560;2829;1582;51304;389114,51,1.23284740612532000000
chr9,639010,1411809,772799,-1,1,1761;58524;10655;23189,4,0.51759901345628000000
chr22,18919942,21440514,2520572,-1,1,54487;27037;9342;29801;65078;10587;1312;6545;421;7290;2812;6899;5625;7625;79680;64976;6576;3053;8218;5413;80764;23617;400891;1399;7122;150209;128977;8220;388849;84861;7353;51586;2928;128989;5297;9127;9993;54584;91179;85376;8216;85359;8318;728229;5902,45,1.78530904889842000000
chr4,71552,5506588,5435036,-1,1,7700;521;7469;401115;79155;4636;133060;55646;654254;166793;54872;53407;1609;55351;79441;7468;152877;285489;353497;10861;92305;285498;10815;27065;2580;53834;84179;5158;402160;3425;152687;4487;6047;54729;6002;54360;10227;10336;10417;84286;345222;2261;255403;4043;8602;7884;170960;57732;10296;3064;3083;57654;10460;85013;118;3954;152;339983;6452;10608;1487;2868;285464;8603,64,1.17754509813734000000
chr17,43706686,44208177,501491,-1,1,246744;162540;104909134;1394;4137;284058,6,1.19643223906311000000
chr15,31014508,32510863,1496355,-1,1,161725;283710;54893;51621;4308;22909;1139,7,0.46780342899913500000
chr3,38569412,38842912,273500,-1,1,6336;6331,2,0.73126142595978100000
chr15,20686218,28940068,8253850,-1,1,2562;7681;727832;100996331;123606;4948;57194;283694;81614;100287399;390538;2558;8924;114791;23742;7337;6638;2567;8926;283685;54551;4692;23191;283767,24,0.29077339665731700000
chr3,177369717,183212044,5842327,-1,1,51193;51555;55669;6657;27094;5290;86;151613;339829;23101;8087;10242;57129;4711;8975;84002;59345;23200;54165;89857;64393;56922;27074;131118,24,0.41079521909677400000
chr11,121829034,131225064,9396030,-1,1,219874;53340;63970;9743;84623;26595;219873;283171;56253;403312;219870;56980;219875;55572;6768;399967;56;79607;390261;3758;26493;9638;83480;114609;79684;641654;84881;55800;90952;219858;219833;63876;100169851;283162;283160;390259;390271;64221;220296;219844;390265;1111;50937;28960;4900;79864;219854;390275;120224;7753;2313;57476;334;219869;4013;23584;390260;414899;84897;79827;54414;219865;283159;116337;4798;399968;26492;6484;8538;170689;54538;9538;29118;399979;3312;390264;6734;84959;3762;2113;338662;3703;11095;219855;80071;160065;338661;29068,88,0.93656576234856600000
chr17,34817422,36168104,1350682,-1,1,26574;284099;9326;284098;11072;6928;79154;79922;3975;11276;79893;11056;6871;31;80179,15,1.11055007766447000000
chr15,32021733,32510863,489130,-1,1,161725;1139,2,0.40888925234600200000
chr18,69874100,78012800,8138700,-1,1,125704;26251;147381;1528;55628;201456;79863;80148;400658;9150;4772;84735;644041;10194;9658;284273;4155;27164;440498;81832;22850;84552;55748;374868;29090;10907;284274;7776;2587,29,0.35632226276923800000
chr2,237232776,243041364,5808588,-1,1,151176;64090;84289;10920;377007;5510;285093;51665;728294;339768;4705;57007;150677;1841;129807;2859;130916;64284;150678;10267;140739;2817;4735;79083;51540;5133;9759;150681;375318;189;51078;547;79781;79919;57140;25992;51052;9208;375316;11132;389090;23192;55502;3069;10494;117581;51281;285193;666;8864;26146;23178;50636;653437;1293;80895;9855,57,0.98130561162196400000
chr18,60985994,77982126,16996132,-1,1,125704;54495;28513;147381;89778;1528;55628;201456;79863;400658;8710;25914;84735;644041;5275;4772;9306;9658;5055;4155;27164;440498;81832;5268;89777;1005;26251;5273;80148;92126;9150;10194;596;220158;6317;6318;284273;284293;79839;22850;10666;84552;55748;374868;9525;5271;2531;10907;29090;284274;7776;220164;2587,53,0.31183565766610900000
chr21,45479335,48056450,2577115,-1,1,7109;386674;386675;386683;386672;5211;54084;6573;6285;3689;8209;104;353332;5822;4047;386679;54039;54058;386676;386677;386680;353333;23181;386681;23275;326;23308;386678;754;3275;54059;8888;1292;5116;84221;29947;386684;80781;7327;6612;755;386682;10841;1291;81543;7226;85395;386685;353323,49,1.90135092923676000000
chr15,31014508,32510863,1496355,-1,1,161725;283710;54893;51621;4308;22909;1139,7,0.46780342899913500000
chr6,139693560,147868274,8174714,-1,1,134637;83443;257218;134957;389432;10370;57211;7957;8504;84946;79747;84085;2519;7402;51390;2911;51534;4829;153918;5325;8676;9749;3097;10981,24,0.29358825275110500000
chr15,31014508,32510863,1496355,-1,1,161725;283710;54893;51621;4308;22909;1139,7,0.46780342899913500000
chr7,96276166,101703138,5426972,-1,1,24146;64816;6863;8896;1551;221914;255374;4885;55262;81844;3268;221908;51593;7979;10980;89122;4951;10095;375607;4584;64598;81628;136227;100861540;25798;9551;6878;2783;7586;100526740;563;7589;7036;1750;5054;101927655;285989;222865;55971;7425;440;10467;10552;1576;1577;55063;93408;222950;100316904;23660;1749;57001;64599;346606;81392;57154;245812;221785;8985;26261;79027;402569;4176;79037;7551;56257;352954;140453;79690;349149;441272;2056;402682;10071;1174;43;11333;2050;10898;51024;7455;389541;7205;64792;1523;9179;22853;8295;84124;402573;10734;29992;29990;168620;25851;56996;221786;4034;26024;100289187;51412;5118;10248,103,1.89792761046123000000
chrX,113032051,155159533,42127482,-1,1,23157;541578;2158;55609;2556;23439;494119;8517;331;3423;4168;6901;474383;5358;92002;57595;51442;266740;102723737;389895;644538;51213;79649;100272147;728269;3149;26576;474382;3547;102723680;3358;8273;728695;57826;83844;114824;203413;8862;23641;7512;158763;55217;8270;537;3421;8450;6658;139804;4101;959;91966;441519;4100;57631;2010;27316;54521;4534;51634;653282;728072;728096;101928917;9363;3920;100506164;84548;90293;55511;100133053;203547;139135;79836;139081;203522;51765;60343;139818;56180;27336;728458;8269;7626;10046;340578;63932;4515;158798;100130613;4108;2564;728075;1193;1260;3054;84631;102723631;170261;441525;554;29944;2539;7739;8260;57481;139170;4204;65991;6170;10813;2316;11219;728062;55558;2000;645188;51438;1736;255313;3654;1852;3897;727940;10857;541466;139741;1069;1485;159090;1774;2258;643311;4107;203523;54967;89885;286410;633;83550;4110;3598;6594;2157;50814;57187;139067;4104;203427;139728;10479;9016;55026;100507170;10178;4105;2332;6845;84968;4068;51114;64663;9142;246100;100533997;79576;6535;393;1038;158800;55796;10761;100132963;215;90167;292;7737;55879;7319;6134;116442;2652;10009;2747;10495;100129239;2239;2334;441518;26071;5956;728712;2664;55922;28985;79184;441521;728090;728049;8933;10735;158521;4694;84528;8263;492;9130;100129520;728082;7411;347454;29071;9947;10134;79057;30014;680;30848;93380;159091;8266;65109;8776;494118;2892;55559;5365;8277;63035;4354;10838;139735;83692;3251;10251;139716;84295;9459;139065;4109;5973;474384;6748;139760;347487;51270;4103;139378;186;9131;3597;2719;7547;9248;474381;11254;90161;728042;2273;728036;64648;54440;4952;83740;100130086;347468;347475,266,0.63141680293163500000
chr5,155312750,164166203,8853453,-1,1,3702;348938;3161;9685;26762;114825;9232;7265;134353;1879;79616;84868;147;153745;153830;408263;6444;134510;900;2566;23120;63920;3593;2554;26999;10569;2559;8728;9443;114898;91937;100190949;27430;11063;2561;134492;2172;54974,38,0.42921106601006400000
chr10,81697501,88864922,7167421,-1,1,657;27069;84332;23063;54537;81619;5995;387694;79812;2746;119385;80195;10718;643161;26103;4143;387695;219348;6623;143241;92211;6441;54462;94233;2894;84293;340745;10974;11155;311,30,0.41856059522665100000
chr18,148992,14081857,13932865,-1,1,116;55556;10403;23255;57132;4158;8774;645369;84203;125228;57045;103910;642597;84617;9097;7525;147495;10650;9218;3613;5797;494514;1149;56984;5771;10939;1068;65258;79959;9229;79822;84034;4729;7298;91133;11031;23253;9663;56907;9989;7050;339291;81929;4161;9984;81035;10928;2774;23347;63895;10627;8731;201475;64863;8736;342850;27098;284217;646000;753;23136;7541;55125,63,0.45216830852807400000
chr12,116420188,116695775,275587,-1,1,23389,1,0.36286181859086200000
chr16,29673954,30198600,524646,-1,1,653808;5531;26470;283897;253980;146378;8479;83719;23475;283899;124446;9344;3835;4150;226;253982;83723;5595;6911;11151;8448;79447;112476;9961;10423;6693;79153,27,5.14632723779463000000
chr10,81489155,89047627,7558472,-1,1,657;27069;84332;23063;54537;81619;5995;387694;79812;2746;119385;80195;10718;643161;26103;4143;387695;219348;6623;143241;92211;6441;54462;94233;2894;84293;340745;10974;11155;311;728118,31,0.41013580522624100000
chrX,7964677,9619810,1655133,-1,1,6907;425054;171482;171483;3730;51480,6,0.36250863223680500000
chr8,191560,5353580,5162020,-1,1,64478;9172;9639;169270;2055;157695;26260;9228;9920;157697,10,0.19372261246566300000
chr2,148186210,149485547,1299337,-1,1,92;26122;5000;55777,4,0.30784931084083600000
chr5,1,10124257,10124256,-1,1,50834;79192;81037;11336;65980;50805;153571;11044;64979;108;79888;10723;11076;23379;4726;9037;10016;7015;6389;133957;9319;340024;348932;153478;153572;54888;85409;79844;57491;4552;6550;170690;134121;79072;6715;6531;134111;55722;84246;389257,40,0.39509076024944500000
chr1,112633589,121281170,8647581,-1,1,83998;10885;200162;829;4893;7252;10286;11085;148281;440603;10352;10717;51592;333926;2210;81839;914;8458;3158;10100;4808;126868;54665;653820;26227;653464;80143;5738;79679;7482;284467;3283;260425;343505;64858;4853;270;476;4803;845;7812;26191;163259;4343;3321;80263;54879;6847;3284;6913;204851;6566;56944;51179;54855;90874;54834;389;55917;9398;965;55356;10745;9860;10905,65,0.75165528949656600000
chr16,29673954,30198600,524646,-1,1,653808;5531;26470;283897;253980;146378;8479;83719;23475;283899;124446;9344;3835;4150;226;253982;83723;5595;6911;11151;8448;79447;112476;9961;10423;6693;79153,27,5.14632723779463000000
chr3,93949,10562542,10468593,-1,1,51185;55831;9901;6396;9695;7428;285367;3708;4968;491;6419;151835;9797;3568;29995;26140;8536;84522;859;63924;100526693;55207;2177;2917;51095;56852;25917;401052;115795;10752;132014;285368;285362;27255;10474;7862;51066;152330;51738;84818;55209;78987;3656;64419;10093;55845;57633;8553;375323;5021,50,0.47761910315932600000
chr22,19023824,21464119,2440295,-1,1,54487;27037;9342;29801;65078;10587;1312;6545;421;7290;2812;6899;7625;79680;64976;6576;3053;8218;5413;80764;23617;400891;1399;7122;150209;128977;8220;388849;84861;7353;51586;2928;128989;5297;9127;9993;54584;91179;8216;85376;85359;8318;728229;5902,44,1.80306069553066000000
chr2,235875302,243041364,7166062,-1,1,151176;64090;23677;84289;10920;377007;5510;285093;51665;339768;4705;57007;150677;1841;129807;2859;130916;64284;150678;10267;140739;2817;4735;79083;401036;51540;9855;9759;150681;375318;189;51078;547;116987;79781;79919;57140;25992;51052;9208;375316;2637;11132;389090;23192;80895;55502;3069;10494;117581;51281;285193;666;8864;26146;23178;50636;653437;1293;5133;728294,61,0.85123461114347000000
chr15,20686218,28691430,8005212,-1,1,2562;7681;727832;100996331;123606;4948;57194;283694;81614;100287399;390538;2558;8924;114791;23742;7337;6638;2567;8926;283685;54551;4692;23191;283767,24,0.29980467725277000000
chr22,44744561,51304566,6560005,-1,1,85358;150383;410;400935;85378;2192;56666;5600;9701;27127;49;25771;23151;23774;9889;80305;11158;414918;55267;79174;9997;9620;1120;440836;55007;64781;5465;1375;112885;415116;83642;23542;553158;644186;7380;23779;23209;6300;10343;83933;79924;7477;25814;23313;10762;79087;55020;84247;55687;6305;51512;1890;348645;55615;23654;25817;113730;29781;55586;91289;54456;26150,62,0.94512123085272000000
chr1,170208576,192458564,22249988,-1,1,5743;7827;10216;64222;84066;3140;2328;91687;148753;9857;460;80896;730159;51278;83872;64326;5321;63923;80133;339479;339416;7175;127670;9887;51430;57795;9213;23215;6004;9068;63931;5279;6646;54953;163589;81627;10625;26052;10228;23127;89866;10092;54823;353299;2326;55103;27;64407;4653;84614;284525;7143;57710;81563;431704;55157;9910;8995;2752;9588;126859;9674;51603;27101;6041;5132;26092;356;6045;92346;116461;7292;81626;85397;23179;4688;1660;3918;8674;462;5396;127665;5768;116496;92344;23057;27252;777;3915;149041;89884;84320;403314;2329;2327;9293;10896;60676;80267;163590;9462;9917,102,0.45842721353377800000
chr21,38625718,42041906,3416188,-1,1,10311;8624;150082;3772;6450;106865373;3763;10317;2114;1859;1826;3150;10281;7485;54014;150084;2078;5121,18,0.52690308612992000000
chr4,1827058,2009615,182557,-1,1,3954;7468;7469,3,1.64332235959180000000
chr8,191530,6911531,6720001,-1,1,389610;9172;728358;1669;26260;1667;157697;64478;1671;9639;79648;169270;285;157695;9228;55326;9920;1672;1668;2055,20,0.29761900333050500000
chr22,18648866,21800797,3151931,-1,1,54487;27037;9342;29801;65078;10587;1312;6545;8214;7290;421;2812;6899;5625;7625;79680;23119;64976;11274;6576;3053;8218;5413;80764;23617;400891;1399;7122;150209;128977;8220;388849;84861;7353;51586;2928;128989;5297;9127;9993;54584;91179;85376;8216;440804;85359;8318;728229;5902,49,1.55460255951034000000
chr4,22422757,30809440,8386683,-1,1,51091;389203;166647;886;5099;10891;29945;55203;29063;23231;3516;1665;6649;91050;55300;55296;57620;10568,18,0.21462597310521900000
chr15,37269953,40018834,2748881,-1,1,400359;10125;4212;7057;161742;145942;161835;283742,8,0.29102751264969300000
chr16,29673954,30198600,524646,-1,1,653808;5531;26470;283897;253980;146378;8479;83719;23475;283899;124446;9344;3835;4150;226;253982;83723;5595;6911;11151;8448;79447;112476;9961;10423;6693;79153,27,5.14632723779463000000
chrX,32687712,32868014,180302,-1,1,1756,1,0.55462501802531300000
chr12,62261096,69279627,7018531,-1,1,100129940;29110;23329;10329;9958;11197;55801;8445;552;23592;338811;56890;23041;283349;11260;55508;2799;8091;55832;144577;1368;84298;50616;283417;253827;115749;57522;4193;57460;5908;3458;92797;23426;51643;11213;57122,36,0.51292784772198100000
chr15,22784523,23179948,395425,-1,1,123606;23191;114791;81614,4,1.01156982992982000000
chr16,14944560,16305736,1361176,-1,1,4629;100288332;123811;89927;4363;9284;54820;23420;123803;255027;23042;54700;368;9665,14,1.02852239534050000000
chr1,759762,5696605,4936843,-1,1,57470;388588;85452;1677;83858;5590;127262;728661;199990;9636;100287898;8510;64856;26155;140625;55229;8764;65220;339456;375790;388581;148398;401934;643965;51150;8784;2782;9651;1855;9731;27237;57801;126789;81669;29101;339453;6497;643988;7161;126792;219293;163688;84808;388585;63976;6339;55052;254173;80772;11079;79258;984;54587;5192;54973;84069;339448;54998;9906;148870;116983;339451;55966;7293;118424;728642;2563;127281;55210;54991;83756;142678;441869;1953;79906;49856,76,1.53944534999391000000
chr15,31014508,32510863,1496355,-1,1,161725;283710;54893;51621;4308;22909;1139,7,0.46780342899913500000
chr10,125121038,135404523,10283485,-1,1,2849;253738;85442;387718;27287;8433;399818;55760;5791;282973;10570;54764;282974;1793;664;50632;282969;4942;7390;594857;56647;119467;196743;119587;118856;101;1892;23172;1571;642938;84435;503542;10539;10844;9679;80313;256536;3632;8038;4288;93426;92170;84504;26098;118471;51363;170394;92565;4255;55844;390010;54777;64077;399823;1488;118472;118611,57,0.55428680063227600000
chr5,16372123,20693629,4321506,-1,1,54463;90441;10409;1016;4651,5,0.11570040629354700000
chr1,146564743,147786706,1221963,-1,1,9557;51205;51463;5565;607;2702;2330;200030;2703,9,0.73651984552723800000
chr14,33974276,37707521,3733245,-1,1,26257;6729;55012;7080;84684;58533;171546;55837;253970;253959;5083;112399;5687;51562;64067;283635;145282;9692;89874;84312;11177;1073;4792,23,0.61608600560638300000
chr16,15048751,16276115,1227364,-1,1,4629;100288332;123811;89927;4363;54820;368;255027;23042;54700;123803;9665,12,0.97770506548994400000
chr8,86842195,95273563,8431368,-1,1,138009;91147;54704;55529;4683;286144;51115;4325;793;2669;245972;169200;8767;85481;168975;157724;1666;734;389676;1015;100130742;11059;64168;862;389677;115111;54714;100127983;8895;51633;137392,31,0.36767461697793300000
chr8,108448737,121747270,13298533,-1,1,114569;84955;9166;55638;6873;90390;7373;93035;114788;401474;7201;157753;441376;64798;340419;9694;6641;284;100132813;27085;4982;27012;169026;84294;8667;3646;79075;10584;7227;4856;28998;5885;5168;2131;56943,35,0.26318692445249400000
chr22,20733427,21505417,771990,-1,1,80764;9342;3053;91179;8216;7625;400891;1399;6545;150209;51586;9127;84861;5297,14,1.81349499345846000000
chr1,759759,8077959,7318200,-1,1,57470;388588;1677;85452;83858;6146;5590;127262;728661;199990;23463;9636;100287898;8510;64856;26155;140625;55229;10911;54206;8764;65220;339456;261734;375790;388581;90326;148398;401934;80835;55735;57449;643965;51150;8784;2782;9651;1855;9731;27237;57801;3604;387509;8863;26038;126789;81669;29101;6497;339453;643988;7161;126792;8718;388591;83715;219293;163688;84808;11332;11315;388585;63976;54626;6339;11079;80772;55052;254173;148479;79258;984;54587;8514;5192;54973;339448;84069;9903;54998;9906;148870;116983;339451;390992;55966;3104;7293;118424;728642;127281;2563;55210;54991;9341;83756;142678;441869;79707;23261;1953;79906;49856,103,1.40744991937908000000
chr1,222821378,226677842,3856464,-1,1,64853;64746;23219;55740;8560;286826;4931;7044;149111;6726;80232;3930;9725;375056;824;164127;3020;29920;7159;55061;7100;83881;84976;388743;2052;163859;400823;29097;142;127602;10637;148362,32,0.82977567014757600000
chr17,34611377,36352418,1741041,-1,1,26574;9326;6928;3975;79893;729877;31;729873;6349;80179;284098;11072;79154;101060321;79922;11276;11056;101060376;6871;284099,20,1.14873802512405000000
chr9,140279169,140734184,455015,-1,1,92715;92714;10811;54932;377841;26012;79813;116225;375775;64975,10,2.19772974517324000000
chr17,43585247,44325222,739975,-1,1,246744;162540;104909134;1394;4137;284058,6,0.81083820399337800000
chr19,3324026,4870882,1546856,-1,1,126259;51341;6915;100131094;5605;4145;126321;1613;51343;55620;9546;10226;10362;84839;80700;10036;116541;4782;23396;91039;84954;79187;56005;51548;440503;1938;116844;10501;83475;27134;100128569;56961;6455;170961;55527;84699;284422;27231;729359;126282;84717;23217;10148;55702;85300;51588;58509;126326;148022,49,3.16771567618447000000
chr19,3874600,4183343,308743,-1,1,51341;1938;27231;5605;1613;85300;51588;51548;84699,9,2.91504584719330000000
chr19,3234036,4823723,1589687,-1,1,126259;60680;51341;6915;100131094;5605;4145;126321;1613;51343;55620;9546;10362;84839;80700;10036;116541;4782;23396;91039;84954;79187;56005;51548;440503;1938;116844;10501;83475;27134;100128569;56961;6455;170961;55527;84699;284422;27231;729359;126282;84717;23217;10148;55702;85300;51588;58509;126326;148022,49,3.08236778686622000000
chr19,3279942,4168106,888164,-1,1,60680;51341;6915;1938;5605;4145;126321;1613;83475;51343;27134;100128569;9546;10362;84699;84839;284422;27231;116541;4782;23396;23217;85300;51588;58509;126326,26,2.92738728433037000000
chr19,3295068,4996928,1701860,-1,1,126259;60680;51341;6915;100131094;5605;4145;126321;1613;51343;55620;9546;10226;10362;84839;80700;10036;116541;4782;23396;91039;23030;84954;79187;56005;51548;440503;1938;116844;10501;83475;27134;100128569;56961;6455;170961;55527;84699;284422;27231;645432;729359;126282;84717;23217;10148;55702;85300;51588;58509;126326;148022;29128,53,3.11423971419506000000
chr19,3585930,4621011,1035081,-1,1,126259;51341;6915;5605;4145;1613;55620;9546;84839;80700;10036;116541;23396;84954;79187;51548;440503;1938;116844;10501;27134;56961;6455;170961;84699;27231;729359;84717;23217;10148;55702;85300;51588;58509;126326,35,3.38137788250388000000
chr19,3979568,4131259,151691,-1,1,51588;51341;1938;5605,4,2.63693956793745000000
chr19,3451211,4600362,1149151,-1,1,126259;51341;6915;5605;4145;126321;1613;51343;55620;9546;10362;84839;80700;10036;116541;4782;23396;84954;79187;51548;440503;1938;116844;10501;83475;27134;100128569;56961;6455;170961;84699;284422;27231;729359;84717;23217;10148;55702;85300;51588;58509;126326,42,3.65487216214405000000
chr19,3413253,4195610,782357,-1,1,51341;6915;1938;5605;4145;126321;1613;83475;51343;27134;100128569;9546;170961;10362;84699;84839;284422;27231;116541;4782;23396;23217;85300;51588;58509;126326;51548,27,3.45110991529442000000
chr22,21798705,23654163,1855458,-1,1,7332;23753;5594;7441;2781;100423062;613;8940;23532;129025;645426;29799;91227;140883;23759;150223;9647;27156;150221;23119;9609;164592,22,1.18569108004600000000
chr17,14111772,15442066,1330294,-1,1,1352;64518;9953;201158;284040;100533496;5376;146822,8,0.60137082479512000000
chr9,129136380,130120163,983783,-1,1,9649;403341;23452;23099;89853;84253;4010,7,0.71153902842395100000
chrX,29063153,34963730,5900577,-1,1,4114;4113;80231;257397;190;4115;4112;53940;11141;158724;170062;83604;1756;2710,14,0.23726493188717000000
chr22,18919942,21440514,2520572,-1,1,54487;27037;9342;29801;65078;10587;1312;6545;421;7290;2812;6899;5625;7625;79680;64976;6576;3053;8218;5413;80764;23617;400891;1399;7122;150209;128977;8220;388849;84861;7353;51586;2928;128989;5297;9127;9993;54584;91179;85376;8216;85359;8318;728229;5902,45,1.78530904889842000000
chr17,87009,932682,845673,-1,1,100506388;79850;51031;50628;29928;29;400566;359845;9501;55178;55275;64359,12,1.41898819047078000000
chr22,51009420,51178264,168844,-1,1,49;23542;1120;85358;410;1375,6,3.55357608206392000000
chr18,66333162,78009973,11676811,-1,1,125704;54495;147381;1528;55628;201456;79863;400658;4772;25914;84735;644041;9306;9658;4155;27164;440498;81832;26251;80148;9150;10194;220158;284273;79839;22850;10666;84552;55748;374868;29090;10907;284274;7776;220164;2587,36,0.30830335440044400000
chr22,18895227,21462353,2567126,-1,1,54487;27037;9342;29801;65078;10587;1312;6545;8214;421;7290;2812;6899;5625;7625;79680;64976;6576;3053;8218;5413;80764;23617;400891;1399;7122;150209;128977;8220;388849;84861;7353;51586;2928;128989;5297;9127;9993;54584;91179;85376;8216;85359;8318;728229;5902,46,1.79188711422813000000
chr17,34618594,36249565,1630971,-1,1,26574;9326;6928;3975;79893;729877;31;6349;80179;284098;11072;79154;101060321;79922;11276;11056;6871;284099,18,1.10363703585165000000
chr9,208454,9737404,9528950,-1,1,58524;10171;23081;55664;89882;50808;158358;81704;23189;5789;6019;1761;169792;55064;6505;29126;2315;5991;26953;90865;7436;3717;90871;6013;57589;157983;3641;403313;169522;115426;6595;79956;9933;2731;55848;11172;10655;80380,38,0.39878475592798800000
chr4,1,3903583,3903582,-1,1,10336;7700;521;7469;401115;79155;4636;10417;84286;654254;345222;54872;1609;2261;255403;79441;4043;10227;8602;7884;170960;57732;7468;152877;10296;3064;3083;285489;57654;353497;10460;118;3954;10861;152;92305;285498;339983;10815;2580;53834;84179;5158;402160;3425;10608;6452;152687;1487;6047;54729;2868;6002;285464;8603,55,1.40896233254483000000
chr17,43706915,44208006,501091,-1,1,246744;162540;104909134;1394;4137;284058,6,1.19738730090942000000
chr20,121521,1580958,1459437,-1,1,140680;10616;1457;343637;57761;83541;55968;10326;55321;140850;245939;85508;85364;9491;128637;6939;400831;2280;81623;642636;140881;51378;9751;400830;113278;140809;284759;6666;27111;80023;128646,31,2.12410676171702000000
chr13,95227374,95277864,50490,-1,1,160897;23483,2,3.96118043176867000000
chr13,95228262,95300908,72646,-1,1,160897;23483,2,2.75307656305922000000
chr13,95228262,95300908,72646,-1,1,160897;23483,2,2.75307656305922000000
chr13,95236251,95309380,73129,-1,1,160897;23483,2,2.73489313405079000000
chr13,95225217,95305083,79866,-1,1,160897;23483,2,2.50419452583077000000
chr13,95225217,95305083,79866,-1,1,160897;23483,2,2.50419452583077000000
chr16,29673954,30198600,524646,-1,1,653808;5531;26470;283897;253980;146378;8479;83719;23475;283899;124446;9344;3835;4150;226;253982;83723;5595;6911;11151;8448;79447;112476;9961;10423;6693;79153,27,5.14632723779463000000
chrX,61091,5697869,5636778,-1,1,414;28227;286530;8225;1438;3563;5613;25878;347527;415;416;207063;4267;293;7499;9189;438;64109;6473;8227;55344;8623;8908,23,0.40803451901068300000
chr17,43717703,44210822,493119,-1,1,246744;162540;104909134;1394;4137;284058,6,1.21674484252280000000
chr7,114045636,114754745,709109,-1,1,29969;93986,2,0.28204408631113100000
chr9,140447749,140954147,506398,-1,1,92715;92714;79813;116225;774,5,0.98736566890074600000
chr13,48874194,64084349,15210155,-1,1,729240;10562;2862;144983;26586;9724;79621;283518;83446;57213;22862;729250;57105;81624;341676;1102;5100;26512;729246;27253;220108;64881;55213;10206;122183;115825;3839;81602;220107;81617;115761;540;729233;51131;79758;440138;55901;4752;10910;10161;84650;5925;11061;647174;81550;51028;83852;107303344,48,0.31557863808751500000
chr10,136391,370849,234458,-1,1,22982;10771,2,0.85303124653456100000
chr15,23739358,28026215,4286857,-1,1,2562;7681;23742;7337;6638;2567;4948;8926;57194;54551;4692;2558,12,0.27992536256749400000
chr6,213630,3290680,3077050,-1,1,56940;389362;2762;1992;4835;94234;2296;8737;63027;2295;56897;55770;340156;670;7280;347733;5272;3662;135458;5269,20,0.64997318860597000000
chr4,143413,1875315,1731902,-1,1,10336;7700;521;3954;4636;10417;10861;84286;654254;92305;54872;285498;1609;2261;255403;10815;2580;53834;84179;7884;170960;5158;3425;7468;152877;10296;1487;54729;57654;10460;285464,31,1.78993961552097000000
chr19,12527157,13476228,949071,-1,1,773;9592;10661;439;4125;163050;51398;84292;10224;55621;1777;2193;811;256126;22983;10535;7001;84261;4066;90480;57474;8677;1725;5886;4784;199699;83546;105372280;112939;79002;54831;29911;30000;2639;163049;3726;163051,37,3.89854921286184000000
chr17,16822683,20193169,3370486,-1,1,2314;55244;125170;55090;11216;79018;79999;10400;54890;254272;9706;400581;92521;8533;22905;729288;5598;218;23164;83450;224;51168;80039;51655;201163;7156;51030;5636;644815;10750;4239;10517;654346;10743;388436;27077;140775;6470;146691;1819;6720;125206;23495;147166;7732;146802;91647;56953;645027;3996;201164,51,1.51313490102021000000
chr2,232831650,233346962,515312,-1,1,9427;248;129563;250;251,5,0.97028596267892100000
chr7,155559462,158909738,3350276,-1,1,9690;155435;389602;55112;140545;6469;64327;3110;5799;7434;64434;54892;10049;57488,14,0.41787601976673000000
chr3,94473675,114825050,20351375,-1,1,7634;131368;348801;201633;403278;64332;205717;131450;868;22989;80218;84873;55076;403274;84864;25890;257068;29114;11259;90102;4345;84692;56987;64422;10402;91653;56954;131544;81050;152185;84319;9666;151888;57577;25871;54931;50852;151871;26137;961;55211;402135;10225;151887;403277;79310;131566;257144;84666;57092;9868;523;91775;10342;214;79691;79669;57650;1371;55773;55779;254887;26341;2838;27136;84100;1295;285335;79413;403273;285220;25945;50939;200959;1814;79295;6152;9626;54847;26339;27107;11148;55347;344805;54762;79598;55032;29083;57337;56650;55081;344807,92,0.45205790763523300000
chr16,29673954,30198600,524646,-1,1,653808;5531;26470;283897;253980;146378;8479;83719;23475;283899;124446;9344;3835;4150;226;253982;83723;5595;6911;11151;8448;79447;112476;9961;10423;6693;79153,27,5.14632723779463000000
chr15,23739358,28525460,4786102,-1,1,2562;7681;23742;8924;7337;6638;2567;4948;8926;57194;54551;4692;2558,13,0.27161978578810100000
chr15,22784523,23179948,395425,-1,1,123606;23191;114791;81614,4,1.01156982992982000000
chr15,20575646,23179948,2604302,-1,1,727832;114791;100996331;123606;283694;81614;100287399;390538;23191;283767,10,0.38398004532500500000
chr10,130650432,135404523,4754091,-1,1,118472;10844;80313;256536;253738;85442;3632;27287;8433;93426;282973;282974;50632;92170;10570;84504;664;282969;118471;170394;196743;55844;54777;503542;101;1892;1571;4255;84435;10539,30,0.63103545977559100000
chr6,1600137,2887651,1287514,-1,1,340156;2762;5272;56897;1992;2296,6,0.46601435013522200000
chr8,221611,6914076,6692465,-1,1,389610;9172;728358;1669;26260;1667;157697;64478;1671;9639;79648;1670;285;157695;9228;55326;9920;1672;1668;2055,20,0.29884355017172300000
chr2,128428255,130059570,1631315,-1,1,55679;84826;55339;5433;79595;56886;83607;9394,8,0.49040191501947800000
chr1,852863,5042947,4190084,-1,1,57470;388588;85452;1677;83858;5590;127262;728661;199990;9636;100287898;8510;64856;26155;140625;55229;8764;65220;339456;375790;388581;148398;401934;643965;51150;8784;2782;9651;1855;9731;27237;57801;126789;81669;29101;339453;6497;643988;7161;126792;219293;163688;84808;388585;63976;6339;55052;254173;80772;11079;79258;984;54587;5192;54973;84069;339448;54998;9906;148870;116983;339451;55966;7293;118424;728642;2563;127281;55210;54991;83756;142678;441869;1953;79906;49856,76,1.81380611939999000000
chr7,72726578,74139390,1412812,-1,1,5982;51085;9275;84277;7462;135886;83451;1364;135892;6804;7461;155382;3984;26608;8468;9031;155368;2969;8326;7458;9569;2006;1365;114049,24,1.69873981817821000000
chr2,174937506,178718807,3781301,-1,1,3235;151556;3239;1123;1386;3233;29789;344191;8540;220988;50940;79634;150737;3232;3238;3231;3236;4780;3234;1134;9541;518;80856;3237;10651;100131390;92104;7456,28,0.74048588038878700000
chr2,153803494,162840073,9036579,-1,1,56475;29994;130940;10716;57282;4065;8502;2820;90;100526664;151525;92196;130399;114805;3760;5937;10010;85461;64844;9936;57471;9595;22925;4929;100144595;151531;3694;10213;11227,29,0.32091790488413800000
chr1,146564743,147786706,1221963,-1,1,9557;51205;51463;5565;607;2702;2330;200030;2703,9,0.73651984552723800000
chr15,20481702,22509254,2027552,-1,1,283694;727832;100287399;390538;100996331,5,0.24660279982954800000
chr8,113109996,128313956,15203960,-1,1,114569;4715;6873;84985;286053;79139;55039;90390;7373;114907;100533106;114788;401474;312;441376;64798;55093;10221;6641;29028;137209;157769;654463;27085;3037;4982;83940;6713;169026;11244;157378;9897;93594;11236;9788;8667;84294;157638;340359;22882;79075;10584;7227;4856;28998;5885;84933;5168;2131,49,0.32228445747029100000
chr5,16503303,21173421,4670118,-1,1,54463;10409;1016;4651,4,0.08565094072569470000
chr10,123241651,135404523,12162872,-1,1,196792;253738;1755;8433;399818;5791;282973;50632;10570;1793;340784;4942;54780;7390;594857;119467;196743;118663;9184;1571;84435;503542;10844;80313;256536;8038;4288;5654;92170;36;118471;51363;170394;55844;54777;118670;4255;399823;1488;118611;11101;2849;85442;387718;27287;118672;59338;2263;55760;282974;54764;664;282969;56647;119587;118856;101;1892;23172;80007;3167;642938;387715;10579;10539;118472;9679;3632;64376;84504;26098;50624;92565;399814;390010;64077;93426,77,0.63307416208934900000
chr22,18919942,20311763,1391821,-1,1,54487;27037;5413;29801;65078;23617;10587;1312;7122;421;7290;128977;8220;2812;388849;7353;2928;128989;6899;9993;54584;5625;79680;85359;64976;8318;5902;6576;8218,29,2.08360126769175000000
chr17,14191926,15442037,1250111,-1,1,64518;9953;201158;284040;100533496;5376,6,0.47995737978467500000
chr17,42906430,42987593,81163,-1,1,10052;2670;51751;9343;388389,5,6.16044256619395000000
chr22,18919942,21440514,2520572,-1,1,54487;27037;9342;29801;65078;10587;1312;6545;421;7290;2812;6899;5625;7625;79680;64976;6576;3053;8218;5413;80764;23617;400891;1399;7122;150209;128977;8220;388849;84861;7353;51586;2928;128989;5297;9127;9993;54584;91179;85376;8216;85359;8318;728229;5902,45,1.78530904889842000000
chr17,7394419,7871060,476641,-1,1,146754;8742;92162;124637;6665;55135;8741;1107;407977;482;100996842;6462;7157;23135;58485;968;9513;26168;9196;84316;1973;116840;9526;1949;112483;5430,26,5.45483917665497000000
chr17,43706886,44210822,503936,-1,1,246744;162540;104909134;1394;4137;284058,6,1.19062738125476000000
chr13,30805425,36900741,6095316,-1,1,675;100526761;3146;90634;10208;84935;23111;9201;241;10443;84056;646799;23047;10129;728591;122042;5983;26960;10808;90627;122046;145173;4081;9365;54937,25,0.41015100775743200000
chr15,31014508,32510863,1496355,-1,1,161725;283710;54893;51621;4308;22909;1139,7,0.46780342899913500000
chrX,61091,8295650,8234559,-1,1,414;28227;51481;286530;57502;8226;8228;8225;1438;3563;26609;5613;25878;347527;415;416;207063;4267;293;412;7499;9189;438;64109;51480;6473;8227;55344;8623;8908,30,0.36431823489272500000
chr1,241262009,244371040,3109031,-1,1,6000;128025;10472;9859;23596;10000;200150;2271;9156;1122;440738;10806;8564;441925,14,0.45030107451485700000
chr16,29673954,30198600,524646,-1,1,653808;5531;26470;283897;253980;146378;8479;83719;23475;283899;124446;9344;3835;4150;226;253982;83723;5595;6911;11151;8448;79447;112476;9961;10423;6693;79153,27,5.14632723779463000000
chr16,29673954,30198600,524646,-1,1,653808;5531;26470;283897;253980;146378;8479;83719;23475;283899;124446;9344;3835;4150;226;253982;83723;5595;6911;11151;8448;79447;112476;9961;10423;6693;79153,27,5.14632723779463000000
chr16,29673954,30198600,524646,-1,1,653808;5531;26470;283897;253980;146378;8479;83719;23475;283899;124446;9344;3835;4150;226;253982;83723;5595;6911;11151;8448;79447;112476;9961;10423;6693;79153,27,5.14632723779463000000
chr7,72726578,74339044,1612466,-1,1,5982;84163;51085;9275;84277;7462;135886;653361;83451;1364;135892;6804;7461;155382;3984;26608;8468;9031;155368;2969;8326;7458;9569;2006;1365;114049,26,1.61243709944892000000
chr18,54037167,77982126,23944959,-1,1,100505549;147381;51046;89778;55628;3998;147372;8792;84735;644041;9480;5275;4772;4155;27164;440498;5268;284257;89777;1005;2235;4677;5273;23556;23239;9150;101927322;10194;220158;6317;6318;79839;10892;374868;90701;5271;29090;10907;55748;2922;284274;7776;2587;125704;54495;28513;1528;201456;115701;79863;400658;8710;25914;9306;9658;5055;23327;28316;54877;81832;57614;55205;26251;4160;80148;92126;30062;23335;596;339302;5205;284273;284293;22850;220441;10666;84552;9525;2531;220164;5366;9352,82,0.34245203760841700000
chr2,121012182,121572874,560692,-1,1,5899;2736;3625,3,0.53505311293901100000
chr8,8130630,11841901,3711271,-1,1,1508;83650;83595;203076;2626;83648;613210;137075;613209;157285;640;66036;252969;286046;79660;2222;54984;4482;8658;203074;9258;90459;94137,23,0.61973377853570900000
chr13,104626238,115059020,10432782,-1,1,7027;55795;79587;79774;3916;8874;22821;55608;23026;8858;55647;10426;84945;728215;1284;101928841;2621;400165;113622;65110;10673;8660;121793;23263;55739;643365;55002;3621;55082;1282;100129836;6656;23250;1948;3981;2155;2159;55208;122258;496;6011;8451;348013;8881;267012,45,0.43133269726138200000
chr15,31014508,32510863,1496355,-1,1,161725;283710;54893;51621;4308;22909;1139,7,0.46780342899913500000
chr15,23739358,28525460,4786102,-1,1,2562;7681;23742;8924;7337;6638;2567;4948;8926;57194;54551;4692;2558,13,0.27161978578810100000
chr4,181303675,185650947,4347272,-1,1,836;60684;80014;201973;79682;53842;100132463;133121;56977;55714;3660;3622;201965;55602;1635,15,0.34504397240384300000
chr15,22784523,28525460,5740937,-1,1,2562;7681;123606;4948;57194;81614;2558;8924;114791;23742;7337;6638;2567;8926;283685;54551;4692;23191,18,0.31353766815417100000
chr16,76849848,83159043,6309195,-1,1,2653;283927;124359;3294;93517;1012;56942;57687;123775;23300;4094;51741;10143;100130958;170692;80790;10200;5336;83657;22879;55839;8139;53630;114780,24,0.38039718220787300000
chrX,61091,2822216,2761125,-1,1,414;28227;286530;8225;1438;3563;207063;4267;293;7499;9189;438;64109;6473;8227;55344;8623;8908,18,0.65190818959663200000
chr2,76339564,80701743,4362179,-1,1,347730;130120;5068;1496;5968;80059;5967,7,0.16047026039050700000
chr16,29673954,30119759,445805,-1,1,653808;5531;26470;283897;253980;146378;8479;83719;23475;283899;124446;9344;3835;4150;226;253982;83723;6911;8448;79447;112476;9961;10423;6693;79153,25,5.60783302116396000000
chr2,15944883,28421764,12476881,-1,1,114818;7781;100526794;64342;375190;348654;9741;6382;54454;339778;3777;9553;3030;4613;200634;55252;9577;60526;81553;79635;9784;57665;56896;84696;92749;11321;3797;3032;100129278;1058;22979;339779;8890;22950;51374;130557;130502;22924;4358;151449;3795;391356;338;79677;130497;26160;7349;8884;10408;64838;51639;9913;1788;375189;7447;150946;93034;100128731;5496;9540;10669;109;54978;23369;80304;150921;790;85465;2976;84226;10890;29959;388931;653140;2646;388;165082;343930;5443;84450;8648;79172;729475;1838;57539;165324;64080;60509;4148;285126;2281;11117;130106;57159;54867;9381;51277;3790;10113;50618,100,0.80148235765012100000
chr9,271257,12907826,12636569,-1,1,58524;10171;23081;55664;89882;50808;158358;81704;23189;5789;6019;286343;1761;169792;55064;6505;29126;2315;5991;26953;90865;7436;3717;90871;6013;57589;3641;7306;403313;169522;115426;6595;79956;9933;2731;55848;11172;10655;80380,39,0.30862807776383000000
chr11,127054775,134868407,7813632,-1,1,8538;170689;120224;9743;63970;2313;29087;399979;334;112936;50863;89944;283171;27034;3762;4978;2113;219833;56980;23310;112937;4798;6768;83700;11095;219938;29068;27087;3758;22997,30,0.38394436799685500000
chr22,18919942,21440514,2520572,-1,1,54487;27037;9342;29801;65078;10587;1312;6545;421;7290;2812;6899;5625;7625;79680;64976;6576;3053;8218;5413;80764;23617;400891;1399;7122;150209;128977;8220;388849;84861;7353;51586;2928;128989;5297;9127;9993;54584;91179;85376;8216;85359;8318;728229;5902,45,1.78530904889842000000
chr18,14316,14358321,14344005,-1,1,116;23255;57132;8774;645369;125228;57045;103910;642597;84617;9097;7525;10650;3613;56984;65258;79822;84034;4729;23253;9663;9989;339291;9984;10928;162655;63895;201475;64863;342850;27098;646000;753;7541;55125;55556;10403;4158;84203;147495;9218;5797;494514;1149;5771;10939;1068;79959;9229;7298;91133;11031;56907;7050;81929;4161;81035;2774;23347;10627;8731;8736;284217;23136,64,0.44617943175563600000
chr22,18919942,21440514,2520572,-1,1,54487;27037;9342;29801;65078;10587;1312;6545;421;7290;2812;6899;5625;7625;79680;64976;6576;3053;8218;5413;80764;23617;400891;1399;7122;150209;128977;8220;388849;84861;7353;51586;2928;128989;5297;9127;9993;54584;91179;85376;8216;85359;8318;728229;5902,45,1.78530904889842000000
chr16,29673954,30198600,524646,-1,1,653808;5531;26470;283897;253980;146378;8479;83719;23475;283899;124446;9344;3835;4150;226;253982;83723;5595;6911;11151;8448;79447;112476;9961;10423;6693;79153,27,5.14632723779463000000
chr20,42164132,47164858,5000726,-1,1,90203;140870;6789;11317;4318;140730;6385;80336;10816;8839;78997;6407;112858;63935;51098;7125;164237;116092;64849;57468;259239;100;128506;8202;57119;10005;149699;60598;27296;81031;10406;26013;2139;90196;10953;140831;128497;55959;958;6590;5266;10955;280664;128486;128488;90204;23613;11065;51604;140902;11142;4605;140832;149708;51006;63925;63916;84969;7529;64405;55713;51526;79183;140686;5476;3787;3172;5360;100526773;6406;90199;259240;140825;8785;57727;57158;55861;391253;10110,79,1.57977061730637000000
chr15,20575646,23179948,2604302,-1,1,727832;114791;100996331;123606;283694;81614;100287399;390538;23191;283767,10,0.38398004532500500000
chr22,51125578,51218980,93402,-1,1,49;11158;85358,3,3.21192265690242000000
chr4,117116790,134810139,17693349,-1,1,79931;5393;133022;10252;54532;57182;3558;9348;9871;55212;8492;84109;4085;11162;132321;10733;171024;132332;2169;84162;22824;57575;57721;8654;51778;256471;166379;59067;132612;55132;10424;79960;401152;132320;79625;79633;2247;27152;80167;7222;83447;11107;308;166378;890,45,0.25433285693963300000
chr4,71552,18839648,18768096,-1,1,728373;7700;521;7469;79155;644414;5860;55646;654254;53407;54872;9948;79441;51056;152877;579;3166;1816;80306;9778;10861;92305;285498;57537;100287404;728379;285550;27065;2580;53834;84179;5158;728386;152687;54360;728405;259282;57533;10417;152992;93624;345222;4043;132864;7884;170960;100287441;57732;10296;3083;100287238;768239;57654;114905;9982;27146;100287327;1400;3954;100288520;645104;728369;1487;100287144;8310;80273;2868;54436;9364;285464;8603;683;257236;401115;728393;133060;4636;728419;202018;6286;166793;114932;1609;55351;2121;9079;100287513;7468;285489;84448;353497;8842;152789;100287205;64151;8532;10815;116449;402160;3425;4487;6047;57545;54729;6002;26234;27201;7466;10227;10336;9957;93621;84286;56606;2261;255403;8602;254251;132884;3064;100287364;10460;85013;728400;100287478;118;152;60312;85460;94031;952;83888;23324;55330;100287178;339983;54876;6452;5522;10608;389199,141,0.75127492954000200000
chr10,75166014,76694543,1528529,-1,1,9632;5328;310;5532;79933;23522;26985;23053;58529;118490;118487;7414;414236;729092;170384;8509;818;132;159195,19,1.24302515686650000000
chr15,59255080,61477893,2222813,-1,1,92483;2958;663;4643;79664;6095;54778;302;9133;9245;145773;27023,12,0.53985647915501700000
chr15,31014508,32510863,1496355,-1,1,161725;283710;54893;51621;4308;22909;1139,7,0.46780342899913500000
chr13,111346820,115089676,3742856,-1,1,7027;55795;79587;79774;3916;8874;22821;55608;8858;10426;101928841;2621;400165;113622;65110;121793;283489;23263;643365;55002;3621;6656;23250;2155;2159;55208;496;6011;122258;348013;8881;8451,32,0.85496209311819600000
chr15,23656965,28559372,4902407,-1,1,2562;7681;23742;8924;7337;6638;2567;4948;8926;57194;283685;54551;4692;2558,14,0.28557400476949400000
chr10,81489154,88940399,7451245,-1,1,657;27069;84332;23063;54537;81619;5995;387694;79812;2746;119385;80195;10718;643161;26103;4143;387695;219348;6623;143241;92211;6441;54462;94233;2894;84293;340745;10974;11155;311,30,0.40261728073630700000
chrX,481940,970747,488807,-1,1,6473,1,0.20457972164883100000
chr22,49371757,51178264,1806507,-1,1,85358;410;400935;85378;9701;56666;5600;49;9889;23774;80305;414918;79174;9997;1120;440836;1375;415116;83642;23542;644186;23209;6300;83933;79924;79087;6305;1890;348645;23654;113730;29781;55586;91289;54456,35,1.93744059668742000000
chr7,72636006,74194373,1558367,-1,1,5982;51085;9275;84277;7462;55695;135886;653361;83451;1364;135892;6804;7461;155382;3984;26608;8468;9031;155368;2969;8326;7458;9569;2006;1365;114049,26,1.66841315299926000000
chr11,124205261,134868378,10663117,-1,1,53340;63970;9743;84623;26595;89944;283171;403312;56980;55572;83700;399967;6768;56;79607;3758;26493;22997;9638;83480;114609;79684;641654;112936;50863;84881;27034;90952;219858;219833;63876;283162;100169851;4900;64221;390271;220296;219844;50937;1111;28960;219938;219854;390275;120224;29087;2313;334;23584;84897;54414;116337;4798;399968;27087;6484;8538;170689;54538;9538;29118;399979;6734;3762;4978;2113;23310;112937;3703;11095;219855;80071;160065;29068,74,0.69398094384596900000
chr15,96128092,100200967,4072875,-1,1,145814;145946;283777;123355;7026;4205;23336;3480;64927;91947,10,0.24552680845839900000
chr22,43106311,51178224,8071913,-1,1,11252;150383;85378;25771;23151;23774;80305;55267;25813;79174;150379;55007;1375;415116;83642;23542;553158;7380;6300;10343;83933;79924;23313;84247;6305;51512;1890;53947;25830;23654;25817;29781;91289;26286;26150;85358;64800;410;400935;706;2192;56666;80274;5600;9701;27127;49;9889;414918;25809;758;9997;9620;1120;440836;64781;5465;112885;29780;644186;23170;23779;23209;7477;64098;25814;80339;10762;79087;55020;27349;55687;638;348645;85352;55615;113730;55586;54456,79,0.97870232248538900000
chr22,18706022,21561491,2855469,-1,1,54487;27037;9342;29801;65078;10587;1312;6545;8214;7290;421;2812;6899;5625;7625;79680;64976;6576;3053;8218;5413;80764;23617;400891;1399;7122;150209;128977;8220;388849;84861;7353;51586;2928;128989;5297;9127;9993;54584;91179;85376;8216;85359;8318;728229;5902,46,1.61094377140848000000
chr10,88334473,93193743,4859270,-1,1,657;9060;142910;84896;27063;3433;643161;3437;8513;57559;340654;55328;10974;728118;355;84333;387700;24138;643414;3434;54537;9023;79812;2746;119385;643418;143279;9585;5728;53354;10556;118932;6623;439996;9562;59;94233;11155;100144748;3988;3363,41,0.84374813500793300000
chrX,32535396,32635128,99732,-1,1,1756,1,1.00268720170056000000
chr5,157501989,168349948,10847959,-1,1,134510;900;79646;2566;23120;63920;3593;2554;10569;2559;114825;6586;9232;5917;23286;114898;7265;27430;1879;79616;2561;147;153830;134492;2172;3161;57451,27,0.24889474600706000000
chr8,109248469,128052349,18803880,-1,1,114569;84955;9166;55638;4715;6873;84985;286053;79139;55039;90390;7373;93035;114907;100533106;114788;401474;7201;312;157753;441376;64798;55093;10221;9694;6641;29028;137209;157769;654463;100132813;27085;4982;3037;83940;6713;27012;169026;11244;157378;9897;93594;11236;9788;84294;8667;157638;340359;22882;3646;79075;10584;7227;4856;28998;5885;84933;5168;2131;56943,60,0.31908308285311300000
chr6,163113,4674704,4511591,-1,1,10455;404220;56940;389362;2762;1992;4835;94234;2296;8899;8737;63027;2295;56897;222826;55770;670;340156;7280;347733;221749;5272;26240;3662;135458;5269,26,0.57629337411126100000
chr22,47278870,51304566,4025696,-1,1,85358;410;400935;85378;9701;56666;5600;49;25771;9889;23774;80305;11158;414918;79174;9997;1120;440836;1375;415116;83642;23542;644186;23209;6300;83933;79924;79087;6305;1890;348645;23654;25817;113730;29781;55586;91289;54456,38,0.94393615414576800000
chr1,564405,7684084,7119679,-1,1,57470;388588;1677;85452;83858;6146;5590;127262;728661;199990;23463;9636;100287898;8510;64856;26155;81399;140625;55229;8764;65220;339456;261734;375790;388581;90326;148398;401934;80835;55735;57449;643965;51150;8784;2782;9651;1855;9731;27237;57801;387509;26038;126789;81669;29101;6497;339453;643988;7161;126792;8718;388591;83715;219293;163688;84808;11332;388585;63976;54626;6339;11079;80772;55052;254173;148479;79258;984;54587;8514;5192;54973;339448;84069;9903;54998;9906;148870;116983;339451;390992;55966;3104;7293;118424;728642;127281;2563;55210;54991;83756;142678;441869;79707;23261;1953;79906;49856,98,1.37646655137121000000
chr1,146155982,147824177,1668195,-1,1,9557;51205;51463;2703;5565;607;2702;2330;200030;149013,10,0.59945030407116700000
chrX,32514287,32815460,301173,-1,1,1756,1,0.33203507618544800000
chrX,31729673,31840644,110971,-1,1,1756,1,0.90113633291580700000
chr7,31870488,37405585,5535097,-1,1,54443;387129;64224;23366;23080;57057;168667;23333;9844;25948;80820;27241;51251;6100;989;23658;313;11328;5137,19,0.34326408371885800000
chr10,128212399,135427143,7214744,-1,1,253738;85442;27287;8433;5791;282974;282973;50632;10570;1793;664;282969;594857;119467;196743;101;1892;1571;399823;642938;84435;10539;503542;10844;80313;256536;3632;4288;93426;92170;84504;118471;170394;55844;54777;4255;118472,37,0.51283870917665300000
chr15,30954726,32157163,1202437,-1,1,161725;283710;54893;51621;4308;22909,6,0.49898664129596800000
chr4,1710501,2364148,653647,-1,1,7469;7884;401115;3954;10608;57732;7468;92305;353497;10460;2261;79441;339983,13,1.98884107170996000000
chr3,137493230,141323013,3829783,-1,1,287015;668;9276;5948;25852;80321;83850;5947;5291;253461;401089;729627;92369;5922;389152;51146;55179;347736;92370;64084;55186;22808;349565;51163;51208;56945;389151;199221,28,0.73111191939595500000
chr14,102265298,104223897,1958599,-1,1,3320;23186;7517;5527;91828;91833;79038;9578;9529;5891;115708;23368;107984640;81693;1983;4140;7187;9895;1152;3831;51550;84334;7127;1778;55778;122416,26,1.32747948916547000000
chr6,44796618,47748744,2952126,-1,1,23607;4224;221400;266977;22875;221393;7941;53405;27242;59084;222611;9481;221395;8464;860;100287718;51302;10231,18,0.60973007249690600000
chr2,237605322,243041364,5436042,-1,1,151176;64090;84289;10920;377007;5510;285093;51665;728294;339768;4705;150677;1841;129807;2859;130916;64284;150678;10267;140739;2817;4735;79083;51540;5133;9759;150681;375318;189;51078;547;79919;57140;25992;51052;9208;375316;11132;389090;23192;55502;3069;10494;117581;51281;285193;666;8864;26146;23178;50636;653437;1293;80895;9855,55,1.01176554559365000000
chr17,43706886,44351152,644266,-1,1,246744;162540;104909134;1394;4137;284058,6,0.93129235440020100000
chr2,126285841,143449731,17163890,-1,1,11249;728378;5433;29798;56886;339745;2863;2995;5624;130013;653269;55627;3176;9394;80097;91409;80731;84083;408029;653781;653275;55041;339761;344148;344561;79595;55677;50649;4249;53353;4175;205147;81615;90557;80122;84084;101929926;23518;1615;7852;92856;905;22930;113457;10746;84826;274;112714;130074;55339;445582;646915;150786;55997;116372;4648;3938;55679;2071;2840;653784;84317;26469;23190;83607,65,0.37870203083333700000
chr22,18706022,21540317,2834295,-1,1,54487;27037;9342;29801;65078;10587;1312;6545;8214;7290;421;2812;6899;5625;7625;79680;64976;6576;3053;8218;5413;80764;23617;400891;1399;7122;150209;128977;8220;388849;84861;7353;51586;2928;128989;5297;9127;9993;54584;91179;85376;8216;85359;8318;728229;5902,46,1.62297855374970000000
chrX,2701273,6445262,3743989,-1,1,414;25878;5613;347527;415;416;7499;57502;8908,9,0.24038532164490900000
chr3,184224662,187805836,3581174,-1,1,55171;1974;6480;197;285382;51726;1427;3273;26998;1608;5984;10644;59343;116832;604;64110;5648;23355;200879;9370;6750;1962;64108;132112;2119;344892;6434;9175;90407;2049;3827,31,0.86563791650447600000
chr22,18916842,21800797,2883955,-1,1,54487;27037;9342;29801;65078;10587;1312;6545;421;7290;2812;6899;5625;7625;79680;23119;64976;6576;3053;8218;5413;80764;23617;400891;1399;7122;150209;128977;8220;388849;84861;7353;51586;2928;128989;5297;9127;9993;54584;91179;85376;8216;440804;85359;8318;728229;5902,47,1.62970642745813000000
chr22,51154323,51197838,43515,-1,1,49;85358,2,4.59611628174193000000
chr14,102647205,107278711,4631506,-1,1,647286;23241;23186;283643;91828;9578;9529;400258;5891;207;55038;9112;107984640;122402;3714;81693;10572;283638;1983;4140;100128927;1396;7187;9895;1152;3831;51550;84334;122618;80757;374569;388021;113146;2972;256281;647310;1397;7517;90135;91833;79038;122616;9556;64423;115708;23368;122622;26153;29933;7127;55778;122416,52,1.12274495596033000000
chr22,18894864,20311733,1416869,-1,1,54487;27037;5413;29801;65078;23617;10587;1312;7122;8214;421;7290;128977;8220;2812;388849;7353;2928;128989;6899;9993;54584;5625;79680;85359;64976;8318;5902;6576;8218,30,2.11734465218732000000
chr1,1969646,3340784,1371138,-1,1,79258;5192;9651;8764;5590;140625;199990;388585;6497;55229;63976;79906;11079;127281;100287898,15,1.09398178739120000000
chr1,16364275,16370226,5951,-1,1,,0,0.00000000000000000000
chr1,16378261,16383274,5013,-1,1,1188,1,19.94813484939160000000
chr2,386460,2246200,1859740,-1,1,7837;23040;129787;7173;54221,5,0.26885478615290300000
chr2,171372721,195000000,23627279,-1,1,3235;129831;344191;26003;1281;4760;6775;5136;150737;51661;54842;3232;3238;10203;84281;4780;3234;83879;389058;494513;9541;80856;3237;84128;6772;6670;100131390;375298;150709;285141;51454;151556;1386;114880;91752;29789;254042;8540;50940;79634;1781;91404;8436;1746;1290;64859;10787;151242;55854;26275;4664;1134;8575;4430;2660;3628;8604;165215;3685;142679;1123;23671;79901;116093;2744;51776;100131211;151112;57703;3236;129401;140469;8520;151126;30061;79828;518;54529;2571;1745;10651;10477;92104;80067;3239;3233;220988;6744;64172;3231;3655;11069;2487;94101;54431;5378;9874;3676;285025;7035;5163;65977;7273;7456,104,0.44016917902395800000
chr21,15006457,33265774,18259317,-1,1,54148;11096;2897;337882;29104;9073;337960;571;10950;337970;643812;7074;9510;337959;4685;337968;149998;337973;26046;351;10069;116159;100131902;522;337963;337967;337878;140578;337979;100288323;54149;337971;337985;8204;30811;337974;337977;5651;337969;388813;57466;337976;2551;10600;1525;140258;26285;10694;337975;337880;100288287;317754;6647;64092;150051;58494;337966;388818;337978;337879;254950;56911;54033;29761;284827;337972;6782;643803;728299,69,0.37788927154285100000
chr7,72634903,74339015,1704112,-1,1,5982;84163;51085;9275;84277;7462;55695;135886;653361;83451;1364;135892;6804;7461;155382;3984;26608;8468;9031;155368;2969;8326;7458;9569;2006;1365;114049,27,1.58440290309557000000
chr6,86301318,91379453,5078135,-1,1,84694;6885;206412;57226;55122;23036;1081;22881;3354;135293;51465;57150;9994;60468;10957;81833;57231;57038;135295;10492;8732;2570;2569;23595;58528;10559;154313;23195;1268;375519,30,0.59076806741057500000
chr19,31563657,37241664,5678007,-1,1,26065;2867;53822;84807;5438;4099;90075;55957;25999;147991;644096;126393;388531;57817;11136;92283;2865;91442;495;374897;57677;9141;9710;148109;126248;79171;84902;22847;55851;728361;101927572;388533;5348;390916;53827;27033;126374;100507527;93099;4037;91646;5184;2821;339324;51599;284406;26330;85415;1340;284402;79414;163183;2116;148103;57711;84306;84063;333;933;6324;115703;147929;826;64377;284403;79713;5349;10054;7705;84079;163175;84924;1054;57616;57655;199745;1155;7305;79047;58510;9757;1346;84964;199746;55094;126375;4868;84911;7392;1050;23354;3249;10870;339318;342892;2864;10430;56301;55900;11045;148137;163081,102,1.79640497096957000000
chr9,204090,500607,296517,-1,1,81704;23189;157983,3,1.01174637541861000000
chr1,156056094,156634505,578411,-1,1,54865;632;60484;128240;64218;391104;7203;128239;100527963;10485;128229;79957;9673;112770;4000;11243;164118;23381;84283;63827;4209;57127,22,3.80352379190576000000
chr13,110343306,112078962,1735656,-1,1,3621;79587;121793;8874;1284;1282;55739;100129836;55608;55647;8660,11,0.63376613799047700000
chrY,297690,1351571,1053881,-1,1,6473;1438;64109,3,0.28466212029631400000
chr1,41126365,45133712,4007347,-1,1,114625;149466;22955;1907;22887;100129924;9682;440585;79033;7075;6487;10465;128218;1503;128209;64834;149461;991;10969;79078;374969;112950;1802;79639;59269;55929;23334;2980;284716;84217;81888;79717;149465;163732;64175;9783;4352;9048;6513;149473;2981;728621;4904;200172;100132074;9670;533;55182;51058;6536;4802;9132;8704;5792,54,1.34752493357825000000
chr16,28824794,29042059,217265,-1,1,11273;79874;7284;930;84901;27040;487;83985;25970,9,4.14240673831496000000
chr7,72642105,74361068,1718963,-1,1,5982;84163;51085;9275;84277;7462;55695;135886;653361;83451;1364;135892;6804;7461;155382;3984;26608;8468;9031;155368;2969;8326;7458;9569;2006;1365;114049,27,1.57071443655274000000
chr16,14968878,16311041,1342163,-1,1,4629;100288332;123811;89927;4363;9284;54820;23420;123803;255027;23042;54700;368;9665,14,1.04309238147677000000
chr1,149852674,150257430,404756,-1,1,51177;51107;9900;8338;317772;11311;10903;23632;51027;148523;8349;10262;79630;56957;81611,15,3.70593641601360000000
chrX,168551,5677733,5509182,-1,1,414;28227;286530;8225;1438;3563;5613;25878;347527;415;416;207063;4267;293;7499;9189;438;64109;6473;8227;55344;8623;8908,23,0.41748484620765800000
chrX,168551,5677733,5509182,-1,1,414;28227;286530;8225;1438;3563;5613;25878;347527;415;416;207063;4267;293;7499;9189;438;64109;6473;8227;55344;8623;8908,23,0.41748484620765800000
chr6,82512470,90113793,7601323,-1,1,4199;7162;90025;55122;3354;135293;57150;134701;4907;10492;2570;2569;167681;58528;154313;51167;9096;1268;22832;5238;25998;206412;23036;1081;112611;51465;23033;10957;81833;57231;57038;135295;8732;112609;23595;9892;10559;375519,38,0.49991297567541900000
chr15,72884575,75753300,2868725,-1,1,57184;1445;192683;84993;79661;653641;10021;9377;5371;10620;56905;79748;55889;80381;161514;9399;57611;1543;54939;1544;585;283677;25989;10066;83440;64220;60490;4756;653643;1198;105376731;594855;8482;80153;3671;1583;54913;80125;4351;4123;25942;388135;342096;4016;27020,45,1.56864112105552000000
chrX,132996180,133087198,91018,-1,1,2719,1,1.09868377683535000000
chr15,22770421,28723454,5953033,-1,1,2562;7681;123606;4948;57194;81614;2558;8924;114791;23742;7337;6638;2567;8926;283685;54551;4692;23191,18,0.30236687752276900000
chr18,62476341,78012829,15536488,-1,1,125704;54495;28513;147381;1528;55628;201456;79863;400658;4772;25914;84735;644041;9306;9658;4155;27164;440498;81832;1005;26251;80148;92126;9150;10194;220158;284273;79839;22850;10666;84552;55748;374868;29090;10907;284274;7776;220164;2587,39,0.25102198128689100000
chr7,72726578,74139390,1412812,-1,1,5982;51085;9275;84277;7462;135886;83451;1364;135892;6804;7461;155382;3984;26608;8468;9031;155368;2969;8326;7458;9569;2006;1365;114049,24,1.69873981817821000000
chr1,229951021,239800851,9849830,-1,1,84451;27185;54583;9804;440730;57568;10753;183;2590;22796;1130;84886;6894;64801;23029;7257;6905;7107;149373;55127;88;128178;388753;8443;51742;56605;645745;1131;54627;2786;148789;3964;375061;149371;57829;4548;148641;80003;3775;79605;4811;9453;83932;128061;84284;359948;6262;79573,48,0.48731805523547100000
chr2,111399243,113102535,1703292,-1,1,10461;699;129804;10018;84910;64682;376940;55289;84524,9,0.52838855580839900000
chr17,28454277,31595510,3141233,-1,1,79915;79736;7756;9527;2124;4974;26083;642;5717;51379;8851;55288;4642;26022;64149;55352;114659;55813;84440;1362;2123;55803;84081;388364;4763;23512;40;162494;84282;6532;124912,31,0.98687362573868300000
chr22,47786898,51178264,3391366,-1,1,85358;410;400935;85378;9701;56666;5600;49;9889;23774;80305;414918;79174;9997;1120;440836;1375;415116;83642;23542;644186;23209;6300;83933;79924;79087;6305;1890;348645;23654;25817;113730;29781;55586;91289;54456,36,1.06151916366443000000
chr9,94358815,99785745,5426930,-1,1,22869;158293;4814;445577;2176;84270;23299;56033;54754;4958;3376;22927;84641;55035;4969;4920;1842;169841;5727;89846;158431;11046;8555;64768;195828;8789;83744;10558;84909;138639;375748;3293;65268;401541;54829;441457;203328;2203;23196;195827;5253,41,0.75549159469534300000
chr10,74236933,79422266,5185333,-1,1,11319;9632;5328;118881;25961;310;5532;5033;51207;23234;170384;90550;159195;3778;84858;84647;142891;79933;23522;10367;26985;51021;58529;23053;338599;118490;118487;7414;414236;729092;83938;317662;170392;8509;818;132;7417;118491,38,0.73283625178942200000
chr7,112137064,119186429,7049365,-1,1,858;64418;51691;1080;83992;136991;29969;7982;7472;56311;5506;93986;4233;54329;22797;857;154743;26136;830,19,0.26952782271878400000
chrX,6570937,7885155,1314218,-1,1,412;8228;26609;8226,4,0.30436350742418700000
chr16,29673954,30198600,524646,-1,1,653808;5531;26470;283897;253980;146378;8479;83719;23475;283899;124446;9344;3835;4150;226;253982;83723;5595;6911;11151;8448;79447;112476;9961;10423;6693;79153,27,5.14632723779463000000
chr16,29673954,30198600,524646,-1,1,653808;5531;26470;283897;253980;146378;8479;83719;23475;283899;124446;9344;3835;4150;226;253982;83723;5595;6911;11151;8448;79447;112476;9961;10423;6693;79153,27,5.14632723779463000000
chrX,49371416,50201911,830495,-1,1,9506;8852;2543;389856;8712;139189;85417;1184,8,0.96328093486414700000
chr17,28732502,33065919,4333417,-1,1,79736;79915;9527;6354;51379;6347;400591;55813;2123;55803;23512;162494;6355;7756;6346;2124;4974;26083;5717;8851;55288;4642;26022;64149;6356;55352;114659;84440;1362;4763;124842;40;84282;6357;124912,35,0.80767671331884300000
chrX,41082474,41092226,9752,-1,1,8239,1,10.25430680885970000000
chrX,40926769,41148506,221737,-1,1,8239,1,0.45098472514735900000
chrX,40998091,41057271,59180,-1,1,8239,1,1.68976005407232000000
chrX,41032491,41059516,27025,-1,1,8239,1,3.70027752081406000000
chr15,22558757,29031689,6472932,-1,1,2562;7681;123606;4948;57194;81614;2558;8924;114791;23742;7337;6638;2567;8926;283685;653720;54551;4692;23191;283767,20,0.30897899128246700000
chr9,70984481,79549501,8565020,-1,1,9413;138199;51104;375743;23137;138255;116224;138240;2650;26578;9615;55071;54981;687;8395;5239;9414;6096;23670;5568;5125;138241;2395;55312;169693;80036;140803;158471;320;256691;7763;301;216;117531,34,0.39696346301584800000
chr9,98181648,98333827,152179,-1,1,5727,1,0.65712089053023100000
chr6,169451062,170911240,1460178,-1,1,28514;5689;84498;55780;253769;7058;6991;387263;55274;5134;6908,11,0.75333281284884400000
chr16,15048751,16276115,1227364,-1,1,4629;100288332;123811;89927;4363;54820;368;255027;23042;54700;123803;9665,12,0.97770506548994400000
chr16,15048751,16249607,1200856,-1,1,4629;100288332;123811;89927;4363;54820;368;255027;23042;54700;123803;9665,12,0.99928717514839400000
chr16,15492317,16249607,757290,-1,1,4629;123811;89927;4363;54820;255027;368;9665,8,1.05639847350421000000
chr16,29673954,30197341,523387,-1,1,653808;5531;26470;283897;253980;146378;8479;83719;23475;283899;124446;9344;3835;4150;226;253982;83723;5595;6911;11151;8448;79447;112476;9961;10423;6693;79153,27,5.15870665492265000000
chr16,29673954,30197341,523387,-1,1,653808;5531;26470;283897;253980;146378;8479;83719;23475;283899;124446;9344;3835;4150;226;253982;83723;5595;6911;11151;8448;79447;112476;9961;10423;6693;79153,27,5.15870665492265000000
chrX,23093129,23530035,436906,-1,1,139411,1,0.22888218518399800000
chr7,151810464,155965323,4154859,-1,1,155435;63917;389602;22976;58508;57180;7516;3361;6469;285888;1804;2020;3638,13,0.31288667076307500000
chr11,31437424,31957424,520000,-1,1,196294;120526;26610;5080,4,0.76923076923076900000
chr11,31152003,31693266,541263,-1,1,120526;26610;341019;196294,4,0.73901227314632600000
chr11,31422424,31751424,329000,-1,1,120526;26610;196294,3,0.91185410334346500000
chr11,31010424,31747424,737000,-1,1,120526;26610;341019;196294,4,0.54274084124830400000
chr6,1598592,1730086,131494,-1,1,2762;2296,2,1.52098194594430000000
chr6,1598592,1730086,131494,-1,1,2762;2296,2,1.52098194594430000000
chr11,31822424,31976424,154000,-1,1,5080,1,0.64935064935064900000
chr11,30918066,31698257,780191,-1,1,120526;26610;341019;196294,4,0.51269496828340800000
chr11,31741695,31837838,96143,-1,1,26610;5080,2,2.08023465046857000000
chr11,31277819,31795239,517420,-1,1,120526;26610;341019;196294,4,0.77306636774767100000
chr11,31242424,31892424,650000,-1,1,341019;196294;120526;26610;5080,5,0.76923076923076900000
chr11,21297424,32607424,11310000,-1,1,7490;258010;341019;57084;8424;159963;338645;4745;63982;203859;5080;143662;196074;196294;627;120534;2188;91057;81930;26610;100500938;55327;387758;55366;3739;2620;2488;5954;744;120526;10480,31,0.27409372236958400000
chr9,33997945,38321388,4323443,-1,1,203260;57462;92014;259308;5079;51754;392309;401505;79269;2189;730098;9853;6461;25853;7094;80256;84688;6366;1211;10488;2592;55833;138716;971;23349;25822;1271;10280;27240;7415;100129969;10020;84720;56656;7016;4882;8434;9380;375704;6363;84904;10850;9925;730112;26267;11258;26206;881;51010;7169;9827;347240;64425;203259;138715;10497;51271;392307;158234;57704;3590;9833;138724;646962;27019;158376;84186;692094;84681;768;152007;22844;152006;318;30968,75,1.73472854852024000000
chr2,32148619,33062281,913662,-1,1,55676;51072;57448;6683;58484;84661;84272;55622,8,0.87559732154779300000
chr17,15786351,20515050,4728699,-1,1,9487;2314;9720;125170;54902;11216;79018;254272;7314;8533;5598;218;224;80039;51655;256223;201163;7156;51030;10750;10743;100129396;140775;51393;57547;1819;147166;7732;91647;201161;3996;4239;201164;55244;9611;55090;645027;79999;284194;10400;54890;9706;92521;22905;729288;100996259;23164;83450;51168;5636;644815;125150;10517;654346;388436;27077;388341;6470;6720;146691;136;23495;57336;125206;146802;56953;400581,67,1.41688020320177000000
chr6,167684407,170911240,3226833,-1,1,3834;5689;54346;168002;100128124;79981;7058;253769;83887;387263;6991;55274;28514;84498;6953;55780;64094;4301;5134;6908,20,0.61980276016763200000
chr2,50818385,51148538,330153,-1,1,9378,1,0.30288987227134100000
chrX,296520,2226742,1930222,-1,1,28227;207063;293;286530;438;64109;6473;8227;1438;3563;8623,11,0.56988263526164300000
chr9,204193,5951392,5747199,-1,1,58524;10171;29126;2315;55664;5991;50808;10655;7436;3717;6505;158358;6013;57589;157983;3641;81704;23189;403313;169522;6595;79956;9933;6019;55848;11172;1761;169792;55064;80380,30,0.52199340931121400000
chr19,3364791,4334388,969597,-1,1,126259;51341;6915;5605;4145;126321;1613;51343;55620;9546;10362;84839;116541;4782;23396;79187;51548;1938;83475;27134;100128569;56961;170961;84699;284422;27231;23217;10148;55702;85300;51588;58509;126326,33,3.40347587709120000000
chr17,16590776,20463301,3872525,-1,1,2314;9720;55244;125170;55090;11216;79018;79999;284194;10400;54890;254272;9706;400581;92521;8533;22905;729288;100996259;5598;218;23164;83450;224;51168;80039;51655;201163;7156;51030;5636;644815;10750;4239;10517;654346;10743;388436;27077;100129396;140775;6470;146691;1819;6720;125206;23495;147166;7732;146802;91647;56953;645027;3996;201164,55,1.42026197377680000000
chr6,148701499,150410578,1709079,-1,1,80328;80329;84918;11104;135250;154064;387082;116254;23328;79465;23118;5110;353091;10090;340152;9113;348995;85313,18,1.05319882814077000000
chr15,22765628,27783485,5017857,-1,1,2562;7681;123606;57194;81614;2558;114791;23742;7337;6638;2567;8926;283685;54551;4692;23191,16,0.31886121904231200000
chr5,86584339,88062552,1478213,-1,1,4208;153396;5921;902,4,0.27059699786160700000
chr17,34450405,36243028,1792623,-1,1,26574;9326;6928;3975;414060;79893;729877;31;6349;80179;284098;11072;9560;414062;101060321;414059;79922;11276;79154;11056;6871;284099,22,1.22725190963186000000
chr1,162703368,171908659,9205291,-1,1,481;375035;9095;84944;8548;149281;2153;6402;51603;4259;54499;92235;440699;57821;2328;51478;7371;5451;83540;10223;9019;10560;25874;80133;8674;6401;4009;5396;5999;23215;117143;8490;339512;92344;57645;4921;8804;55827;92342;26052;29922;6403;55811;1805;2329;2326;919;2327;55732;223;6375;261726;57147;22920;4653;92241;5087;6846;6258;387597;149297;23432,62,0.67352569299547400000
chr8,7169490,12404062,5234572,-1,1,401447;392197;1508;377630;83650;504180;503841;245940;203076;83648;55894;245910;613209;157285;252969;245908;100132396;503618;54984;392188;100289462;4482;613211;203074;245909;90459;503614;140596;83595;100133267;100133251;653423;100131980;645402;2626;85002;613210;137075;1673;728957;100131608;640;66036;286046;79660;2222;8658;9258;414325;653333;94137;10407;645836,53,1.01249920719402000000
chr1,146507518,147824207,1316689,-1,1,9557;51205;51463;5565;607;2702;2330;200030;2703,9,0.68353270969834200000
chr22,18661724,20311763,1650039,-1,1,54487;27037;5413;29801;65078;23617;10587;1312;7122;8214;7290;421;128977;8220;2812;388849;7353;2928;128989;6899;9993;54584;5625;79680;85359;64976;8318;5902;6576;8218,30,1.81813884399096000000
chr10,121862637,135434178,13571541,-1,1,196792;253738;1755;8433;399818;5791;282973;50632;10570;1793;340784;4942;54780;196051;7390;594857;119467;196743;118663;9184;1571;84435;503542;10844;80313;256536;8038;4288;5654;92170;36;118471;51363;170394;55844;54777;118670;4255;399823;1488;118611;11101;55717;2849;85442;387718;27287;118672;59338;2263;55760;282974;54764;664;282969;56647;119587;118856;101;1892;23172;80007;3167;642938;387715;10579;10539;118472;9679;3632;64376;84504;26098;50624;92565;399814;390010;64077;93426,79,0.58210044091529500000
chr8,71544918,73525716,1980798,-1,1,9242;2138;9312;8989;51110;389668,6,0.30290822183786500000
chr7,153918548,159126310,5207762,-1,1,155435;140545;3361;64327;5799;1804;64434;10049;9690;389602;22976;55112;6469;3110;7434;285888;54892;2020;3638;57488,20,0.38404212788526000000
chr22,18894835,21464119,2569284,-1,1,54487;27037;9342;29801;65078;10587;1312;6545;8214;421;7290;2812;6899;5625;7625;79680;64976;6576;3053;8218;5413;80764;23617;400891;1399;7122;150209;128977;8220;388849;84861;7353;51586;2928;128989;5297;9127;9993;54584;91179;85376;8216;85359;8318;728229;5902,46,1.79038206753321000000
chr13,110723731,115092648,4368917,-1,1,7027;55795;79587;79774;3916;8874;22821;55608;8858;55647;10426;1284;101928841;2621;400165;113622;65110;121793;283489;23263;55739;643365;55002;3621;1282;100129836;6656;23250;2155;2159;55208;496;6011;122258;348013;8881;8451,37,0.84689180407867700000
chr8,140297719,144576458,4278739,-1,1,1584;389692;5747;11156;22898;111188157;1585;57152;27161;8581;116447;8000;23237;4061;2765;54108;114822;338328;8629;57210;79943;203062;51337;105375787;23144;137797;66004;286128;2843;83696;575;389690;432355;2738;51305;4062;54742,37,0.86474075656402500000
chr16,28837450,29042118,204668,-1,1,11273;27040;79874;7284;930;84901;487;83985;25970,9,4.39736548947564000000
chr15,99049131,101293703,2244572,-1,1,145814;283777;4205;123355;204219;55180;23336;170691;64927;3480;140460;145748,12,0.53462308181693400000
chr22,18919942,20311763,1391821,-1,1,54487;27037;5413;29801;65078;23617;10587;1312;7122;421;7290;128977;8220;2812;388849;7353;2928;128989;6899;9993;54584;5625;79680;85359;64976;8318;5902;6576;8218,29,2.08360126769175000000
chr1,6695148,7630401,935253,-1,1,23261;90326;55735,3,0.32076881870467100000
chr17,29033905,30326929,1293024,-1,1,79915;79736;55352;55813;2124;84440;2123;55803;4974;4763;23512;84282;51379,13,1.00539510480857000000
chr20,49508676,49571808,63132,-1,1,8813;23394,2,3.16796553253501000000
chr16,15493046,18069465,2576419,-1,1,4629;123811;64131;89927;4363;54820;408050;255027;101059938;368;9665,11,0.42694918800086500000
chr22,18919942,21440514,2520572,-1,1,54487;27037;9342;29801;65078;10587;1312;6545;421;7290;2812;6899;5625;7625;79680;64976;6576;3053;8218;5413;80764;23617;400891;1399;7122;150209;128977;8220;388849;84861;7353;51586;2928;128989;5297;9127;9993;54584;91179;85376;8216;85359;8318;728229;5902,45,1.78530904889842000000
chr17,43717703,44210822,493119,-1,1,246744;162540;104909134;1394;4137;284058,6,1.21674484252280000000
chr2,220158232,225214248,5056016,-1,1,23704;10290;29926;2181;3623;10056;2043;5270;23549;55515;6508;114790;116255;130612;7857;5798;57590;100996693;389075;23363;1674;79586;130367;130340;5077;151278;65080,27,0.53401729741361600000
chr5,26142,2453629,2427487,-1,1,4726;10016;7015;6389;81037;11336;133957;9319;340024;65980;348932;153478;85409;79844;50805;57491;6550;64979;79888;10723;6531;11076;55722;389257,24,0.98867676737300800000
chrX,6467006,8131810,1664804,-1,1,412;8228;26609;8226,4,0.24026852410253700000
chr4,72447,11175255,11102808,-1,1,728373;257236;7700;521;7469;79155;644414;401115;728393;133060;4636;728419;55646;6286;654254;53407;54872;166793;114932;1609;55351;9948;2121;79441;100287513;7468;152877;285489;3166;84448;1816;353497;152789;100287205;9778;10861;92305;285498;57537;100287404;728379;8532;10815;27065;2580;53834;84179;5158;116449;728386;402160;3425;152687;4487;6047;54729;6002;54360;728405;27201;7466;10227;57533;10336;10417;152992;93621;93624;345222;84286;56606;2261;255403;4043;8602;7884;170960;100287441;57732;132884;10296;3083;3064;100287238;768239;100287364;57654;10460;85013;728400;100287327;100287478;118;1400;3954;152;100288520;60312;85460;94031;23324;55330;728369;100287178;339983;6452;5522;10608;1487;100287144;8310;80273;2868;54436;389199;285464;8603,117,1.05378747430380000000
chr16,89833580,89877173,43593,-1,1,2175,1,2.29394627577822000000
chr6,15521690,16846846,1325156,-1,1,3720;2766;6310;29116;84062,5,0.37731406717397800000
chr6,170426,9797451,9627025,-1,1,6745;154007;6239;57128;9450;56940;1832;654;94234;2296;9425;63027;51299;9521;222826;670;5272;10799;285782;3662;10455;404220;648791;389362;10667;2762;1992;2162;4835;8899;8737;2295;56897;63915;81567;55770;340156;7280;51000;347733;221749;26240;83732;135458;5269,45,0.46743412424918400000
chr14,101297515,101361403,63888,-1,1,388015,1,1.56523916854495000000
chr14,101297515,101361403,63888,-1,1,388015,1,1.56523916854495000000
chr16,29673954,30198600,524646,-1,1,653808;5531;26470;283897;253980;146378;8479;83719;23475;283899;124446;9344;3835;4150;226;253982;83723;5595;6911;11151;8448;79447;112476;9961;10423;6693;79153,27,5.14632723779463000000
chr12,69936826,72307558,2370732,-1,1,55266;5801;117177;10818;64786;23011;83591;10576;5787;376132;196446;4848;27345;144453;8549;7103;196441,17,0.71707810077225100000
chr3,189233607,189947958,714351,-1,1,55214;8626,2,0.27997441033889500000
chr1,146564743,147786706,1221963,-1,1,9557;51205;51463;5565;607;2702;2330;200030;2703,9,0.73651984552723800000
chr22,18919942,21440514,2520572,-1,1,54487;27037;9342;29801;65078;10587;1312;6545;421;7290;2812;6899;5625;7625;79680;64976;6576;3053;8218;5413;80764;23617;400891;1399;7122;150209;128977;8220;388849;84861;7353;51586;2928;128989;5297;9127;9993;54584;91179;85376;8216;85359;8318;728229;5902,45,1.78530904889842000000
chr7,72726578,74139390,1412812,-1,1,5982;51085;9275;84277;7462;135886;83451;1364;135892;6804;7461;155382;3984;26608;8468;9031;155368;2969;8326;7458;9569;2006;1365;114049,24,1.69873981817821000000
chr2,111044816,111399243,354427,-1,1,729540;100288695;699,3,0.84643664280655800000
chr15,30954726,32635959,1681233,-1,1,161725;283710;54893;51621;4308;22909;1139,7,0.41636108736861600000
chr12,65078661,68906300,3827639,-1,1,100129940;23329;11197;55801;8091;55832;8445;84298;23592;50616;253827;56890;283349;3458;92797;23426;51643;11213;2799,19,0.49638954979819200000
chr3,110863961,120154172,9290211,-1,1,10225;151887;7634;55254;201633;205717;257144;2932;8702;131450;80218;89876;941;523;79691;2596;79669;55779;152404;257068;254887;29114;56983;57514;285335;90102;4345;11167;64422;79413;10063;25945;91653;165829;64091;1814;51365;4045;152405;152185;54847;54762;344805;55347;7348;141;8856;151888;57577;25871;116064;26137;55032;29083;51300;344807,56,0.60278501747699800000
chr2,50792617,51122150,329533,-1,1,9378,1,0.30345974454758700000
chrX,32543770,32984400,440630,-1,1,1756,1,0.22694777931597900000
chr5,151737,1340609,1188872,-1,1,10016;7015;6389;133957;11336;9319;340024;153478;348932;65980;81037;85409;79844;57491;6550;10723;11076;55722;389257,19,1.59815354386343000000
chr17,58120809,60316749,2195940,-1,1,10513;124773;342538;84669;388407;9969;6909;8493;63897;9496;762;54828;57508;83990,14,0.63754018780112400000
chr14,101204495,101340732,136237,-1,1,8788,1,0.73401498858606700000
chr14,101204495,101340732,136237,-1,1,8788,1,0.73401498858606700000
chr22,18916842,21798907,2882065,-1,1,54487;27037;9342;29801;65078;10587;1312;6545;421;7290;2812;6899;5625;7625;79680;23119;64976;6576;3053;8218;5413;80764;23617;400891;1399;7122;150209;128977;8220;388849;84861;7353;51586;2928;128989;5297;9127;9993;54584;91179;85376;8216;440804;85359;8318;728229;5902,47,1.63077515600793000000
chr8,20819980,24767936,3947956,-1,1,55909;80346;55806;9583;8756;9796;649;10361;57805;91782;203069;2675;157310;27299;10863;23221;23516;1960;9046;5533;23039;10174;8795;6781;64236;541565;79873;137814;6440;203190;55124;8797;4017;4824;8794;8793;661;8822;2039;51312;64760,41,1.03851208068175000000
chr6,1309409,3501166,2191757,-1,1,389362;2762;1992;4835;94234;2296;8737;63027;2295;56897;340156;670;7280;347733;5272;5269,16,0.73000793427373600000
chr17,14101029,15420960,1319931,-1,1,1352;64518;9953;201158;284040;100533496;5376;146822,8,0.60609228815748700000
chr16,29656684,30190568,533884,-1,1,653808;5531;26470;283897;253980;146378;8479;83719;23475;283899;124446;9344;3835;4150;226;253982;83723;5595;6911;8448;79447;112476;9961;10423;6693;79153,26,4.86997175416383000000
chr1,144289645,148545664,4256019,-1,1,9557;148738;128077;84265;9659;10628;2330;653519;5174;388677;200035;51205;284615;645142;5565;148741;10623;100132406;9939;27246;11126;400818;8799;149013;10401;644591;8515;51463;607;2702;200030;2703,32,0.75187634265730500000
chr7,100606848,119393804,18786956,-1,1,24146;222255;154907;50640;246721;51691;81844;1080;83992;29969;80228;5577;1811;60561;4584;375607;4233;136227;5172;22797;857;55904;100310812;26136;79872;830;375612;286006;83943;3912;9512;64418;10234;5054;4189;10603;7982;5001;100134938;27000;4897;222235;5649;7425;100271927;10467;54784;58160;222234;93408;858;222256;729597;6733;346606;10466;548644;22798;3475;11179;8985;136991;9732;5294;1738;7472;79706;83787;5701;56311;26959;10156;140453;154743;10071;1174;222229;51024;11062;5439;64792;1523;441273;222236;10135;6856;2845;100289561;5506;54517;55973;93986;168455;54329;168451;54674;375611,97,0.51631568200830400000
chr5,6801589,18992827,12191238,-1,1,54463;10299;9037;7204;50834;134145;4651;651746;83853;134147;1501;56172;4552;54491;22948;23194;1767;79072;108;441061;90268;10409;134121;90441;1611,25,0.20506531002019600000
chr18,136226,4409550,4273324,-1,1,116;55556;10403;9663;103910;7050;9984;9097;7525;81035;23347;10627;494514;64863;1068;8736;27098;9229;84034;7298,20,0.46801974294483600000
chr2,174065715,190659870,16594155,-1,1,3235;129831;344191;1281;4760;5136;150737;3232;3238;51661;10203;4780;3234;83879;494513;9541;80856;3237;84128;100131390;6670;375298;150709;51454;151556;1386;114880;91752;29789;8540;50940;79634;91404;1290;10787;151242;55854;1134;8575;165215;3685;142679;1123;116093;51776;151112;57703;3236;129401;151126;30061;518;54529;10651;10477;92104;3239;3233;220988;6744;64172;3231;2487;94101;54431;5378;3676;285025;7035;65977;7273;7456,72,0.43388771528288100000
chr18,136226,15181666,15045440,-1,1,116;23255;57132;8774;645369;125228;57045;103910;642597;84617;9097;7525;10650;3613;56984;65258;79822;84034;4729;23253;9663;9989;339291;9984;10928;162655;63895;201475;64863;342850;27098;646000;753;7541;55125;55556;10403;4158;84203;388468;147495;9218;5797;494514;1149;5771;10939;1068;79959;9229;7298;91133;11031;56907;7050;81929;4161;81035;2774;23347;10627;8731;8736;374860;284217;23136,66,0.43867111895697300000
chr22,46168628,51115526,4946898,-1,1,85358;150383;410;400935;85378;9701;56666;5600;25771;23151;23774;9889;80305;414918;55267;79174;9997;9620;1120;440836;64781;5465;1375;415116;83642;23542;644186;23209;6300;10343;83933;79924;7477;25814;79087;55020;55687;6305;51512;1890;348645;23654;25817;113730;29781;55586;91289;54456,48,0.97030502751421200000
chr21,46597460,48097372,1499912,-1,1,3275;54059;6573;6285;8888;1292;5116;104;84221;80781;4047;54039;54058;10841;1291;23181;23275,17,1.13339982612313000000
chr2,131461909,147661652,16199743,-1,1,11249;4249;53353;4175;205147;29798;79712;81615;90557;55843;80122;339745;2863;23518;1615;7852;905;22930;113457;130013;9839;3176;130074;646915;445582;150786;84083;408029;80731;116372;55041;3938;653784;344148;344561;23190;8942;50649,38,0.23457162252512300000
chr5,113576,12747875,12634299,-1,1,10299;50834;79192;81037;11336;65980;50805;134147;153571;1501;11044;64979;22948;108;79888;10723;11076;23379;1611;4726;9037;10016;7015;6389;134145;133957;9319;340024;348932;153478;153572;54888;651746;85409;79844;83853;57491;4552;6550;170690;134121;79072;6715;6531;134111;55722;84246;389257,48,0.37991818936689700000
chr8,158040,6940661,6782621,-1,1,389610;9172;728358;1669;26260;1667;157697;64478;1671;9639;79648;1670;169270;285;157695;9228;55326;9920;1672;1668;2055,21,0.30961482294234000000
chr5,176534633,176635283,100650,-1,1,64324,1,0.99354197714853500000
chr11,123062324,123066147,3823,-1,1,79827,1,26.15746795710180000000
chr15,22770421,36101244,13330823,-1,1,321;7681;440270;256646;23015;123606;57099;57369;643699;23359;9990;6263;6638;254531;22909;342184;8926;161725;283710;283685;653720;89839;4692;54893;1133;23191;51234;728498;2562;101059918;6447;9824;70;79768;161779;89978;4948;57194;55505;81614;4308;2558;1139;7082;8924;114791;23742;51621;7337;89832;653125;26585;653073;2567;54989;56851;54551;9716;728047;56160,60,0.45008473970436800000
chr16,85880,2145951,2060071,-1,1,283951;3029;51764;254528;90850;124056;645811;90861;84331;3039;64714;23162;84326;9143;4832;6123;1186;10573;3483;57585;64499;9727;117166;197342;9028;390667;9742;65990;4913;10232;3042;7329;339123;398;283948;8786;79006;84219;23430;63922;3050;6755;7177;146310;8938;390664;55692;3040;7249;30812;64285;65993;146325;124093;4833;115939;8312;89941;10607;8131;64711;84264;58986;79622;84572;90864;51728;26063;9894;5310;64718;79652;6650;10101;81889;4350;64428;64788;25823;146330;83986;4716;10273;283869;3049;57799;6187;197335;51734;9091;9351;8912;2671;388199;113000,95,4.61149154567974000000
chr16,85880,2146448,2060568,-1,1,283951;3029;51764;254528;90850;124056;645811;90861;84331;3039;64714;23162;84326;9143;4832;6123;1186;10573;3483;57585;64499;9727;117166;197342;9028;390667;9742;65990;4913;10232;3042;7329;339123;398;283948;8786;79006;84219;23430;63922;3050;6755;7177;146310;8938;390664;55692;3040;7249;30812;64285;65993;146325;124093;4833;115939;8312;89941;10607;8131;64711;84264;58986;79622;84572;90864;51728;26063;9894;5310;64718;79652;6650;10101;81889;4350;64428;64788;25823;146330;83986;4716;10273;283869;3049;57799;6187;197335;51734;9091;9351;8912;2671;388199;113000,95,4.61037927406424000000
chr6,93082925,110504681,17421756,-1,1,221264;253714;639;100130890;7101;84539;64780;84816;256380;57673;28962;6492;8724;29078;51805;57531;2898;202;57107;892;2830;85015;10973;9841;5454;25957;10690;246269;59336;23376;27244;84553;8763;84071;285755;11149;9457;2309;8936;51362;114792;389421;81491;55084;2045;79694;5550;64208;221262;11231;51250;9474;26235;9896;55278;285753;6610,57,0.32717712267351200000
chrX,146425635,151604987,5179352,-1,1,158521;84548;4110;4108;2564;1260;541578;4109;2334;2556;203547;139135;4104;91966;728269;4107;100533997;79057;3149;4103;89885;10046;4534;3423;9248;83692;101928917;100130086;2332;100506164;8776,31,0.59853047253787700000
chr10,121468628,135426384,13957756,-1,1,196792;253738;1755;8433;399818;5791;50632;79892;282973;10570;1793;340784;4942;54780;196051;7390;594857;119467;196743;118663;9184;1571;84435;503542;10844;22876;256536;80313;8038;11196;4288;5654;92170;36;118471;51363;170394;55844;54777;118670;4255;399823;1488;118611;11101;55717;2849;85442;387718;27287;118672;59338;2263;55760;282974;54764;664;282969;56647;119587;118856;101;1892;23172;80007;3167;642938;387715;10579;10539;118472;9679;3632;64376;84504;26098;50624;92565;399814;390010;64077;93426,82,0.58748698573037100000
chr9,4339192,18272756,13933564,-1,1,10171;23081;55664;89882;9350;50808;158358;6619;203238;5789;6019;54796;286343;158326;55064;6505;29126;2315;4781;11168;100129385;8777;6456;340481;26953;90865;3717;90871;54875;6013;57589;3641;7306;403313;158219;115426;79956;2731;55848;11172;80380,41,0.29425350183197900000
chr17,43703801,44212416,508615,-1,1,246744;162540;104909134;1394;4137;284058,6,1.17967421330476000000
chr15,22770421,23282799,512378,-1,1,123606;23191;114791;81614,4,0.78067364328679200000
chr18,65997926,78014123,12016197,-1,1,125704;54495;147381;1528;55628;201456;79863;400658;4772;25914;84735;644041;9306;9658;4155;27164;440498;81832;26251;80148;9150;10194;220158;284273;79839;22850;10666;84552;55748;374868;29090;10907;284274;7776;220164;2587,36,0.29959562081081100000
chr11,19909597,34927853,15018256,-1,1,79832;10553;258010;341019;8424;159963;966;4005;5080;143662;196074;627;120534;4076;91057;51074;100500938;847;25758;10196;91614;3739;2620;2488;1479;55226;5954;9152;25841;744;55346;493860;7490;57084;120237;4745;338645;203859;63982;196294;2188;26273;81930;26610;79056;55327;26298;89797;387758;55366;10114;100131378;120526;10480;2001,55,0.36622095135413900000
chr16,29580020,30176508,596488,-1,1,653808;5531;26470;283897;253980;146378;8479;83719;23475;283899;124446;9344;3835;4150;226;253982;83723;5595;6911;8448;79447;112476;9961;10423;6693;79153,26,4.35884711846676000000
chr16,29567295,30177999,610704,-1,1,653808;5531;26470;283897;253980;146378;8479;83719;23475;283899;124446;9344;3835;4150;226;253982;83723;5595;6911;8448;79447;112476;9961;10423;6693;79153,26,4.25738164479028000000
chr22,18916842,21798907,2882065,-1,1,54487;27037;9342;29801;65078;10587;1312;6545;421;7290;2812;6899;5625;7625;79680;23119;64976;6576;3053;8218;5413;80764;23617;400891;1399;7122;150209;128977;8220;388849;84861;7353;51586;2928;128989;5297;9127;9993;54584;91179;85376;8216;440804;85359;8318;728229;5902,47,1.63077515600793000000
chr7,15173336,23108143,7934807,-1,1,196;392636;55536;27075;222894;25928;256130;256227;340273;28969;4223;3569;100506049;84668;155465;10551;9771;221830;57037;221823;7291;221833;23161;8701;6671;9734;346389;3696;54543;729920,30,0.37808102957009500000
chr16,51170089,51246010,75921,-1,1,6299,1,1.31715862541326000000
chr8,131465786,137325904,5860118,-1,1,6482;7038;51105;6503;10086;10397;8840;10656;137835;57623;23167;114;23639;729330;3786,15,0.25596754195052000000
chr17,34817422,36168104,1350682,-1,1,26574;284099;9326;284098;11072;6928;79154;79922;3975;11276;79893;11056;6871;31;80179,15,1.11055007766447000000
chr18,65094544,78014582,12920038,-1,1,125704;54495;147381;1528;55628;201456;79863;400658;4772;25914;84735;644041;9306;9658;4155;27164;440498;81832;26251;80148;92126;9150;10194;220158;284273;79839;22850;10666;84552;55748;374868;29090;10907;284274;7776;220164;2587,37,0.28637686669342600000
chr16,3827823,3833104,5281,-1,1,1387,1,18.93580761219470000000
chr6,383951,4753825,4369874,-1,1,10455;404220;389362;2762;1992;4835;94234;2296;8899;8737;63027;2295;56897;222826;55770;670;340156;7280;347733;221749;5272;26240;3662;135458;5269,25,0.57209887516207600000
chrX,60701,9619811,9559110,-1,1,414;51481;171482;425054;1438;5613;347527;415;207063;293;412;438;64109;51480;55344;8623;6907;28227;286530;57502;8226;8228;3730;8225;3563;26609;25878;416;4267;7499;9189;6473;8227;171483;8908,35,0.36614287313358700000
chr22,19004735,21798907,2794172,-1,1,54487;27037;9342;29801;65078;10587;1312;6545;421;7290;2812;6899;7625;79680;23119;64976;6576;3053;8218;5413;80764;23617;400891;1399;7122;150209;128977;8220;388849;84861;7353;51586;2928;128989;5297;9127;9993;54584;91179;85376;8216;440804;85359;8318;728229;5902,46,1.64628376492213000000
chr22,18644790,21800797,3156007,-1,1,54487;27037;9342;29801;65078;10587;1312;6545;8214;7290;421;2812;6899;5625;7625;79680;23119;64976;11274;6576;3053;8218;5413;80764;23617;400891;1399;7122;150209;128977;8220;388849;84861;7353;51586;2928;128989;5297;9127;9993;54584;91179;85376;8216;440804;85359;8318;728229;5902,49,1.55259478195074000000
chr9,140298046,140535223,237177,-1,1,92715;92714;10811;54932;377841;26012;79813;116225;375775;64975,10,4.21626042997424000000
chr1,752566,15416326,14663760,-1,1,10277;100526739;1677;93190;83858;6146;5590;728661;57540;23463;9636;8510;440560;10630;64856;765;26155;140625;26232;6518;54206;8764;65220;339456;261734;375790;388581;148398;9563;80835;57449;80045;643965;5195;60672;2023;440561;391003;5351;2782;9651;1855;84328;57801;23435;387509;26038;81669;6497;643988;7161;22883;400736;126792;8718;388591;126767;11315;63976;10459;6339;11079;80772;50651;26270;343071;148479;79258;8514;339448;126755;9903;9927;148345;729528;118424;55210;54991;473;142678;441869;79707;2475;390999;49856;57470;388588;85452;56998;127262;199990;391004;93611;4878;100287898;10747;80176;441871;1676;378708;55229;10911;90326;7133;943;401934;55735;54897;284498;51150;391002;653619;8784;343066;9731;1185;27237;6723;23095;343069;10218;29914;155184;4524;5394;3604;8863;84275;126789;199953;29101;374946;1325;645382;339453;440563;83715;219293;163688;5226;84808;55187;11332;388585;645425;54626;55052;23254;254173;400735;57085;984;54587;5192;54973;84069;4879;54998;9906;148870;116983;339451;390992;55966;65122;3104;7293;728642;127281;2563;64802;645414;116362;441873;9249;9341;83756;23261;90231;1953;79906;343068;5293;65121;7799,185,1.26161366525366000000
chr22,47856365,51178234,3321869,-1,1,85358;410;400935;85378;9701;56666;5600;49;9889;23774;80305;414918;79174;9997;1120;440836;1375;415116;83642;23542;644186;23209;6300;83933;79924;79087;6305;1890;348645;23654;25817;113730;29781;55586;91289;54456,36,1.08372726317624000000
chr18,148963,14081887,13932924,-1,1,116;55556;10403;23255;57132;4158;8774;645369;84203;125228;57045;103910;642597;84617;9097;7525;147495;10650;9218;3613;5797;494514;1149;56984;5771;10939;1068;65258;79959;9229;79822;84034;4729;7298;91133;11031;23253;9663;56907;9989;7050;339291;81929;4161;9984;81035;10928;2774;23347;63895;10627;8731;201475;64863;8736;342850;27098;284217;646000;753;23136;7541;55125,63,0.45216639378783700000
chr17,34456073,36347393,1891320,-1,1,26574;9326;6928;3975;414060;79893;729877;31;729873;6349;80179;284098;11072;9560;414062;101060321;414059;79922;11276;79154;11056;101060376;6871;284099,24,1.26895501554470000000
chr5,150243846,169117584,18873738,-1,1,348938;9685;26762;2890;6586;9337;9232;7265;285643;134353;1879;79616;147;153830;408263;57451;134510;79646;23120;63920;3593;10569;8728;23286;206358;29093;55568;1794;91937;10146;56923;27430;25929;6678;153201;2561;2760;285641;54974;2878;3702;114825;79685;345611;2196;4238;9421;2741;84868;153745;6444;900;26112;2566;2554;23367;26999;2559;10827;5917;9443;10318;114898;91975;10826;100190949;11063;54908;134492;2172;3161;475;309,73,0.38678082741214300000
chr12,77878203,83378230,5500027,-1,1,29080;8825;4659;4617;8499;84190;160335;374462;5074;283310;79611;4618;6857;89795,14,0.25454420496481200000
chr15,92688957,94233207,1544250,-1,1,145858;28232;56963;1106;400451;8128,6,0.38853812530354500000
chr22,18919476,21798907,2879431,-1,1,54487;27037;9342;29801;65078;10587;1312;6545;421;7290;2812;6899;5625;7625;79680;23119;64976;6576;3053;8218;5413;80764;23617;400891;1399;7122;150209;128977;8220;388849;84861;7353;51586;2928;128989;5297;9127;9993;54584;91179;85376;8216;440804;85359;8318;728229;5902,47,1.63226693051509000000
chr17,16756344,20430791,3674447,-1,1,2314;55244;125170;55090;11216;79018;79999;284194;10400;54890;254272;9706;400581;92521;8533;22905;729288;100996259;5598;218;23164;83450;224;51168;80039;51655;201163;7156;51030;5636;644815;10750;4239;10517;654346;10743;388436;27077;140775;6470;146691;1819;6720;125206;23495;147166;7732;146802;91647;56953;645027;3996;201164,53,1.44239391669005000000
chr8,8093065,11888779,3795714,-1,1,1508;83650;83595;203076;2626;83648;613210;137075;613209;157285;640;66036;252969;286046;79660;2222;54984;613211;4482;8658;203074;9258;90459;94137,24,0.63229210630727200000
chr7,125875286,127816631,1941345,-1,1,381;168850;29999;64101;2918;79571;27044;5078,8,0.41208543561293800000
chr12,131428181,133777562,2349381,-1,1,6433;192111;100289635;5426;5827;57634;100507055;7574;101060200;10795;2802;7637;22953;7699;55743;283383;4326;8408;80324;317781;79050;7556;23141;50614;57666,25,1.06411007835681000000
chr16,29673967,30190593,516626,-1,1,653808;5531;26470;283897;253980;146378;8479;83719;23475;283899;124446;9344;3835;4150;226;253982;83723;5595;6911;8448;79447;112476;9961;10423;6693;79153,26,5.03265418310344000000
chr22,46988862,51178264,4189402,-1,1,85358;410;400935;85378;9701;56666;5600;49;25771;23151;23774;9889;80305;414918;79174;9997;1120;440836;64781;1375;415116;83642;23542;644186;23209;6300;83933;79924;79087;6305;1890;348645;23654;25817;113730;29781;55586;91289;54456,39,0.93092045117656400000
chr14,104478740,107282437,2803697,-1,1,647310;23241;1397;283643;90135;122616;207;400258;64423;55038;374569;9112;122402;122622;3714;10572;283638;26153;100128927;1396;29933;122618;80757;113146;388021;2972;256281,27,0.96301419161913700000
chr2,233854244,243068396,9214152,-1,1,54658;151176;64090;84289;285093;339768;6694;2859;130916;64284;10267;79083;414061;54579;9759;150681;189;54578;51078;79781;57140;25992;55230;9208;3635;6295;54657;2637;54659;11132;389090;23192;54577;55502;3069;10494;54576;117581;54575;285193;25791;8864;26146;23178;1293;5133;80895;23677;10920;10123;377007;5510;51665;4705;57007;150677;1841;4759;129807;150678;140739;2817;4735;9855;401036;51540;375318;339766;547;55054;116987;79919;8527;51052;375316;55355;79054;54600;51281;666;50636;653437;728294,83,0.90078826570258500000
chr12,75067173,82730083,7662910,-1,1,8825;23390;8499;114882;144321;1466;4618;79611;5074;283310;79738;6857;89795;22822;11010;4673;4659;4617;144455;374462;256710;3747;84698;11103,24,0.31319694476380400000
chr22,18628147,21407681,2779534,-1,1,54487;27037;9342;29801;65078;10587;1312;6545;8214;7290;421;2812;6899;5625;7625;79680;64976;11274;6576;3053;8218;5413;80764;23617;400891;1399;7122;150209;128977;8220;388849;84861;7353;51586;2928;128989;5297;9127;9993;54584;91179;85376;8216;85359;8318;728229;5902,47,1.69093092583145000000
chr15,23208902,29006792,5797890,-1,1,2562;7681;23742;8924;7337;6638;2567;4948;8926;57194;283685;653720;54551;4692;2558,15,0.25871480831819900000
chr2,241014100,243041364,2027264,-1,1,64090;84289;5510;285093;728294;150677;1841;129807;2859;130916;150678;2817;4735;375318;189;51078;547;79919;57140;25992;11132;23192;3069;10494;51281;285193;666;23178;50636;653437;5133;9855,32,1.57848213158227000000
chr4,85537264,100681416,15144152,-1,1,23001;55008;658;83478;56955;5783;51191;9429;100996939;84992;401145;131;266812;10611;285555;124;4547;22915;152926;2895;3381;8633;8916;1040;285513;10144;130;5311;126;84103;51170;127;4299;27306;6622;56916;345275;5602;1758;132989;6696;1977;345274;5161;474;93587;1834;166815;53343;5910;128;57563;8404;23173;10098;125,56,0.36977970110178500000
chr22,45536752,51178264,5641512,-1,1,85358;150383;410;400935;85378;2192;56666;5600;9701;27127;49;25771;23151;23774;9889;80305;414918;55267;79174;9997;9620;1120;440836;55007;64781;5465;1375;415116;83642;23542;644186;7380;23209;6300;10343;83933;79924;7477;23313;25814;10762;79087;55020;55687;6305;51512;1890;348645;23654;25817;113730;29781;55586;91289;54456;26150,56,0.99264168896565300000
chr5,107514482,125007433,17492951,-1,1,642987;4015;93166;28966;56929;51014;167227;57507;353376;1176;644100;285605;91137;9627;64848;9315;3295;51334;100505841;83942;9867;153241;134430;6728;100302736;1657;25816;153443;153733;9140;814;324;2241;5229;94033;64097;4124;1036;340069;6643;4163;51397;5480;1456;3781;55521;134429;206338;64839;7905;57556;85480;133923,53,0.30297918287200400000
chr1,12784752,20348108,7563356,-1,1,93190;4681;440567;63036;11223;391004;126917;353238;22977;51032;5081;440560;842;10630;11330;3362;441871;388595;51702;127707;23352;11240;8574;30814;54546;23400;391002;440561;23013;391003;653619;23341;79363;6390;55160;5320;284723;55920;832;440574;343069;6248;23252;255104;23569;1969;81569;114827;8659;645382;79814;440563;400736;55092;374955;9696;55672;26099;126767;23065;84966;645425;80834;23254;343071;400735;27129;54896;79180;128272;126755;729528;4237;7709;65122;100532736;29943;645414;441873;1188;23207;54751;149563;727684;390999;51154;84301;348487;343068;1187;55707;54455;65121;7799,94,1.24283453006840000000
chr20,61468347,62908674,1440327,-1,1,54345;6919;10139;3785;198437;1137;1299;140700;10287;2832;100132911;85441;4987;11083;8771;55251;54994;140685;128414;57642;79025;50861;140701;6725;84619;63910;5753;55738;7165;26205;51750;284739;54915;79444;56731;80331;54963;57473;24148;10732;1917;128408;4661;79144;54923,45,3.12429052569312000000
chr7,72726578,74139390,1412812,-1,1,5982;51085;9275;84277;7462;135886;83451;1364;135892;6804;7461;155382;3984;26608;8468;9031;155368;2969;8326;7458;9569;2006;1365;114049,24,1.69873981817821000000
chr3,93949,6274554,6180605,-1,1,51095;51185;3568;10752;9695;285362;27255;3708;57633;8553;6419;152330;55207,13,0.21033539596851800000
chr3,114005609,114082148,76539,-1,1,26137;201633,2,2.61304694338834000000
chr15,30913573,32446830,1533257,-1,1,51621;22909;161725;283710;54893;89839;4308;1139,8,0.52176510526284900000
chr22,44223471,51178264,6954793,-1,1,150383;85378;25771;23151;23774;80305;55267;25813;79174;150379;55007;1375;415116;83642;23542;553158;7380;6300;10343;83933;79924;23313;84247;6305;51512;1890;25830;23654;25817;29781;91289;26150;85358;410;400935;2192;56666;5600;9701;27127;49;9889;414918;9997;9620;1120;440836;64781;5465;112885;29780;644186;23779;23209;7477;25814;64098;80339;10762;79087;55020;55687;348645;85352;55615;113730;55586;54456,68,0.97774297524024100000
chr22,28020482,29902266,1881784,-1,1,4330;150274;25807;10634;150275;162;2130;4744;11200;129080;84133;83999;7494;23760;25770;10633;23331;5988,18,0.95653911394719000000
chr7,72726578,74139390,1412812,-1,1,5982;51085;9275;84277;7462;135886;83451;1364;135892;6804;7461;155382;3984;26608;8468;9031;155368;2969;8326;7458;9569;2006;1365;114049,24,1.69873981817821000000
chrX,32613846,33007664,393818,-1,1,1756,1,0.25392440162714800000
chr22,18729944,21505417,2775473,-1,1,54487;27037;9342;29801;65078;10587;1312;6545;8214;7290;421;2812;6899;5625;7625;79680;64976;6576;3053;8218;5413;80764;23617;400891;1399;7122;150209;128977;8220;388849;84861;7353;51586;2928;128989;5297;9127;9993;54584;91179;85376;8216;85359;8318;728229;5902,46,1.65737515731553000000
chrX,68716578,69176919,460341,-1,1,27112;1896,2,0.43446054120749600000
chr5,84899017,91552997,6653980,-1,1,57561;5921;153364;116068;84059;10622;4208;1070;153396;902;1350,11,0.16531459367175700000
chr6,167644277,170898549,3254272,-1,1,3834;5689;54346;168002;100128124;79981;7058;253769;83887;387263;6991;55274;28514;84498;6953;55780;64094;4301;5134;6908,20,0.61457677784770300000
chr6,162584300,170906796,8322496,-1,1,168002;10846;387263;55274;135138;55780;285800;2853;4301;113402;5134;9444;401285;3834;5689;54346;253769;100128124;168090;79981;7058;83887;6991;6196;11116;8635;28514;5071;84498;6862;51660;64094;1235;6953;6908,35,0.42054691284922200000
chr11,32247887,36458409,4210522,-1,1,79832;7490;966;143458;4005;26273;79899;51074;4076;24147;8050;79056;847;26298;25758;91614;25891;1479;55226;10114;6506;25841;100131378;54765;10480;29099;55346;960;493860;2001,30,0.71250073031324900000
chr3,195703615,197356334,1652719,-1,1,622;255798;80235;200933;5062;5130;4241;26043;1739;84984;348793;255758;116211;131540;200931;375387;22916;7037;165918;54965;205564,21,1.27063342286257000000
chr22,18919942,21440514,2520572,-1,1,54487;27037;9342;29801;65078;10587;1312;6545;421;7290;2812;6899;5625;7625;79680;64976;6576;3053;8218;5413;80764;23617;400891;1399;7122;150209;128977;8220;388849;84861;7353;51586;2928;128989;5297;9127;9993;54584;91179;85376;8216;85359;8318;728229;5902,45,1.78530904889842000000
chr17,34475679,36423183,1947504,-1,1,26574;9326;6928;3975;414060;79893;729877;31;729873;6349;80179;284098;11072;9560;414062;101060321;414059;79922;11276;79154;11056;101060376;6871;284099,24,1.23234663446134000000
chr15,23620191,28709715,5089524,-1,1,2562;7681;23742;8924;7337;6638;2567;4948;8926;57194;283685;54551;4692;2558,14,0.27507484000468400000
chr17,2571667,2674474,102807,-1,1,5048;23277,2,1.94539282344587000000
chrX,6489877,8131810,1641933,-1,1,412;8228;26609;8226,4,0.24361529977167200000
chr20,70580,810327,739747,-1,1,245938;140680;10616;1457;57761;140850;245939;85508;85364;128637;6939;81623;140881;400830;140809;113278;6666;80023,18,2.43326434578309000000
chrX,61091,1322831,1261740,-1,1,28227;6473;8225;55344;64109,5,0.39627815556295300000
chrX,919417,7106107,6186690,-1,1,414;51481;286530;57502;8226;1438;3563;5613;25878;347527;415;416;207063;4267;293;412;7499;9189;438;64109;8227;8623;8908,23,0.37176583924521800000
chrX,919417,7106107,6186690,-1,1,414;51481;286530;57502;8226;1438;3563;5613;25878;347527;415;416;207063;4267;293;412;7499;9189;438;64109;8227;8623;8908,23,0.37176583924521800000
chr2,148731026,149020865,289839,-1,1,5000;55777,2,0.69003826262166200000
chr2,111399243,113240721,1841478,-1,1,10461;150465;699;129804;10018;84910;64682;376940;55289;727851;84524,11,0.59734626207861300000
chr15,30954724,32443563,1488839,-1,1,161725;283710;54893;51621;4308;22909;1139,7,0.47016500776779800000
chr22,47569644,51219009,3649365,-1,1,85358;410;400935;85378;9701;56666;5600;49;25771;9889;23774;80305;11158;414918;79174;9997;1120;440836;1375;415116;83642;23542;644186;23209;6300;83933;79924;79087;6305;1890;348645;23654;25817;113730;29781;55586;91289;54456,38,1.04127704408849000000
chr7,19095444,19155418,59974,-1,1,7291,1,1.66738920198753000000
chr4,53531672,56238263,2706591,-1,1,26511;5156;65997;3815;79644;170825;100288413;81608;152579;84708;3791,11,0.40641530249675700000
chr4,53475823,56238263,2762440,-1,1,64854;26511;5156;65997;3815;79644;170825;100288413;81608;152579;84708;3791,12,0.43439857517267300000
chr8,99938470,104936546,4998076,-1,1,7071;115908;6674;51366;116039;26166;528;79870;9699;51123;6788;25879;7534;4956;286151;50484;5440;157680;157567;51582;81034;8323;25897;79977;169166;26986;1345;83988,28,0.56021557095170200000
chr5,84906983,91527049,6620066,-1,1,57561;5921;153364;116068;84059;10622;4208;1070;153396;902;1350,11,0.16616148539908800000
chr4,175852205,190469337,14617132,-1,1,285440;53842;205860;25854;175;55325;140458;7098;55714;60684;60559;836;80014;83891;57587;132851;55602;2160;2823;3818;79682;353322;11086;116966;291;100132463;27295;3660;441054;391723;201965;2195;339976;55247;201973;4543;132625;55805;133121;256309;8470;2180;7424;56977;3622;1635,46,0.31469921732936400000
chr22,41701951,42924628,1222677,-1,1,150372;27341;50;164684;79879;5372;91689;1565;6721;2547;27351;79019;84844;4809;440829;10766;115650;4700;150368;7008;23264;27254;6942;79640;150365;4668;55964;171568,28,2.29005698152497000000
chr4,71552,3872380,3800828,-1,1,10336;7700;521;7469;401115;79155;4636;10417;84286;654254;345222;54872;1609;2261;255403;79441;4043;8602;7884;170960;57732;7468;152877;10296;3064;3083;285489;57654;353497;10460;285464;118;3954;10861;152;92305;285498;339983;10815;2580;53834;84179;5158;402160;3425;10608;6452;152687;1487;6047;54729;2868;6002;10227;8603,55,1.44705311579477000000
chr17,14101029,15551871,1450842,-1,1,1352;64518;9953;201158;284040;100533496;5376;374286;146822;10626,10,0.68925492920662600000
chr8,118806849,119682936,876087,-1,1,2131;401474,2,0.22828782986164600000
chr7,72726578,74139390,1412812,-1,1,5982;51085;9275;84277;7462;135886;83451;1364;135892;6804;7461;155382;3984;26608;8468;9031;155368;2969;8326;7458;9569;2006;1365;114049,24,1.69873981817821000000
chr12,15400293,25429768,10029475,-1,1,80763;338821;2059;121536;55907;79912;3375;5965;4257;28234;144363;3764;51071;10060;79785;51026;6660;54477;55500;586;5288;2998;645177;10599;6489;4033;93661;729025;55885;3845;6579;11171;55259;3945;89869;53919;196415;5800;9847;5139,40,0.39882446488973700000
chr22,18894835,21464119,2569284,-1,1,54487;27037;9342;29801;65078;10587;1312;6545;8214;421;7290;2812;6899;5625;7625;79680;64976;6576;3053;8218;5413;80764;23617;400891;1399;7122;150209;128977;8220;388849;84861;7353;51586;2928;128989;5297;9127;9993;54584;91179;85376;8216;85359;8318;728229;5902,46,1.79038206753321000000
chr17,2575922,2602623,26701,-1,1,5048;23277,2,7.49035616643571000000
chr13,97717556,102620181,4902625,-1,1,2259;9358;9375;337867;2841;10150;171425;87769;259232;84899;3843;6564;140432;10160;5095;1880;85416;8428;23348;7546;5911,21,0.42834195966446500000
chr1,145382386,145833024,450638,-1,1,148738;128077;27246;84265;11126;10628;653519;8799;5174;10401;200035;284615;8515;148741;10623;9939,16,3.55052170478300000000
chr8,24567350,32090299,7522949,-1,1,29942;2053;7993;286133;157574;54793;1191;55756;7486;55872;389643;79618;619373;2796;81551;2961;10671;51669;10687;64641;157570;55140;4747;665;7976;4741;1135;55246;2137;5516;148;5520;23087;5368;55893;23303;51435;2936;2185;1846;100507341;56154;3084;11030;1808;157313;23484;80005,48,0.63804765923576000000
chr17,100,15000000,14999900,-1,1,84622;6517;201243;50628;10514;5023;5338;284114;51087;9955;56985;26001;83460;3000;5198;22861;2027;433;8386;8390;246;643664;23108;23140;10749;6844;57659;5216;23125;727910;728392;6154;359845;37;407977;4641;124936;8402;124997;124976;4995;4927;2256;51479;23302;8711;201232;57555;2811;9526;23399;80169;5026;54739;1366;9851;146849;51763;146852;1352;9423;8735;8742;54785;51031;5187;286753;23746;5345;124637;6665;162514;55135;146822;482;59344;9905;9212;7775;388323;23135;9953;146850;58485;124975;23293;79003;440400;432;727857;9501;1949;409;388325;64359;6117;162517;239;644139;1742;4619;9098;23277;342527;4994;1140;1107;83547;57048;8383;147040;9032;7157;489;8392;23729;968;27043;84461;201140;51009;81565;4628;644070;708;10594;8388;388333;23533;643904;7326;400566;55178;388327;146760;124961;114826;6416;93649;55421;124641;100506388;6341;9552;84254;9513;9135;26168;374768;51003;388336;1984;1973;9340;5957;388324;124944;22899;10462;84314;9912;55720;55065;284111;1497;29928;83394;29;8578;162515;4622;4335;5176;6462;7531;84316;83903;124751;23587;400569;5048;399512;124739;9744;5430;146754;60528;92162;443;63826;84817;7566;1856;26189;100130311;100996842;254863;1398;4621;8522;7442;83659;339168;146845;116840;84268;4620;84690;79142;112483;30851;162387;1145;54478;124935;8387;5694;247;84667;8741;79066;29098;9482;55275;56919;1801;50488;388335;255877;79850;1770;8447;2874;9196;5306;3090;201305;4991;58191;84225;284013;11337;242;3682;4626,245,1.63334422229482000000
chr3,1,8749407,8749406,-1,1,2917;51095;51185;10752;9695;285362;27255;3708;6419;51066;152330;3568;29995;57633;8553;55207,16,0.18286955708764700000
chr3,195660855,197961930,2301075,-1,1,84248;622;255798;80235;200933;728262;5062;89782;5130;4241;26043;6165;1739;84984;348793;255758;116211;131540;200931;375387;22916;9711;7037;84223;165918;54965;205564;84859,28,1.21682257205871000000
chr21,36062272,48022981,11960709,-1,1,386672;5211;4599;5316;861;106865373;54084;56894;6285;3689;8209;1409;54101;1859;1826;386679;874;7485;386676;51227;386680;386681;7267;326;53347;5121;5152;10311;1476;150082;3772;54059;8208;10317;1292;5116;84221;29947;64699;11077;6612;3150;63977;10281;755;8566;1291;7307;7113;875;54014;7032;150094;53820;85395;9980;386685;23515;353323;8624;7031;7109;386674;386675;386683;8568;4731;6450;23076;6493;6573;3763;2114;104;54093;353332;3141;5822;4047;4600;54039;54058;7033;386677;89765;353333;23181;25825;23275;2078;90625;49854;23562;754;89766;23308;386678;54102;8888;25966;54020;80781;386684;7327;9619;10785;386682;54097;10841;873;81543;7226;150084,113,0.94476004725138000000
chr5,112174106,112197427,23321,-1,1,324;6728,2,8.57596157969212000000
chr1,16354404,16375449,21045,-1,1,1187;1188,2,9.50344499881207000000
chr1,197434389,197455060,20671,-1,1,23418,1,4.83769532194862000000
chr6,156674766,157711981,1037215,-1,1,57492;729515,2,0.19282405287235500000
chr9,20933009,22733942,1800933,-1,1,3447;4507;3441;54914;3451;3448;3439;401494;3444;63951;338376;3442;3449;3452;1030;3467;3440;55958;3443;3456;3446;3445;1029,23,1.27711580608496000000
chr3,195677895,197346971,1669076,-1,1,622;255798;80235;200933;5062;5130;4241;26043;1739;84984;348793;255758;116211;131540;200931;375387;22916;7037;165918;54965;205564,21,1.25818117329588000000
chr4,71552,2094416,2022864,-1,1,10336;7700;521;7469;401115;4636;10417;84286;654254;54872;1609;2261;255403;7884;170960;7468;152877;10296;57654;353497;10460;3954;10861;92305;285498;339983;10815;2580;53834;84179;5158;3425;152687;1487;54729;285464,36,1.77965498422039000000
chr16,29353320,30310065,956745,-1,1,654483;552900;283897;83719;23475;283899;548593;445329;226;613037;253982;83723;6911;11151;79447;112476;9961;107282092;79153;653808;5531;26470;253980;146378;8479;124446;9344;3835;4150;728888;5595;79008;8448;6818;10423;6693,36,3.76275810168854000000
chr11,27413965,39528164,12114199,-1,1,79832;341019;5896;966;4005;5080;196074;7189;627;120534;4076;51074;847;119710;25758;91614;25891;3739;2488;1479;55226;6506;5954;25841;744;29099;55346;960;493860;24147;7490;143458;196294;26273;79899;8050;81930;26610;79056;55327;26298;55366;5897;10114;100131378;54765;120526;10480;2001,49,0.40448402737977200000
chr7,72726578,74139390,1412812,-1,1,5982;51085;9275;84277;7462;135886;83451;1364;135892;6804;7461;155382;3984;26608;8468;9031;155368;2969;8326;7458;9569;2006;1365;114049,24,1.69873981817821000000
chr15,97673323,102399819,4726496,-1,1,145814;390649;4205;123355;204219;80213;79705;390648;55829;3480;55180;145748;220;5046;283777;23336;22856;170691;100128108;64927;140460;6627;123283;91947,24,0.50777573915221800000
chr15,23707452,28559402,4851950,-1,1,2562;7681;23742;8924;7337;6638;2567;4948;8926;57194;54551;4692;2558,13,0.26793351126866500000
chr8,24709966,30005569,5295603,-1,1,2053;286133;157574;54793;1191;55756;55872;389643;79618;619373;2796;81551;51669;10687;64641;157570;55140;4747;665;7976;4741;1135;55246;2137;148;5520;23087;5368;55893;23303;51435;2185;1846;1808;157313;23484;80005,37,0.69869285896242600000
chr2,145134408,145220327,85919,-1,1,9839,1,1.16388691674717000000
chr3,138447123,142164735,3717612,-1,1,287015;668;9276;5948;5947;5291;253461;729627;401089;92369;5922;389152;54464;483;92370;64084;55186;256356;349565;56945;9616;389151;7029;131890,24,0.64557570827724900000
chr14,102254904,107287708,5032804,-1,1,647286;23241;23186;283643;5527;91828;9578;9529;400258;5891;207;55038;9112;107984640;122402;3714;81693;10572;283638;1983;4140;100128927;1396;7187;9895;1152;3831;51550;84334;122618;80757;1778;374569;388021;113146;2972;256281;647310;3320;1397;7517;90135;91833;79038;122616;9556;64423;115708;23368;122622;26153;29933;7127;55778;122416,55,1.09283015988701000000
chr2,159726976,163096058,3369082,-1,1,29994;10716;57282;4065;100526664;151525;2191;5937;10010;1803;85461;64844;9936;22925;2641;3694;10213,17,0.50458849027717300000
chr7,9163976,19335410,10171434,-1,1,196;2115;392636;27075;222894;54664;25928;1607;28969;9678;4223;100506049;155465;85477;10551;10124;57037;221823;7291;23161;221981;9734;221806;4697;729920,25,0.24578638567580500000
chr17,14100118,15442066,1341948,-1,1,1352;64518;9953;201158;284040;100533496;5376;146822,8,0.59614828592464100000
chr20,49819044,50538473,719429,-1,1,57167;4773;10079,3,0.41699736874660300000
chr14,23853433,30527065,6673632,-1,1,728635;283629;23351;10548;25983;26277;7051;55072;8906;10901;317749;9985;85446;90668;2290;5720;10379;80344;5875;56948;1511;84502;643866;4857;51016;4624;145553;3002;4625;4901;2999;4738;100528064;1241;79711;10202;51292;9362;29082;27141;56413;115817;196883;5587;5106;161247;4776;57523;161424;1215;11035;29091;5721;79178,54,0.80915459527885300000
chrX,36206175,40389845,4183670,-1,1,442444;6103;8406;1536;54880;7102;5009;58526;7504;347404;6990;441490;25763;286464;5638;94122,16,0.38243934153506400000
chr1,64384835,76575202,12190367,-1,1,100526835;256435;9295;431707;81573;5733;1647;148581;127247;57708;23169;54741;9406;57554;6121;10022;26135;4919;200132;79971;5876;127254;149233;3716;400757;9829;5142;3595;57685;51086;55970;204962;205;11147;1429;55635;127253;34;55631;3953;9077;257194;4438;84251;79819;127255;55225;1491;8790,49,0.40195672533895000000
chrX,6552712,7341273,788561,-1,1,412;8226,2,0.25362654252492800000
chr3,195887210,196519558,632348,-1,1,255758;116211;131540;200931;255798;375387;200933;84984;165918;5062;5130;54965;26043;348793,14,2.21397078823686000000
chrX,73636615,73658747,22132,-1,1,6567,1,4.51834447858305000000
chr2,2092451,3177387,1084936,-1,1,23040,1,0.09217133545204510000
chr17,34790209,36249799,1459590,-1,1,26574;9326;6928;3975;79893;31;80179;284098;11072;79154;101060321;79922;11276;11056;6871;284099,16,1.09619824745305000000
chr10,81651077,88906961,7255884,-1,1,657;27069;84332;23063;54537;81619;5995;387694;79812;2746;119385;80195;10718;643161;26103;4143;387695;219348;6623;143241;92211;6441;54462;94233;2894;84293;340745;10974;11155;311,30,0.41345754700598900000
chr3,138633814,143559133,4925319,-1,1,287015;668;344838;5948;9276;5947;23350;253461;26577;729627;401089;92369;5922;389152;54464;483;92370;64084;55186;9435;256356;349565;545;285195;56945;7220;5357;9616;389151;7029;131890,31,0.62940085708154100000
chr20,5572697,8196643,2623946,-1,1,149840;84515;54363;51605;164312;650;56255;55612;23236;54675;1114;56261,12,0.45732648461515600000
chr18,61328747,78010032,16681285,-1,1,125704;54495;28513;147381;89778;1528;55628;201456;79863;400658;8710;25914;84735;644041;4772;9306;9658;5055;4155;27164;440498;81832;1005;26251;5273;80148;92126;9150;10194;220158;6317;284273;284293;79839;22850;10666;84552;55748;374868;5271;29090;10907;284274;7776;220164;2587,46,0.27575813254194700000
chr14,25977865,31542216,5564351,-1,1,4857;2290;55632;23256;5587;29966;11154;1690,8,0.14377238243956900000
chrX,7073279,7744191,670912,-1,1,412,1,0.14905084422398200000
chr18,12842,15375878,15363036,-1,1,116;23255;57132;8774;645369;125228;57045;103910;642597;84617;9097;7525;10650;3613;56984;65258;79822;84034;4729;23253;9663;9989;339291;9984;10928;162655;63895;201475;64863;342850;27098;646000;753;7541;55125;55556;10403;4158;84203;388468;147495;9218;5797;494514;1149;5771;10939;1068;79959;9229;7298;91133;11031;56907;7050;81929;4161;81035;2774;23347;10627;8731;8736;374860;284217;23136,66,0.42960258636378900000
chr17,29053968,30272879,1218911,-1,1,79915;79736;55352;55813;2124;84440;2123;55803;4974;4763;23512;84282;51379,13,1.06652577587699000000
chr2,166419514,170577849,4158335,-1,1,115677;79809;6335;129446;6323;57818;10324;10170;8647;27347;253782;493911;100526832;9360;2591;6332;4036;79675;129881;57405;8708;80034;129880,23,0.55310599073908200000
chr16,29586128,30190593,604465,-1,1,653808;5531;26470;283897;253980;146378;8479;83719;23475;283899;124446;9344;3835;4150;226;253982;83723;5595;6911;8448;79447;112476;9961;10423;6693;79153,26,4.30132431158132000000
chr19,33116668,37421560,4304892,-1,1,26065;2867;53822;84807;5438;4099;388536;90075;55957;25999;644096;126393;388531;57817;11136;92283;2865;91442;495;374897;57677;9710;148109;126248;79171;84902;55851;728361;101927572;388533;5348;390916;53827;27033;126374;93099;4037;91646;728485;5184;2821;339324;51599;284406;26330;85415;1340;284402;79414;374900;163183;2116;148103;374899;57711;84306;84063;333;933;6324;115703;147929;826;64377;284403;79713;5349;10054;7705;84079;163175;84924;1054;57655;199745;1155;7305;79047;58510;9757;1346;84964;199746;55094;126375;4868;84911;7392;1050;23354;3249;10870;339318;25850;342892;2864;10430;56301;55900;11045;148137;163081,102,2.36939742042309000000
chr17,1808131,3330594,1522463,-1,1,23277;55720;4994;8387;63826;26189;79066;146760;4335;9905;8383;1801;124641;4995;8392;23293;3090;4991;8386;8390;23108;5048,22,1.44502690705784000000
chr12,70784877,71420117,635240,-1,1,5787;27345;5801,3,0.47226245198665100000
chr15,100193199,102252128,2058929,-1,1,220;4205;80213;204219;55180;170691;22856;79705;55829;140460;6627;145748;123283;5046,14,0.67996516635590600000
chr1,59590261,71256945,11666684,-1,1,9295;81573;4774;1647;148581;57708;23169;55225;54741;57554;6121;85440;10022;26135;4919;200132;79971;1573;10207;84455;27329;149233;3716;9829;400757;5142;54596;3595;57685;51361;83941;55970;127795;27022;205;11147;29929;7398;55635;5236;84938;55277;3953;55631;9077;84251;79819;163782;23421;1491,50,0.42857079183768100000
chr7,149170550,152676990,3506440,-1,1,54480;84626;58508;65999;474344;643641;168537;1020;26;11194;6009;155061;392843;57180;116988;23145;2636;168391;653857;5919;51667;51422;9311;55303;349136;155051;113763;63917;55340;83590;28959;170575;6522;3757;168544;29803;4846;10922;10061;100527949;6604;285973;7516;155066;26157;55365;136371;285971;155038,49,1.39742873113471000000
chr15,30652489,32510863,1858374,-1,1,728498;101059918;51621;89832;22909;161725;283710;54893;89839;4308;1139,11,0.59191529799706600000
chr16,49494625,51372130,1877505,-1,1,124460;23090;55027;85407;1540;6299;64282;255919;113;29117;64127,11,0.58588392574187600000
chr10,81651077,88864922,7213845,-1,1,657;27069;84332;23063;54537;81619;5995;387694;79812;2746;119385;80195;10718;643161;26103;4143;387695;219348;6623;143241;92211;6441;54462;94233;2894;84293;340745;10974;11155;311,30,0.41586698910220600000
chr11,89998247,102803094,12804847,-1,1,53942;341208;24145;330;28970;120114;54851;643037;390243;387804;5241;4314;143872;390245;84441;7225;8898;10413;9702;79780;85016;4321;253935;329;4312;4544;2526;143689;85459;9440;23052;55693;4317;143684;114908;143686;159989;4316;9313;79101;4361;10929;4319;120103;56935;154810;57562;51503;10888;64066;8690,51,0.39828668003608300000
chr16,29326560,30199805,873245,-1,1,552900;283897;83719;23475;283899;445329;226;253982;83723;6911;11151;79447;112476;9961;107282092;79153;653808;5531;26470;253980;146378;8479;124446;9344;3835;4150;728888;5595;79008;8448;10423;6693,32,3.66449278266695000000
chr8,8079853,11723203,3643350,-1,1,1508;83650;83595;203076;2626;83648;137075;157285;640;66036;252969;286046;79660;2222;54984;4482;8658;203074;9258;90459;94137,21,0.57639260570628700000
chrX,26212533,31069707,4857174,-1,1,4114;4113;80231;257397;347541;139425;4115;4112;190;158809;11141;139422;347442;2710,14,0.28823344603261100000
chr2,167182965,167322057,139092,-1,1,6335;6332,2,1.43789721910678000000
chr15,38226847,39577571,1350724,-1,1,161742;145942;400359;10125;283742,5,0.37017184857898400000
chr8,8130630,11841901,3711271,-1,1,1508;83650;83595;203076;2626;83648;613210;137075;613209;157285;640;66036;252969;286046;79660;2222;54984;4482;8658;203074;9258;90459;94137,23,0.61973377853570900000
chrX,135175703,135293203,117500,-1,1,2273,1,0.85106382978723400000
chr16,66491377,67698549,1207172,-1,1,55336;50855;1783;283848;80262;9114;865;84752;181;57546;1874;26231;8883;146212;100529251;29109;146227;25894;766;283847;84080;6236;7084;51192;10664;51647;79767;6553;29100;146225;8996;51673;23491;3299;79567;65057;653319;55282;123920;1014;8824;113540;146223;8717;283849;3291;146206;29800,48,3.97623536662547000000
chr7,72726578,74139390,1412812,-1,1,5982;51085;9275;84277;7462;135886;83451;1364;135892;6804;7461;155382;3984;26608;8468;9031;155368;2969;8326;7458;9569;2006;1365;114049,24,1.69873981817821000000
chr2,174586430,179707517,5121087,-1,1,3235;1123;129831;344191;150737;3232;3238;51661;3236;4780;3234;494513;9541;518;80856;3237;10651;6670;100131390;92104;151556;3239;1386;114880;3233;29789;8540;220988;50940;79634;3231;1134;8575;285025;65977;7273;7456,37,0.72250285925624800000
chr7,143842331,156087602,12245271,-1,1,27153;57541;84626;1804;168537;389602;26;22976;11194;155061;392843;57180;6469;116988;346528;168391;51422;349136;55303;155051;63917;113763;155435;55340;83590;28959;3361;168544;136051;7988;10061;100128553;402317;6604;285973;26157;55365;285888;8427;285971;54480;58508;65999;474344;643641;8454;9601;155054;27010;1020;6009;23145;7984;2636;100142659;26047;2020;100289678;653857;3638;5919;51667;9311;2146;170575;6522;3757;401427;4846;29803;10922;135935;202865;100527949;7516;155066;136371;445328;155038,79,0.64514701226293800000
chr15,22833375,23086456,253081,-1,1,123606;23191;114791;81614,4,1.58052165117097000000
chr3,138654510,138723800,69290,-1,1,729627;668;401089,3,4.32962909510752000000
chr1,849466,1584117,734651,-1,1,83858;126789;81669;29101;339453;643988;9636;126792;219293;8510;84808;64856;26155;6339;55052;254173;80772;375790;984;388581;54587;54973;84069;148398;401934;54998;116983;339451;643965;51150;7293;118424;8784;55210;54991;1855;83756;142678;441869;57801,40,5.44476220681657000000
chr10,126198009,135430043,9232034,-1,1,253738;85442;387718;27287;8433;5791;399818;55760;282973;10570;54764;282974;1793;664;50632;282969;7390;594857;56647;119467;196743;118856;101;1892;23172;1571;642938;84435;503542;10539;399823;118472;10844;9679;80313;256536;3632;8038;4288;92170;84504;26098;118471;170394;92565;55844;54777;64077;4255;1488;93426;118611,52,0.56325615785210500000
chr13,111005475,115106996,4101521,-1,1,7027;55795;79587;79774;3916;8874;22821;55608;8858;55647;10426;1284;101928841;2621;400165;113622;65110;121793;283489;23263;55739;643365;55002;3621;100129836;6656;23250;2155;2159;55208;496;6011;122258;348013;8881;8451,36,0.87772316660087800000
chr14,57592236,64626169,7033933,-1,1,112849;64430;51528;10640;317761;5529;387990;51635;5494;27133;23224;4990;51804;51339;26520;55745;6252;9786;341880;145407;6617;55195;145389;81537;23002;64582;57570;122876;5583;161291;5684;57381;112840;6495;3091;4331;729665;83851;122830;55860;5926,41,0.58288869114903400000
chr1,1099673,6706826,5607153,-1,1,57470;388588;1677;85452;83858;6146;5590;127262;728661;199990;23463;100287898;8510;64856;140625;55229;8764;65220;339456;261734;388581;90326;80835;55735;57449;643965;51150;8784;2782;9651;1855;9731;27237;387509;26038;126789;81669;29101;6497;339453;643988;7161;126792;8718;388591;83715;219293;163688;11332;388585;63976;54626;6339;11079;80772;55052;254173;148479;79258;984;54587;8514;5192;54973;339448;9903;54998;9906;148870;116983;390992;55966;3104;7293;118424;728642;127281;2563;55210;83756;142678;441869;79707;1953;79906;49856,86,1.53375518734730000000
chr12,63889149,64150614,261465,-1,1,283417,1,0.38246036754441300000
chr17,54230835,55124156,893321,-1,1,162282;339210;8526;7706;59342;8161;9241,7,0.78359290781253300000
chr15,67486919,67560748,73829,-1,1,4088;64799;79719,3,4.06344390415690000000
chr11,43478355,50140265,6661910,-1,1,5913;55709;283116;221120;4722;399888;1408;119764;79096;55343;29763;51144;387763;23788;2132;114900;143678;403253;4192;8534;79797;55761;8525;256148;53;9537;392;23360;23279;90993;119765;6688;10062;9776;9409;2147;5795;51317;9479;283254;1132;60529;2346;8567;390110;120071;283092;55626;390113;5702;4607;256144;91252;57586;84364;646754;114971;9793;90139;79841;1643;283093;3732;84680;4038;10658;56981,67,1.00571757949297000000
chr16,21951415,22431170,479755,-1,1,7385;730094;1039;146177;55718;29904;255762,7,1.45907807109879000000
chr12,71766297,94672002,22905705,-1,1,29080;574016;160418;79611;8092;4673;8835;574028;160419;11081;28977;29953;1634;11163;8825;144321;55117;440107;23011;6857;91298;89795;144448;11010;4659;80184;8693;4618;196441;100528030;23390;160335;10154;196477;64786;1833;83591;25834;8738;552889;7334;84190;256710;3747;11103;84698;121278;9182;84125;4922;55266;1848;8499;114882;4254;5074;283310;694;79738;338809;8411;22822;4617;144455;8549;374462;4060;282809;1466;490,70,0.30560072261473700000
chr21,43205976,48090317,4884341,-1,1,386672;5211;5316;54084;56894;6285;3689;8209;1409;386679;386676;386680;386681;326;53347;5152;1476;3275;54059;1292;5116;84221;29947;64699;11077;6612;63977;755;8566;1291;7307;875;7032;150094;85395;386685;353323;7031;7109;386674;386675;386683;8568;4731;23076;6573;104;353332;5822;4047;54039;54058;7033;386677;89765;353333;23181;23275;90625;49854;23308;386678;89766;754;8888;54020;25966;80781;9619;386684;7327;10785;386682;10841;81543;7226,76,1.55599291695645000000
chr18,10008963,11451314,1442351,-1,1,8774;63895;147495,3,0.20799375464086100000
chr18,73123274,78013728,4890454,-1,1,26251;79863;80148;400658;9150;4772;9658;4155;27164;440498;22850;84552;374868;10907;284274;7776;2587,17,0.34761598820886600000
chr18,136227,9845079,9708852,-1,1,116;55556;10403;23255;645369;57045;103910;642597;9097;7525;5797;494514;1068;9229;79822;84034;4729;7298;91133;11031;23253;9663;9989;7050;339291;9984;81035;10928;23347;10627;201475;64863;8736;27098;284217;23136;7541,37,0.38109551984106900000
chr9,27081659,27230164,148505,-1,1,7010,1,0.67337800074071600000
chr1,66986862,81189766,14202904,-1,1,100526835;256435;9295;431707;81573;5733;81849;1647;11080;127247;57708;23169;9406;57554;6121;26009;10022;26135;200132;79971;5876;91624;127254;149233;23032;400757;3595;51086;374986;55970;64123;204962;11147;1429;10026;26289;55635;127253;10964;10561;34;5737;55631;9077;8880;257194;4438;79819;84251;127255;54810;1491;8790,53,0.37316312213333300000
chr6,82770129,89584546,6814417,-1,1,4199;7162;5238;25998;90025;206412;55122;23036;1081;112611;3354;57150;23033;375519;81833;57231;134701;4907;10492;1268;57038;8732;112609;167681;23595;9892;10559;154313;51167;9096;22832,31,0.45491786017791400000
chr1,834101,2225782,1391681,-1,1,85452;83858;126789;5590;81669;728661;29101;199990;339453;6497;643988;9636;126792;219293;8510;163688;84808;64856;26155;6339;55052;254173;80772;65220;339456;375790;984;388581;54587;54973;84069;148398;401934;54998;9906;116983;339451;643965;51150;7293;118424;728642;2563;8784;55210;2782;54991;1855;83756;142678;441869;57801,52,3.73648846251404000000
chr15,37196610,38244056,1047446,-1,1,4212;145942,2,0.19094063082965600000
chr1,241331883,247224284,5892401,-1,1,6000;128025;10472;57116;25909;23596;200150;200159;3192;9156;93474;1122;84288;10806;8564;51029;55083;116228;257044;9859;10000;2271;159;440738;64216;163882;441925;64754;51097,29,0.49215930823445300000
chr16,22043878,22532821,488943,-1,1,730094;1039;146177;100132247;55718;29904,6,1.22713690552887000000
chr22,18844632,21462353,2617721,-1,1,54487;27037;9342;29801;65078;10587;1312;6545;8214;7290;421;2812;6899;5625;7625;79680;64976;6576;3053;8218;5413;80764;23617;400891;1399;7122;150209;128977;8220;388849;84861;7353;51586;2928;128989;5297;9127;9993;54584;91179;85376;8216;85359;8318;728229;5902,46,1.75725373330466000000
chr15,22765628,23300287,534659,-1,1,123606;23191;114791;81614,4,0.74814040350952700000
chr12,59726752,68141916,8415164,-1,1,100129940;29110;23329;10329;9958;11197;8091;55832;144577;8445;552;84298;23592;283417;338811;253827;115749;57522;57460;23041;283349;92797;11260;23426;51643;11213;9194;2799,28,0.33273267163896000000
chr5,91402678,107559969,16157291,-1,1,51752;5066;153643;285600;285704;83989;55781;1946;345757;9652;90355;134187;317671;2745;7903;7025;83594;84250;83890;79772;54826;64167;1105;4012;353189;285601;831;22936;133482;64839;22836;23262;153642;167410;5122,35,0.21662047183528500000
chr22,18967371,21462353,2494982,-1,1,54487;27037;9342;29801;65078;10587;1312;6545;421;7290;2812;6899;7625;79680;64976;6576;3053;8218;5413;80764;23617;400891;1399;7122;150209;128977;8220;388849;84861;7353;51586;2928;128989;5297;9127;9993;54584;91179;85376;8216;85359;8318;728229;5902,44,1.76353977704048000000
chr20,61845191,62893189,1047998,-1,1,54345;6919;10139;3785;198437;1137;140700;10287;2832;85441;4987;8771;55251;140685;128414;57642;79025;50861;54923;140701;84619;6725;5753;55738;7165;26205;51750;284739;54915;79444;56731;80331;54963;57473;24148;1917;4661;79144,38,3.62596111824641000000
chr22,45146790,48300260,3153470,-1,1,553158;150383;7380;23779;2192;10343;7477;25814;27127;23313;10762;25771;55020;23151;55687;51512;55267;9620;55007;64781;5465;112885;26150,23,0.72935528164212800000
chr14,105623939,107282437,1658498,-1,1,647310;3714;23241;1397;1396;90135;283643;80757;2972;9112;256281,11,0.66325072445067800000
chrX,782028,822052,40024,-1,1,,0,0.00000000000000000000
chrY,467477,1174749,707272,-1,1,6473,1,0.14138832019364500000
chrX,168551,923637,755086,-1,1,55344;6473;28227;8225,4,0.52974098314629100000
chr12,79149033,91643524,12494491,-1,1,29080;100528030;160335;160418;196477;79611;1833;8092;25834;84190;160419;11081;1634;8825;84125;9182;4922;1848;8499;4254;5074;283310;55117;6857;91298;144448;4659;4617;374462;80184;8693;4060;282809;4618;490,35,0.28012345600953200000
chr1,837847,1477469,639622,1,0,83858;126789;81669;29101;339453;9636;126792;219293;84808;64856;26155;6339;55052;254173;80772;375790;388581;54587;54973;84069;148398;401934;54998;116983;339451;643965;51150;7293;118424;8784;55210;54991;1855;83756;441869;57801,36,5.62832422899775000000
chr1,536263,756788,220525,1,0,81399,1,0.45346332615349700000
chr1,862453,1069517,207064,1,0,375790;84808;84069;148398;54991;401934;26155;339451;9636;57801,10,4.82942471892748000000
chr1,668630,850204,181574,1,0,,0,0.00000000000000000000
chr1,49911,222421,172510,1,0,79501,1,0.57967654049040600000
chr1,342144,471337,129193,1,0,729759,1,0.77403574497070300000
chr1,542945,673049,130104,1,0,81399,1,0.76861587652954600000
chr1,1567881,1683706,115825,1,0,8510;984;65220;728642;728661;9906,6,5.18022879343838000000
chr1,13514,91174,77660,1,0,79501,1,1.28766417718259000000
chr1,637238,724071,86833,1,0,,0,0.00000000000000000000
chr1,773023,852634,79611,1,0,,0,0.00000000000000000000
chr1,10443,80811,70368,1,0,79501,1,1.42110050022738000000
chr1,1627841,1674823,46982,1,0,728642;9906,2,4.25694947000979000000
chr1,364820,423588,58768,1,0,729759,1,1.70160631636265000000
chr1,738914,795375,56461,1,0,,0,0.00000000000000000000
chr1,713039,756009,42970,1,0,,0,0.00000000000000000000
chr1,125400,176984,51584,1,0,,0,0.00000000000000000000
chr1,238341,267671,29330,1,0,,0,0.00000000000000000000
chr1,60905,97505,36600,1,0,79501,1,2.73224043715847000000
chr1,317770,344692,26922,1,0,,0,0.00000000000000000000
chr1,91470,124563,33093,1,0,,0,0.00000000000000000000
chr1,1394465,1427573,33108,1,0,219293;83858,2,6.04083605170956000000
chr1,1433748,1465993,32245,1,0,55210,1,3.10125600868352000000
chr1,437342,468644,31302,1,0,,0,0.00000000000000000000
chr1,1643676,1672599,28923,1,0,728642;9906,2,6.91491200774470000000
chr1,46501,71800,25299,1,0,79501,1,3.95272540416617000000
chr1,546255,564414,18159,1,0,,0,0.00000000000000000000
chr1,523550,546149,22599,1,0,,0,0.00000000000000000000
chr1,1634170,1655791,21621,1,0,728642,1,4.62513297257296000000
chr1,1385297,1399303,14006,1,0,219293,1,7.13979722975867000000
chr1,77166,88027,10861,1,0,,0,0.00000000000000000000
chr1,22022,35107,13085,1,0,,0,0.00000000000000000000
chr1,461238,471352,10114,1,0,,0,0.00000000000000000000
chr1,754193,762622,8429,1,0,,0,0.00000000000000000000
chr1,564388,570189,5801,1,0,,0,0.00000000000000000000
chr1,459969,463757,3788,1,0,,0,0.00000000000000000000
chr1,87433,91967,4534,1,0,,0,0.00000000000000000000
chr1,1011110,1013998,2888,1,0,,0,0.00000000000000000000
chr1,724107,727222,3115,1,0,,0,0.00000000000000000000
chr1,546384,549347,2963,1,0,,0,0.00000000000000000000
chr1,1074477,1076068,1591,1,0,,0,0.00000000000000000000
chr1,1223580,1225633,2053,1,0,6339,1,48.70920603994150000000
chr1,1285396,1286862,1466,1,0,,0,0.00000000000000000000
chr1,1137108,1138211,1103,1,0,,0,0.00000000000000000000
chr1,869420,870414,994,1,0,148398,1,100.60362173038200000000
chr1,1540850,1541970,1120,1,0,,0,0.00000000000000000000
chr1,1034418,1035210,792,1,0,54991,1,126.26262626262600000000
chr1,2053407,2055667,2260,1,0,5590,1,44.24778761061950000000
chr1,2581112,2632986,51874,1,0,100287898,1,1.92774800478082000000
chr1,2614820,2631820,17000,1,0,100287898,1,5.88235294117647000000
chr1,2583647,2588347,4700,1,0,100287898,1,21.27659574468090000000
chr1,2694461,3224368,529907,1,0,63976;140625;100287898,3,0.56613707688330200000
chr1,2978575,3109044,130469,1,0,63976,1,0.76646559719167000000
chr1,2684255,2693344,9089,1,0,100287898,1,11.00231048520190000000
chr1,3083952,3084887,935,1,0,63976,1,106.95187165775400000000
chr1,3466176,4482598,1016422,1,0,57470;388588;1677;9731;127262;339448;148870;1953;7161;49856,10,0.98384332491819300000
chr1,4392800,4403828,11028,1,0,,0,0.00000000000000000000
chr1,5726195,5736601,10406,1,0,,0,0.00000000000000000000
chr1,6065070,6066763,1693,1,0,8514,1,59.06674542232720000000
chr1,6065997,6067404,1407,1,0,8514,1,71.07320540156360000000
chr1,6065965,6066712,747,1,0,8514,1,133.86880856760400000000
chr1,6166718,6169303,2585,1,0,26038,1,38.68471953578340000000
chr1,6476628,6514806,38178,1,0,83715;54626,2,5.23861910000524000000
chr1,7569432,7571537,2105,1,0,23261,1,47.50593824228030000000
chr1,7570131,7571476,1345,1,0,23261,1,74.34944237918220000000
chr1,7921710,7956379,34669,1,0,,0,0.00000000000000000000
chr1,8216828,8240818,23990,1,0,,0,0.00000000000000000000
chr1,8200939,8211240,10301,1,0,,0,0.00000000000000000000
chr1,8206130,8211074,4944,1,0,,0,0.00000000000000000000
chr1,8893789,8906700,12911,1,0,,0,0.00000000000000000000
chr1,8715448,8719999,4551,1,0,473,1,21.97319270490000000000
chr1,8669883,8674420,4537,1,0,473,1,22.04099625303060000000
chr1,9312092,9403586,91494,1,0,9563;80176,2,2.18593568977201000000
chr1,11099470,11102721,3251,1,0,10747,1,30.75976622577670000000
chr1,11449834,11536217,86383,1,0,,0,0.00000000000000000000
chr1,12030791,12031816,1025,1,0,5351,1,97.56097560975610000000
chr1,12845927,13612852,766925,1,0,400735;440560;441873;441871;391002;645382;343069;440563;65122;343068;400736;440561;391003;65121;343071,15,1.95586269843857000000
chr1,13403492,13838258,434766,1,0,126755;729528;645382;391004;645425;400736;391002;645414;653619,9,2.07007907702074000000
chr1,12855591,13141899,286308,1,0,400735;440560;441871;343069;65122;440561;391003;65121;343071,9,3.14346787375833000000
chr1,13167964,13408675,240711,1,0,343068;440563;441873,3,1.24630781310368000000
chr1,13355070,13482087,127017,1,0,400736;343068;645382,3,2.36188856609745000000
chr1,12880836,13008647,127811,1,0,400735;343069;440560;65122;441871;440561;343071,7,5.47683689197330000000
chr1,13617174,13729043,111869,1,0,729528;391004;645414;653619,4,3.57561075901277000000
chr1,12839662,12967782,128120,1,0,400735;343069;440560;65122;65121;343071,6,4.68310958476428000000
chr1,13103023,13219695,116672,1,0,440563;441873,2,1.71420735052112000000
chr1,12976741,13052998,76257,1,0,440561;391003;441871,3,3.93406506943625000000
chr1,12855963,12893947,37984,1,0,440560;65121,2,5.26537489469250000000
chr1,13611453,13678693,67240,1,0,729528;653619;391002,3,4.46162998215348000000
chr1,13326664,13387963,61299,1,0,343068,1,1.63134798283822000000
chr1,13414742,13473792,59050,1,0,400736,1,1.69348010160881000000
chr1,13161724,13209765,48041,1,0,440563,1,2.08155533814866000000
chr1,12896352,12933743,37391,1,0,343069;65122,2,5.34888074670375000000
chr1,13369108,13417656,48548,1,0,645382,1,2.05981708824256000000
chr1,12949251,12996888,47637,1,0,441871;343071,2,4.19841719671684000000
chr1,12875427,12919034,43607,1,0,343069;440560;65122,3,6.87962941729539000000
chr1,13607293,13639422,32129,1,0,391002,1,3.11245292414952000000
chr1,13655781,13695085,39304,1,0,729528;645414,2,5.08854060655404000000
chr1,12846551,12883541,36990,1,0,65121,1,2.70343336036767000000
chr1,12913801,12949300,35499,1,0,400735;65122,2,5.63396152004282000000
chr1,13443701,13472700,28999,1,0,400736,1,3.44839477223353000000
chr1,12897609,12922238,24629,1,0,343069;65122,2,8.12050834382232000000
chr1,12840259,12865371,25112,1,0,65121,1,3.98215992354253000000
chr1,13103015,13123052,20037,1,0,,0,0.00000000000000000000
chr1,13170916,13190162,19246,1,0,440563,1,5.19588485919152000000
chr1,12909198,12926765,17567,1,0,65122,1,5.69249160357488000000
chr1,12961351,12974577,13226,1,0,,0,0.00000000000000000000
chr1,13210903,13219906,9003,1,0,441873,1,11.10740864156390000000
chr1,13170878,13178356,7478,1,0,,0,0.00000000000000000000
chr1,13320047,13326650,6603,1,0,,0,0.00000000000000000000
chr1,13176833,13182837,6004,1,0,,0,0.00000000000000000000
chr1,13047332,13052938,5606,1,0,,0,0.00000000000000000000
chr1,14311017,14372098,61081,1,0,,0,0.00000000000000000000
chr1,16009544,16011390,1846,1,0,23207,1,54.17118093174430000000
chr1,16349568,16390980,41412,1,0,1187;348487;1188,3,7.24427702115329000000
chr1,16346737,16367892,21155,1,0,1187,1,4.72701489009690000000
chr1,16370402,16381747,11345,1,0,1188,1,8.81445570736007000000
chr1,16566146,16593053,26907,1,0,54455,1,3.71650499869922000000
chr1,16827057,17278750,451693,1,0,9696;55672;11223,3,0.66416791936115900000
chr1,17018059,17257057,238998,1,0,9696;11223,2,0.83682708641913300000
chr1,16850243,17080864,230621,1,0,55672,1,0.43361185668260900000
chr1,17095964,17258426,162462,1,0,9696,1,0.61552855436963700000
chr1,16939654,17108608,168954,1,0,55672;11223,2,1.18375415793648000000
chr1,16857250,16985345,128095,1,0,55672,1,0.78067059604200000000
chr1,17041124,17174951,133827,1,0,11223,1,0.74723336845330200000
chr1,17178161,17288473,110312,1,0,9696,1,0.90651968960765800000
chr1,16907641,17030786,123145,1,0,55672,1,0.81205083438223200000
chr1,17013072,17113613,100541,1,0,11223,1,0.99461911061159100000
chr1,16891796,16979008,87212,1,0,55672,1,1.14663119754162000000
chr1,17188030,17263282,75252,1,0,9696,1,1.32886833572530000000
chr1,16968068,17046685,78617,1,0,,0,0.00000000000000000000
chr1,17046407,17121271,74864,1,0,11223,1,1.33575550331267000000
chr1,16886191,16940252,54061,1,0,55672,1,1.84976230554374000000
chr1,16931822,16995043,63221,1,0,55672,1,1.58175289856219000000
chr1,17234454,17286783,52329,1,0,9696,1,1.91098626000879000000
chr1,17015425,17060383,44958,1,0,,0,0.00000000000000000000
chr1,17082432,17125314,42882,1,0,11223,1,2.33198078447834000000
chr1,17229478,17269786,40308,1,0,9696,1,2.48089709238861000000
chr1,16963691,17007063,43372,1,0,,0,0.00000000000000000000
chr1,16922765,16969441,46676,1,0,55672,1,2.14242865712572000000
chr1,17008705,17051596,42891,1,0,,0,0.00000000000000000000
chr1,17208616,17225383,16767,1,0,,0,0.00000000000000000000
chr1,17051491,17083999,32508,1,0,11223,1,3.07616586686354000000
chr1,17175741,17202312,26571,1,0,,0,0.00000000000000000000
chr1,17238417,17266696,28279,1,0,9696,1,3.53619293468652000000
chr1,16894035,16920359,26324,1,0,55672,1,3.79881476979183000000
chr1,16963725,16985732,22007,1,0,,0,0.00000000000000000000
chr1,17013385,17032840,19455,1,0,,0,0.00000000000000000000
chr1,17245177,17260088,14911,1,0,9696,1,6.70645831936154000000
chr1,16833795,16845312,11517,1,0,,0,0.00000000000000000000
chr1,17219119,17230800,11681,1,0,,0,0.00000000000000000000
chr1,16855545,16863546,8001,1,0,,0,0.00000000000000000000
chr1,16978196,16982644,4448,1,0,,0,0.00000000000000000000
chr1,17077522,17082534,5012,1,0,11223,1,19.95211492418200000000
chr1,16890861,16893754,2893,1,0,55672,1,34.56619426201180000000
chr1,17593767,17622864,29097,1,0,51702,1,3.43678042409870000000
chr1,21730518,21810508,79990,1,0,84224,1,1.25015626953369000000
chr1,21732637,21790627,57990,1,0,84224,1,1.72443524745646000000
chr1,22294487,22338675,44188,1,0,23436;10136,2,4.52611568751697000000
chr1,22889175,22891149,1974,1,0,2046,1,50.65856129685920000000
chr1,22890329,22891179,850,1,0,2046,1,117.64705882352900000000
chr1,25308104,25710676,402572,1,0,6006;25949;6007;23585;57035,5,1.24201385093847000000
chr1,25585230,25670032,84802,1,0,23585;6007;57035,3,3.53765241385816000000
chr1,25581732,25658765,77033,1,0,6007;57035,2,2.59628990173043000000
chr1,25688355,25753252,64897,1,0,23585;6006,2,3.08180655500254000000
chr1,25619266,25668312,49046,1,0,23585;6007;57035,3,6.11670676507768000000
chr1,25686550,25721370,34820,1,0,23585;6006,2,5.74382538770821000000
chr1,25586155,25622695,36540,1,0,6007;57035,2,5.47345374931582000000
chr1,25610133,25646986,36853,1,0,6007;57035,2,5.42696659702060000000
chr1,25625082,25646207,21125,1,0,6007;57035,2,9.46745562130178000000
chr1,25709998,25722241,12243,1,0,6006,1,8.16793269623458000000
chr1,25688907,25700016,11109,1,0,6006,1,9.00171032496174000000
chr1,26458176,26464427,6251,1,0,,0,0.00000000000000000000
chr1,26460544,26464384,3840,1,0,,0,0.00000000000000000000
chr1,27347860,27416513,68653,1,0,,0,0.00000000000000000000
chr1,28834489,28842054,7565,1,0,1104,1,13.21877065432910000000
chr1,37424181,37426011,1830,1,0,2899,1,54.64480874316940000000
chr1,40789539,40802347,12808,1,0,,0,0.00000000000000000000
chr1,41345642,41381734,36092,1,0,,0,0.00000000000000000000
chr1,41991470,41997984,6514,1,0,59269,1,15.35155050660120000000
chr1,44095567,44107276,11709,1,0,,0,0.00000000000000000000
chr1,44337357,44338438,1081,1,0,6487,1,92.50693802035150000000
chr1,45643086,45661602,18516,1,0,57643,1,5.40073449989199000000
chr1,46186033,46501996,315963,1,0,23139;3652,2,0.63298550779679900000
chr1,46355451,46523175,167724,1,0,23139;110117499;8503,3,1.78865278672104000000
chr1,46184288,46343246,158958,1,0,23139;3652,2,1.25819398834912000000
chr1,46458427,46550399,91972,1,0,23139;110117499;8503,3,3.26186230591919000000
chr1,47358532,47592013,233481,1,0,1579;199974;260293,3,1.28490112685829000000
chr1,47267339,47313085,45746,1,0,1580,1,2.18598347396494000000
chr1,47506904,47527140,20236,1,0,260293,1,4.94168808064835000000
chr1,47713985,47724872,10887,1,0,6491,1,9.18526683200147000000
chr1,48667987,48797800,129813,1,0,54558;200010,2,1.54067774413965000000
chr1,53561007,53568319,7312,1,0,6512,1,13.67614879649890000000
chr1,55097830,55283311,185481,1,0,26027;55001;374977;163747;7268;25973,6,3.23483267827972000000
chr1,55092194,55103535,11341,1,0,26027,1,8.81756458866061000000
chr1,55092388,55095168,2780,1,0,26027,1,35.97122302158270000000
chr1,55092216,55094043,1827,1,0,26027,1,54.73453749315820000000
chr1,55301814,55304081,2267,1,0,163747,1,44.11116012351120000000
chr1,58722032,58735992,13960,1,0,,0,0.00000000000000000000
chr1,58743908,58744838,930,1,0,,0,0.00000000000000000000
chr1,59155376,59156703,1327,1,0,114803,1,75.35795026375280000000
chr1,60106272,60107114,842,1,0,55277,1,118.76484560570100000000
chr1,60871960,60949389,77429,1,0,,0,0.00000000000000000000
chr1,62082875,62083686,811,1,0,,0,0.00000000000000000000
chr1,65406389,65410643,4254,1,0,3716,1,23.50728725905030000000
chr1,68723006,68748712,25706,1,0,,0,0.00000000000000000000
chr1,70108807,70132871,24064,1,0,57554,1,4.15558510638298000000
chr1,72752120,72811815,59695,1,0,,0,0.00000000000000000000
chr1,72773840,72811150,37310,1,0,,0,0.00000000000000000000
chr1,72766443,72794102,27659,1,0,,0,0.00000000000000000000
chr1,73681826,73707424,25598,1,0,,0,0.00000000000000000000
chr1,77166921,77192625,25704,1,0,,0,0.00000000000000000000
chr1,77297192,77381720,84528,1,0,81849,1,1.18303993942836000000
chr1,81402971,81418813,15842,1,0,,0,0.00000000000000000000
chr1,81402960,81403923,963,1,0,,0,0.00000000000000000000
chr1,83802483,83978943,176460,1,0,,0,0.00000000000000000000
chr1,85973271,86005846,32575,1,0,23576,1,3.06983883346124000000
chr1,87011381,87073708,62327,1,0,22802,1,1.60444109294527000000
chr1,89476435,89478866,2431,1,0,2635,1,41.13533525298230000000
chr1,89476419,89478226,1807,1,0,2635,1,55.34034311012730000000
chr1,89859256,89885508,26252,1,0,,0,0.00000000000000000000
chr1,92231372,92588609,357237,1,0,253152;7049;284697;646817;676,5,1.39963105725331000000
chr1,92525678,92650349,124671,1,0,253152;23285;646817;284697,4,3.20844462625631000000
chr1,94288443,94291233,2790,1,0,8412,1,35.84229390681000000000
chr1,96715944,96764585,48641,1,0,,0,0.00000000000000000000
chr1,104068083,104285108,217025,1,0,279;276;277;55599;280;101928436,6,2.76465844948739000000
chr1,104134854,104306036,171182,1,0,279;277;278;276,4,2.33669427860406000000
chr1,104094573,104177297,82724,1,0,279;55599;280,3,3.62651709298390000000
chr1,104110638,104225896,115258,1,0,279;276;280,3,2.60285620087109000000
chr1,104217669,104305130,87461,1,0,277;278,2,2.28673351550977000000
chr1,104225521,104305249,79728,1,0,277;278,2,2.50852899859522000000
chr1,104175500,104256747,81247,1,0,276;277,2,2.46162935246840000000
chr1,104109605,104173784,64179,1,0,279;280,2,3.11628414278814000000
chr1,104066658,104132185,65527,1,0,55599;280;101928436,3,4.57826544783067000000
chr1,104160060,104211524,51464,1,0,279;276,2,3.88621172081455000000
chr1,104198189,104248669,50480,1,0,276;277,2,3.96196513470681000000
chr1,104224278,104269947,45669,1,0,277,1,2.18966914099280000000
chr1,104104262,104141924,37662,1,0,280,1,2.65519621900058000000
chr1,104130234,104154028,23794,1,0,,0,0.00000000000000000000
chr1,104155703,104175459,19756,1,0,279,1,5.06175339137477000000
chr1,104204602,104225234,20632,1,0,276,1,4.84683986041101000000
chr1,104141144,104154768,13624,1,0,,0,0.00000000000000000000
chr1,104254411,104269218,14807,1,0,,0,0.00000000000000000000
chr1,104122228,104136945,14717,1,0,,0,0.00000000000000000000
chr1,104156283,104166881,10598,1,0,279,1,9.43574259294206000000
chr1,104103457,104114518,11061,1,0,280,1,9.04077389024500000000
chr1,104113284,104123031,9747,1,0,280,1,10.25956704627060000000
chr1,104221094,104228515,7421,1,0,,0,0.00000000000000000000
chr1,104306252,104316241,9989,1,0,,0,0.00000000000000000000
chr1,104292440,104301310,8870,1,0,278,1,11.27395715896280000000
chr1,104153484,104161450,7966,1,0,279,1,12.55335174491590000000
chr1,104123062,104129833,6771,1,0,,0,0.00000000000000000000
chr1,104221457,104226524,5067,1,0,,0,0.00000000000000000000
chr1,105317080,105385340,68260,1,0,,0,0.00000000000000000000
chr1,105991018,106084529,93511,1,0,,0,0.00000000000000000000
chr1,106025195,106086067,60872,1,0,,0,0.00000000000000000000
chr1,106018879,106060655,41776,1,0,,0,0.00000000000000000000
chr1,106016637,106030570,13933,1,0,,0,0.00000000000000000000
chr1,106010828,106021915,11087,1,0,,0,0.00000000000000000000
chr1,106019022,106022293,3271,1,0,,0,0.00000000000000000000
chr1,108318172,108762656,444484,1,0,29957;10451,2,0.44995995356413300000
chr1,108760471,109097308,336837,1,0,148545;653149,2,0.59375899915983100000
chr1,108917312,109000328,83016,1,0,653149,1,1.20458706755324000000
chr1,108778954,108853239,74285,1,0,148545,1,1.34616679006529000000
chr1,108978203,108993126,14923,1,0,653149,1,6.70106546940964000000
chr1,108789901,108802500,12599,1,0,,0,0.00000000000000000000
chr1,108732810,108737489,4679,1,0,29957,1,21.37208805300280000000
chr1,110182077,110244734,62657,1,0,2948;2946;2944,3,4.78797261279665000000
chr1,110213612,110260658,47046,1,0,2946;2949;2944,3,6.37673766101263000000
chr1,110213702,110244772,31070,1,0,2946;2944,2,6.43707756678468000000
chr1,110223105,110253318,30213,1,0,2946;2944,2,6.61966703074835000000
chr1,110219461,110242962,23501,1,0,2946;2944,2,8.51027615846134000000
chr1,110244563,110253731,9168,1,0,,0,0.00000000000000000000
chr1,110230102,110241366,11264,1,0,2944,1,8.87784090909091000000
chr1,110251967,110258318,6351,1,0,2949,1,15.74555188159340000000
chr1,110187090,110191461,4371,1,0,,0,0.00000000000000000000
chr1,110187237,110189762,2525,1,0,,0,0.00000000000000000000
chr1,110187221,110188533,1312,1,0,,0,0.00000000000000000000
chr1,111371536,111384580,13044,1,0,,0,0.00000000000000000000
chr1,112693312,112705453,12141,1,0,,0,0.00000000000000000000
chr1,113332245,113631968,299723,1,0,6566;9860,2,0.66728279111045900000
chr1,116234306,116284653,50347,1,0,81839;845,2,3.97243132659344000000
chr1,117142389,117205323,62934,1,0,3321,1,1.58896621857819000000
chr1,117162022,117203503,41481,1,0,3321,1,2.41074226754418000000
chr1,117132144,117169375,37231,1,0,3321,1,2.68593376487336000000
chr1,117880710,117881859,1149,1,0,,0,0.00000000000000000000
chr1,119888444,120154798,266354,1,0,51179;3284;3283,3,1.12632061091630000000
chr1,120094325,120148668,54343,1,0,,0,0.00000000000000000000
chr1,120114801,120147594,32793,1,0,,0,0.00000000000000000000
chr1,120141625,120152379,10754,1,0,,0,0.00000000000000000000
chr1,120370078,120406007,35929,1,0,343505,1,2.78326699880320000000
chr1,121171923,121350989,179066,1,0,,0,0.00000000000000000000
chr1,120765068,120936665,171597,1,0,653820;2210,2,1.16552154175190000000
chr1,120531255,120633674,102419,1,0,4853,1,0.97638133549439100000
chr1,121352128,121460257,108129,1,0,,0,0.00000000000000000000
chr1,120537830,120622577,84747,1,0,4853,1,1.17998277225153000000
chr1,120619794,120696650,76856,1,0,,0,0.00000000000000000000
chr1,121087806,121134802,46996,1,0,653464,1,2.12784066729083000000
chr1,120747342,120777380,30038,1,0,,0,0.00000000000000000000
chr1,120906911,120936695,29784,1,0,2210,1,3.35750738651625000000
chr1,121106824,121134074,27250,1,0,653464,1,3.66972477064220000000
chr1,121473109,121485194,12085,1,0,,0,0.00000000000000000000
chr1,142642220,142729493,87273,1,0,,0,0.00000000000000000000
chr1,142620970,142665172,44202,1,0,,0,0.00000000000000000000
chr1,142663938,142697387,33449,1,0,,0,0.00000000000000000000
chr1,142694147,142722256,28109,1,0,,0,0.00000000000000000000
chr1,142798217,142864660,66443,1,0,,0,0.00000000000000000000
chr1,143138874,143234055,95181,1,0,,0,0.00000000000000000000
chr1,143205985,143282224,76239,1,0,,0,0.00000000000000000000
chr1,143118134,143136011,17877,1,0,,0,0.00000000000000000000
chr1,143278687,143286211,7524,1,0,,0,0.00000000000000000000
chr1,143344231,143436966,92735,1,0,,0,0.00000000000000000000
chr1,143349483,143407099,57616,1,0,,0,0.00000000000000000000
chr1,143526673,143544522,17849,1,0,,0,0.00000000000000000000
chr1,143653549,143770622,117073,1,0,,0,0.00000000000000000000
chr1,143716029,143770622,54593,1,0,,0,0.00000000000000000000
chr1,145183860,147913211,2729351,1,0,9557;148738;128077;27246;84265;11126;10628;2330;653519;8799;149013;5174;388677;10401;200035;51205;284615;8515;51463;5565;148741;607;2702;10623;200030;100132406;2703;9939,28,1.02588490817048000000
chr1,148397063,149643182,1246119,1,0,728945;284565;730262;653598;554282;388692,6,0.48149494550681000000
chr1,148798919,149609977,811058,1,0,554282;653598;388692;728945,4,0.49318297828268800000
chr1,149045312,149687860,642548,1,0,554282;653598;388692;644634,4,0.62252158593599200000
chr1,148974342,149441884,467542,1,0,388692,1,0.21388452802101200000
chr1,145623419,145991856,368437,1,0,653519;11126;27246;5174,4,1.08566729183008000000
chr1,144994028,145319374,325346,1,0,388677;100132406;9659,3,0.92209524629164000000
chr1,148527867,148881353,353486,1,0,728945;730262;284565,3,0.84868990568226200000
chr1,145373766,145792051,418285,1,0,148738;128077;27246;84265;11126;10628;653519;8799;5174;10401;200035;284615;8515;148741;10623;9939,16,3.82514314402859000000
chr1,148748605,149025330,276725,1,0,728945,1,0.36136959074893800000
chr1,149033506,149297533,264027,1,0,388692,1,0.37874914308006400000
chr1,149615835,149798742,182907,1,0,2209;653604;644634;440689,4,2.18690372703068000000
chr1,144901042,145087525,186483,1,0,9659,1,0.53624190945019100000
chr1,144321887,144560360,238473,1,0,,0,0.00000000000000000000
chr1,149227778,149425739,197961,1,0,388692,1,0.50515000429377500000
chr1,145111831,145319347,207516,1,0,388677;100132406,2,0.96378110603519700000
chr1,145613582,145797942,184360,1,0,653519;11126;27246;5174,4,2.16966804078976000000
chr1,145191732,145379885,188153,1,0,388677;100132406,2,1.06296471488629000000
chr1,149167907,149315449,147542,1,0,388692,1,0.67777310867414000000
chr1,148176093,148342356,166263,1,0,645142,1,0.60145672819569000000
chr1,147731329,147883764,152435,1,0,,0,0.00000000000000000000
chr1,143984598,144094724,110126,1,0,,0,0.00000000000000000000
chr1,149071405,149172208,100803,1,0,,0,0.00000000000000000000
chr1,147911053,148017348,106295,1,0,644591,1,0.94077802342537300000
chr1,144951487,145080277,128790,1,0,9659,1,0.77645779951859600000
chr1,144307867,144401316,93449,1,0,,0,0.00000000000000000000
chr1,148832247,148954132,121885,1,0,,0,0.00000000000000000000
chr1,149237433,149315774,78341,1,0,388692,1,1.27647081349485000000
chr1,144995623,145102407,106784,1,0,9659,1,0.93646988312855900000
chr1,145189779,145285955,96176,1,0,388677,1,1.03976043919481000000
chr1,144883128,144964983,81855,1,0,9659,1,1.22167246961090000000
chr1,149683774,149776656,92882,1,0,2209;440689,2,2.15326974010034000000
chr1,145286672,145376644,89972,1,0,100132406,1,1.11145689770151000000
chr1,149510674,149599400,88726,1,0,653598,1,1.12706534724883000000
chr1,144813011,144897119,84108,1,0,400818;9659,2,2.37789508726875000000
chr1,144007818,144095783,87965,1,0,,0,0.00000000000000000000
chr1,149129637,149193990,64353,1,0,,0,0.00000000000000000000
chr1,149205248,149257306,52058,1,0,,0,0.00000000000000000000
chr1,144152333,144224427,72094,1,0,,0,0.00000000000000000000
chr1,148176093,148248256,72163,1,0,645142,1,1.38575170101021000000
chr1,144908540,144986503,77963,1,0,9659,1,1.28265972320203000000
chr1,148749225,148820765,71540,1,0,728945,1,1.39781940173330000000
chr1,149032674,149096734,64060,1,0,,0,0.00000000000000000000
chr1,149289466,149358386,68920,1,0,388692,1,1.45095763203714000000
chr1,145120396,145182241,61845,1,0,,0,0.00000000000000000000
chr1,148595061,148656743,61682,1,0,730262;284565,2,3.24243701566097000000
chr1,148511446,148574484,63038,1,0,284565,1,1.58634474443986000000
chr1,147964798,148025993,61195,1,0,,0,0.00000000000000000000
chr1,147935474,147994336,58862,1,0,644591,1,1.69888892664198000000
chr1,144344294,144401216,56922,1,0,,0,0.00000000000000000000
chr1,149249381,149284851,35470,1,0,,0,0.00000000000000000000
chr1,146459387,146505577,46190,1,0,149013,1,2.16497077289457000000
chr1,143979635,144021892,42257,1,0,,0,0.00000000000000000000
chr1,144913707,144951388,37681,1,0,9659,1,2.65385738170431000000
chr1,144494957,144532297,37340,1,0,,0,0.00000000000000000000
chr1,144321218,144361447,40229,1,0,,0,0.00000000000000000000
chr1,145097031,145134706,37675,1,0,,0,0.00000000000000000000
chr1,144673943,144709637,35694,1,0,400818,1,2.80159130386059000000
chr1,149037435,149062012,24577,1,0,,0,0.00000000000000000000
chr1,149510519,149543780,33261,1,0,,0,0.00000000000000000000
chr1,148762722,148789972,27250,1,0,,0,0.00000000000000000000
chr1,149229130,149256159,27029,1,0,,0,0.00000000000000000000
chr1,146034945,146059037,24092,1,0,,0,0.00000000000000000000
chr1,147964798,147994290,29492,1,0,,0,0.00000000000000000000
chr1,148604297,148628433,24136,1,0,,0,0.00000000000000000000
chr1,144373689,144401451,27762,1,0,,0,0.00000000000000000000
chr1,147575324,147598772,23448,1,0,200030,1,4.26475605595360000000
chr1,149015483,149036608,21125,1,0,,0,0.00000000000000000000
chr1,147706942,147730419,23477,1,0,,0,0.00000000000000000000
chr1,144452751,144470699,17948,1,0,,0,0.00000000000000000000
chr1,148575057,148595577,20520,1,0,284565,1,4.87329434697856000000
chr1,148921596,148936971,15375,1,0,,0,0.00000000000000000000
chr1,148738933,148757699,18766,1,0,,0,0.00000000000000000000
chr1,144900348,144916560,16212,1,0,9659,1,6.16827041697508000000
chr1,149041933,149060277,18344,1,0,,0,0.00000000000000000000
chr1,144502554,144520084,17530,1,0,,0,0.00000000000000000000
chr1,149242660,149256247,13587,1,0,,0,0.00000000000000000000
chr1,148766480,148783191,16711,1,0,,0,0.00000000000000000000
chr1,144336333,144352689,16356,1,0,,0,0.00000000000000000000
chr1,144274544,144290722,16178,1,0,,0,0.00000000000000000000
chr1,148330862,148347374,16512,1,0,,0,0.00000000000000000000
chr1,144810749,144823835,13086,1,0,400818,1,7.64175454684395000000
chr1,149023762,149032150,8388,1,0,,0,0.00000000000000000000
chr1,148607263,148619841,12578,1,0,,0,0.00000000000000000000
chr1,144145808,144157854,12046,1,0,,0,0.00000000000000000000
chr1,144611379,144622190,10811,1,0,400818,1,9.24983812783276000000
chr1,144087186,144095572,8386,1,0,,0,0.00000000000000000000
chr1,149231192,149241215,10023,1,0,,0,0.00000000000000000000
chr1,149240213,149249883,9670,1,0,,0,0.00000000000000000000
chr1,146459458,146465297,5839,1,0,149013,1,17.12622024319230000000
chr1,148823561,148829081,5520,1,0,,0,0.00000000000000000000
chr1,147985333,147989981,4648,1,0,,0,0.00000000000000000000
chr1,146034759,146039376,4617,1,0,,0,0.00000000000000000000
chr1,145205298,145210158,4860,1,0,388677,1,20.57613168724280000000
chr1,147577067,147580856,3789,1,0,200030,1,26.39218791237790000000
chr1,144162110,144164782,2672,1,0,,0,0.00000000000000000000
chr1,151332481,151402190,69709,1,0,8991;23126;5692,3,4.30360498644364000000
chr1,151920733,152232368,311635,1,0,6281;6282;126637;126638;388697;100131107;7062,7,2.24621753012338000000
chr1,152275126,152290161,15035,1,0,2312,1,6.65114732291320000000
chr1,152185672,152194076,8404,1,0,388697,1,11.89909566872920000000
chr1,152549985,152588089,38104,1,0,353144;84648;353143,3,7.87318916649171000000
chr1,152561863,152588061,26198,1,0,353144;353143,2,7.63417054737003000000
chr1,152556880,152576261,19381,1,0,353144,1,5.15969248232805000000
chr1,152571177,152586936,15759,1,0,353144;353143,2,12.69116060663750000000
chr1,152648559,152663592,15033,1,0,353140;26239,2,13.30406439167170000000
chr1,152649738,152655897,6159,1,0,,0,0.00000000000000000000
chr1,152803950,152855431,51481,1,0,448835;4184,2,3.88492842019386000000
chr1,152759203,152779077,19874,1,0,353133;353135;353134,3,15.09509912448430000000
chr1,152753409,152773332,19923,1,0,353135;353134,2,10.03864879787180000000
chr1,152761495,152773537,12042,1,0,353134,1,8.30426839395449000000
chr1,152762699,152773451,10752,1,0,353134,1,9.30059523809524000000
chr1,152758072,152767916,9844,1,0,353135,1,10.15847216578630000000
chr1,153042672,153069775,27103,1,0,6701;6704,2,7.37925690882928000000
chr1,153069195,153087963,18768,1,0,6705,1,5.32821824381927000000
chr1,153215570,153217622,2052,1,0,,0,0.00000000000000000000
chr1,153215868,153216712,844,1,0,,0,0.00000000000000000000
chr1,153673424,153693491,20067,1,0,,0,0.00000000000000000000
chr1,155184969,155228032,43063,1,0,10067;10712;2629,3,6.96653739869494000000
chr1,155180788,155211598,30810,1,0,4580;2629,2,6.49139889646219000000
chr1,155189250,155211654,22404,1,0,2629,1,4.46348866273880000000
chr1,155563724,155633882,70158,1,0,55154;55249,2,2.85070840103766000000
chr1,158020230,158085574,65344,1,0,55243,1,1.53036238981391000000
chr1,158726896,158728010,1114,1,0,,0,0.00000000000000000000
chr1,158867579,158869906,2327,1,0,,0,0.00000000000000000000
chr1,158961696,158966203,4507,1,0,,0,0.00000000000000000000
chr1,159012852,159018840,5988,1,0,3428,1,16.70006680026720000000
chr1,159648711,159649629,918,1,0,,0,0.00000000000000000000
chr1,161488372,161659238,170866,1,0,2214;2213;3310;2215;2212,5,2.92626970842649000000
chr1,161564682,161639943,75261,1,0,2215;2213,2,2.65741884907190000000
chr1,161592851,161636995,44144,1,0,2215;2213,2,4.53062703878217000000
chr1,161410297,161442471,32174,1,0,,0,0.00000000000000000000
chr1,161487915,161520485,32570,1,0,2214;3310;2212,3,9.21093030396070000000
chr1,161434356,161440600,6244,1,0,,0,0.00000000000000000000
chr1,166183240,166196377,13137,1,0,,0,0.00000000000000000000
chr1,169004358,169005263,905,1,0,,0,0.00000000000000000000
chr1,169214680,169257419,42739,1,0,29922,1,2.33978333606308000000
chr1,169226238,169253120,26882,1,0,29922,1,3.71996131240235000000
chr1,169224034,169241019,16985,1,0,29922,1,5.88754783632617000000
chr1,169227768,169241713,13945,1,0,29922,1,7.17102904266762000000
chr1,169232813,169239019,6206,1,0,29922,1,16.11343860779890000000
chr1,174810624,174819520,8896,1,0,9910,1,11.24100719424460000000
chr1,175071079,175077063,5984,1,0,63923,1,16.71122994652410000000
chr1,175430855,175772378,341523,1,0,7143,1,0.29280604820173200000
chr1,176226064,176271734,45670,1,0,,0,0.00000000000000000000
chr1,178449096,178481285,32189,1,0,,0,0.00000000000000000000
chr1,179323738,179393328,69590,1,0,6646;126859,2,2.87397614599799000000
chr1,179607357,179608025,668,1,0,163589,1,149.70059880239500000000
chr1,181153987,181213705,59718,1,0,,0,0.00000000000000000000
chr1,183778313,183785301,6988,1,0,23179,1,14.31024613623350000000
chr1,185097772,185132169,34397,1,0,81627;54823,2,5.81446056342123000000
chr1,186235180,186573744,338564,1,0,5132;10216;7175;10896;54953,5,1.47682565187084000000
chr1,187464914,187466483,1569,1,0,,0,0.00000000000000000000
chr1,188539470,188540236,766,1,0,,0,0.00000000000000000000
chr1,188856830,189078125,221295,1,0,,0,0.00000000000000000000
chr1,189777093,189786390,9297,1,0,,0,0.00000000000000000000
chr1,189884687,189928094,43407,1,0,,0,0.00000000000000000000
chr1,189969109,189989544,20435,1,0,,0,0.00000000000000000000
chr1,191608580,192004979,396399,1,0,,0,0.00000000000000000000
chr1,193868573,193914238,45665,1,0,,0,0.00000000000000000000
chr1,194606030,195239259,633229,1,0,,0,0.00000000000000000000
chr1,195052602,195072917,20315,1,0,,0,0.00000000000000000000
chr1,194451195,194454485,3290,1,0,,0,0.00000000000000000000
chr1,194451372,194453274,1902,1,0,,0,0.00000000000000000000
chr1,195407417,195468957,61540,1,0,,0,0.00000000000000000000
chr1,195439996,195471717,31721,1,0,,0,0.00000000000000000000
chr1,196740669,196896497,155828,1,0,10877;3078;10878,3,1.92519957902303000000
chr1,196704080,196819917,115837,1,0,3078;10878;3075,3,2.58984607681483000000
chr1,196786199,196904331,118132,1,0,10877;3078,2,1.69302136592964000000
chr1,196754172,196811036,56864,1,0,3078;10878,2,3.51716375914463000000
chr1,196711670,196758387,46717,1,0,10878;3075,2,4.28109681700452000000
chr1,196878802,196915861,37059,1,0,10877;3080,2,5.39679969777922000000
chr1,196819616,196870345,50729,1,0,10877,1,1.97125904315086000000
chr1,196789618,196824897,35279,1,0,3078,1,2.83454746449729000000
chr1,196739705,196768268,28563,1,0,10878,1,3.50103280467738000000
chr1,196781610,196813270,31660,1,0,3078,1,3.15855969677827000000
chr1,196886960,196918208,31248,1,0,10877;3080,2,6.40040962621608000000
chr1,196762225,196780564,18339,1,0,10878,1,5.45286002508316000000
chr1,196732603,196749760,17157,1,0,10878,1,5.82852480037303000000
chr1,196788906,196801613,12707,1,0,3078,1,7.86967813016448000000
chr1,197822098,197890009,67911,1,0,388722;56956,2,2.94503099645124000000
chr1,198618898,198731524,112626,1,0,5788,1,0.88789444710812800000
chr1,198773799,198775214,1415,1,0,,0,0.00000000000000000000
chr1,199564078,199566648,2570,1,0,,0,0.00000000000000000000
chr1,199564854,199566635,1781,1,0,,0,0.00000000000000000000
chr1,200805837,200898737,92900,1,0,55765;2848;23271,3,3.22927879440258000000
chr1,201224281,201227743,3462,1,0,,0,0.00000000000000000000
chr1,202347574,202530233,182659,1,0,4660,1,0.54746823315577100000
chr1,205441231,205457687,16456,1,0,,0,0.00000000000000000000
chr1,206090369,206133999,43630,1,0,,0,0.00000000000000000000
chr1,206282073,206287814,5741,1,0,440712,1,17.41856819369450000000
chr1,206556676,206584624,27948,1,0,23380,1,3.57807356519250000000
chr1,207292505,207293206,701,1,0,722,1,142.65335235378000000000
chr1,207542070,207545131,3061,1,0,,0,0.00000000000000000000
chr1,207697466,207748433,50967,1,0,1378,1,1.96205387799949000000
chr1,208434563,208457606,23043,1,0,,0,0.00000000000000000000
chr1,208441948,208457135,15187,1,0,,0,0.00000000000000000000
chr1,208445736,208457102,11366,1,0,,0,0.00000000000000000000
chr1,209107073,209165110,58037,1,0,,0,0.00000000000000000000
chr1,210078041,210085958,7917,1,0,,0,0.00000000000000000000
chr1,210722467,210724870,2403,1,0,55733,1,41.61464835622140000000
chr1,211750461,211753044,2583,1,0,7779,1,38.71467286101430000000
chr1,217431846,217759215,327369,1,0,55105,1,0.30546569772947300000
chr1,222373986,222381517,7531,1,0,,0,0.00000000000000000000
chr1,222639039,222693573,54534,1,0,,0,0.00000000000000000000
chr1,223621119,223645457,24338,1,0,,0,0.00000000000000000000
chr1,223631224,223646658,15434,1,0,,0,0.00000000000000000000
chr1,224107799,224207830,100031,1,0,,0,0.00000000000000000000
chr1,224183629,224208436,24807,1,0,,0,0.00000000000000000000
chr1,224076244,224088484,12240,1,0,,0,0.00000000000000000000
chr1,225393691,225463092,69401,1,0,127602,1,1.44090142793331000000
chr1,225657524,225686912,29388,1,0,55740,1,3.40274942153260000000
chr1,228791784,228893429,101645,1,0,58480,1,0.98381622312951900000
chr1,228724719,228783551,58832,1,0,,0,0.00000000000000000000
chr1,228255412,228260674,5262,1,0,,0,0.00000000000000000000
chr1,230617783,231412936,795153,1,0,64801;375061;8443;440730;149373;10753;183;128061;22796;84886;79573,11,1.38338156304510000000
chr1,231429183,231445910,16727,1,0,,0,0.00000000000000000000
chr1,231708281,231812252,103971,1,0,27185,1,0.96180665762568400000
chr1,232890597,232899241,8644,1,0,,0,0.00000000000000000000
chr1,234912231,234956612,44381,1,0,,0,0.00000000000000000000
chr1,234912618,234923469,10851,1,0,,0,0.00000000000000000000
chr1,235532357,235711649,179292,1,0,2786;6905;148789,3,1.67324810922964000000
chr1,236616801,236789303,172502,1,0,55127;128178;3964,3,1.73911027118526000000
chr1,237118633,237133231,14598,1,0,,0,0.00000000000000000000
chr1,236670618,236679552,8934,1,0,,0,0.00000000000000000000
chr1,236876894,236878365,1471,1,0,88,1,67.98096532970770000000
chr1,238659905,238771197,111292,1,0,,0,0.00000000000000000000
chr1,238709960,238794898,84938,1,0,,0,0.00000000000000000000
chr1,239354558,239562409,207851,1,0,1131,1,0.48111387484303700000
chr1,241277814,241347920,70106,1,0,6000,1,1.42641143411406000000
chr1,242380729,242896103,515374,1,0,200150,1,0.19403384726431700000
chr1,243046323,243237331,191008,1,0,,0,0.00000000000000000000
chr1,243168760,243261768,93008,1,0,,0,0.00000000000000000000
chr1,243265739,243351820,86081,1,0,9859,1,1.16169654162940000000
chr1,243153501,243206942,53441,1,0,,0,0.00000000000000000000
chr1,243020383,243075259,54876,1,0,,0,0.00000000000000000000
chr1,243049304,243084880,35576,1,0,,0,0.00000000000000000000
chr1,243049066,243064383,15317,1,0,,0,0.00000000000000000000
chr1,243782750,243783865,1115,1,0,10000,1,89.68609865470850000000
chr1,243934023,244001311,67288,1,0,10000,1,1.48614909047676000000
chr1,244482501,244534881,52380,1,0,200159,1,1.90912562046583000000
chr1,246282186,246642125,359939,1,0,64754,1,0.27782485365575800000
chr1,246596116,246815058,218942,1,0,163882;64216;64754,3,1.37022590457747000000
chr1,246900053,246964774,64721,1,0,51097,1,1.54509355541478000000
chr1,246181539,246237531,55992,1,0,64754,1,1.78596942420346000000
chr1,246138227,246140393,2166,1,0,64754,1,46.16805170821790000000
chr1,247279213,247282281,3068,1,0,,0,0.00000000000000000000
chr1,247291971,247293275,1304,1,0,7678,1,76.68711656441720000000
chr1,248777854,249172647,394793,1,0,403244;127077;401994;80851;79894;403239;55657;646627,8,2.02637838056906000000
chr1,247844830,248216875,372045,1,0,343171;81466;284532;26188;26246;391189;343172;284521;391190;391191;343169;25893,12,3.22541628028867000000
chr1,248508843,248856938,348095,1,0,401993;254879;403244;127077;343173;343563;127069;403239;127074;391211;127066;26696;127068;401994;401992,15,4.30916847412344000000
chr1,248685989,248831301,145312,1,0,403244;127069;127077;403239;127068;343563,6,4.12904646553623000000
chr1,248735481,248826296,90815,1,0,403244;127069;127077;403239;127068,5,5.50569839784177000000
chr1,249130873,249234838,103965,1,0,55657;267002;79894,3,2.88558649545520000000
chr1,248179382,248265560,86178,1,0,81466;284521;391192;26246,4,4.64155584952076000000
chr1,248605739,248692975,87236,1,0,343173;401993;391211;401992,4,4.58526296483103000000
chr1,248347878,248429640,81762,1,0,127062;26245,2,2.44612411633766000000
chr1,248572871,248637448,64577,1,0,343173;401992,2,3.09707790699475000000
chr1,248752797,248801990,49193,1,0,403244;127069;127077,3,6.09842863822089000000
chr1,248818462,248866057,47595,1,0,401994,1,2.10106103582309000000
chr1,248608027,248637745,29718,1,0,343173;401992,2,6.72992798977051000000
chr1,248572358,248596103,23745,1,0,,0,0.00000000000000000000
chr1,249210764,249229708,18944,1,0,267002,1,5.27871621621622000000
chr1,248617331,248634905,17574,1,0,,0,0.00000000000000000000
chr1,248609916,248625792,15876,1,0,401992,1,6.29881582262535000000
chr1,249220683,249231446,10763,1,0,,0,0.00000000000000000000
chr1,248615668,248618123,2455,1,0,401992,1,40.73319755600820000000
chr1,248800254,248802459,2205,1,0,403244,1,45.35147392290250000000
chr1,248546232,248548355,2123,1,0,,0,0.00000000000000000000
chr1,248604155,248605458,1303,1,0,,0,0.00000000000000000000
chr10,60073,129474,69401,1,0,347688,1,1.44090142793331000000
chr10,100701,135330,34629,1,0,,0,0.00000000000000000000
chr10,86526,115230,28704,1,0,347688,1,3.48383500557414000000
chr10,463625,464236,611,1,0,22982,1,163.66612111293000000000
chr10,763734,764352,618,1,0,,0,0.00000000000000000000
chr10,2207097,2831710,624613,1,0,,0,0.00000000000000000000
chr10,2688099,3134213,446114,1,0,5214,1,0.22415795065835200000
chr10,1370004,1462101,92097,1,0,105,1,1.08581169853524000000
chr10,1861297,1921657,60360,1,0,,0,0.00000000000000000000
chr10,1884391,1912165,27774,1,0,,0,0.00000000000000000000
chr10,1110016,1117446,7430,1,0,22884,1,13.45895020188430000000
chr10,1658662,1659984,1322,1,0,105,1,75.64296520423600000000
chr10,1281478,1282455,977,1,0,105,1,102.35414534288600000000
chr10,3127046,3128011,965,1,0,5214,1,103.62694300518100000000
chr10,2066869,2067419,550,1,0,,0,0.00000000000000000000
chr10,4290030,4291751,1721,1,0,,0,0.00000000000000000000
chr10,4290173,4291552,1379,1,0,,0,0.00000000000000000000
chr10,4708566,4710334,1768,1,0,,0,0.00000000000000000000
chr10,5034406,5087198,52792,1,0,1646,1,1.89422639793908000000
chr10,5651094,5705155,54061,1,0,79754,1,1.84976230554374000000
chr10,5890314,5892598,2284,1,0,,0,0.00000000000000000000
chr10,6674036,6865692,191656,1,0,,0,0.00000000000000000000
chr10,6653496,6664226,10730,1,0,,0,0.00000000000000000000
chr10,7087337,7134170,46833,1,0,,0,0.00000000000000000000
chr10,7077055,7078352,1297,1,0,,0,0.00000000000000000000
chr10,7706408,7727355,20947,1,0,80760,1,4.77395331073662000000
chr10,12092546,12173049,80503,1,0,55176;55526,2,2.48437946411935000000
chr10,12542527,12551342,8815,1,0,57118,1,11.34429948950650000000
chr10,15001480,15062421,60941,1,0,644890,1,1.64093139265847000000
chr10,15028831,15051819,22988,1,0,,0,0.00000000000000000000
chr10,15645717,15796480,150763,1,0,8516,1,0.66329271770925200000
chr10,16850206,16976687,126481,1,0,6251;8029,2,1.58126517026273000000
chr10,17336958,17337711,753,1,0,,0,0.00000000000000000000
chr10,17364415,17383538,19123,1,0,338596,1,5.22930502536213000000
chr10,18376247,18404255,28008,1,0,,0,0.00000000000000000000
chr10,18746997,18761018,14021,1,0,783,1,7.13215890450039000000
chr10,19290710,19323635,32925,1,0,,0,0.00000000000000000000
chr10,20786321,20820364,34043,1,0,,0,0.00000000000000000000
chr10,24160522,24166603,6081,1,0,56243,1,16.44466370662720000000
chr10,24363032,24378698,15666,1,0,56243,1,6.38325035107877000000
chr10,24375251,24380849,5598,1,0,56243,1,17.86352268667380000000
chr10,24375251,24379010,3759,1,0,56243,1,26.60281989890930000000
chr10,24377661,24379026,1365,1,0,56243,1,73.26007326007330000000
chr10,24521516,24549353,27837,1,0,56243,1,3.59234112871358000000
chr10,26999555,27001887,2332,1,0,23590,1,42.88164665523160000000
chr10,27224620,27235850,11230,1,0,,0,0.00000000000000000000
chr10,27224672,27229473,4801,1,0,,0,0.00000000000000000000
chr10,27226085,27228439,2354,1,0,,0,0.00000000000000000000
chr10,27427014,27985729,558715,1,0,91452;374308;84930;22931;283078;10730,6,1.07389277180674000000
chr10,28663549,28665264,1715,1,0,,0,0.00000000000000000000
chr10,28664015,28665069,1054,1,0,,0,0.00000000000000000000
chr10,29384863,29649883,265020,1,0,84569,1,0.37733001282922000000
chr10,29742071,29742962,891,1,0,,0,0.00000000000000000000
chr10,31246708,31251728,5020,1,0,220929,1,19.92031872509960000000
chr10,31443622,31444774,1152,1,0,,0,0.00000000000000000000
chr10,31443710,31444628,918,1,0,,0,0.00000000000000000000
chr10,32253193,32269559,16366,1,0,,0,0.00000000000000000000
chr10,32863336,32869033,5697,1,0,79741,1,17.55309812181850000000
chr10,34096615,34097112,497,1,0,,0,0.00000000000000000000
chr10,35020944,35315414,294470,1,0,56288;8453,2,0.67918633477094400000
chr10,35004233,35166755,162522,1,0,56288,1,0.61530131305300200000
chr10,35166832,35321926,155094,1,0,8453,1,0.64477026835338600000
chr10,35025740,35089205,63465,1,0,56288,1,1.57567163003230000000
chr10,38688921,39090593,401672,1,0,,0,0.00000000000000000000
chr10,38873729,39134907,261178,1,0,,0,0.00000000000000000000
chr10,37186232,37364148,177916,1,0,,0,0.00000000000000000000
chr10,38913848,39033468,119620,1,0,,0,0.00000000000000000000
chr10,39068483,39154793,86310,1,0,,0,0.00000000000000000000
chr10,38693769,38769644,75875,1,0,,0,0.00000000000000000000
chr10,38755086,38818824,63738,1,0,,0,0.00000000000000000000
chr10,38870056,38930617,60561,1,0,,0,0.00000000000000000000
chr10,39009257,39061469,52212,1,0,,0,0.00000000000000000000
chr10,37438354,37495010,56656,1,0,91074,1,1.76503812482350000000
chr10,37460858,37495018,34160,1,0,91074,1,2.92740046838408000000
chr10,38868836,38898870,30034,1,0,,0,0.00000000000000000000
chr10,38797801,38818733,20932,1,0,,0,0.00000000000000000000
chr10,37437481,37458130,20649,1,0,91074,1,4.84284953266502000000
chr10,38914405,38928478,14073,1,0,,0,0.00000000000000000000
chr10,42709645,43050772,341127,1,0,,0,0.00000000000000000000
chr10,42629270,42838259,208989,1,0,,0,0.00000000000000000000
chr10,42483429,42651751,168322,1,0,,0,0.00000000000000000000
chr10,42789198,42947829,158631,1,0,,0,0.00000000000000000000
chr10,42355722,42437087,81365,1,0,,0,0.00000000000000000000
chr10,42857624,42929897,72273,1,0,,0,0.00000000000000000000
chr10,42606410,42679446,73036,1,0,,0,0.00000000000000000000
chr10,42660151,42720457,60306,1,0,,0,0.00000000000000000000
chr10,43185235,43249473,64238,1,0,,0,0.00000000000000000000
chr10,43182121,43223614,41493,1,0,,0,0.00000000000000000000
chr10,42355001,42398230,43229,1,0,,0,0.00000000000000000000
chr10,42715976,42754871,38895,1,0,,0,0.00000000000000000000
chr10,42779801,42818400,38599,1,0,,0,0.00000000000000000000
chr10,42738423,42773082,34659,1,0,,0,0.00000000000000000000
chr10,42645901,42672500,26599,1,0,,0,0.00000000000000000000
chr10,43050332,43066616,16284,1,0,,0,0.00000000000000000000
chr10,42631310,42643650,12340,1,0,,0,0.00000000000000000000
chr10,42533116,42546570,13454,1,0,,0,0.00000000000000000000
chr10,42659254,42669241,9987,1,0,,0,0.00000000000000000000
chr10,43325598,43331203,5605,1,0,9790,1,17.84121320249780000000
chr10,43678898,43680776,1878,1,0,55454,1,53.24813631522900000000
chr10,44193584,44202108,8524,1,0,,0,0.00000000000000000000
chr10,45206627,45362929,156302,1,0,,0,0.00000000000000000000
chr10,45601377,45646843,45466,1,0,,0,0.00000000000000000000
chr10,46740843,48127687,1386844,1,0,195977;83849;728113;9721;5540,5,0.36053081673209100000
chr10,46282409,47240897,958488,1,0,119016;83849;253725;728113;9721;5540,6,0.62598592783634200000
chr10,47088737,48131306,1042569,1,0,728113;195977,2,0.19183382586668100000
chr10,46907197,47670183,762986,1,0,195977;83849;728113;9721;5540,5,0.65532001897806800000
chr10,47523073,48120387,597314,1,0,195977,1,0.16741613288823000000
chr10,47070260,47707312,637052,1,0,728113;195977;5540,3,0.47091917143341500000
chr10,46654838,47153110,498272,1,0,9721;83849;5540,3,0.60208079121443700000
chr10,47471696,47794537,322841,1,0,195977,1,0.30975000077437500000
chr10,47030423,47329117,298694,1,0,728113;5540,2,0.66958157847161300000
chr10,47098702,47324471,225769,1,0,728113,1,0.44293060606194800000
chr10,47244262,47480155,235893,1,0,,0,0.00000000000000000000
chr10,46939873,47174699,234826,1,0,728113;9721;83849;5540,4,1.70338889220103000000
chr10,47540498,47746402,205904,1,0,195977,1,0.48566322169554700000
chr10,46527944,46682974,155030,1,0,,0,0.00000000000000000000
chr10,47892511,48055660,163149,1,0,,0,0.00000000000000000000
chr10,47006131,47149453,143322,1,0,5540,1,0.69772958792090500000
chr10,46924790,47049005,124215,1,0,9721;83849,2,1.61011150022139000000
chr10,48751776,48880536,128760,1,0,26095,1,0.77663870767319100000
chr10,49266893,49389813,122920,1,0,143162,1,0.81353726000650800000
chr10,47537368,47652803,115435,1,0,,0,0.00000000000000000000
chr10,47007919,47086703,78784,1,0,5540,1,1.26929325751422000000
chr10,47601430,47704291,102861,1,0,195977,1,0.97218576525602500000
chr10,47089872,47150786,60914,1,0,,0,0.00000000000000000000
chr10,46900767,46968758,67991,1,0,83849,1,1.47078289773647000000
chr10,47040770,47104225,63455,1,0,5540,1,1.57591994326688000000
chr10,47531763,47597768,66005,1,0,,0,0.00000000000000000000
chr10,47698559,47753807,55248,1,0,195977,1,1.81002027222705000000
chr10,47011721,47057897,46176,1,0,,0,0.00000000000000000000
chr10,47645964,47697149,51185,1,0,195977,1,1.95369737227703000000
chr10,46976292,47023561,47269,1,0,9721,1,2.11555141847723000000
chr10,47924133,47966959,42826,1,0,,0,0.00000000000000000000
chr10,47037538,47081698,44160,1,0,,0,0.00000000000000000000
chr10,47383494,47426955,43461,1,0,,0,0.00000000000000000000
chr10,46262157,46305349,43192,1,0,253725,1,2.31524356362289000000
chr10,47596405,47634034,37629,1,0,,0,0.00000000000000000000
chr10,48242980,48278731,35751,1,0,100133093;653145,2,5.59424911191295000000
chr10,47037048,47065223,28175,1,0,,0,0.00000000000000000000
chr10,46170011,46201013,31002,1,0,,0,0.00000000000000000000
chr10,47042344,47060123,17779,1,0,,0,0.00000000000000000000
chr10,47637179,47654693,17514,1,0,,0,0.00000000000000000000
chr10,47056492,47068154,11662,1,0,,0,0.00000000000000000000
chr10,46799483,46810615,11132,1,0,,0,0.00000000000000000000
chr10,46389926,46397446,7520,1,0,,0,0.00000000000000000000
chr10,47055778,47059726,3948,1,0,,0,0.00000000000000000000
chr10,47058554,47059800,1246,1,0,,0,0.00000000000000000000
chr10,51118205,51137410,19205,1,0,8505,1,5.20697734964853000000
chr10,51072489,51079469,6980,1,0,8505,1,14.32664756446990000000
chr10,51481718,51607341,125623,1,0,4477;100652748;8031;100287932,4,3.18413029461166000000
chr10,51300974,51397653,96679,1,0,8505;100652748,2,2.06870157945366000000
chr10,51600128,51694155,94027,1,0,100287932;100652748,2,2.12704861369607000000
chr10,51293231,51301436,8205,1,0,8505,1,12.18769043266300000000
chr10,51693770,51700648,6878,1,0,100652748,1,14.53911020645540000000
chr10,52006147,52110410,104263,1,0,259230;56624,2,1.91822602457248000000
chr10,51907414,51911058,3644,1,0,,0,0.00000000000000000000
chr10,51909884,51912723,2839,1,0,,0,0.00000000000000000000
chr10,51909871,51911058,1187,1,0,,0,0.00000000000000000000
chr10,52414948,52500270,85322,1,0,653308,1,1.17203066032207000000
chr10,54533329,54548929,15600,1,0,,0,0.00000000000000000000
chr10,54562047,54562526,479,1,0,,0,0.00000000000000000000
chr10,54680524,54694771,14247,1,0,,0,0.00000000000000000000
chr10,56445428,56470499,25071,1,0,65217,1,3.98867217103426000000
chr10,56458047,56469354,11307,1,0,65217,1,8.84407888918369000000
chr10,56586273,56641659,55386,1,0,,0,0.00000000000000000000
chr10,57371469,57389077,17608,1,0,,0,0.00000000000000000000
chr10,57773028,57779093,6065,1,0,,0,0.00000000000000000000
chr10,58728458,58757714,29256,1,0,,0,0.00000000000000000000
chr10,58739323,58753163,13840,1,0,,0,0.00000000000000000000
chr10,59839520,59894850,55330,1,0,,0,0.00000000000000000000
chr10,61361972,61364971,2999,1,0,,0,0.00000000000000000000
chr10,64035398,64128133,92735,1,0,,0,0.00000000000000000000
chr10,65509257,65511076,1819,1,0,,0,0.00000000000000000000
chr10,65992658,66016853,24195,1,0,,0,0.00000000000000000000
chr10,67779460,67971002,191542,1,0,29119,1,0.52207870858610600000
chr10,68032524,68148495,115971,1,0,29119,1,0.86228453665140400000
chr10,68071761,68119591,47830,1,0,29119,1,2.09073803052478000000
chr10,67162231,67184208,21977,1,0,,0,0.00000000000000000000
chr10,66841600,66842090,490,1,0,,0,0.00000000000000000000
chr10,69338648,69460166,121518,1,0,29119,1,0.82292335291890900000
chr10,70195053,70261790,66737,1,0,1763;8034,2,2.99683833555599000000
chr10,71055421,71071317,15896,1,0,3098,1,6.29089079013588000000
chr10,75475447,75682321,206874,1,0,9632;5328;170384;8509;23053;818;118487;414236,8,3.86708817927821000000
chr10,75708906,75900462,191556,1,0,26985;7414,2,1.04408110422018000000
chr10,77136291,77173140,36849,1,0,84858,1,2.71377785014519000000
chr10,77544098,77702065,157967,1,0,83938,1,0.63304361037431900000
chr10,78253258,78266574,13316,1,0,83938,1,7.50976269149895000000
chr10,78253549,78260622,7073,1,0,83938,1,14.13827230312460000000
chr10,79362682,79594710,232028,1,0,3778;9231,2,0.86196493526643300000
chr10,81280420,81558633,278213,1,0,729262;653509;729238,3,1.07831050310374000000
chr10,81663511,81842215,178704,1,0,6441;80195,2,1.11916912883875000000
chr10,81418747,81542017,123270,1,0,729262,1,0.81122738703658600000
chr10,81561459,81679541,118082,1,0,,0,0.00000000000000000000
chr10,81452378,81556716,104338,1,0,729262,1,0.95842358488757700000
chr10,81505301,81601706,96405,1,0,,0,0.00000000000000000000
chr10,81304811,81392296,87485,1,0,653509;729238,2,2.28610618963251000000
chr10,81561968,81600906,38938,1,0,,0,0.00000000000000000000
chr10,81784030,81804538,20508,1,0,,0,0.00000000000000000000
chr10,81474395,81501867,27472,1,0,,0,0.00000000000000000000
chr10,81971971,81994234,22263,1,0,,0,0.00000000000000000000
chr10,82095098,82114680,19582,1,0,84332;143241,2,10.21346134204880000000
chr10,83777115,83804138,27023,1,0,10718,1,3.70055138215594000000
chr10,84403679,84431217,27538,1,0,10718,1,3.63134577674486000000
chr10,85522579,85523993,1414,1,0,,0,0.00000000000000000000
chr10,86623452,86930338,306886,1,0,,0,0.00000000000000000000
chr10,88974967,89173511,198544,1,0,728118,1,0.50366669352889000000
chr10,88891352,89011018,119666,1,0,54537;728118,2,1.67131850316715000000
chr10,89027106,89129070,101964,1,0,,0,0.00000000000000000000
chr10,89189706,89275944,86238,1,0,9562,1,1.15958162295044000000
chr10,89075883,89157994,82111,1,0,,0,0.00000000000000000000
chr10,88987710,89025487,37777,1,0,728118,1,2.64711332292135000000
chr10,88868784,88887975,19191,1,0,54537,1,5.21077588452921000000
chr10,88977471,88996637,19166,1,0,728118,1,5.21757278514035000000
chr10,88987466,88995571,8105,1,0,728118,1,12.33806292412090000000
chr10,89274283,89276718,2435,1,0,9562,1,41.06776180698150000000
chr10,89275526,89276755,1229,1,0,9562,1,81.36696501220500000000
chr10,89275956,89276615,659,1,0,9562,1,151.74506828528100000000
chr10,90794988,90803055,8067,1,0,,0,0.00000000000000000000
chr10,92087358,92566821,479463,1,0,3363,1,0.20856666729236700000
chr10,93633411,93634547,1136,1,0,,0,0.00000000000000000000
chr10,95545513,95546339,826,1,0,9211,1,121.06537530266300000000
chr10,96778312,96814689,36377,1,0,1558,1,2.74898974626825000000
chr10,96954249,96954777,528,1,0,142827,1,189.39393939393900000000
chr10,102213758,102269671,55913,1,0,7479;25956,2,3.57698567417237000000
chr10,103139545,103365695,226150,1,0,8945;27343;25911,3,1.32655317267300000000
chr10,103286508,103323347,36839,1,0,8945,1,2.71451450908005000000
chr10,105147981,105313230,165249,1,0,9148;6877;119395;51063;255022;22984;84833,7,4.23603168551701000000
chr10,105156529,105220101,63572,1,0,51063;255022;22984,3,4.71905870509029000000
chr10,105308425,105311240,2815,1,0,9148,1,35.52397868561280000000
chr10,107100163,107280387,180224,1,0,,0,0.00000000000000000000
chr10,107995971,107997704,1733,1,0,,0,0.00000000000000000000
chr10,107950692,107951601,909,1,0,,0,0.00000000000000000000
chr10,110813921,110978850,164929,1,0,,0,0.00000000000000000000
chr10,112918898,113001546,82648,1,0,,0,0.00000000000000000000
chr10,114111698,114117684,5986,1,0,,0,0.00000000000000000000
chr10,114112091,114116825,4734,1,0,,0,0.00000000000000000000
chr10,115300361,115511276,210915,1,0,3026;79949;4892;840,4,1.89649858947917000000
chr10,115350248,115440959,90711,1,0,4892;840,2,2.20480426850106000000
chr10,115541979,115543315,1336,1,0,79949,1,74.85029940119760000000
chr10,116659579,116868969,209390,1,0,57700;142940;26033,3,1.43273317732461000000
chr10,122226759,122228578,1819,1,0,196051,1,54.97526113249040000000
chr10,122367347,122474459,107112,1,0,,0,0.00000000000000000000
chr10,124349528,124379142,29614,1,0,1755,1,3.37678125211049000000
chr10,124341037,124359959,18922,1,0,1755,1,5.28485360955502000000
chr10,124360335,124380532,20197,1,0,1755,1,4.95123038074962000000
chr10,124342414,124352037,9623,1,0,1755,1,10.39176971838300000000
chr10,124355107,124358407,3300,1,0,1755,1,30.30303030303030000000
chr10,127574882,127606174,31292,1,0,92565,1,3.19570497251694000000
chr10,127576313,127593360,17047,1,0,92565,1,5.86613480377779000000
chr10,128513424,128614347,100923,1,0,1793,1,0.99085441376098600000
chr10,129882268,129883286,1018,1,0,5791,1,98.23182711198430000000
chr10,130472020,131726895,1254875,1,0,4255;253738,2,0.15937842414583100000
chr10,133047401,134036654,989253,1,0,664;256536;282973;282974;10570;55844,6,0.60651825165048800000
chr10,135235715,135502817,267102,1,0,93426;1571;441581;503542,4,1.49755524106895000000
chr10,133842438,134172250,329812,1,0,282973;282974;80313;10570,4,1.21281214752647000000
chr10,134739063,134930267,191204,1,0,84435;54777,2,1.04600322168992000000
chr10,133511068,133660375,149307,1,0,,0,0.00000000000000000000
chr10,134650768,134809904,159136,1,0,54777,1,0.62839332394932600000
chr10,135234828,135403312,168484,1,0,93426;1571;503542,3,1.78058450654068000000
chr10,135014366,135193246,178880,1,0,10844;118471;282969;85442;27287;196743;8433;101;1892;50632;118472,11,6.14937388193202000000
chr10,135347027,135490244,143217,1,0,93426;441581;1571,3,2.09472339177612000000
chr10,134132296,134227689,95393,1,0,282974;80313;170394,3,3.14488484479993000000
chr10,134698963,134791735,92772,1,0,54777,1,1.07791143879619000000
chr10,135350470,135438903,88433,1,0,93426;441581;1571,3,3.39239876516685000000
chr10,135299289,135380526,81237,1,0,93426;1571,2,2.46193237071778000000
chr10,135435395,135513128,77733,1,0,441581,1,1.28645491618746000000
chr10,134572153,134626969,54816,1,0,3632;84504;54777,3,5.47285464098074000000
chr10,135273198,135338534,65336,1,0,,0,0.00000000000000000000
chr10,135243065,135295896,52831,1,0,,0,0.00000000000000000000
chr10,134151201,134187930,36729,1,0,80313,1,2.72264423207819000000
chr10,135345847,135378149,32302,1,0,93426;1571,2,6.19156708562937000000
chr10,135477155,135524597,47442,1,0,,0,0.00000000000000000000
chr10,135141195,135186635,45440,1,0,50632;1892;118471;282969,4,8.80281690140845000000
chr10,135458881,135498977,40096,1,0,,0,0.00000000000000000000
chr10,134187915,134219565,31650,1,0,80313;170394,2,6.31911532385466000000
chr10,133441488,133466045,24557,1,0,,0,0.00000000000000000000
chr10,135502398,135524551,22153,1,0,,0,0.00000000000000000000
chr10,134955430,134968627,13197,1,0,,0,0.00000000000000000000
chr10,135033444,135048655,15211,1,0,85442;8433,2,13.14837946223130000000
chr10,135484163,135491926,7763,1,0,,0,0.00000000000000000000
chr10,133455149,133459375,4226,1,0,,0,0.00000000000000000000
chr10,135290465,135294797,4332,1,0,,0,0.00000000000000000000
chr10,135128946,135131723,2777,1,0,,0,0.00000000000000000000
chr10,132636113,132638584,2471,1,0,,0,0.00000000000000000000
chr10,135129958,135132230,2272,1,0,,0,0.00000000000000000000
chr10,133455341,133457280,1939,1,0,,0,0.00000000000000000000
chr10,134987972,134989752,1780,1,0,85442,1,56.17977528089890000000
chr10,134424371,134425829,1458,1,0,3632,1,68.58710562414270000000
chr10,132840362,132841893,1531,1,0,,0,0.00000000000000000000
chr10,133183688,133185115,1427,1,0,,0,0.00000000000000000000
chr10,135104975,135106286,1311,1,0,10844,1,76.27765064836000000000
chr10,132840209,132841158,949,1,0,,0,0.00000000000000000000
chr10,135244694,135245412,718,1,0,,0,0.00000000000000000000
chr11,195089,243061,47972,1,0,23410;60626;51272;113746;5719,5,10.42274660218460000000
chr11,175113,193943,18830,1,0,147199,1,5.31067445565587000000
chr11,429245,435180,5935,1,0,338440,1,16.84919966301600000000
chr11,400972,403367,2395,1,0,11187,1,41.75365344467640000000
chr11,384915,385658,743,1,0,,0,0.00000000000000000000
chr11,195929,196584,655,1,0,,0,0.00000000000000000000
chr11,1016045,1042376,26331,1,0,4588,1,3.79780486878584000000
chr11,1015791,1019718,3927,1,0,4588,1,25.46473134708430000000
chr11,1016886,1018423,1537,1,0,4588,1,65.06180871828240000000
chr11,1078875,1079557,682,1,0,4583,1,146.62756598240500000000
chr11,1372987,1374460,1473,1,0,,0,0.00000000000000000000
chr11,1315373,1316262,889,1,0,54472,1,112.48593925759300000000
chr11,1315709,1316194,485,1,0,54472,1,206.18556701030900000000
chr11,1450788,1454440,3652,1,0,9024,1,27.38225629791890000000
chr11,1597187,1726249,129062,1,0,440023;440021;439915;387266;387264,5,3.87410701833227000000
chr11,2063436,2089023,25587,1,0,,0,0.00000000000000000000
chr11,1905924,1907584,1660,1,0,4046,1,60.24096385542170000000
chr11,2320848,2321991,1143,1,0,29125,1,87.48906386701660000000
chr11,2449575,2451230,1655,1,0,,0,0.00000000000000000000
chr11,3239311,3360988,121677,1,0,116534;386746,2,1.64369601485901000000
chr11,3426081,3674989,248908,1,0,417;116969,2,0.80350973050283600000
chr11,3628850,3758508,129658,1,0,57053;417;4928;116969,4,3.08503910287063000000
chr11,4200040,4377387,177347,1,0,,0,0.00000000000000000000
chr11,4251699,4394893,143194,1,0,143496,1,0.69835328295878300000
chr11,4130590,4257269,126679,1,0,6240,1,0.78939682188839500000
chr11,4250474,4340921,90447,1,0,,0,0.00000000000000000000
chr11,4431590,4489029,57439,1,0,119774,1,1.74097738470377000000
chr11,4349747,4387104,37357,1,0,,0,0.00000000000000000000
chr11,4330328,4350789,20461,1,0,,0,0.00000000000000000000
chr11,4255965,4278463,22498,1,0,,0,0.00000000000000000000
chr11,4229361,4233073,3712,1,0,,0,0.00000000000000000000
chr11,4293238,4298276,5038,1,0,,0,0.00000000000000000000
chr11,4364906,4367232,2326,1,0,,0,0.00000000000000000000
chr11,4967675,4993719,26044,1,0,401666;401667,2,7.67931193365075000000
chr11,4967936,4983805,15869,1,0,401666;401667,2,12.60318860671750000000
chr11,4963663,4975974,12311,1,0,401666,1,8.12281699293315000000
chr11,4972111,4983844,11733,1,0,401667,1,8.52296940253984000000
chr11,4968318,4976369,8051,1,0,401666;401667,2,24.84163457955530000000
chr11,5271384,5275214,3830,1,0,3048,1,26.10966057441250000000
chr11,5892747,5961013,68266,1,0,390081,1,1.46485805525445000000
chr11,5784682,5809443,24761,1,0,79473;390075,2,8.07721820604984000000
chr11,5793499,5809339,15840,1,0,79473;390075,2,12.62626262626260000000
chr11,5604876,5620426,15550,1,0,117854;445372,2,12.86173633440510000000
chr11,5760086,5768910,8824,1,0,,0,0.00000000000000000000
chr11,5876104,5882779,6675,1,0,390079,1,14.98127340823970000000
chr11,5760095,5762329,2234,1,0,,0,0.00000000000000000000
chr11,5760940,5762372,1432,1,0,,0,0.00000000000000000000
chr11,5382776,5383919,1143,1,0,282763,1,87.48906386701660000000
chr11,7540999,7678983,137984,1,0,8495,1,0.72472170686456400000
chr11,7700499,7804617,104118,1,0,341277,1,0.96044872164275200000
chr11,9323857,9328160,4303,1,0,440026,1,23.23960027887520000000
chr11,7135661,7136514,853,1,0,,0,0.00000000000000000000
chr11,10529211,10531721,2510,1,0,100463486,1,39.84063745019920000000
chr11,10964142,10985552,21410,1,0,,0,0.00000000000000000000
chr11,11874870,11876747,1877,1,0,55031,1,53.27650506126800000000
chr11,17723530,17783128,59598,1,0,4654;3746,2,3.35581730930568000000
chr11,18144633,18198754,54121,1,0,117196;117195,2,3.69542321834408000000
chr11,18933444,18990589,57145,1,0,259249,1,1.74993437746085000000
chr11,18944481,18973406,28925,1,0,259249,1,3.45721694036301000000
chr11,18940205,18963657,23452,1,0,259249,1,4.26402865427256000000
chr11,18949422,18965068,15646,1,0,259249,1,6.39140994503387000000
chr11,20753678,20754240,562,1,0,4745,1,177.93594306049800000000
chr11,21186933,21217159,30226,1,0,4745,1,3.30840997816449000000
chr11,21617356,21698030,80674,1,0,,0,0.00000000000000000000
chr11,22086875,22223797,136922,1,0,203859,1,0.73034282292107900000
chr11,25129111,25315252,186141,1,0,,0,0.00000000000000000000
chr11,25634779,25734765,99986,1,0,,0,0.00000000000000000000
chr11,23796545,23872731,76186,1,0,,0,0.00000000000000000000
chr11,25857171,25919603,62432,1,0,,0,0.00000000000000000000
chr11,25672434,25731571,59137,1,0,,0,0.00000000000000000000
chr11,25091551,25127628,36077,1,0,338645,1,2.77184910053497000000
chr11,24443153,24452245,9092,1,0,,0,0.00000000000000000000
chr11,25078714,25083528,4814,1,0,338645,1,20.77274615704200000000
chr11,26608360,26611319,2959,1,0,63982,1,33.79520108144640000000
chr11,29006965,29012679,5714,1,0,,0,0.00000000000000000000
chr11,29007150,29012087,4937,1,0,,0,0.00000000000000000000
chr11,30743457,30798879,55422,1,0,,0,0.00000000000000000000
chr11,31393781,31397522,3741,1,0,120526,1,26.73082063619350000000
chr11,33063806,33513945,450139,1,0,1479;55346;10114,3,0.66646080432932900000
chr11,33346917,33513991,167074,1,0,10114,1,0.59853717514394800000
chr11,33330112,33395665,65553,1,0,10114,1,1.52548319680259000000
chr11,34171916,34174282,2366,1,0,25841,1,42.26542688081150000000
chr11,37762560,37842217,79657,1,0,,0,0.00000000000000000000
chr11,36730049,36791406,61357,1,0,,0,0.00000000000000000000
chr11,38300343,38301114,771,1,0,,0,0.00000000000000000000
chr11,41337180,41347594,10414,1,0,57689,1,9.60245822930670000000
chr11,42813734,42818536,4802,1,0,,0,0.00000000000000000000
chr11,42959223,42972763,13540,1,0,,0,0.00000000000000000000
chr11,42967424,42976363,8939,1,0,,0,0.00000000000000000000
chr11,42968994,42972690,3696,1,0,,0,0.00000000000000000000
chr11,42968030,42970953,2923,1,0,,0,0.00000000000000000000
chr11,42969604,42971157,1553,1,0,,0,0.00000000000000000000
chr11,43948917,43968496,19579,1,0,387763,1,5.10751315184637000000
chr11,45429867,45431564,1697,1,0,,0,0.00000000000000000000
chr11,45430488,45431410,922,1,0,,0,0.00000000000000000000
chr11,46142069,46142658,589,1,0,51317,1,169.77928692699500000000
chr11,47057894,47063426,5532,1,0,79096,1,18.07664497469270000000
chr11,48270372,48711629,441257,1,0,390113;256144;403253;256148,4,0.90650119998096300000
chr11,48662789,48921814,259025,1,0,,0,0.00000000000000000000
chr11,48701118,48840850,139732,1,0,,0,0.00000000000000000000
chr11,48185151,48347240,162089,1,0,390113;119765;256148;256144;5795;119764,6,3.70167007014665000000
chr11,48911007,48994171,83164,1,0,,0,0.00000000000000000000
chr11,48799509,48882326,82817,1,0,,0,0.00000000000000000000
chr11,48596534,48667977,71443,1,0,,0,0.00000000000000000000
chr11,48848572,48920644,72072,1,0,,0,0.00000000000000000000
chr11,48473613,48555160,81547,1,0,403253,1,1.22628668130035000000
chr11,48706153,48779996,73843,1,0,,0,0.00000000000000000000
chr11,48735417,48784679,49262,1,0,,0,0.00000000000000000000
chr11,48451799,48501848,50049,1,0,,0,0.00000000000000000000
chr11,48918739,48972242,53503,1,0,,0,0.00000000000000000000
chr11,48600881,48604229,3348,1,0,,0,0.00000000000000000000
chr11,48327587,48328159,572,1,0,256148,1,174.82517482517500000000
chr11,49040316,49045847,5531,1,0,,0,0.00000000000000000000
chr11,49116136,49119929,3793,1,0,,0,0.00000000000000000000
chr11,49116841,49119222,2381,1,0,,0,0.00000000000000000000
chr11,50400410,51310493,910083,1,0,,0,0.00000000000000000000
chr11,50020323,50716738,696415,1,0,,0,0.00000000000000000000
chr11,50215628,50672958,457330,1,0,,0,0.00000000000000000000
chr11,51155720,51584059,428339,1,0,81318;119749,2,0.46691989288857700000
chr11,50382526,50763272,380746,1,0,,0,0.00000000000000000000
chr11,50171853,50533604,361751,1,0,,0,0.00000000000000000000
chr11,49742161,50023855,281694,1,0,283092;283093,2,0.70999027313325800000
chr11,50409746,50620119,210373,1,0,,0,0.00000000000000000000
chr11,51110102,51351329,241227,1,0,,0,0.00000000000000000000
chr11,51364454,51586062,221608,1,0,81318;119749,2,0.90249449478358200000
chr11,50281390,50416601,135211,1,0,,0,0.00000000000000000000
chr11,51158112,51268278,110166,1,0,,0,0.00000000000000000000
chr11,51218367,51340208,121841,1,0,,0,0.00000000000000000000
chr11,50215765,50303658,87893,1,0,,0,0.00000000000000000000
chr11,50115630,50194250,78620,1,0,,0,0.00000000000000000000
chr11,51377161,51474835,97674,1,0,81318,1,1.02381391158343000000
chr11,50265376,50350446,85070,1,0,,0,0.00000000000000000000
chr11,51285210,51357960,72750,1,0,,0,0.00000000000000000000
chr11,50240742,50289468,48726,1,0,,0,0.00000000000000000000
chr11,50342972,50402349,59377,1,0,,0,0.00000000000000000000
chr11,49709643,49760989,51346,1,0,,0,0.00000000000000000000
chr11,50309995,50360795,50800,1,0,,0,0.00000000000000000000
chr11,51535431,51564743,29312,1,0,,0,0.00000000000000000000
chr11,51572143,51594097,21954,1,0,,0,0.00000000000000000000
chr11,51342314,51363486,21172,1,0,,0,0.00000000000000000000
chr11,49852171,49876468,24297,1,0,,0,0.00000000000000000000
chr11,50039138,50062691,23553,1,0,,0,0.00000000000000000000
chr11,49898587,49909136,10549,1,0,,0,0.00000000000000000000
chr11,51183289,51196204,12915,1,0,,0,0.00000000000000000000
chr11,51581326,51594053,12727,1,0,,0,0.00000000000000000000
chr11,51353224,51367675,14451,1,0,,0,0.00000000000000000000
chr11,50070922,50078186,7264,1,0,,0,0.00000000000000000000
chr11,51347669,51350690,3021,1,0,,0,0.00000000000000000000
chr11,54701572,55297747,596175,1,0,81327;79097;81328,3,0.50320795068562100000
chr11,55453563,55915367,461804,1,0,390148;84767;219436;10798;390144;219447;338674;120586;219438;390142;282770;390152;219437;390151;81168;26338,16,3.46467332461390000000
chr11,54694843,55024972,330129,1,0,,0,0.00000000000000000000
chr11,54723351,54905207,181856,1,0,,0,0.00000000000000000000
chr11,55459122,55609227,150105,1,0,390142;219437;26338;219436;390144;219438,6,3.99720195862896000000
chr11,55373715,55449707,75992,1,0,219432;219431;81300,3,3.94778397726076000000
chr11,55358977,55432928,73951,1,0,219432;219429;219431;81300,4,5.40898703195359000000
chr11,54701354,54764403,63049,1,0,,0,0.00000000000000000000
chr11,55041641,55121102,79461,1,0,81327,1,1.25847900227785000000
chr11,54778899,54843533,64634,1,0,,0,0.00000000000000000000
chr11,55397624,55448019,50395,1,0,219432;219431;81300,3,5.95297152495287000000
chr11,54947684,55011536,63852,1,0,,0,0.00000000000000000000
chr11,55374395,55427848,53453,1,0,219431;81300,2,3.74160477428769000000
chr11,55387443,55430987,43544,1,0,219431;81300,2,4.59305530038582000000
chr11,55411834,55446945,35111,1,0,219432;219431,2,5.69622055765999000000
chr11,54938366,54970943,32577,1,0,,0,0.00000000000000000000
chr11,54858101,54885300,27199,1,0,,0,0.00000000000000000000
chr11,54695628,54709984,14356,1,0,,0,0.00000000000000000000
chr11,54957689,54972850,15161,1,0,,0,0.00000000000000000000
chr11,55452992,55468588,15596,1,0,,0,0.00000000000000000000
chr11,54883952,54892245,8293,1,0,,0,0.00000000000000000000
chr11,54694268,54701465,7197,1,0,,0,0.00000000000000000000
chr11,55031988,55038453,6465,1,0,79097,1,15.46790409899460000000
chr11,56439714,56440246,532,1,0,,0,0.00000000000000000000
chr11,57970342,57983087,12745,1,0,219959;219958,2,15.69242840329540000000
chr11,58801453,58860834,59381,1,0,,0,0.00000000000000000000
chr11,58802294,58848024,45730,1,0,,0,0.00000000000000000000
chr11,60759913,60879373,119460,1,0,923;921,2,1.67420056922819000000
chr11,60966146,61020399,54253,1,0,5222;643847;643834,3,5.52964813005732000000
chr11,61981436,62004179,22743,1,0,,0,0.00000000000000000000
chr11,62092889,62157092,64203,1,0,80150,1,1.55755961559429000000
chr11,62137601,62153766,16165,1,0,80150,1,6.18620476337767000000
chr11,62294412,62404313,109901,1,0,1937;79026;23193;6094;9219;64852;256364;26229,8,7.27927862348841000000
chr11,66707745,66714185,6440,1,0,5091,1,15.52795031055900000000
chr11,66712155,66713215,1060,1,0,5091,1,94.33962264150940000000
chr11,67448489,67756119,307630,1,0,222,1,0.32506582582973100000
chr11,67506977,67628079,121102,1,0,,0,0.00000000000000000000
chr11,67749066,67819793,70727,1,0,221;4728;81622;10312,4,5.65554880031671000000
chr11,67756817,67777771,20954,1,0,221;81622,2,9.54471699914098000000
chr11,68434354,68435004,650,1,0,,0,0.00000000000000000000
chr11,69982681,69984152,1471,1,0,55107,1,67.98096532970770000000
chr11,71327668,71615559,287891,1,0,245911;100129216;100131539;55199,4,1.38941474377455000000
chr11,71297532,71436568,139036,1,0,,0,0.00000000000000000000
chr11,71509013,71551009,41996,1,0,100131539;245911;55199,3,7.14353747975998000000
chr11,71853982,71890685,36703,1,0,,0,0.00000000000000000000
chr11,72924397,72951263,26866,1,0,5029,1,3.72217672895109000000
chr11,73580695,73610170,29475,1,0,80227;51287,2,6.78541136556404000000
chr11,73949629,74539898,590269,1,0,10714;51400;10008;25884;283209;283208;254225;387787;100287896,9,1.52472855596347000000
chr11,74936742,75052283,115541,1,0,100507050;408,2,1.73098726858864000000
chr11,80897822,80906149,8327,1,0,,0,0.00000000000000000000
chr11,81472375,81478750,6375,1,0,,0,0.00000000000000000000
chr11,81471350,81473934,2584,1,0,,0,0.00000000000000000000
chr11,81856334,81862981,6647,1,0,,0,0.00000000000000000000
chr11,81864732,81882059,17327,1,0,,0,0.00000000000000000000
chr11,82923371,82934958,11587,1,0,338699,1,8.63036161215155000000
chr11,83826542,83844017,17475,1,0,1740,1,5.72246065808298000000
chr11,85477458,85547370,69912,1,0,54843,1,1.43036960750658000000
chr11,87738386,87814417,76031,1,0,,0,0.00000000000000000000
chr11,87298857,87332368,33511,1,0,,0,0.00000000000000000000
chr11,88625223,88663414,38191,1,0,2915,1,2.61841795187348000000
chr11,89503478,89551397,47919,1,0,57093,1,2.08685490097873000000
chr11,89449146,89463085,13939,1,0,390231,1,7.17411579022885000000
chr11,89682684,89691748,9064,1,0,,0,0.00000000000000000000
chr11,89544747,89550193,5446,1,0,,0,0.00000000000000000000
chr11,89684409,89688922,4513,1,0,,0,0.00000000000000000000
chr11,92704480,92707592,3112,1,0,4544,1,32.13367609254500000000
chr11,96685825,96696742,10917,1,0,,0,0.00000000000000000000
chr11,97248934,97380631,131697,1,0,,0,0.00000000000000000000
chr11,98148039,98211020,62981,1,0,,0,0.00000000000000000000
chr11,98202135,98210514,8379,1,0,,0,0.00000000000000000000
chr11,101399878,101437495,37617,1,0,7225,1,2.65837254432836000000
chr11,102751329,102752723,1394,1,0,,0,0.00000000000000000000
chr11,102937335,103144120,206785,1,0,79659;84259,2,0.96718814227337600000
chr11,103343254,103380306,37052,1,0,79659,1,2.69890964050524000000
chr11,104941809,104977130,35321,1,0,440068,1,2.83117692024575000000
chr11,104950651,104972543,21892,1,0,440068,1,4.56787867714234000000
chr11,104262442,104273232,10790,1,0,,0,0.00000000000000000000
chr11,104267902,104273593,5691,1,0,,0,0.00000000000000000000
chr11,106940899,107202602,261703,1,0,143884,1,0.38211254742972000000
chr11,107555404,107689660,134256,1,0,54733;6588,2,1.48969133595519000000
chr11,107128096,107232040,103944,1,0,143884,1,0.96205649195720800000
chr11,107648693,107673191,24498,1,0,54733,1,4.08196587476529000000
chr11,107238737,107249703,10966,1,0,143884,1,9.11909538573773000000
chr11,107239130,107242922,3792,1,0,143884,1,26.37130801687760000000
chr11,108255053,108266827,11774,1,0,160140,1,8.49329030066248000000
chr11,112205328,112207335,2007,1,0,,0,0.00000000000000000000
chr11,117196967,117224379,27412,1,0,22897,1,3.64803735590252000000
chr11,121068057,121077587,9530,1,0,,0,0.00000000000000000000
chr11,124085997,124097575,11578,1,0,26492,1,8.63707030575229000000
chr11,126235302,126251859,16557,1,0,6484,1,6.03974149906384000000
chr11,127749631,127751694,2063,1,0,,0,0.00000000000000000000
chr11,128682708,128683385,677,1,0,2313,1,147.71048744460900000000
chr11,130418372,131101880,683508,1,0,283171;399979,2,0.29260813333567400000
chr11,131550684,131551780,1096,1,0,50863,1,91.24087591240880000000
chr11,131923559,131930176,6617,1,0,50863,1,15.11258878645910000000
chr11,132868972,133432098,563126,1,0,4978,1,0.17758015080106400000
chr11,133627815,133737311,109496,1,0,219938,1,0.91327537078980100000
chr11,134342017,134703640,361623,1,0,,0,0.00000000000000000000
chr11,134204677,134436237,231560,1,0,27087;89944,2,0.86370703057522900000
chr11,134476412,134745300,268888,1,0,,0,0.00000000000000000000
chr11,134247176,134390898,143722,1,0,27087,1,0.69578770125659300000
chr11,134621361,134725193,103832,1,0,,0,0.00000000000000000000
chr11,134227064,134305456,78392,1,0,27087;89944,2,2.55128074293295000000
chr11,134152613,134206393,53780,1,0,89944;112937,2,3.71885459278542000000
chr11,134897286,134944770,47484,1,0,,0,0.00000000000000000000
chr11,134860184,134905781,45597,1,0,,0,0.00000000000000000000
chr11,134574936,134607505,32569,1,0,,0,0.00000000000000000000
chr11,134371797,134401227,29430,1,0,,0,0.00000000000000000000
chr11,134593204,134617886,24682,1,0,,0,0.00000000000000000000
chr11,134920082,134945587,25505,1,0,,0,0.00000000000000000000
chr11,134613197,134627197,14000,1,0,,0,0.00000000000000000000
chr11,134601662,134607419,5757,1,0,,0,0.00000000000000000000
chr11,134795314,134800312,4998,1,0,,0,0.00000000000000000000
chr11,134732951,134734005,1054,1,0,,0,0.00000000000000000000
chr12,33481407,34820720,1339313,1,0,341359;84920,2,0.14933029097753800000
chr12,34169379,34807004,637625,1,0,84920,1,0.15683199372672000000
chr12,27284283,27791867,507584,1,0,341346;23012;8496;56938,4,0.78804690455175900000
chr12,33549777,33936125,386348,1,0,341359,1,0.25883400457618500000
chr12,34458018,34848657,390639,1,0,,0,0.00000000000000000000
chr12,33461567,33707114,245547,1,0,341359,1,0.40725400839757800000
chr12,30955156,31247803,292647,1,0,441631;1663,2,0.68341722279743200000
chr12,8321236,8592345,271109,1,0,55138;440077,2,0.73771066250106000000
chr12,34637284,34854795,217511,1,0,,0,0.00000000000000000000
chr12,31259646,31406621,146975,1,0,,0,0.00000000000000000000
chr12,632240,867504,235264,1,0,283358;65125;4815,3,1.27516322089227000000
chr12,8000050,8215352,215302,1,0,144195;719;55810;6515,4,1.85785547742241000000
chr12,9601994,9718439,116445,1,0,,0,0.00000000000000000000
chr12,174815,325821,151006,1,0,6539;440073,2,1.32445068407878000000
chr12,526518,671005,144487,1,0,84318;283358,2,1.38420757576806000000
chr12,8070815,8207676,136861,1,0,6515;55810,2,1.46133668466546000000
chr12,7990860,8085715,94855,1,0,144195;6515,2,2.10848136629593000000
chr12,31292035,31401701,109666,1,0,,0,0.00000000000000000000
chr12,9632200,9734000,101800,1,0,,0,0.00000000000000000000
chr12,166001,256500,90499,1,0,440073,1,1.10498458546503000000
chr12,19467987,19584284,116297,1,0,54477,1,0.85986740844561800000
chr12,34430676,34540257,109581,1,0,,0,0.00000000000000000000
chr12,8338854,8432726,93872,1,0,55138,1,1.06528038179649000000
chr12,8019660,8115453,95793,1,0,144195;6515,2,2.08783522804380000000
chr12,31268292,31353566,85274,1,0,,0,0.00000000000000000000
chr12,30322774,30403820,81046,1,0,,0,0.00000000000000000000
chr12,34264402,34323836,59434,1,0,,0,0.00000000000000000000
chr12,34487750,34560206,72456,1,0,,0,0.00000000000000000000
chr12,6805206,6888380,83174,1,0,50813;3902;8079;5763;196500,5,6.01149397648304000000
chr12,31999988,32056168,56180,1,0,,0,0.00000000000000000000
chr12,11502817,11577174,74357,1,0,653247;5542,2,2.68972658929220000000
chr12,3066644,3124994,58350,1,0,7004,1,1.71379605826907000000
chr12,8319330,8383233,63903,1,0,55138;440077,2,3.12974351751874000000
chr12,31354136,31416653,62517,1,0,,0,0.00000000000000000000
chr12,7432998,7489764,56766,1,0,341392,1,1.76161786985167000000
chr12,9572863,9622296,49433,1,0,,0,0.00000000000000000000
chr12,11216660,11252675,36015,1,0,259289;5554;106707243,3,8.32986255726781000000
chr12,2794792,2851070,56278,1,0,775,1,1.77689327978962000000
chr12,147410,189634,42224,1,0,440073,1,2.36832133383858000000
chr12,623073,680246,57173,1,0,283358;4815,2,3.49815472338341000000
chr12,11502777,11543818,41041,1,0,5542,1,2.43658780244146000000
chr12,11187640,11237312,49672,1,0,5554;106707243;259292,3,6.03961990658721000000
chr12,28697569,28747736,50167,1,0,55297,1,1.99334223692866000000
chr12,673150,720213,47063,1,0,4815,1,2.12481142298621000000
chr12,34310913,34356210,45297,1,0,,0,0.00000000000000000000
chr12,3371982,3416632,44650,1,0,10867,1,2.23964165733483000000
chr12,8558090,8596215,38125,1,0,,0,0.00000000000000000000
chr12,3660347,3705056,44709,1,0,56341,1,2.23668612583596000000
chr12,6541143,6579968,38825,1,0,55080;939;6843,3,7.72698003863490000000
chr12,31100687,31134766,34079,1,0,441631,1,2.93435840253529000000
chr12,1637913,1674266,36353,1,0,,0,0.00000000000000000000
chr12,31305227,31334748,29521,1,0,,0,0.00000000000000000000
chr12,15095785,15132141,36356,1,0,5149;397,2,5.50115524260095000000
chr12,11218662,11246028,27366,1,0,259289;5554;106707243,3,10.96250822188120000000
chr12,2906074,2946337,40263,1,0,83714;55846;2288,3,7.45100961180240000000
chr12,11514936,11544419,29483,1,0,,0,0.00000000000000000000
chr12,8342581,8378884,36303,1,0,55138,1,2.75459328430157000000
chr12,34227438,34254664,27226,1,0,,0,0.00000000000000000000
chr12,34404589,34431214,26625,1,0,,0,0.00000000000000000000
chr12,8003268,8025094,21826,1,0,144195,1,4.58169156052415000000
chr12,30387481,30415545,28064,1,0,,0,0.00000000000000000000
chr12,8361522,8391789,30267,1,0,55138,1,3.30392837083292000000
chr12,34826971,34856400,29429,1,0,,0,0.00000000000000000000
chr12,11222250,11250349,28099,1,0,259289;5554;106707243,3,10.67653653154920000000
chr12,31373023,31402166,29143,1,0,,0,0.00000000000000000000
chr12,11465028,11494324,29296,1,0,,0,0.00000000000000000000
chr12,147109,176356,29247,1,0,440073,1,3.41915410127534000000
chr12,8555999,8580445,24446,1,0,,0,0.00000000000000000000
chr12,8340851,8361212,20361,1,0,,0,0.00000000000000000000
chr12,11509295,11536259,26964,1,0,,0,0.00000000000000000000
chr12,779349,796512,17163,1,0,,0,0.00000000000000000000
chr12,29205357,29226777,21420,1,0,,0,0.00000000000000000000
chr12,11218663,11235949,17286,1,0,5554;106707243,2,11.57005669327780000000
chr12,2242855,2257682,14827,1,0,775,1,6.74445268766440000000
chr12,22571269,22586585,15316,1,0,,0,0.00000000000000000000
chr12,31286958,31305534,18576,1,0,,0,0.00000000000000000000
chr12,11200283,11213636,13353,1,0,5554;106707243,2,14.97790758631020000000
chr12,9641620,9658033,16413,1,0,,0,0.00000000000000000000
chr12,34385776,34399675,13899,1,0,,0,0.00000000000000000000
chr12,34699009,34712384,13375,1,0,,0,0.00000000000000000000
chr12,33384647,33395426,10779,1,0,,0,0.00000000000000000000
chr12,10573722,10583904,10182,1,0,3822,1,9.82125319190729000000
chr12,34243427,34257481,14054,1,0,,0,0.00000000000000000000
chr12,6687824,6699423,11599,1,0,1108,1,8.62143288214501000000
chr12,33293907,33308022,14115,1,0,,0,0.00000000000000000000
chr12,14634100,14647438,13338,1,0,55729,1,7.49737591842855000000
chr12,9549134,9561794,12660,1,0,,0,0.00000000000000000000
chr12,10587805,10600415,12610,1,0,3821;3822,2,15.86042823156230000000
chr12,866597,874906,8309,1,0,65125,1,12.03514261644000000000
chr12,8371086,8379457,8371,1,0,55138,1,11.94600406164140000000
chr12,34099290,34109875,10585,1,0,,0,0.00000000000000000000
chr12,8092314,8103253,10939,1,0,,0,0.00000000000000000000
chr12,8363837,8371766,7929,1,0,,0,0.00000000000000000000
chr12,17956419,17965477,9058,1,0,,0,0.00000000000000000000
chr12,34207442,34217122,9680,1,0,,0,0.00000000000000000000
chr12,11230068,11239663,9595,1,0,5554;106707243,2,20.84418968212610000000
chr12,7918028,7924582,6554,1,0,360030,1,15.25785779676530000000
chr12,11241459,11248234,6775,1,0,259289;5554;106707243,3,44.28044280442800000000
chr12,9547010,9555027,8017,1,0,,0,0.00000000000000000000
chr12,147109,154586,7477,1,0,,0,0.00000000000000000000
chr12,6242282,6248094,5812,1,0,,0,0.00000000000000000000
chr12,868378,874490,6112,1,0,65125,1,16.36125654450260000000
chr12,147109,152779,5670,1,0,,0,0.00000000000000000000
chr12,10582117,10586813,4696,1,0,3822,1,21.29471890971040000000
chr12,11161417,11165193,3776,1,0,5554;106707243,2,52.96610169491530000000
chr12,12306629,12310727,4098,1,0,4040,1,24.40214738897020000000
chr12,6037426,6041887,4461,1,0,57101,1,22.41649854292760000000
chr12,17962471,17964746,2275,1,0,,0,0.00000000000000000000
chr12,2161268,2163795,2527,1,0,775,1,39.57261574990110000000
chr12,6037075,6039490,2415,1,0,57101,1,41.40786749482400000000
chr12,30478308,30480640,2332,1,0,,0,0.00000000000000000000
chr12,6645451,6647259,1808,1,0,2597,1,55.30973451327430000000
chr12,33715134,33716902,1768,1,0,,0,0.00000000000000000000
chr12,5221901,5223382,1481,1,0,,0,0.00000000000000000000
chr12,16419765,16420962,1197,1,0,729025,1,83.54218880534670000000
chr12,7955441,7956660,1219,1,0,,0,0.00000000000000000000
chr12,1365623,1366367,744,1,0,23085,1,134.40860215053800000000
chr12,17444812,17445876,1064,1,0,,0,0.00000000000000000000
chr12,16420202,16420918,716,1,0,729025,1,139.66480446927400000000
chr12,37978439,38879361,900922,1,0,144245,1,0.11099740044088200000
chr12,37887763,38445048,557285,1,0,,0,0.00000000000000000000
chr12,38360939,38900939,540000,1,0,144245,1,0.18518518518518500000
chr12,84021899,84357713,335814,1,0,,0,0.00000000000000000000
chr12,37875132,38258635,383503,1,0,,0,0.00000000000000000000
chr12,59735816,60002188,266372,1,0,9194,1,0.37541483339089700000
chr12,37857751,38044379,186628,1,0,,0,0.00000000000000000000
chr12,84470123,84711338,241215,1,0,,0,0.00000000000000000000
chr12,63938556,64127916,189360,1,0,283417,1,0.52809463455851300000
chr12,37995989,38158452,162463,1,0,,0,0.00000000000000000000
chr12,50681760,50846217,164457,1,0,113251;121006,2,1.21612336355400000000
chr12,38087801,38272000,184199,1,0,,0,0.00000000000000000000
chr12,38808282,38929909,121627,1,0,,0,0.00000000000000000000
chr12,63802742,63922155,119413,1,0,,0,0.00000000000000000000
chr12,59657908,59796662,138754,1,0,,0,0.00000000000000000000
chr12,47947259,48056875,109616,1,0,79657,1,0.91227558020726900000
chr12,37990887,38100942,110055,1,0,,0,0.00000000000000000000
chr12,63989296,64093960,104664,1,0,283417,1,0.95543835511732800000
chr12,95545812,95664919,119107,1,0,55591;55785,2,1.67916243377803000000
chr12,63980496,64066824,86328,1,0,283417,1,1.15837271800575000000
chr12,37869694,37953602,83908,1,0,,0,0.00000000000000000000
chr12,38416366,38490132,73766,1,0,,0,0.00000000000000000000
chr12,52682860,52783207,100347,1,0,3891;3887;3890;3889;3892,5,4.98270999631279000000
chr12,63837221,63924875,87654,1,0,,0,0.00000000000000000000
chr12,59558384,59644822,86438,1,0,,0,0.00000000000000000000
chr12,64069015,64136517,67502,1,0,,0,0.00000000000000000000
chr12,52201114,52282359,81245,1,0,6334;341405;401720,3,3.69253492522617000000
chr12,70852401,70927327,74926,1,0,5787,1,1.33465018818568000000
chr12,48703519,48763663,60144,1,0,341567;121274,2,3.32535248736366000000
chr12,38043013,38108044,65031,1,0,,0,0.00000000000000000000
chr12,52502658,52570232,67574,1,0,144501,1,1.47985911741202000000
chr12,67334438,67397584,63146,1,0,,0,0.00000000000000000000
chr12,54472846,54522040,49194,1,0,,0,0.00000000000000000000
chr12,52842315,52891054,48739,1,0,3854;3853;286887,3,6.15523502739080000000
chr12,42011430,42066515,55085,1,0,,0,0.00000000000000000000
chr12,57333296,57382223,48927,1,0,8608,1,2.04386126269749000000
chr12,61788038,61830374,42336,1,0,,0,0.00000000000000000000
chr12,41780697,41821115,40418,1,0,29951,1,2.47414518283933000000
chr12,38076681,38108047,31366,1,0,,0,0.00000000000000000000
chr12,61425722,61450733,25011,1,0,,0,0.00000000000000000000
chr12,92508231,92536572,28341,1,0,694,1,3.52845700575139000000
chr12,37990522,38017190,26668,1,0,,0,0.00000000000000000000
chr12,38019801,38050000,30199,1,0,,0,0.00000000000000000000
chr12,49675423,49691973,16550,1,0,5630,1,6.04229607250755000000
chr12,84578989,84595604,16615,1,0,,0,0.00000000000000000000
chr12,92304176,92327459,23283,1,0,,0,0.00000000000000000000
chr12,58487925,58507516,19591,1,0,,0,0.00000000000000000000
chr12,61402852,61425433,22581,1,0,,0,0.00000000000000000000
chr12,59925488,59945796,20308,1,0,,0,0.00000000000000000000
chr12,50767280,50784684,17404,1,0,121006,1,5.74580556193978000000
chr12,40873785,40884668,10883,1,0,283463,1,9.18864283745291000000
chr12,58718288,58734179,15891,1,0,,0,0.00000000000000000000
chr12,61602046,61617652,15606,1,0,,0,0.00000000000000000000
chr12,71497481,71511742,14261,1,0,,0,0.00000000000000000000
chr12,70509663,70519973,10310,1,0,,0,0.00000000000000000000
chr12,80151448,80163545,12097,1,0,,0,0.00000000000000000000
chr12,45902581,45910961,8380,1,0,,0,0.00000000000000000000
chr12,37858073,37869301,11228,1,0,,0,0.00000000000000000000
chr12,38010182,38017089,6907,1,0,,0,0.00000000000000000000
chr12,40876040,40884379,8339,1,0,283463,1,11.99184554502940000000
chr12,80155300,80162700,7400,1,0,,0,0.00000000000000000000
chr12,93343432,93349666,6234,1,0,,0,0.00000000000000000000
chr12,70872376,70878185,5809,1,0,,0,0.00000000000000000000
chr12,40875467,40879068,3601,1,0,283463,1,27.77006387114690000000
chr12,60521910,60525161,3251,1,0,,0,0.00000000000000000000
chr12,55780615,55784310,3695,1,0,,0,0.00000000000000000000
chr12,52213258,52216524,3266,1,0,401720,1,30.61849357011630000000
chr12,58637763,58639736,1973,1,0,,0,0.00000000000000000000
chr12,84593272,84595665,2393,1,0,,0,0.00000000000000000000
chr12,74103499,74105547,2048,1,0,,0,0.00000000000000000000
chr12,96010370,96012237,1867,1,0,,0,0.00000000000000000000
chr12,60521846,60523604,1758,1,0,,0,0.00000000000000000000
chr12,52706707,52708119,1412,1,0,3889,1,70.82152974504250000000
chr12,69255626,69256510,884,1,0,1368,1,113.12217194570100000000
chr12,48334581,48335181,600,1,0,,0,0.00000000000000000000
chr12,107775113,108466619,691506,1,0,121549;11137;121551;11108,4,0.57844762012187900000
chr12,107019233,107367130,347897,1,0,55188;90488;5992,3,0.86232419365501900000
chr12,129164029,129371605,207576,1,0,121260;92293;144423,3,1.44525378656492000000
chr12,112180416,112305617,125201,1,0,8550;217;80724,3,2.39614699563103000000
chr12,123018576,123114816,96240,1,0,9735,1,1.03906899418121000000
chr12,123636406,123733693,97287,1,0,10198;91574,2,2.05577312487794000000
chr12,124113000,124196492,83492,1,0,2967;1967;79867,3,3.59315862597614000000
chr12,129223623,129267588,43965,1,0,,0,0.00000000000000000000
chr12,116685101,116722900,37799,1,0,23389,1,2.64557263419667000000
chr12,123179081,123207272,28191,1,0,338442;8843,2,7.09446277180660000000
chr12,129490912,129512767,21855,1,0,,0,0.00000000000000000000
chr12,111136309,111146499,10190,1,0,,0,0.00000000000000000000
chr12,124495945,124500200,4255,1,0,144348;100533183,2,47.00352526439480000000
chr12,129871411,129874091,2680,1,0,121256,1,37.31343283582090000000
chr12,125024806,125026515,1709,1,0,9612,1,58.51375073142190000000
chr12,108460671,108462101,1430,1,0,,0,0.00000000000000000000
chr12,129872219,129873603,1384,1,0,121256,1,72.25433526011560000000
chr12,124395903,124397052,1149,1,0,196385,1,87.03220191470840000000
chr12,122185202,122186210,1008,1,0,144404,1,99.20634920634920000000
chr12,113011808,113012757,949,1,0,,0,0.00000000000000000000
chr12,114501590,114502418,828,1,0,,0,0.00000000000000000000
chr12,132609928,133198926,588998,1,0,317781;79050;22953;100507055;50614;57666,6,1.01867918057447000000
chr12,130712367,131206952,494585,1,0,9271;23504,2,0.40437942921843600000
chr12,131532327,131845743,313416,1,0,283383,1,0.31906475738315800000
chr12,132339132,132547463,208331,1,0,8408;80324;57634,3,1.44001612818064000000
chr12,130447731,130695994,248263,1,0,11211,1,0.40279864498535800000
chr12,131451518,131661070,209552,1,0,283383,1,0.47720852103535200000
chr12,133620488,133774473,153985,1,0,7637;7556;7699;101060200;10795,5,3.24706951975842000000
chr12,131959313,132109090,149777,1,0,,0,0.00000000000000000000
chr12,131795297,131883367,88070,1,0,,0,0.00000000000000000000
chr12,133686034,133766695,80661,1,0,10795;101060200;7556,3,3.71926953546324000000
chr12,132173949,132246741,72792,1,0,6433,1,1.37377733816903000000
chr12,133717202,133779425,62223,1,0,10795;7556,2,3.21424553621651000000
chr12,131898314,131955524,57210,1,0,,0,0.00000000000000000000
chr12,131686123,131737685,51562,1,0,,0,0.00000000000000000000
chr12,133704960,133737283,32323,1,0,101060200;7556,2,6.18754447297590000000
chr12,133577308,133606560,29252,1,0,7574,1,3.41856967044988000000
chr12,133142521,133174528,32007,1,0,57666,1,3.12431655575343000000
chr12,132100845,132130003,29158,1,0,,0,0.00000000000000000000
chr12,132132822,132154923,22101,1,0,,0,0.00000000000000000000
chr12,133727575,133752113,24538,1,0,7556,1,4.07531176134974000000
chr12,131937015,131952999,15984,1,0,,0,0.00000000000000000000
chr12,131790562,131796991,6429,1,0,,0,0.00000000000000000000
chr12,132132038,132138166,6128,1,0,,0,0.00000000000000000000
chr12,131792739,131795123,2384,1,0,,0,0.00000000000000000000
chr12,130876512,130878411,1899,1,0,,0,0.00000000000000000000
chr12,131794164,131796438,2274,1,0,,0,0.00000000000000000000
chr12,132963965,132965238,1273,1,0,,0,0.00000000000000000000
chr12,132619127,132620886,1759,1,0,,0,0.00000000000000000000
chr12,133049455,133050799,1344,1,0,,0,0.00000000000000000000
chr12,133264695,133265930,1235,1,0,5827,1,80.97165991902830000000
chr12,133305972,133306974,1002,1,0,23141,1,99.80039920159680000000
chr12,132964245,132965025,780,1,0,,0,0.00000000000000000000
chr12,131851420,131851990,570,1,0,,0,0.00000000000000000000
chr13,19106525,19471586,365061,1,0,,0,0.00000000000000000000
chr13,19047085,19271884,224799,1,0,,0,0.00000000000000000000
chr13,19040958,19218200,177242,1,0,,0,0.00000000000000000000
chr13,19143824,19279263,135439,1,0,,0,0.00000000000000000000
chr13,19312812,19389745,76933,1,0,,0,0.00000000000000000000
chr13,19322539,19372438,49899,1,0,,0,0.00000000000000000000
chr13,19149072,19201237,52165,1,0,,0,0.00000000000000000000
chr13,19380917,19423164,42247,1,0,,0,0.00000000000000000000
chr13,19346013,19359803,13790,1,0,,0,0.00000000000000000000
chr13,19174249,19189000,14751,1,0,,0,0.00000000000000000000
chr13,19427912,19441402,13490,1,0,,0,0.00000000000000000000
chr13,19194144,19203692,9548,1,0,,0,0.00000000000000000000
chr13,19454375,19463468,9093,1,0,,0,0.00000000000000000000
chr13,19031254,19032115,861,1,0,,0,0.00000000000000000000
chr13,19646801,19651310,4509,1,0,,0,0.00000000000000000000
chr13,20053898,20562856,508958,1,0,7750;9205;93492;54737;55269,5,0.98239933354029200000
chr13,20181539,20483256,301717,1,0,54737;9205;55269,3,0.99430923680137400000
chr13,20016512,20251009,234497,1,0,54737;93492,2,0.85288937598348800000
chr13,20043809,20134000,90191,1,0,93492,1,1.10875808007451000000
chr13,20230525,20324766,94241,1,0,54737;55269,2,2.12221856729025000000
chr13,20417998,20449244,31246,1,0,9205,1,3.20040965243551000000
chr13,21534913,21541123,6210,1,0,,0,0.00000000000000000000
chr13,21727231,21729991,2760,1,0,221150,1,36.23188405797100000000
chr13,21727911,21729240,1329,1,0,221150,1,75.24454477050410000000
chr13,23095150,23107695,12545,1,0,,0,0.00000000000000000000
chr13,23673007,24951543,1278536,1,0,6445;4285;55504;221178;338872;387911;542767;26278,8,0.62571566228874300000
chr13,23339167,23860036,520869,1,0,6445,1,0.19198685274032400000
chr13,24585765,24955735,369970,1,0,221178;338872,2,0.54058437170581400000
chr13,23483512,23707103,223591,1,0,,0,0.00000000000000000000
chr13,23915264,24062370,147106,1,0,26278,1,0.67978192595815300000
chr13,23351165,23513207,162042,1,0,,0,0.00000000000000000000
chr13,24462070,24597068,134998,1,0,4285;387911;542767;221178,4,2.96300685936088000000
chr13,24932466,25024412,91946,1,0,143,1,1.08759489265438000000
chr13,23398947,23421650,22703,1,0,,0,0.00000000000000000000
chr13,23523016,23540625,17609,1,0,,0,0.00000000000000000000
chr13,25206876,25245338,38462,1,0,,0,0.00000000000000000000
chr13,27048192,27053343,5151,1,0,,0,0.00000000000000000000
chr13,27050129,27052101,1972,1,0,,0,0.00000000000000000000
chr13,28511289,28525280,13991,1,0,,0,0.00000000000000000000
chr13,31725815,31892148,166333,1,0,145173;10808,2,1.20240721925294000000
chr13,34135979,34144788,8809,1,0,90627,1,11.35202633670110000000
chr13,35629563,35634533,4970,1,0,26960,1,20.12072434607650000000
chr13,35668030,35708903,40873,1,0,26960,1,2.44660289188462000000
chr13,36791739,36795481,3742,1,0,100526761,1,26.72367717797970000000
chr13,39057299,39060130,2831,1,0,,0,0.00000000000000000000
chr13,43464872,43859997,395125,1,0,94240;55068;29103,3,0.75925340082252400000
chr13,43543481,43743458,199977,1,0,94240;29103,2,1.00011501322652000000
chr13,43725008,43887109,162101,1,0,55068,1,0.61689934053460500000
chr13,43435449,43500768,65319,1,0,94240,1,1.53094811616834000000
chr13,43474089,43525764,51675,1,0,94240,1,1.93517174649250000000
chr13,43736852,43788564,51712,1,0,55068,1,1.93378712871287000000
chr13,41992845,42018063,25218,1,0,,0,0.00000000000000000000
chr13,41722413,41749634,27221,1,0,,0,0.00000000000000000000
chr13,45948785,45960228,11443,1,0,,0,0.00000000000000000000
chr13,43598669,43608765,10096,1,0,29103,1,9.90491283676704000000
chr13,42237097,42241727,4630,1,0,23078,1,21.59827213822890000000
chr13,43600118,43603084,2966,1,0,29103,1,33.71544167228590000000
chr13,39934312,39935387,1075,1,0,10186,1,93.02325581395350000000
chr13,39934567,39935245,678,1,0,10186,1,147.49262536873200000000
chr13,49533641,49536713,3072,1,0,,0,0.00000000000000000000
chr13,50122844,50188407,65563,1,0,55213,1,1.52525052239830000000
chr13,50513136,50514851,1715,1,0,,0,0.00000000000000000000
chr13,51068985,51074949,5964,1,0,,0,0.00000000000000000000
chr13,51069447,51072410,2963,1,0,,0,0.00000000000000000000
chr13,52348131,52350439,2308,1,0,79758,1,43.32755632582320000000
chr13,52859973,52889836,29863,1,0,,0,0.00000000000000000000
chr13,52910222,52934819,24597,1,0,,0,0.00000000000000000000
chr13,52882466,52902614,20148,1,0,,0,0.00000000000000000000
chr13,52852461,52864624,12163,1,0,,0,0.00000000000000000000
chr13,53071238,53099537,28299,1,0,,0,0.00000000000000000000
chr13,56948541,57006900,58359,1,0,,0,0.00000000000000000000
chr13,57711749,57749551,37802,1,0,729250;729240;729233;122183;729246,5,13.22681339611660000000
chr13,57818193,57849734,31541,1,0,,0,0.00000000000000000000
chr13,57752839,57784899,32060,1,0,,0,0.00000000000000000000
chr13,57793983,57823496,29513,1,0,,0,0.00000000000000000000
chr13,57810291,57822585,12294,1,0,,0,0.00000000000000000000
chr13,57741777,57744082,2305,1,0,729250,1,43.38394793926250000000
chr13,58142353,58194179,51826,1,0,,0,0.00000000000000000000
chr13,61203296,61214540,11244,1,0,,0,0.00000000000000000000
chr13,62422841,62500912,78071,1,0,,0,0.00000000000000000000
chr13,62654988,62657577,2589,1,0,,0,0.00000000000000000000
chr13,63601620,63650121,48501,1,0,,0,0.00000000000000000000
chr13,64310929,64402244,91315,1,0,,0,0.00000000000000000000
chr13,64411084,64505239,94155,1,0,,0,0.00000000000000000000
chr13,64329526,64384533,55007,1,0,,0,0.00000000000000000000
chr13,64263819,64320330,56511,1,0,,0,0.00000000000000000000
chr13,64345620,64391138,45518,1,0,,0,0.00000000000000000000
chr13,64194660,64241239,46579,1,0,,0,0.00000000000000000000
chr13,65291116,65314674,23558,1,0,,0,0.00000000000000000000
chr13,65530240,65553029,22789,1,0,,0,0.00000000000000000000
chr13,81615159,81991782,376623,1,0,,0,0.00000000000000000000
chr13,106806394,107241285,434891,1,0,1948;55082,2,0.45988535058210000000
chr13,113017855,113205779,187924,1,0,10426;122258,2,1.06426002000809000000
chr13,67852453,68047995,195542,1,0,,0,0.00000000000000000000
chr13,113186585,113371019,184434,1,0,10426;400165;23250,3,1.62659813266534000000
chr13,114965694,115109840,144146,1,0,8881;283489;65110,3,2.08122320425125000000
chr13,111648524,111768878,120354,1,0,8874,1,0.83088223075261300000
chr13,114427817,114546454,118637,1,0,6011;348013;2621,3,2.52872206815749000000
chr13,95935301,96038456,103155,1,0,10257,1,0.96941495807280300000
chr13,66722560,66801866,79306,1,0,,0,0.00000000000000000000
chr13,106408432,106485283,76851,1,0,,0,0.00000000000000000000
chr13,93273640,93338632,64992,1,0,2262,1,1.53865091088134000000
chr13,115022776,115086420,63644,1,0,8881;283489;65110,3,4.71372006787757000000
chr13,89655533,89726331,70798,1,0,,0,0.00000000000000000000
chr13,111681460,111747796,66336,1,0,,0,0.00000000000000000000
chr13,86606378,86666449,60071,1,0,,0,0.00000000000000000000
chr13,68047598,68094834,47236,1,0,,0,0.00000000000000000000
chr13,70736139,70775411,39272,1,0,,0,0.00000000000000000000
chr13,114506646,114537879,31233,1,0,348013;2621,2,6.40348349502129000000
chr13,67932916,67956566,23650,1,0,,0,0.00000000000000000000
chr13,84160980,84185427,24447,1,0,,0,0.00000000000000000000
chr13,103683850,103702707,18857,1,0,6555,1,5.30307047780665000000
chr13,72458509,72479420,20911,1,0,,0,0.00000000000000000000
chr13,114030876,114046342,15466,1,0,,0,0.00000000000000000000
chr13,113310352,113326595,16243,1,0,400165,1,6.15649818383304000000
chr13,76107429,76121271,13842,1,0,170622,1,7.22438953908395000000
chr13,114919889,114930154,10265,1,0,,0,0.00000000000000000000
chr13,85857620,85867853,10233,1,0,,0,0.00000000000000000000
chr13,92576108,92586232,10124,1,0,2262,1,9.87751876728566000000
chr13,114031443,114037930,6487,1,0,,0,0.00000000000000000000
chr13,72841037,72846916,5879,1,0,,0,0.00000000000000000000
chr13,114032196,114036229,4033,1,0,,0,0.00000000000000000000
chr13,76111121,76115472,4351,1,0,170622,1,22.98322224775910000000
chr13,114031892,114034627,2735,1,0,,0,0.00000000000000000000
chr13,99254423,99257221,2798,1,0,,0,0.00000000000000000000
chr13,114770962,114772925,1963,1,0,22821,1,50.94243504839530000000
chr13,101894178,101896475,2297,1,0,259232,1,43.53504571179800000000
chr13,90862846,90864843,1997,1,0,,0,0.00000000000000000000
chr13,110417317,110419297,1980,1,0,8660,1,50.50505050505050000000
chr13,114218776,114220526,1750,1,0,,0,0.00000000000000000000
chr13,114033291,114034971,1680,1,0,,0,0.00000000000000000000
chr13,110664567,110665604,1037,1,0,,0,0.00000000000000000000
chr13,89421982,89422968,986,1,0,,0,0.00000000000000000000
chr13,72845685,72846886,1201,1,0,,0,0.00000000000000000000
chr13,112868988,112869944,956,1,0,,0,0.00000000000000000000
chr13,113421330,113422267,937,1,0,23250,1,106.72358591248700000000
chr13,114920819,114921830,1011,1,0,,0,0.00000000000000000000
chr13,112669257,112670307,1050,1,0,,0,0.00000000000000000000
chr13,109361779,109362419,640,1,0,23026,1,156.25000000000000000000
chr13,113421186,113421837,651,1,0,23250,1,153.60983102918600000000
chr14,19185702,20396192,1210490,1,0,441669;390429;79317;441670;440153;390431;79334;641455;404785,9,0.74350056588654200000
chr14,19596713,20418095,821382,1,0,441669;390429;79317;441670;390431;79334;641455;79544,8,0.97396826324414200000
chr14,19855507,20416916,561409,1,0,441669;390429;79317;441670;390431;79334;641455;79544,8,1.42498606185508000000
chr14,19002057,19482927,480870,1,0,440153,1,0.20795641233597400000
chr14,20100344,20418818,318474,1,0,441669;390429;390431;79334;79317;79544;441670,7,2.19798162487362000000
chr14,20190229,20426809,236580,1,0,441669;390429;390431;79317;79544;441670,6,2.53613999492772000000
chr14,19000219,19220072,219853,1,0,,0,0.00000000000000000000
chr14,19676917,19864216,187299,1,0,,0,0.00000000000000000000
chr14,19560448,19687197,126749,1,0,404785,1,0.78896085965175300000
chr14,20194197,20319219,125022,1,0,441669;390429;441670,3,2.39957767432932000000
chr14,19347674,19482955,135281,1,0,440153,1,0.73920210524759600000
chr14,19419916,19548084,128168,1,0,,0,0.00000000000000000000
chr14,19194802,19318860,124058,1,0,,0,0.00000000000000000000
chr14,20289690,20420752,131062,1,0,79317;390429;79544;390431,4,3.05199066090858000000
chr14,20335536,20423298,87762,1,0,79317;79544;390431,3,3.41833595405757000000
chr14,20093688,20153430,59742,1,0,,0,0.00000000000000000000
chr14,20198489,20259429,60940,1,0,441669;441670,2,3.28191663931736000000
chr14,19427558,19472919,45361,1,0,,0,0.00000000000000000000
chr14,19000110,19056499,56389,1,0,,0,0.00000000000000000000
chr14,20274328,20327803,53475,1,0,390429,1,1.87003272557270000000
chr14,20372949,20422282,49333,1,0,79317;79544,2,4.05408144649626000000
chr14,20163742,20199573,35831,1,0,79334,1,2.79087940610086000000
chr14,19553374,19586381,33007,1,0,404785,1,3.02966037507195000000
chr14,19441813,19471645,29832,1,0,,0,0.00000000000000000000
chr14,19776344,19799401,23057,1,0,,0,0.00000000000000000000
chr14,19756768,19781470,24702,1,0,,0,0.00000000000000000000
chr14,19818016,19832515,14499,1,0,,0,0.00000000000000000000
chr14,19794439,19806131,11692,1,0,,0,0.00000000000000000000
chr14,19593334,19602774,9440,1,0,,0,0.00000000000000000000
chr14,20085863,20094903,9040,1,0,,0,0.00000000000000000000
chr14,19462329,19469848,7519,1,0,,0,0.00000000000000000000
chr14,20520546,20542579,22033,1,0,122742,1,4.53864657559116000000
chr14,20542722,20556090,13368,1,0,,0,0.00000000000000000000
chr14,20551149,20555141,3992,1,0,,0,0.00000000000000000000
chr14,21351904,21420613,68709,1,0,6037,1,1.45541341017916000000
chr14,21351965,21408910,56945,1,0,6037,1,1.75608042848362000000
chr14,21418111,21426800,8689,1,0,6036,1,11.50880423524000000000
chr14,22049287,22058850,9563,1,0,,0,0.00000000000000000000
chr14,22585264,22961615,376351,1,0,,0,0.00000000000000000000
chr14,22715107,22941034,225927,1,0,,0,0.00000000000000000000
chr14,22572913,22790993,218080,1,0,,0,0.00000000000000000000
chr14,22815005,22960150,145145,1,0,,0,0.00000000000000000000
chr14,22762905,22914189,151284,1,0,,0,0.00000000000000000000
chr14,23127111,23288222,161111,1,0,9056;5018,2,1.24138016646908000000
chr14,22676929,22795424,118495,1,0,,0,0.00000000000000000000
chr14,22840432,22933672,93240,1,0,,0,0.00000000000000000000
chr14,22881340,22949846,68506,1,0,,0,0.00000000000000000000
chr14,22760429,22791710,31281,1,0,,0,0.00000000000000000000
chr14,22419946,22421020,1074,1,0,,0,0.00000000000000000000
chr14,22774811,22775440,629,1,0,,0,0.00000000000000000000
chr14,22881711,22882230,519,1,0,,0,0.00000000000000000000
chr14,24428452,24495306,66854,1,0,728635;10901;317749,3,4.48739043288360000000
chr14,24480187,24515863,35676,1,0,728635,1,2.80300482116829000000
chr14,24480135,24500794,20659,1,0,728635,1,4.84050534875841000000
chr14,24504022,24523670,19648,1,0,728635;90668,2,10.17915309446250000000
chr14,24426300,24439202,12902,1,0,10901;317749,2,15.50147263990080000000
chr14,24488845,24503941,15096,1,0,728635,1,6.62427133015368000000
chr14,24479388,24485152,5764,1,0,728635,1,17.34906315058990000000
chr14,24915232,24997941,82709,1,0,1215,1,1.20905826451777000000
chr14,26283773,26284779,1006,1,0,,0,0.00000000000000000000
chr14,26284257,26284762,505,1,0,,0,0.00000000000000000000
chr14,26841018,26877981,36963,1,0,,0,0.00000000000000000000
chr14,27280621,27330133,49512,1,0,,0,0.00000000000000000000
chr14,28203036,28669895,466859,1,0,,0,0.00000000000000000000
chr14,28211005,28331926,120921,1,0,,0,0.00000000000000000000
chr14,31514759,31678655,163896,1,0,25831;11154,2,1.22028603504661000000
chr14,32034542,32476635,442093,1,0,80224,1,0.22619675045748300000
chr14,35506336,35728306,221970,1,0,9692;283635;55012,3,1.35153399107988000000
chr14,35206214,35274233,68019,1,0,11177,1,1.47017745041827000000
chr14,35724981,35788414,63433,1,0,9692;5687,2,3.15293301593808000000
chr14,39660738,39808953,148215,1,0,4253,1,0.67469554363593400000
chr14,42987183,42993206,6023,1,0,,0,0.00000000000000000000
chr14,43825279,44242723,417444,1,0,,0,0.00000000000000000000
chr14,44820661,44934929,114268,1,0,,0,0.00000000000000000000
chr14,43893148,43949503,56355,1,0,,0,0.00000000000000000000
chr14,46811074,46887994,76920,1,0,,0,0.00000000000000000000
chr14,46832496,46867177,34681,1,0,,0,0.00000000000000000000
chr14,48378499,48410390,31891,1,0,,0,0.00000000000000000000
chr14,48463983,48508300,44317,1,0,,0,0.00000000000000000000
chr14,50104949,50205845,100896,1,0,5427;122773,2,1.98223913732953000000
chr14,50825145,50827079,1934,1,0,8814,1,51.70630816959670000000
chr14,52207143,52242313,35170,1,0,,0,0.00000000000000000000
chr14,55623280,55690988,67708,1,0,9787,1,1.47693034796479000000
chr14,63766003,63862707,96704,1,0,122876;5529,2,2.06816677696889000000
chr14,63592793,63599712,6919,1,0,,0,0.00000000000000000000
chr14,65014709,65020965,6256,1,0,145376,1,15.98465473145780000000
chr14,65015764,65020280,4516,1,0,145376,1,22.14348981399470000000
chr14,65733000,65742386,9386,1,0,,0,0.00000000000000000000
chr14,66287921,67046960,759039,1,0,10243,1,0.13174553613187200000
chr14,68171152,68181334,10182,1,0,145226,1,9.82125319190729000000
chr14,70949267,71013234,63967,1,0,8748,1,1.56330607969734000000
chr14,73994655,74052092,57437,1,0,641371;399671;10965,3,5.22311402057907000000
chr14,74570515,74600852,30337,1,0,91750,1,3.29630484227181000000
chr14,74017837,74047377,29540,1,0,399671;10965,2,6.77048070412999000000
chr14,74001253,74026923,25670,1,0,641371;399671,2,7.79119594857811000000
chr14,74000189,74018230,18041,1,0,641371;399671,2,11.08585998558840000000
chr14,74032724,74050283,17559,1,0,10965,1,5.69508514152287000000
chr14,74011071,74024022,12951,1,0,399671,1,7.72141147401745000000
chr14,74028137,74040600,12463,1,0,10965,1,8.02375030089064000000
chr14,74004835,74011763,6928,1,0,641371;399671,2,28.86836027713630000000
chr14,80106296,80115015,8719,1,0,9369,1,11.46920518408070000000
chr14,82485284,82504114,18830,1,0,,0,0.00000000000000000000
chr14,82499214,82503341,4127,1,0,,0,0.00000000000000000000
chr14,84294406,84350431,56025,1,0,,0,0.00000000000000000000
chr14,85139158,85139656,498,1,0,,0,0.00000000000000000000
chr14,85297097,85302136,5039,1,0,,0,0.00000000000000000000
chr14,86149539,86153474,3935,1,0,,0,0.00000000000000000000
chr14,86283516,86308402,24886,1,0,,0,0.00000000000000000000
chr14,87866747,88202625,335878,1,0,,0,0.00000000000000000000
chr14,88400031,88414591,14560,1,0,2581,1,6.86813186813187000000
chr14,93524702,93526487,1785,1,0,3705,1,56.02240896358540000000
chr14,93712434,93713151,717,1,0,55727,1,139.47001394700100000000
chr14,94316013,94333306,17293,1,0,,0,0.00000000000000000000
chr14,94454261,94455476,1215,1,0,,0,0.00000000000000000000
chr14,94886106,94909287,23181,1,0,256394,1,4.31387774470471000000
chr14,95569857,95754539,184682,1,0,23405;79789,2,1.08294257155543000000
chr14,95789477,96047598,258121,1,0,51218;161176,2,0.77483040899423100000
chr14,96676974,96700003,23029,1,0,624,1,4.34235094880368000000
chr14,100116712,100187288,70576,1,0,84439;10858,2,2.83382452958513000000
chr14,100356526,100418067,61541,1,0,2009,1,1.62493297151492000000
chr14,100069312,100072613,3301,1,0,317762;84439,2,60.58770069675860000000
chr14,100702212,100707566,5354,1,0,7528,1,18.67762420620100000000
chr14,100744034,100744922,888,1,0,7528,1,112.61261261261300000000
chr14,101014790,101169905,155115,1,0,57596,1,0.64468297714598800000
chr14,101152023,101153762,1739,1,0,,0,0.00000000000000000000
chr14,101151982,101153042,1060,1,0,,0,0.00000000000000000000
chr14,101418862,101862621,443759,1,0,,0,0.00000000000000000000
chr14,101524217,101713874,189657,1,0,,0,0.00000000000000000000
chr14,101925811,102026080,100269,1,0,,0,0.00000000000000000000
chr14,101922107,101926958,4851,1,0,,0,0.00000000000000000000
chr14,102026645,102027791,1146,1,0,1735,1,87.26003490401400000000
chr14,102178176,102180104,1928,1,0,,0,0.00000000000000000000
chr14,102267755,102427340,159585,1,0,5527,1,0.62662530939624600000
chr14,102783776,102791427,7651,1,0,55778,1,13.07018690367270000000
chr14,104697299,104889173,191874,1,0,,0,0.00000000000000000000
chr14,104485881,104602445,116564,1,0,374569;122402,2,1.71579561442641000000
chr14,105273954,105274788,834,1,0,,0,0.00000000000000000000
chr14,105447060,105664762,217702,1,0,3714;122616;55038;29933;256281,5,2.29671753130426000000
chr14,105407084,105419680,12596,1,0,113146,1,7.93902826294062000000
chr14,105695764,105707442,11678,1,0,2972,1,8.56311012159616000000
chr14,105410517,105418327,7810,1,0,113146,1,12.80409731113960000000
chr14,105920806,105964886,44080,1,0,1396;9112;283643;1397,4,9.07441016333938000000
chr14,105940033,105950943,10910,1,0,1397,1,9.16590284142988000000
chr14,105769981,105782805,12824,1,0,2972;23241,2,15.59575795383660000000
chr14,105780555,105781571,1016,1,0,2972;23241,2,196.85039370078700000000
chr14,106044263,106876355,832092,1,0,,0,0.00000000000000000000
chr14,106518074,106921300,403226,1,0,,0,0.00000000000000000000
chr14,106870792,107170225,299433,1,0,,0,0.00000000000000000000
chr14,106329806,106732869,403063,1,0,,0,0.00000000000000000000
chr14,106497248,106792864,295616,1,0,,0,0.00000000000000000000
chr14,106741887,106940047,198160,1,0,,0,0.00000000000000000000
chr14,106047975,106322306,274331,1,0,,0,0.00000000000000000000
chr14,106492673,106717069,224396,1,0,,0,0.00000000000000000000
chr14,106022279,106219296,197017,1,0,,0,0.00000000000000000000
chr14,106929714,107139921,210207,1,0,,0,0.00000000000000000000
chr14,107097478,107283545,186067,1,0,,0,0.00000000000000000000
chr14,106646506,106831496,184990,1,0,,0,0.00000000000000000000
chr14,106383011,106563029,180018,1,0,,0,0.00000000000000000000
chr14,106250315,106414437,164122,1,0,,0,0.00000000000000000000
chr14,106862485,107013061,150576,1,0,,0,0.00000000000000000000
chr14,106592610,106749678,157068,1,0,,0,0.00000000000000000000
chr14,106205277,106327080,121803,1,0,,0,0.00000000000000000000
chr14,106780397,106921214,140817,1,0,,0,0.00000000000000000000
chr14,106534818,106665410,130592,1,0,,0,0.00000000000000000000
chr14,106745198,106828944,83746,1,0,,0,0.00000000000000000000
chr14,106350207,106479914,129707,1,0,,0,0.00000000000000000000
chr14,106855287,106943684,88397,1,0,,0,0.00000000000000000000
chr14,106082176,106201805,119629,1,0,,0,0.00000000000000000000
chr14,106673633,106776569,102936,1,0,,0,0.00000000000000000000
chr14,106570938,106637290,66352,1,0,,0,0.00000000000000000000
chr14,106051697,106141464,89767,1,0,,0,0.00000000000000000000
chr14,106484993,106568698,83705,1,0,,0,0.00000000000000000000
chr14,106415411,106489151,73740,1,0,,0,0.00000000000000000000
chr14,106156702,106241909,85207,1,0,,0,0.00000000000000000000
chr14,106876682,106949202,72520,1,0,,0,0.00000000000000000000
chr14,106725259,106787954,62695,1,0,,0,0.00000000000000000000
chr14,106775060,106833409,58349,1,0,,0,0.00000000000000000000
chr14,106530845,106586833,55988,1,0,,0,0.00000000000000000000
chr14,106021206,106083160,61954,1,0,,0,0.00000000000000000000
chr14,106873749,106920482,46733,1,0,,0,0.00000000000000000000
chr14,106675162,106722285,47123,1,0,,0,0.00000000000000000000
chr14,106078912,106123811,44899,1,0,,0,0.00000000000000000000
chr14,106522941,106566436,43495,1,0,,0,0.00000000000000000000
chr14,106191918,106243046,51128,1,0,,0,0.00000000000000000000
chr14,107149914,107187183,37269,1,0,,0,0.00000000000000000000
chr14,106829838,106877015,47177,1,0,,0,0.00000000000000000000
chr14,106899703,106936157,36454,1,0,,0,0.00000000000000000000
chr14,106762174,106800873,38699,1,0,,0,0.00000000000000000000
chr14,106783664,106825769,42105,1,0,,0,0.00000000000000000000
chr14,106342606,106373645,31039,1,0,,0,0.00000000000000000000
chr14,107145110,107179398,34288,1,0,,0,0.00000000000000000000
chr14,107250311,107289542,39231,1,0,,0,0.00000000000000000000
chr14,106918289,106943487,25198,1,0,,0,0.00000000000000000000
chr14,107099517,107130310,30793,1,0,,0,0.00000000000000000000
chr14,106118177,106145774,27597,1,0,,0,0.00000000000000000000
chr14,106067447,106097992,30545,1,0,,0,0.00000000000000000000
chr14,107181459,107213576,32117,1,0,,0,0.00000000000000000000
chr14,106167469,106190928,23459,1,0,,0,0.00000000000000000000
chr14,106855413,106886267,30854,1,0,,0,0.00000000000000000000
chr14,106889680,106916136,26456,1,0,,0,0.00000000000000000000
chr14,106784994,106807217,22223,1,0,,0,0.00000000000000000000
chr14,106854888,106879985,25097,1,0,,0,0.00000000000000000000
chr14,107241684,107269503,27819,1,0,,0,0.00000000000000000000
chr14,106537594,106561966,24372,1,0,,0,0.00000000000000000000
chr14,106826451,106850917,24466,1,0,,0,0.00000000000000000000
chr14,107159207,107182032,22825,1,0,,0,0.00000000000000000000
chr14,106712396,106725735,13339,1,0,,0,0.00000000000000000000
chr14,106080943,106098204,17261,1,0,,0,0.00000000000000000000
chr14,106899758,106916642,16884,1,0,,0,0.00000000000000000000
chr14,106917353,106934733,17380,1,0,,0,0.00000000000000000000
chr14,106922654,106939460,16806,1,0,,0,0.00000000000000000000
chr14,106865970,106880030,14060,1,0,,0,0.00000000000000000000
chr14,107147166,107164532,17366,1,0,,0,0.00000000000000000000
chr14,107082820,107098932,16112,1,0,,0,0.00000000000000000000
chr14,106330648,106345746,15098,1,0,,0,0.00000000000000000000
chr14,106716251,106728729,12478,1,0,,0,0.00000000000000000000
chr14,107274469,107289540,15071,1,0,,0,0.00000000000000000000
chr14,106793896,106806770,12874,1,0,,0,0.00000000000000000000
chr14,106805092,106814699,9607,1,0,,0,0.00000000000000000000
chr14,106865840,106875366,9526,1,0,,0,0.00000000000000000000
chr14,106925542,106934308,8766,1,0,,0,0.00000000000000000000
chr14,106718188,106724847,6659,1,0,,0,0.00000000000000000000
chr14,106355917,106362097,6180,1,0,,0,0.00000000000000000000
chr14,107217438,107222183,4745,1,0,,0,0.00000000000000000000
chr14,107173637,107178347,4710,1,0,,0,0.00000000000000000000
chr14,106874132,106877231,3099,1,0,,0,0.00000000000000000000
chr14,106184195,106185217,1022,1,0,,0,0.00000000000000000000
chr14,107174028,107174896,868,1,0,,0,0.00000000000000000000
chr14,105987053,105987772,719,1,0,,0,0.00000000000000000000
chr15,20228227,22775879,2547652,1,0,283694;727832;100287399;390538;283767;100996331,6,0.23551097245620700000
chr15,20388741,22207639,1818898,1,0,100996331;727832;100287399,3,0.16493503209085900000
chr15,21163454,22488853,1325399,1,0,390538;283694;100996331,3,0.22634693401760500000
chr15,22391445,23356444,964999,1,0,123606;114791;81614;23191;283767,5,0.51813525195362900000
chr15,20276941,20815774,538833,1,0,727832,1,0.18558625770878900000
chr15,20815652,21272415,456763,1,0,100287399,1,0.21893191874122900000
chr15,20193868,20579744,385876,1,0,,0,0.00000000000000000000
chr15,22737799,23202693,464894,1,0,123606;114791;81614;23191;283767,5,1.07551398813493000000
chr15,22288859,22683801,394942,1,0,390538;283694,2,0.50640347190220300000
chr15,23264565,23614796,350231,1,0,,0,0.00000000000000000000
chr15,20488906,20840418,351512,1,0,727832,1,0.28448530917863400000
chr15,20297946,20623721,325775,1,0,,0,0.00000000000000000000
chr15,20579258,20813515,234257,1,0,727832,1,0.42688158731649400000
chr15,22278694,22562758,284064,1,0,390538;283694,2,0.70406668919680100000
chr15,20262299,20531077,268778,1,0,,0,0.00000000000000000000
chr15,20424529,20642092,217563,1,0,,0,0.00000000000000000000
chr15,20011666,20253324,241658,1,0,,0,0.00000000000000000000
chr15,22410175,22630103,219928,1,0,,0,0.00000000000000000000
chr15,22270552,22451838,181286,1,0,390538;283694,2,1.10322915172711000000
chr15,21079851,21214180,134329,1,0,,0,0.00000000000000000000
chr15,20832111,21016704,184593,1,0,,0,0.00000000000000000000
chr15,20403184,20578764,175580,1,0,,0,0.00000000000000000000
chr15,22506819,22677272,170453,1,0,,0,0.00000000000000000000
chr15,22397843,22566480,168637,1,0,,0,0.00000000000000000000
chr15,20567228,20722801,155573,1,0,,0,0.00000000000000000000
chr15,20211401,20339679,128278,1,0,,0,0.00000000000000000000
chr15,21944154,22077813,133659,1,0,100996331,1,0.74817258845270400000
chr15,21143072,21297411,154339,1,0,,0,0.00000000000000000000
chr15,20941203,21104581,163378,1,0,100287399,1,0.61207751349630900000
chr15,22357093,22494328,137235,1,0,390538;283694,2,1.45735417349801000000
chr15,20021679,20146699,125020,1,0,,0,0.00000000000000000000
chr15,20525916,20630424,104508,1,0,,0,0.00000000000000000000
chr15,20166547,20269627,103080,1,0,,0,0.00000000000000000000
chr15,22477901,22584791,106890,1,0,,0,0.00000000000000000000
chr15,22284435,22372945,88510,1,0,390538,1,1.12981584001808000000
chr15,22334358,22420582,86224,1,0,390538;283694,2,2.31953980330302000000
chr15,20485407,20582400,96993,1,0,,0,0.00000000000000000000
chr15,20443205,20518679,75474,1,0,,0,0.00000000000000000000
chr15,23212463,23285245,72782,1,0,,0,0.00000000000000000000
chr15,21078447,21151643,73196,1,0,,0,0.00000000000000000000
chr15,22446740,22506124,59384,1,0,,0,0.00000000000000000000
chr15,20562288,20644378,82090,1,0,,0,0.00000000000000000000
chr15,21313600,21385584,71984,1,0,,0,0.00000000000000000000
chr15,21143743,21214430,70687,1,0,,0,0.00000000000000000000
chr15,20098934,20163668,64734,1,0,,0,0.00000000000000000000
chr15,22008243,22085826,77583,1,0,100996331,1,1.28894216516505000000
chr15,20230627,20279461,48834,1,0,,0,0.00000000000000000000
chr15,23567452,23640728,73276,1,0,,0,0.00000000000000000000
chr15,20712616,20787713,75097,1,0,727832,1,1.33161111628960000000
chr15,22383746,22452236,68490,1,0,283694,1,1.46006716308950000000
chr15,23455801,23514813,59012,1,0,,0,0.00000000000000000000
chr15,20538885,20594572,55687,1,0,,0,0.00000000000000000000
chr15,20391601,20429520,37919,1,0,,0,0.00000000000000000000
chr15,20312722,20370056,57334,1,0,,0,0.00000000000000000000
chr15,20589641,20640319,50678,1,0,,0,0.00000000000000000000
chr15,23090701,23138372,47671,1,0,,0,0.00000000000000000000
chr15,22295237,22338182,42945,1,0,,0,0.00000000000000000000
chr15,22541092,22592074,50982,1,0,,0,0.00000000000000000000
chr15,23619784,23671044,51260,1,0,,0,0.00000000000000000000
chr15,21205217,21255156,49939,1,0,,0,0.00000000000000000000
chr15,22414196,22462881,48685,1,0,,0,0.00000000000000000000
chr15,20444245,20489678,45433,1,0,,0,0.00000000000000000000
chr15,22514833,22542540,27707,1,0,,0,0.00000000000000000000
chr15,21255216,21295518,40302,1,0,,0,0.00000000000000000000
chr15,23182282,23216768,34486,1,0,,0,0.00000000000000000000
chr15,20177616,20217623,40007,1,0,,0,0.00000000000000000000
chr15,20150561,20178663,28102,1,0,,0,0.00000000000000000000
chr15,20545197,20580518,35321,1,0,,0,0.00000000000000000000
chr15,21902636,21929981,27345,1,0,,0,0.00000000000000000000
chr15,20247632,20278178,30546,1,0,,0,0.00000000000000000000
chr15,22262229,22292809,30580,1,0,,0,0.00000000000000000000
chr15,22053963,22083537,29574,1,0,100996331,1,3.38134848177453000000
chr15,20598930,20625789,26859,1,0,,0,0.00000000000000000000
chr15,22343933,22373204,29271,1,0,390538,1,3.41635065423115000000
chr15,23490919,23514606,23687,1,0,,0,0.00000000000000000000
chr15,20603959,20627118,23159,1,0,,0,0.00000000000000000000
chr15,22565057,22590778,25721,1,0,,0,0.00000000000000000000
chr15,20566764,20589874,23110,1,0,,0,0.00000000000000000000
chr15,20585510,20609933,24423,1,0,,0,0.00000000000000000000
chr15,22314648,22338114,23466,1,0,,0,0.00000000000000000000
chr15,21260201,21281690,21489,1,0,,0,0.00000000000000000000
chr15,20329950,20354075,24125,1,0,,0,0.00000000000000000000
chr15,22546426,22568632,22206,1,0,,0,0.00000000000000000000
chr15,20149989,20170818,20829,1,0,,0,0.00000000000000000000
chr15,21205091,21225710,20619,1,0,,0,0.00000000000000000000
chr15,20846717,20867060,20343,1,0,,0,0.00000000000000000000
chr15,20506964,20526100,19136,1,0,,0,0.00000000000000000000
chr15,21145101,21164300,19199,1,0,,0,0.00000000000000000000
chr15,22818518,22833367,14849,1,0,,0,0.00000000000000000000
chr15,22579267,22595061,15794,1,0,,0,0.00000000000000000000
chr15,22679609,22695249,15640,1,0,,0,0.00000000000000000000
chr15,23500338,23514805,14467,1,0,,0,0.00000000000000000000
chr15,23435096,23448423,13327,1,0,,0,0.00000000000000000000
chr15,20564288,20576944,12656,1,0,,0,0.00000000000000000000
chr15,20581466,20590371,8905,1,0,,0,0.00000000000000000000
chr15,22372936,22383193,10257,1,0,283694,1,9.74943940723408000000
chr15,22336671,22344586,7915,1,0,,0,0.00000000000000000000
chr15,22676431,22682811,6380,1,0,,0,0.00000000000000000000
chr15,22006126,22013550,7424,1,0,,0,0.00000000000000000000
chr15,20585653,20589302,3649,1,0,,0,0.00000000000000000000
chr15,20733561,20737057,3496,1,0,,0,0.00000000000000000000
chr15,23671857,23673371,1514,1,0,,0,0.00000000000000000000
chr15,21398166,21398778,612,1,0,,0,0.00000000000000000000
chr15,24359235,24729095,369860,1,0,,0,0.00000000000000000000
chr15,24550362,24762516,212154,1,0,,0,0.00000000000000000000
chr15,24335546,24549828,214282,1,0,,0,0.00000000000000000000
chr15,24100314,24296335,196021,1,0,,0,0.00000000000000000000
chr15,24518061,24663935,145874,1,0,,0,0.00000000000000000000
chr15,24380455,24506377,125922,1,0,,0,0.00000000000000000000
chr15,24451077,24539021,87944,1,0,,0,0.00000000000000000000
chr15,24375740,24437918,62178,1,0,,0,0.00000000000000000000
chr15,24671880,24720652,48772,1,0,,0,0.00000000000000000000
chr15,24595837,24652000,56163,1,0,,0,0.00000000000000000000
chr15,24386365,24436052,49687,1,0,,0,0.00000000000000000000
chr15,24456276,24506504,50228,1,0,,0,0.00000000000000000000
chr15,24724279,24774681,50402,1,0,,0,0.00000000000000000000
chr15,24330064,24379115,49051,1,0,,0,0.00000000000000000000
chr15,24610640,24651054,40414,1,0,,0,0.00000000000000000000
chr15,24686804,24721004,34200,1,0,,0,0.00000000000000000000
chr15,24508224,24545444,37220,1,0,,0,0.00000000000000000000
chr15,24486572,24507338,20766,1,0,,0,0.00000000000000000000
chr15,24486610,24504375,17765,1,0,,0,0.00000000000000000000
chr15,24055373,24068696,13323,1,0,,0,0.00000000000000000000
chr15,24829422,24974397,144975,1,0,23742,1,0.68977409898258300000
chr15,24813416,24823231,9815,1,0,,0,0.00000000000000000000
chr15,25297756,25334988,37232,1,0,,0,0.00000000000000000000
chr15,25416364,25496934,80570,1,0,,0,0.00000000000000000000
chr15,25931275,25932580,1305,1,0,57194,1,76.62835249042150000000
chr15,25931609,25932224,615,1,0,57194,1,162.60162601626000000000
chr15,27402992,27409882,6890,1,0,2567,1,14.51378809869380000000
chr15,30626961,32577203,1950242,1,0,728498;101059918;51621;89832;22909;161725;283710;54893;89839;4308;1139,11,0.56403256621486000000
chr15,33376560,35110885,1734325,1,0,440270;70;256646;23015;79768;161779;57099;9990;6263;254531;1133;342184;55505;56851;51234;57369,16,0.92254911853314700000
chr15,30453455,31002253,548798,1,0,728498;89832;101059918;89839,4,0.72886562997678600000
chr15,32011062,32546527,535465,1,0,161725;1139,2,0.37350713865518800000
chr15,32483980,32854211,370231,1,0,653125;728047,2,0.54020327849369700000
chr15,30488097,30796070,307973,1,0,89832;101059918,2,0.64940757793702700000
chr15,34731023,35034969,303946,1,0,440270,1,0.32900581024260900000
chr15,32068734,32310731,241997,1,0,161725,1,0.41322826316028700000
chr15,31059319,31312746,253427,1,0,4308;22909;54893,3,1.18377284188346000000
chr15,30632342,30878938,246596,1,0,89832;101059918,2,0.81104316371717300000
chr15,34881304,35142566,261262,1,0,57369;70,2,0.76551507681943800000
chr15,30442877,30686467,243590,1,0,89832,1,0.41052588365696500000
chr15,28738424,28945206,206782,1,0,653720,1,0.48360108713524400000
chr15,32445892,32681439,235547,1,0,1139,1,0.42454372163517300000
chr15,30861211,31093746,232535,1,0,728498;89839,2,0.86008557851506200000
chr15,28526643,28686121,159478,1,0,8924,1,0.62704573671603600000
chr15,34672124,34871363,199239,1,0,440270;23015,2,1.00381953332430000000
chr15,30590736,30750445,159709,1,0,89832;101059918,2,1.25227757984835000000
chr15,30605853,30675765,69912,1,0,89832,1,1.43036960750658000000
chr15,31898860,32030940,132080,1,0,161725,1,0.75711689884918200000
chr15,34713785,34817775,103990,1,0,440270,1,0.96163092605058200000
chr15,32488204,32589899,101695,1,0,,0,0.00000000000000000000
chr15,30922371,31004716,82345,1,0,89839,1,1.21440281741454000000
chr15,28917764,28980893,63129,1,0,653720,1,1.58405803988658000000
chr15,28358203,28441700,83497,1,0,8924,1,1.19764781968214000000
chr15,30502289,30586670,84381,1,0,,0,0.00000000000000000000
chr15,32686868,32752045,65177,1,0,653125;728047,2,3.06856713257744000000
chr15,31006223,31084095,77872,1,0,,0,0.00000000000000000000
chr15,34667216,34738585,71369,1,0,23015,1,1.40116857459121000000
chr15,28482867,28548222,65355,1,0,8924,1,1.53010481217963000000
chr15,28658068,28705000,46932,1,0,,0,0.00000000000000000000
chr15,34747352,34796127,48775,1,0,,0,0.00000000000000000000
chr15,30675752,30726820,51068,1,0,89832;101059918,2,3.91634683167541000000
chr15,28911629,28953709,42080,1,0,653720,1,2.37642585551331000000
chr15,34658966,34700709,41743,1,0,254531;23015,2,4.79122248041588000000
chr15,32698247,32739450,41203,1,0,728047,1,2.42700774215470000000
chr15,28527012,28567454,40442,1,0,8924,1,2.47267692003363000000
chr15,32108157,32146643,38486,1,0,161725,1,2.59834745102115000000
chr15,28448292,28485151,36859,1,0,8924,1,2.71304159092759000000
chr15,33284029,33310647,26618,1,0,342184,1,3.75685626267939000000
chr15,32901253,32925084,23831,1,0,9824,1,4.19621501405732000000
chr15,32508864,32525794,16930,1,0,,0,0.00000000000000000000
chr15,34727472,34744090,16618,1,0,,0,0.00000000000000000000
chr15,32504333,32519715,15382,1,0,,0,0.00000000000000000000
chr15,28658389,28670508,12119,1,0,,0,0.00000000000000000000
chr15,28739054,28753556,14502,1,0,,0,0.00000000000000000000
chr15,28701268,28709133,7865,1,0,,0,0.00000000000000000000
chr15,28737463,28743850,6387,1,0,,0,0.00000000000000000000
chr15,28904165,28909737,5572,1,0,,0,0.00000000000000000000
chr15,32504264,32512220,7956,1,0,,0,0.00000000000000000000
chr15,34848294,34853567,5273,1,0,,0,0.00000000000000000000
chr15,34704270,34710395,6125,1,0,,0,0.00000000000000000000
chr15,31617536,31621947,4411,1,0,51621,1,22.67059623668100000000
chr15,29346284,29347823,1539,1,0,321,1,64.97725795971410000000
chr15,39178376,39374405,196029,1,0,,0,0.00000000000000000000
chr15,39372561,39373866,1305,1,0,,0,0.00000000000000000000
chr15,39372596,39373251,655,1,0,,0,0.00000000000000000000
chr15,41594163,41618022,23859,1,0,11339,1,4.19129049834444000000
chr15,41590371,41596538,6167,1,0,,0,0.00000000000000000000
chr15,42097143,42198420,101277,1,0,51332;100137049;23005;8681;100137047;30844,6,5.92434610029918000000
chr15,43174746,43273884,99138,1,0,146057;197131,2,2.01738990094616000000
chr15,43883592,43995778,112186,1,0,117155;1159;548596;161497,4,3.56550728254862000000
chr15,43849432,43915712,66280,1,0,1159;9677;161497,3,4.52625226312613000000
chr15,43948866,44040886,92020,1,0,548596;2923,2,2.17344055640078000000
chr15,43889913,43939094,49181,1,0,117155;1159;161497,3,6.09991663447266000000
chr15,43921157,43945942,24785,1,0,117155,1,4.03469840629413000000
chr15,44137371,44138796,1425,1,0,79968,1,70.17543859649120000000
chr15,45154177,45175380,21203,1,0,,0,0.00000000000000000000
chr15,45129530,45146345,16815,1,0,,0,0.00000000000000000000
chr15,45109436,45118112,8676,1,0,,0,0.00000000000000000000
chr15,45224381,45236351,11970,1,0,,0,0.00000000000000000000
chr15,45318900,45326353,7453,1,0,6652,1,13.41741580571580000000
chr15,45253701,45262461,8760,1,0,145645,1,11.41552511415530000000
chr15,45319486,45323774,4288,1,0,6652,1,23.32089552238810000000
chr15,46860532,46861121,589,1,0,,0,0.00000000000000000000
chr15,47340563,47396476,55913,1,0,,0,0.00000000000000000000
chr15,48609961,48638901,28940,1,0,1854,1,3.45542501727713000000
chr15,50831569,51658828,827259,1,0,388121;84888;54822;373509;23431;342035;1588,7,0.84616788696164100000
chr15,51072875,51086217,13342,1,0,,0,0.00000000000000000000
chr15,52995819,53037539,41720,1,0,,0,0.00000000000000000000
chr15,53522596,53588895,66299,1,0,,0,0.00000000000000000000
chr15,53888879,54328665,439786,1,0,440279;256764,2,0.45476663650048000000
chr15,54490191,54496351,6160,1,0,440279,1,16.23376623376620000000
chr15,56210691,56418184,207493,1,0,4734;64864,2,0.96388793838828300000
chr15,56787587,56801490,13903,1,0,,0,0.00000000000000000000
chr15,57640906,57782210,141304,1,0,84952,1,0.70769404970843000000
chr15,58776328,58777789,1461,1,0,3990,1,68.44626967830250000000
chr15,59927919,59969965,42046,1,0,2958;663,2,4.75669504828045000000
chr15,62600279,62613600,13321,1,0,,0,0.00000000000000000000
chr15,62706129,62707772,1643,1,0,,0,0.00000000000000000000
chr15,69503597,69522651,19054,1,0,26035,1,5.24824183898394000000
chr15,71229947,71436723,206776,1,0,79875;196993;54839,3,1.45084535922931000000
chr15,71881818,71882778,960,1,0,79875,1,104.16666666666700000000
chr15,71881908,71882578,670,1,0,79875,1,149.25373134328400000000
chr15,72386271,72388104,1833,1,0,4649,1,54.55537370430990000000
chr15,72903561,72963910,60349,1,0,55889,1,1.65702828547283000000
chr15,72936171,72963379,27208,1,0,55889,1,3.67538959129668000000
chr15,74342074,74410191,68117,1,0,342096,1,1.46806230456421000000
chr15,74359844,74382966,23122,1,0,342096,1,4.32488539053715000000
chr15,74640593,74659057,18464,1,0,1583,1,5.41594454072790000000
chr15,75548295,75590420,42125,1,0,653643;653641,2,4.74777448071217000000
chr15,76198623,76316410,117787,1,0,145957;26263,2,1.69798025248966000000
chr15,76855406,76897532,42126,1,0,49855,1,2.37383088828752000000
chr15,76884067,76909125,25058,1,0,49855,1,3.99074147976694000000
chr15,76884360,76901040,16680,1,0,49855,1,5.99520383693046000000
chr15,76891462,76902969,11507,1,0,49855,1,8.69036238811158000000
chr15,76884625,76895268,10643,1,0,49855,1,9.39584703561026000000
chr15,76890205,76895096,4891,1,0,49855,1,20.44571662236760000000
chr15,76891728,76895734,4006,1,0,49855,1,24.96255616575140000000
chr15,77276734,77330674,53940,1,0,9051,1,1.85391175380052000000
chr15,77330531,77333101,2570,1,0,,0,0.00000000000000000000
chr15,77330656,77332547,1891,1,0,,0,0.00000000000000000000
chr15,78938846,79002210,63364,1,0,,0,0.00000000000000000000
chr15,79729351,79731981,2630,1,0,23251,1,38.02281368821290000000
chr15,81975503,82074090,98587,1,0,,0,0.00000000000000000000
chr15,81955658,82001228,45570,1,0,,0,0.00000000000000000000
chr15,82645651,83144243,498592,1,0,647042;440295;6218,3,0.60169437134972100000
chr15,83246800,83449302,202502,1,0,64506;123722;8120,3,1.48146684971013000000
chr15,83108933,83267685,158752,1,0,64506,1,0.62991332392662800000
chr15,82931235,83044920,113685,1,0,647042,1,0.87962352113295500000
chr15,82475415,82593837,118422,1,0,283726;79631,2,1.68887537788587000000
chr15,83082419,83192952,110533,1,0,,0,0.00000000000000000000
chr15,82707139,82809962,102823,1,0,440295,1,0.97254505314958700000
chr15,82618608,82690268,71660,1,0,,0,0.00000000000000000000
chr15,82941670,82990547,48877,1,0,,0,0.00000000000000000000
chr15,83118115,83148984,30869,1,0,,0,0.00000000000000000000
chr15,82935155,82963316,28161,1,0,647042,1,3.55101026241966000000
chr15,82742017,82766060,24043,1,0,,0,0.00000000000000000000
chr15,82970766,82991218,20452,1,0,,0,0.00000000000000000000
chr15,82643956,82652979,9023,1,0,,0,0.00000000000000000000
chr15,84813587,85089384,275797,1,0,100505679;643707,2,0.72517104972135300000
chr15,84785983,84984473,198490,1,0,100505679;643707,2,1.00760743614288000000
chr15,85080039,85141988,61949,1,0,,0,0.00000000000000000000
chr15,84842831,84927698,84867,1,0,100505679;643707,2,2.35662860711466000000
chr15,84843989,84902060,58071,1,0,100505679,1,1.72202992888016000000
chr15,85034709,85070990,36281,1,0,,0,0.00000000000000000000
chr15,84949020,84984411,35391,1,0,,0,0.00000000000000000000
chr15,84878297,84902260,23963,1,0,,0,0.00000000000000000000
chr15,84847654,84873966,26312,1,0,100505679,1,3.80054727880815000000
chr15,85768416,86139708,371292,1,0,100133220;11214,2,0.53865959945272200000
chr15,85830983,86009026,178043,1,0,11214,1,0.56166207039872400000
chr15,86081069,86179928,98859,1,0,11214,1,1.01154169069078000000
chr15,85719148,85805412,86264,1,0,100133220,1,1.15923212464064000000
chr15,85734420,85781249,46829,1,0,,0,0.00000000000000000000
chr15,85733318,85750891,17573,1,0,,0,0.00000000000000000000
chr15,86248769,86249138,369,1,0,11214,1,271.00271002710000000000
chr15,86359571,86392299,32728,1,0,,0,0.00000000000000000000
chr15,87671140,87689942,18802,1,0,,0,0.00000000000000000000
chr15,90634971,90791153,156182,1,0,3418;10519;390637;10509,4,2.56111459707265000000
chr15,90842756,90970569,127813,1,0,8826;342132,2,1.56478605462668000000
chr15,91173796,91182157,8361,1,0,64784,1,11.96029183112070000000
chr15,91980742,91988171,7429,1,0,,0,0.00000000000000000000
chr15,91981847,91983405,1558,1,0,,0,0.00000000000000000000
chr15,92674913,92676804,1891,1,0,28232,1,52.88207297726070000000
chr15,92675080,92676540,1460,1,0,28232,1,68.49315068493150000000
chr15,93804858,93822223,17365,1,0,,0,0.00000000000000000000
chr15,94884501,94888944,4443,1,0,55784,1,22.50731487733510000000
chr15,96023989,96057911,33922,1,0,,0,0.00000000000000000000
chr15,98842350,98843844,1494,1,0,,0,0.00000000000000000000
chr15,99188339,99194954,6615,1,0,3480,1,15.11715797430080000000
chr15,99537296,99927801,390505,1,0,145814;123355;64927;23336,4,1.02431466946646000000
chr15,99574748,99575471,723,1,0,,0,0.00000000000000000000
chr15,99574883,99575459,576,1,0,,0,0.00000000000000000000
chr15,100246015,100942167,696152,1,0,4205;145748;204219;170691,4,0.57458715912616800000
chr15,100369172,100598434,229262,1,0,170691,1,0.43618218457485300000
chr15,100851435,101048561,197126,1,0,204219;170691,2,1.01457950752311000000
chr15,101321940,101415818,93878,1,0,,0,0.00000000000000000000
chr15,100416612,100423047,6435,1,0,,0,0.00000000000000000000
chr15,101094539,101098824,4285,1,0,,0,0.00000000000000000000
chr15,101418909,101422073,3164,1,0,220,1,31.60556257901390000000
chr15,100466599,100468734,2135,1,0,,0,0.00000000000000000000
chr15,101259281,101260543,1262,1,0,,0,0.00000000000000000000
chr15,102025198,102319344,294146,1,0,100128108;80213;123283;5046,4,1.35986890863721000000
chr15,101943221,102188271,245050,1,0,80213;5046,2,0.81615996735360100000
chr15,102311423,102462509,151086,1,0,26682;390648;390649,3,1.98562408164886000000
chr15,101732897,101903642,170745,1,0,6627;55829;5046;22856,4,2.34267474889455000000
chr15,102032537,102146715,114178,1,0,,0,0.00000000000000000000
chr15,102438302,102520933,82631,1,0,26682,1,1.21019956190776000000
chr15,102157224,102276335,119111,1,0,80213;123283,2,1.67910604394221000000
chr15,102353133,102446904,93771,1,0,390649,1,1.06642778684241000000
chr15,102216903,102306143,89240,1,0,100128108;123283,2,2.24114746750336000000
chr15,102303492,102386179,82687,1,0,390648;390649,2,2.41875990179835000000
chr15,102387761,102459370,71609,1,0,,0,0.00000000000000000000
chr15,102095601,102160436,64835,1,0,,0,0.00000000000000000000
chr15,101919294,101991196,71902,1,0,5046,1,1.39078189758282000000
chr15,102335756,102396342,60586,1,0,390648;390649,2,3.30109266167101000000
chr15,102461670,102516504,54834,1,0,26682,1,1.82368603421235000000
chr15,102277709,102334263,56554,1,0,100128108,1,1.76822152279238000000
chr15,102438101,102490500,52399,1,0,26682,1,1.90843336704899000000
chr15,102334532,102369834,35302,1,0,390648;390649,2,5.66540139368874000000
chr15,102454535,102486765,32230,1,0,26682,1,3.10269934843314000000
chr15,102495333,102510143,14810,1,0,,0,0.00000000000000000000
chr15,102292120,102305203,13083,1,0,,0,0.00000000000000000000
chr15,101670755,101671294,539,1,0,,0,0.00000000000000000000
chr16,152198,208751,56553,1,0,3050;8131,2,3.53650557883755000000
chr16,60157,69843,9686,1,0,,0,0.00000000000000000000
chr16,203016,213826,10810,1,0,3050,1,9.25069380203515000000
chr16,192277,200590,8313,1,0,,0,0.00000000000000000000
chr16,380854,386043,5189,1,0,8312,1,19.27153594141450000000
chr16,235915,237278,1363,1,0,,0,0.00000000000000000000
chr16,553465,554901,1436,1,0,9727,1,69.63788300835660000000
chr16,213313,213853,540,1,0,,0,0.00000000000000000000
chr16,131670,132210,540,1,0,4350,1,185.18518518518500000000
chr16,730115,732767,2652,1,0,339123;10273,2,75.41478129713420000000
chr16,817351,818088,737,1,0,10232,1,135.68521031207600000000
chr16,896579,897257,678,1,0,,0,0.00000000000000000000
chr16,1002232,1004311,2079,1,0,64788,1,48.10004810004810000000
chr16,1422824,1424153,1329,1,0,64718,1,75.24454477050410000000
chr16,2652944,2741463,88519,1,0,5170;54442,2,2.25940193630746000000
chr16,2700401,2740597,40196,1,0,54442,1,2.48780973231167000000
chr16,2146706,2184244,37538,1,0,5310,1,2.66396717992434000000
chr16,2661421,2699803,38382,1,0,,0,0.00000000000000000000
chr16,2707090,2722504,15414,1,0,,0,0.00000000000000000000
chr16,2171287,2191053,19766,1,0,5310,1,5.05919255286856000000
chr16,2690085,2697366,7281,1,0,,0,0.00000000000000000000
chr16,3213024,3238123,25099,1,0,,0,0.00000000000000000000
chr16,3913201,4217371,304170,1,0,115;1387,2,0.65752704079955300000
chr16,5007959,5357306,349347,1,0,196483;9717;51172;56052;146556,5,1.43124171668856000000
chr16,4406099,4522486,116387,1,0,114990;9093;100529144;79585;57407,5,4.29601244125203000000
chr16,5127432,5210881,83449,1,0,196483;56052,2,2.39667341729679000000
chr16,6656915,6694664,37749,1,0,54715,1,2.64907679673634000000
chr16,5515339,5527560,12221,1,0,,0,0.00000000000000000000
chr16,4163540,4168879,5339,1,0,115,1,18.73009926952610000000
chr16,3928421,3932314,3893,1,0,1387,1,25.68713074749550000000
chr16,4394287,4394872,585,1,0,100529144;51025,2,341.88034188034200000000
chr16,6780434,6784276,3842,1,0,54715,1,26.02811035918790000000
chr16,8895657,8986890,91233,1,0,23589;5373;7874,3,3.28828384466147000000
chr16,8735581,8830022,94441,1,0,18;79091,2,2.11772429347423000000
chr16,9223707,9293101,69394,1,0,,0,0.00000000000000000000
chr16,8867511,8908286,40775,1,0,18;25880;5373,3,7.35744941753525000000
chr16,9250242,9288215,37973,1,0,,0,0.00000000000000000000
chr16,8931773,8943520,11747,1,0,5373,1,8.51281178173151000000
chr16,8823776,8829803,6027,1,0,18,1,16.59200265472040000000
chr16,10318531,10340266,21735,1,0,,0,0.00000000000000000000
chr16,11581529,11639415,57886,1,0,,0,0.00000000000000000000
chr16,12019260,12039059,19799,1,0,,0,0.00000000000000000000
chr16,13294452,13296525,2073,1,0,729993,1,48.23926676314520000000
chr16,13408567,13468845,60278,1,0,,0,0.00000000000000000000
chr16,14882199,16570588,1688389,1,0,100288332;23042;101059938;368;123803;9665;4629;123811;89927;4363;9284;54820;23420;408050;255027;54700,16,0.94764891266171500000
chr16,15519031,16316190,797159,1,0,4363;54820;4629;123811;89927;368;9665,7,0.87811841803203600000
chr16,17582547,18086117,503570,1,0,,0,0.00000000000000000000
chr16,16317104,16760218,443114,1,0,408050;101059938;368,3,0.67702667936467800000
chr16,18787774,19219705,431931,1,0,51760;6210;79905;10229;23049;162073;23204,7,1.62062922087093000000
chr16,14835740,15088961,253221,1,0,642799;23042;23420;9284,4,1.57964781751908000000
chr16,16601276,16810610,209334,1,0,,0,0.00000000000000000000
chr16,18558424,18765452,207028,1,0,283820,1,0.48302645052843100000
chr16,16099092,16267615,168523,1,0,4363;368,2,1.18678162624686000000
chr16,16532425,16712136,179711,1,0,,0,0.00000000000000000000
chr16,15126713,15317017,190304,1,0,23042;54700;123803,3,1.57642508827980000000
chr16,14903870,15074940,171070,1,0,23042;23420;9284,3,1.75366808908634000000
chr16,15530183,15700899,170716,1,0,89927;9665,2,1.17153635277303000000
chr16,16742122,16888507,146385,1,0,,0,0.00000000000000000000
chr16,18660531,18769587,109056,1,0,,0,0.00000000000000000000
chr16,15057864,15194052,136188,1,0,23042;54700;123803,3,2.20283725438365000000
chr16,14989961,15108562,118601,1,0,23042;23420;9284,3,2.52948963330832000000
chr16,16666636,16757924,91288,1,0,,0,0.00000000000000000000
chr16,14778377,14857229,78852,1,0,642799;642778;8399,3,3.80459595190991000000
chr16,16409864,16490705,80841,1,0,101059938,1,1.23699607872243000000
chr16,18607512,18675650,68138,1,0,,0,0.00000000000000000000
chr16,15048633,15125958,77325,1,0,23042,1,1.29324280633689000000
chr16,14980783,15052120,71337,1,0,23420;9284,2,2.80359420777437000000
chr16,18868380,18938732,70352,1,0,23049,1,1.42142369797589000000
chr16,14917663,14982216,64553,1,0,23420,1,1.54911468095983000000
chr16,15976456,16026491,50035,1,0,123811,1,1.99860097931448000000
chr16,16632948,16689329,56381,1,0,,0,0.00000000000000000000
chr16,16674062,16731057,56995,1,0,,0,0.00000000000000000000
chr16,15048573,15086535,37962,1,0,23042,1,2.63421316052895000000
chr16,18292404,18331769,39365,1,0,,0,0.00000000000000000000
chr16,15976420,16005568,29148,1,0,123811,1,3.43076711952793000000
chr16,15221452,15249207,27755,1,0,23042,1,3.60295442262655000000
chr16,18192570,18228038,35468,1,0,,0,0.00000000000000000000
chr16,15080289,15105134,24845,1,0,23042,1,4.02495471925941000000
chr16,16444475,16473255,28780,1,0,101059938,1,3.47463516330785000000
chr16,15454250,15481478,27228,1,0,100288332,1,3.67268987806670000000
chr16,16631918,16651453,19535,1,0,,0,0.00000000000000000000
chr16,14782121,14802556,20435,1,0,8399,1,4.89356496207487000000
chr16,15059633,15076845,17212,1,0,23042,1,5.80990006971880000000
chr16,18427209,18446513,19304,1,0,,0,0.00000000000000000000
chr16,14823244,14841897,18653,1,0,,0,0.00000000000000000000
chr16,15007968,15021864,13896,1,0,,0,0.00000000000000000000
chr16,14987792,15004812,17020,1,0,23420,1,5.87544065804935000000
chr16,15503295,15515884,12589,1,0,255027,1,7.94344268806101000000
chr16,16024888,16036311,11423,1,0,,0,0.00000000000000000000
chr16,16724452,16731116,6664,1,0,,0,0.00000000000000000000
chr16,16456423,16463590,7167,1,0,,0,0.00000000000000000000
chr16,14797018,14802985,5967,1,0,,0,0.00000000000000000000
chr16,16726484,16731111,4627,1,0,,0,0.00000000000000000000
chr16,19744814,19804727,59913,1,0,124152,1,1.66908684258842000000
chr16,20561433,20715029,153596,1,0,348158;116285,2,1.30211724263653000000
chr16,20413075,20505813,92738,1,0,204474;123876;54988,3,3.23491988181759000000
chr16,20530862,20619852,88990,1,0,348158,1,1.12372176649062000000
chr16,20543005,20560695,17690,1,0,348158,1,5.65291124929339000000
chr16,20545359,20554693,9334,1,0,348158,1,10.71352046282410000000
chr16,21146143,21351302,205159,1,0,7783;55567;257629;1428;57146,5,2.43713412523945000000
chr16,21809626,22541284,731658,1,0,730094;440345;100132247;29904;7385;1039;146177;55718;255762,9,1.23008290758797000000
chr16,21474194,21938012,463818,1,0,440345;51108;10261;146183,4,0.86240723732153600000
chr16,22533379,22710217,176838,1,0,100132247,1,0.56548931790678500000
chr16,21593751,21783875,190124,1,0,51108;10261;146183,3,1.57791756958616000000
chr16,21410766,21596579,185813,1,0,23117,1,0.53817547749619200000
chr16,22463176,22580313,117137,1,0,100132247,1,0.85370122164644800000
chr16,22622927,22783522,160595,1,0,,0,0.00000000000000000000
chr16,21512076,21595577,83501,1,0,,0,0.00000000000000000000
chr16,21738941,21808248,69307,1,0,146183,1,1.44285570000144000000
chr16,22648027,22697006,48979,1,0,,0,0.00000000000000000000
chr16,21868292,21945682,77390,1,0,440345,1,1.29215660938106000000
chr16,22709935,22780504,70569,1,0,,0,0.00000000000000000000
chr16,21538372,21587854,49482,1,0,,0,0.00000000000000000000
chr16,22651379,22691525,40146,1,0,,0,0.00000000000000000000
chr16,22512620,22549128,36508,1,0,100132247,1,2.73912567108579000000
chr16,21773129,21807024,33895,1,0,,0,0.00000000000000000000
chr16,21541722,21569418,27696,1,0,,0,0.00000000000000000000
chr16,21572650,21580300,7650,1,0,,0,0.00000000000000000000
chr16,21863852,21868415,4563,1,0,440345,1,21.91540653079110000000
chr16,22545008,22549519,4511,1,0,100132247,1,22.16803369541120000000
chr16,21844859,21849128,4269,1,0,440345,1,23.42468962286250000000
chr16,21412446,21416659,4213,1,0,23117,1,23.73605506764780000000
chr16,23047991,23049477,1486,1,0,,0,0.00000000000000000000
chr16,25340299,25343094,2795,1,0,,0,0.00000000000000000000
chr16,28702902,29040038,337136,1,0,100507607;8663;11273;79874;7284;930;84901;27040;487;83985;25970,11,3.26277822599782000000
chr16,28625847,28813589,187742,1,0,8663;100507607;6817;728734,4,2.13058346028060000000
chr16,29044047,29120030,75983,1,0,,0,0.00000000000000000000
chr16,28604024,28626786,22762,1,0,6817;6799,2,8.78657411475266000000
chr16,29120774,29138901,18127,1,0,,0,0.00000000000000000000
chr16,28609678,28623024,13346,1,0,6817,1,7.49288176232579000000
chr16,28708752,28720744,11992,1,0,8663,1,8.33889259506337000000
chr16,28820662,28832532,11870,1,0,,0,0.00000000000000000000
chr16,28417270,28428998,11728,1,0,,0,0.00000000000000000000
chr16,28614865,28618201,3336,1,0,6817,1,29.97601918465230000000
chr16,29248126,29263330,15204,1,0,,0,0.00000000000000000000
chr16,29399170,29651722,252552,1,0,552900;445329;728888;107282092;79008,5,1.97979030061136000000
chr16,30198958,30257314,58356,1,0,548593;654483;6818;11151;613037,5,8.56809925286174000000
chr16,29321179,29350780,29601,1,0,,0,0.00000000000000000000
chr16,29459925,29487610,27685,1,0,445329;552900;107282092;79008,4,14.44825717897780000000
chr16,30199999,30224691,24692,1,0,548593;11151;654483;6818,4,16.19957881095090000000
chr16,29412682,29430385,17703,1,0,728888,1,5.64876009715867000000
chr16,29429645,29442941,13296,1,0,,0,0.00000000000000000000
chr16,30206685,30217207,10522,1,0,548593;6818,2,19.00779319521000000000
chr16,30200097,30206750,6653,1,0,548593;11151;654483,3,45.09243950097700000000
chr16,29391633,29395697,4064,1,0,728888,1,24.60629921259840000000
chr16,30233188,30237183,3995,1,0,613037,1,25.03128911138920000000
chr16,29493791,29497177,3386,1,0,,0,0.00000000000000000000
chr16,31345002,31417353,72351,1,0,3681;3687,2,2.76430180647123000000
chr16,31399768,31416173,16405,1,0,3681,1,6.09570252971655000000
chr16,32009854,33919042,1909188,1,0,653550;729264;24150;729355,4,0.20951315428339200000
chr16,34252000,35283453,1031453,1,0,,0,0.00000000000000000000
chr16,32745819,33757778,1011959,1,0,653550;729355,2,0.19763646550897800000
chr16,32101343,33055809,954466,1,0,729264;24150,2,0.20954125133844500000
chr16,32961400,33846999,885599,1,0,653550;729355,2,0.22583584669811100000
chr16,32103640,32640108,536468,1,0,729264,1,0.18640440809144300000
chr16,32787243,33418563,631320,1,0,653550;729355,2,0.31679655325350100000
chr16,33337259,33916071,578812,1,0,,0,0.00000000000000000000
chr16,32338471,32784140,445669,1,0,24150,1,0.22438177212236000000
chr16,34277426,34719632,442206,1,0,,0,0.00000000000000000000
chr16,34869395,35283220,413825,1,0,,0,0.00000000000000000000
chr16,32254768,32712013,457245,1,0,729264;24150,2,0.43740226793075900000
chr16,33303169,33631383,328214,1,0,,0,0.00000000000000000000
chr16,32586445,32887827,301382,1,0,24150,1,0.33180481913319300000
chr16,33579718,33985597,405879,1,0,,0,0.00000000000000000000
chr16,32083814,32390009,306195,1,0,729264,1,0.32658926501085900000
chr16,32428865,32682908,254043,1,0,,0,0.00000000000000000000
chr16,33464787,33774929,310142,1,0,,0,0.00000000000000000000
chr16,34451274,34760388,309114,1,0,,0,0.00000000000000000000
chr16,32490437,32747834,257397,1,0,24150,1,0.38850491652971900000
chr16,33295236,33572524,277288,1,0,,0,0.00000000000000000000
chr16,33041995,33290678,248683,1,0,653550;729355,2,0.80423671903588100000
chr16,31965004,32136094,171090,1,0,,0,0.00000000000000000000
chr16,32786013,33006492,220479,1,0,,0,0.00000000000000000000
chr16,33592784,33807673,214889,1,0,,0,0.00000000000000000000
chr16,33309067,33494574,185507,1,0,,0,0.00000000000000000000
chr16,33467883,33620266,152383,1,0,,0,0.00000000000000000000
chr16,32490634,32658347,167713,1,0,,0,0.00000000000000000000
chr16,32860961,33032996,172035,1,0,,0,0.00000000000000000000
chr16,33809984,33971430,161446,1,0,,0,0.00000000000000000000
chr16,32093149,32251868,158719,1,0,,0,0.00000000000000000000
chr16,34851745,34978728,126983,1,0,,0,0.00000000000000000000
chr16,32542424,32656069,113645,1,0,,0,0.00000000000000000000
chr16,33420109,33530513,110404,1,0,,0,0.00000000000000000000
chr16,35149701,35275800,126099,1,0,,0,0.00000000000000000000
chr16,31961680,32083217,121537,1,0,,0,0.00000000000000000000
chr16,33908770,34004355,95585,1,0,,0,0.00000000000000000000
chr16,33706170,33812617,106447,1,0,,0,0.00000000000000000000
chr16,32662861,32782372,119511,1,0,24150,1,0.83674306130816400000
chr16,32354116,32471329,117213,1,0,,0,0.00000000000000000000
chr16,33534692,33621835,87143,1,0,,0,0.00000000000000000000
chr16,34571408,34656098,84690,1,0,,0,0.00000000000000000000
chr16,33411133,33493803,82670,1,0,,0,0.00000000000000000000
chr16,33772221,33846625,74404,1,0,,0,0.00000000000000000000
chr16,33876345,33951116,74771,1,0,,0,0.00000000000000000000
chr16,33123189,33185166,61977,1,0,,0,0.00000000000000000000
chr16,33358230,33429747,71517,1,0,,0,0.00000000000000000000
chr16,33484523,33543761,59238,1,0,,0,0.00000000000000000000
chr16,33588216,33631823,43607,1,0,,0,0.00000000000000000000
chr16,32850168,32899560,49392,1,0,,0,0.00000000000000000000
chr16,33295511,33358951,63440,1,0,,0,0.00000000000000000000
chr16,32593825,32647013,53188,1,0,,0,0.00000000000000000000
chr16,32043931,32081304,37373,1,0,,0,0.00000000000000000000
chr16,32187312,32243428,56116,1,0,,0,0.00000000000000000000
chr16,32708094,32762778,54684,1,0,,0,0.00000000000000000000
chr16,33523792,33571506,47714,1,0,,0,0.00000000000000000000
chr16,35020673,35064501,43828,1,0,,0,0.00000000000000000000
chr16,32831655,32863936,32281,1,0,,0,0.00000000000000000000
chr16,32328770,32370893,42123,1,0,,0,0.00000000000000000000
chr16,32877938,32914199,36261,1,0,,0,0.00000000000000000000
chr16,32254911,32293137,38226,1,0,729264,1,2.61602050960080000000
chr16,33779661,33812083,32422,1,0,,0,0.00000000000000000000
chr16,33864044,33901935,37891,1,0,,0,0.00000000000000000000
chr16,33446097,33480208,34111,1,0,,0,0.00000000000000000000
chr16,34459709,34490238,30529,1,0,,0,0.00000000000000000000
chr16,31962996,31993881,30885,1,0,,0,0.00000000000000000000
chr16,32903515,32927806,24291,1,0,,0,0.00000000000000000000
chr16,34176373,34196484,20111,1,0,,0,0.00000000000000000000
chr16,33948743,33964347,15604,1,0,,0,0.00000000000000000000
chr16,33290287,33309014,18727,1,0,,0,0.00000000000000000000
chr16,32292814,32311097,18283,1,0,,0,0.00000000000000000000
chr16,35243037,35257000,13963,1,0,,0,0.00000000000000000000
chr16,33298701,33309600,10899,1,0,,0,0.00000000000000000000
chr16,32301982,32312169,10187,1,0,,0,0.00000000000000000000
chr16,33957258,33966177,8919,1,0,,0,0.00000000000000000000
chr16,33484574,33490688,6114,1,0,,0,0.00000000000000000000
chr16,33567697,33572489,4792,1,0,,0,0.00000000000000000000
chr16,33486576,33490489,3913,1,0,,0,0.00000000000000000000
chr16,33204980,33208179,3199,1,0,653550,1,31.25976867771180000000
chr16,46465993,46774327,308334,1,0,91807;55737;79801;23594,4,1.29729449233623000000
chr16,46385919,46499342,113423,1,0,,0,0.00000000000000000000
chr16,46442568,46501790,59222,1,0,,0,0.00000000000000000000
chr16,46491567,46500669,9102,1,0,,0,0.00000000000000000000
chr16,48509336,48510912,1576,1,0,,0,0.00000000000000000000
chr16,50462296,50503191,40895,1,0,,0,0.00000000000000000000
chr16,55831873,55864567,32694,1,0,1066,1,3.05866519850737000000
chr16,55745405,55784305,38900,1,0,,0,0.00000000000000000000
chr16,55792880,55826512,33632,1,0,,0,0.00000000000000000000
chr16,55839776,55864892,25116,1,0,1066,1,3.98152572065616000000
chr16,55795257,55814424,19167,1,0,,0,0.00000000000000000000
chr16,55798890,55822423,23533,1,0,,0,0.00000000000000000000
chr16,55788369,55806152,17783,1,0,,0,0.00000000000000000000
chr16,55843101,55847133,4032,1,0,1066,1,24.80158730158730000000
chr16,56658530,56714739,56209,1,0,4496;4495;4493;4494;4490;4499;4489,7,12.45352167802310000000
chr16,56700340,56705084,4744,1,0,4496;4495,2,42.15851602023610000000
chr16,58647061,58650133,3072,1,0,23019,1,32.55208333333330000000
chr16,63292522,63394022,101500,1,0,,0,0.00000000000000000000
chr16,68786671,68795657,8986,1,0,999,1,11.12842198976190000000
chr16,68803402,68825665,22263,1,0,999,1,4.49175762475857000000
chr16,70007373,70248903,241530,1,0,55066;283971,2,0.82805448598517800000
chr16,70035832,70161860,126028,1,0,55066,1,0.79347446599168400000
chr16,70149105,70250079,100974,1,0,55066;283971,2,1.98070790500525000000
chr16,70151214,70204367,53153,1,0,55066,1,1.88136135307509000000
chr16,70009870,70062334,52464,1,0,,0,0.00000000000000000000
chr16,70237579,70281788,44209,1,0,,0,0.00000000000000000000
chr16,70177192,70207947,30755,1,0,55066,1,3.25150382051699000000
chr16,70240543,70260389,19846,1,0,,0,0.00000000000000000000
chr16,69976411,70005305,28894,1,0,348174,1,3.46092614383609000000
chr16,70065934,70088257,22323,1,0,,0,0.00000000000000000000
chr16,70181848,70196734,14886,1,0,55066,1,6.71772134891845000000
chr16,70026855,70034648,7793,1,0,,0,0.00000000000000000000
chr16,70848127,71105161,257034,1,0,54768,1,0.38905358824124400000
chr16,71056854,71206504,149650,1,0,54768,1,0.66822586034079500000
chr16,70977467,70980524,3057,1,0,54768,1,32.71180896303570000000
chr16,71628774,71740287,111513,1,0,91862;23035,2,1.79351286397102000000
chr16,72088515,72116064,27549,1,0,3250;3240,2,7.25979164397982000000
chr16,72090035,72094209,4174,1,0,3240,1,23.95783421178730000000
chr16,74346554,74468820,122266,1,0,440348;497190,2,1.63577773052198000000
chr16,74387937,74459162,71225,1,0,440348;497190,2,2.80800280800281000000
chr16,74360562,74409164,48602,1,0,,0,0.00000000000000000000
chr16,74479010,74522014,43004,1,0,2734,1,2.32536508231792000000
chr16,74393952,74434293,40341,1,0,440348,1,2.47886765325599000000
chr16,74427403,74465268,37865,1,0,497190,1,2.64096130991681000000
chr16,74383453,74407957,24504,1,0,,0,0.00000000000000000000
chr16,75537256,75580281,43025,1,0,23563;79583,2,4.64846019755956000000
chr16,75557749,75578465,20716,1,0,23563;79583,2,9.65437343116432000000
chr16,75429758,75430626,868,1,0,10428,1,115.20737327188900000000
chr16,75934435,76000417,65982,1,0,,0,0.00000000000000000000
chr16,77200731,77228179,27448,1,0,22879,1,3.64325269600700000000
chr16,76539197,76548290,9093,1,0,85445,1,10.99747058176620000000
chr16,76540839,76546270,5431,1,0,85445,1,18.41281531946230000000
chr16,77749604,77754573,4969,1,0,,0,0.00000000000000000000
chr16,77927473,78594768,667295,1,0,51741;57687;10143,3,0.44957627436141400000
chr16,78359749,78384935,25186,1,0,51741,1,3.97045977924244000000
chr16,78370597,78384984,14387,1,0,51741,1,6.95071939945784000000
chr16,78372382,78379662,7280,1,0,51741,1,13.73626373626370000000
chr16,78374669,78382935,8266,1,0,51741,1,12.09774981853380000000
chr16,78372397,78376124,3727,1,0,51741,1,26.83123155352830000000
chr16,79891701,79932109,40408,1,0,,0,0.00000000000000000000
chr16,79256733,79278725,21992,1,0,,0,0.00000000000000000000
chr16,81837672,81841805,4133,1,0,5336,1,24.19549963706750000000
chr16,83144145,83191556,47411,1,0,1012,1,2.10921516103858000000
chr16,84472353,84588869,116516,1,0,9914;57707,2,1.71650245459851000000
chr16,84823953,84930111,106158,1,0,83716,1,0.94199212494583500000
chr16,85302468,85304543,2075,1,0,,0,0.00000000000000000000
chr16,85437757,85448129,10372,1,0,,0,0.00000000000000000000
chr16,86273615,86292293,18678,1,0,,0,0.00000000000000000000
chr16,87510068,87534785,24717,1,0,23174,1,4.04579843832180000000
chr16,87546778,87562359,15581,1,0,,0,0.00000000000000000000
chr16,87889860,87950666,60806,1,0,8140;763,2,3.28914909712857000000
chr16,88121907,88171983,50076,1,0,,0,0.00000000000000000000
chr16,88613242,88618965,5723,1,0,,0,0.00000000000000000000
chr16,88599886,88601538,1652,1,0,161882,1,60.53268765133170000000
chr16,88613322,88614315,993,1,0,,0,0.00000000000000000000
chr16,88779303,88958185,178882,1,0,353;863;51693;348180;2588;9780;390748;81620,8,4.47222191165126000000
chr16,90119965,90288630,168665,1,0,11105,1,0.59289123410310400000
chr16,90175087,90263842,88755,1,0,,0,0.00000000000000000000
chr16,90086621,90163679,77058,1,0,11105;2622,2,2.59544758493602000000
chr16,90243133,90281964,38831,1,0,,0,0.00000000000000000000
chr16,90163597,90184829,21232,1,0,,0,0.00000000000000000000
chr16,90146410,90164126,17716,1,0,,0,0.00000000000000000000
chr16,90269351,90294720,25369,1,0,,0,0.00000000000000000000
chr16,90282536,90294720,12184,1,0,,0,0.00000000000000000000
chr16,90282308,90286341,4033,1,0,,0,0.00000000000000000000
chr16,89645439,89647843,2404,1,0,27132,1,41.59733777038270000000
chr16,89918577,89919508,931,1,0,84501,1,107.41138560687400000000
chr16,89973743,89975018,1275,1,0,22980,1,78.43137254901960000000
chr16,89258924,89259509,585,1,0,1013,1,170.94017094017100000000
chr17,160657,715840,555183,1,0,100506388;79850;51031;50628;400566;359845;9501;55178;55275;64359,10,1.80120789001104000000
chr17,816777,1176226,359449,1,0,29;64359;29928;727857,4,1.11281433527427000000
chr17,756249,953937,197688,1,0,29;64359;29928,3,1.51754279470681000000
chr17,402767,568968,166201,1,0,55275,1,0.60168109698497600000
chr17,696070,858356,162286,1,0,64359,1,0.61619609824630600000
chr17,27658,151887,124229,1,0,9501;8447,2,1.60993004853939000000
chr17,185251,280978,95727,1,0,400566;9501,2,2.08927470828502000000
chr17,738167,804925,66758,1,0,64359,1,1.49794781149825000000
chr17,676396,731704,55308,1,0,64359;55178;51031,3,5.42417010197440000000
chr17,26763,67111,40348,1,0,9501;8447,2,4.95687518588282000000
chr17,750,24279,23529,1,0,8447,1,4.25007437630159000000
chr17,955335,959642,4307,1,0,29,1,23.21801718133270000000
chr17,16444,21699,5255,1,0,8447,1,19.02949571836350000000
chr17,1019833,1022886,3053,1,0,29,1,32.75466754012450000000
chr17,103456,107807,4351,1,0,9501,1,22.98322224775910000000
chr17,965356,969066,3710,1,0,29,1,26.95417789757410000000
chr17,164239,167320,3081,1,0,9501,1,32.45699448231090000000
chr17,193910,196609,2699,1,0,9501,1,37.05075954057060000000
chr17,69876,71896,2020,1,0,9501,1,49.50495049504950000000
chr17,412195,413817,1622,1,0,55275,1,61.65228113440200000000
chr17,66805,68323,1518,1,0,9501,1,65.87615283267460000000
chr17,41266,42583,1317,1,0,,0,0.00000000000000000000
chr17,955546,956667,1121,1,0,29,1,89.20606601248880000000
chr17,205517,206535,1018,1,0,,0,0.00000000000000000000
chr17,20625,21790,1165,1,0,8447,1,85.83690987124460000000
chr17,549034,550100,1066,1,0,55275,1,93.80863039399630000000
chr17,195204,196038,834,1,0,9501,1,119.90407673860900000000
chr17,122748,123394,646,1,0,9501,1,154.79876160990700000000
chr17,51239,51734,495,1,0,,0,0.00000000000000000000
chr17,1555423,1617029,61606,1,0,10594;727910,2,3.24643703535370000000
chr17,1642133,1645339,3206,1,0,,0,0.00000000000000000000
chr17,3459881,3547429,87548,1,0,23729;1497;162514;7442,4,4.56892219125508000000
chr17,3182807,3195168,12361,1,0,4994,1,8.08996035919424000000
chr17,3588966,3591199,2233,1,0,5026,1,44.78280340349310000000
chr17,4147401,4386833,239432,1,0,201305;51479;7326,3,1.25296535133148000000
chr17,4312334,4382914,70580,1,0,201305,1,1.41683196372910000000
chr17,4048449,4118726,70277,1,0,51479;124936,2,2.84588129829105000000
chr17,4776051,4845716,69665,1,0,2811;26001;100130311;1145;8402;50488,6,8.61264623555587000000
chr17,6293251,6314029,20778,1,0,,0,0.00000000000000000000
chr17,6296079,6312820,16741,1,0,,0,0.00000000000000000000
chr17,6729507,6748728,19221,1,0,83659,1,5.20264294261485000000
chr17,8655109,8662287,7178,1,0,388333,1,13.93145723042630000000
chr17,13178621,13236242,57621,1,0,,0,0.00000000000000000000
chr17,14668287,15084618,416331,1,0,,0,0.00000000000000000000
chr17,14189920,14191556,1636,1,0,,0,0.00000000000000000000
chr17,14190735,14191443,708,1,0,,0,0.00000000000000000000
chr17,15855134,16097403,242269,1,0,136;125150;9611;54902,4,1.65105729581581000000
chr17,15691074,15794651,103577,1,0,,0,0.00000000000000000000
chr17,15634408,15677211,42803,1,0,353149,1,2.33628483984767000000
chr17,16359216,16456631,97415,1,0,388341;57336,2,2.05307190884361000000
chr17,16660760,16707833,47073,1,0,9720;100129396,2,4.24872007307799000000
chr17,16723577,16756972,33395,1,0,,0,0.00000000000000000000
chr17,16711572,16724682,13110,1,0,,0,0.00000000000000000000
chr17,17348667,17393368,44701,1,0,55090,1,2.23708641864835000000
chr17,17525592,17533785,8193,1,0,,0,0.00000000000000000000
chr17,20271534,20490640,219106,1,0,100996259;284194;256223,3,1.36920029574726000000
chr17,18270825,18481032,210207,1,0,645027;654346;80039,3,1.42716465198590000000
chr17,20436136,20641734,205598,1,0,256223,1,0.48638605433905000000
chr17,18917345,19127717,210372,1,0,79999;388436;400581;125206;10750,5,2.37674215199741000000
chr17,18353719,18475319,121600,1,0,654346;80039,2,1.64473684210526000000
chr17,18585563,18736902,151339,1,0,10517;729288;51030;147166,4,2.64307283647969000000
chr17,18278173,18424843,146670,1,0,645027;654346,2,1.36360537260517000000
chr17,20345614,20462309,116695,1,0,284194,1,0.85693474441921200000
chr17,20106281,20225142,118861,1,0,92521,1,0.84131885143150400000
chr17,19034991,19134246,99255,1,0,388436;400581;79999,3,3.02251775729182000000
chr17,18941024,19006420,65396,1,0,10750,1,1.52914551348706000000
chr17,18361739,18423872,62133,1,0,654346,1,1.60945069447797000000
chr17,20345926,20393059,47133,1,0,284194,1,2.12165574013961000000
chr17,19013030,19053300,40270,1,0,400581,1,2.48323814253787000000
chr17,18929007,18971235,42228,1,0,10750,1,2.36809699725301000000
chr17,18356196,18388707,32511,1,0,654346,1,3.07588200916613000000
chr17,20350700,20375144,24444,1,0,284194,1,4.09098347242677000000
chr17,18531928,18553419,21491,1,0,254272,1,4.65311060443907000000
chr17,20444337,20458174,13837,1,0,,0,0.00000000000000000000
chr17,18359814,18376676,16862,1,0,,0,0.00000000000000000000
chr17,18538923,18549533,10610,1,0,254272,1,9.42507068803016000000
chr17,19004002,19014203,10201,1,0,,0,0.00000000000000000000
chr17,20601811,20610967,9156,1,0,,0,0.00000000000000000000
chr17,20630697,20638401,7704,1,0,,0,0.00000000000000000000
chr17,19655655,19662138,6483,1,0,,0,0.00000000000000000000
chr17,21571276,22200583,629307,1,0,100462977,1,0.15890495417975600000
chr17,21940462,22201855,261393,1,0,100462977,1,0.38256571522573300000
chr17,21364501,21577069,212568,1,0,339263,1,0.47043769523164400000
chr17,21296115,21526819,230704,1,0,339263;3768,2,0.86691171371107600000
chr17,22034027,22242795,208768,1,0,,0,0.00000000000000000000
chr17,21380542,21520130,139588,1,0,339263,1,0.71639395936613500000
chr17,21700386,21825876,125490,1,0,,0,0.00000000000000000000
chr17,21796255,21929290,133035,1,0,,0,0.00000000000000000000
chr17,21347892,21414305,66413,1,0,,0,0.00000000000000000000
chr17,22206459,22262910,56451,1,0,,0,0.00000000000000000000
chr17,21222378,21256022,33644,1,0,,0,0.00000000000000000000
chr17,21524899,21566524,41625,1,0,,0,0.00000000000000000000
chr17,21307046,21352455,45409,1,0,3768,1,2.20220661102425000000
chr17,21703241,21724426,21185,1,0,,0,0.00000000000000000000
chr17,22243959,22262882,18923,1,0,,0,0.00000000000000000000
chr17,22205801,22226507,20706,1,0,,0,0.00000000000000000000
chr17,21551090,21566549,15459,1,0,,0,0.00000000000000000000
chr17,21901054,21916303,15249,1,0,,0,0.00000000000000000000
chr17,21683114,21685523,2409,1,0,,0,0.00000000000000000000
chr17,25267881,25307287,39406,1,0,,0,0.00000000000000000000
chr17,25385897,25420781,34884,1,0,,0,0.00000000000000000000
chr17,25309314,25333813,24499,1,0,,0,0.00000000000000000000
chr17,25411066,25424919,13853,1,0,,0,0.00000000000000000000
chr17,25268349,25274471,6122,1,0,,0,0.00000000000000000000
chr17,25263007,25268349,5342,1,0,,0,0.00000000000000000000
chr17,25739284,25760603,21319,1,0,,0,0.00000000000000000000
chr17,25965227,26074692,109465,1,0,3965,1,0.91353400630338500000
chr17,25957852,26005501,47649,1,0,3965,1,2.09867993032383000000
chr17,26061741,26095948,34207,1,0,4843,1,2.92337825591253000000
chr17,27812516,27816653,4137,1,0,57551,1,24.17210539037950000000
chr17,28874663,29090724,216061,1,0,26083,1,0.46283225570556500000
chr17,28866741,28941492,74751,1,0,26083,1,1.33777474548835000000
chr17,28876882,28905161,28279,1,0,26083,1,3.53619293468652000000
chr17,29548331,29560018,11687,1,0,4763,1,8.55651578677163000000
chr17,29582807,29590116,7309,1,0,4763,1,13.68176221097280000000
chr17,29635401,29649500,14099,1,0,2123;2124;4763,3,21.27810483012980000000
chr17,30416807,30535192,118385,1,0,55288,1,0.84470160915656600000
chr17,30329162,30379684,50522,1,0,114659,1,1.97933573492736000000
chr17,30380596,30412585,31989,1,0,,0,0.00000000000000000000
chr17,30442258,30447138,4880,1,0,,0,0.00000000000000000000
chr17,31959227,32944152,984925,1,0,6355;6347;400591;6356;6346;6354;124842;40;6357,9,0.91377516054521900000
chr17,32063879,32064621,742,1,0,40,1,134.77088948787100000000
chr17,33680531,33765601,85070,1,0,91607;146857;55106,3,3.52650758199130000000
chr17,34684088,36248562,1564474,1,0,26574;9326;6928;3975;79893;729877;31;80179;284098;11072;79154;101060321;79922;11276;11056;6871;284099,17,1.08662719866230000000
chr17,34417399,34819846,402447,1,0,6349;9560;414060;414062;414059;6348;101060321;729877;6351,9,2.23631931658082000000
chr17,36228043,36443070,215027,1,0,729873;101060376,2,0.93011575290544900000
chr17,34426648,34675816,249168,1,0,6349;414062;6351;9560;414060;414059,6,2.40801387015989000000
chr17,35569819,35797963,228144,1,0,284099;6871;31,3,1.31495897328003000000
chr17,34504803,34675816,171013,1,0,414060;6349;9560;414062,4,2.33900346757264000000
chr17,34409128,34544381,135253,1,0,6348;6351;9560;414062;414059,5,3.69677567225866000000
chr17,34827875,34940684,112809,1,0,79893;80179;9326;284098,4,3.54581637989877000000
chr17,36331572,36430370,98798,1,0,729873,1,1.01216623818296000000
chr17,34571308,34666062,94754,1,0,6349;414060,2,2.11072883466661000000
chr17,34401933,34485280,83347,1,0,6348;6351,2,2.39960646453982000000
chr17,34727147,34813684,86537,1,0,729877;101060321,2,2.31115014386910000000
chr17,34485680,34566330,80650,1,0,9560;414062;414059,3,3.71977681339120000000
chr17,34436664,34492771,56107,1,0,,0,0.00000000000000000000
chr17,34816924,34873447,56523,1,0,80179;9326,2,3.53838260531111000000
chr17,34593543,34653460,59917,1,0,6349,1,1.66897541599212000000
chr17,34327925,34384961,57036,1,0,6368;6359,2,3.50655726208009000000
chr17,36339529,36391308,51779,1,0,729873,1,1.93128488383321000000
chr17,34401215,34441578,40363,1,0,6348;6351,2,4.95503307484578000000
chr17,36251429,36291329,39900,1,0,101060376,1,2.50626566416040000000
chr17,34508458,34550170,41712,1,0,9560;414062,2,4.79478327579593000000
chr17,34441241,34477919,36678,1,0,,0,0.00000000000000000000
chr17,34758039,34790173,32134,1,0,,0,0.00000000000000000000
chr17,34610041,34641487,31446,1,0,6349,1,3.18005469694079000000
chr17,36388600,36419333,30733,1,0,,0,0.00000000000000000000
chr17,34594565,34620579,26014,1,0,,0,0.00000000000000000000
chr17,36350126,36375085,24959,1,0,,0,0.00000000000000000000
chr17,34790899,34811405,20506,1,0,101060321,1,4.87662147664098000000
chr17,34502940,34524192,21252,1,0,414062;414059,2,9.41087897609637000000
chr17,34725878,34745384,19506,1,0,,0,0.00000000000000000000
chr17,36332753,36350004,17251,1,0,729873,1,5.79676540490406000000
chr17,36325301,36335769,10468,1,0,,0,0.00000000000000000000
chr17,34406582,34416057,9475,1,0,6348,1,10.55408970976250000000
chr17,34505918,34514685,8767,1,0,,0,0.00000000000000000000
chr17,34808325,34815107,6782,1,0,,0,0.00000000000000000000
chr17,36277659,36282873,5214,1,0,,0,0.00000000000000000000
chr17,34670667,34675816,5149,1,0,,0,0.00000000000000000000
chr17,35755805,35758690,2885,1,0,31,1,34.66204506065860000000
chr17,36279847,36282199,2352,1,0,,0,0.00000000000000000000
chr17,36621619,36688056,66437,1,0,57636;80725,2,3.01037072715505000000
chr17,39237388,39263180,25792,1,0,100132476;728224;100132386,3,11.63151364764270000000
chr17,39210501,39221719,11218,1,0,730755;85294;728279,3,26.74273489035480000000
chr17,39390166,39430973,40807,1,0,81870;85280;100507608;83901,4,9.80223981179699000000
chr17,39420438,39445374,24936,1,0,100507608;100505724,2,8.02053256336221000000
chr17,39423012,39432812,9800,1,0,100505724,1,10.20408163265310000000
chr17,39530466,39544300,13834,1,0,3885,1,7.22856729796154000000
chr17,39531718,39539732,8014,1,0,3885,1,12.47816321437480000000
chr17,39532839,39536612,3773,1,0,3885,1,26.50410813676120000000
chr17,39644850,39743283,98433,1,0,3880;3861;3857;3860;8689;3866,6,6.09551674743226000000
chr17,39689101,39744380,55279,1,0,3861;3857,2,3.61801045605022000000
chr17,39661013,39692381,31368,1,0,3860;3880;3866,3,9.56388676358072000000
chr17,39764744,39787822,23078,1,0,3872;3868,2,8.66626224109542000000
chr17,39734458,39741346,6888,1,0,3861,1,14.51800232288040000000
chr17,40701888,40708438,6550,1,0,3292,1,15.26717557251910000000
chr17,41411555,41760909,349354,1,0,2118;1659;379;4222,4,1.14497043113862000000
chr17,41860623,41871624,11001,1,0,284067,1,9.09008271975275000000
chr17,41436707,41443329,6622,1,0,,0,0.00000000000000000000
chr17,41397300,41401062,3762,1,0,,0,0.00000000000000000000
chr17,41399935,41401162,1227,1,0,,0,0.00000000000000000000
chr17,41517149,41518120,971,1,0,,0,0.00000000000000000000
chr17,43583929,43705315,121386,1,0,104909134,1,0.82381823274512700000
chr17,43656694,43704567,47873,1,0,104909134,1,2.08886010903850000000
chr17,43590526,43650827,60301,1,0,,0,0.00000000000000000000
chr17,43583325,43607752,24427,1,0,,0,0.00000000000000000000
chr17,43649989,43668779,18790,1,0,,0,0.00000000000000000000
chr17,43650980,43662092,11112,1,0,,0,0.00000000000000000000
chr17,43589222,43597741,8519,1,0,,0,0.00000000000000000000
chr17,44221777,44785049,563272,1,0,474170;100506084;51326;4905;9884;284058,6,1.06520473234956000000
chr17,44410218,44786237,376019,1,0,474170;51326;4905;9884;100506084,5,1.32972004074262000000
chr17,44197878,44514183,316305,1,0,100506084;9884;284058,3,0.94845165267700500000
chr17,44348036,44565034,216998,1,0,9884;100506084,2,0.92166748080627500000
chr17,44158811,44372586,213775,1,0,9884;284058,2,0.93556309203601900000
chr17,44579445,44770721,191276,1,0,4905;474170;51326,3,1.56841422865388000000
chr17,44648422,44795710,147288,1,0,4905;51326,2,1.35788387377112000000
chr17,44303785,44433007,129222,1,0,9884;100506084,2,1.54772407175249000000
chr17,44165201,44301900,136699,1,0,284058,1,0.73153424677576300000
chr17,44269219,44367594,98375,1,0,284058,1,1.01651842439644000000
chr17,44215593,44292812,77219,1,0,284058,1,1.29501806550201000000
chr17,44566999,44651848,84849,1,0,474170;51326,2,2.35712854600526000000
chr17,44356168,44425888,69720,1,0,9884;100506084,2,2.86861732644865000000
chr17,44306464,44363991,57527,1,0,,0,0.00000000000000000000
chr17,44165353,44211743,46390,1,0,284058,1,2.15563699073076000000
chr17,44341403,44366497,25094,1,0,,0,0.00000000000000000000
chr17,44230893,44262697,31804,1,0,284058,1,3.14425858382593000000
chr17,44610177,44637704,27527,1,0,474170;51326,2,7.26559378065172000000
chr17,44634620,44657059,22439,1,0,51326,1,4.45652658318107000000
chr17,44225752,44246372,20620,1,0,284058,1,4.84966052376334000000
chr17,44568780,44582653,13873,1,0,,0,0.00000000000000000000
chr17,45130773,45217176,86403,1,0,996,1,1.15736722104557000000
chr17,45089987,45137854,47867,1,0,,0,0.00000000000000000000
chr17,45116474,45134076,17602,1,0,,0,0.00000000000000000000
chr17,45124083,45133581,9498,1,0,,0,0.00000000000000000000
chr17,45212900,45214698,1798,1,0,996,1,55.61735261401560000000
chr17,45590230,45684394,94164,1,0,9520,1,1.06197697633915000000
chr17,45627596,45671109,43513,1,0,9520,1,2.29816376715005000000
chr17,45600707,45632564,31857,1,0,9520,1,3.13902752927143000000
chr17,45551104,45560111,9007,1,0,,0,0.00000000000000000000
chr17,46732109,46783718,51609,1,0,,0,0.00000000000000000000
chr17,47923187,47925248,2061,1,0,255061;729220,2,97.04027171276080000000
chr17,55090294,55092644,2350,1,0,,0,0.00000000000000000000
chr17,55209240,55210011,771,1,0,,0,0.00000000000000000000
chr17,55686686,55690121,3435,1,0,124540,1,29.11208151382820000000
chr17,55687839,55689818,1979,1,0,124540,1,50.53057099545230000000
chr17,57227428,57564425,336997,1,0,284161;348235;388403;55181;55771,5,1.48369273316973000000
chr17,57643319,57749989,106670,1,0,79665;1213,2,1.87494140808100000000
chr17,57247610,57263078,15468,1,0,55771,1,6.46495991724851000000
chr17,57870487,57871036,549,1,0,81671,1,182.14936247723100000000
chr17,58001975,58029464,27489,1,0,6198,1,3.63781876386918000000
chr17,58014404,58020465,6061,1,0,6198,1,16.49892756970800000000
chr17,58081201,58105157,23956,1,0,,0,0.00000000000000000000
chr17,58173668,58203837,30169,1,0,,0,0.00000000000000000000
chr17,58172935,58187476,14541,1,0,,0,0.00000000000000000000
chr17,58173591,58183441,9850,1,0,,0,0.00000000000000000000
chr17,58452135,58459360,7225,1,0,84669,1,13.84083044982700000000
chr17,58410510,58413881,3371,1,0,84669,1,29.66478789676650000000
chr17,60307540,60357096,49556,1,0,,0,0.00000000000000000000
chr17,60331606,60359947,28341,1,0,,0,0.00000000000000000000
chr17,60297885,60312986,15101,1,0,,0,0.00000000000000000000
chr17,60329615,60343753,14138,1,0,,0,0.00000000000000000000
chr17,61938600,62000179,61579,1,0,1443;2689;1442;1444;2688,5,8.11965117978532000000
chr17,62824438,62923957,99519,1,0,374819,1,1.00483324792251000000
chr17,62893308,62929495,36187,1,0,374819,1,2.76342332881974000000
chr17,62851211,62877267,26056,1,0,374819,1,3.83788762665029000000
chr17,62909588,62927675,18087,1,0,374819,1,5.52883286338254000000
chr17,62915636,62926025,10389,1,0,,0,0.00000000000000000000
chr17,62853572,62858036,4464,1,0,374819,1,22.40143369175630000000
chr17,65941104,65990586,49482,1,0,284018;2186,2,4.04187381269957000000
chr17,65976594,65980178,3584,1,0,2186,1,27.90178571428570000000
chr17,66109870,66159159,49289,1,0,,0,0.00000000000000000000
chr17,69207433,69216415,8982,1,0,,0,0.00000000000000000000
chr17,71827288,72699164,871876,1,0,6169;10871;100130520;146722;100131439;350383;55890;342510;124599;124602;64446;388419;94015;146723;11314;326624,16,1.83512334322771000000
chr17,72479549,72664764,185215,1,0,342510;10871;11314;100130520;146723;100131439;124599,7,3.77939151796561000000
chr17,71999544,72099661,100117,1,0,,0,0.00000000000000000000
chr17,75217717,75233568,15851,1,0,,0,0.00000000000000000000
chr17,75248635,75250510,1875,1,0,,0,0.00000000000000000000
chr17,76574840,76591029,16189,1,0,,0,0.00000000000000000000
chr17,77368069,77402019,33950,1,0,146713,1,2.94550810014728000000
chr17,77363249,77388975,25726,1,0,146713,1,3.88711809064759000000
chr17,79455958,79468592,12634,1,0,,0,0.00000000000000000000
chr17,78604777,78614104,9327,1,0,57521,1,10.72156105929020000000
chr17,78461708,78463724,2016,1,0,,0,0.00000000000000000000
chr17,78717525,78718778,1253,1,0,57521,1,79.80845969672790000000
chr17,80227659,80703656,475997,1,0,79701;284004;64122;79415;6398;3607;400629;10966;79672;56270;2837;924;1453;26502,14,2.94119500753156000000
chr17,80233853,80372937,139084,1,0,79701;2837;924;6398;400629,5,3.59494981450059000000
chr17,80934795,81036400,101605,1,0,146712,1,0.98420353329068500000
chr17,80993580,81047367,53787,1,0,146712;284207,2,3.71837060999870000000
chr17,80912947,80970827,57880,1,0,146712,1,1.72771250863856000000
chr17,80317295,80319535,2240,1,0,400629,1,44.64285714285710000000
chr17,80628378,80630390,2012,1,0,10966,1,49.70178926441350000000
chr17,81025945,81026839,894,1,0,,0,0.00000000000000000000
chr18,40689,312564,271875,1,0,9984;9097,2,0.73563218390804600000
chr18,559408,785048,225640,1,0,1068;55556;27098;7298;494514;7525,6,2.65910299592271000000
chr18,11321,161559,150238,1,0,9097,1,0.66561056457088100000
chr18,153985,282924,128939,1,0,9984;9097,2,1.55112107275533000000
chr18,15799,85614,69815,1,0,,0,0.00000000000000000000
chr18,40598,87399,46801,1,0,,0,0.00000000000000000000
chr18,100180,113540,13360,1,0,,0,0.00000000000000000000
chr18,1975585,2070805,95220,1,0,,0,0.00000000000000000000
chr18,2401284,2577777,176493,1,0,10403;64863,2,1.13318941827721000000
chr18,2664884,2735383,70499,1,0,23347,1,1.41845983630973000000
chr18,2183351,2238360,55009,1,0,,0,0.00000000000000000000
chr18,4535511,4536680,1169,1,0,,0,0.00000000000000000000
chr18,5324675,5326377,1702,1,0,,0,0.00000000000000000000
chr18,5324818,5326039,1221,1,0,,0,0.00000000000000000000
chr18,6806810,7409428,602618,1,0,79822;339291;284217,3,0.49782781131662200000
chr18,7465465,7565122,99657,1,0,,0,0.00000000000000000000
chr18,7135036,7145311,10275,1,0,,0,0.00000000000000000000
chr18,7108710,7113772,5062,1,0,284217,1,19.75503753457130000000
chr18,7144026,7146925,2899,1,0,,0,0.00000000000000000000
chr18,9694644,9752026,57382,1,0,11031,1,1.74270677215852000000
chr18,9965601,10103610,138009,1,0,,0,0.00000000000000000000
chr18,9921377,9962385,41008,1,0,9218,1,2.43854857588763000000
chr18,11615205,11644712,29507,1,0,,0,0.00000000000000000000
chr18,11920168,11929180,9012,1,0,,0,0.00000000000000000000
chr18,11635914,11644932,9018,1,0,,0,0.00000000000000000000
chr18,13261891,13263066,1175,1,0,753,1,85.10638297872340000000
chr18,14432553,14565138,132585,1,0,388468,1,0.75423313346155300000
chr18,14261230,14332493,71263,1,0,,0,0.00000000000000000000
chr18,14491541,14512580,21039,1,0,388468,1,4.75307761775750000000
chr18,14284405,14297204,12799,1,0,,0,0.00000000000000000000
chr18,14578164,14590141,11977,1,0,,0,0.00000000000000000000
chr18,14736798,14747444,10646,1,0,,0,0.00000000000000000000
chr18,15075464,15401915,326451,1,0,,0,0.00000000000000000000
chr18,15163004,15381174,218170,1,0,,0,0.00000000000000000000
chr18,15337815,15406325,68510,1,0,,0,0.00000000000000000000
chr18,15380309,15410866,30557,1,0,,0,0.00000000000000000000
chr18,15372439,15381185,8746,1,0,,0,0.00000000000000000000
chr18,15405695,15410866,5171,1,0,,0,0.00000000000000000000
chr18,18529340,18624860,95520,1,0,6093,1,1.04690117252931000000
chr18,23778157,23786885,8728,1,0,,0,0.00000000000000000000
chr18,26573259,26629937,56678,1,0,,0,0.00000000000000000000
chr18,28972223,29051649,79426,1,0,147409;1830,2,2.51806713166973000000
chr18,29358280,29498406,140126,1,0,22878,1,0.71364343519404000000
chr18,29542037,29574010,31973,1,0,,0,0.00000000000000000000
chr18,29650212,29674088,23876,1,0,54941;51444,2,8.37661249790585000000
chr18,29888051,29889353,1302,1,0,64762,1,76.80491551459290000000
chr18,35306075,35306638,563,1,0,,0,0.00000000000000000000
chr18,38259975,38275361,15386,1,0,,0,0.00000000000000000000
chr18,38260077,38267019,6942,1,0,,0,0.00000000000000000000
chr18,39589181,39707525,118344,1,0,5289,1,0.84499425403907200000
chr18,38864358,38868246,3888,1,0,,0,0.00000000000000000000
chr18,63984153,64390003,405850,1,0,28513,1,0.24639645189109300000
chr18,76993586,77351185,357599,1,0,374868;4772,2,0.55928568032908400000
chr18,63821453,64143194,321741,1,0,,0,0.00000000000000000000
chr18,76849912,77088676,238764,1,0,374868,1,0.41882360824915000000
chr18,77685520,77888708,203188,1,0,10907;440498;22850;79863;80148,5,2.46077524263244000000
chr18,75920239,76057763,137524,1,0,,0,0.00000000000000000000
chr18,76180440,76348376,167936,1,0,,0,0.00000000000000000000
chr18,62112216,62269601,157385,1,0,,0,0.00000000000000000000
chr18,61835711,61985805,150094,1,0,,0,0.00000000000000000000
chr18,44495994,44635156,139162,1,0,100506888;83473;162699;84064;9063;728929;51224,7,5.03010879406735000000
chr18,77911671,78012060,100389,1,0,84552,1,0.99612507346422400000
chr18,56019676,56116734,97058,1,0,23327,1,1.03031177234231000000
chr18,44423805,44512218,88413,1,0,9063,1,1.13105538778234000000
chr18,71434828,71503831,69003,1,0,,0,0.00000000000000000000
chr18,77954748,78015057,60309,1,0,84552,1,1.65812731101494000000
chr18,74409065,74473714,64649,1,0,,0,0.00000000000000000000
chr18,48889077,48955184,66107,1,0,,0,0.00000000000000000000
chr18,58258788,58312592,53804,1,0,,0,0.00000000000000000000
chr18,44222828,44264539,41711,1,0,125336;29906,2,4.79489822828510000000
chr18,57652308,57668317,16009,1,0,,0,0.00000000000000000000
chr18,57206667,57227333,20666,1,0,147372,1,4.83886576986354000000
chr18,62174753,62193160,18407,1,0,,0,0.00000000000000000000
chr18,44542290,44558084,15794,1,0,100506888;83473;162699;728929,4,25.32607319235150000000
chr18,44524981,44536817,11836,1,0,83473,1,8.44880027036161000000
chr18,74996366,75010936,14570,1,0,,0,0.00000000000000000000
chr18,57652437,57664980,12543,1,0,,0,0.00000000000000000000
chr18,66200298,66209578,9280,1,0,,0,0.00000000000000000000
chr18,63203644,63211938,8294,1,0,,0,0.00000000000000000000
chr18,63199976,63207125,7149,1,0,,0,0.00000000000000000000
chr18,76290566,76296980,6414,1,0,,0,0.00000000000000000000
chr18,66204250,66209628,5378,1,0,,0,0.00000000000000000000
chr18,63203710,63208516,4806,1,0,,0,0.00000000000000000000
chr18,51205994,51210606,4612,1,0,,0,0.00000000000000000000
chr18,76774117,76777156,3039,1,0,,0,0.00000000000000000000
chr18,76130005,76133302,3297,1,0,,0,0.00000000000000000000
chr18,63766767,63769420,2653,1,0,,0,0.00000000000000000000
chr18,74104901,74106912,2011,1,0,9658,1,49.72650422675290000000
chr18,77378482,77380784,2302,1,0,,0,0.00000000000000000000
chr18,49196844,49198433,1589,1,0,,0,0.00000000000000000000
chr18,70610707,70613103,2396,1,0,,0,0.00000000000000000000
chr18,76196619,76198544,1925,1,0,,0,0.00000000000000000000
chr18,67953689,67955319,1630,1,0,,0,0.00000000000000000000
chr18,77645823,77647082,1259,1,0,26251,1,79.42811755361400000000
chr18,54946736,54948708,1972,1,0,,0,0.00000000000000000000
chr18,64219760,64221203,1443,1,0,28513,1,69.30006930006930000000
chr18,51136445,51137770,1325,1,0,,0,0.00000000000000000000
chr18,77524428,77525562,1134,1,0,,0,0.00000000000000000000
chr18,75267039,75268078,1039,1,0,,0,0.00000000000000000000
chr18,44559080,44560215,1135,1,0,51224;83473,2,176.21145374449300000000
chr18,77645884,77646894,1010,1,0,26251,1,99.00990099009900000000
chr18,76373596,76374429,833,1,0,,0,0.00000000000000000000
chr18,73271757,73272689,932,1,0,,0,0.00000000000000000000
chr18,70610617,70611455,838,1,0,,0,0.00000000000000000000
chr18,75681141,75681850,709,1,0,,0,0.00000000000000000000
chr18,75084880,75085551,671,1,0,,0,0.00000000000000000000
chr18,51435913,51436456,543,1,0,,0,0.00000000000000000000
chr18,73271603,73272152,549,1,0,,0,0.00000000000000000000
chr19,71606,269991,198385,1,0,81099,1,0.50407036822340400000
chr19,60232,147098,86866,1,0,81099,1,1.15119839753183000000
chr19,190701,263942,73241,1,0,,0,0.00000000000000000000
chr19,60070,121692,61622,1,0,81099,1,1.62279705300055000000
chr19,470703,521323,50620,1,0,91978;8174;284451,3,5.92651126037139000000
chr19,123190,171948,48758,1,0,,0,0.00000000000000000000
chr19,252971,289598,36627,1,0,8612,1,2.73022633576323000000
chr19,85830,115340,29510,1,0,81099,1,3.38868180277872000000
chr19,60070,82205,22135,1,0,,0,0.00000000000000000000
chr19,376729,382694,5965,1,0,,0,0.00000000000000000000
chr19,517187,519415,2228,1,0,91978,1,44.88330341113110000000
chr19,380529,382846,2317,1,0,,0,0.00000000000000000000
chr19,376393,377629,1236,1,0,,0,0.00000000000000000000
chr19,496629,497521,892,1,0,8174,1,112.10762331838600000000
chr19,399697,400931,1234,1,0,,0,0.00000000000000000000
chr19,410772,411352,580,1,0,,0,0.00000000000000000000
chr19,563996,565656,1660,1,0,,0,0.00000000000000000000
chr19,572414,582660,10246,1,0,682,1,9.75990630489947000000
chr19,795563,810141,14578,1,0,5725,1,6.85965152970229000000
chr19,877662,879943,2281,1,0,10025,1,43.84042086804030000000
chr19,1255549,1393590,138041,1,0,55009;374291;84939;1153;1943;90007,6,4.34653472519034000000
chr19,1248725,1251923,3198,1,0,90007,1,31.26954346466540000000
chr19,1137277,1138293,1016,1,0,22904,1,98.42519685039370000000
chr19,1049154,1049985,831,1,0,10347,1,120.33694344163700000000
chr19,1049554,1050029,475,1,0,10347,1,210.52631578947400000000
chr19,1627764,1629146,1382,1,0,6929,1,72.35890014471780000000
chr19,1950330,1951594,1264,1,0,1455,1,79.11392405063290000000
chr19,2014069,2015499,1430,1,0,55643,1,69.93006993006990000000
chr19,2909593,2910422,829,1,0,126295,1,120.62726176115800000000
chr19,3789078,3847881,58803,1,0,4145;23217,2,3.40118701426798000000
chr19,4663056,4664031,975,1,0,56005,1,102.56410256410300000000
chr19,5311448,5452077,140629,1,0,5802,1,0.71109088452595100000
chr19,5510246,5510694,448,1,0,,0,0.00000000000000000000
chr19,6888929,7106939,218010,1,0,79230;653656;653657;2015;125997;284428,6,2.75216733177377000000
chr19,6896412,7019812,123400,1,0,2015,1,0.81037277147487900000
chr19,7017900,7107594,89694,1,0,79230;653656;653657;125997;284428,5,5.57450888576716000000
chr19,7019028,7062817,43789,1,0,653656;653657;125997;284428,4,9.13471419762954000000
chr19,7066691,7107653,40962,1,0,79230,1,2.44128704653093000000
chr19,6853075,6886794,33719,1,0,7409,1,2.96568700139387000000
chr19,8336982,8366357,29375,1,0,,0,0.00000000000000000000
chr19,8847108,8902155,55047,1,0,,0,0.00000000000000000000
chr19,8853318,8893049,39731,1,0,,0,0.00000000000000000000
chr19,9285750,9290115,4365,1,0,,0,0.00000000000000000000
chr19,11924434,12086815,162381,1,0,126070;284390;90592;7620;90594,5,3.07917798264575000000
chr19,12503125,12554394,51269,1,0,90576;10224,2,3.90099280266828000000
chr19,12505873,12533259,27386,1,0,90576,1,3.65150076681516000000
chr19,12695030,12699383,4353,1,0,57474,1,22.97266253158740000000
chr19,12695146,12697850,2704,1,0,57474,1,36.98224852071010000000
chr19,13775994,13776805,811,1,0,,0,0.00000000000000000000
chr19,14732117,14733954,1837,1,0,84658,1,54.43658138268920000000
chr19,15045632,15049127,3495,1,0,,0,0.00000000000000000000
chr19,15046789,15049545,2756,1,0,,0,0.00000000000000000000
chr19,15777609,15834802,57193,1,0,66002,1,1.74846572132953000000
chr19,15788968,15818094,29126,1,0,66002,1,3.43335851129575000000
chr19,15800013,15824263,24250,1,0,66002,1,4.12371134020619000000
chr19,15780280,15791634,11354,1,0,66002,1,8.80746873348600000000
chr19,16014063,16022211,8148,1,0,,0,0.00000000000000000000
chr19,17261364,17261930,566,1,0,4650,1,176.67844522968200000000
chr19,17443249,17450279,7030,1,0,84705;57719,2,28.44950213371270000000
chr19,18291729,18311770,20041,1,0,84769;5864,2,9.97954193902500000000
chr19,18763734,18765604,1870,1,0,55295,1,53.47593582887700000000
chr19,19833296,19840183,6887,1,0,7561,1,14.52011035283870000000
chr19,19837996,19839598,1602,1,0,7561,1,62.42197253433210000000
chr19,24061020,24569382,508362,1,0,9534;730087,2,0.39342043661800100000
chr19,24373248,24597870,224622,1,0,,0,0.00000000000000000000
chr19,22133045,22264855,131810,1,0,113835;7757,2,1.51733555875882000000
chr19,20828995,20985056,156061,1,0,199777,1,0.64077508153862900000
chr19,21028885,21126871,97986,1,0,7639,1,1.02055395668769000000
chr19,24008849,24110761,101912,1,0,730087,1,0.98123871575476900000
chr19,24496865,24595705,98840,1,0,,0,0.00000000000000000000
chr19,24055078,24137109,82031,1,0,730087,1,1.21905133425169000000
chr19,22365145,22442903,77758,1,0,163223,1,1.28604130764680000000
chr19,21686607,21725605,38998,1,0,353088,1,2.56423406328530000000
chr19,22411270,22455559,44289,1,0,,0,0.00000000000000000000
chr19,24002839,24043950,41111,1,0,,0,0.00000000000000000000
chr19,23142762,23181942,39180,1,0,388523,1,2.55232261357836000000
chr19,24603093,24631642,28549,1,0,,0,0.00000000000000000000
chr19,23126625,23144017,17392,1,0,,0,0.00000000000000000000
chr19,21749162,21766916,17754,1,0,,0,0.00000000000000000000
chr19,23015991,23031579,15588,1,0,,0,0.00000000000000000000
chr19,21821039,21833813,12774,1,0,,0,0.00000000000000000000
chr19,23925721,23937895,12174,1,0,148213,1,8.21422704123542000000
chr19,21743333,21755156,11823,1,0,,0,0.00000000000000000000
chr19,23826914,23837892,10978,1,0,171392,1,9.10912734560029000000
chr19,21750100,21756537,6437,1,0,,0,0.00000000000000000000
chr19,23374249,23379722,5473,1,0,,0,0.00000000000000000000
chr19,21753481,21757449,3968,1,0,,0,0.00000000000000000000
chr19,22347159,22350805,3646,1,0,,0,0.00000000000000000000
chr19,23140897,23142753,1856,1,0,,0,0.00000000000000000000
chr19,20800896,20802316,1420,1,0,,0,0.00000000000000000000
chr19,22528732,22529730,998,1,0,,0,0.00000000000000000000
chr19,23140871,23141948,1077,1,0,,0,0.00000000000000000000
chr19,20801360,20802057,697,1,0,,0,0.00000000000000000000
chr19,27868914,28728001,859087,1,0,,0,0.00000000000000000000
chr19,27770181,28338822,568641,1,0,,0,0.00000000000000000000
chr19,28246833,28474547,227714,1,0,,0,0.00000000000000000000
chr19,27731801,27950900,219099,1,0,,0,0.00000000000000000000
chr19,27936632,28102901,166269,1,0,,0,0.00000000000000000000
chr19,28215075,28219158,4083,1,0,,0,0.00000000000000000000
chr19,28772964,28776250,3286,1,0,,0,0.00000000000000000000
chr19,30002422,30006065,3643,1,0,,0,0.00000000000000000000
chr19,30003515,30006098,2583,1,0,,0,0.00000000000000000000
chr19,30056800,30058505,1705,1,0,,0,0.00000000000000000000
chr19,31287464,31289363,1899,1,0,,0,0.00000000000000000000
chr19,33211100,33211863,763,1,0,91646,1,131.06159895150700000000
chr19,33473103,33526108,53005,1,0,85415,1,1.88661447033299000000
chr19,34207621,34235326,27705,1,0,64377,1,3.60945677675510000000
chr19,34727530,34730692,3162,1,0,,0,0.00000000000000000000
chr19,34727808,34729856,2048,1,0,,0,0.00000000000000000000
chr19,35699520,35743141,43621,1,0,148109;51599,2,4.58494761697348000000
chr19,35851541,35863290,11749,1,0,,0,0.00000000000000000000
chr19,35855380,35861784,6404,1,0,,0,0.00000000000000000000
chr19,36746508,36806427,59919,1,0,,0,0.00000000000000000000
chr19,36840814,36847752,6938,1,0,57677,1,14.41337561256850000000
chr19,36844089,36845592,1503,1,0,57677,1,66.53359946773120000000
chr19,36925838,36984249,58411,1,0,84924,1,1.71200630018318000000
chr19,37738581,37806604,68023,1,0,,0,0.00000000000000000000
chr19,39280546,39283148,2602,1,0,653499,1,38.43197540353570000000
chr19,40334741,40426528,91787,1,0,8857;2091,2,2.17895780448212000000
chr19,40365900,40410274,44374,1,0,8857,1,2.25357191147970000000
chr19,40386065,40401034,14969,1,0,8857,1,6.68047297748681000000
chr19,41442502,41522514,80012,1,0,1555,1,1.24981252812078000000
chr19,41336256,41389888,53632,1,0,1548;1549,2,3.72911694510740000000
chr19,41360238,41394946,34708,1,0,1549,1,2.88118013138181000000
chr19,41351959,41373440,21481,1,0,1548,1,4.65527675620316000000
chr19,41495414,41525937,30523,1,0,1555,1,3.27621793401697000000
chr19,41361791,41380732,18941,1,0,,0,0.00000000000000000000
chr19,41352219,41360383,8164,1,0,1548,1,12.24889759921610000000
chr19,42186342,42191608,5266,1,0,1087,1,18.98974553740980000000
chr19,43211537,43822191,610654,1,0,5670;440533;5676;5678;5680;5669;5671;5672;5673;5675,10,1.63758855260098000000
chr19,43268818,43648725,379907,1,0,5670;440533;5669;5675;5676;5680,6,1.57933388960983000000
chr19,43473210,43746565,273355,1,0,5672;5670;5673;5680,4,1.46329864096139000000
chr19,43306412,43518370,211958,1,0,5676;5680;5669;5675,4,1.88716632540409000000
chr19,43605688,43772118,166430,1,0,5672;5678;5673,3,1.80255963468125000000
chr19,43466625,43636716,170091,1,0,5670;5680,2,1.17584116737511000000
chr19,43243408,43366388,122980,1,0,440533;5671,2,1.62628069604814000000
chr19,43357531,43499297,141766,1,0,5676;5669;5675,3,2.11616325494124000000
chr19,43576907,43697327,120420,1,0,5672;5670;5673,3,2.49128051818635000000
chr19,43666408,43747719,81311,1,0,5672;5673,2,2.45969180061738000000
chr19,43275410,43356844,81434,1,0,,0,0.00000000000000000000
chr19,43547854,43609588,61734,1,0,5670,1,1.61985291735510000000
chr19,43502974,43547230,44256,1,0,5680,1,2.25958062183659000000
chr19,43369082,43411700,42618,1,0,5669;5675,2,4.69285278520813000000
chr19,43702164,43764093,61929,1,0,5672;5678,2,3.22950475544575000000
chr19,43315264,43370176,54912,1,0,,0,0.00000000000000000000
chr19,43596761,43647997,51236,1,0,,0,0.00000000000000000000
chr19,43654104,43693573,39469,1,0,5673,1,2.53363399123363000000
chr19,43726417,43778262,51845,1,0,5678,1,1.92882630919086000000
chr19,43716604,43762975,46371,1,0,5678,1,2.15652023894244000000
chr19,43448307,43490508,42201,1,0,,0,0.00000000000000000000
chr19,43423930,43451047,27117,1,0,5676,1,3.68772356824132000000
chr19,43765761,43789861,24100,1,0,5678,1,4.14937759336100000000
chr19,43223637,43244069,20432,1,0,5671,1,4.89428347689898000000
chr19,43511809,43530631,18822,1,0,5680,1,5.31293167569865000000
chr19,43671895,43690688,18793,1,0,5673,1,5.32113020805619000000
chr19,43625586,43642184,16598,1,0,,0,0.00000000000000000000
chr19,43757435,43773682,16247,1,0,5678,1,6.15498245829999000000
chr19,43081634,43095102,13468,1,0,1088,1,7.42500742500742000000
chr19,43407768,43421989,14221,1,0,5675,1,7.03185429997890000000
chr19,43428284,43441330,13046,1,0,5676,1,7.66518473095202000000
chr19,43371358,43383871,12513,1,0,5669,1,7.99168864381044000000
chr19,43258385,43269831,11446,1,0,440533,1,8.73667656823344000000
chr19,43858470,43864228,5758,1,0,57126,1,17.36714136853070000000
chr19,44913237,44920761,7524,1,0,,0,0.00000000000000000000
chr19,44956714,44963497,6783,1,0,,0,0.00000000000000000000
chr19,45826405,45907191,80786,1,0,10848;147700;2068,3,3.71351471789667000000
chr19,45848681,45881737,33056,1,0,147700;2068,2,6.05033881897386000000
chr19,48250461,48411104,160643,1,0,29997;6415;284355;1406;6822,5,3.11249167408477000000
chr19,48387697,48467629,79932,1,0,6822,1,1.25106340389331000000
chr19,48412612,48462899,50287,1,0,,0,0.00000000000000000000
chr19,49518848,49559939,41091,1,0,94027;94115;10856;1082;3972;114336;93659;114335,8,19.46898347570030000000
chr19,49632077,49677977,45900,1,0,3270;8541;54795,3,6.53594771241830000000
chr19,50468800,50554336,85536,1,0,25888;51231,2,2.33819678264123000000
chr19,50428000,50482310,54310,1,0,259307;114132;22809;23636;51231,5,9.20640765973117000000
chr19,50589879,50643440,53561,1,0,,0,0.00000000000000000000
chr19,51254643,51267041,12398,1,0,,0,0.00000000000000000000
chr19,51406887,51408001,1114,1,0,,0,0.00000000000000000000
chr19,52134621,52149039,14418,1,0,100049587,1,6.93577472603690000000
chr19,52141215,52148783,7568,1,0,100049587,1,13.21353065539110000000
chr19,52268853,52622736,353883,1,0,80110;284370;2358;2359;79898;284371;90317;59348;9668;84765;65251,11,3.10837197604858000000
chr19,52662982,52703807,40825,1,0,5518;162962,2,4.89895897121862000000
chr19,52983057,53088237,105180,1,0,388558;147660;55762,3,2.85225328009127000000
chr19,53153456,53549805,396349,1,0,7576;90333;100271846;162967;125893;388559;81856;55769;162966;147664;100529240,11,2.77533184138222000000
chr19,53396729,53480830,84101,1,0,125893;388559;100529240,3,3.56713951082627000000
chr19,53199403,53272930,73527,1,0,81856;162966,2,2.72008921892638000000
chr19,53317679,53364132,46453,1,0,7576;90333,2,4.30542699072180000000
chr19,53516029,53558611,42582,1,0,100271846;147664,2,4.69682025268893000000
chr19,53097438,53139998,42560,1,0,55769,1,2.34962406015038000000
chr19,53332614,53369443,36829,1,0,90333,1,2.71525156805778000000
chr19,53520090,53545014,24924,1,0,,0,0.00000000000000000000
chr19,53323747,53352449,28702,1,0,7576;90333,2,6.96815552923141000000
chr19,53329708,53345364,15656,1,0,90333,1,6.38732754215636000000
chr19,53600238,53630081,29843,1,0,90338;55786,2,6.70173910129679000000
chr19,54039205,54205720,166515,1,0,55422;503834,2,1.20109299462511000000
chr19,53931827,54002033,70206,1,0,126017;388561,2,2.84875936529641000000
chr19,53676152,53714729,38577,1,0,79788,1,2.59221816108044000000
chr19,53874359,53904365,30006,1,0,170958;91661,2,6.66533359994668000000
chr19,54555352,54560459,5107,1,0,284415,1,19.58096729978460000000
chr19,54557044,54560240,3196,1,0,284415,1,31.28911138923650000000
chr19,54726574,54842601,116027,1,0,11025;10990;10288,3,2.58560507468089000000
chr19,54725828,54796605,70777,1,0,11025;10990;10288,3,4.23866510307021000000
chr19,55082397,55110301,27904,1,0,11027;11024,2,7.16743119266055000000
chr19,54722167,54752307,30140,1,0,11025,1,3.31785003317850000000
chr19,54724048,54743091,19043,1,0,11025,1,5.25127343380770000000
chr19,54778411,54796032,17621,1,0,10288,1,5.67504681913626000000
chr19,54730665,54743745,13080,1,0,11025,1,7.64525993883792000000
chr19,54723393,54737028,13635,1,0,11025,1,7.33406674000733000000
chr19,54800739,54808447,7708,1,0,,0,0.00000000000000000000
chr19,54739497,54747869,8372,1,0,11025,1,11.94457716196850000000
chr19,54737016,54738405,1389,1,0,11025,1,71.99424046076310000000
chr19,55150037,55176280,26243,1,0,11006,1,3.81053995351141000000
chr19,55246288,55364220,117932,1,0,3811;3805;3812;3809;115653;3802;3804,7,5.93562391886850000000
chr19,55314527,55381084,66557,1,0,3809;3811;3805;3812,4,6.00988626290247000000
chr19,55240247,55301187,60940,1,0,115653;3802;3804,3,4.92287495897604000000
chr19,55294864,55345200,50336,1,0,3809;3811;3802;3805,4,7.94659885568977000000
chr19,55258844,55294933,36089,1,0,3802;3804,2,5.54185485882125000000
chr19,55329252,55360115,30863,1,0,3809;3811,2,6.48025143375563000000
chr19,55266181,55280730,14549,1,0,,0,0.00000000000000000000
chr19,55247202,55257551,10349,1,0,115653;3804,2,19.32553869939120000000
chr19,55282343,55287902,5559,1,0,3802,1,17.98884691491280000000
chr19,55358473,55361191,2718,1,0,3809,1,36.79175864606330000000
chr19,56447371,56805133,357762,1,0,126206;342933;79149;85569;55311;126208;126205,7,1.95660802432902000000
chr19,56349454,56522143,172689,1,0,126206;147945;126204;126205,4,2.31630271760216000000
chr19,56263863,56300865,37002,1,0,204801;342931;729974,3,8.10766985568348000000
chr19,56325808,56358108,32300,1,0,204801;147945,2,6.19195046439629000000
chr19,56268052,56285011,16959,1,0,342931;729974,2,11.79314818090690000000
chr19,56280630,56289562,8932,1,0,729974,1,11.19570085087330000000
chr19,56268028,56274497,6469,1,0,342931,1,15.45833977430820000000
chr19,56223675,56224733,1058,1,0,338321,1,94.51795841209830000000
chr19,56866394,56874377,7983,1,0,79149,1,12.52661906551420000000
chr19,57524599,57614051,89452,1,0,,0,0.00000000000000000000
chr19,57835706,57836480,774,1,0,125919,1,129.19896640826900000000
chr19,57988182,58004764,16582,1,0,400720;79744,2,12.06127125799060000000
chr19,58132436,58157361,24925,1,0,7693;10520,2,8.02407221664995000000
chr19,58291125,58384053,92928,1,0,54807;100293516;79818;84914;730051,5,5.38050964187328000000
chr19,58978365,59097695,119330,1,0,25799;9040;55663;7593;10998;84878;10155;27243,8,6.70409787982905000000
chr2,34673,226909,192236,1,0,642273;26751,2,1.04038785659294000000
chr2,68529,187575,119046,1,0,,0,0.00000000000000000000
chr2,16297,104877,88580,1,0,642273,1,1.12892300745089000000
chr2,117533,186907,69374,1,0,,0,0.00000000000000000000
chr2,250064,298533,48469,1,0,52;26751;285016,3,6.18952320039613000000
chr2,306405,308952,2547,1,0,,0,0.00000000000000000000
chr2,666281,1353829,687548,1,0,129787;54221,2,0.29088878158324900000
chr2,315048,795109,480061,1,0,129787,1,0.20830686100308100000
chr2,817897,1076754,258857,1,0,54221,1,0.38631367898105900000
chr2,702469,896568,194099,1,0,,0,0.00000000000000000000
chr2,1427849,1514568,86719,1,0,7173,1,1.15314982875725000000
chr2,1272832,1355440,82608,1,0,54221,1,1.21053650978113000000
chr2,1523710,1541417,17707,1,0,7173,1,5.64748404585757000000
chr2,1527164,1540331,13167,1,0,7173,1,7.59474443684970000000
chr2,1218823,1227156,8333,1,0,54221,1,12.00048001920080000000
chr2,1529619,1535529,5910,1,0,7173,1,16.92047377326570000000
chr2,1528334,1533837,5503,1,0,7173,1,18.17190623296380000000
chr2,1535580,1540457,4877,1,0,7173,1,20.50440844781630000000
chr2,397985,401212,3227,1,0,,0,0.00000000000000000000
chr2,1346038,1349865,3827,1,0,54221,1,26.13012803762740000000
chr2,1530176,1533560,3384,1,0,7173,1,29.55082742316780000000
chr2,1706793,1708522,1729,1,0,7837,1,57.83689994216310000000
chr2,1536167,1537215,1048,1,0,7173,1,95.41984732824430000000
chr2,732114,733099,985,1,0,,0,0.00000000000000000000
chr2,739943,740889,946,1,0,,0,0.00000000000000000000
chr2,1754149,1754852,703,1,0,,0,0.00000000000000000000
chr2,3693013,4083261,390248,1,0,55821;728597,2,0.51249461880650200000
chr2,4215655,4223411,7756,1,0,,0,0.00000000000000000000
chr2,3440557,3442133,1576,1,0,51112,1,63.45177664974620000000
chr2,3184232,3185148,916,1,0,,0,0.00000000000000000000
chr2,3772984,3773494,510,1,0,728597,1,196.07843137254900000000
chr2,5473828,5513387,39559,1,0,,0,0.00000000000000000000
chr2,5767407,5780379,12972,1,0,,0,0.00000000000000000000
chr2,5845469,5846721,1252,1,0,,0,0.00000000000000000000
chr2,6400570,6402147,1577,1,0,,0,0.00000000000000000000
chr2,8602928,8643247,40319,1,0,,0,0.00000000000000000000
chr2,9444577,9446417,1840,1,0,8853,1,54.34782608695650000000
chr2,9546113,9546736,623,1,0,9270,1,160.51364365971100000000
chr2,10150554,10157686,7132,1,0,,0,0.00000000000000000000
chr2,10885571,10893565,7994,1,0,245973,1,12.50938203652740000000
chr2,12019028,12027542,8514,1,0,,0,0.00000000000000000000
chr2,12019439,12024608,5169,1,0,,0,0.00000000000000000000
chr2,13200420,13266553,66133,1,0,,0,0.00000000000000000000
chr2,13508917,13559233,50316,1,0,,0,0.00000000000000000000
chr2,13580875,13597385,16510,1,0,,0,0.00000000000000000000
chr2,14348053,14372709,24656,1,0,,0,0.00000000000000000000
chr2,14354450,14373755,19305,1,0,,0,0.00000000000000000000
chr2,14351460,14367172,15712,1,0,,0,0.00000000000000000000
chr2,14357723,14369106,11383,1,0,,0,0.00000000000000000000
chr2,15519918,15520770,852,1,0,51594,1,117.37089201877900000000
chr2,18322140,18346864,24724,1,0,,0,0.00000000000000000000
chr2,18173779,18193236,19457,1,0,,0,0.00000000000000000000
chr2,18326205,18343245,17040,1,0,,0,0.00000000000000000000
chr2,19767592,19770575,2983,1,0,,0,0.00000000000000000000
chr2,25294212,25299227,5015,1,0,22979,1,19.94017946161520000000
chr2,31595345,31868877,273532,1,0,6716;7498,2,0.73117587704546400000
chr2,32293427,32296828,3401,1,0,6683,1,29.40311673037340000000
chr2,32616874,33333128,716254,1,0,57448;4052;55622,3,0.41884582843516400000
chr2,32698465,33008908,310443,1,0,57448;55622,2,0.64424064965227100000
chr2,32842525,32985890,143365,1,0,57448;55622,2,1.39504063055837000000
chr2,32979165,33123337,144172,1,0,55622,1,0.69361595871597800000
chr2,32991382,33042516,51134,1,0,55622,1,1.95564594985724000000
chr2,33224644,33227229,2585,1,0,4052,1,38.68471953578340000000
chr2,33764725,33767662,2937,1,0,25780,1,34.04834865509020000000
chr2,34098211,34125322,27111,1,0,,0,0.00000000000000000000
chr2,34199750,34259861,60111,1,0,,0,0.00000000000000000000
chr2,34578995,34664847,85852,1,0,,0,0.00000000000000000000
chr2,34525950,34603379,77429,1,0,,0,0.00000000000000000000
chr2,35964826,35997992,33166,1,0,,0,0.00000000000000000000
chr2,34693423,34737946,44523,1,0,,0,0.00000000000000000000
chr2,35976307,36000775,24468,1,0,,0,0.00000000000000000000
chr2,34705748,34733230,27482,1,0,,0,0.00000000000000000000
chr2,34701538,34723972,22434,1,0,,0,0.00000000000000000000
chr2,36986329,36991009,4680,1,0,5212,1,21.36752136752140000000
chr2,37150366,37158216,7850,1,0,6801,1,12.73885350318470000000
chr2,37907203,37931660,24457,1,0,,0,0.00000000000000000000
chr2,37955902,38003447,47545,1,0,,0,0.00000000000000000000
chr2,38956624,38974130,17506,1,0,6432;130589,2,11.42465440420430000000
chr2,38961956,38972101,10145,1,0,6432,1,9.85707244948250000000
chr2,40143779,40245464,101685,1,0,,0,0.00000000000000000000
chr2,41722037,41770142,48105,1,0,,0,0.00000000000000000000
chr2,44082268,44098957,16689,1,0,64241,1,5.99197075918269000000
chr2,43450718,43454988,4270,1,0,678,1,23.41920374707260000000
chr2,44517278,44539740,22462,1,0,6519,1,4.45196331582228000000
chr2,45303278,45333439,30161,1,0,,0,0.00000000000000000000
chr2,45328022,45351769,23747,1,0,,0,0.00000000000000000000
chr2,45646824,46363634,716810,1,0,5581;55133,2,0.27901396464893100000
chr2,45410920,45976420,565500,1,0,5581;55133,2,0.35366931918656100000
chr2,46775471,46790265,14794,1,0,23433,1,6.75949709341625000000
chr2,48812543,48825044,12501,1,0,286749;11037,2,15.99872010239180000000
chr2,49250209,49260581,10372,1,0,2492,1,9.64134207481681000000
chr2,52670099,52748362,78263,1,0,,0,0.00000000000000000000
chr2,52743327,52783194,39867,1,0,,0,0.00000000000000000000
chr2,52751723,52783791,32068,1,0,,0,0.00000000000000000000
chr2,52745663,52769039,23376,1,0,,0,0.00000000000000000000
chr2,52785825,52806016,20191,1,0,,0,0.00000000000000000000
chr2,53558095,53559850,1755,1,0,,0,0.00000000000000000000
chr2,54228877,54704273,475396,1,0,6711;129852;388951;98,4,0.84140379809674500000
chr2,54565696,54567498,1802,1,0,129852,1,55.49389567147610000000
chr2,56287270,56391374,104104,1,0,,0,0.00000000000000000000
chr2,56719836,56749664,29828,1,0,,0,0.00000000000000000000
chr2,55910531,55941705,31174,1,0,87178,1,3.20780137293899000000
chr2,56645103,56656060,10957,1,0,,0,0.00000000000000000000
chr2,56651629,56655677,4048,1,0,,0,0.00000000000000000000
chr2,56653275,56655695,2420,1,0,,0,0.00000000000000000000
chr2,56654512,56655655,1143,1,0,,0,0.00000000000000000000
chr2,57592859,57681722,88863,1,0,,0,0.00000000000000000000
chr2,57389132,57449621,60489,1,0,,0,0.00000000000000000000
chr2,57407649,57441853,34204,1,0,,0,0.00000000000000000000
chr2,60990073,61095866,105793,1,0,64895,1,0.94524212377000400000
chr2,64342104,64515722,173618,1,0,57162,1,0.57597714522687700000
chr2,64293435,64303789,10354,1,0,,0,0.00000000000000000000
chr2,68585251,68605231,19980,1,0,5341,1,5.00500500500501000000
chr2,68963494,69026814,63320,1,0,9938,1,1.57927984838913000000
chr2,71215632,71272144,56512,1,0,113419,1,1.76953567383918000000
chr2,71523858,71578478,54620,1,0,27332,1,1.83083119736360000000
chr2,73851986,73911771,59785,1,0,9027,1,1.67266036631262000000
chr2,73875736,73914543,38807,1,0,,0,0.00000000000000000000
chr2,74010467,74039497,29030,1,0,388960,1,3.44471236651740000000
chr2,74900922,75052085,151163,1,0,10505,1,0.66153754556339800000
chr2,75151402,75240182,88780,1,0,56655,1,1.12637981527371000000
chr2,75815000,75904060,89060,1,0,6936;9801,2,2.24567707163710000000
chr2,75777646,75813155,35509,1,0,84141,1,2.81618744543637000000
chr2,76650562,76755530,104968,1,0,,0,0.00000000000000000000
chr2,76773732,76775433,1701,1,0,,0,0.00000000000000000000
chr2,76973024,77018818,45794,1,0,80059,1,2.18369218674936000000
chr2,77896205,77918108,21903,1,0,,0,0.00000000000000000000
chr2,77974656,78003333,28677,1,0,,0,0.00000000000000000000
chr2,79329951,79343767,13816,1,0,,0,0.00000000000000000000
chr2,79602690,79655711,53021,1,0,,0,0.00000000000000000000
chr2,82103023,82187328,84305,1,0,,0,0.00000000000000000000
chr2,82210392,82308598,98206,1,0,,0,0.00000000000000000000
chr2,83438064,83562503,124439,1,0,,0,0.00000000000000000000
chr2,83990864,84024731,33867,1,0,,0,0.00000000000000000000
chr2,86282713,86510932,228219,1,0,10989;25885;55037;65055;51318,5,2.19087806010893000000
chr2,87353511,87997149,643638,1,0,,0,0.00000000000000000000
chr2,87607118,88019142,412024,1,0,,0,0.00000000000000000000
chr2,87374888,87587734,212846,1,0,,0,0.00000000000000000000
chr2,86972686,87178263,205577,1,0,926;64795;400966;925,4,1.94574295762658000000
chr2,88125338,88261543,136205,1,0,,0,0.00000000000000000000
chr2,87461951,87570275,108324,1,0,,0,0.00000000000000000000
chr2,87561494,87650574,89080,1,0,,0,0.00000000000000000000
chr2,87925052,87995371,70319,1,0,,0,0.00000000000000000000
chr2,87294958,87346228,51270,1,0,,0,0.00000000000000000000
chr2,88165485,88222915,57430,1,0,,0,0.00000000000000000000
chr2,87559615,87604655,45040,1,0,,0,0.00000000000000000000
chr2,87347223,87390971,43748,1,0,,0,0.00000000000000000000
chr2,87525128,87564546,39418,1,0,,0,0.00000000000000000000
chr2,87381771,87421541,39770,1,0,,0,0.00000000000000000000
chr2,87237012,87276522,39510,1,0,400966;5343,2,5.06200961781827000000
chr2,87589287,87614941,25654,1,0,,0,0.00000000000000000000
chr2,87599077,87623125,24048,1,0,,0,0.00000000000000000000
chr2,87131990,87151392,19402,1,0,400966,1,5.15410782393568000000
chr2,87257509,87280275,22766,1,0,,0,0.00000000000000000000
chr2,88278097,88287773,9676,1,0,,0,0.00000000000000000000
chr2,87141402,87149799,8397,1,0,400966,1,11.90901512444920000000
chr2,87560571,87567091,6520,1,0,,0,0.00000000000000000000
chr2,88827973,88831297,3324,1,0,200523,1,30.08423586040910000000
chr2,89065685,89106705,41020,1,0,,0,0.00000000000000000000
chr2,89967881,91792677,1824796,1,0,,0,0.00000000000000000000
chr2,89268161,90294704,1026543,1,0,,0,0.00000000000000000000
chr2,91676733,92240346,563613,1,0,,0,0.00000000000000000000
chr2,89171613,89534947,363334,1,0,,0,0.00000000000000000000
chr2,89952901,90278188,325287,1,0,,0,0.00000000000000000000
chr2,89351628,89578086,226458,1,0,,0,0.00000000000000000000
chr2,92036653,92277828,241175,1,0,,0,0.00000000000000000000
chr2,91621488,91814817,193329,1,0,,0,0.00000000000000000000
chr2,89128221,89334283,206062,1,0,,0,0.00000000000000000000
chr2,91742752,91937644,194892,1,0,,0,0.00000000000000000000
chr2,89966169,90101942,135773,1,0,,0,0.00000000000000000000
chr2,89284928,89458395,173467,1,0,,0,0.00000000000000000000
chr2,90120247,90271890,151643,1,0,,0,0.00000000000000000000
chr2,89211622,89341490,129868,1,0,,0,0.00000000000000000000
chr2,91615706,91698961,83255,1,0,,0,0.00000000000000000000
chr2,89155912,89260169,104257,1,0,,0,0.00000000000000000000
chr2,92046787,92163536,116749,1,0,,0,0.00000000000000000000
chr2,91862167,91969856,107689,1,0,,0,0.00000000000000000000
chr2,91767201,91834088,66887,1,0,,0,0.00000000000000000000
chr2,89976510,90045522,69012,1,0,,0,0.00000000000000000000
chr2,89475708,89544677,68969,1,0,,0,0.00000000000000000000
chr2,92122926,92198821,75895,1,0,,0,0.00000000000000000000
chr2,90198500,90264664,66164,1,0,,0,0.00000000000000000000
chr2,91695892,91762061,66169,1,0,,0,0.00000000000000000000
chr2,91616161,91679722,63561,1,0,,0,0.00000000000000000000
chr2,92258804,92304442,45638,1,0,,0,0.00000000000000000000
chr2,91914212,91957042,42830,1,0,,0,0.00000000000000000000
chr2,90065989,90119450,53461,1,0,,0,0.00000000000000000000
chr2,91765425,91807820,42395,1,0,,0,0.00000000000000000000
chr2,91957233,92001355,44122,1,0,,0,0.00000000000000000000
chr2,92028209,92065677,37468,1,0,,0,0.00000000000000000000
chr2,89131433,89161599,30166,1,0,,0,0.00000000000000000000
chr2,92227095,92265926,38831,1,0,,0,0.00000000000000000000
chr2,92143718,92177451,33733,1,0,,0,0.00000000000000000000
chr2,90212408,90249248,36840,1,0,,0,0.00000000000000000000
chr2,89596317,89630384,34067,1,0,,0,0.00000000000000000000
chr2,89277655,89306397,28742,1,0,,0,0.00000000000000000000
chr2,91759879,91787635,27756,1,0,,0,0.00000000000000000000
chr2,92004442,92032119,27677,1,0,,0,0.00000000000000000000
chr2,91708501,91735900,27399,1,0,,0,0.00000000000000000000
chr2,91677637,91692987,15350,1,0,,0,0.00000000000000000000
chr2,91759790,91777708,17918,1,0,,0,0.00000000000000000000
chr2,90303449,90319467,16018,1,0,,0,0.00000000000000000000
chr2,91961412,91971577,10165,1,0,,0,0.00000000000000000000
chr2,91843122,91854698,11576,1,0,,0,0.00000000000000000000
chr2,91917942,91925751,7809,1,0,,0,0.00000000000000000000
chr2,91679714,91685533,5819,1,0,,0,0.00000000000000000000
chr2,96005331,96348319,342988,1,0,653192;129868;51011;30818,4,1.16622155877174000000
chr2,96443475,96675622,232147,1,0,400986,1,0.43076154333245700000
chr2,96294243,96407260,113017,1,0,,0,0.00000000000000000000
chr2,95556526,95623138,66612,1,0,,0,0.00000000000000000000
chr2,95455400,95545025,89625,1,0,150483,1,1.11576011157601000000
chr2,96371477,96472844,101367,1,0,,0,0.00000000000000000000
chr2,95326829,95416100,89271,1,0,,0,0.00000000000000000000
chr2,96591462,96635634,44172,1,0,400986,1,2.26387756950104000000
chr2,95524851,95569066,44215,1,0,150483,1,2.26167590184327000000
chr2,95421441,95457786,36345,1,0,,0,0.00000000000000000000
chr2,95516548,95545421,28873,1,0,150483,1,3.46344335538392000000
chr2,96514615,96527805,13190,1,0,400986,1,7.58150113722517000000
chr2,95598308,95611515,13207,1,0,,0,0.00000000000000000000
chr2,95547639,95555881,8242,1,0,,0,0.00000000000000000000
chr2,96248430,96254608,6178,1,0,,0,0.00000000000000000000
chr2,97809617,98197448,387831,1,0,57730;375248,2,0.51568853443897000000
chr2,97737786,98034674,296888,1,0,151313;375248,2,0.67365471154105200000
chr2,98015643,98273789,258146,1,0,1329;57730;10120,3,1.16213305648741000000
chr2,97748475,97920629,172154,1,0,151313;375248,2,1.16175052569211000000
chr2,98042933,98162176,119243,1,0,57730,1,0.83862365086420200000
chr2,97815951,97895879,79928,1,0,375248,1,1.25112601341207000000
chr2,98108112,98218168,110056,1,0,57730,1,0.90862833466598800000
chr2,97742618,97818903,76285,1,0,151313;375248,2,2.62174739463853000000
chr2,97804202,97857250,53048,1,0,375248,1,1.88508520585130000000
chr2,98118214,98162154,43940,1,0,57730,1,2.27583067819754000000
chr2,97837578,97877164,39586,1,0,375248,1,2.52614560703279000000
chr2,98140375,98160063,19688,1,0,57730,1,5.07923608289313000000
chr2,97858649,97879958,21309,1,0,375248,1,4.69285278520813000000
chr2,97902272,97916793,14521,1,0,375248,1,6.88657805936230000000
chr2,98172174,98185747,13573,1,0,57730,1,7.36756796581448000000
chr2,98076705,98089546,12841,1,0,,0,0.00000000000000000000
chr2,98123576,98134234,10658,1,0,57730,1,9.38262338149747000000
chr2,98234130,98240477,6347,1,0,,0,0.00000000000000000000
chr2,98436161,98819010,382849,1,0,23505;200403,2,0.52239917043011700000
chr2,98872606,98886425,13819,1,0,200403,1,7.23641363340329000000
chr2,99841106,99924306,83200,1,0,254773;129530,2,2.40384615384615000000
chr2,100103719,100105108,1389,1,0,51455,1,71.99424046076310000000
chr2,106507788,106547677,39889,1,0,8440,1,2.50695680513425000000
chr2,106695079,106695930,851,1,0,,0,0.00000000000000000000
chr2,106695029,106695626,597,1,0,,0,0.00000000000000000000
chr2,110463877,111369741,905864,1,0,84220;100288695;4867;96626;729540;7851,6,0.66235108139853200000
chr2,108528837,109265669,736832,1,0,6819;9648;27233;3987;442038;60482,6,0.81429688178580700000
chr2,110874327,111365996,491669,1,0,729540;100288695;4867,3,0.61016659581954500000
chr2,110726899,111067882,340983,1,0,7851;4867,2,0.58653950490200400000
chr2,110851070,111022670,171600,1,0,7851;4867,2,1.16550116550117000000
chr2,110854474,110953425,98951,1,0,7851;4867,2,2.02120241331568000000
chr2,108903256,109007041,103785,1,0,6819;27233,2,1.92706075059016000000
chr2,110362986,110441885,78899,1,0,65124;151011,2,2.53488637371830000000
chr2,110687164,110733462,46298,1,0,,0,0.00000000000000000000
chr2,111153675,111199419,45744,1,0,,0,0.00000000000000000000
chr2,107085175,107132441,47266,1,0,,0,0.00000000000000000000
chr2,110836445,110852778,16333,1,0,7851,1,6.12257393008020000000
chr2,111124284,111142477,18193,1,0,,0,0.00000000000000000000
chr2,107066026,107083016,16990,1,0,653489,1,5.88581518540318000000
chr2,108521102,108539429,18327,1,0,,0,0.00000000000000000000
chr2,110751047,110758836,7789,1,0,,0,0.00000000000000000000
chr2,106860448,106870977,10529,1,0,,0,0.00000000000000000000
chr2,110985702,110991331,5629,1,0,,0,0.00000000000000000000
chr2,106880209,106885796,5587,1,0,,0,0.00000000000000000000
chr2,108855360,108856275,915,1,0,,0,0.00000000000000000000
chr2,112024578,112398088,373510,1,0,,0,0.00000000000000000000
chr2,112018098,112176372,158274,1,0,,0,0.00000000000000000000
chr2,112276736,112282808,6072,1,0,,0,0.00000000000000000000
chr2,112477890,112582148,104258,1,0,64682,1,0.95915900938057500000
chr2,112595004,112603809,8805,1,0,64682,1,11.35718341851220000000
chr2,113045326,113051038,5712,1,0,376940,1,17.50700280112040000000
chr2,113045417,113048714,3297,1,0,376940,1,30.33060357901120000000
chr2,114385005,114504133,119128,1,0,80255;11159,2,1.67886642938688000000
chr2,114151907,114252595,100688,1,0,150472,1,0.99316701096456400000
chr2,114327402,114361459,34057,1,0,,0,0.00000000000000000000
chr2,114172119,114192640,20521,1,0,,0,0.00000000000000000000
chr2,114313792,114331501,17709,1,0,,0,0.00000000000000000000
chr2,114337278,114348943,11665,1,0,,0,0.00000000000000000000
chr2,116531965,116670151,138186,1,0,57628,1,0.72366231021955900000
chr2,116662065,116662614,549,1,0,,0,0.00000000000000000000
chr2,117777115,117927236,150121,1,0,,0,0.00000000000000000000
chr2,117799314,117834282,34968,1,0,,0,0.00000000000000000000
chr2,117762438,117792703,30265,1,0,,0,0.00000000000000000000
chr2,118881404,118882258,854,1,0,,0,0.00000000000000000000
chr2,121493456,121509469,16013,1,0,,0,0.00000000000000000000
chr2,121797526,121798713,1187,1,0,,0,0.00000000000000000000
chr2,121797719,121798301,582,1,0,,0,0.00000000000000000000
chr2,123872340,123934363,62023,1,0,,0,0.00000000000000000000
chr2,123781249,123829723,48474,1,0,,0,0.00000000000000000000
chr2,124006119,124140217,134098,1,0,,0,0.00000000000000000000
chr2,124826641,124840134,13493,1,0,129684,1,7.41125027792189000000
chr2,126378702,126383887,5185,1,0,,0,0.00000000000000000000
chr2,127674758,127677272,2514,1,0,,0,0.00000000000000000000
chr2,127724864,127725324,460,1,0,,0,0.00000000000000000000
chr2,132751908,133412515,660607,1,0,116372;2863;646915,3,0.45412779458891600000
chr2,130869362,131158749,289387,1,0,91409;84317;728378;26469;92856;55627;112714;80097,8,2.76446419500530000000
chr2,131948370,132273680,325310,1,0,445582;150786;113457;653784,4,1.22959638498663000000
chr2,132764295,133074128,309833,1,0,646915,1,0.32275451614256700000
chr2,130870129,131006429,136300,1,0,91409;55627;112714;728378;80097,5,3.66837857666911000000
chr2,131942861,132108556,165695,1,0,445582,1,0.60351851293038400000
chr2,132379816,132516201,136385,1,0,29798,1,0.73321846244088400000
chr2,131040434,131159105,118671,1,0,92856;84317;26469,3,2.52799757312233000000
chr2,132950723,133040088,89365,1,0,,0,0.00000000000000000000
chr2,132347447,132455010,107563,1,0,,0,0.00000000000000000000
chr2,132225655,132298099,72444,1,0,90557;113457;653784,3,4.14112970018221000000
chr2,132316407,132374192,57785,1,0,,0,0.00000000000000000000
chr2,131368399,131445959,77560,1,0,653781,1,1.28932439401753000000
chr2,132095070,132152150,57080,1,0,150786,1,1.75192711983181000000
chr2,132033324,132063834,30510,1,0,,0,0.00000000000000000000
chr2,132968149,133009945,41796,1,0,,0,0.00000000000000000000
chr2,130903823,130953618,49795,1,0,55627;112714;80097,3,6.02470127522844000000
chr2,133011997,133044069,32072,1,0,,0,0.00000000000000000000
chr2,132269026,132308195,39169,1,0,90557,1,2.55303939339784000000
chr2,132480064,132524977,44913,1,0,29798,1,2.22652684078107000000
chr2,133280599,133312036,31437,1,0,2863,1,3.18096510481280000000
chr2,133039238,133071294,32056,1,0,646915,1,3.11954080359371000000
chr2,132307998,132339108,31110,1,0,,0,0.00000000000000000000
chr2,132058130,132087895,29765,1,0,,0,0.00000000000000000000
chr2,133014974,133035280,20306,1,0,,0,0.00000000000000000000
chr2,132804253,132815502,11249,1,0,,0,0.00000000000000000000
chr2,132491127,132509509,18382,1,0,29798,1,5.44010445000544000000
chr2,131936992,131948525,11533,1,0,,0,0.00000000000000000000
chr2,131200483,131212162,11679,1,0,,0,0.00000000000000000000
chr2,133038132,133047244,9112,1,0,,0,0.00000000000000000000
chr2,131950285,131959385,9100,1,0,,0,0.00000000000000000000
chr2,130816984,130825516,8532,1,0,,0,0.00000000000000000000
chr2,130809480,130816920,7440,1,0,,0,0.00000000000000000000
chr2,133016017,133023425,7408,1,0,,0,0.00000000000000000000
chr2,132093081,132096330,3249,1,0,,0,0.00000000000000000000
chr2,133037003,133039222,2219,1,0,,0,0.00000000000000000000
chr2,136198851,136232918,34067,1,0,84083,1,2.93539202160449000000
chr2,142184749,142243006,58257,1,0,53353,1,1.71653191891103000000
chr2,144167920,144200739,32819,1,0,55843,1,3.04701544836832000000
chr2,146859907,146877022,17115,1,0,,0,0.00000000000000000000
chr2,149231886,149359274,127388,1,0,55777,1,0.78500329701384800000
chr2,152433827,152466067,32240,1,0,4703,1,3.10173697270471000000
chr2,153795883,153799834,3951,1,0,,0,0.00000000000000000000
chr2,153797656,153799766,2110,1,0,,0,0.00000000000000000000
chr2,154849265,154900055,50790,1,0,114805,1,1.96889151407757000000
chr2,154895727,154899174,3447,1,0,114805,1,29.01073397156950000000
chr2,154895881,154898528,2647,1,0,114805,1,37.77861730260670000000
chr2,159622308,159623049,741,1,0,,0,0.00000000000000000000
chr2,159697282,159954739,257457,1,0,85461,1,0.38841437599288400000
chr2,159700896,159745788,44892,1,0,,0,0.00000000000000000000
chr2,159959777,159960973,1196,1,0,85461,1,83.61204013377930000000
chr2,162135205,162139108,3903,1,0,,0,0.00000000000000000000
chr2,162135200,162136887,1687,1,0,,0,0.00000000000000000000
chr2,162332586,162333917,1331,1,0,,0,0.00000000000000000000
chr2,165601869,165727045,125176,1,0,22837,1,0.79887518374129200000
chr2,165820280,165864068,43788,1,0,,0,0.00000000000000000000
chr2,165830891,165855232,24341,1,0,,0,0.00000000000000000000
chr2,167494647,167501455,6808,1,0,,0,0.00000000000000000000
chr2,172906284,172910164,3880,1,0,254042,1,25.77319587628870000000
chr2,172908010,172910075,2065,1,0,254042,1,48.42615012106540000000
chr2,173004557,173007303,2746,1,0,,0,0.00000000000000000000
chr2,173006172,173007286,1114,1,0,,0,0.00000000000000000000
chr2,177265200,177271797,6597,1,0,,0,0.00000000000000000000
chr2,178548835,178580528,31693,1,0,50940,1,3.15527088000505000000
chr2,179296070,179297104,1034,1,0,8575,1,96.71179883945840000000
chr2,179519199,179528023,8824,1,0,7273,1,11.33272892112420000000
chr2,180068330,180080116,11786,1,0,91404,1,8.48464279653827000000
chr2,184570852,184613737,42885,1,0,,0,0.00000000000000000000
chr2,185749734,185775773,26039,1,0,91752,1,3.84039325626944000000
chr2,188505077,188505560,483,1,0,,0,0.00000000000000000000
chr2,188985705,189002541,16836,1,0,,0,0.00000000000000000000
chr2,189184348,189252540,68192,1,0,51454,1,1.46644767714688000000
chr2,193219355,193324453,105098,1,0,,0,0.00000000000000000000
chr2,194691678,194703140,11462,1,0,,0,0.00000000000000000000
chr2,194689656,194696019,6363,1,0,,0,0.00000000000000000000
chr2,197363966,197540030,176064,1,0,284992;57520,2,1.13595056343148000000
chr2,202739814,202743136,3322,1,0,65061,1,30.10234798314270000000
chr2,206257620,206548651,291031,1,0,117583;8828,2,0.68721201521487400000
chr2,205657732,205683082,25350,1,0,117583,1,3.94477317554241000000
chr2,203899555,203903759,4204,1,0,65065,1,23.78686964795430000000
chr2,206128023,206129981,1958,1,0,117583,1,51.07252298263530000000
chr2,207662293,207668151,5858,1,0,,0,0.00000000000000000000
chr2,208351273,208359345,8072,1,0,,0,0.00000000000000000000
chr2,209996297,210031992,35695,1,0,,0,0.00000000000000000000
chr2,213231905,213282283,50378,1,0,2066,1,1.98499344952162000000
chr2,215096624,215123601,26977,1,0,79582,1,3.70686140045224000000
chr2,218617554,218686993,69439,1,0,7145,1,1.44011290485174000000
chr2,218647121,218699172,52051,1,0,7145,1,1.92119267641352000000
chr2,220052471,220055941,3470,1,0,,0,0.00000000000000000000
chr2,220052920,220054328,1408,1,0,,0,0.00000000000000000000
chr2,222230273,222233827,3554,1,0,,0,0.00000000000000000000
chr2,228240641,228258273,17632,1,0,79853,1,5.67150635208711000000
chr2,229264377,229268354,3977,1,0,,0,0.00000000000000000000
chr2,230726233,230915900,189667,1,0,130888;151473;9320,3,1.58171954003596000000
chr2,232686870,232715451,28581,1,0,,0,0.00000000000000000000
chr2,233205049,233310766,105717,1,0,250;251;129563,3,2.83776497630466000000
chr2,233245285,233280682,35397,1,0,250;251,2,5.65019634432297000000
chr2,233440712,233488116,47404,1,0,80303;9470,2,4.21905324445195000000
chr2,234305480,234306351,871,1,0,8527,1,114.81056257175700000000
chr2,234524405,234559804,35399,1,0,54575;54576,2,5.64987711517275000000
chr2,234698773,234699751,978,1,0,339766,1,102.24948875255600000000
chr2,235554178,235558335,4157,1,0,,0,0.00000000000000000000
chr2,235781652,235816243,34591,1,0,,0,0.00000000000000000000
chr2,236075756,236099723,23967,1,0,,0,0.00000000000000000000
chr2,238451080,238453982,2902,1,0,79083,1,34.45899379738110000000
chr2,238451679,238454003,2324,1,0,79083,1,43.02925989672980000000
chr2,238719618,238776617,56999,1,0,10267;375316,2,3.50883348830681000000
chr2,239026115,239028625,2510,1,0,339768,1,39.84063745019920000000
chr2,239500461,239501638,1177,1,0,,0,0.00000000000000000000
chr2,241629577,241711434,81857,1,0,547;375318,2,2.44328524133550000000
chr2,241424537,241514342,89805,1,0,285193;51281;57140,3,3.34057123768164000000
chr2,241409934,241416800,6866,1,0,,0,0.00000000000000000000
chr2,241671504,241672602,1098,1,0,547,1,91.07468123861570000000
chr2,241862718,241864936,2218,1,0,,0,0.00000000000000000000
chr2,241915274,241920968,5694,1,0,,0,0.00000000000000000000
chr2,242509769,242510559,790,1,0,666,1,126.58227848101300000000
chr2,242953504,243080309,126805,1,0,,0,0.00000000000000000000
chr2,242955237,243015999,60762,1,0,,0,0.00000000000000000000
chr2,243026086,243069355,43269,1,0,,0,0.00000000000000000000
chr2,242988880,243037339,48459,1,0,,0,0.00000000000000000000
chr2,243019390,243055431,36041,1,0,,0,0.00000000000000000000
chr2,243070063,243102472,32409,1,0,,0,0.00000000000000000000
chr2,242744667,242749093,4426,1,0,,0,0.00000000000000000000
chr2,242948590,242952780,4190,1,0,,0,0.00000000000000000000
chr2,242704737,242706921,2184,1,0,728294,1,45.78754578754580000000
chr20,98561,224509,125948,1,0,140881;140850;81623;245939,4,3.17591386921587000000
chr20,379865,493176,113311,1,0,1457;10616;128637,3,2.64758055263831000000
chr20,884966,986813,101847,1,0,343637;51378,2,1.96372990858837000000
chr20,61947,119089,57142,1,0,245938,1,1.75002625039376000000
chr20,1552450,1598316,45866,1,0,10326,1,2.18026424802686000000
chr20,1561425,1585030,23605,1,0,10326,1,4.23639059521288000000
chr20,1388929,1390765,1836,1,0,,0,0.00000000000000000000
chr20,1389678,1390840,1162,1,0,,0,0.00000000000000000000
chr20,1894702,1896738,2036,1,0,140885,1,49.11591355599210000000
chr20,2653799,2958998,305199,1,0,57593;100288797;5786;64773;64601;56265;128653,7,2.29358549667594000000
chr20,3011188,3346954,335766,1,0,64949;65992;83959;25943;551;2797;5786;5020;60493;9762;22888;3704,12,3.57391754972213000000
chr20,4019284,4068568,49284,1,0,,0,0.00000000000000000000
chr20,5421056,5748865,327809,1,0,149840;56261,2,0.61011137583165800000
chr20,9736814,9894097,157283,1,0,57144,1,0.63579662137675400000
chr20,12139770,12330015,190245,1,0,,0,0.00000000000000000000
chr20,12376410,12393090,16680,1,0,,0,0.00000000000000000000
chr20,12799924,12879392,79468,1,0,,0,0.00000000000000000000
chr20,14427715,14441694,13979,1,0,140733,1,7.15358752414336000000
chr20,14705088,14776923,71835,1,0,140733,1,1.39207907009118000000
chr20,15709506,15712363,2857,1,0,140733,1,35.00175008750440000000
chr20,15711621,15712363,742,1,0,140733,1,134.77088948787100000000
chr20,16558260,16571796,13536,1,0,,0,0.00000000000000000000
chr20,19904595,19905346,751,1,0,54453,1,133.15579227696400000000
chr20,19904759,19905259,500,1,0,54453,1,200.00000000000000000000
chr20,21190140,21190589,449,1,0,55857,1,222.71714922049000000000
chr20,21286456,21288450,1994,1,0,22803,1,50.15045135406220000000
chr20,23401405,23474075,72670,1,0,128817;63908;140880;10047,4,5.50433466354754000000
chr20,23654636,23757320,102684,1,0,1469;1472,2,1.94772311168244000000
chr20,23648255,23704411,56156,1,0,1472,1,1.78075361492984000000
chr20,23788158,23837591,49433,1,0,1470,1,2.02294014120122000000
chr20,23763139,23785707,22568,1,0,,0,0.00000000000000000000
chr20,23956156,23979865,23709,1,0,92086,1,4.21780758361804000000
chr20,24419047,24426046,6999,1,0,,0,0.00000000000000000000
chr20,25081518,25409480,327962,1,0,26090;5834;9837;955,4,1.21965349644166000000
chr20,25895462,26215527,320065,1,0,,0,0.00000000000000000000
chr20,25735279,25864849,129570,1,0,,0,0.00000000000000000000
chr20,25663802,25744711,80909,1,0,26152,1,1.23595644489488000000
chr20,26055176,26113822,58646,1,0,,0,0.00000000000000000000
chr20,26256820,26318524,61704,1,0,,0,0.00000000000000000000
chr20,26173000,26218779,45779,1,0,,0,0.00000000000000000000
chr20,25733409,25771542,38133,1,0,,0,0.00000000000000000000
chr20,26122346,26167214,44868,1,0,,0,0.00000000000000000000
chr20,26296040,26319101,23061,1,0,,0,0.00000000000000000000
chr20,26206836,26227576,20740,1,0,,0,0.00000000000000000000
chr20,25740346,25758070,17724,1,0,,0,0.00000000000000000000
chr20,26073187,26087550,14363,1,0,,0,0.00000000000000000000
chr20,26242945,26258451,15506,1,0,,0,0.00000000000000000000
chr20,25696193,25707773,11580,1,0,,0,0.00000000000000000000
chr20,26056512,26064014,7502,1,0,,0,0.00000000000000000000
chr20,26298244,26302442,4198,1,0,,0,0.00000000000000000000
chr20,29835041,30415801,580760,1,0,245930;598;245936;245934;245937;84701;28954;81502;245932;22974;245929;85366;3397;117285,14,2.41063434120807000000
chr20,29841786,30006546,164760,1,0,245930;245932;245929;245934;117285,5,3.03471716436028000000
chr20,29503919,29652539,148620,1,0,,0,0.00000000000000000000
chr20,29424521,29519540,95019,1,0,,0,0.00000000000000000000
chr20,29573907,29652773,78866,1,0,,0,0.00000000000000000000
chr20,29517388,29573197,55809,1,0,,0,0.00000000000000000000
chr20,29804078,29853225,49147,1,0,245929,1,2.03471218996073000000
chr20,29507685,29537351,29666,1,0,,0,0.00000000000000000000
chr20,29805426,29831068,25642,1,0,,0,0.00000000000000000000
chr20,29629343,29652652,23309,1,0,,0,0.00000000000000000000
chr20,36716942,36856616,139674,1,0,7052;85449;58490,3,2.14785858499076000000
chr20,39906455,39907455,1000,1,0,23051,1,100.00000000000000000000
chr20,42272167,42273870,1703,1,0,51098,1,58.71990604815030000000
chr20,45245437,45275356,29919,1,0,64849,1,3.34235769912096000000
chr20,46611592,47118878,507286,1,0,,0,0.00000000000000000000
chr20,47131322,47132983,1661,1,0,,0,0.00000000000000000000
chr20,46523475,46524811,1336,1,0,,0,0.00000000000000000000
chr20,49126500,49149653,23153,1,0,5770,1,4.31909471774716000000
chr20,50683026,50697326,14300,1,0,,0,0.00000000000000000000
chr20,51171014,51176508,5494,1,0,,0,0.00000000000000000000
chr20,52199409,52212460,13051,1,0,7764,1,7.66224810359359000000
chr20,52331958,52336547,4589,1,0,,0,0.00000000000000000000
chr20,52475173,52484154,8981,1,0,,0,0.00000000000000000000
chr20,56099970,56102075,2105,1,0,140690,1,47.50593824228030000000
chr20,56283652,56286221,2569,1,0,56937,1,38.92565200467110000000
chr20,59564577,59590288,25711,1,0,,0,0.00000000000000000000
chr20,59569226,59592261,23035,1,0,,0,0.00000000000000000000
chr20,59822715,59834059,11344,1,0,1002,1,8.81523272214386000000
chr20,60517588,60523957,6369,1,0,,0,0.00000000000000000000
chr20,60545702,60547152,1450,1,0,,0,0.00000000000000000000
chr20,61304243,61305034,791,1,0,,0,0.00000000000000000000
chr20,62238129,62241551,3422,1,0,26205,1,29.22267679719460000000
chr20,61765950,61766886,936,1,0,,0,0.00000000000000000000
chr20,61724718,61725587,869,1,0,,0,0.00000000000000000000
chr20,62467262,62467870,608,1,0,,0,0.00000000000000000000
chr20,62591036,62597874,6838,1,0,57473,1,14.62415911085110000000
chr20,62595702,62598314,2612,1,0,57473,1,38.28483920367530000000
chr20,62596214,62597479,1265,1,0,57473,1,79.05138339920950000000
chr20,62842978,62904584,61606,1,0,55251;4661,2,3.24643703535370000000
chr20,62877021,62918780,41759,1,0,55251,1,2.39469335951531000000
chr20,62927745,62948437,20692,1,0,,0,0.00000000000000000000
chr20,62949512,62957862,8350,1,0,,0,0.00000000000000000000
chr20,62722166,62729096,6930,1,0,4987,1,14.43001443001440000000
chr20,62724479,62727150,2671,1,0,4987,1,37.43916136278550000000
chr20,62804645,62808017,3372,1,0,4661,1,29.65599051008300000000
chr20,62762926,62765716,2790,1,0,,0,0.00000000000000000000
chr20,62724866,62726868,2002,1,0,4987,1,49.95004995005000000000
chr20,62763194,62765091,1897,1,0,,0,0.00000000000000000000
chr21,10741509,11135228,393719,1,0,7179;85319,2,0.50797650100706300000
chr21,10704853,10982352,277499,1,0,7179,1,0.36036165896093300000
chr21,10950173,11168705,218532,1,0,7179;85319,2,0.91519777423901300000
chr21,10864066,11057285,193219,1,0,7179;85319,2,1.03509489232425000000
chr21,10702875,10862702,159827,1,0,,0,0.00000000000000000000
chr21,11020111,11187132,167021,1,0,85319,1,0.59872710617227800000
chr21,10984214,11086775,102561,1,0,7179;85319,2,1.95005898928443000000
chr21,10854321,10944929,90608,1,0,7179,1,1.10365530637471000000
chr21,11068062,11176644,108582,1,0,85319,1,0.92096295886979400000
chr21,10697941,10772881,74940,1,0,,0,0.00000000000000000000
chr21,10945866,10990772,44906,1,0,7179,1,2.22687391439897000000
chr21,11019226,11054541,35315,1,0,85319,1,2.83165793572137000000
chr21,11066060,11098169,32109,1,0,85319,1,3.11439160360024000000
chr21,11032848,11054628,21780,1,0,85319,1,4.59136822773186000000
chr21,11046039,11056758,10719,1,0,85319,1,9.32922847280530000000
chr21,11186222,11188048,1826,1,0,,0,0.00000000000000000000
chr21,14410328,15305010,894682,1,0,317754,1,0.11177155682130600000
chr21,14899981,15401068,501087,1,0,317754,1,0.19956614320467300000
chr21,14549925,15077427,527502,1,0,317754,1,0.18957274095643200000
chr21,14641188,15007659,366471,1,0,317754,1,0.27287288762275900000
chr21,18761699,19117982,356283,1,0,10950;1525,2,0.56135150989522400000
chr21,14366826,14575401,208575,1,0,,0,0.00000000000000000000
chr21,15170322,15371516,201194,1,0,,0,0.00000000000000000000
chr21,14960172,15104506,144334,1,0,317754,1,0.69283744647830700000
chr21,16953661,17145762,192101,1,0,29761,1,0.52055949734774900000
chr21,15096864,15177751,80887,1,0,,0,0.00000000000000000000
chr21,14338201,14447500,109299,1,0,,0,0.00000000000000000000
chr21,15220226,15288752,68526,1,0,,0,0.00000000000000000000
chr21,14982557,15054713,72156,1,0,317754,1,1.38588613559510000000
chr21,15021243,15095674,74431,1,0,,0,0.00000000000000000000
chr21,15283220,15352389,69169,1,0,,0,0.00000000000000000000
chr21,15230632,15271828,41196,1,0,,0,0.00000000000000000000
chr21,20992283,21034573,42290,1,0,,0,0.00000000000000000000
chr21,15618178,15660423,42245,1,0,,0,0.00000000000000000000
chr21,14940292,14973713,33421,1,0,,0,0.00000000000000000000
chr21,20055307,20079464,24157,1,0,,0,0.00000000000000000000
chr21,14721702,14743851,22149,1,0,,0,0.00000000000000000000
chr21,15899773,15928041,28268,1,0,64092,1,3.53756898259516000000
chr21,14509498,14529019,19521,1,0,,0,0.00000000000000000000
chr21,21301807,21316763,14956,1,0,,0,0.00000000000000000000
chr21,15374557,15390035,15478,1,0,,0,0.00000000000000000000
chr21,15263794,15270896,7102,1,0,,0,0.00000000000000000000
chr21,16588332,16591538,3206,1,0,,0,0.00000000000000000000
chr21,32372727,33179773,807046,1,0,6647;57466;150051;7074;728299,5,0.61954337175328300000
chr21,35718620,35905230,186610,1,0,101928147;9992;3753;54065;1827,5,2.67938481324688000000
chr21,47912623,48099247,186624,1,0,23181;6285;3275,3,1.60751028806584000000
chr21,32082954,32246306,163352,1,0,337879;337977;100288323;337878;337978,5,3.06087467554728000000
chr21,29062668,29217742,155074,1,0,,0,0.00000000000000000000
chr21,37476892,37605459,128567,1,0,9980;874,2,1.55560913764807000000
chr21,33867582,34003552,135970,1,0,8867;59271;140290;56683,4,2.94182540266235000000
chr21,33190136,33304588,114452,1,0,30811,1,0.87372872470555300000
chr21,42084844,42188303,103459,1,0,1826,1,0.96656646594303100000
chr21,48008932,48083023,74091,1,0,6285;3275,2,2.69938319094087000000
chr21,37528334,37604430,76096,1,0,9980,1,1.31412952060555000000
chr21,40115668,40158592,42924,1,0,,0,0.00000000000000000000
chr21,47981997,48049532,67535,1,0,23181;6285,2,2.96142740801066000000
chr21,45953223,46008519,55296,1,0,386679;386682;386677;386672;386680;54084,6,10.85069444444440000000
chr21,39851336,39873538,22202,1,0,2078,1,4.50409872984416000000
chr21,44821875,44841352,19477,1,0,150094,1,5.13426092314011000000
chr21,44821876,44832735,10859,1,0,,0,0.00000000000000000000
chr21,42842763,42847503,4740,1,0,7113,1,21.09704641350210000000
chr21,44970066,44973483,3417,1,0,11077,1,29.26543751829090000000
chr21,44827837,44831543,3706,1,0,,0,0.00000000000000000000
chr21,35383724,35387475,3751,1,0,,0,0.00000000000000000000
chr21,44007587,44010494,2907,1,0,,0,0.00000000000000000000
chr21,45720200,45722913,2713,1,0,5211,1,36.85956505713230000000
chr21,44970188,44972928,2740,1,0,11077,1,36.49635036496350000000
chr21,45942684,45945229,2545,1,0,54084,1,39.29273084479370000000
chr21,47388104,47389789,1685,1,0,,0,0.00000000000000000000
chr21,45829241,45830965,1724,1,0,7226,1,58.00464037122970000000
chr21,45681867,45683230,1363,1,0,29947,1,73.36757153338220000000
chr21,42845954,42847688,1734,1,0,7113,1,57.67012687427910000000
chr21,47454249,47455414,1165,1,0,,0,0.00000000000000000000
chr21,47026042,47027155,1113,1,0,,0,0.00000000000000000000
chr21,45682073,45683050,977,1,0,29947,1,102.35414534288600000000
chr21,46401471,46402363,892,1,0,,0,0.00000000000000000000
chr21,46447998,46448698,700,1,0,,0,0.00000000000000000000
chr21,47388178,47388850,672,1,0,,0,0.00000000000000000000
chr22,16820903,17382138,561235,1,0,150160;150165,2,0.35635696276960600000
chr22,16052369,16568581,516212,1,0,81061;23784,2,0.38743771938660900000
chr22,16777210,17225717,448507,1,0,150160,1,0.22296196045992600000
chr22,16939465,17226873,287408,1,0,150160,1,0.34793742693314000000
chr22,16085095,16386502,301407,1,0,23784,1,0.33177729780662000000
chr22,17069712,17306167,236455,1,0,150160;150165,2,0.84582690152460300000
chr22,16207976,16407842,199866,1,0,23784,1,0.50033522460048200000
chr22,16070123,16247483,177360,1,0,,0,0.00000000000000000000
chr22,16868185,17048148,179963,1,0,,0,0.00000000000000000000
chr22,16506970,16628665,121695,1,0,,0,0.00000000000000000000
chr22,16878415,16967084,88669,1,0,,0,0.00000000000000000000
chr22,16051697,16145851,94154,1,0,,0,0.00000000000000000000
chr22,16349662,16431284,81622,1,0,,0,0.00000000000000000000
chr22,17033657,17082435,48778,1,0,150160,1,2.05010455533232000000
chr22,17550215,17623651,73436,1,0,23765;27439;27440,3,4.08518982515388000000
chr22,16982267,17043159,60892,1,0,,0,0.00000000000000000000
chr22,16517693,16553331,35638,1,0,,0,0.00000000000000000000
chr22,16859474,16898180,38706,1,0,,0,0.00000000000000000000
chr22,16061176,16098829,37653,1,0,,0,0.00000000000000000000
chr22,16580816,16613907,33091,1,0,,0,0.00000000000000000000
chr22,17368171,17386609,18438,1,0,,0,0.00000000000000000000
chr22,16050035,16069354,19319,1,0,,0,0.00000000000000000000
chr22,16847868,16866438,18570,1,0,,0,0.00000000000000000000
chr22,17005945,17021721,15776,1,0,,0,0.00000000000000000000
chr22,17504131,17515496,11365,1,0,,0,0.00000000000000000000
chr22,16364722,16375423,10701,1,0,,0,0.00000000000000000000
chr22,18140781,18144784,4003,1,0,23786,1,24.98126405196100000000
chr22,18057988,18060276,2288,1,0,83733,1,43.70629370629370000000
chr22,18058381,18059763,1382,1,0,83733,1,72.35890014471780000000
chr22,19033305,21651007,2617702,1,0,54487;27037;9342;29801;65078;10587;1312;6545;421;7290;2812;6899;7625;79680;64976;6576;3053;8218;5413;80764;23617;400891;1399;7122;150209;128977;8220;388849;84861;7353;51586;2928;128989;5297;9127;9993;54584;91179;8216;85376;85359;8318;728229;5902,44,1.68086359715506000000
chr22,18733650,20256447,1522797,1,0,54487;27037;5413;29801;65078;23617;10587;1312;7122;8214;7290;421;128977;8220;2812;388849;7353;2928;128989;6899;9993;54584;5625;79680;64976;8318;5902;6576;8218,29,1.90439040791386000000
chr22,20758015,21464827,706812,1,0,80764;9342;91179;8216;7625;400891;1399;84861;6545;150209;5297;51586;9127;3053,14,1.98072471887857000000
chr22,19678592,20311988,633396,1,0,54487;5413;27037;29801;65078;10587;1312;421;388849;2812;128989;6899;54584;79680;85359;5902,16,2.52606584190617000000
chr22,21492135,21866886,374751,1,0,645426;440804;23119,3,0.80053155295116000000
chr22,21056670,21465835,409165,1,0,80764;9342;3053;8216;400891;1399;6545;150209;9127;5297,10,2.44400180856134000000
chr22,18651140,18977769,326629,1,0,11274;5625;8214,3,0.91847325252809800000
chr22,20687251,20954593,267342,1,0,91179;51586;84861;7625,4,1.49621084603242000000
chr22,20083772,20311017,227245,1,0,54487;27037;29801;65078;85359;388849;5902,7,3.08037580584831000000
chr22,18806567,19010854,204287,1,0,5625;8214,2,0.97901481738926100000
chr22,21693919,21838701,144782,1,0,645426;440804;23119,3,2.07208078352281000000
chr22,18727915,18877226,149311,1,0,,0,0.00000000000000000000
chr22,20308978,20505407,196429,1,0,85376;728229,2,1.01817959669906000000
chr22,21742345,21919900,177555,1,0,645426;7332;150221;440804;23119,5,2.81602883613528000000
chr22,21256865,21435776,178911,1,0,400891;1399;80764;6545;150209;8216;9127,7,3.91255987613953000000
chr22,20936502,21089013,152511,1,0,51586;5297,2,1.31138081843277000000
chr22,18792038,18913225,121187,1,0,5625;8214,2,1.65034203338642000000
chr22,18908655,19002237,93582,1,0,5625,1,1.06858156483084000000
chr22,20625591,20742469,116878,1,0,,0,0.00000000000000000000
chr22,21723828,21845082,121254,1,0,645426;440804;23119,3,2.47414518283933000000
chr22,18763430,18844774,81344,1,0,,0,0.00000000000000000000
chr22,20377604,20444957,67353,1,0,728229,1,1.48471486051104000000
chr22,18935584,19010652,75068,1,0,,0,0.00000000000000000000
chr22,21564530,21628204,63674,1,0,,0,0.00000000000000000000
chr22,21326187,21380465,54278,1,0,8216;80764;9127;150209,4,7.36946829286267000000
chr22,18790185,18850978,60793,1,0,,0,0.00000000000000000000
chr22,21464886,21510593,45707,1,0,,0,0.00000000000000000000
chr22,21039489,21094484,54995,1,0,5297,1,1.81834712246568000000
chr22,19947055,19983050,35995,1,0,421;1312,2,5.55632726767607000000
chr22,20694425,20743122,48697,1,0,,0,0.00000000000000000000
chr22,20327103,20365676,38573,1,0,,0,0.00000000000000000000
chr22,18884209,18925455,41246,1,0,5625;8214,2,4.84895505018668000000
chr22,21813388,21844900,31512,1,0,645426,1,3.17339426250317000000
chr22,18968575,19004204,35629,1,0,,0,0.00000000000000000000
chr22,21485353,21508945,23592,1,0,,0,0.00000000000000000000
chr22,18685275,18713833,28558,1,0,,0,0.00000000000000000000
chr22,21681401,21710485,29084,1,0,,0,0.00000000000000000000
chr22,18656546,18683455,26909,1,0,11274,1,3.71622877104315000000
chr22,20627160,20655434,28274,1,0,,0,0.00000000000000000000
chr22,18780274,18807746,27472,1,0,,0,0.00000000000000000000
chr22,20489573,20509431,19858,1,0,,0,0.00000000000000000000
chr22,21467507,21484213,16706,1,0,,0,0.00000000000000000000
chr22,18878645,18893248,14603,1,0,,0,0.00000000000000000000
chr22,19741202,19755688,14486,1,0,6899,1,6.90321689907497000000
chr22,21041150,21053211,12061,1,0,,0,0.00000000000000000000
chr22,18615917,18626353,10436,1,0,,0,0.00000000000000000000
chr22,18619348,18625511,6163,1,0,,0,0.00000000000000000000
chr22,20899737,20904474,4737,1,0,51586,1,21.11040743086340000000
chr22,21530206,21533968,3762,1,0,,0,0.00000000000000000000
chr22,22926824,24218503,1291679,1,0,4320;3543;2781;7621;100423062;66035;613;400916;150248;91227;266747;27156;51233;6598;29802;9609;91319,17,1.31611646546859000000
chr22,23691325,25072602,1381277,1,0,4320;3543;7621;2952;66035;388886;391322;400916;150248;266747;51733;2678;653689;4282;83606;23384;135;51233;6598;1652;29802;56241;100037417;2687;23523;6634;91319,27,1.95471292144878000000
chr22,22491173,23262536,771363,1,0,129025;91227;140883;100423062;7441;23532,6,0.77784389450881100000
chr22,24589852,25024191,434339,1,0,51733;2678;83606;135;23384;388886;2687;6634,8,1.84187926941859000000
chr22,22754304,23229204,474900,1,0,129025;91227;140883;23532,4,0.84228258580753800000
chr22,23584245,23964329,380084,1,0,51233;613;3543,3,0.78929920754359600000
chr22,22303949,22578085,274136,1,0,9647;8940,2,0.72956488750109400000
chr22,22754220,23037982,283762,1,0,129025;91227;140883;23532,4,1.40963201556234000000
chr22,22453541,22697290,243749,1,0,7441,1,0.41025809336653700000
chr22,22998068,23235764,237696,1,0,100423062,1,0.42070543887991400000
chr22,22165597,22364380,198783,1,0,5594;9647;8940,3,1.50918338087261000000
chr22,22309584,22469282,159698,1,0,8940,1,0.62618191837092500000
chr22,24294276,24397447,103171,1,0,2952;1652;100037417;391322;653689,5,4.84632309466808000000
chr22,23125876,23225054,99178,1,0,,0,0.00000000000000000000
chr22,22602069,22671078,69009,1,0,,0,0.00000000000000000000
chr22,24171305,24271732,100427,1,0,6598;66035;4282;91319,4,3.98299262150617000000
chr22,22503773,22562643,58870,1,0,,0,0.00000000000000000000
chr22,24341935,24404350,62415,1,0,2952;391322,2,3.20435792678042000000
chr22,22692761,22751542,58781,1,0,,0,0.00000000000000000000
chr22,24269430,24344335,74905,1,0,1652;653689;100037417,3,4.00507309258394000000
chr22,23919062,23980052,60990,1,0,51233;3543,2,3.27922610263978000000
chr22,22739637,22789880,50243,1,0,,0,0.00000000000000000000
chr22,24997583,25055993,58410,1,0,2678,1,1.71203561034070000000
chr22,22549384,22581844,32460,1,0,,0,0.00000000000000000000
chr22,24281414,24313377,31963,1,0,653689;100037417,2,6.25723492788537000000
chr22,24638383,24666273,27890,1,0,2687,1,3.58551452133381000000
chr22,24366488,24404505,38017,1,0,2952;391322,2,5.26080437698924000000
chr22,23955940,23987127,31187,1,0,51233,1,3.20646423189149000000
chr22,24275374,24293520,18146,1,0,,0,0.00000000000000000000
chr22,23805882,23827195,21313,1,0,,0,0.00000000000000000000
chr22,25004549,25022228,17679,1,0,2678,1,5.65642853102551000000
chr22,23933222,23952430,19208,1,0,51233,1,5.20616409829238000000
chr22,22487801,22507800,19999,1,0,,0,0.00000000000000000000
chr22,24345335,24363948,18613,1,0,,0,0.00000000000000000000
chr22,22629519,22648855,19336,1,0,,0,0.00000000000000000000
chr22,22740309,22755981,15672,1,0,,0,0.00000000000000000000
chr22,23244892,23263630,18738,1,0,,0,0.00000000000000000000
chr22,24649728,24661697,11969,1,0,,0,0.00000000000000000000
chr22,23234428,23249036,14608,1,0,100423062,1,6.84556407447974000000
chr22,24390811,24404561,13750,1,0,,0,0.00000000000000000000
chr22,22656331,22663922,7591,1,0,,0,0.00000000000000000000
chr22,24344041,24354853,10812,1,0,,0,0.00000000000000000000
chr22,24277660,24285996,8336,1,0,,0,0.00000000000000000000
chr22,24652224,24660563,8339,1,0,,0,0.00000000000000000000
chr22,24313554,24322019,8465,1,0,1652;100037417,2,23.62669816893090000000
chr22,24669005,24676699,7694,1,0,23384,1,12.99714062906160000000
chr22,24348754,24352243,3489,1,0,,0,0.00000000000000000000
chr22,23099464,23102668,3204,1,0,,0,0.00000000000000000000
chr22,24322314,24326106,3792,1,0,,0,0.00000000000000000000
chr22,24364568,24367535,2967,1,0,,0,0.00000000000000000000
chr22,24025670,24027619,1949,1,0,,0,0.00000000000000000000
chr22,25318690,25381553,62863,1,0,255349;129049,2,3.18152172183956000000
chr22,25658049,25966427,308378,1,0,91355;157,2,0.64855469586027500000
chr22,25703259,25785235,81976,1,0,91355,1,1.21986923001854000000
chr22,25660589,25715013,54424,1,0,,0,0.00000000000000000000
chr22,25927365,25980682,53317,1,0,157,1,1.87557439465836000000
chr22,25719691,25735657,15966,1,0,,0,0.00000000000000000000
chr22,25651595,25659586,7991,1,0,,0,0.00000000000000000000
chr22,25956792,25965135,8343,1,0,157,1,11.98609612849100000000
chr22,27553480,27580285,26805,1,0,,0,0.00000000000000000000
chr22,29070507,29094545,24038,1,0,23331;11200,2,8.32015974706714000000
chr22,29795550,29820610,25060,1,0,,0,0.00000000000000000000
chr22,30278628,30298418,19790,1,0,8897,1,5.05305709954522000000
chr22,30455223,30470342,15119,1,0,,0,0.00000000000000000000
chr22,32365881,32547330,181449,1,0,150297;6523,2,1.10223809445078000000
chr22,32386566,32449737,63171,1,0,6523,1,1.58300485982492000000
chr22,33008982,33101142,92160,1,0,8224,1,1.08506944444444000000
chr22,33780367,33782836,2469,1,0,9215,1,40.50222762251920000000
chr22,35294938,35299252,4314,1,0,,0,0.00000000000000000000
chr22,35645474,35646397,923,1,0,,0,0.00000000000000000000
chr22,35753487,35762486,8999,1,0,,0,0.00000000000000000000
chr22,36620323,36710635,90312,1,0,4627;8542;23780,3,3.32181769864470000000
chr22,36829766,37011291,181525,1,0,10369;25828;8664;80020,4,2.20355322958270000000
chr22,37143527,37147036,3509,1,0,,0,0.00000000000000000000
chr22,37775799,37815984,40185,1,0,114794,1,2.48849073037203000000
chr22,39284805,39315894,31089,1,0,,0,0.00000000000000000000
chr22,39357300,39388952,31652,1,0,9582;200315,2,6.31871603690130000000
chr22,39427548,39450626,23078,1,0,200316;140564,2,8.66626224109542000000
chr22,39359355,39379392,20037,1,0,9582,1,4.99076708090033000000
chr22,39379645,39386817,7172,1,0,9582,1,13.94311210262130000000
chr22,42520016,42542795,22779,1,0,1565,1,4.39000834101585000000
chr22,42520875,42534038,13163,1,0,1565,1,7.59705234369065000000
chr22,42781398,42929016,147618,1,0,27341;150372,2,1.35484832473005000000
chr22,42895263,42963891,68628,1,0,27341;253190,2,2.91426240018651000000
chr22,42888045,42949053,61008,1,0,27341,1,1.63912929451875000000
chr22,42907792,42951991,44199,1,0,27341;253190,2,4.52498925315052000000
chr22,42905915,42934158,28243,1,0,27341,1,3.54070035052933000000
chr22,42956361,42974403,18042,1,0,253190,1,5.54262276909434000000
chr22,42934146,42949980,15834,1,0,253190,1,6.31552355690287000000
chr22,43421358,43550404,129046,1,0,25809;706;638;27349,4,3.09966988515723000000
chr22,43298399,43426911,128512,1,0,11252,1,0.77813745019920300000
chr22,43298418,43357059,58641,1,0,11252,1,1.70529151958527000000
chr22,46920774,47014204,93430,1,0,9620,1,1.07032002568768000000
chr22,46535015,46537437,2422,1,0,,0,0.00000000000000000000
chr22,48220301,48236245,15944,1,0,,0,0.00000000000000000000
chr22,48454470,48479731,25261,1,0,,0,0.00000000000000000000
chr22,49402482,49995893,593411,1,0,,0,0.00000000000000000000
chr22,49729547,50086068,356521,1,0,348645,1,0.28048838637836200000
chr22,48866738,49091318,224580,1,0,25817,1,0.44527562561225400000
chr22,49258319,49331012,72693,1,0,,0,0.00000000000000000000
chr22,49354290,49397457,43167,1,0,,0,0.00000000000000000000
chr22,49910965,49955441,44476,1,0,,0,0.00000000000000000000
chr22,49661306,49662341,1035,1,0,,0,0.00000000000000000000
chr22,50467091,50467871,780,1,0,,0,0.00000000000000000000
chr22,50782162,50785347,3185,1,0,9701,1,31.39717425431710000000
chr22,50930680,51038037,107357,1,0,644186;1890;113730;9997;29781;91289;440836;1120;1375,9,8.38324468828302000000
chr22,51066406,51078951,12545,1,0,410,1,7.97130330809087000000
chr22,51067975,51077904,9929,1,0,,0,0.00000000000000000000
chr3,358558,1386986,1028428,1,0,27255;10752,2,0.19447156242342700000
chr3,1190961,2189608,998647,1,0,27255;152330,2,0.20027096661783400000
chr3,854735,1428005,573270,1,0,27255,1,0.17443787395119200000
chr3,2267161,2653485,386324,1,0,152330,1,0.25885008438512800000
chr3,1528588,1968641,440053,1,0,,0,0.00000000000000000000
chr3,66332,403433,337101,1,0,10752,1,0.29664699897063500000
chr3,2239674,2516474,276800,1,0,152330,1,0.36127167630057800000
chr3,1264545,1487422,222877,1,0,27255,1,0.44867797036033300000
chr3,423259,583255,159996,1,0,10752,1,0.62501562539063500000
chr3,65062,226972,161910,1,0,,0,0.00000000000000000000
chr3,1103895,1269692,165797,1,0,27255,1,0.60314722220546800000
chr3,1482063,1661028,178965,1,0,,0,0.00000000000000000000
chr3,965416,1115406,149990,1,0,,0,0.00000000000000000000
chr3,1806103,1911982,105879,1,0,,0,0.00000000000000000000
chr3,2025791,2169358,143567,1,0,152330,1,0.69653889821477100000
chr3,1592507,1720053,127546,1,0,,0,0.00000000000000000000
chr3,284497,421324,136827,1,0,10752,1,0.73084990535493700000
chr3,107539,193241,85702,1,0,,0,0.00000000000000000000
chr3,254332,313494,59162,1,0,10752,1,1.69027416246915000000
chr3,73109,127557,54448,1,0,,0,0.00000000000000000000
chr3,1084162,1143170,59008,1,0,27255,1,1.69468546637744000000
chr3,612262,659112,46850,1,0,,0,0.00000000000000000000
chr3,61078,103870,42792,1,0,,0,0.00000000000000000000
chr3,284019,318596,34577,1,0,10752,1,2.89209590190011000000
chr3,2504407,2528226,23819,1,0,152330,1,4.19832906503212000000
chr3,313586,326698,13112,1,0,10752,1,7.62660158633313000000
chr3,1913299,1926283,12984,1,0,,0,0.00000000000000000000
chr3,228882,234350,5468,1,0,,0,0.00000000000000000000
chr3,1782358,1788539,6181,1,0,,0,0.00000000000000000000
chr3,4335167,4409900,74733,1,0,285362;6419,2,2.67619391701123000000
chr3,5246796,5458659,211863,1,0,9695,1,0.47200313410081000000
chr3,5577436,5708668,131232,1,0,,0,0.00000000000000000000
chr3,6316543,6337825,21282,1,0,,0,0.00000000000000000000
chr3,6320485,6338515,18030,1,0,,0,0.00000000000000000000
chr3,6772185,7423110,650925,1,0,2917,1,0.15362753005338600000
chr3,7599930,7816311,216381,1,0,2917,1,0.46214778561888500000
chr3,8453361,8454366,1005,1,0,,0,0.00000000000000000000
chr3,8601016,8601919,903,1,0,29995,1,110.74197120708700000000
chr3,8821709,8862623,40914,1,0,,0,0.00000000000000000000
chr3,12629875,12809237,179362,1,0,55287;5894,2,1.11506339135380000000
chr3,13040083,13048790,8707,1,0,9922,1,11.48501205926270000000
chr3,13217153,13253367,36214,1,0,,0,0.00000000000000000000
chr3,13744522,13757457,12935,1,0,,0,0.00000000000000000000
chr3,15845204,15846456,1252,1,0,23243,1,79.87220447284340000000
chr3,18946549,18952846,6297,1,0,,0,0.00000000000000000000
chr3,21249362,21347128,97766,1,0,,0,0.00000000000000000000
chr3,25030868,25032226,1358,1,0,5915,1,73.63770250368190000000
chr3,26021648,26143512,121864,1,0,,0,0.00000000000000000000
chr3,26427561,26442679,15118,1,0,,0,0.00000000000000000000
chr3,26432365,26439434,7069,1,0,,0,0.00000000000000000000
chr3,26450983,26452252,1269,1,0,,0,0.00000000000000000000
chr3,28465901,28727854,261953,1,0,152098,1,0.38174787080125100000
chr3,32102023,32119760,17737,1,0,,0,0.00000000000000000000
chr3,32102078,32107945,5867,1,0,,0,0.00000000000000000000
chr3,35801040,35943025,141985,1,0,10777,1,0.70429974997358900000
chr3,41915162,42204149,288987,1,0,22906;54986,2,0.69207265378719500000
chr3,43704877,43720592,15715,1,0,55129,1,6.36334712058543000000
chr3,46799188,46854086,54898,1,0,,0,0.00000000000000000000
chr3,46789786,46815538,25752,1,0,,0,0.00000000000000000000
chr3,47233536,47256865,23329,1,0,,0,0.00000000000000000000
chr3,47907639,48036815,129176,1,0,4134,1,0.77413761070167800000
chr3,49721361,49734351,12990,1,0,63891;4485,2,15.39645881447270000000
chr3,49721399,49726478,5079,1,0,4485,1,19.68891514077570000000
chr3,50123797,50124736,939,1,0,,0,0.00000000000000000000
chr3,50410194,50411846,1652,1,0,9254,1,60.53268765133170000000
chr3,53724913,53926056,201143,1,0,776;58515;93973;55540;55349,5,2.48579368906698000000
chr3,60390737,60580781,190044,1,0,2272,1,0.52619393403632800000
chr3,61577950,61629813,51863,1,0,5793,1,1.92815687484334000000
chr3,61136304,61187579,51275,1,0,2272,1,1.95026816187226000000
chr3,62946099,63195469,249370,1,0,,0,0.00000000000000000000
chr3,62941958,63077128,135170,1,0,,0,0.00000000000000000000
chr3,64533162,64535755,2593,1,0,56999,1,38.56536829926730000000
chr3,65117906,65119672,1766,1,0,,0,0.00000000000000000000
chr3,65886903,65966549,79646,1,0,9223,1,1.25555583456796000000
chr3,68625945,68657149,31204,1,0,,0,0.00000000000000000000
chr3,68732304,68747726,15422,1,0,,0,0.00000000000000000000
chr3,68739789,68747894,8105,1,0,,0,0.00000000000000000000
chr3,68746181,68747413,1232,1,0,,0,0.00000000000000000000
chr3,69155101,69171142,16041,1,0,56203;10550,2,12.46805062028550000000
chr3,74136397,74195836,59439,1,0,,0,0.00000000000000000000
chr3,75271458,75280323,8865,1,0,,0,0.00000000000000000000
chr3,75490677,75884528,393851,1,0,100131827;100288801,2,0.50780625160276300000
chr3,75412186,75660728,248542,1,0,,0,0.00000000000000000000
chr3,75512069,75625382,113313,1,0,,0,0.00000000000000000000
chr3,75668151,75765701,97550,1,0,100288801,1,1.02511532547412000000
chr3,75710951,75803473,92522,1,0,100131827;100288801,2,2.16164804046605000000
chr3,75532876,75591920,59044,1,0,,0,0.00000000000000000000
chr3,75833916,75886760,52844,1,0,100131827,1,1.89236242525168000000
chr3,75755566,75802397,46831,1,0,100131827,1,2.13533770365783000000
chr3,75766218,75793587,27369,1,0,100131827,1,3.65376886258175000000
chr3,75573827,75593591,19764,1,0,,0,0.00000000000000000000
chr3,75598570,75614384,15814,1,0,,0,0.00000000000000000000
chr3,75984241,75998092,13851,1,0,6092,1,7.21969532885712000000
chr3,76057833,76259299,201466,1,0,6092,1,0.49636166896647600000
chr3,76723369,76818117,94748,1,0,6092,1,1.05543124920843000000
chr3,77338917,77346180,7263,1,0,6092,1,13.76841525540410000000
chr3,78460435,78476012,15577,1,0,,0,0.00000000000000000000
chr3,80061583,80064416,2833,1,0,,0,0.00000000000000000000
chr3,80062938,80064322,1384,1,0,,0,0.00000000000000000000
chr3,80493928,80562034,68106,1,0,,0,0.00000000000000000000
chr3,81908897,81923843,14946,1,0,,0,0.00000000000000000000
chr3,84105626,84822039,716413,1,0,,0,0.00000000000000000000
chr3,84200533,84560784,360251,1,0,,0,0.00000000000000000000
chr3,84104998,84107286,2288,1,0,,0,0.00000000000000000000
chr3,86700294,86782921,82627,1,0,,0,0.00000000000000000000
chr3,87948471,88004743,56272,1,0,3355,1,1.77708274097242000000
chr3,89367725,89461234,93509,1,0,2042,1,1.06941577816039000000
chr3,89389937,89423158,33221,1,0,2042,1,3.01014418590650000000
chr3,89850276,90177384,327108,1,0,,0,0.00000000000000000000
chr3,89944873,90089377,144504,1,0,,0,0.00000000000000000000
chr3,90306715,90502558,195843,1,0,,0,0.00000000000000000000
chr3,90443601,90504800,61199,1,0,,0,0.00000000000000000000
chr3,94294076,94298365,4289,1,0,,0,0.00000000000000000000
chr3,94512427,94513945,1518,1,0,,0,0.00000000000000000000
chr3,96336840,96346965,10125,1,0,,0,0.00000000000000000000
chr3,97899419,97939393,39974,1,0,,0,0.00000000000000000000
chr3,98410626,98414846,4220,1,0,,0,0.00000000000000000000
chr3,98946486,99008598,62112,1,0,,0,0.00000000000000000000
chr3,98899189,98902420,3231,1,0,,0,0.00000000000000000000
chr3,99207352,99216748,9396,1,0,,0,0.00000000000000000000
chr3,100330027,100443745,113718,1,0,84873;10342,2,1.75873652368139000000
chr3,100354246,100384556,30310,1,0,84873,1,3.29924117452986000000
chr3,112115134,112259098,143964,1,0,64422;151888,2,1.38923619793837000000
chr3,118718361,118863770,145409,1,0,152404,1,0.68771534086610900000
chr3,118774435,118819086,44651,1,0,152404,1,2.23959149851067000000
chr3,118715373,118775643,60270,1,0,152404,1,1.65920026547204000000
chr3,121125773,121434434,308661,1,0,2804;503582;10721;3059;9515;51725,6,1.94388017922575000000
chr3,121214301,121362411,148110,1,0,503582;51725;10721;3059,4,2.70069542907299000000
chr3,121289899,121390271,100372,1,0,2804;503582;51725;3059,4,3.98517514844777000000
chr3,125004347,125862566,858219,1,0,7707;200810;54946;152015;8723;114885;10840,7,0.81564262734803100000
chr3,125421650,125674169,252519,1,0,200810,1,0.39600980520277700000
chr3,125403039,125470785,67746,1,0,,0,0.00000000000000000000
chr3,125438081,125461164,23083,1,0,,0,0.00000000000000000000
chr3,125398917,125399907,990,1,0,,0,0.00000000000000000000
chr3,124936376,124936985,609,1,0,,0,0.00000000000000000000
chr3,125399220,125399694,474,1,0,,0,0.00000000000000000000
chr3,126234394,126235747,1353,1,0,131669,1,73.90983000739100000000
chr3,128357005,128417803,60798,1,0,6184,1,1.64479094707063000000
chr3,128380557,128413028,32471,1,0,,0,0.00000000000000000000
chr3,128379304,128403753,24449,1,0,,0,0.00000000000000000000
chr3,128401783,128412446,10663,1,0,,0,0.00000000000000000000
chr3,128403845,128415090,11245,1,0,,0,0.00000000000000000000
chr3,128379327,128380278,951,1,0,,0,0.00000000000000000000
chr3,129728355,129929331,200976,1,0,644974,1,0.49757184937505000000
chr3,129814164,129890419,76255,1,0,644974,1,1.31138941708740000000
chr3,129755980,129811514,55534,1,0,644974,1,1.80069867108438000000
chr3,129762783,129799975,37192,1,0,,0,0.00000000000000000000
chr3,129778373,129805766,27393,1,0,644974,1,3.65056766327164000000
chr3,129768077,129792974,24897,1,0,,0,0.00000000000000000000
chr3,129790144,129810014,19870,1,0,644974,1,5.03271263210871000000
chr3,129784668,129798336,13668,1,0,,0,0.00000000000000000000
chr3,129784358,129792664,8306,1,0,,0,0.00000000000000000000
chr3,129789157,129798830,9673,1,0,,0,0.00000000000000000000
chr3,131989532,131994150,4618,1,0,,0,0.00000000000000000000
chr3,133132004,133136826,4822,1,0,8419,1,20.73828287017830000000
chr3,133138012,133140443,2431,1,0,8419,1,41.13533525298230000000
chr3,136021245,136031478,10233,1,0,5096,1,9.77230528681716000000
chr3,136020949,136026225,5276,1,0,5096,1,18.95375284306290000000
chr3,137583848,137600397,16549,1,0,,0,0.00000000000000000000
chr3,137777143,137805842,28699,1,0,199221,1,3.48444196661905000000
chr3,137864788,137935661,70873,1,0,51163;25852,2,2.82194912025736000000
chr3,138260390,138746535,486145,1,0,5291;668;55179;401089;729627;389151;80321,7,1.43989961842660000000
chr3,138173046,138352707,179661,1,0,80321;55179;83850,3,1.66981147828410000000
chr3,140014229,140189522,175293,1,0,64084,1,0.57047343590445700000
chr3,140544475,140547052,2577,1,0,,0,0.00000000000000000000
chr3,141837508,142076194,238686,1,0,256356;54464;7029,3,1.25688142580629000000
chr3,142765016,142809951,44935,1,0,23350,1,2.22543674196061000000
chr3,146385203,146390571,5368,1,0,,0,0.00000000000000000000
chr3,150143052,150147325,4273,1,0,9819,1,23.40276152586010000000
chr3,151311572,151392171,80599,1,0,,0,0.00000000000000000000
chr3,155478463,155520300,41837,1,0,285315,1,2.39022874489089000000
chr3,155477711,155498329,20618,1,0,285315,1,4.85013095353575000000
chr3,155482106,155497695,15589,1,0,285315,1,6.41477965231894000000
chr3,158131981,158385353,253372,1,0,4291;51319;85476;56925,4,1.57870640796931000000
chr3,159257020,159257647,627,1,0,100505385;29970,2,318.97926634768700000000
chr3,159596021,159658518,62497,1,0,100505385;29970,2,3.20015360737315000000
chr3,162509703,162626307,116604,1,0,,0,0.00000000000000000000
chr3,162541075,162627770,86695,1,0,,0,0.00000000000000000000
chr3,162512238,162604214,91976,1,0,,0,0.00000000000000000000
chr3,161872204,161955849,83645,1,0,,0,0.00000000000000000000
chr3,162545921,162607251,61330,1,0,,0,0.00000000000000000000
chr3,162512906,162565200,52294,1,0,,0,0.00000000000000000000
chr3,162511582,162540298,28716,1,0,,0,0.00000000000000000000
chr3,162509635,162525647,16012,1,0,,0,0.00000000000000000000
chr3,162765123,162769093,3970,1,0,,0,0.00000000000000000000
chr3,163669802,163672414,2612,1,0,,0,0.00000000000000000000
chr3,164267959,164299963,32004,1,0,,0,0.00000000000000000000
chr3,164696499,164799079,102580,1,0,6476,1,0.97484889842074500000
chr3,165784436,165944023,159587,1,0,,0,0.00000000000000000000
chr3,166122430,166140413,17983,1,0,,0,0.00000000000000000000
chr3,166090773,166094198,3425,1,0,,0,0.00000000000000000000
chr3,166520597,166537403,16806,1,0,,0,0.00000000000000000000
chr3,166525303,166532495,7192,1,0,,0,0.00000000000000000000
chr3,169426864,169433601,6737,1,0,,0,0.00000000000000000000
chr3,170389773,170556398,166625,1,0,,0,0.00000000000000000000
chr3,171892218,171893193,975,1,0,64778,1,102.56410256410300000000
chr3,173228282,173304670,76388,1,0,22871,1,1.30910614232602000000
chr3,173251324,173300180,48856,1,0,22871,1,2.04683150483052000000
chr3,173628003,173707520,79517,1,0,22871,1,1.25759271602299000000
chr3,175894038,175952926,58888,1,0,,0,0.00000000000000000000
chr3,176688293,176879667,191374,1,0,79718,1,0.52253702174799100000
chr3,176521107,176593083,71976,1,0,,0,0.00000000000000000000
chr3,176693691,176707927,14236,1,0,,0,0.00000000000000000000
chr3,178550170,178550885,715,1,0,10242,1,139.86013986014000000000
chr3,178921568,178922280,712,1,0,5290,1,140.44943820224700000000
chr3,183601783,183609950,8167,1,0,55486,1,12.24439818782910000000
chr3,184559714,184608313,48599,1,0,23355,1,2.05765550731497000000
chr3,184470894,184472268,1374,1,0,,0,0.00000000000000000000
chr3,187580980,187613477,32497,1,0,,0,0.00000000000000000000
chr3,187732960,187734817,1857,1,0,,0,0.00000000000000000000
chr3,188074390,188092104,17714,1,0,4026,1,5.64525234277972000000
chr3,189737162,189740739,3577,1,0,55214,1,27.95638803466590000000
chr3,190969418,191271226,301808,1,0,344901;257313;152137;152138,4,1.32534591528389000000
chr3,191064484,191071734,7250,1,0,152137,1,13.79310344827590000000
chr3,191988493,191997178,8685,1,0,2257,1,11.51410477835350000000
chr3,192873091,192885148,12057,1,0,,0,0.00000000000000000000
chr3,192875351,192885439,10088,1,0,,0,0.00000000000000000000
chr3,192879485,192885551,6066,1,0,,0,0.00000000000000000000
chr3,194236288,194272602,36314,1,0,,0,0.00000000000000000000
chr3,194384096,194400303,16207,1,0,55341,1,6.17017338187203000000
chr3,194398682,194400447,1765,1,0,,0,0.00000000000000000000
chr3,194708030,195237488,529458,1,0,23527;152002,2,0.37774478806628700000
chr3,196410871,196702832,291961,1,0,5062;54965;80235;205564;22916;84984,6,2.05506899894164000000
chr3,197570134,197862369,292235,1,0,84223;6165;84859;89782,4,1.36876144199018000000
chr3,197132202,197352288,220086,1,0,622,1,0.45436783802695300000
chr3,197394524,197638445,243921,1,0,9711;84248;84223;84859,4,1.63987520549686000000
chr3,195293112,195475929,182817,1,0,347;4585;200958,3,1.64098524754262000000
chr3,197268058,197439388,171330,1,0,9711;622,2,1.16733788595109000000
chr3,197718252,197885000,166748,1,0,89782;728262,2,1.19941468563341000000
chr3,197564532,197722956,158424,1,0,84223;6165;84859;89782,4,2.52486996919659000000
chr3,195376588,195493533,116945,1,0,200958;4585,2,1.71020565222968000000
chr3,195402836,195474668,71832,1,0,200958;4585,2,2.78427441808665000000
chr3,197212968,197289515,76547,1,0,622,1,1.30638692567965000000
chr3,195667884,195725540,57656,1,0,,0,0.00000000000000000000
chr3,197896185,197962390,66205,1,0,728262,1,1.51045993505022000000
chr3,197845564,197893887,48323,1,0,728262,1,2.06940794238768000000
chr3,195383343,195442696,59353,1,0,,0,0.00000000000000000000
chr3,195429800,195474397,44597,1,0,200958;4585,2,4.48460658788708000000
chr3,197348050,197394916,46866,1,0,,0,0.00000000000000000000
chr3,195198439,195235974,37535,1,0,,0,0.00000000000000000000
chr3,195444182,195472656,28474,1,0,200958,1,3.51197583760624000000
chr3,195417833,195445821,27988,1,0,,0,0.00000000000000000000
chr3,197864539,197895443,30904,1,0,728262,1,3.23582707740098000000
chr3,197772753,197806124,33371,1,0,,0,0.00000000000000000000
chr3,197667547,197687490,19943,1,0,84223;6165;89782,3,15.04287218572930000000
chr3,197879237,197907728,28491,1,0,728262,1,3.50988031308132000000
chr3,195710828,195733090,22262,1,0,,0,0.00000000000000000000
chr3,195197292,195211738,14446,1,0,,0,0.00000000000000000000
chr3,197814703,197832948,18245,1,0,,0,0.00000000000000000000
chr3,195455805,195474320,18515,1,0,200958;4585,2,10.80205238995410000000
chr3,195449972,195464621,14649,1,0,200958,1,6.82640453273261000000
chr3,195504659,195515575,10916,1,0,4585,1,9.16086478563576000000
chr3,195340729,195356343,15614,1,0,,0,0.00000000000000000000
chr3,195457240,195467158,9918,1,0,200958,1,10.08267795926600000000
chr3,197109935,197119275,9340,1,0,,0,0.00000000000000000000
chr3,196933936,196942104,8168,1,0,1739,1,12.24289911851130000000
chr3,197825505,197832869,7364,1,0,,0,0.00000000000000000000
chr3,196934757,196939246,4489,1,0,1739,1,22.27667631989310000000
chr3,195473923,195477950,4027,1,0,4585,1,24.83238142537870000000
chr3,195460465,195464853,4388,1,0,,0,0.00000000000000000000
chr3,196555224,196559321,4097,1,0,5062,1,24.40810349035880000000
chr3,197162974,197165510,2536,1,0,,0,0.00000000000000000000
chr3,194786030,194787337,1307,1,0,,0,0.00000000000000000000
chr3,197186283,197187048,765,1,0,,0,0.00000000000000000000
chr3,196061794,196062431,637,1,0,116211,1,156.98587127158600000000
chr4,30270,132502,102232,1,0,152687;255403,2,1.95633461147195000000
chr4,126240,240099,113859,1,0,255403,1,0.87827927524394200000
chr4,308118,407635,99517,1,0,7700,1,1.00485344212547000000
chr4,21957,87823,65866,1,0,152687,1,1.51823399022257000000
chr4,66847,132670,65823,1,0,152687;255403,2,3.03845160506206000000
chr4,14430,66685,52255,1,0,152687,1,1.91369246962013000000
chr4,68025,113281,45256,1,0,152687,1,2.20965175888280000000
chr4,10379,43490,33111,1,0,,0,0.00000000000000000000
chr4,152769,183508,30739,1,0,255403,1,3.25319626533069000000
chr4,10215,35743,25528,1,0,,0,0.00000000000000000000
chr4,10001,24028,14027,1,0,,0,0.00000000000000000000
chr4,42727,49786,7059,1,0,,0,0.00000000000000000000
chr4,737983,742030,4047,1,0,10336,1,24.70966147763780000000
chr4,1034862,1131809,96947,1,0,285498,1,1.03149143346365000000
chr4,965554,1013297,47743,1,0,1609;53834;10861;3425,4,8.37819156735019000000
chr4,1080354,1081202,848,1,0,285498,1,117.92452830188700000000
chr4,1391241,1392423,1182,1,0,,0,0.00000000000000000000
chr4,1626580,1627594,1014,1,0,,0,0.00000000000000000000
chr4,1602802,1603688,886,1,0,,0,0.00000000000000000000
chr4,2377826,2421983,44157,1,0,57732;402160,2,4.52929320379555000000
chr4,2950945,3026733,75788,1,0,8602;2868,2,2.63894020161503000000
chr4,2972240,3013466,41226,1,0,2868,1,2.42565371367584000000
chr4,3059756,3069436,9680,1,0,,0,0.00000000000000000000
chr4,3342927,3343567,640,1,0,6002,1,156.25000000000000000000
chr4,3545624,3917934,372310,1,0,152,1,0.26859337648733600000
chr4,3897713,4173794,276081,1,0,,0,0.00000000000000000000
chr4,3594411,3707410,112999,1,0,,0,0.00000000000000000000
chr4,3433298,3477823,44525,1,0,6002;285489;3083,3,6.73778775968557000000
chr4,3574339,3602644,28305,1,0,,0,0.00000000000000000000
chr4,4209132,4240128,30996,1,0,133060;85013,2,6.45244547683572000000
chr4,4128156,4152295,24139,1,0,,0,0.00000000000000000000
chr4,4104848,4121453,16605,1,0,,0,0.00000000000000000000
chr4,3467456,3474415,6959,1,0,285489,1,14.36988072998990000000
chr4,3427373,3428043,670,1,0,6002,1,149.25373134328400000000
chr4,5895101,5898874,3773,1,0,,0,0.00000000000000000000
chr4,6651992,6652881,889,1,0,,0,0.00000000000000000000
chr4,6682378,6685289,2911,1,0,,0,0.00000000000000000000
chr4,6777761,6810920,33159,1,0,9778,1,3.01577249012335000000
chr4,6897743,6900088,2345,1,0,,0,0.00000000000000000000
chr4,7166758,7167285,527,1,0,,0,0.00000000000000000000
chr4,7217450,7224910,7460,1,0,57537,1,13.40482573726540000000
chr4,7443350,7444852,1502,1,0,57537,1,66.57789613848200000000
chr4,9544877,10590322,1045445,1,0,116449;85460;56606;1816;9948,5,0.47826523633476700000
chr4,8712204,9472909,760705,1,0,728373;100287205;100287327;100287478;728393;644414;728419;100288520;100287404;728379;728369;100287178;100287441;100287513;728386;100287144;3166;100287238;100287364;728405;728400,21,2.76059707771081000000
chr4,9444833,9753524,308691,1,0,644414,1,0.32394854401326900000
chr4,10043753,10325645,281892,1,0,9948,1,0.35474578916748300000
chr4,9383483,9583335,199852,1,0,644414,1,0.50037027400276200000
chr4,9842120,10017395,175275,1,0,56606,1,0.57053202110968500000
chr4,9508921,9622072,113151,1,0,,0,0.00000000000000000000
chr4,9324682,9474204,149522,1,0,728373;728393;728386;728400;644414;728419;728379;728405;728369,9,6.01918112384800000000
chr4,9631509,9754384,122875,1,0,,0,0.00000000000000000000
chr4,10112855,10220706,107851,1,0,9948,1,0.92720512558993400000
chr4,9324689,9378396,53707,1,0,728373;728393;728386;728400;728419;728379;728405;728369,8,14.89563744018470000000
chr4,9371748,9456417,84669,1,0,644414,1,1.18106981303665000000
chr4,10171844,10239760,67916,1,0,,0,0.00000000000000000000
chr4,10212512,10255808,43296,1,0,,0,0.00000000000000000000
chr4,9371048,9410958,39910,1,0,,0,0.00000000000000000000
chr4,9326485,9363989,37504,1,0,728373;728369;728379;728405;728393;728400;728386,7,18.66467576791810000000
chr4,9417997,9457368,39371,1,0,644414,1,2.53994056539077000000
chr4,10209242,10235191,25949,1,0,,0,0.00000000000000000000
chr4,9485717,9514683,28966,1,0,,0,0.00000000000000000000
chr4,10224033,10242799,18766,1,0,,0,0.00000000000000000000
chr4,9457278,9480845,23567,1,0,,0,0.00000000000000000000
chr4,8621993,8638996,17003,1,0,,0,0.00000000000000000000
chr4,9469141,9485483,16342,1,0,,0,0.00000000000000000000
chr4,10182037,10197521,15484,1,0,,0,0.00000000000000000000
chr4,10136147,10153182,17035,1,0,,0,0.00000000000000000000
chr4,10136085,10137213,1128,1,0,,0,0.00000000000000000000
chr4,14680954,14727260,46306,1,0,,0,0.00000000000000000000
chr4,18725182,18789799,64617,1,0,,0,0.00000000000000000000
chr4,19057458,19057989,531,1,0,,0,0.00000000000000000000
chr4,23648080,23719763,71683,1,0,,0,0.00000000000000000000
chr4,25555983,25581131,25148,1,0,,0,0.00000000000000000000
chr4,29288200,29297651,9451,1,0,,0,0.00000000000000000000
chr4,33299764,33304225,4461,1,0,,0,0.00000000000000000000
chr4,33835895,33847274,11379,1,0,,0,0.00000000000000000000
chr4,34683509,34688710,5201,1,0,,0,0.00000000000000000000
chr4,34773626,34830235,56609,1,0,,0,0.00000000000000000000
chr4,34778888,34820889,42001,1,0,,0,0.00000000000000000000
chr4,39920501,40139267,218766,1,0,55728;23244,2,0.91421884570728500000
chr4,39982252,40063890,81638,1,0,55728,1,1.22491976775521000000
chr4,40674687,40779802,105115,1,0,79730,1,0.95133900965609100000
chr4,40749612,40841494,91882,1,0,323;79730,2,2.17670490411615000000
chr4,43377377,43686029,308652,1,0,,0,0.00000000000000000000
chr4,44965860,45007696,41836,1,0,,0,0.00000000000000000000
chr4,44958136,44981040,22904,1,0,,0,0.00000000000000000000
chr4,45783835,45811162,27327,1,0,,0,0.00000000000000000000
chr4,46202858,46205001,2143,1,0,,0,0.00000000000000000000
chr4,49103571,49302043,198472,1,0,,0,0.00000000000000000000
chr4,49513877,49655439,141562,1,0,,0,0.00000000000000000000
chr4,49192092,49325551,133459,1,0,,0,0.00000000000000000000
chr4,49085801,49176035,90234,1,0,,0,0.00000000000000000000
chr4,49125413,49197600,72187,1,0,,0,0.00000000000000000000
chr4,49546458,49615441,68983,1,0,,0,0.00000000000000000000
chr4,49273520,49333243,59723,1,0,,0,0.00000000000000000000
chr4,49617846,49660115,42269,1,0,,0,0.00000000000000000000
chr4,49489242,49524812,35570,1,0,,0,0.00000000000000000000
chr4,49560212,49589820,29608,1,0,,0,0.00000000000000000000
chr4,49633127,49659886,26759,1,0,,0,0.00000000000000000000
chr4,49511921,49521495,9574,1,0,,0,0.00000000000000000000
chr4,49512455,49514726,2271,1,0,,0,0.00000000000000000000
chr4,52660212,52683233,23021,1,0,,0,0.00000000000000000000
chr4,54591392,54603209,11817,1,0,,0,0.00000000000000000000
chr4,55439563,55511972,72409,1,0,,0,0.00000000000000000000
chr4,58045781,58101533,55752,1,0,,0,0.00000000000000000000
chr4,59972575,59988411,15836,1,0,,0,0.00000000000000000000
chr4,60236982,61770129,1533147,1,0,,0,0.00000000000000000000
chr4,60540296,60895824,355528,1,0,,0,0.00000000000000000000
chr4,60325205,60338255,13050,1,0,,0,0.00000000000000000000
chr4,60324153,60330809,6656,1,0,,0,0.00000000000000000000
chr4,61330251,61331890,1639,1,0,,0,0.00000000000000000000
chr4,60816245,60817727,1482,1,0,,0,0.00000000000000000000
chr4,61939202,61942233,3031,1,0,,0,0.00000000000000000000
chr4,62498860,62499695,835,1,0,23284,1,119.76047904191600000000
chr4,63582123,64138312,556189,1,0,,0,0.00000000000000000000
chr4,63025743,63521365,495622,1,0,,0,0.00000000000000000000
chr4,63889117,64139415,250298,1,0,,0,0.00000000000000000000
chr4,63647129,63679630,32501,1,0,,0,0.00000000000000000000
chr4,64690789,64716596,25807,1,0,,0,0.00000000000000000000
chr4,64700051,64712904,12853,1,0,,0,0.00000000000000000000
chr4,64700124,64710124,10000,1,0,,0,0.00000000000000000000
chr4,65719094,65719583,489,1,0,,0,0.00000000000000000000
chr4,66021420,66041376,19956,1,0,,0,0.00000000000000000000
chr4,66586933,66642768,55835,1,0,,0,0.00000000000000000000
chr4,66591050,66630441,39391,1,0,,0,0.00000000000000000000
chr4,66607183,66627994,20811,1,0,,0,0.00000000000000000000
chr4,67659522,67676404,16882,1,0,,0,0.00000000000000000000
chr4,68263907,68269746,5839,1,0,,0,0.00000000000000000000
chr4,68264353,68267158,2805,1,0,,0,0.00000000000000000000
chr4,68741106,69012151,271045,1,0,339967;389208;9407,3,1.10682727960302000000
chr4,69296139,69516915,220776,1,0,28983;7367;7366,3,1.35884335253832000000
chr4,69374643,69583963,209320,1,0,7366;7367,2,0.95547487101089200000
chr4,69370568,69490300,119732,1,0,7367,1,0.83519861022951300000
chr4,69435889,69540693,104804,1,0,7366,1,0.95416205488340100000
chr4,69434028,69486981,52953,1,0,7367,1,1.88846713122958000000
chr4,69491860,69537946,46086,1,0,7366,1,2.16985635550927000000
chr4,69430740,69472408,41668,1,0,7367,1,2.39992320245752000000
chr4,69380623,69421192,40569,1,0,7367,1,2.46493628139713000000
chr4,70036163,70250381,214218,1,0,54490;10720,2,0.93362835989506000000
chr4,70125560,70242273,116713,1,0,54490,1,0.85680258411659400000
chr4,70029241,70181724,152483,1,0,54490;10720,2,1.31162162339408000000
chr4,70128671,70206288,77617,1,0,54490,1,1.28837754615613000000
chr4,70238055,70318534,80479,1,0,,0,0.00000000000000000000
chr4,70073350,70123847,50497,1,0,10720,1,1.98031566231657000000
chr4,70118205,70167601,49396,1,0,54490,1,2.02445542149162000000
chr4,69671998,69718989,46991,1,0,7365,1,2.12806707667426000000
chr4,70031677,70075881,44204,1,0,10720,1,2.26223871142883000000
chr4,70292192,70317912,25720,1,0,,0,0.00000000000000000000
chr4,72008721,72061902,53181,1,0,8671,1,1.88037080912356000000
chr4,74777470,75050010,272540,1,0,5196;441024;6374;2921;2920;5473,6,2.20151170470390000000
chr4,76187438,76392895,205457,1,0,,0,0.00000000000000000000
chr4,78277450,78288913,11463,1,0,,0,0.00000000000000000000
chr4,78276555,78281343,4788,1,0,,0,0.00000000000000000000
chr4,80857048,80887833,30785,1,0,118429,1,3.24833522819555000000
chr4,81547134,81604444,57310,1,0,255119,1,1.74489617867737000000
chr4,82443913,82552181,108268,1,0,,0,0.00000000000000000000
chr4,89021115,89077257,56142,1,0,9429,1,1.78119767731823000000
chr4,90101722,90107788,6066,1,0,,0,0.00000000000000000000
chr4,92187940,92257969,70029,1,0,401145,1,1.42797983692470000000
chr4,92392152,93222515,830363,1,0,401145,1,0.12042925804738400000
chr4,92379081,92898309,519228,1,0,401145,1,0.19259361975856500000
chr4,94048325,94111596,63271,1,0,2895,1,1.58050291602788000000
chr4,98354484,98358435,3951,1,0,,0,0.00000000000000000000
chr4,98742651,98863602,120951,1,0,285555,1,0.82678109316996100000
chr4,98947231,98965702,18471,1,0,285555,1,5.41389204699258000000
chr4,99147215,99435188,287973,1,0,5910;10098,2,0.69450955471519900000
chr4,99813410,99817175,3765,1,0,1977,1,26.56042496679950000000
chr4,100869249,100872047,2798,1,0,3015,1,35.73981415296640000000
chr4,101960197,101961080,883,1,0,5530,1,113.25028312570800000000
chr4,103808243,103819296,11053,1,0,493856;150159,2,18.09463494074010000000
chr4,104894092,104894637,545,1,0,,0,0.00000000000000000000
chr4,107023333,107057075,33742,1,0,93627,1,2.96366546144271000000
chr4,107056567,107063246,6679,1,0,93627,1,14.97230124270100000000
chr4,107281858,107398277,116419,1,0,100507096,1,0.85896631993059500000
chr4,109720672,109722010,1338,1,0,,0,0.00000000000000000000
chr4,115162596,115182642,20046,1,0,,0,0.00000000000000000000
chr4,115174840,115190003,15163,1,0,,0,0.00000000000000000000
chr4,115173197,115183948,10751,1,0,,0,0.00000000000000000000
chr4,115175192,115181657,6465,1,0,,0,0.00000000000000000000
chr4,115179249,115182300,3051,1,0,,0,0.00000000000000000000
chr4,115441560,115492098,50538,1,0,,0,0.00000000000000000000
chr4,115507932,115513687,5755,1,0,,0,0.00000000000000000000
chr4,115928721,115931894,3173,1,0,64579,1,31.51591553734640000000
chr4,115928713,115929276,563,1,0,64579,1,177.61989342806400000000
chr4,117289738,117344323,54585,1,0,,0,0.00000000000000000000
chr4,119552399,119584340,31941,1,0,,0,0.00000000000000000000
chr4,119338179,119366741,28562,1,0,,0,0.00000000000000000000
chr4,119981892,120126520,144628,1,0,51778;171024,2,1.38285809110269000000
chr4,120487344,120698333,210989,1,0,8654,1,0.47395835801866400000
chr4,122938162,123174172,236010,1,0,84162,1,0.42371085970933400000
chr4,126606239,126624524,18285,1,0,,0,0.00000000000000000000
chr4,128835954,129087556,251602,1,0,55132;256471;80167,3,1.19235936121334000000
chr4,129771713,129953399,181686,1,0,132320;79960,2,1.10080028180487000000
chr4,131938367,132361775,423408,1,0,,0,0.00000000000000000000
chr4,132641337,132897533,256196,1,0,,0,0.00000000000000000000
chr4,131947462,132054803,107341,1,0,,0,0.00000000000000000000
chr4,132586317,132660524,74207,1,0,,0,0.00000000000000000000
chr4,132828045,132901888,73843,1,0,,0,0.00000000000000000000
chr4,132592881,132638910,46029,1,0,,0,0.00000000000000000000
chr4,132640805,132686975,46170,1,0,,0,0.00000000000000000000
chr4,132664901,132684280,19379,1,0,,0,0.00000000000000000000
chr4,133786687,133819078,32391,1,0,,0,0.00000000000000000000
chr4,135433036,135435718,2682,1,0,,0,0.00000000000000000000
chr4,138180112,138191442,11330,1,0,,0,0.00000000000000000000
chr4,144808304,145014186,205882,1,0,2996;2994,2,0.97143023673754900000
chr4,144919620,145050185,130565,1,0,2993;2994,2,1.53180408225788000000
chr4,144805908,144911321,105413,1,0,2996,1,0.94864959729824600000
chr4,144765426,144837816,72390,1,0,2996,1,1.38140627158447000000
chr4,144709860,144754924,45064,1,0,,0,0.00000000000000000000
chr4,144956345,145017148,60803,1,0,,0,0.00000000000000000000
chr4,144719630,144746258,26628,1,0,,0,0.00000000000000000000
chr4,145039608,145066250,26642,1,0,2993,1,3.75347196156445000000
chr4,144704172,144728275,24103,1,0,,0,0.00000000000000000000
chr4,145021875,145039073,17198,1,0,2993,1,5.81462960809396000000
chr4,151675113,152070985,395872,1,0,152503;6189;987,3,0.75782070972435500000
chr4,152778492,152779012,520,1,0,,0,0.00000000000000000000
chr4,154332729,154918179,585450,1,0,285533;7097;84057;6423;23240,5,0.85404389785635000000
chr4,158162088,158223985,61897,1,0,2891,1,1.61558718516245000000
chr4,163284113,163390348,106235,1,0,,0,0.00000000000000000000
chr4,161876297,161932948,56651,1,0,,0,0.00000000000000000000
chr4,161951736,162006886,55150,1,0,,0,0.00000000000000000000
chr4,161873345,161885919,12574,1,0,,0,0.00000000000000000000
chr4,161878984,161885006,6022,1,0,,0,0.00000000000000000000
chr4,162447263,162452224,4961,1,0,56884,1,20.15722636565210000000
chr4,162449581,162451490,1909,1,0,56884,1,52.38344683080150000000
chr4,162053196,162053790,594,1,0,,0,0.00000000000000000000
chr4,165203040,165206164,3124,1,0,55016,1,32.01024327784890000000
chr4,165804330,165829774,25444,1,0,100506013,1,3.93019965414243000000
chr4,165863307,165884540,21233,1,0,152756;391712,2,9.41930014599915000000
chr4,166003443,166004845,1402,1,0,201931,1,71.32667617689020000000
chr4,168809992,168993946,183954,1,0,,0,0.00000000000000000000
chr4,168796401,168856366,59965,1,0,,0,0.00000000000000000000
chr4,168817267,168844004,26737,1,0,,0,0.00000000000000000000
chr4,168109170,168115403,6233,1,0,50859,1,16.04363869725650000000
chr4,169030212,169031118,906,1,0,11199,1,110.37527593819000000000
chr4,171243983,171286995,43012,1,0,,0,0.00000000000000000000
chr4,171842762,171923656,80894,1,0,,0,0.00000000000000000000
chr4,172365448,172378218,12770,1,0,,0,0.00000000000000000000
chr4,172374335,172380537,6202,1,0,,0,0.00000000000000000000
chr4,172966883,172988432,21549,1,0,442117,1,4.64058657014247000000
chr4,172988028,172996074,8046,1,0,442117,1,12.42853591846880000000
chr4,173424924,173434784,9860,1,0,442117,1,10.14198782961460000000
chr4,173425218,173430615,5397,1,0,442117,1,18.52881230313140000000
chr4,180674744,180742763,68019,1,0,,0,0.00000000000000000000
chr4,181167601,181170600,2999,1,0,,0,0.00000000000000000000
chr4,181270093,181274480,4387,1,0,,0,0.00000000000000000000
chr4,181735871,181740515,4644,1,0,,0,0.00000000000000000000
chr4,182160318,182162930,2612,1,0,,0,0.00000000000000000000
chr4,185182745,185226557,43812,1,0,,0,0.00000000000000000000
chr4,185157924,185169751,11827,1,0,,0,0.00000000000000000000
chr4,187686145,189577490,1891345,1,0,205860;132625;339976,3,0.15861728029524000000
chr4,188448899,189059897,610998,1,0,205860;132625,2,0.32733331369333500000
chr4,189889893,190390489,500596,1,0,,0,0.00000000000000000000
chr4,190463917,190709940,246023,1,0,,0,0.00000000000000000000
chr4,189435211,189783149,347938,1,0,,0,0.00000000000000000000
chr4,190258132,190517660,259528,1,0,,0,0.00000000000000000000
chr4,188698095,189072008,373913,1,0,205860;132625;339976,3,0.80232567468903200000
chr4,189183166,189478258,295092,1,0,,0,0.00000000000000000000
chr4,188280621,188536462,255841,1,0,,0,0.00000000000000000000
chr4,190791212,191026229,235017,1,0,2483;448831,2,0.85100226792104400000
chr4,189404036,189620247,216211,1,0,,0,0.00000000000000000000
chr4,190472935,190661312,188377,1,0,,0,0.00000000000000000000
chr4,189780465,189955694,175229,1,0,,0,0.00000000000000000000
chr4,186368770,186524214,155444,1,0,8470;441054;27295;256309,4,2.57327397648028000000
chr4,190540607,190668410,127803,1,0,,0,0.00000000000000000000
chr4,190224907,190323794,98887,1,0,,0,0.00000000000000000000
chr4,190919733,191024210,104477,1,0,448831,1,0.95714846329814200000
chr4,190784074,190893128,109054,1,0,2483,1,0.91697691052139300000
chr4,190470175,190573809,103634,1,0,,0,0.00000000000000000000
chr4,188382430,188449688,67258,1,0,,0,0.00000000000000000000
chr4,186303789,186382339,78550,1,0,441054;256309;353322;55325,4,5.09229789942712000000
chr4,189334897,189388235,53338,1,0,,0,0.00000000000000000000
chr4,190687565,190752430,64865,1,0,,0,0.00000000000000000000
chr4,190258665,190315700,57035,1,0,,0,0.00000000000000000000
chr4,190856652,190897674,41022,1,0,2483,1,2.43771634732583000000
chr4,190567695,190594658,26963,1,0,,0,0.00000000000000000000
chr4,190634887,190653385,18498,1,0,,0,0.00000000000000000000
chr4,191014702,191031399,16697,1,0,,0,0.00000000000000000000
chr4,187861323,187881644,20321,1,0,,0,0.00000000000000000000
chr4,190804704,190819529,14825,1,0,,0,0.00000000000000000000
chr4,187880219,187894794,14575,1,0,,0,0.00000000000000000000
chr4,190193770,190205830,12060,1,0,,0,0.00000000000000000000
chr4,189421224,189430506,9282,1,0,,0,0.00000000000000000000
chr4,190191671,190197843,6172,1,0,,0,0.00000000000000000000
chr4,187353298,187357887,4589,1,0,,0,0.00000000000000000000
chr4,187093540,187098156,4616,1,0,25854,1,21.66377816291160000000
chr4,189072075,189075845,3770,1,0,,0,0.00000000000000000000
chr4,189366062,189370342,4280,1,0,,0,0.00000000000000000000
chr4,190606176,190610266,4090,1,0,,0,0.00000000000000000000
chr4,186441540,186444358,2818,1,0,27295,1,35.48616039744500000000
chr4,190756750,190758783,2033,1,0,,0,0.00000000000000000000
chr4,190766969,190768802,1833,1,0,,0,0.00000000000000000000
chr4,189894787,189896457,1670,1,0,,0,0.00000000000000000000
chr5,679280,849813,170533,1,0,11076;79844,2,1.17279353556203000000
chr5,1060529,1247867,187338,1,0,340024;348932;10723,3,1.60138359542645000000
chr5,21005,173323,152318,1,0,153478,1,0.65652122533121500000
chr5,352354,495898,143544,1,0,6550;57491;11336,3,2.08995151312490000000
chr5,718901,865506,146605,1,0,79844;65980,2,1.36420995191160000000
chr5,486761,636277,149516,1,0,6550;55722,2,1.33764948232965000000
chr5,629026,759556,130530,1,0,11076;55722,2,1.53221481651728000000
chr5,680643,795575,114932,1,0,11076,1,0.87007969930045600000
chr5,584273,681299,97026,1,0,11076;55722,2,2.06130315585513000000
chr5,1003832,1113638,109806,1,0,85409;10723,2,1.82139409504034000000
chr5,800300,864321,64021,1,0,79844;65980,2,3.12397494572094000000
chr5,136790,233850,97060,1,0,133957;153478;6389;389257,4,4.12116216773130000000
chr5,735244,816520,81276,1,0,79844,1,1.23037551060584000000
chr5,326755,400523,73768,1,0,57491,1,1.35560134475653000000
chr5,693930,749171,55241,1,0,,0,0.00000000000000000000
chr5,724918,788574,63656,1,0,,0,0.00000000000000000000
chr5,71919,124503,52584,1,0,,0,0.00000000000000000000
chr5,786664,844111,57447,1,0,79844,1,1.74073493829095000000
chr5,118881,166548,47667,1,0,153478,1,2.09788742736065000000
chr5,550950,598670,47720,1,0,,0,0.00000000000000000000
chr5,763764,814708,50944,1,0,79844,1,1.96293969849246000000
chr5,703020,741720,38700,1,0,,0,0.00000000000000000000
chr5,838139,866450,28311,1,0,79844;65980,2,7.06439193246441000000
chr5,17682,52328,34646,1,0,,0,0.00000000000000000000
chr5,799317,824349,25032,1,0,79844,1,3.99488654522212000000
chr5,723364,748022,24658,1,0,,0,0.00000000000000000000
chr5,824944,847655,22711,1,0,79844,1,4.40315265730263000000
chr5,788138,797769,9631,1,0,79844,1,10.38313778423840000000
chr5,814446,825367,10921,1,0,79844,1,9.15667063455728000000
chr5,1040772,1049139,8367,1,0,,0,0.00000000000000000000
chr5,1069577,1075571,5994,1,0,10723,1,16.68335001668340000000
chr5,1022032,1026982,4950,1,0,85409,1,20.20202020202020000000
chr5,467715,473797,6082,1,0,6550,1,16.44195988161790000000
chr5,896298,900229,3931,1,0,9319,1,25.43881963876880000000
chr5,1070016,1073479,3463,1,0,10723,1,28.87669650591970000000
chr5,100445,102505,2060,1,0,,0,0.00000000000000000000
chr5,83429,85543,2114,1,0,,0,0.00000000000000000000
chr5,1178620,1180322,1702,1,0,,0,0.00000000000000000000
chr5,467476,468857,1381,1,0,,0,0.00000000000000000000
chr5,1170149,1170983,834,1,0,,0,0.00000000000000000000
chr5,474259,474984,725,1,0,6550,1,137.93103448275900000000
chr5,492303,492836,533,1,0,6550,1,187.61726078799300000000
chr5,1333043,1333955,912,1,0,81037,1,109.64912280701800000000
chr5,1663762,1664338,576,1,0,,0,0.00000000000000000000
chr5,2208301,2212500,4199,1,0,,0,0.00000000000000000000
chr5,2490114,2491757,1643,1,0,,0,0.00000000000000000000
chr5,2873791,2874933,1142,1,0,,0,0.00000000000000000000
chr5,3590051,3606550,16499,1,0,79192,1,6.06097339232681000000
chr5,3752298,3978065,225767,1,0,,0,0.00000000000000000000
chr5,4221449,4294504,73055,1,0,,0,0.00000000000000000000
chr5,4950685,5421029,470344,1,0,170690,1,0.21261034476893500000
chr5,5682285,5718728,36443,1,0,,0,0.00000000000000000000
chr5,5690151,5713536,23385,1,0,,0,0.00000000000000000000
chr5,6712185,6715465,3280,1,0,11044,1,30.48780487804880000000
chr5,8017359,8020550,3191,1,0,,0,0.00000000000000000000
chr5,9182398,9816128,633730,1,0,50834;9037,2,0.31559181354835700000
chr5,10273930,10274861,931,1,0,,0,0.00000000000000000000
chr5,10639143,10640182,1039,1,0,651746,1,96.24639076034650000000
chr5,11745403,11764964,19561,1,0,1501,1,5.11221307704105000000
chr5,12780942,13233960,453018,1,0,,0,0.00000000000000000000
chr5,12808171,12898469,90298,1,0,,0,0.00000000000000000000
chr5,13147559,13206846,59287,1,0,,0,0.00000000000000000000
chr5,12781328,12829765,48437,1,0,,0,0.00000000000000000000
chr5,12813152,12831144,17992,1,0,,0,0.00000000000000000000
chr5,13799935,14154838,354903,1,0,1767;7204,2,0.56353426147426200000
chr5,14138248,14148501,10253,1,0,7204,1,9.75324295328197000000
chr5,14142617,14145712,3095,1,0,7204,1,32.31017770597740000000
chr5,14934596,15164350,229754,1,0,,0,0.00000000000000000000
chr5,14995242,15000583,5341,1,0,,0,0.00000000000000000000
chr5,14871840,14872645,805,1,0,56172,1,124.22360248447200000000
chr5,17484149,17656209,172060,1,0,,0,0.00000000000000000000
chr5,17417489,17489087,71598,1,0,,0,0.00000000000000000000
chr5,17480802,17517565,36763,1,0,,0,0.00000000000000000000
chr5,17606431,17620788,14357,1,0,,0,0.00000000000000000000
chr5,17508536,17517271,8735,1,0,,0,0.00000000000000000000
chr5,17600109,17606674,6565,1,0,,0,0.00000000000000000000
chr5,17631199,17634929,3730,1,0,,0,0.00000000000000000000
chr5,17712801,17715800,2999,1,0,,0,0.00000000000000000000
chr5,18609524,18673319,63795,1,0,,0,0.00000000000000000000
chr5,18873813,18981184,107371,1,0,,0,0.00000000000000000000
chr5,19374673,19376549,1876,1,0,,0,0.00000000000000000000
chr5,19375620,19376363,743,1,0,,0,0.00000000000000000000
chr5,19383993,19396462,12469,1,0,,0,0.00000000000000000000
chr5,20832570,20834915,2345,1,0,,0,0.00000000000000000000
chr5,21097004,21181345,84341,1,0,,0,0.00000000000000000000
chr5,21468924,21733331,264407,1,0,,0,0.00000000000000000000
chr5,21270635,21383560,112925,1,0,,0,0.00000000000000000000
chr5,21444997,21519798,74801,1,0,,0,0.00000000000000000000
chr5,21317779,21379928,62149,1,0,,0,0.00000000000000000000
chr5,21517525,21572917,55392,1,0,,0,0.00000000000000000000
chr5,21343796,21393098,49302,1,0,,0,0.00000000000000000000
chr5,21451784,21479721,27937,1,0,,0,0.00000000000000000000
chr5,21498979,21523821,24842,1,0,,0,0.00000000000000000000
chr5,21482328,21497778,15450,1,0,,0,0.00000000000000000000
chr5,21440882,21452501,11619,1,0,,0,0.00000000000000000000
chr5,21477499,21488057,10558,1,0,,0,0.00000000000000000000
chr5,22204577,23787842,1583265,1,0,1010;56979,2,0.12632124123251600000
chr5,22136626,22223827,87201,1,0,1010,1,1.14677583972661000000
chr5,21932018,22013697,81679,1,0,1010,1,1.22430490089252000000
chr5,21935446,21978645,43199,1,0,1010,1,2.31486839973148000000
chr5,23880731,23905134,24403,1,0,,0,0.00000000000000000000
chr5,22125806,22138077,12271,1,0,1010,1,8.14929508597506000000
chr5,22125384,22131249,5865,1,0,1010,1,17.05029838022170000000
chr5,23900270,23904810,4540,1,0,,0,0.00000000000000000000
chr5,23903107,23906122,3015,1,0,,0,0.00000000000000000000
chr5,26125447,26227874,102427,1,0,,0,0.00000000000000000000
chr5,26794935,26802354,7419,1,0,,0,0.00000000000000000000
chr5,28213967,28321236,107269,1,0,,0,0.00000000000000000000
chr5,28490969,28495543,4574,1,0,,0,0.00000000000000000000
chr5,29430688,29458930,28242,1,0,,0,0.00000000000000000000
chr5,29622489,29637087,14598,1,0,,0,0.00000000000000000000
chr5,31135050,31452135,317085,1,0,1004;29102,2,0.63074569910276400000
chr5,31935058,32126333,191275,1,0,23037;64083,2,1.04561495229382000000
chr5,32102676,32202739,100063,1,0,23037;64083,2,1.99874079330022000000
chr5,32107903,32155781,47878,1,0,23037;64083,2,4.17728392998872000000
chr5,32105525,32127093,21568,1,0,23037;64083,2,9.27299703264095000000
chr5,32620557,32724036,103479,1,0,4883,1,0.96637965191004900000
chr5,33280502,33574682,294180,1,0,6897;81792,2,0.67985587055544200000
chr5,34258998,34564136,305138,1,0,,0,0.00000000000000000000
chr5,34934772,35064147,129375,1,0,134218;5618;64902,3,2.31884057971015000000
chr5,34179600,34259440,79840,1,0,,0,0.00000000000000000000
chr5,34257918,34325284,67366,1,0,,0,0.00000000000000000000
chr5,34197493,34257700,60207,1,0,,0,0.00000000000000000000
chr5,34195913,34210719,14806,1,0,,0,0.00000000000000000000
chr5,34178782,34197398,18616,1,0,,0,0.00000000000000000000
chr5,34247406,34252897,5491,1,0,,0,0.00000000000000000000
chr5,36242903,36377435,134532,1,0,202151,1,0.74331757500074300000
chr5,35497998,35564595,66597,1,0,,0,0.00000000000000000000
chr5,37185074,37550816,365742,1,0,65250;9631;55100,3,0.82025034040389100000
chr5,37395079,37523694,128615,1,0,55100,1,0.77751428682502000000
chr5,37537749,37597777,60028,1,0,55100,1,1.66588925168255000000
chr5,42616088,42815184,199096,1,0,100129792;2690;6414,3,1.50681078474706000000
chr5,42492859,42674541,181682,1,0,2690,1,0.55041225878182800000
chr5,45004817,45014230,9413,1,0,,0,0.00000000000000000000
chr5,45575082,46328622,753540,1,0,348980,1,0.13270695649866000000
chr5,46109619,46390222,280603,1,0,,0,0.00000000000000000000
chr5,46271565,46405359,133794,1,0,,0,0.00000000000000000000
chr5,46209387,46289253,79866,1,0,,0,0.00000000000000000000
chr5,46247822,46310373,62551,1,0,,0,0.00000000000000000000
chr5,46268147,46275802,7655,1,0,,0,0.00000000000000000000
chr5,46270889,46275722,4833,1,0,,0,0.00000000000000000000
chr5,49469384,49626393,157009,1,0,,0,0.00000000000000000000
chr5,49405763,49550474,144711,1,0,,0,0.00000000000000000000
chr5,49886032,49982645,96613,1,0,79668,1,1.03505739393249000000
chr5,49405763,49485157,79394,1,0,,0,0.00000000000000000000
chr5,49405763,49441299,35536,1,0,,0,0.00000000000000000000
chr5,51198180,51225534,27354,1,0,,0,0.00000000000000000000
chr5,52458908,52459730,822,1,0,,0,0.00000000000000000000
chr5,53688156,53694142,5986,1,0,,0,0.00000000000000000000
chr5,57320371,57338138,17767,1,0,,0,0.00000000000000000000
chr5,57324018,57337391,13373,1,0,,0,0.00000000000000000000
chr5,57323763,57333682,9919,1,0,,0,0.00000000000000000000
chr5,59703559,59773442,69883,1,0,5144,1,1.43096318131734000000
chr5,59719419,59763826,44407,1,0,5144,1,2.25189722341072000000
chr5,60001737,60003644,1907,1,0,,0,0.00000000000000000000
chr5,60625377,60629516,4139,1,0,57688,1,24.16042522348390000000
chr5,61624616,61848188,223572,1,0,27292;3796;51194,3,1.34184960549622000000
chr5,61508733,61554031,45298,1,0,,0,0.00000000000000000000
chr5,63698307,63701409,3102,1,0,,0,0.00000000000000000000
chr5,65028298,65030613,2315,1,0,57486,1,43.19654427645790000000
chr5,68590887,68645318,54431,1,0,202243,1,1.83718836692326000000
chr5,68966246,70392112,1425866,1,0,6607;2966;6606;8293;728492;4671,6,0.42079690517902800000
chr5,69837417,70447399,609982,1,0,4671;8293;2966;6606,4,0.65575705512621700000
chr5,68960761,69520311,559550,1,0,6607;728492,2,0.35743007774104200000
chr5,70106015,70491087,385072,1,0,4671;8293;2966;6606,4,1.03876677608343000000
chr5,68838441,69137650,299209,1,0,100506658;728340,2,0.66842909137091500000
chr5,69524393,69778239,253846,1,0,,0,0.00000000000000000000
chr5,69221021,69468771,247750,1,0,6607;728492,2,0.80726538849646800000
chr5,70190596,70398340,207744,1,0,4671;8293;2966;6606,4,1.92544670363524000000
chr5,69845718,70049273,203555,1,0,,0,0.00000000000000000000
chr5,68981491,69163846,182355,1,0,,0,0.00000000000000000000
chr5,70110168,70282513,172345,1,0,4671;8293;6606,3,1.74069453712031000000
chr5,69571994,69760738,188744,1,0,,0,0.00000000000000000000
chr5,69608771,69775181,166410,1,0,,0,0.00000000000000000000
chr5,70533966,70678436,144470,1,0,,0,0.00000000000000000000
chr5,69279761,69394623,114862,1,0,6607;728492,2,1.74121989866100000000
chr5,68832097,68920868,88771,1,0,100506658;728340,2,2.25298802536865000000
chr5,70390946,70494889,103943,1,0,,0,0.00000000000000000000
chr5,70285787,70383762,97975,1,0,2966;4671,2,2.04133707578464000000
chr5,70176732,70271392,94660,1,0,4671;8293;6606,3,3.16923727023030000000
chr5,70312460,70410610,98150,1,0,2966;4671,2,2.03769740193581000000
chr5,69220483,69311039,90556,1,0,,0,0.00000000000000000000
chr5,68977303,69083084,105781,1,0,,0,0.00000000000000000000
chr5,69329618,69415936,86318,1,0,6607;728492,2,2.31701383257258000000
chr5,70094774,70197367,102593,1,0,8293,1,0.97472537112668500000
chr5,70580146,70658524,78378,1,0,,0,0.00000000000000000000
chr5,69424840,69487993,63153,1,0,,0,0.00000000000000000000
chr5,69705092,69771795,66703,1,0,,0,0.00000000000000000000
chr5,70256617,70317368,60751,1,0,4671,1,1.64606343928495000000
chr5,70156407,70216337,59930,1,0,8293,1,1.66861338227933000000
chr5,68842269,68907146,64877,1,0,100506658;728340,2,3.08275660095257000000
chr5,70426135,70490474,64339,1,0,,0,0.00000000000000000000
chr5,70306309,70354362,48053,1,0,2966;4671,2,4.16207104655276000000
chr5,69368105,69417537,49432,1,0,6607,1,2.02298106489723000000
chr5,69316806,69372152,55346,1,0,6607;728492,2,3.61363061467857000000
chr5,69225666,69276900,51234,1,0,,0,0.00000000000000000000
chr5,70198974,70250862,51888,1,0,8293;6606,2,3.85445575084798000000
chr5,69782088,69831030,48942,1,0,,0,0.00000000000000000000
chr5,69341815,69382938,41123,1,0,6607,1,2.43172920263599000000
chr5,70226107,70252171,26064,1,0,6606,1,3.83670963781461000000
chr5,68821631,68854527,32896,1,0,100506658,1,3.03988326848249000000
chr5,70328684,70358740,30056,1,0,2966,1,3.32712270428533000000
chr5,69151152,69168495,17343,1,0,,0,0.00000000000000000000
chr5,70447435,70477003,29568,1,0,,0,0.00000000000000000000
chr5,70368112,70391916,23804,1,0,,0,0.00000000000000000000
chr5,70245262,70274302,29040,1,0,4671;6606,2,6.88705234159780000000
chr5,69316084,69343660,27576,1,0,728492,1,3.62634174644619000000
chr5,70275781,70303316,27535,1,0,4671,1,3.63174142001089000000
chr5,69397494,69424477,26983,1,0,,0,0.00000000000000000000
chr5,69238468,69263763,25295,1,0,,0,0.00000000000000000000
chr5,68949418,68970973,21555,1,0,,0,0.00000000000000000000
chr5,70066636,70078684,12048,1,0,,0,0.00000000000000000000
chr5,69922521,69939061,16540,1,0,,0,0.00000000000000000000
chr5,70533980,70552104,18124,1,0,,0,0.00000000000000000000
chr5,70196490,70214356,17866,1,0,8293,1,5.59722377700660000000
chr5,69373946,69390813,16867,1,0,,0,0.00000000000000000000
chr5,69826860,69843692,16832,1,0,,0,0.00000000000000000000
chr5,69533069,69546584,13515,1,0,,0,0.00000000000000000000
chr5,70627245,70642883,15638,1,0,,0,0.00000000000000000000
chr5,68935766,68949877,14111,1,0,,0,0.00000000000000000000
chr5,69188769,69194017,5248,1,0,,0,0.00000000000000000000
chr5,69391448,69397627,6179,1,0,,0,0.00000000000000000000
chr5,70267021,70275781,8760,1,0,4671,1,11.41552511415530000000
chr5,69194086,69202139,8053,1,0,,0,0.00000000000000000000
chr5,69368534,69375937,7403,1,0,6607,1,13.50803728218290000000
chr5,70243935,70251158,7223,1,0,6606,1,13.84466288245880000000
chr5,68928269,68935823,7554,1,0,,0,0.00000000000000000000
chr5,70299755,70305301,5546,1,0,4671,1,18.03101334294990000000
chr5,70306506,70313289,6783,1,0,4671,1,14.74273920094350000000
chr5,69463259,69468814,5555,1,0,,0,0.00000000000000000000
chr5,69522634,69525130,2496,1,0,,0,0.00000000000000000000
chr5,70118475,70120572,2097,1,0,,0,0.00000000000000000000
chr5,69243423,69245563,2140,1,0,,0,0.00000000000000000000
chr5,69677566,69678424,858,1,0,,0,0.00000000000000000000
chr5,71957897,72040583,82686,1,0,,0,0.00000000000000000000
chr5,75431020,75454952,23932,1,0,22987,1,4.17850576633796000000
chr5,76084464,76135477,51013,1,0,2150,1,1.96028463332876000000
chr5,76223926,76401510,177584,1,0,1393;55109;84327,3,1.68934138210650000000
chr5,79592158,79614658,22500,1,0,,0,0.00000000000000000000
chr5,79851528,79884624,33096,1,0,340120,1,3.02151317379744000000
chr5,79945853,79948137,2284,1,0,100462981;1719,2,87.56567425569180000000
chr5,81419830,81431462,11632,1,0,83734,1,8.59697386519945000000
chr5,81421525,81429563,8038,1,0,83734,1,12.44090569793480000000
chr5,83948423,83955213,6790,1,0,,0,0.00000000000000000000
chr5,84343089,84549040,205951,1,0,,0,0.00000000000000000000
chr5,86215059,86217502,2443,1,0,,0,0.00000000000000000000
chr5,90499728,90502221,2493,1,0,,0,0.00000000000000000000
chr5,90499806,90501853,2047,1,0,,0,0.00000000000000000000
chr5,91948246,91949146,900,1,0,,0,0.00000000000000000000
chr5,96083588,96367786,284198,1,0,51752;4012;64167;831,4,1.40746944031978000000
chr5,95301854,95455120,153266,1,0,,0,0.00000000000000000000
chr5,97468766,97565679,96913,1,0,,0,0.00000000000000000000
chr5,93899345,93909772,10427,1,0,285600,1,9.59048623765225000000
chr5,94955997,94957264,1267,1,0,285601,1,78.92659826361480000000
chr5,97401548,97402755,1207,1,0,,0,0.00000000000000000000
chr5,98345156,98347139,1983,1,0,,0,0.00000000000000000000
chr5,98345171,98346266,1095,1,0,,0,0.00000000000000000000
chr5,98912124,99166820,254696,1,0,,0,0.00000000000000000000
chr5,98746481,98922540,176059,1,0,,0,0.00000000000000000000
chr5,99070417,99159749,89332,1,0,,0,0.00000000000000000000
chr5,98912124,99003827,91703,1,0,,0,0.00000000000000000000
chr5,99404547,99504494,99947,1,0,,0,0.00000000000000000000
chr5,99660937,99709081,48144,1,0,,0,0.00000000000000000000
chr5,99710209,99729979,19770,1,0,,0,0.00000000000000000000
chr5,99382042,99390870,8828,1,0,,0,0.00000000000000000000
chr5,99722753,99730429,7676,1,0,,0,0.00000000000000000000
chr5,100102091,100102792,701,1,0,,0,0.00000000000000000000
chr5,100949152,101116086,166934,1,0,,0,0.00000000000000000000
chr5,101007332,101102518,95186,1,0,,0,0.00000000000000000000
chr5,100899474,100943452,43978,1,0,,0,0.00000000000000000000
chr5,101196266,101255157,58891,1,0,,0,0.00000000000000000000
chr5,101368718,101730438,361720,1,0,353189;133482,2,0.55291385602123200000
chr5,101630166,101730279,100113,1,0,353189;133482,2,1.99774255091746000000
chr5,101485568,101572523,86955,1,0,353189,1,1.15002012535219000000
chr5,104458953,105031008,572055,1,0,,0,0.00000000000000000000
chr5,104536373,104629721,93348,1,0,,0,0.00000000000000000000
chr5,103990301,104028986,38685,1,0,,0,0.00000000000000000000
chr5,104221461,104261711,40250,1,0,,0,0.00000000000000000000
chr5,106324748,106326427,1679,1,0,,0,0.00000000000000000000
chr5,109269738,109346699,76961,1,0,,0,0.00000000000000000000
chr5,110415769,110455109,39340,1,0,134430,1,2.54194204372140000000
chr5,110425399,110442235,16836,1,0,134430,1,5.93965312425754000000
chr5,111938482,111946966,8484,1,0,,0,0.00000000000000000000
chr5,111939605,111944424,4819,1,0,,0,0.00000000000000000000
chr5,112912892,112947505,34613,1,0,64848,1,2.88908791494525000000
chr5,112936525,112950332,13807,1,0,,0,0.00000000000000000000
chr5,115222844,115446093,223249,1,0,206338;51397;1176;644100,4,1.79172135149542000000
chr5,117877785,117880462,2677,1,0,,0,0.00000000000000000000
chr5,118516444,118591864,75420,1,0,1657,1,1.32590824714930000000
chr5,120052492,120074201,21709,1,0,,0,0.00000000000000000000
chr5,120289859,120420164,130305,1,0,,0,0.00000000000000000000
chr5,133134764,133136564,1800,1,0,,0,0.00000000000000000000
chr5,134258851,134264637,5786,1,0,84105,1,17.28309713100590000000
chr5,134259133,134262295,3162,1,0,84105,1,31.62555344718530000000
chr5,135115117,135122310,7193,1,0,,0,0.00000000000000000000
chr5,135115344,135120214,4870,1,0,,0,0.00000000000000000000
chr5,135116166,135119971,3805,1,0,,0,0.00000000000000000000
chr5,136854963,136856297,1334,1,0,,0,0.00000000000000000000
chr5,137736034,137745377,9343,1,0,51780,1,10.70320025687680000000
chr5,137807380,137816528,9148,1,0,,0,0.00000000000000000000
chr5,137808544,137812063,3519,1,0,,0,0.00000000000000000000
chr5,138777624,138783164,5540,1,0,,0,0.00000000000000000000
chr5,140050393,140053493,3100,1,0,3035;373863;54853,3,96.77419354838710000000
chr5,140222538,140238960,16422,1,0,56142;56145;56140;56147;56139;56144;56141;56146;9752;56143,10,60.89392278650590000000
chr5,140213630,140216362,2732,1,0,56142;56145;56147;56141;56144;56143;56146,7,256.22254758418700000000
chr5,140236029,140238517,2488,1,0,56142;56145;56140;56147;56139;56144;56141;56146;9752;56143,10,401.92926045016100000000
chr5,140220607,140223257,2650,1,0,56142;56145;56140;56147;56144;56141;56146;56143,8,301.88679245283000000000
chr5,140582453,140590493,8040,1,0,56125;56124,2,24.87562189054730000000
chr5,140554513,140560187,5674,1,0,56129;56128,2,35.24850193866760000000
chr5,140551785,140556137,4352,1,0,56129,1,22.97794117647060000000
chr5,140593392,140595732,2340,1,0,56123,1,42.73504273504270000000
chr5,140593199,140594558,1359,1,0,56123,1,73.58351729212660000000
chr5,141619974,141654293,34319,1,0,,0,0.00000000000000000000
chr5,141809116,142445189,636073,1,0,2246;23092,2,0.31442931864738800000
chr5,147323719,147337996,14277,1,0,,0,0.00000000000000000000
chr5,147553094,147554786,1692,1,0,408187,1,59.10165484633570000000
chr5,155475886,155488649,12763,1,0,,0,0.00000000000000000000
chr5,155311797,155312616,819,1,0,,0,0.00000000000000000000
chr5,156396774,156479831,83057,1,0,26762,1,1.20399243892748000000
chr5,159361711,159470710,108999,1,0,7265;147,2,1.83487921907540000000
chr5,169378633,169384948,6315,1,0,100131897;1794,2,31.67062549485350000000
chr5,170129999,170131245,1246,1,0,30820,1,80.25682182985550000000
chr5,172083188,172160285,77097,1,0,54492,1,1.29706733076514000000
chr5,175382112,175649169,267057,1,0,84321;202134,2,0.74890379207435100000
chr5,175488432,175626703,138271,1,0,202134,1,0.72321744979062900000
chr5,175578148,175719664,141516,1,0,375484,1,0.70663387885468800000
chr5,175556383,175645775,89392,1,0,,0,0.00000000000000000000
chr5,175525664,175598662,72998,1,0,202134,1,1.36990054522042000000
chr5,175571151,175624322,53171,1,0,,0,0.00000000000000000000
chr5,175329865,175379344,49479,1,0,,0,0.00000000000000000000
chr5,175458277,175468249,9972,1,0,,0,0.00000000000000000000
chr5,175628451,175639879,11428,1,0,,0,0.00000000000000000000
chr5,176168645,176292484,123839,1,0,90249,1,0.80750006056250500000
chr5,177059342,177109302,49960,1,0,,0,0.00000000000000000000
chr5,177172913,177211865,38952,1,0,285596,1,2.56726227151366000000
chr5,177118859,177152904,34045,1,0,285596,1,2.93728888236158000000
chr5,177253297,177272860,19563,1,0,,0,0.00000000000000000000
chr5,177236646,177241088,4442,1,0,,0,0.00000000000000000000
chr5,177405878,177407626,1748,1,0,,0,0.00000000000000000000
chr5,178348177,178352984,4807,1,0,80108,1,20.80299563137090000000
chr5,178348631,178352912,4281,1,0,80108,1,23.35902826442420000000
chr5,178506567,178790149,283582,1,0,9509;30832,2,0.70526338060948900000
chr5,178727112,178891394,164282,1,0,9509,1,0.60870941429980200000
chr5,178838942,178839817,875,1,0,,0,0.00000000000000000000
chr5,178957395,179029606,72211,1,0,80230,1,1.38483056598025000000
chr5,179062282,179080937,18655,1,0,285679,1,5.36049316537121000000
chr5,180038891,180199806,160915,1,0,2324;134083,2,1.24289221017307000000
chr5,180113561,180224583,111022,1,0,4245;134083,2,1.80144475869647000000
chr5,179879704,179943232,63528,1,0,57472,1,1.57410905427528000000
chr5,180175778,180200687,24909,1,0,,0,0.00000000000000000000
chr5,180383314,180474384,91070,1,0,10917;153579,2,2.19611288020204000000
chr5,180449903,180529198,79295,1,0,153579,1,1.26111356327637000000
chr5,180543129,180633325,90196,1,0,81786;285659;26693,3,3.32608984877378000000
chr5,180375599,180437002,61403,1,0,79908;10917,2,3.25716984512157000000
chr5,180429203,180481764,52561,1,0,10917;153579,2,3.80510264264379000000
chr5,180375738,180417276,41538,1,0,79908;10917,2,4.81486831335163000000
chr5,180574241,180609698,35457,1,0,285659,1,2.82031756775813000000
chr5,180406289,180431108,24819,1,0,10917,1,4.02917119948427000000
chr5,180569933,180575077,5144,1,0,,0,0.00000000000000000000
chr5,180569195,180570021,826,1,0,,0,0.00000000000000000000
chr5,180776968,180896486,119518,1,0,26683,1,0.83669405445204900000
chr5,180666742,180711196,44454,1,0,84851;10399,2,4.49903270796779000000
chr5,180825287,180843945,18658,1,0,,0,0.00000000000000000000
chr5,180888209,180905169,16960,1,0,,0,0.00000000000000000000
chr6,258103,388989,130886,1,0,56940,1,0.76402365417233300000
chr6,256892,371999,115107,1,0,56940,1,0.86875689575786000000
chr6,163687,259874,96187,1,0,,0,0.00000000000000000000
chr6,295978,383263,87285,1,0,56940,1,1.14567222317695000000
chr6,255986,314640,58654,1,0,56940,1,1.70491356088246000000
chr6,209657,267148,57491,1,0,,0,0.00000000000000000000
chr6,335831,386161,50330,1,0,56940,1,1.98688654877806000000
chr6,327573,368705,41132,1,0,56940,1,2.43119712146261000000
chr6,256485,293417,36932,1,0,56940,1,2.70767897758042000000
chr6,359678,381452,21774,1,0,,0,0.00000000000000000000
chr6,60031,72962,12931,1,0,,0,0.00000000000000000000
chr6,280387,294769,14382,1,0,56940,1,6.95313586427479000000
chr6,861912,863775,1863,1,0,,0,0.00000000000000000000
chr6,1130982,1223463,92481,1,0,,0,0.00000000000000000000
chr6,3144025,3147951,3926,1,0,670,1,25.47121752419770000000
chr6,3157163,3223513,66350,1,0,7280,1,1.50715900527506000000
chr6,3718252,3719613,1361,1,0,,0,0.00000000000000000000
chr6,7423145,7452834,29689,1,0,,0,0.00000000000000000000
chr6,13631201,13710600,79399,1,0,10048;51406,2,2.51892341213365000000
chr6,14745232,14745727,495,1,0,,0,0.00000000000000000000
chr6,15102751,15159104,56353,1,0,,0,0.00000000000000000000
chr6,15661713,15718702,56989,1,0,84062,1,1.75472459597466000000
chr6,16390483,16401131,10648,1,0,6310,1,9.39143501126972000000
chr6,17722327,17904166,181839,1,0,63971,1,0.54993703220981200000
chr6,17471134,17662369,191235,1,0,51439;10486;9972,3,1.56875049023453000000
chr6,18706484,19115186,408702,1,0,,0,0.00000000000000000000
chr6,20861636,20929129,67493,1,0,54901,1,1.48163513253226000000
chr6,26427603,26464459,36856,1,0,11120;10384,2,5.42652485348383000000
chr6,26368929,26406147,37218,1,0,11118;10385;11119,3,8.06061583104949000000
chr6,26732015,26905655,173640,1,0,,0,0.00000000000000000000
chr6,26859889,26971774,111885,1,0,,0,0.00000000000000000000
chr6,26713908,26802229,88321,1,0,,0,0.00000000000000000000
chr6,26720897,26778932,58035,1,0,,0,0.00000000000000000000
chr6,26727311,26776479,49168,1,0,,0,0.00000000000000000000
chr6,26737017,26760784,23767,1,0,,0,0.00000000000000000000
chr6,26949590,26970285,20695,1,0,,0,0.00000000000000000000
chr6,26875833,26884508,8675,1,0,,0,0.00000000000000000000
chr6,26739614,26748928,9314,1,0,,0,0.00000000000000000000
chr6,26926453,26932752,6299,1,0,,0,0.00000000000000000000
chr6,27618361,27670141,51780,1,0,,0,0.00000000000000000000
chr6,27634272,27649111,14839,1,0,,0,0.00000000000000000000
chr6,28578604,28581659,3055,1,0,114821,1,32.73322422258590000000
chr6,29128515,29334555,206040,1,0,442191;26707;81696,3,1.45602795573675000000
chr6,29086228,29169208,82980,1,0,26707,1,1.20510966497951000000
chr6,29810761,29915363,104602,1,0,3105,1,0.95600466530276700000
chr6,29848425,29925330,76905,1,0,3105,1,1.30030557180938000000
chr6,29701775,29788850,87075,1,0,,0,0.00000000000000000000
chr6,29850235,29905099,54864,1,0,,0,0.00000000000000000000
chr6,29826363,29872856,46493,1,0,,0,0.00000000000000000000
chr6,29743464,29798556,55092,1,0,3135,1,1.81514557467509000000
chr6,29874127,29923147,49020,1,0,3105,1,2.03998368013056000000
chr6,29841163,29864532,23369,1,0,,0,0.00000000000000000000
chr6,29872812,29891364,18552,1,0,,0,0.00000000000000000000
chr6,29895734,29911056,15322,1,0,3105,1,6.52656311186529000000
chr6,30857509,30964073,106564,1,0,135656;2968;394263;389376;780;57176,6,5.63041927855561000000
chr6,31351005,31457155,106150,1,0,100507436,1,0.94206311822892100000
chr6,31234439,31329771,95332,1,0,3107;3106,2,2.09793143960055000000
chr6,31284863,31351321,66458,1,0,3106,1,1.50470974149087000000
chr6,31283558,31316786,33228,1,0,,0,0.00000000000000000000
chr6,31331216,31358436,27220,1,0,,0,0.00000000000000000000
chr6,31218771,31236094,17323,1,0,,0,0.00000000000000000000
chr6,31287368,31301426,14058,1,0,,0,0.00000000000000000000
chr6,31261478,31277536,16058,1,0,,0,0.00000000000000000000
chr6,31237251,31251825,14574,1,0,3107,1,6.86153423905585000000
chr6,31278877,31288698,9821,1,0,,0,0.00000000000000000000
chr6,31322713,31328180,5467,1,0,3106,1,18.29156758734220000000
chr6,31282992,31286695,3703,1,0,,0,0.00000000000000000000
chr6,31237952,31240631,2679,1,0,3107,1,37.32736095558040000000
chr6,31289391,31290013,622,1,0,,0,0.00000000000000000000
chr6,31948857,32023063,74206,1,0,7148;8859;721;1589;720,5,6.73799962267202000000
chr6,31959023,31985220,26197,1,0,721;720,2,7.63446196129328000000
chr6,31991704,32014000,22296,1,0,7148;1589;721,3,13.45532831001080000000
chr6,31980389,32001592,21203,1,0,721,1,4.71631372918927000000
chr6,31953039,31958552,5513,1,0,720,1,18.13894431344100000000
chr6,32434521,32735965,301444,1,0,3118;3119;3117;3120;3123;3127,6,1.99041944772495000000
chr6,32604674,32747868,143194,1,0,3118;3119;3117;3120,4,2.79341313183513000000
chr6,32461126,32621167,160041,1,0,3123;3117;3127,3,1.87451965433858000000
chr6,32510738,32602234,91496,1,0,3123,1,1.09294395383405000000
chr6,32443285,32537214,93929,1,0,3127,1,1.06463392562467000000
chr6,32617751,32689376,71625,1,0,3119,1,1.39616055846422000000
chr6,32519208,32572675,53467,1,0,3123,1,1.87031252922363000000
chr6,32607799,32659003,51204,1,0,3119;3117,2,3.90594484805875000000
chr6,32501752,32547365,45613,1,0,3123,1,2.19235744195734000000
chr6,32454356,32495837,41481,1,0,3127,1,2.41074226754418000000
chr6,32554538,32594448,39910,1,0,3123,1,2.50563768479078000000
chr6,32605042,32631144,26102,1,0,3119;3117,2,7.66224810359359000000
chr6,32631154,32660245,29091,1,0,3119,1,3.43748925784607000000
chr6,32522541,32549592,27051,1,0,3123,1,3.69672100846549000000
chr6,32468941,32494215,25274,1,0,3127,1,3.95663527736013000000
chr6,32672987,32698070,25083,1,0,,0,0.00000000000000000000
chr6,32437142,32455430,18288,1,0,,0,0.00000000000000000000
chr6,32458334,32473964,15630,1,0,,0,0.00000000000000000000
chr6,32604215,32620973,16758,1,0,3117,1,5.96729920038191000000
chr6,32549790,32560976,11186,1,0,3123,1,8.93974611121044000000
chr6,32612767,32625902,13135,1,0,,0,0.00000000000000000000
chr6,32689641,32699567,9926,1,0,,0,0.00000000000000000000
chr6,32560325,32570778,10453,1,0,,0,0.00000000000000000000
chr6,32538753,32548375,9622,1,0,3123,1,10.39284971939310000000
chr6,32541229,32548049,6820,1,0,3123,1,14.66275659824050000000
chr6,32536336,32542727,6391,1,0,,0,0.00000000000000000000
chr6,32492389,32498857,6468,1,0,3127,1,15.46072974644400000000
chr6,32553340,32558501,5161,1,0,3123,1,19.37608990505720000000
chr6,32627105,32630253,3148,1,0,3119,1,31.76620076238880000000
chr6,32546773,32549584,2811,1,0,3123,1,35.57452863749560000000
chr6,32505269,32507344,2075,1,0,,0,0.00000000000000000000
chr6,32604395,32605690,1295,1,0,3117,1,77.22007722007720000000
chr6,32778732,32779777,1045,1,0,,0,0.00000000000000000000
chr6,32550590,32552070,1480,1,0,3123,1,67.56756756756760000000
chr6,32458939,32460272,1333,1,0,,0,0.00000000000000000000
chr6,32488866,32489947,1081,1,0,3127,1,92.50693802035150000000
chr6,32778895,32779632,737,1,0,,0,0.00000000000000000000
chr6,33100784,33101930,1146,1,0,,0,0.00000000000000000000
chr6,34745462,34902124,156662,1,0,23294;6882;54887,3,1.91495065810471000000
chr6,35485217,35567416,82199,1,0,2289,1,1.21655981216316000000
chr6,35626458,35629745,3287,1,0,2289,1,30.42287800425920000000
chr6,35677078,35739769,62691,1,0,2289;221481,2,3.19025059418417000000
chr6,35755256,35774730,19474,1,0,1208;222662;340204,3,15.40515559207150000000
chr6,35754107,35766678,12571,1,0,1208;340204,2,15.90963328295280000000
chr6,35754732,35765281,10549,1,0,1208;340204,2,18.95914304673430000000
chr6,37832990,38154062,321072,1,0,60685;114781,2,0.62291324064384300000
chr6,37961552,37987678,26126,1,0,60685,1,3.82760468498813000000
chr6,46797421,46828715,31294,1,0,221395;4224,2,6.39100146993034000000
chr6,48601656,48712608,110952,1,0,,0,0.00000000000000000000
chr6,49432028,49461776,29748,1,0,55166,1,3.36157052574963000000
chr6,49428740,49447872,19132,1,0,4594;55166,2,10.45369015262390000000
chr6,49431877,49441052,9175,1,0,55166,1,10.89918256130790000000
chr6,52244431,52296429,51998,1,0,85315;114327,2,3.84630178083772000000
chr6,52628257,52678343,50086,1,0,2938;2939,2,3.99313181328116000000
chr6,52689412,52745556,56144,1,0,221357,1,1.78113422627529000000
chr6,52629816,52664641,34825,1,0,2938,1,2.87150035893754000000
chr6,52607203,52630145,22942,1,0,2939,1,4.35881788858862000000
chr6,52658323,52670112,11789,1,0,2938,1,8.48248367121893000000
chr6,53091926,53405172,313246,1,0,2729;60481,2,0.63847583049743700000
chr6,53885918,54103794,217876,1,0,90523,1,0.45897666562632000000
chr6,53581312,53592678,11366,1,0,,0,0.00000000000000000000
chr6,53928851,53935286,6435,1,0,90523,1,15.54001554001550000000
chr6,53928927,53934087,5160,1,0,90523,1,19.37984496124030000000
chr6,56144134,56148133,3999,1,0,81578,1,25.00625156289070000000
chr6,56911876,56946808,34932,1,0,57691,1,2.86270468338486000000
chr6,57975136,58774716,799580,1,0,,0,0.00000000000000000000
chr6,58198395,58777385,578990,1,0,,0,0.00000000000000000000
chr6,57546073,58113955,567882,1,0,,0,0.00000000000000000000
chr6,57314989,57754627,439638,1,0,5558,1,0.22745986470687200000
chr6,57372134,57575626,203492,1,0,5558,1,0.49141981011538500000
chr6,57704872,57959361,254489,1,0,,0,0.00000000000000000000
chr6,58249533,58392142,142609,1,0,,0,0.00000000000000000000
chr6,58557110,58774879,217769,1,0,,0,0.00000000000000000000
chr6,57872678,58058372,185694,1,0,,0,0.00000000000000000000
chr6,57333253,57457323,124070,1,0,5558,1,0.80599661481421800000
chr6,57205859,57340170,134311,1,0,5558,1,0.74454065564250100000
chr6,58273670,58363752,90082,1,0,,0,0.00000000000000000000
chr6,58684473,58774594,90121,1,0,,0,0.00000000000000000000
chr6,58358203,58430434,72231,1,0,,0,0.00000000000000000000
chr6,57308608,57383356,74748,1,0,5558,1,1.33782843688125000000
chr6,58247238,58269196,21958,1,0,,0,0.00000000000000000000
chr6,58184007,58202029,18022,1,0,,0,0.00000000000000000000
chr6,57619742,57629827,10085,1,0,,0,0.00000000000000000000
chr6,58139729,58151305,11576,1,0,,0,0.00000000000000000000
chr6,57623712,57628385,4673,1,0,,0,0.00000000000000000000
chr6,58773485,58779966,6481,1,0,,0,0.00000000000000000000
chr6,57624016,57627224,3208,1,0,,0,0.00000000000000000000
chr6,61923146,62917626,994480,1,0,100463487;202559,2,0.20111012790604100000
chr6,61880260,62128238,247978,1,0,,0,0.00000000000000000000
chr6,62178821,62288093,109272,1,0,100463487,1,0.91514752178051100000
chr6,61881802,61961638,79836,1,0,,0,0.00000000000000000000
chr6,63286218,63363914,77696,1,0,,0,0.00000000000000000000
chr6,62064900,62123181,58281,1,0,,0,0.00000000000000000000
chr6,62204976,62243105,38129,1,0,,0,0.00000000000000000000
chr6,68508999,68606744,97745,1,0,,0,0.00000000000000000000
chr6,70188989,70277993,89004,1,0,,0,0.00000000000000000000
chr6,65894993,65950473,55480,1,0,346007,1,1.80245133381399000000
chr6,68456059,68504083,48024,1,0,,0,0.00000000000000000000
chr6,68818801,68842416,23615,1,0,,0,0.00000000000000000000
chr6,70202619,70223000,20381,1,0,,0,0.00000000000000000000
chr6,68235799,68248879,13080,1,0,,0,0.00000000000000000000
chr6,67847615,67859857,12242,1,0,,0,0.00000000000000000000
chr6,65337002,65348979,11977,1,0,346007,1,8.34933622776989000000
chr6,69230104,69241972,11868,1,0,,0,0.00000000000000000000
chr6,67133585,67143043,9458,1,0,,0,0.00000000000000000000
chr6,67159737,67167245,7508,1,0,,0,0.00000000000000000000
chr6,66399235,66404752,5517,1,0,346007,1,18.12579300344390000000
chr6,72863823,72873611,9788,1,0,22999,1,10.21659174499390000000
chr6,72863898,72868023,4125,1,0,22999,1,24.24242424242420000000
chr6,74301718,74423034,121316,1,0,26503;135228,2,1.64858716080319000000
chr6,74666559,74944460,277901,1,0,,0,0.00000000000000000000
chr6,74564769,74614549,49780,1,0,,0,0.00000000000000000000
chr6,74707825,74718498,10673,1,0,,0,0.00000000000000000000
chr6,74591999,74602382,10383,1,0,,0,0.00000000000000000000
chr6,74708884,74717014,8130,1,0,,0,0.00000000000000000000
chr6,74832508,74833460,952,1,0,,0,0.00000000000000000000
chr6,75370887,75449989,79102,1,0,,0,0.00000000000000000000
chr6,77097503,77100357,2854,1,0,,0,0.00000000000000000000
chr6,77438392,77457282,18890,1,0,,0,0.00000000000000000000
chr6,78767422,79128355,360933,1,0,,0,0.00000000000000000000
chr6,78877720,79044604,166884,1,0,,0,0.00000000000000000000
chr6,78857262,78964957,107695,1,0,,0,0.00000000000000000000
chr6,78966774,79038146,71372,1,0,,0,0.00000000000000000000
chr6,78969567,79012292,42725,1,0,,0,0.00000000000000000000
chr6,78997941,79032608,34667,1,0,,0,0.00000000000000000000
chr6,78971478,78995210,23732,1,0,,0,0.00000000000000000000
chr6,79014542,79034857,20315,1,0,,0,0.00000000000000000000
chr6,78879305,78898720,19415,1,0,,0,0.00000000000000000000
chr6,79521092,79527602,6510,1,0,,0,0.00000000000000000000
chr6,80113099,80310071,196972,1,0,167691,1,0.50768637166703900000
chr6,80125584,80230443,104859,1,0,167691,1,0.95366158365042600000
chr6,80884508,81013571,129063,1,0,594,1,0.77481540023089500000
chr6,81557092,81642010,84918,1,0,,0,0.00000000000000000000
chr6,81514254,81561663,47409,1,0,,0,0.00000000000000000000
chr6,83521127,83572049,50922,1,0,,0,0.00000000000000000000
chr6,86676621,87884682,1208061,1,0,3354;23036;1081,3,0.24833183092575600000
chr6,88836377,88867149,30772,1,0,1268,1,3.24970752632263000000
chr6,90159677,90355285,195608,1,0,22881;23195;57226,3,1.53367960410617000000
chr6,89921631,89922223,592,1,0,2569,1,168.91891891891900000000
chr6,93065038,93152786,87748,1,0,,0,0.00000000000000000000
chr6,95529872,95600654,70782,1,0,,0,0.00000000000000000000
chr6,95343807,95366226,22419,1,0,,0,0.00000000000000000000
chr6,95543719,95565931,22212,1,0,,0,0.00000000000000000000
chr6,100278012,100645952,367940,1,0,84539,1,0.27178344295265500000
chr6,101193766,101196508,2742,1,0,10973,1,36.46973012399710000000
chr6,102814674,102816464,1790,1,0,,0,0.00000000000000000000
chr6,103735936,103771527,35591,1,0,,0,0.00000000000000000000
chr6,103723156,103762048,38892,1,0,,0,0.00000000000000000000
chr6,103737836,103763256,25420,1,0,,0,0.00000000000000000000
chr6,103735150,103759932,24782,1,0,,0,0.00000000000000000000
chr6,103748242,103768854,20612,1,0,,0,0.00000000000000000000
chr6,103735984,103747936,11952,1,0,,0,0.00000000000000000000
chr6,103751476,103762047,10571,1,0,,0,0.00000000000000000000
chr6,104864385,104936491,72106,1,0,,0,0.00000000000000000000
chr6,104899310,104937748,38438,1,0,,0,0.00000000000000000000
chr6,106599177,106903540,304363,1,0,9474,1,0.32855504775547600000
chr6,108877765,108883855,6090,1,0,2309,1,16.42036124794750000000
chr6,111328244,111602137,273893,1,0,117247;84154;91749,3,1.09531824471600000000
chr6,114224051,114225062,1011,1,0,,0,0.00000000000000000000
chr6,115255479,115388972,133493,1,0,,0,0.00000000000000000000
chr6,117502276,117571045,68769,1,0,,0,0.00000000000000000000
chr6,117730038,117741495,11457,1,0,6098,1,8.72828838264816000000
chr6,118673782,119117852,444070,1,0,5350;387119,2,0.45037944468214500000
chr6,118724333,118872206,147873,1,0,5350;387119,2,1.35251195282438000000
chr6,124429315,124472993,43678,1,0,154215,1,2.28948211914465000000
chr6,124541365,124565279,23914,1,0,154215,1,4.18165091578155000000
chr6,125534167,125584954,50787,1,0,7164,1,1.96900781696103000000
chr6,126183237,126187051,3814,1,0,135112,1,26.21919244887260000000
chr6,131415267,131453048,37781,1,0,,0,0.00000000000000000000
chr6,132019210,132037061,17851,1,0,643854;79541;5169,3,16.80578118872890000000
chr6,132019301,132028299,8998,1,0,79541;5169,2,22.22716159146480000000
chr6,137375499,137419129,43630,1,0,,0,0.00000000000000000000
chr6,137897110,137964095,66985,1,0,,0,0.00000000000000000000
chr6,139603088,139607602,4514,1,0,167838,1,22.15330084182540000000
chr6,141017042,141804128,787086,1,0,,0,0.00000000000000000000
chr6,140974401,141064161,89760,1,0,,0,0.00000000000000000000
chr6,145709371,145841146,131775,1,0,,0,0.00000000000000000000
chr6,150518893,150519503,610,1,0,81706,1,163.93442622950800000000
chr6,151355528,151372686,17158,1,0,25902,1,5.82818510315888000000
chr6,151733392,151854649,121257,1,0,79624;80129;55005,3,2.47408397040996000000
chr6,153958312,153961510,3198,1,0,,0,0.00000000000000000000
chr6,154620051,154621466,1415,1,0,26034,1,70.67137809187280000000
chr6,158624339,158641238,16899,1,0,,0,0.00000000000000000000
chr6,159539857,160009816,469959,1,0,84624,1,0.21278451950063700000
chr6,162755176,162970421,215245,1,0,5071,1,0.46458686612929500000
chr6,161646245,161817105,170860,1,0,56895;5071,2,1.17054898747513000000
chr6,161349614,161566120,216506,1,0,4216;56895,2,0.92376192807589600000
chr6,162598180,162740905,142725,1,0,5071,1,0.70064809949203000000
chr6,162690350,162783652,93302,1,0,5071,1,1.07178838610105000000
chr6,162843342,162899225,55883,1,0,5071,1,1.78945296422884000000
chr6,160877744,160956591,78847,1,0,4018,1,1.26827907212703000000
chr6,161028108,161072130,44022,1,0,4018,1,2.27159147698878000000
chr6,162639829,162687212,47383,1,0,5071,1,2.11046155794272000000
chr6,162712426,162751899,39473,1,0,5071,1,2.53337724520558000000
chr6,163039621,163078036,38415,1,0,5071,1,2.60314981127164000000
chr6,162891544,162920864,29320,1,0,5071,1,3.41064120054570000000
chr6,161258722,161279603,20881,1,0,,0,0.00000000000000000000
chr6,161268874,161273930,5056,1,0,,0,0.00000000000000000000
chr6,161726247,161728479,2232,1,0,,0,0.00000000000000000000
chr6,165134581,165195292,60711,1,0,,0,0.00000000000000000000
chr6,165724328,165732027,7699,1,0,,0,0.00000000000000000000
chr6,165875523,165893735,18212,1,0,10846,1,5.49088513068307000000
chr6,167161656,167163213,1557,1,0,6196,1,64.22607578676940000000
chr6,167608002,168205775,597773,1,0,83887;54346;6953,3,0.50186274723013600000
chr6,167569172,167924324,355152,1,0,83887;6953;54346;2853;401285,5,1.40784790737487000000
chr6,168073775,168367048,293273,1,0,4301,1,0.34097922413587300000
chr6,168334397,168608075,273678,1,0,3834;4301;100128124;79981,4,1.46157162797156000000
chr6,167609519,167781943,172424,1,0,83887;54346,2,1.15993133206514000000
chr6,168459565,168597265,137700,1,0,79981,1,0.72621641249092200000
chr6,168333689,168433085,99396,1,0,3834;4301;100128124,3,3.01823010986358000000
chr6,167697624,167784801,87177,1,0,83887;54346,2,2.29418309875311000000
chr6,168537602,168597241,59639,1,0,,0,0.00000000000000000000
chr6,167607715,167657962,50247,1,0,,0,0.00000000000000000000
chr6,167579341,167591824,12483,1,0,401285,1,8.01089481695105000000
chr6,167773439,167784535,11096,1,0,,0,0.00000000000000000000
chr6,168634466,168638759,4293,1,0,,0,0.00000000000000000000
chr6,167798477,167802772,4295,1,0,,0,0.00000000000000000000
chr6,168716878,168718822,1944,1,0,168002,1,51.44032921810700000000
chr6,169660725,169714337,53612,1,0,,0,0.00000000000000000000
chr6,169758426,169792064,33638,1,0,,0,0.00000000000000000000
chr6,168992954,168996042,3088,1,0,64094,1,32.38341968911920000000
chr6,168961034,168963548,2514,1,0,64094,1,39.77724741447890000000
chr6,169240078,169241263,1185,1,0,,0,0.00000000000000000000
chr6,170483304,170487574,4270,1,0,,0,0.00000000000000000000
chr6,170483887,170486038,2151,1,0,,0,0.00000000000000000000
chr6,170528446,170530538,2092,1,0,,0,0.00000000000000000000
chr6,170554999,170556209,1210,1,0,,0,0.00000000000000000000
chr6,170402650,170403307,657,1,0,,0,0.00000000000000000000
chr6,170707434,170709554,2120,1,0,84498,1,47.16981132075470000000
chr6,170770380,170778046,7666,1,0,,0,0.00000000000000000000
chr6,170936701,171053223,116522,1,0,,0,0.00000000000000000000
chr6,170868301,170910378,42077,1,0,5134;6908,2,4.75319057917627000000
chr6,171021876,171055000,33124,1,0,,0,0.00000000000000000000
chr6,171039500,171055000,15500,1,0,,0,0.00000000000000000000
chr6,170981863,170991938,10075,1,0,,0,0.00000000000000000000
chr7,34268,231486,197218,1,0,56975,1,0.50705310874261000000
chr7,10239,89504,79265,1,0,,0,0.00000000000000000000
chr7,73148,134417,61269,1,0,,0,0.00000000000000000000
chr7,10887,71715,60828,1,0,,0,0.00000000000000000000
chr7,39174,76056,36882,1,0,,0,0.00000000000000000000
chr7,40245,69790,29545,1,0,,0,0.00000000000000000000
chr7,19108,41286,22178,1,0,,0,0.00000000000000000000
chr7,82951,110309,27358,1,0,,0,0.00000000000000000000
chr7,209759,229225,19466,1,0,56975,1,5.13716223158327000000
chr7,69082,80755,11673,1,0,,0,0.00000000000000000000
chr7,591191,592215,1024,1,0,5575,1,97.65625000000000000000
chr7,929263,930008,745,1,0,51608,1,134.22818791946300000000
chr7,976694,977404,710,1,0,11033,1,140.84507042253500000000
chr7,1312344,1326072,13728,1,0,,0,0.00000000000000000000
chr7,1310511,1315642,5131,1,0,,0,0.00000000000000000000
chr7,1154881,1157572,2691,1,0,84310,1,37.16090672612410000000
chr7,1312737,1313762,1025,1,0,,0,0.00000000000000000000
chr7,1311697,1312824,1127,1,0,,0,0.00000000000000000000
chr7,1235724,1236525,801,1,0,,0,0.00000000000000000000
chr7,1560690,1562790,2100,1,0,,0,0.00000000000000000000
chr7,2270655,2357273,86618,1,0,8379;29960;29886;4521,4,4.61797778752684000000
chr7,2030411,2031833,1422,1,0,8379,1,70.32348804500700000000
chr7,2961317,3314341,353024,1,0,84433,1,0.28326686004351000000
chr7,3454418,3603697,149279,1,0,221935,1,0.66988658820061800000
chr7,3442221,3477104,34883,1,0,221935,1,2.86672591233552000000
chr7,3338728,3369654,30926,1,0,221935,1,3.23352518916122000000
chr7,3610395,3620012,9617,1,0,221935,1,10.39825309348030000000
chr7,3623510,3722053,98543,1,0,221935,1,1.01478542362217000000
chr7,4342116,4529271,187155,1,0,,0,0.00000000000000000000
chr7,4280540,4386987,106447,1,0,221935,1,0.93943464822869600000
chr7,4541110,4592439,51329,1,0,,0,0.00000000000000000000
chr7,4418737,4449157,30420,1,0,,0,0.00000000000000000000
chr7,4158233,4160242,2009,1,0,221935,1,49.77600796416130000000
chr7,4015419,4017241,1822,1,0,221935,1,54.88474204171240000000
chr7,4159132,4160274,1142,1,0,221935,1,87.56567425569180000000
chr7,5036761,5098568,61807,1,0,57786;100533952,2,3.23587943113240000000
chr7,5069913,5085442,15529,1,0,,0,0.00000000000000000000
chr7,5285503,5465988,180485,1,0,222962;84629,2,1.10812532897471000000
chr7,5753762,6032251,278489,1,0,5395;222967;54476;51622;654231,5,1.79540305003070000000
chr7,5784560,5900974,116414,1,0,54476,1,0.85900321267201500000
chr7,5790017,5832214,42197,1,0,54476,1,2.36983671825011000000
chr7,6854704,7439324,584620,1,0,221960;56913;340267,3,0.51315384352228800000
chr7,6895665,7042482,146817,1,0,,0,0.00000000000000000000
chr7,7340443,7467005,126562,1,0,340267,1,0.79012657827784000000
chr7,6847689,6892409,44720,1,0,221960,1,2.23613595706619000000
chr7,6749102,6768483,19381,1,0,,0,0.00000000000000000000
chr7,8992886,8994386,1500,1,0,,0,0.00000000000000000000
chr7,9805513,9910611,105098,1,0,,0,0.00000000000000000000
chr7,9899545,9961678,62133,1,0,,0,0.00000000000000000000
chr7,10279486,11796901,1517415,1,0,9678;221981;4697,3,0.19770464902482200000
chr7,10549363,10634125,84762,1,0,,0,0.00000000000000000000
chr7,10490464,10505844,15380,1,0,,0,0.00000000000000000000
chr7,12597246,12638349,41103,1,0,85477,1,2.43291243948130000000
chr7,12519412,12566444,47032,1,0,,0,0.00000000000000000000
chr7,12524617,12525615,998,1,0,,0,0.00000000000000000000
chr7,13278111,13280738,2627,1,0,,0,0.00000000000000000000
chr7,14186572,14338662,152090,1,0,1607,1,0.65750542441975100000
chr7,15246643,15325676,79033,1,0,392636,1,1.26529424417648000000
chr7,16013663,16029620,15957,1,0,,0,0.00000000000000000000
chr7,16171796,16173975,2179,1,0,729920,1,45.89261128958240000000
chr7,16953805,17402101,448296,1,0,196,1,0.22306690222531500000
chr7,17399858,17626941,227083,1,0,,0,0.00000000000000000000
chr7,17111167,17280596,169429,1,0,,0,0.00000000000000000000
chr7,17403258,17463319,60061,1,0,,0,0.00000000000000000000
chr7,16394882,16440330,45448,1,0,729920,1,2.20031684562577000000
chr7,17975319,18386863,411544,1,0,23161;221823;9734,3,0.72896215228505300000
chr7,19396381,19525380,128999,1,0,,0,0.00000000000000000000
chr7,19509943,19530208,20265,1,0,,0,0.00000000000000000000
chr7,24038200,24039976,1776,1,0,,0,0.00000000000000000000
chr7,25997981,26240339,242358,1,0,9603;3181,2,0.82522549286592600000
chr7,26132856,26204038,71182,1,0,9603,1,1.40484954061420000000
chr7,26137323,26149099,11776,1,0,,0,0.00000000000000000000
chr7,26137276,26145510,8234,1,0,,0,0.00000000000000000000
chr7,26251715,26252962,1247,1,0,11335,1,80.19246190858060000000
chr7,28574259,28575191,932,1,0,9586,1,107.29613733905600000000
chr7,29200899,29538076,337177,1,0,54504;1124,2,0.59316026893886600000
chr7,29672186,29801961,129775,1,0,,0,0.00000000000000000000
chr7,30655644,31170376,514732,1,0,2617;11185;1395;84182;117;2692;358,7,1.35993099321589000000
chr7,32209693,32421473,211780,1,0,5137,1,0.47218811974690700000
chr7,32746123,32851515,105392,1,0,,0,0.00000000000000000000
chr7,32851278,32904084,52806,1,0,,0,0.00000000000000000000
chr7,33130224,33187622,57398,1,0,27241;6100,2,3.48444196661905000000
chr7,32801069,32827653,26584,1,0,,0,0.00000000000000000000
chr7,34072148,34230788,158640,1,0,168667,1,0.63035804336863300000
chr7,35230074,35284645,54571,1,0,57057,1,1.83247512415019000000
chr7,35924320,35996837,72517,1,0,989,1,1.37898699615263000000
chr7,35981862,36014680,32818,1,0,,0,0.00000000000000000000
chr7,37930964,37937022,6058,1,0,51314,1,16.50709805216240000000
chr7,38298021,38383745,85724,1,0,445347,1,1.16653445942793000000
chr7,38303560,38357499,53939,1,0,445347,1,1.85394612432563000000
chr7,38321724,38354989,33265,1,0,,0,0.00000000000000000000
chr7,38286385,38327004,40619,1,0,445347,1,2.46190206553583000000
chr7,38371521,38407065,35544,1,0,,0,0.00000000000000000000
chr7,38285259,38311187,25928,1,0,445347,1,3.85683431039803000000
chr7,38289772,38301501,11729,1,0,445347,1,8.52587603376247000000
chr7,38397503,38404089,6586,1,0,,0,0.00000000000000000000
chr7,39546815,39551827,5012,1,0,,0,0.00000000000000000000
chr7,40006195,40141667,135472,1,0,8621,1,0.73815991496397800000
chr7,40075082,40198092,123010,1,0,136647;8621;79783,3,2.43882611169824000000
chr7,40393228,40486239,93011,1,0,79783,1,1.07514164991238000000
chr7,40162608,40209267,46659,1,0,79783;136647,2,4.28641848303650000000
chr7,40178325,40218063,39738,1,0,79783,1,2.51648296341034000000
chr7,40393251,40426663,33412,1,0,79783,1,2.99293666946007000000
chr7,42830554,42864221,33667,1,0,,0,0.00000000000000000000
chr7,44000845,44081141,80296,1,0,285955,1,1.24539204941716000000
chr7,44037235,44051009,13774,1,0,285955,1,7.26005517641934000000
chr7,44266166,44267385,1219,1,0,816,1,82.03445447087780000000
chr7,44266680,44267330,650,1,0,816,1,153.84615384615400000000
chr7,45000071,45001422,1351,1,0,,0,0.00000000000000000000
chr7,46704818,46722083,17265,1,0,,0,0.00000000000000000000
chr7,47799806,47802076,2270,1,0,,0,0.00000000000000000000
chr7,47799598,47801185,1587,1,0,,0,0.00000000000000000000
chr7,53188989,53239014,50025,1,0,,0,0.00000000000000000000
chr7,51451814,51481391,29577,1,0,,0,0.00000000000000000000
chr7,52720983,52743254,22271,1,0,,0,0.00000000000000000000
chr7,52728526,52744548,16022,1,0,,0,0.00000000000000000000
chr7,51741183,51750832,9649,1,0,,0,0.00000000000000000000
chr7,51590494,51598340,7846,1,0,,0,0.00000000000000000000
chr7,52736977,52742360,5383,1,0,,0,0.00000000000000000000
chr7,52964292,52964985,693,1,0,,0,0.00000000000000000000
chr7,54646638,55192215,545577,1,0,1956;23480,2,0.36658436847594400000
chr7,54303912,54419326,115414,1,0,,0,0.00000000000000000000
chr7,57004601,57912495,907894,1,0,90827;441234,2,0.22029003385857800000
chr7,55619800,56385412,765612,1,0,5723;51142;349075;2631;51373;25870;81552;908;389493;5260;346288,11,1.43675908946046000000
chr7,56996832,57601031,604199,1,0,90827;441234,2,0.33101676765436500000
chr7,56133342,56514848,381506,1,0,51142;389493;5260;25870,4,1.04847630181439000000
chr7,57633285,58029051,395766,1,0,,0,0.00000000000000000000
chr7,57740775,57932576,191801,1,0,,0,0.00000000000000000000
chr7,56031072,56186821,155749,1,0,5723;51142;908;389493;2631;25870;5260,7,4.49441087904256000000
chr7,57932501,58054155,121654,1,0,,0,0.00000000000000000000
chr7,57608023,57719158,111135,1,0,,0,0.00000000000000000000
chr7,55618296,55745843,127547,1,0,81552,1,0.78402471245893700000
chr7,57491052,57596638,105586,1,0,441234,1,0.94709525884113400000
chr7,56871929,56954917,82988,1,0,,0,0.00000000000000000000
chr7,57837683,57898040,60357,1,0,,0,0.00000000000000000000
chr7,57727191,57791738,64547,1,0,,0,0.00000000000000000000
chr7,57978001,58054300,76299,1,0,,0,0.00000000000000000000
chr7,56697249,56760814,63565,1,0,,0,0.00000000000000000000
chr7,57593156,57629386,36230,1,0,,0,0.00000000000000000000
chr7,57516693,57557944,41251,1,0,441234,1,2.42418365615379000000
chr7,57737949,57775535,37586,1,0,,0,0.00000000000000000000
chr7,56876251,56896004,19753,1,0,,0,0.00000000000000000000
chr7,57882194,57911172,28978,1,0,,0,0.00000000000000000000
chr7,57698617,57725185,26568,1,0,,0,0.00000000000000000000
chr7,56419329,56445602,26273,1,0,,0,0.00000000000000000000
chr7,57913999,57933968,19969,1,0,,0,0.00000000000000000000
chr7,56879177,56894219,15042,1,0,,0,0.00000000000000000000
chr7,56087306,56089233,1927,1,0,5723,1,51.89413596263620000000
chr7,61113011,62231602,1118591,1,0,,0,0.00000000000000000000
chr7,61962501,62764020,801519,1,0,,0,0.00000000000000000000
chr7,64603187,65167542,564355,1,0,168374,1,0.17719343321136500000
chr7,61173582,61842602,669020,1,0,,0,0.00000000000000000000
chr7,61929281,62510846,581565,1,0,,0,0.00000000000000000000
chr7,62254792,62761357,506565,1,0,,0,0.00000000000000000000
chr7,61856604,62349336,492732,1,0,,0,0.00000000000000000000
chr7,62609281,62991256,381975,1,0,,0,0.00000000000000000000
chr7,62483264,62675281,192017,1,0,,0,0.00000000000000000000
chr7,62074308,62396366,322058,1,0,,0,0.00000000000000000000
chr7,62028049,62266398,238349,1,0,,0,0.00000000000000000000
chr7,65133791,65342267,208476,1,0,154807,1,0.47967152094245900000
chr7,61740640,61914956,174316,1,0,,0,0.00000000000000000000
chr7,62667344,62831420,164076,1,0,,0,0.00000000000000000000
chr7,61097410,61245729,148319,1,0,,0,0.00000000000000000000
chr7,62424495,62613869,189374,1,0,,0,0.00000000000000000000
chr7,61987050,62152561,165511,1,0,,0,0.00000000000000000000
chr7,63131033,63300571,169538,1,0,,0,0.00000000000000000000
chr7,64021663,64161734,140071,1,0,340252;51427,2,1.42784730600910000000
chr7,61984769,62115500,130731,1,0,,0,0.00000000000000000000
chr7,61739666,61840080,100414,1,0,,0,0.00000000000000000000
chr7,62373894,62485832,111938,1,0,,0,0.00000000000000000000
chr7,62051848,62128436,76588,1,0,,0,0.00000000000000000000
chr7,62295764,62389418,93654,1,0,,0,0.00000000000000000000
chr7,61835328,61917160,81832,1,0,,0,0.00000000000000000000
chr7,65241832,65298693,56861,1,0,,0,0.00000000000000000000
chr7,65093702,65150946,57244,1,0,,0,0.00000000000000000000
chr7,64966866,65034218,67352,1,0,,0,0.00000000000000000000
chr7,64894379,64944644,50265,1,0,,0,0.00000000000000000000
chr7,65411743,65466616,54873,1,0,154807;2990,2,3.64477976418275000000
chr7,65057794,65105405,47611,1,0,,0,0.00000000000000000000
chr7,64534085,64581674,47589,1,0,,0,0.00000000000000000000
chr7,62121050,62162266,41216,1,0,,0,0.00000000000000000000
chr7,64840505,64879676,39171,1,0,168374,1,2.55290903985091000000
chr7,62145901,62187900,41999,1,0,,0,0.00000000000000000000
chr7,65248626,65287267,38641,1,0,,0,0.00000000000000000000
chr7,64951697,64982626,30929,1,0,,0,0.00000000000000000000
chr7,61776364,61803721,27357,1,0,,0,0.00000000000000000000
chr7,63209749,63226587,16838,1,0,,0,0.00000000000000000000
chr7,61736528,61761552,25024,1,0,,0,0.00000000000000000000
chr7,65035514,65059345,23831,1,0,,0,0.00000000000000000000
chr7,64551559,64566927,15368,1,0,,0,0.00000000000000000000
chr7,61057794,61077991,20197,1,0,,0,0.00000000000000000000
chr7,65263727,65284040,20313,1,0,,0,0.00000000000000000000
chr7,64583771,64601206,17435,1,0,,0,0.00000000000000000000
chr7,65262652,65275447,12795,1,0,,0,0.00000000000000000000
chr7,64568657,64583080,14423,1,0,,0,0.00000000000000000000
chr7,65110610,65120706,10096,1,0,,0,0.00000000000000000000
chr7,61968121,61976743,8622,1,0,,0,0.00000000000000000000
chr7,61065450,61070566,5116,1,0,,0,0.00000000000000000000
chr7,64601614,64609926,8312,1,0,,0,0.00000000000000000000
chr7,64716098,64722227,6129,1,0,,0,0.00000000000000000000
chr7,62156338,62162176,5838,1,0,,0,0.00000000000000000000
chr7,61054330,61057118,2788,1,0,,0,0.00000000000000000000
chr7,64719104,64722467,3363,1,0,,0,0.00000000000000000000
chr7,64593573,64596101,2528,1,0,,0,0.00000000000000000000
chr7,64719233,64721500,2267,1,0,,0,0.00000000000000000000
chr7,61973227,61975321,2094,1,0,,0,0.00000000000000000000
chr7,64346428,64347926,1498,1,0,,0,0.00000000000000000000
chr7,65929234,66046609,117375,1,0,,0,0.00000000000000000000
chr7,65931900,65939658,7758,1,0,,0,0.00000000000000000000
chr7,66101152,66131586,30434,1,0,154881,1,3.28579877768285000000
chr7,66581300,66732956,151656,1,0,55253,1,0.65938703381336700000
chr7,66462135,66582155,120020,1,0,55253,1,0.83319446758873500000
chr7,66741243,66771926,30683,1,0,,0,0.00000000000000000000
chr7,66740315,66757367,17052,1,0,,0,0.00000000000000000000
chr7,66437866,66456704,18838,1,0,51119,1,5.30841915277630000000
chr7,70282831,70617871,335040,1,0,64409,1,0.29847182425979000000
chr7,70210846,70300943,90097,1,0,26053,1,1.10991486952951000000
chr7,70314909,70366457,51548,1,0,,0,0.00000000000000000000
chr7,71227353,71266880,39527,1,0,83698,1,2.52991625977180000000
chr7,70323853,70364102,40249,1,0,,0,0.00000000000000000000
chr7,70418499,70426328,7829,1,0,,0,0.00000000000000000000
chr7,70196283,70203047,6764,1,0,26053,1,14.78415138971020000000
chr7,70421011,70425854,4843,1,0,,0,0.00000000000000000000
chr7,72284225,72700873,416648,1,0,378108;9883;441250,3,0.72003225744513400000
chr7,71998799,72327585,328786,1,0,441250,1,0.30414920343323600000
chr7,72192924,72323267,130343,1,0,441250,1,0.76720652432428300000
chr7,72328740,72423492,94752,1,0,9883,1,1.05538669368457000000
chr7,72037773,72112211,74438,1,0,441250,1,1.34339987640721000000
chr7,72149598,72216235,66637,1,0,441250,1,1.50066779716974000000
chr7,72478326,72528152,49826,1,0,,0,0.00000000000000000000
chr7,72303183,72349650,46467,1,0,,0,0.00000000000000000000
chr7,72263532,72303351,39819,1,0,441250,1,2.51136392174590000000
chr7,72328386,72346360,17974,1,0,,0,0.00000000000000000000
chr7,72332232,72344041,11809,1,0,,0,0.00000000000000000000
chr7,72510066,72520020,9954,1,0,,0,0.00000000000000000000
chr7,72519302,72527236,7934,1,0,,0,0.00000000000000000000
chr7,72491624,72499340,7716,1,0,,0,0.00000000000000000000
chr7,74301172,74333676,32504,1,0,,0,0.00000000000000000000
chr7,74316707,74333980,17273,1,0,,0,0.00000000000000000000
chr7,74311886,74321459,9573,1,0,,0,0.00000000000000000000
chr7,74472287,74474345,2058,1,0,81554,1,48.59086491739550000000
chr7,74472404,74473627,1223,1,0,81554,1,81.76614881439080000000
chr7,74694325,74713908,19583,1,0,,0,0.00000000000000000000
chr7,74695468,74702788,7320,1,0,,0,0.00000000000000000000
chr7,74907805,74985366,77561,1,0,,0,0.00000000000000000000
chr7,74916980,74927018,10038,1,0,,0,0.00000000000000000000
chr7,74973262,74982662,9400,1,0,,0,0.00000000000000000000
chr7,74945596,74954835,9239,1,0,,0,0.00000000000000000000
chr7,74909647,74917817,8170,1,0,,0,0.00000000000000000000
chr7,74965555,74973262,7707,1,0,,0,0.00000000000000000000
chr7,74937557,74944886,7329,1,0,,0,0.00000000000000000000
chr7,74772229,74774133,1904,1,0,,0,0.00000000000000000000
chr7,75119620,75138940,19320,1,0,442590,1,5.17598343685300000000
chr7,75122087,75135334,13247,1,0,442590,1,7.54887899146977000000
chr7,75126979,75139439,12460,1,0,442590,1,8.02568218298555000000
chr7,75328373,75425731,97358,1,0,10344;3092,2,2.05427391688408000000
chr7,75353823,75375513,21690,1,0,3092,1,4.61041954817888000000
chr7,75353462,75364748,11286,1,0,3092,1,8.86053517632465000000
chr7,75664252,75667736,3484,1,0,51657,1,28.70264064293920000000
chr7,75758612,75798416,39804,1,0,,0,0.00000000000000000000
chr7,76140860,76786678,645818,1,0,22932;57639;105375355,3,0.46452715780606900000
chr7,76127898,76476584,348686,1,0,113878;22932;105375355,3,0.86037294299168900000
chr7,76326553,76553149,226596,1,0,,0,0.00000000000000000000
chr7,76431576,76712153,280577,1,0,,0,0.00000000000000000000
chr7,76091282,76312482,221200,1,0,113878;22932;105375355,3,1.35623869801085000000
chr7,76457858,76592138,134280,1,0,,0,0.00000000000000000000
chr7,76295573,76442932,147359,1,0,,0,0.00000000000000000000
chr7,76188566,76285461,96895,1,0,22932,1,1.03204499716188000000
chr7,76060899,76144728,83829,1,0,113878;105375355;7784,3,3.57871381025659000000
chr7,76438115,76504450,66335,1,0,,0,0.00000000000000000000
chr7,76641470,76696030,54560,1,0,,0,0.00000000000000000000
chr7,76282049,76314792,32743,1,0,,0,0.00000000000000000000
chr7,76315925,76363940,48015,1,0,,0,0.00000000000000000000
chr7,76148577,76174963,26386,1,0,,0,0.00000000000000000000
chr7,76639584,76670596,31012,1,0,,0,0.00000000000000000000
chr7,76675902,76697657,21755,1,0,,0,0.00000000000000000000
chr7,76156853,76172848,15995,1,0,,0,0.00000000000000000000
chr7,76144157,76157036,12879,1,0,105375355,1,7.76457799518596000000
chr7,76668797,76682355,13558,1,0,,0,0.00000000000000000000
chr7,76145025,76149660,4635,1,0,105375355,1,21.57497303128370000000
chr7,79318189,79409613,91424,1,0,,0,0.00000000000000000000
chr7,81441603,81442401,798,1,0,,0,0.00000000000000000000
chr7,85418829,85531682,112853,1,0,,0,0.00000000000000000000
chr7,86684841,86778291,93450,1,0,222223,1,1.07009095773141000000
chr7,88157465,89812329,1654864,1,0,219557;219578;26872,3,0.18128377921086000000
chr7,88467967,89047822,579855,1,0,219578,1,0.17245690733028100000
chr7,88151788,88632723,480935,1,0,219557;219578,2,0.41585661263996200000
chr7,89529254,89891093,361839,1,0,79846;26872;261729,3,0.82909802425940800000
chr7,88917192,89250651,333459,1,0,219578,1,0.29988694262263100000
chr7,89209878,89370939,161061,1,0,,0,0.00000000000000000000
chr7,89702271,89751415,49144,1,0,,0,0.00000000000000000000
chr7,89810490,89812338,1848,1,0,,0,0.00000000000000000000
chr7,90105821,90167184,61363,1,0,,0,0.00000000000000000000
chr7,90184343,90222619,38276,1,0,,0,0.00000000000000000000
chr7,93326798,93332765,5967,1,0,,0,0.00000000000000000000
chr7,93541849,93542515,666,1,0,,0,0.00000000000000000000
chr7,96543299,96546429,3130,1,0,,0,0.00000000000000000000
chr7,97385701,97402792,17091,1,0,,0,0.00000000000000000000
chr7,97502755,97633641,130886,1,0,4951,1,0.76402365417233300000
chr7,99358163,99389170,31007,1,0,1576,1,3.22507820814655000000
chr7,99809377,99937347,127970,1,0,352954;79037;441272;10734,4,3.12573259357662000000
chr7,99899144,99931609,32465,1,0,441272,1,3.08024025874018000000
chr7,99902169,99923462,21293,1,0,441272,1,4.69637909172028000000
chr7,100959668,101141052,181384,1,0,64792;136227,2,1.10263308781370000000
chr7,100630947,100656356,25409,1,0,10071,1,3.93561336534299000000
chr7,100675054,100686171,11117,1,0,140453,1,8.99523252676082000000
chr7,102114231,102359638,245407,1,0,100134938;246721;100271927;10156;5439;548644;441273;100310812,8,3.25989071216387000000
chr7,102159068,102271226,112158,1,0,10156;548644;441273,3,2.67479805274702000000
chr7,102328707,102393620,64913,1,0,222234,1,1.54052346987506000000
chr7,102280412,102345668,65256,1,0,246721;100134938;100310812,3,4.59727841118058000000
chr7,101967858,102030032,62174,1,0,100289561;729597,2,3.21677871779200000000
chr7,102397857,102436790,38933,1,0,222234,1,2.56851514139676000000
chr7,102220093,102253572,33479,1,0,10156,1,2.98694704142896000000
chr7,101980135,101999589,19454,1,0,729597,1,5.14033103731880000000
chr7,102154741,102167950,13209,1,0,100271927,1,7.57059580588992000000
chr7,101985271,101997537,12266,1,0,729597,1,8.15261699005381000000
chr7,102203101,102216100,12999,1,0,548644,1,7.69289945380414000000
chr7,102257301,102269700,12399,1,0,,0,0.00000000000000000000
chr7,102113550,102119381,5831,1,0,5439;222229,2,34.29943405933800000000
chr7,103822662,103899099,76437,1,0,5001,1,1.30826693878619000000
chr7,104763559,105155978,392419,1,0,54517;6733,2,0.50965931822873000000
chr7,105011434,105190391,178957,1,0,60561;54517;6733,3,1.67638035952771000000
chr7,107936544,107999542,62998,1,0,4897,1,1.58735197942792000000
chr7,108595319,108642278,46959,1,0,,0,0.00000000000000000000
chr7,109414289,109453329,39040,1,0,,0,0.00000000000000000000
chr7,109429858,109456252,26394,1,0,,0,0.00000000000000000000
chr7,109430112,109449605,19493,1,0,,0,0.00000000000000000000
chr7,109441512,109453902,12390,1,0,,0,0.00000000000000000000
chr7,110181935,110188714,6779,1,0,,0,0.00000000000000000000
chr7,111094968,111097782,2814,1,0,83943,1,35.53660270078180000000
chr7,112434006,112480343,46337,1,0,154743,1,2.15810259619742000000
chr7,112570038,112608289,38251,1,0,154743,1,2.61431073697420000000
chr7,116559369,116604412,45043,1,0,7982,1,2.22010079257598000000
chr7,121083584,121085242,1658,1,0,,0,0.00000000000000000000
chr7,121843830,121931382,87552,1,0,,0,0.00000000000000000000
chr7,122424183,122458820,34637,1,0,93664,1,2.88708606403557000000
chr7,122794522,122880008,85486,1,0,6561,1,1.16978218655686000000
chr7,125583095,125604686,21591,1,0,,0,0.00000000000000000000
chr7,126043805,126054062,10257,1,0,,0,0.00000000000000000000
chr7,126045479,126046617,1138,1,0,,0,0.00000000000000000000
chr7,127214986,127217660,2674,1,0,,0,0.00000000000000000000
chr7,127928047,127947963,19916,1,0,,0,0.00000000000000000000
chr7,128213166,128254276,41110,1,0,,0,0.00000000000000000000
chr7,130407589,130469097,61508,1,0,136259,1,1.62580477336281000000
chr7,133624224,134074979,450755,1,0,84912;60412;136332,3,0.66555002163037600000
chr7,133770554,133800875,30321,1,0,,0,0.00000000000000000000
chr7,133798741,133834561,35820,1,0,136332,1,2.79173646007817000000
chr7,133781769,133800457,18688,1,0,,0,0.00000000000000000000
chr7,135897523,135986114,88591,1,0,,0,0.00000000000000000000
chr7,140202636,140232557,29921,1,0,27147,1,3.34213428695565000000
chr7,140267204,140345214,78010,1,0,27147,1,1.28188693757211000000
chr7,141763492,141793464,29972,1,0,8972,1,3.33644735086080000000
chr7,142109447,142120577,11130,1,0,,0,0.00000000000000000000
chr7,142351411,142456643,105232,1,0,100463482,1,0.95028128325984500000
chr7,142454908,142486480,31572,1,0,5644,1,3.16736348663373000000
chr7,142475423,142486381,10958,1,0,,0,0.00000000000000000000
chr7,143567074,144070444,503370,1,0,9747;135941;401427;100128553;402317;135948;346525;442361;392138;135946;100142659;346528;7984;26211;445328;393046,16,3.17857639509705000000
chr7,143215528,143528214,312686,1,0,285966;441294;340307,3,0.95942894789021600000
chr7,143880832,144078249,197417,1,0,402317;401427;346528;100142659;7984;445328;100128553,7,3.54579392858771000000
chr7,143225370,143401787,176417,1,0,285966;441294,2,1.13367759342920000000
chr7,143910421,144013373,102952,1,0,402317;401427;100142659,3,2.91397933017328000000
chr7,143448518,143572222,123704,1,0,9747;340307,2,1.61676259458061000000
chr7,143956034,144053312,97278,1,0,7984;401427;100142659;346528,4,4.11192664322868000000
chr7,143218356,143305811,87455,1,0,441294,1,1.14344520038877000000
chr7,143896576,143970229,73653,1,0,402317;401427;100142659,3,4.07315384302065000000
chr7,143446505,143513109,66604,1,0,340307,1,1.50141132664705000000
chr7,143399387,143451590,52203,1,0,285966,1,1.91559872038005000000
chr7,143505502,143547653,42151,1,0,,0,0.00000000000000000000
chr7,143884211,143930465,46254,1,0,402317;445328,2,4.32395036104985000000
chr7,143993383,144034914,41531,1,0,346528,1,2.40783992680167000000
chr7,144036532,144074453,37921,1,0,7984,1,2.63706125893305000000
chr7,143425343,143441500,16157,1,0,285966,1,6.18926780961812000000
chr7,143929920,143952039,22119,1,0,402317,1,4.52100004521000000000
chr7,144061693,144075026,13333,1,0,7984,1,7.50018750468762000000
chr7,143951742,143963034,11292,1,0,401427,1,8.85582713425434000000
chr7,143883299,143894081,10782,1,0,445328,1,9.27471712112781000000
chr7,143268495,143273347,4852,1,0,441294,1,20.61005770816160000000
chr7,143951842,143953545,1703,1,0,,0,0.00000000000000000000
chr7,143771313,143772244,931,1,0,392138,1,107.41138560687400000000
chr7,146133835,146139798,5963,1,0,26047,1,16.77008217340260000000
chr7,146220494,146259593,39099,1,0,26047,1,2.55761016905803000000
chr7,146704572,146778709,74137,1,0,26047,1,1.34885414840093000000
chr7,147104413,147144096,39683,1,0,26047,1,2.51997076833909000000
chr7,148073131,148076330,3199,1,0,26047,1,31.25976867771180000000
chr7,149434374,149847332,412958,1,0,155066;23145;643641;168544,4,0.96862150630330400000
chr7,149526743,149734453,207710,1,0,23145;643641;155066,3,1.44432140965770000000
chr7,149961203,149992074,30871,1,0,653857,1,3.23928606135208000000
chr7,149862878,149883330,20452,1,0,,0,0.00000000000000000000
chr7,151149962,151170840,20878,1,0,6009,1,4.78973081712808000000
chr7,151699918,151924683,224765,1,0,58508;168391;63917,3,1.33472738193224000000
chr7,152019089,152216853,197764,1,0,58508,1,0.50565320280738700000
chr7,151811861,151936585,124724,1,0,58508;63917,2,1.60354061768385000000
chr7,151912549,151955767,43218,1,0,58508,1,2.31385071035217000000
chr7,151953386,151990406,37020,1,0,58508,1,2.70124257158293000000
chr7,151938538,151967092,28554,1,0,58508,1,3.50213630314492000000
chr7,152098884,152113140,14256,1,0,58508,1,7.01459034792368000000
chr7,152930100,153519720,589620,1,0,,0,0.00000000000000000000
chr7,153480121,153710909,230788,1,0,1804,1,0.43329809175520400000
chr7,153646704,153947907,301203,1,0,1804,1,0.33200200529211200000
chr7,152587543,152812467,224924,1,0,,0,0.00000000000000000000
chr7,153519642,153638380,118738,1,0,1804,1,0.84219036871094300000
chr7,153151310,153209682,58372,1,0,,0,0.00000000000000000000
chr7,152918929,152956286,37357,1,0,,0,0.00000000000000000000
chr7,152511426,152546456,35030,1,0,57180,1,2.85469597487868000000
chr7,154392174,154400082,7908,1,0,1804,1,12.64542235710670000000
chr7,154450131,154455924,5793,1,0,1804,1,17.26221301570860000000
chr7,154446964,154449403,2439,1,0,1804,1,41.00041000410000000000
chr7,154448205,154449434,1229,1,0,1804,1,81.36696501220500000000
chr7,154906983,154959348,52365,1,0,,0,0.00000000000000000000
chr7,155138298,155142013,3715,1,0,,0,0.00000000000000000000
chr7,155946749,155948675,1926,1,0,,0,0.00000000000000000000
chr7,157439456,157443897,4441,1,0,5799,1,22.51745102454400000000
chr7,158502602,158982372,479770,1,0,55112;7434;57488,3,0.62529962273589400000
chr7,157495790,157858273,362483,1,0,5799,1,0.27587500655203100000
chr7,158287791,158518364,230573,1,0,54892;5799,2,0.86740424941341800000
chr7,158922705,159016415,93710,1,0,7434,1,1.06712197204140000000
chr7,159013147,159117175,104028,1,0,,0,0.00000000000000000000
chr7,157732875,157808966,76091,1,0,5799,1,1.31421587309932000000
chr7,158428062,158498013,69951,1,0,54892,1,1.42957212906177000000
chr7,159027567,159071104,43537,1,0,,0,0.00000000000000000000
chr7,159086457,159120518,34061,1,0,,0,0.00000000000000000000
chr7,158388065,158423848,35783,1,0,,0,0.00000000000000000000
chr7,159096499,159119186,22687,1,0,,0,0.00000000000000000000
chr7,158120999,158134906,13907,1,0,5799,1,7.19062342705113000000
chr7,159117462,159128541,11079,1,0,,0,0.00000000000000000000
chr7,159117533,159122709,5176,1,0,,0,0.00000000000000000000
chr7,157523852,157528033,4181,1,0,5799,1,23.91772303276730000000
chr7,158707230,158710650,3420,1,0,55112,1,29.23976608187130000000
chr7,157939700,157942168,2468,1,0,5799,1,40.51863857374390000000
chr7,157517552,157519176,1624,1,0,5799,1,61.57635467980300000000
chr7,158707734,158709764,2030,1,0,55112,1,49.26108374384240000000
chr7,157650782,157652807,2025,1,0,5799,1,49.38271604938270000000
chr7,158460033,158461058,1025,1,0,54892,1,97.56097560975610000000
chr7,158046631,158047330,699,1,0,5799,1,143.06151645207400000000
chr7,157891747,157892454,707,1,0,5799,1,141.44271570014100000000
chr8,166690,670673,503983,1,0,26260;157695;157697;169270,4,0.79367756452102500000
chr8,58250,403431,345181,1,0,26260;441308;169270,3,0.86910924992974700000
chr8,2591977,2930610,338633,1,0,64478,1,0.29530494665316100000
chr8,2216675,2515000,298325,1,0,,0,0.00000000000000000000
chr8,2572213,2745537,173324,1,0,,0,0.00000000000000000000
chr8,2132772,2270867,138095,1,0,,0,0.00000000000000000000
chr8,2354949,2565093,210144,1,0,,0,0.00000000000000000000
chr8,24555,199151,174596,1,0,441308;169270,2,1.14550161515728000000
chr8,268344,418124,149780,1,0,26260,1,0.66764588062491600000
chr8,562130,731716,169586,1,0,9228;157697,2,1.17934263441558000000
chr8,653312,831713,178401,1,0,9228;157697,2,1.12106994915948000000
chr8,2789073,2922813,133740,1,0,64478,1,0.74771945566023600000
chr8,148340,296306,147966,1,0,169270,1,0.67583093413351700000
chr8,2668990,2804767,135777,1,0,64478,1,0.73650176392172500000
chr8,1518588,1651595,133007,1,0,9228,1,0.75184012871503000000
chr8,17005,131941,114936,1,0,441308,1,0.87004941880698800000
chr8,208716,322006,113290,1,0,,0,0.00000000000000000000
chr8,344574,416946,72372,1,0,26260,1,1.38174984800752000000
chr8,442698,513779,71081,1,0,157695,1,1.40684571123085000000
chr8,2195083,2287535,92452,1,0,,0,0.00000000000000000000
chr8,2220126,2282716,62590,1,0,,0,0.00000000000000000000
chr8,616670,691804,75134,1,0,9228;157697,2,2.66191071951447000000
chr8,181330,244053,62723,1,0,169270,1,1.59431149658020000000
chr8,283678,341240,57562,1,0,,0,0.00000000000000000000
chr8,329703,384511,54808,1,0,26260,1,1.82455116041454000000
chr8,1914865,1965984,51119,1,0,9920,1,1.95621980085682000000
chr8,2264712,2310604,45892,1,0,,0,0.00000000000000000000
chr8,2147430,2182340,34910,1,0,,0,0.00000000000000000000
chr8,274944,309537,34593,1,0,,0,0.00000000000000000000
chr8,2246429,2270976,24547,1,0,,0,0.00000000000000000000
chr8,132133,170197,38064,1,0,,0,0.00000000000000000000
chr8,14450,44708,30258,1,0,,0,0.00000000000000000000
chr8,256076,284061,27985,1,0,,0,0.00000000000000000000
chr8,2537446,2556007,18561,1,0,,0,0.00000000000000000000
chr8,2251660,2266879,15219,1,0,,0,0.00000000000000000000
chr8,2306441,2324956,18515,1,0,,0,0.00000000000000000000
chr8,375976,384467,8491,1,0,26260,1,11.77717583323520000000
chr8,10073,21538,11465,1,0,,0,0.00000000000000000000
chr8,2254050,2263654,9604,1,0,,0,0.00000000000000000000
chr8,16849,21724,4875,1,0,,0,0.00000000000000000000
chr8,594461,599472,5011,1,0,157697,1,19.95609658750750000000
chr8,2254638,2259358,4720,1,0,,0,0.00000000000000000000
chr8,1336456,1340824,4368,1,0,9228,1,22.89377289377290000000
chr8,323804,327332,3528,1,0,,0,0.00000000000000000000
chr8,1298206,1300480,2274,1,0,9228,1,43.97537379067720000000
chr8,3139567,3141095,1528,1,0,64478,1,65.44502617801050000000
chr8,3181374,3182295,921,1,0,64478,1,108.57763300760000000000
chr8,3140040,3140759,719,1,0,64478,1,139.08205841446500000000
chr8,1746416,1746946,530,1,0,,0,0.00000000000000000000
chr8,3685702,5951470,2265768,1,0,64478,1,0.04413514534586070000
chr8,5590226,6137014,546788,1,0,,0,0.00000000000000000000
chr8,4494811,5092970,598159,1,0,64478,1,0.16717962949650500000
chr8,6126579,6297030,170451,1,0,79648,1,0.58667886958715400000
chr8,5799938,5951850,151912,1,0,,0,0.00000000000000000000
chr8,4623365,4710574,87209,1,0,64478,1,1.14667064179156000000
chr8,4586029,4657644,71615,1,0,64478,1,1.39635551211338000000
chr8,5743647,5804017,60370,1,0,,0,0.00000000000000000000
chr8,4718265,4762568,44303,1,0,64478,1,2.25718348644561000000
chr8,4502578,4537830,35252,1,0,64478,1,2.83671848405764000000
chr8,4003586,4026274,22688,1,0,64478,1,4.40761636107193000000
chr8,5595495,5606600,11105,1,0,,0,0.00000000000000000000
chr8,4025391,4033797,8406,1,0,64478,1,11.89626457292410000000
chr8,3996836,4004485,7649,1,0,64478,1,13.07360439273110000000
chr8,3786311,3790617,4306,1,0,64478,1,23.22340919647000000000
chr8,4122658,4125233,2575,1,0,64478,1,38.83495145631070000000
chr8,6135094,6136924,1830,1,0,,0,0.00000000000000000000
chr8,3580046,3581683,1637,1,0,64478,1,61.08735491753210000000
chr8,4122966,4124599,1633,1,0,64478,1,61.23698714023270000000
chr8,4449231,4449968,737,1,0,64478,1,135.68521031207600000000
chr8,6966183,8005045,1038862,1,0,401447;503614;504180;503841;140596;100133251;653423;100131980;645402;55894;245910;1673;100131608;245908;100132396;503618;392188;100289462;245909;414325;10407;645836,22,2.11770186993075000000
chr8,7246769,8004085,757316,1,0,503614;504180;503841;140596;100133251;653423;55894;245910;1673;100131608;245908;100132396;503618;392188;100289462;245909;414325;10407;645836,19,2.50886023799840000000
chr8,7250805,7660114,409309,1,0,100131608;503614;504180;503841;503618;100289462;100133251;55894;10407,9,2.19882778047881000000
chr8,6768075,7227905,459830,1,0,401447;1671;1670;728358;1669;645402;100131980;1667;1668,9,1.95724506882979000000
chr8,7524983,8042963,517980,1,0,645836;140596;245908;100132396;392188;100133251;653423;245909;414325;245910;1673,11,2.12363411714738000000
chr8,7043222,7448225,405003,1,0,401447;100131608;503614;504180;503841;503618;100289462;100131980;645402;55894;10407,11,2.71602926398076000000
chr8,6651912,7044046,392134,1,0,389610;1671;1670;728358;1669;1672;1667;1668,8,2.04011893893414000000
chr8,7569264,7842412,273148,1,0,645836;140596;245908;100132396;392188;100133251;653423;245909;414325;245910;1673,11,4.02712082826892000000
chr8,6968588,7216845,248257,1,0,401447;100131980;645402,3,1.20842514007661000000
chr8,7840403,8083334,242931,1,0,,0,0.00000000000000000000
chr8,7228156,7446529,218373,1,0,100131608;503614;504180;503841;503618;100289462;55894;10407,8,3.66345656285347000000
chr8,7939353,8114345,174992,1,0,,0,0.00000000000000000000
chr8,7734784,7910989,176205,1,0,645836;414325;100132396;392188;1673,5,2.83760392724384000000
chr8,7105017,7294241,189224,1,0,401447;100131980;645402;55894;100289462,5,2.64237094660297000000
chr8,7621482,7797878,176396,1,0,140596;245908;100132396;100133251;653423;245909;414325;245910;1673,9,5.10215651148552000000
chr8,7292803,7425959,133156,1,0,10407;100131608;503614;504180;503841;503618,6,4.50599297065097000000
chr8,7100155,7205476,105321,1,0,401447;645402,2,1.89895652339040000000
chr8,7210913,7347782,136869,1,0,100131980;10407;55894;504180;503841;503618;100289462,7,5.11437944311714000000
chr8,7665720,7796292,130572,1,0,140596;245908;100132396;653423;245909;414325;245910;1673,8,6.12688784731795000000
chr8,8011113,8136248,125135,1,0,,0,0.00000000000000000000
chr8,7940732,8056872,116140,1,0,,0,0.00000000000000000000
chr8,7350528,7449879,99351,1,0,100131608;503614,2,2.01306479049028000000
chr8,7275779,7345471,69692,1,0,10407;55894;504180;503841;503618,5,7.17442461114619000000
chr8,7543134,7632173,89039,1,0,,0,0.00000000000000000000
chr8,7205474,7279617,74143,1,0,100131980;100289462,2,2.69748998556843000000
chr8,8077425,8147248,69823,1,0,,0,0.00000000000000000000
chr8,7177608,7235838,58230,1,0,401447;100131980;645402,3,5.15198351365276000000
chr8,7656169,7739590,83421,1,0,245909;414325;140596;245908;245910;653423,6,7.19243355989499000000
chr8,7936902,8001069,64167,1,0,,0,0.00000000000000000000
chr8,7733257,7811579,78322,1,0,100132396;414325;1673,3,3.83034141109778000000
chr8,7811560,7879611,68051,1,0,645836;392188,2,2.93897224140718000000
chr8,7403729,7463766,60037,1,0,,0,0.00000000000000000000
chr8,7706807,7759880,53073,1,0,414325;1673;653423,3,5.65259171330055000000
chr8,7110945,7157807,46862,1,0,,0,0.00000000000000000000
chr8,6828736,6878156,49420,1,0,728358;1667;1668,3,6.07041683528936000000
chr8,7167517,7215653,48136,1,0,401447;100131980;645402,3,6.23234169852086000000
chr8,6879860,6921297,41437,1,0,1670,1,2.41330212129256000000
chr8,8095698,8136378,40680,1,0,,0,0.00000000000000000000
chr8,7936751,7978932,42181,1,0,,0,0.00000000000000000000
chr8,7723637,7747781,24144,1,0,414325,1,4.14181577203446000000
chr8,7214606,7248742,34136,1,0,100131980,1,2.92945863604406000000
chr8,7186645,7226106,39461,1,0,401447;100131980;645402,3,7.60244291832442000000
chr8,7748721,7774444,25723,1,0,1673,1,3.88757143412510000000
chr8,7416288,7441402,25114,1,0,,0,0.00000000000000000000
chr8,7365287,7394830,29543,1,0,503614,1,3.38489659140913000000
chr8,7069911,7096515,26604,1,0,,0,0.00000000000000000000
chr8,7867718,7891591,23873,1,0,,0,0.00000000000000000000
chr8,7186419,7202490,16071,1,0,401447;645402,2,12.44477630514590000000
chr8,7823665,7837441,13776,1,0,645836;392188,2,14.51800232288040000000
chr8,7775940,7788030,12090,1,0,100132396,1,8.27129859387924000000
chr8,7705402,7721319,15917,1,0,653423,1,6.28259094050386000000
chr8,7916471,7928195,11724,1,0,,0,0.00000000000000000000
chr8,7212582,7227421,14839,1,0,100131980,1,6.73899858481030000000
chr8,7825120,7837356,12236,1,0,645836;392188,2,16.34521085322000000000
chr8,7188106,7200378,12272,1,0,401447;645402,2,16.29726205997390000000
chr8,6979596,6988762,9166,1,0,,0,0.00000000000000000000
chr8,6824456,6826570,2114,1,0,,0,0.00000000000000000000
chr8,8583218,8588982,5764,1,0,,0,0.00000000000000000000
chr8,9205161,9316817,111656,1,0,,0,0.00000000000000000000
chr8,10183543,10547696,364153,1,0,203074;94137;203076;4482,4,1.09843939223348000000
chr8,11397149,11491496,94347,1,0,640,1,1.05991711448165000000
chr8,11392137,11443083,50946,1,0,640,1,1.96286263887253000000
chr8,11903309,12553669,650360,1,0,392197;377630;728957;85002;653333;100133267;245940,7,1.07632695737745000000
chr8,12174011,12504370,330359,1,0,245940;653333,2,0.60540200206442100000
chr8,12027847,12278571,250724,1,0,245940;85002,2,0.79768989007833300000
chr8,12230668,12408909,178241,1,0,653333,1,0.56103814498347700000
chr8,11863554,12058032,194478,1,0,392197;377630;728957;100133267;85002,5,2.57098489289277000000
chr8,12267305,12432097,164792,1,0,653333,1,0.60682557405699300000
chr8,12232590,12328693,96103,1,0,653333,1,1.04055024296848000000
chr8,12175383,12277316,101933,1,0,245940,1,0.98103656323271200000
chr8,12257533,12357173,99640,1,0,653333,1,1.00361300682457000000
chr8,11951018,12050994,99976,1,0,392197;377630;728957;85002,4,4.00096023045531000000
chr8,11901700,11998080,96380,1,0,392197;377630;100133267;728957,4,4.15023863872173000000
chr8,12158144,12240206,82062,1,0,245940,1,1.21859082157393000000
chr8,12233054,12309727,76673,1,0,653333,1,1.30424008451476000000
chr8,11985759,12041503,55744,1,0,392197;377630;85002,3,5.38174512055109000000
chr8,12203440,12251632,48192,1,0,,0,0.00000000000000000000
chr8,12389851,12428483,38632,1,0,,0,0.00000000000000000000
chr8,12233244,12270300,37056,1,0,,0,0.00000000000000000000
chr8,11984149,12014248,30099,1,0,392197;377630,2,6.64473902787468000000
chr8,12207233,12240948,33715,1,0,,0,0.00000000000000000000
chr8,12468728,12490327,21599,1,0,,0,0.00000000000000000000
chr8,12227682,12256119,28437,1,0,,0,0.00000000000000000000
chr8,11865067,11888393,23326,1,0,,0,0.00000000000000000000
chr8,11985747,11999045,13298,1,0,392197;377630,2,15.03985561738610000000
chr8,12237337,12251609,14272,1,0,,0,0.00000000000000000000
chr8,12512907,12529730,16823,1,0,,0,0.00000000000000000000
chr8,12229750,12242948,13198,1,0,,0,0.00000000000000000000
chr8,11985695,11996481,10786,1,0,392197;377630,2,18.54255516410160000000
chr8,12283126,12293852,10726,1,0,653333,1,9.32314003356330000000
chr8,12231976,12239733,7757,1,0,,0,0.00000000000000000000
chr8,12456051,12465358,9307,1,0,,0,0.00000000000000000000
chr8,12269663,12277569,7906,1,0,,0,0.00000000000000000000
chr8,12027292,12035253,7961,1,0,,0,0.00000000000000000000
chr8,12814492,12840402,25910,1,0,57604,1,3.85951370127364000000
chr8,15765490,16304858,539368,1,0,4481,1,0.18540217439670100000
chr8,16286234,16889657,603423,1,0,26281;286097,2,0.33144245413250700000
chr8,18832311,19341621,509310,1,0,63898;55790;23362,3,0.58903222006243700000
chr8,13335001,13579129,244128,1,0,157773;10395,2,0.81924236466116100000
chr8,17604837,17815899,211062,1,0,2267;57509;5108,3,1.42138329021804000000
chr8,15669454,15885126,215672,1,0,,0,0.00000000000000000000
chr8,16266330,16403141,136811,1,0,,0,0.00000000000000000000
chr8,14780392,14918733,138341,1,0,137868,1,0.72285150461540700000
chr8,13416756,13526937,110181,1,0,157773;10395,2,1.81519499732259000000
chr8,15877827,15998876,121049,1,0,4481,1,0.82611173987393500000
chr8,15947114,16021867,74753,1,0,4481,1,1.33773895362059000000
chr8,15883478,15935151,51673,1,0,,0,0.00000000000000000000
chr8,16204221,16240988,36767,1,0,,0,0.00000000000000000000
chr8,19984631,20024142,39511,1,0,6570,1,2.53094075067703000000
chr8,17729040,17754181,25141,1,0,2267,1,3.97756652480013000000
chr8,13504545,13524732,20187,1,0,,0,0.00000000000000000000
chr8,15963080,15985028,21948,1,0,4481,1,4.55622380171314000000
chr8,15421889,15433104,11215,1,0,7991,1,8.91662951404369000000
chr8,13598773,13609767,10994,1,0,,0,0.00000000000000000000
chr8,21167866,21171758,3892,1,0,,0,0.00000000000000000000
chr8,17580748,17581779,1031,1,0,57509,1,96.99321047526670000000
chr8,22994548,23021232,26684,1,0,8793,1,3.74756408334583000000
chr8,24975628,24991235,15607,1,0,,0,0.00000000000000000000
chr8,24978806,24990668,11862,1,0,,0,0.00000000000000000000
chr8,25066726,25070660,3934,1,0,80005,1,25.41942043721400000000
chr8,25411336,25416596,5260,1,0,,0,0.00000000000000000000
chr8,25511993,25596018,84025,1,0,,0,0.00000000000000000000
chr8,25579082,25589289,10207,1,0,,0,0.00000000000000000000
chr8,26333957,26342514,8557,1,0,,0,0.00000000000000000000
chr8,29174571,29187229,12658,1,0,,0,0.00000000000000000000
chr8,32680129,32691129,11000,1,0,,0,0.00000000000000000000
chr8,36247232,36437766,190534,1,0,,0,0.00000000000000000000
chr8,39225972,39389203,163231,1,0,,0,0.00000000000000000000
chr8,39231634,39341401,109767,1,0,,0,0.00000000000000000000
chr8,39232186,39322780,90594,1,0,,0,0.00000000000000000000
chr8,39242862,39244174,1312,1,0,,0,0.00000000000000000000
chr8,40774688,40779590,4902,1,0,,0,0.00000000000000000000
chr8,41833101,41908800,75699,1,0,7994,1,1.32102141375712000000
chr8,42190479,42194131,3652,1,0,,0,0.00000000000000000000
chr8,43026750,43819890,793140,1,0,340441;138050,2,0.25216229165090700000
chr8,43379667,43820330,440663,1,0,,0,0.00000000000000000000
chr8,43481055,43814457,333402,1,0,,0,0.00000000000000000000
chr8,43734846,43827719,92873,1,0,,0,0.00000000000000000000
chr8,43820519,43838857,18338,1,0,,0,0.00000000000000000000
chr8,43631514,43637977,6463,1,0,,0,0.00000000000000000000
chr8,46875219,47437981,562762,1,0,,0,0.00000000000000000000
chr8,46997908,47201224,203316,1,0,,0,0.00000000000000000000
chr8,48174372,48304848,130476,1,0,23514,1,0.76642447653208200000
chr8,46843561,46927612,84051,1,0,,0,0.00000000000000000000
chr8,48161759,48229848,68089,1,0,23514,1,1.46866601066252000000
chr8,47469036,47502908,33872,1,0,,0,0.00000000000000000000
chr8,47521126,47567390,46264,1,0,,0,0.00000000000000000000
chr8,47408101,47456400,48299,1,0,,0,0.00000000000000000000
chr8,46954213,46992148,37935,1,0,,0,0.00000000000000000000
chr8,47257465,47286216,28751,1,0,,0,0.00000000000000000000
chr8,47524002,47543021,19019,1,0,,0,0.00000000000000000000
chr8,46838946,46857819,18873,1,0,,0,0.00000000000000000000
chr8,47525533,47536546,11013,1,0,,0,0.00000000000000000000
chr8,47531288,47538431,7143,1,0,,0,0.00000000000000000000
chr8,49092895,49093897,1002,1,0,,0,0.00000000000000000000
chr8,50435230,50541200,105970,1,0,,0,0.00000000000000000000
chr8,51890365,52192356,301991,1,0,,0,0.00000000000000000000
chr8,51745238,51885442,140204,1,0,,0,0.00000000000000000000
chr8,51183095,51195105,12010,1,0,54212,1,8.32639467110741000000
chr8,53322025,53914777,592752,1,0,389658;9821;9705;2831,4,0.67481847383053900000
chr8,53517591,53758638,241047,1,0,9821,1,0.41485685364265100000
chr8,53402811,53689112,286301,1,0,389658;9821,2,0.69856549575446800000
chr8,53714999,53858688,143689,1,0,2831,1,0.69594749772077200000
chr8,53261249,53403133,141884,1,0,9705,1,0.70480110512813300000
chr8,53860527,53932741,72214,1,0,,0,0.00000000000000000000
chr8,53335903,53390193,54290,1,0,,0,0.00000000000000000000
chr8,54256366,54272954,16588,1,0,,0,0.00000000000000000000
chr8,54511407,54517458,6051,1,0,,0,0.00000000000000000000
chr8,56150662,56207540,56878,1,0,114786,1,1.75814902071100000000
chr8,56696980,56893783,196803,1,0,96764;4067,2,1.01624467106701000000
chr8,57050344,57103872,53528,1,0,5324,1,1.86818113884322000000
chr8,58103876,58196854,92978,1,0,,0,0.00000000000000000000
chr8,58097834,58173764,75930,1,0,,0,0.00000000000000000000
chr8,58085198,58134668,49470,1,0,,0,0.00000000000000000000
chr8,58115091,58134591,19500,1,0,,0,0.00000000000000000000
chr8,58115150,58125975,10825,1,0,,0,0.00000000000000000000
chr8,59478951,59534210,55259,1,0,8439;6386,2,3.61931992978519000000
chr8,60133316,60138603,5287,1,0,,0,0.00000000000000000000
chr8,60135447,60136564,1117,1,0,,0,0.00000000000000000000
chr8,62297084,62552149,255065,1,0,444;157807,2,0.78411385333150400000
chr8,62380669,62387091,6422,1,0,157807,1,15.57147306135160000000
chr8,68018872,68130826,111954,1,0,10565;79848,2,1.78644800543080000000
chr8,69727145,69831498,104353,1,0,116328,1,0.95828581832817500000
chr8,70428418,70465837,37419,1,0,23213,1,2.67243913519870000000
chr8,70858400,70865544,7144,1,0,,0,0.00000000000000000000
chr8,72681146,72683081,1935,1,0,,0,0.00000000000000000000
chr8,73595983,73639951,43968,1,0,9312,1,2.27438136826783000000
chr8,75358522,75367738,9216,1,0,,0,0.00000000000000000000
chr8,75363019,75366934,3915,1,0,,0,0.00000000000000000000
chr8,75609942,75689307,79365,1,0,,0,0.00000000000000000000
chr8,75894879,75912789,17910,1,0,83690,1,5.58347292015634000000
chr8,79688425,80143370,454945,1,0,3574,1,0.21980678983173800000
chr8,82045016,82046423,1407,1,0,,0,0.00000000000000000000
chr8,82045168,82046025,857,1,0,,0,0.00000000000000000000
chr8,83029507,83056724,27217,1,0,,0,0.00000000000000000000
chr8,85260791,85269462,8671,1,0,138046,1,11.53269519086610000000
chr8,85293082,85346303,53221,1,0,138046,1,1.87895755434885000000
chr8,86310578,86495901,185323,1,0,761;760,2,1.07919686169553000000
chr8,87175013,87332671,157658,1,0,157724,1,0.63428433698258300000
chr8,86781904,86901080,119176,1,0,,0,0.00000000000000000000
chr8,86463460,86535973,72513,1,0,,0,0.00000000000000000000
chr8,86763116,86840611,77495,1,0,,0,0.00000000000000000000
chr8,87110927,87171990,61063,1,0,245972,1,1.63765291584102000000
chr8,86515410,86550906,35496,1,0,,0,0.00000000000000000000
chr8,86554466,86576414,21948,1,0,,0,0.00000000000000000000
chr8,86852933,86872225,19292,1,0,,0,0.00000000000000000000
chr8,86539517,86555941,16424,1,0,,0,0.00000000000000000000
chr8,86566887,86576451,9564,1,0,,0,0.00000000000000000000
chr8,90471789,90783871,312082,1,0,8767,1,0.32042860530245300000
chr8,90588796,90704421,115625,1,0,,0,0.00000000000000000000
chr8,90526009,90555896,29887,1,0,,0,0.00000000000000000000
chr8,95556410,95580731,24321,1,0,25962,1,4.11167303975988000000
chr8,97520773,97521912,1139,1,0,6383,1,87.79631255487270000000
chr8,100213556,100228531,14975,1,0,157680,1,6.67779632721202000000
chr8,103213187,103586832,373645,1,0,51366;4956;50484,3,0.80290114948681200000
chr8,103161259,103324834,163575,1,0,51366;50484,2,1.22268072749503000000
chr8,103391448,103531609,140161,1,0,51366,1,0.71346522927205100000
chr8,107535827,107547049,11222,1,0,55074,1,8.91106754589200000000
chr8,112294093,112296384,2291,1,0,,0,0.00000000000000000000
chr8,112294597,112296293,1696,1,0,,0,0.00000000000000000000
chr8,115307658,115309162,1504,1,0,,0,0.00000000000000000000
chr8,115591177,115621083,29906,1,0,,0,0.00000000000000000000
chr8,120150120,120161159,11039,1,0,,0,0.00000000000000000000
chr8,120468251,120493724,25473,1,0,,0,0.00000000000000000000
chr8,122323495,122394503,71008,1,0,,0,0.00000000000000000000
chr8,122398625,122430583,31958,1,0,,0,0.00000000000000000000
chr8,122317204,122340963,23759,1,0,,0,0.00000000000000000000
chr8,123496773,123563457,66684,1,0,,0,0.00000000000000000000
chr8,125245133,125481153,236020,1,0,157378;55039,2,0.84738581476146100000
chr8,125432490,125485772,53282,1,0,55039,1,1.87680642618520000000
chr8,125867771,125967592,99821,1,0,,0,0.00000000000000000000
chr8,127192279,127194543,2264,1,0,,0,0.00000000000000000000
chr8,129762854,129766029,3175,1,0,,0,0.00000000000000000000
chr8,130868091,131125773,257682,1,0,50807;51571,2,0.77615044900303500000
chr8,131061379,131062900,1521,1,0,,0,0.00000000000000000000
chr8,132069267,132177640,108373,1,0,,0,0.00000000000000000000
chr8,132664949,132734272,69323,1,0,,0,0.00000000000000000000
chr8,131850825,131852764,1939,1,0,114,1,51.57297576070140000000
chr8,136675548,136723285,47737,1,0,,0,0.00000000000000000000
chr8,137159995,137163874,3879,1,0,,0,0.00000000000000000000
chr8,138783637,139250473,466836,1,0,51059,1,0.21420798738743400000
chr8,138806123,138922793,116670,1,0,,0,0.00000000000000000000
chr8,138743021,138743807,786,1,0,,0,0.00000000000000000000
chr8,140329690,140457653,127963,1,0,,0,0.00000000000000000000
chr8,140265167,140266903,1736,1,0,,0,0.00000000000000000000
chr8,140604241,140606771,2530,1,0,,0,0.00000000000000000000
chr8,140759649,140760778,1129,1,0,83696,1,88.57395925597870000000
chr8,141025744,141363967,338223,1,0,83696,1,0.29566292061746200000
chr8,141407785,141522222,114437,1,0,83696;54108,2,1.74768649999563000000
chr8,142001824,142005115,3291,1,0,5747,1,30.38590094196290000000
chr8,142560491,142561665,1174,1,0,,0,0.00000000000000000000
chr8,142560707,142561293,586,1,0,,0,0.00000000000000000000
chr8,142640541,142644998,4457,1,0,,0,0.00000000000000000000
chr8,144153615,144155560,1945,1,0,,0,0.00000000000000000000
chr8,144292869,144295263,2394,1,0,338328,1,41.77109440267330000000
chr8,144292829,144293768,939,1,0,,0,0.00000000000000000000
chr8,144596817,144699712,102895,1,0,65263;23144;84948;7264;93100;79792;642475;1936,8,7.77491617668497000000
chr8,144700604,144714760,14156,1,0,,0,0.00000000000000000000
chr8,144678672,144684974,6302,1,0,84948;1936,2,31.73595683909870000000
chr8,144743636,144744705,1069,1,0,,0,0.00000000000000000000
chr8,145219366,145554739,335373,1,0,642658;8694;727957;83482;3297;23246,6,1.78905278600245000000
chr8,145160213,145284762,124549,1,0,727957;84232;340390;51236,4,3.21158740736578000000
chr8,145513462,145562784,49322,1,0,8694;83482;3297,3,6.08247840720165000000
chr8,145171456,145218648,47192,1,0,727957;51236,2,4.23800644176979000000
chr8,145559358,145562138,2780,1,0,83482,1,35.97122302158270000000
chr8,145602596,145607718,5122,1,0,203054,1,19.52362358453730000000
chr8,145744859,145750365,5506,1,0,9684;441381,2,36.32401017072290000000
chr8,146174398,146295604,121206,1,0,65265;7564,2,1.65008332920812000000
chr8,146265852,146301310,35458,1,0,65265,1,2.82023802808957000000
chr8,146193953,146223876,29923,1,0,,0,0.00000000000000000000
chr8,146276746,146278906,2160,1,0,65265,1,46.29629629629630000000
chr9,73839,478171,404332,1,0,81704;23189;55871;2298;157983,5,1.23660754033814000000
chr9,643453,1138368,494915,1,0,1761;58524;10655;23189,4,0.80821959326349000000
chr9,514830,877545,362715,1,0,1761;23189,2,0.55139710240822700000
chr9,289789,527208,237419,1,0,81704;23189,2,0.84239256335845100000
chr9,73137,322906,249769,1,0,81704;2298;157983;55871,4,1.60147976730499000000
chr9,216241,427609,211368,1,0,81704,1,0.47310851216835100000
chr9,47448,218910,171462,1,0,81704;2298;157983;55871,4,2.33287842204104000000
chr9,377450,484057,106607,1,0,81704;23189,2,1.87604941514159000000
chr9,193539,273407,79868,1,0,81704;157983,2,2.50413181749887000000
chr9,305178,363556,58378,1,0,81704,1,1.71297406557265000000
chr9,225672,293179,67507,1,0,81704,1,1.48132786229576000000
chr9,116933,201032,84099,1,0,2298;55871,2,2.37814956182594000000
chr9,224230,276540,52310,1,0,81704,1,1.91168036704263000000
chr9,10526,42240,31714,1,0,100287171,1,3.15318156019424000000
chr9,90651,118159,27508,1,0,2298,1,3.63530609277301000000
chr9,208131,232163,24032,1,0,81704;157983,2,8.32223701731025000000
chr9,11235,31212,19977,1,0,100287171,1,5.00575662011313000000
chr9,514301,527559,13258,1,0,23189,1,7.54261577915221000000
chr9,10485,20285,9800,1,0,100287171,1,10.20408163265310000000
chr9,319999,322880,2881,1,0,81704,1,34.71017007983340000000
chr9,1722795,1759540,36745,1,0,,0,0.00000000000000000000
chr9,4376284,4377610,1326,1,0,,0,0.00000000000000000000
chr9,4599944,4600533,589,1,0,55064,1,169.77928692699500000000
chr9,5101854,5226899,125045,1,0,3717;11172,2,1.59942420728538000000
chr9,5302684,5339885,37201,1,0,6019;6013,2,5.37619956452783000000
chr9,6617589,6755396,137807,1,0,2731;23081,2,1.45130508609867000000
chr9,6672217,6796787,124570,1,0,23081,1,0.80276149955848100000
chr9,6922140,6995063,72923,1,0,23081,1,1.37130946340661000000
chr9,6683125,6690284,7159,1,0,,0,0.00000000000000000000
chr9,6011632,6014285,2653,1,0,26953,1,37.69317753486620000000
chr9,10254793,10325251,70458,1,0,5789,1,1.41928524794913000000
chr9,10312450,10328987,16537,1,0,5789,1,6.04704601802020000000
chr9,10686231,11155008,468777,1,0,,0,0.00000000000000000000
chr9,10820224,10892170,71946,1,0,,0,0.00000000000000000000
chr9,11421904,11457882,35978,1,0,,0,0.00000000000000000000
chr9,11440114,11465211,25097,1,0,,0,0.00000000000000000000
chr9,11699029,11751670,52641,1,0,,0,0.00000000000000000000
chr9,11986832,12038545,51713,1,0,,0,0.00000000000000000000
chr9,12112298,12169877,57579,1,0,,0,0.00000000000000000000
chr9,13486358,13503524,17166,1,0,,0,0.00000000000000000000
chr9,15815337,15828126,12789,1,0,203238,1,7.81921964187974000000
chr9,15815337,15817189,1852,1,0,203238,1,53.99568034557240000000
chr9,16055230,16096241,41011,1,0,,0,0.00000000000000000000
chr9,17580913,17635184,54271,1,0,6456,1,1.84260470601242000000
chr9,17910048,17911533,1485,1,0,,0,0.00000000000000000000
chr9,19322691,19441412,118721,1,0,340485;55667;6194,3,2.52693289308547000000
chr9,22406958,22746000,339042,1,0,63951,1,0.29494870841960600000
chr9,20085508,20422693,337185,1,0,4300,1,0.29657309785429400000
chr9,21166047,21239960,73913,1,0,3451;3441;3452;3448;3446;3444;3449,7,9.47059380623165000000
chr9,21251089,21278743,27654,1,0,,0,0.00000000000000000000
chr9,21190821,21209982,19161,1,0,3444;3446,2,10.43786858723450000000
chr9,22496584,22502720,6136,1,0,,0,0.00000000000000000000
chr9,22666357,22666924,567,1,0,,0,0.00000000000000000000
chr9,23358241,23392679,34438,1,0,,0,0.00000000000000000000
chr9,23362782,23378488,15706,1,0,,0,0.00000000000000000000
chr9,24466395,24497256,30861,1,0,,0,0.00000000000000000000
chr9,27208623,27293520,84897,1,0,7010;54586,2,2.35579584673192000000
chr9,27200776,27239253,38477,1,0,7010,1,2.59895522000156000000
chr9,28454635,28479222,24587,1,0,158038,1,4.06718997844389000000
chr9,30251990,30396197,144207,1,0,,0,0.00000000000000000000
chr9,30181815,30229825,48010,1,0,,0,0.00000000000000000000
chr9,31291355,31292642,1287,1,0,,0,0.00000000000000000000
chr9,32080938,32090230,9292,1,0,,0,0.00000000000000000000
chr9,33086298,33254682,168384,1,0,2683;27290;573,3,1.78164196123147000000
chr9,32716572,32727150,10578,1,0,,0,0.00000000000000000000
chr9,32882738,32883305,567,1,0,,0,0.00000000000000000000
chr9,33289975,33552969,262994,1,0,364;65083;4799;360;441459,5,1.90118405743097000000
chr9,33485985,33510699,24714,1,0,,0,0.00000000000000000000
chr9,33381794,33396057,14263,1,0,364,1,7.01114772488256000000
chr9,33723782,33788819,65037,1,0,5646,1,1.53758629703092000000
chr9,35170039,35175162,5123,1,0,10497,1,19.51981260979890000000
chr9,35913286,35914367,1081,1,0,,0,0.00000000000000000000
chr9,36362611,36363818,1207,1,0,152006,1,82.85004142502070000000
chr9,37502437,37514512,12075,1,0,26267;64425,2,16.56314699792960000000
chr9,43153944,45413070,2259126,1,0,728577;389730,2,0.08852981197153240000
chr9,43515434,44781699,1266265,1,0,728577;389730,2,0.15794482197644300000
chr9,68581159,69868836,1287677,1,0,653404;728747;644019,3,0.23297767996166700000
chr9,38972705,40189160,1216455,1,0,79937;647060,2,0.16441216485607800000
chr9,39916667,40967105,1050438,1,0,26149;727830,2,0.19039676782446900000
chr9,45260402,46136914,876512,1,0,,0,0.00000000000000000000
chr9,38934340,39809774,875434,1,0,79937;647060,2,0.22845811334720800000
chr9,69079474,69913959,834485,1,0,653404;728747;644019,3,0.35950316662372600000
chr9,43580349,44349371,769022,1,0,728577;389730,2,0.26007058315626900000
chr9,44283472,44840754,557282,1,0,,0,0.00000000000000000000
chr9,67738257,68364558,626301,1,0,84210,1,0.15966763584921600000
chr9,43313320,43785784,472464,1,0,728577;389730,2,0.42331267567476000000
chr9,45821535,46401782,580247,1,0,,0,0.00000000000000000000
chr9,38897382,39313460,416078,1,0,79937,1,0.24033955171866800000
chr9,69490595,69923070,432475,1,0,,0,0.00000000000000000000
chr9,68709661,69155850,446189,1,0,,0,0.00000000000000000000
chr9,44448603,44848287,399684,1,0,,0,0.00000000000000000000
chr9,44175774,44459627,283853,1,0,,0,0.00000000000000000000
chr9,45378525,45672985,294460,1,0,,0,0.00000000000000000000
chr9,42035340,42327330,291990,1,0,,0,0.00000000000000000000
chr9,43503511,43798036,294525,1,0,728577;389730,2,0.67905950258891400000
chr9,68077920,68301670,223750,1,0,,0,0.00000000000000000000
chr9,38771955,39008318,236363,1,0,,0,0.00000000000000000000
chr9,41472101,41651503,179402,1,0,727905,1,0.55740738676268900000
chr9,69773911,69951466,177555,1,0,,0,0.00000000000000000000
chr9,44726106,44884685,158579,1,0,,0,0.00000000000000000000
chr9,45865565,46068883,203318,1,0,,0,0.00000000000000000000
chr9,39065541,39303477,237936,1,0,79937,1,0.42028108398897200000
chr9,69490468,69679189,188721,1,0,,0,0.00000000000000000000
chr9,45066948,45241287,174339,1,0,,0,0.00000000000000000000
chr9,67533741,67720463,186722,1,0,,0,0.00000000000000000000
chr9,44702475,44858805,156330,1,0,,0,0.00000000000000000000
chr9,40041269,40231836,190567,1,0,,0,0.00000000000000000000
chr9,68187802,68347732,159930,1,0,,0,0.00000000000000000000
chr9,66664501,66863200,198699,1,0,,0,0.00000000000000000000
chr9,44128015,44323846,195831,1,0,,0,0.00000000000000000000
chr9,65718792,65887760,168968,1,0,,0,0.00000000000000000000
chr9,44257222,44435258,178036,1,0,,0,0.00000000000000000000
chr9,66627342,66764724,137382,1,0,,0,0.00000000000000000000
chr9,43000103,43160512,160409,1,0,441425,1,0.62340641734566000000
chr9,68391303,68514147,122844,1,0,,0,0.00000000000000000000
chr9,42845904,42994903,148999,1,0,,0,0.00000000000000000000
chr9,40476246,40626472,150226,1,0,,0,0.00000000000000000000
chr9,43693126,43842698,149572,1,0,728577,1,0.66857433209424200000
chr9,39075999,39192868,116869,1,0,79937,1,0.85565890013605000000
chr9,46076351,46202140,125789,1,0,,0,0.00000000000000000000
chr9,39146048,39278087,132039,1,0,79937,1,0.75735199448647700000
chr9,69865732,69988303,122571,1,0,,0,0.00000000000000000000
chr9,67898051,67987599,89548,1,0,84210,1,1.11671952472417000000
chr9,46266431,46391053,124622,1,0,,0,0.00000000000000000000
chr9,41800791,41915968,115177,1,0,,0,0.00000000000000000000
chr9,69800270,69911517,111247,1,0,,0,0.00000000000000000000
chr9,42732162,42833951,101789,1,0,,0,0.00000000000000000000
chr9,44727847,44819629,91782,1,0,,0,0.00000000000000000000
chr9,66917267,67014026,96759,1,0,,0,0.00000000000000000000
chr9,69002417,69088291,85874,1,0,,0,0.00000000000000000000
chr9,46047571,46117850,70279,1,0,,0,0.00000000000000000000
chr9,67810820,67905631,94811,1,0,,0,0.00000000000000000000
chr9,66769593,66857151,87558,1,0,,0,0.00000000000000000000
chr9,65580127,65674129,94002,1,0,,0,0.00000000000000000000
chr9,46379438,46450936,71498,1,0,,0,0.00000000000000000000
chr9,68664260,68742848,78588,1,0,,0,0.00000000000000000000
chr9,41576606,41650220,73614,1,0,,0,0.00000000000000000000
chr9,68753698,68836795,83097,1,0,,0,0.00000000000000000000
chr9,45657275,45724171,66896,1,0,,0,0.00000000000000000000
chr9,44209273,44260533,51260,1,0,,0,0.00000000000000000000
chr9,68445328,68512147,66819,1,0,,0,0.00000000000000000000
chr9,40355547,40424475,68928,1,0,,0,0.00000000000000000000
chr9,65968427,66046120,77693,1,0,,0,0.00000000000000000000
chr9,45730061,45795879,65818,1,0,,0,0.00000000000000000000
chr9,46905291,46980348,75057,1,0,,0,0.00000000000000000000
chr9,67208477,67268559,60082,1,0,,0,0.00000000000000000000
chr9,68228743,68300336,71593,1,0,,0,0.00000000000000000000
chr9,40764515,40832486,67971,1,0,26149,1,1.47121566550441000000
chr9,68293438,68342149,48711,1,0,,0,0.00000000000000000000
chr9,41465177,41532907,67730,1,0,727905,1,1.47645061272700000000
chr9,44163465,44216539,53074,1,0,,0,0.00000000000000000000
chr9,43334560,43396564,62004,1,0,,0,0.00000000000000000000
chr9,67307729,67365930,58201,1,0,,0,0.00000000000000000000
chr9,66970664,67015878,45214,1,0,,0,0.00000000000000000000
chr9,67794779,67851418,56639,1,0,,0,0.00000000000000000000
chr9,43160227,43212575,52348,1,0,,0,0.00000000000000000000
chr9,46405638,46458990,53352,1,0,,0,0.00000000000000000000
chr9,45361291,45401425,40134,1,0,,0,0.00000000000000000000
chr9,42296598,42341474,44876,1,0,,0,0.00000000000000000000
chr9,66455869,66498508,42639,1,0,,0,0.00000000000000000000
chr9,66243007,66269026,26019,1,0,,0,0.00000000000000000000
chr9,66497887,66537269,39382,1,0,,0,0.00000000000000000000
chr9,41937704,41966502,28798,1,0,,0,0.00000000000000000000
chr9,44869928,44907067,37139,1,0,,0,0.00000000000000000000
chr9,44726671,44763938,37267,1,0,,0,0.00000000000000000000
chr9,67772378,67809632,37254,1,0,,0,0.00000000000000000000
chr9,66933002,66963224,30222,1,0,,0,0.00000000000000000000
chr9,69676788,69713038,36250,1,0,,0,0.00000000000000000000
chr9,46097673,46119694,22021,1,0,,0,0.00000000000000000000
chr9,44244310,44278568,34258,1,0,,0,0.00000000000000000000
chr9,69709220,69744587,35367,1,0,,0,0.00000000000000000000
chr9,42796997,42832018,35021,1,0,,0,0.00000000000000000000
chr9,68354067,68388365,34298,1,0,,0,0.00000000000000000000
chr9,44145648,44175778,30130,1,0,,0,0.00000000000000000000
chr9,41975464,42008096,32632,1,0,,0,0.00000000000000000000
chr9,40996570,41029046,32476,1,0,,0,0.00000000000000000000
chr9,67292844,67317362,24518,1,0,,0,0.00000000000000000000
chr9,44958628,44988275,29647,1,0,,0,0.00000000000000000000
chr9,43181611,43212479,30868,1,0,,0,0.00000000000000000000
chr9,68664260,68695750,31490,1,0,,0,0.00000000000000000000
chr9,68411037,68436855,25818,1,0,,0,0.00000000000000000000
chr9,67337125,67366268,29143,1,0,,0,0.00000000000000000000
chr9,44259494,44279355,19861,1,0,,0,0.00000000000000000000
chr9,42782193,42807315,25122,1,0,,0,0.00000000000000000000
chr9,69502801,69525800,22999,1,0,,0,0.00000000000000000000
chr9,41459864,41479434,19570,1,0,,0,0.00000000000000000000
chr9,44445082,44458065,12983,1,0,,0,0.00000000000000000000
chr9,65528752,65550006,21254,1,0,,0,0.00000000000000000000
chr9,43403389,43425306,21917,1,0,,0,0.00000000000000000000
chr9,43466112,43481428,15316,1,0,,0,0.00000000000000000000
chr9,65596408,65616893,20485,1,0,,0,0.00000000000000000000
chr9,39844517,39863647,19130,1,0,,0,0.00000000000000000000
chr9,39315460,39333721,18261,1,0,,0,0.00000000000000000000
chr9,41345407,41363008,17601,1,0,,0,0.00000000000000000000
chr9,40664477,40682135,17658,1,0,,0,0.00000000000000000000
chr9,44307267,44323236,15969,1,0,,0,0.00000000000000000000
chr9,44258465,44275140,16675,1,0,,0,0.00000000000000000000
chr9,44891710,44908262,16552,1,0,,0,0.00000000000000000000
chr9,44235835,44252261,16426,1,0,,0,0.00000000000000000000
chr9,68397871,68413970,16099,1,0,,0,0.00000000000000000000
chr9,46118272,46134027,15755,1,0,,0,0.00000000000000000000
chr9,44726732,44739489,12757,1,0,,0,0.00000000000000000000
chr9,44353026,44368202,15176,1,0,,0,0.00000000000000000000
chr9,69267985,69278313,10328,1,0,,0,0.00000000000000000000
chr9,44244702,44259149,14447,1,0,,0,0.00000000000000000000
chr9,41971423,41985739,14316,1,0,,0,0.00000000000000000000
chr9,44626150,44635578,9428,1,0,,0,0.00000000000000000000
chr9,40359056,40368030,8974,1,0,,0,0.00000000000000000000
chr9,42073201,42086900,13699,1,0,,0,0.00000000000000000000
chr9,42279323,42289269,9946,1,0,,0,0.00000000000000000000
chr9,39869762,39880606,10844,1,0,,0,0.00000000000000000000
chr9,44101517,44113481,11964,1,0,,0,0.00000000000000000000
chr9,43392432,43404174,11742,1,0,,0,0.00000000000000000000
chr9,39043224,39053264,10040,1,0,,0,0.00000000000000000000
chr9,42991103,42997544,6441,1,0,,0,0.00000000000000000000
chr9,43468727,43477858,9131,1,0,,0,0.00000000000000000000
chr9,41601963,41607057,5094,1,0,,0,0.00000000000000000000
chr9,44333971,44340694,6723,1,0,,0,0.00000000000000000000
chr9,42875866,42880622,4756,1,0,,0,0.00000000000000000000
chr9,46375292,46378322,3030,1,0,,0,0.00000000000000000000
chr9,46125839,46129010,3171,1,0,,0,0.00000000000000000000
chr9,44862406,44865386,2980,1,0,,0,0.00000000000000000000
chr9,70153246,70174108,20862,1,0,,0,0.00000000000000000000
chr9,70147685,70151424,3739,1,0,,0,0.00000000000000000000
chr9,71047299,71200407,153108,1,0,5239;169693,2,1.30626747132743000000
chr9,70558919,70652583,93664,1,0,,0,0.00000000000000000000
chr9,70318931,70392253,73322,1,0,,0,0.00000000000000000000
chr9,70854085,70901026,46941,1,0,445571,1,2.13033382331011000000
chr9,70671249,70735204,63955,1,0,,0,0.00000000000000000000
chr9,70701826,70735048,33222,1,0,,0,0.00000000000000000000
chr9,70835469,70869037,33568,1,0,445571,1,2.97902764537655000000
chr9,70406760,70415475,8715,1,0,,0,0.00000000000000000000
chr9,70426949,70429031,2082,1,0,349334,1,48.03073967339100000000
chr9,71540942,71817211,276269,1,0,5568;9414;8395;2395,4,1.44786421929351000000
chr9,71686769,71717615,30846,1,0,2395,1,3.24191143097971000000
chr9,71739732,71745433,5701,1,0,9414,1,17.54078231889140000000
chr9,71740026,71742965,2939,1,0,9414,1,34.02517863218780000000
chr9,71740194,71742712,2518,1,0,9414,1,39.71405877680700000000
chr9,71895582,71896481,899,1,0,,0,0.00000000000000000000
chr9,72030993,72054902,23909,1,0,320,1,4.18252540884186000000
chr9,72093633,72123241,29608,1,0,320,1,3.37746554985139000000
chr9,72029769,72049070,19301,1,0,320,1,5.18107870058546000000
chr9,74487173,74535496,48323,1,0,138241;51104,2,4.13881588477537000000
chr9,78919551,78922076,2525,1,0,5125,1,39.60396039603960000000
chr9,79768701,79788697,19996,1,0,,0,0.00000000000000000000
chr9,79769644,79778548,8904,1,0,,0,0.00000000000000000000
chr9,79770398,79777403,7005,1,0,,0,0.00000000000000000000
chr9,81436281,81460558,24277,1,0,,0,0.00000000000000000000
chr9,83427080,83431735,4655,1,0,,0,0.00000000000000000000
chr9,85376471,85384244,7773,1,0,,0,0.00000000000000000000
chr9,86392243,86444978,52735,1,0,80318,1,1.89627382193989000000
chr9,86507078,86517507,10429,1,0,55582,1,9.58864704190239000000
chr9,87238243,87276201,37958,1,0,,0,0.00000000000000000000
chr9,89154952,89155776,824,1,0,,0,0.00000000000000000000
chr9,91149081,91150193,1112,1,0,158046,1,89.92805755395680000000
chr9,93417870,94128163,710293,1,0,6850;549,2,0.28157394202111000000
chr9,93577919,93687363,109444,1,0,6850,1,0.91370929425094100000
chr9,97042237,97244392,202155,1,0,54754;169841;84641,3,1.48400979446464000000
chr9,97077103,97098848,21745,1,0,54754,1,4.59875833524948000000
chr9,101308448,101312520,4072,1,0,9568,1,24.55795677799610000000
chr9,101309040,101311127,2087,1,0,9568,1,47.91566842357450000000
chr9,105968615,105989355,20740,1,0,,0,0.00000000000000000000
chr9,106568245,106569725,1480,1,0,,0,0.00000000000000000000
chr9,107362058,107367653,5595,1,0,392376,1,17.87310098302060000000
chr9,107361985,107367022,5037,1,0,392376,1,19.85308715505260000000
chr9,108536106,108538162,2056,1,0,55151,1,48.63813229571980000000
chr9,112055812,112115033,59221,1,0,54566,1,1.68859019604532000000
chr9,112721869,113066303,344434,1,0,255220;11217;7295;445815;401546,5,1.45165692120987000000
chr9,112891605,113066667,175062,1,0,255220;11217;7295;445815;401546,5,2.85613097074179000000
chr9,113024538,113029791,5253,1,0,,0,0.00000000000000000000
chr9,114429280,114478085,48805,1,0,158401;552891;2790,3,6.14691117713349000000
chr9,115377434,115592520,215086,1,0,58493;158405;401548,3,1.39479092084097000000
chr9,115815695,115877579,61884,1,0,7539,1,1.61592657229655000000
chr9,115821992,115853153,31161,1,0,,0,0.00000000000000000000
chr9,115852525,115882922,30397,1,0,,0,0.00000000000000000000
chr9,115881234,115907800,26566,1,0,,0,0.00000000000000000000
chr9,115825155,115837427,12272,1,0,,0,0.00000000000000000000
chr9,116118952,116141024,22072,1,0,54836;81932,2,9.06125407756434000000
chr9,116953983,117447204,493221,1,0,9550;5004;25861;85301;5005;100505478;80709;203197,8,1.62199095334546000000
chr9,116598396,117093358,494962,1,0,5004;5005;113220;114991;259;85301,6,1.21221427099454000000
chr9,117078800,117098147,19347,1,0,5004;5005,2,10.33752002894510000000
chr9,117087079,117097545,10466,1,0,5004;5005,2,19.10949742021780000000
chr9,119513404,119515884,2480,1,0,23245,1,40.32258064516130000000
chr9,119521372,119536855,15483,1,0,23245,1,6.45869663501905000000
chr9,121534231,121537916,3685,1,0,,0,0.00000000000000000000
chr9,124226357,124227849,1492,1,0,,0,0.00000000000000000000
chr9,124872121,124899579,27458,1,0,4702,1,3.64192585038969000000
chr9,128419722,128572386,152664,1,0,79109;5090,2,1.31006655138081000000
chr9,128510002,128525639,15637,1,0,5090,1,6.39508857197672000000
chr9,128508347,128511433,3086,1,0,5090,1,32.40440699935190000000
chr9,129520417,129523059,2642,1,0,,0,0.00000000000000000000
chr9,130622568,130646494,23926,1,0,203,1,4.17955362367299000000
chr9,131412325,131414355,2030,1,0,89891,1,49.26108374384240000000
chr9,131424578,131462254,37676,1,0,6418,1,2.65420957638815000000
chr9,131445934,131458675,12741,1,0,6418,1,7.84867749784161000000
chr9,131448643,131454822,6179,1,0,6418,1,16.18384851917790000000
chr9,132026885,132028020,1135,1,0,,0,0.00000000000000000000
chr9,132157444,132160333,2889,1,0,,0,0.00000000000000000000
chr9,132215527,132218230,2703,1,0,,0,0.00000000000000000000
chr9,133379202,133387370,8168,1,0,,0,0.00000000000000000000
chr9,134670080,134763835,93755,1,0,9442,1,1.06660978081169000000
chr9,134618113,134622163,4050,1,0,,0,0.00000000000000000000
chr9,135589954,135734009,144055,1,0,158067,1,0.69417930651487300000
chr9,135938539,135956102,17563,1,0,1056,1,5.69378807720777000000
chr9,135943299,135957453,14154,1,0,1056,1,7.06514059629787000000
chr9,136625268,136626148,880,1,0,,0,0.00000000000000000000
chr9,136533481,136534433,952,1,0,1757,1,105.04201680672300000000
chr9,136692363,136693634,1271,1,0,7410,1,78.67820613690010000000
chr9,136756303,136757380,1077,1,0,7410,1,92.85051067780870000000
chr9,136877077,136879752,2675,1,0,,0,0.00000000000000000000
chr9,137216790,137219019,2229,1,0,6256,1,44.86316733961420000000
chr9,138144520,138310277,165757,1,0,157927,1,0.60329277194929900000
chr9,138219080,138301804,82724,1,0,157927,1,1.20883903099463000000
chr9,138156152,138218699,62547,1,0,,0,0.00000000000000000000
chr9,138315814,138360813,44999,1,0,,0,0.00000000000000000000
chr9,138213942,138217608,3666,1,0,,0,0.00000000000000000000
chr9,138338293,138339079,786,1,0,,0,0.00000000000000000000
chr9,138479139,138480207,1068,1,0,,0,0.00000000000000000000
chr9,139054772,139058851,4079,1,0,,0,0.00000000000000000000
chr9,139399884,139654708,254824,1,0,138307;138311;158062;389812;10555;414332;4851;51162,8,3.13942171851945000000
chr9,139492741,139493260,519,1,0,,0,0.00000000000000000000
chr9,139663637,139674096,10459,1,0,,0,0.00000000000000000000
chr9,139738802,139748994,10192,1,0,29085;389813;158056,3,29.43485086342230000000
chr9,140230697,140264730,34033,1,0,54932,1,2.93832456733171000000
chr9,140223110,140224250,1140,1,0,54932,1,87.71929824561400000000
chr9,140344692,140346828,2136,1,0,26012,1,46.81647940074910000000
chr9,140930127,141122376,192249,1,0,100132403;774,2,1.04031750490250000000
chr9,141035603,141153370,117767,1,0,100132403,1,0.84913430757342900000
chr9,141018379,141089916,71537,1,0,774,1,1.39787802116387000000
chr9,141061380,141116464,55084,1,0,100132403,1,1.81540919323215000000
chr9,141091742,141153370,61628,1,0,100132403,1,1.62263906016746000000
chr9,140977280,141009164,31884,1,0,774,1,3.13636933885334000000
chr9,141089009,141119278,30269,1,0,100132403,1,3.30371006640457000000
chr9,141048969,141071181,22212,1,0,,0,0.00000000000000000000
chr9,141072972,141092798,19826,1,0,,0,0.00000000000000000000
chr9,141006045,141018112,12067,1,0,774,1,8.28706389326262000000
chrX,685355,686227,872,1,0,,0,0.00000000000000000000
chrX,1450624,1453595,2971,1,0,,0,0.00000000000000000000
chrX,1452048,1453254,1206,1,0,,0,0.00000000000000000000
chrX,1935517,1940345,4828,1,0,,0,0.00000000000000000000
chrX,5055525,5057308,1783,1,0,,0,0.00000000000000000000
chrX,8455803,8515757,59954,1,0,3730,1,1.66794542482570000000
chrX,9371901,9382634,10733,1,0,,0,0.00000000000000000000
chrX,17787639,17793339,5700,1,0,,0,0.00000000000000000000
chrX,20143867,20146413,2546,1,0,1964,1,39.27729772191670000000
chrX,26059960,26064483,4523,1,0,,0,0.00000000000000000000
chrX,26515855,26522414,6559,1,0,,0,0.00000000000000000000
chrX,30301127,30309760,8633,1,0,,0,0.00000000000000000000
chrX,36493834,36502366,8532,1,0,,0,0.00000000000000000000
chrX,37337586,37344151,6565,1,0,,0,0.00000000000000000000
chrX,47863263,48007627,144364,1,0,7569;57232;729201;389852,4,2.77077387714389000000
chrX,47881691,47951985,70294,1,0,57232,1,1.42259652317410000000
chrX,49293915,49371336,77421,1,0,729422;645073;729442;2543;100008586;729447;729431;100132399,8,10.33311375466600000000
chrX,53539696,53548381,8685,1,0,,0,0.00000000000000000000
chrX,56794435,56807887,13452,1,0,550643,1,7.43383883437407000000
chrX,57744142,57757278,13136,1,0,,0,0.00000000000000000000
chrX,58558783,58581854,23071,1,0,,0,0.00000000000000000000
chrX,61708219,61904253,196034,1,0,,0,0.00000000000000000000
chrX,62423594,62505460,81866,1,0,,0,0.00000000000000000000
chrX,62470203,62504561,34358,1,0,,0,0.00000000000000000000
chrX,63722947,63735218,12271,1,0,,0,0.00000000000000000000
chrX,63871223,63879033,7810,1,0,,0,0.00000000000000000000
chrX,64658579,64663167,4588,1,0,,0,0.00000000000000000000
chrX,72538321,72544314,5993,1,0,,0,0.00000000000000000000
chrX,78921002,78926289,5287,1,0,,0,0.00000000000000000000
chrX,79211811,79219032,7221,1,0,,0,0.00000000000000000000
chrX,79298539,79303039,4500,1,0,,0,0.00000000000000000000
chrX,88459002,89265165,806163,1,0,90316,1,0.12404439300736900000
chrX,91539788,92373579,833791,1,0,27328,1,0.11993413217461000000
chrX,101055462,101067890,12428,1,0,,0,0.00000000000000000000
chrX,103260139,103311694,51555,1,0,158983;286436,2,3.87935214819125000000
chrX,103322828,103336800,13972,1,0,,0,0.00000000000000000000
chrX,114205626,114400230,194604,1,0,57631;3598,2,1.02772810425274000000
chrX,115133890,115156033,22143,1,0,,0,0.00000000000000000000
chrX,115138371,115145199,6828,1,0,,0,0.00000000000000000000
chrX,114542318,114545110,2792,1,0,,0,0.00000000000000000000
chrX,115934895,116049342,114447,1,0,,0,0.00000000000000000000
chrX,116469384,116471139,1755,1,0,,0,0.00000000000000000000
chrX,119034715,119058434,23719,1,0,158798,1,4.21602934356423000000
chrX,120006512,120123897,117385,1,0,728042;255313;728075;653282;728072;643311;728082;100507170;728036;728062;728096;728049;728090,13,11.07466882480730000000
chrX,134782493,134977046,194553,1,0,541466;102723631;441521;102723680;102723737;441519;55511,7,3.59799129286107000000
chrX,134838596,134897058,58462,1,0,441521;541466;441519,3,5.13153843522288000000
chrX,134753661,134802864,49203,1,0,,0,0.00000000000000000000
chrX,134923820,134971984,48164,1,0,102723680;102723737;102723631,3,6.22871854497135000000
chrX,134860742,134912976,52234,1,0,441521;441519,2,3.82892368955087000000
chrX,134851425,134892475,41050,1,0,441521;541466;441519,3,7.30816077953715000000
chrX,134869165,134880837,11672,1,0,441521,1,8.56751199451679000000
chrX,134936991,134947878,10887,1,0,102723680,1,9.18526683200147000000
chrX,140079711,140206213,126502,1,0,728695,1,0.79050133594725800000
chrX,140081666,140110810,29144,1,0,728695,1,3.43123799066703000000
chrX,140085701,140103800,18099,1,0,728695,1,5.52516713630587000000
chrX,140656994,140690775,33781,1,0,728712;30014,2,5.92048784819869000000
chrX,141314752,141320722,5970,1,0,,0,0.00000000000000000000
chrX,143161004,143295559,134555,1,0,,0,0.00000000000000000000
chrX,144422220,144424392,2172,1,0,,0,0.00000000000000000000
chrX,146359941,146369163,9222,1,0,,0,0.00000000000000000000
chrX,148880088,149053559,173471,1,0,4107,1,0.57646523049962200000
chrX,150723114,150731721,8607,1,0,,0,0.00000000000000000000
chrX,152952763,152978988,26225,1,0,6535;10134,2,7.62631077216397000000
chrX,153409846,153460630,50784,1,0,5956;2652,2,3.93824826717076000000
chrX,153784907,153798128,13221,1,0,8517,1,7.56372437788367000000
chrY,6119981,6131321,11340,1,0,,0,0.00000000000000000000
chrY,27040718,28423206,1382488,1,0,57135;442868;9085,3,0.21700007522669300000
chrY,26333849,27002735,668886,1,0,57135;442867;57054,3,0.44850692046178300000
chrY,25849203,26217059,367856,1,0,253175,1,0.27184550476273300000
chrY,28284607,28436871,152264,1,0,,0,0.00000000000000000000
chrY,25531837,25618249,86412,1,0,,0,0.00000000000000000000
chr1,61724,346583,284859,-1,0,79501,1,0.35105087078168500000
chr1,834801,1029900,195099,-1,0,375790;84808;84069;148398;54991;401934;26155;339451;9636;57801,10,5.12560289904100000000
chr1,523102,617975,94873,-1,0,,0,0.00000000000000000000
chr1,371965,460419,88454,-1,0,,0,0.00000000000000000000
chr1,415991,464262,48271,-1,0,,0,0.00000000000000000000
chr1,522151,565535,43384,-1,0,,0,0.00000000000000000000
chr1,767447,800391,32944,-1,0,,0,0.00000000000000000000
chr1,713044,755966,42922,-1,0,,0,0.00000000000000000000
chr1,60905,97505,36600,-1,0,79501,1,2.73224043715847000000
chr1,775800,791968,16168,-1,0,,0,0.00000000000000000000
chr1,565138,573443,8305,-1,0,,0,0.00000000000000000000
chr1,564582,570166,5584,-1,0,,0,0.00000000000000000000
chr1,754201,759100,4899,-1,0,,0,0.00000000000000000000
chr1,1011248,1014703,3455,-1,0,,0,0.00000000000000000000
chr1,724359,726928,2569,-1,0,,0,0.00000000000000000000
chr1,766596,769111,2515,-1,0,,0,0.00000000000000000000
chr1,87811,89158,1347,-1,0,,0,0.00000000000000000000
chr1,136250,137520,1270,-1,0,,0,0.00000000000000000000
chr1,869393,870384,991,-1,0,148398,1,100.90817356205900000000
chr1,947116,948002,886,-1,0,,0,0.00000000000000000000
chr1,963841,964480,639,-1,0,375790,1,156.49452269170600000000
chr1,869551,870311,760,-1,0,148398,1,131.57894736842100000000
chr1,873400,874044,644,-1,0,148398,1,155.27950310559000000000
chr1,964980,965433,453,-1,0,375790,1,220.75055187638000000000
chr1,1504541,1672592,168051,-1,0,8510;984;142678;728661;29101;9906;643988;728642,8,4.76045962237654000000
chr1,1393754,1445361,51607,-1,0,219293;83858,2,3.87544325382216000000
chr1,1227753,1298391,70638,-1,0,54587;54973;126789;1855;80772;83756;116983,7,9.90968034202554000000
chr1,1593969,1668696,74727,-1,0,728642;728661;9906,3,4.01461319201895000000
chr1,1627358,1676597,49239,-1,0,728642;9906,2,4.06182091431589000000
chr1,1585840,1646559,60719,-1,0,728642;984;728661,3,4.94079283255653000000
chr1,1393169,1426078,32909,-1,0,219293;83858,2,6.07736485459905000000
chr1,1420011,1458055,38044,-1,0,55210;83858,2,5.25707076017243000000
chr1,1616990,1652775,35785,-1,0,728642;728661,2,5.58893391085650000000
chr1,1643586,1671585,27999,-1,0,728642;9906,2,7.14311225400907000000
chr1,1660501,1691900,31399,-1,0,65220;9906,2,6.36962960603841000000
chr1,1663658,1672055,8397,-1,0,9906,1,11.90901512444920000000
chr1,1400227,1409102,8875,-1,0,219293;83858,2,22.53521126760560000000
chr1,1414267,1416772,2505,-1,0,83858,1,39.92015968063870000000
chr1,1223552,1225600,2048,-1,0,6339,1,48.82812500000000000000
chr1,1443542,1445749,2207,-1,0,,0,0.00000000000000000000
chr1,1522875,1524673,1798,-1,0,,0,0.00000000000000000000
chr1,1285360,1287006,1646,-1,0,,0,0.00000000000000000000
chr1,1649334,1650587,1253,-1,0,728642,1,79.80845969672790000000
chr1,1540993,1541870,877,-1,0,,0,0.00000000000000000000
chr1,1183406,1183746,340,-1,0,,0,0.00000000000000000000
chr1,1142715,1143140,425,-1,0,,0,0.00000000000000000000
chr1,1302470,1302853,383,-1,0,,0,0.00000000000000000000
chr1,1465911,1466230,319,-1,0,55210,1,313.47962382445100000000
chr1,1598413,1598580,167,-1,0,728661,1,598.80239520958100000000
chr1,1058906,1058985,79,-1,0,,0,0.00000000000000000000
chr1,1866313,1867098,785,-1,0,85452,1,127.38853503184700000000
chr1,1910403,1911773,1370,-1,0,85452,1,72.99270072992700000000
chr1,1912935,1913787,852,-1,0,85452,1,117.37089201877900000000
chr1,1922955,1924561,1606,-1,0,85452,1,62.26650062266500000000
chr1,2024493,2027492,2999,-1,0,5590,1,33.34444814938310000000
chr1,2037733,2038228,495,-1,0,5590,1,202.02020202020200000000
chr1,2053115,2055760,2645,-1,0,5590,1,37.80718336483930000000
chr1,2073723,2074000,277,-1,0,5590,1,361.01083032491000000000
chr1,2395452,2485486,90034,-1,0,388585;55229;9651,3,3.33207454961459000000
chr1,2481985,2537041,55056,-1,0,79258;127281;8764,3,5.44899738448126000000
chr1,2303675,2320380,16705,-1,0,79906,1,5.98623166716552000000
chr1,2390805,2391051,246,-1,0,,0,0.00000000000000000000
chr1,2367783,2368008,225,-1,0,,0,0.00000000000000000000
chr1,2566193,2566623,430,-1,0,,0,0.00000000000000000000
chr1,2627633,2691911,64278,-1,0,100287898,1,1.55574224462491000000
chr1,2582294,2632994,50700,-1,0,100287898,1,1.97238658777120000000
chr1,2588780,2614637,25857,-1,0,100287898,1,3.86742468190432000000
chr1,2609210,2626391,17181,-1,0,100287898,1,5.82038298120016000000
chr1,2618398,2624948,6550,-1,0,100287898,1,15.26717557251910000000
chr1,2876503,2876863,360,-1,0,,0,0.00000000000000000000
chr1,2876601,2876721,120,-1,0,,0,0.00000000000000000000
chr1,2911535,2911850,315,-1,0,,0,0.00000000000000000000
chr1,2919031,2919366,335,-1,0,,0,0.00000000000000000000
chr1,3209942,3212156,2214,-1,0,63976,1,45.16711833785000000000
chr1,3215636,3217174,1538,-1,0,63976,1,65.01950585175550000000
chr1,3670511,3671643,1132,-1,0,148870,1,88.33922261484100000000
chr1,3063024,3063372,348,-1,0,63976,1,287.35632183908000000000
chr1,3082050,3082398,348,-1,0,63976,1,287.35632183908000000000
chr1,3098346,3098554,208,-1,0,63976,1,480.76923076923100000000
chr1,3716952,3717152,200,-1,0,,0,0.00000000000000000000
chr1,4059835,4059953,118,-1,0,,0,0.00000000000000000000
chr1,4118869,4126178,7309,-1,0,,0,0.00000000000000000000
chr1,4123791,4127912,4121,-1,0,,0,0.00000000000000000000
chr1,4126085,4126927,842,-1,0,,0,0.00000000000000000000
chr1,4155038,4155583,545,-1,0,,0,0.00000000000000000000
chr1,4155145,4155460,315,-1,0,,0,0.00000000000000000000
chr1,4204671,4204720,49,-1,0,,0,0.00000000000000000000
chr1,4284519,4285954,1435,-1,0,,0,0.00000000000000000000
chr1,4392511,4395379,2868,-1,0,,0,0.00000000000000000000
chr1,4390935,4393378,2443,-1,0,,0,0.00000000000000000000
chr1,4392451,4393627,1176,-1,0,,0,0.00000000000000000000
chr1,4392803,4393623,820,-1,0,,0,0.00000000000000000000
chr1,4436046,4436356,310,-1,0,,0,0.00000000000000000000
chr1,4596973,4602728,5755,-1,0,,0,0.00000000000000000000
chr1,4676496,4676644,148,-1,0,,0,0.00000000000000000000
chr1,4882236,4883038,802,-1,0,,0,0.00000000000000000000
chr1,5028128,5057280,29152,-1,0,,0,0.00000000000000000000
chr1,5112321,5173976,61655,-1,0,,0,0.00000000000000000000
chr1,5172406,5173484,1078,-1,0,,0,0.00000000000000000000
chr1,5302078,5304591,2513,-1,0,,0,0.00000000000000000000
chr1,5350910,5351276,366,-1,0,,0,0.00000000000000000000
chr1,5359266,5362140,2874,-1,0,,0,0.00000000000000000000
chr1,5474221,5474296,75,-1,0,,0,0.00000000000000000000
chr1,5633688,5633986,298,-1,0,,0,0.00000000000000000000
chr1,5644651,5645444,793,-1,0,,0,0.00000000000000000000
chr1,5727696,5727971,275,-1,0,,0,0.00000000000000000000
chr1,5804066,5804417,351,-1,0,,0,0.00000000000000000000
chr1,5869340,5869558,218,-1,0,,0,0.00000000000000000000
chr1,5876593,5877293,700,-1,0,,0,0.00000000000000000000
chr1,5876965,5877603,638,-1,0,,0,0.00000000000000000000
chr1,6031428,6041299,9871,-1,0,261734,1,10.13068584743190000000
chr1,6065085,6067422,2337,-1,0,8514,1,42.78990158322640000000
chr1,6064842,6065798,956,-1,0,8514,1,104.60251046025100000000
chr1,6065991,6066613,622,-1,0,8514,1,160.77170418006400000000
chr1,6072194,6072792,598,-1,0,8514,1,167.22408026755900000000
chr1,6066011,6066442,431,-1,0,8514,1,232.01856148491900000000
chr1,6065042,6065394,352,-1,0,8514,1,284.09090909090900000000
chr1,6072194,6072560,366,-1,0,8514,1,273.22404371584700000000
chr1,6066333,6066620,287,-1,0,8514,1,348.43205574912900000000
chr1,6065254,6065454,200,-1,0,8514,1,500.00000000000000000000
chr1,6167809,6168837,1028,-1,0,26038,1,97.27626459143970000000
chr1,6453030,6587140,134110,-1,0,83715;8718;54626;11332;79707;57449,6,4.47393930355678000000
chr1,6436824,6445562,8738,-1,0,11332,1,11.44426642252230000000
chr1,6458638,6459609,971,-1,0,,0,0.00000000000000000000
chr1,6762475,6763612,1137,-1,0,,0,0.00000000000000000000
chr1,6858602,6858863,261,-1,0,23261,1,383.14176245210700000000
chr1,6858643,6858849,206,-1,0,23261,1,485.43689320388300000000
chr1,6861223,6861853,630,-1,0,23261,1,158.73015873015900000000
chr1,7022816,7023474,658,-1,0,23261,1,151.97568389057700000000
chr1,7163578,7164357,779,-1,0,23261,1,128.36970474967900000000
chr1,7174777,7175409,632,-1,0,23261,1,158.22784810126600000000
chr1,7568313,7571336,3023,-1,0,23261,1,33.07972213033410000000
chr1,7483043,7486288,3245,-1,0,23261,1,30.81664098613250000000
chr1,7570072,7571523,1451,-1,0,23261,1,68.91798759476220000000
chr1,7570091,7571432,1341,-1,0,23261,1,74.57121551081280000000
chr1,7559435,7560187,752,-1,0,23261,1,132.97872340425500000000
chr1,7552940,7553254,314,-1,0,23261,1,318.47133757961800000000
chr1,7608705,7608986,281,-1,0,23261,1,355.87188612099600000000
chr1,7608756,7609020,264,-1,0,23261,1,378.78787878787900000000
chr1,7645731,7648448,2717,-1,0,23261,1,36.80529996319470000000
chr1,7715041,7715335,294,-1,0,23261,1,340.13605442176900000000
chr1,7803137,7804437,1300,-1,0,23261,1,76.92307692307690000000
chr1,7908787,7909509,722,-1,0,10911,1,138.50415512465400000000
chr1,7924947,7925552,605,-1,0,,0,0.00000000000000000000
chr1,7963021,7963342,321,-1,0,,0,0.00000000000000000000
chr1,7963173,7963458,285,-1,0,,0,0.00000000000000000000
chr1,7975336,7978253,2917,-1,0,3604,1,34.28179636612960000000
chr1,8182439,8190870,8431,-1,0,,0,0.00000000000000000000
chr1,8185308,8186282,974,-1,0,,0,0.00000000000000000000
chr1,8247756,8250066,2310,-1,0,,0,0.00000000000000000000
chr1,8360192,8364086,3894,-1,0,,0,0.00000000000000000000
chr1,8338188,8338938,750,-1,0,,0,0.00000000000000000000
chr1,8550488,8551372,884,-1,0,473,1,113.12217194570100000000
chr1,8673080,8684779,11699,-1,0,473,1,8.54773912300197000000
chr1,8705954,8706335,381,-1,0,473,1,262.46719160105000000000
chr1,8728786,8729309,523,-1,0,473,1,191.20458891013400000000
chr1,8977038,8978053,1015,-1,0,,0,0.00000000000000000000
chr1,9006369,9012990,6621,-1,0,765,1,15.10345869204050000000
chr1,9134132,9136906,2774,-1,0,,0,0.00000000000000000000
chr1,9171836,9176293,4457,-1,0,80045,1,22.43661655822300000000
chr1,9439960,9440517,557,-1,0,,0,0.00000000000000000000
chr1,9593085,9602174,9089,-1,0,84275,1,11.00231048520190000000
chr1,9595352,9597836,2484,-1,0,,0,0.00000000000000000000
chr1,9595917,9597784,1867,-1,0,,0,0.00000000000000000000
chr1,9596243,9597012,769,-1,0,,0,0.00000000000000000000
chr1,9817066,9817546,480,-1,0,22883,1,208.33333333333300000000
chr1,9822295,9825843,3548,-1,0,22883,1,28.18489289740700000000
chr1,9846031,9856674,10643,-1,0,22883,1,9.39584703561026000000
chr1,10067181,10068689,1508,-1,0,116362,1,66.31299734748010000000
chr1,10095420,10103423,8003,-1,0,10277,1,12.49531425715360000000
chr1,10249542,10252084,2542,-1,0,,0,0.00000000000000000000
chr1,10254783,10257437,2654,-1,0,,0,0.00000000000000000000
chr1,10369560,10379501,9941,-1,0,23095,1,10.05935016597930000000
chr1,10481664,10484575,2911,-1,0,,0,0.00000000000000000000
chr1,10482479,10483779,1300,-1,0,,0,0.00000000000000000000
chr1,10543546,10545992,2446,-1,0,5195,1,40.88307440719540000000
chr1,10636623,10644062,7439,-1,0,5195,1,13.44266702513780000000
chr1,10954253,10956121,1868,-1,0,,0,0.00000000000000000000
chr1,11037079,11038113,1034,-1,0,148345,1,96.71179883945840000000
chr1,11047365,11047568,203,-1,0,,0,0.00000000000000000000
chr1,11054658,11056074,1416,-1,0,,0,0.00000000000000000000
chr1,11060110,11062312,2202,-1,0,,0,0.00000000000000000000
chr1,11097626,11106353,8727,-1,0,10747,1,11.45869141744010000000
chr1,11230347,11232292,1945,-1,0,2475,1,51.41388174807200000000
chr1,11412764,11416729,3965,-1,0,,0,0.00000000000000000000
chr1,11467114,11473421,6307,-1,0,,0,0.00000000000000000000
chr1,11682796,11683306,510,-1,0,,0,0.00000000000000000000
chr1,11682878,11683188,310,-1,0,,0,0.00000000000000000000
chr1,11988863,11993808,4945,-1,0,,0,0.00000000000000000000
chr1,12021756,12026327,4571,-1,0,5351,1,21.87705097352880000000
chr1,12053069,12053401,332,-1,0,9927,1,301.20481927710800000000
chr1,12910004,13709344,799340,-1,0,400735;441873;441871;729528;391002;645382;653619;440563;65122;343068;400736;440561;645414;391003;343071,15,1.87654815222559000000
chr1,13123701,13395783,272082,-1,0,343068;440563;441873,3,1.10260877235539000000
chr1,12884932,13177694,292762,-1,0,400735;440560;441871;343069;65122;440561;391003;343071,8,2.73259507722997000000
chr1,12848166,13012745,164579,-1,0,400735;440560;441871;343069;65122;440561;65121;343071,8,4.86088747653103000000
chr1,13020942,13177962,157020,-1,0,391003,1,0.63686154629983400000
chr1,13352739,13488981,136242,-1,0,400736;343068;645382,3,2.20196415202361000000
chr1,12935657,13049137,113480,-1,0,400735;441871;440561;391003;343071,5,4.40606274233345000000
chr1,12851198,12919015,67817,-1,0,343069;440560;65122;65121,4,5.89822610849787000000
chr1,13692847,13774442,81595,-1,0,645425;391004;645414,3,3.67669587597279000000
chr1,13157840,13219320,61480,-1,0,440563;441873,2,3.25309043591412000000
chr1,12886641,12942069,55428,-1,0,400735;343069;440560;65122,4,7.21656924298189000000
chr1,13607227,13664027,56800,-1,0,653619;391002,2,3.52112676056338000000
chr1,12909404,12955044,45640,-1,0,400735;65122;343071,3,6.57318141980719000000
chr1,12843369,12888280,44911,-1,0,440560;65121,2,4.45325198726370000000
chr1,12874033,12916874,42841,-1,0,343069;440560,2,4.66842510679022000000
chr1,12953584,12995473,41889,-1,0,441871;343071,2,4.77452314450094000000
chr1,13178185,13214126,35941,-1,0,440563,1,2.78233772015247000000
chr1,12851490,12880900,29410,-1,0,65121,1,3.40020401224073000000
chr1,12899395,12924283,24888,-1,0,343069;65122,2,8.03600128576021000000
chr1,13146806,13171497,24691,-1,0,,0,0.00000000000000000000
chr1,12875484,12897226,21742,-1,0,440560,1,4.59939288013982000000
chr1,13182549,13196278,13729,-1,0,440563,1,7.28385170077937000000
chr1,12909397,12926956,17559,-1,0,65122,1,5.69508514152287000000
chr1,13178747,13187525,8778,-1,0,440563,1,11.39211665527450000000
chr1,12911340,12919572,8232,-1,0,65122,1,12.14771622934890000000
chr1,13320539,13329506,8967,-1,0,,0,0.00000000000000000000
chr1,13484304,13490931,6627,-1,0,,0,0.00000000000000000000
chr1,13704304,13711752,7448,-1,0,,0,0.00000000000000000000
chr1,13340489,13346626,6137,-1,0,,0,0.00000000000000000000
chr1,13176833,13182837,6004,-1,0,,0,0.00000000000000000000
chr1,13773169,13777114,3945,-1,0,,0,0.00000000000000000000
chr1,12743410,12746657,3247,-1,0,,0,0.00000000000000000000
chr1,13326579,13329506,2927,-1,0,,0,0.00000000000000000000
chr1,13693223,13696214,2991,-1,0,645414,1,33.43363423604150000000
chr1,12805275,12807017,1742,-1,0,93190,1,57.40528128587830000000
chr1,12822373,12822609,236,-1,0,,0,0.00000000000000000000
chr1,13827951,13828142,191,-1,0,126755,1,523.56020942408400000000
chr1,13848519,13848857,338,-1,0,,0,0.00000000000000000000
chr1,13854189,13854378,189,-1,0,,0,0.00000000000000000000
chr1,13883461,13884475,1014,-1,0,,0,0.00000000000000000000
chr1,13894204,13894831,627,-1,0,,0,0.00000000000000000000
chr1,13999697,14000110,413,-1,0,,0,0.00000000000000000000
chr1,14163063,14166989,3926,-1,0,,0,0.00000000000000000000
chr1,14436280,14438927,2647,-1,0,,0,0.00000000000000000000
chr1,14437268,14438932,1664,-1,0,,0,0.00000000000000000000
chr1,14436822,14438063,1241,-1,0,,0,0.00000000000000000000
chr1,14436349,14436655,306,-1,0,,0,0.00000000000000000000
chr1,14456109,14465126,9017,-1,0,,0,0.00000000000000000000
chr1,14619214,14622472,3258,-1,0,,0,0.00000000000000000000
chr1,15106602,15148280,41678,-1,0,23254,1,2.39934737751332000000
chr1,15274737,15279614,4877,-1,0,23254,1,20.50440844781630000000
chr1,15325640,15327580,1940,-1,0,23254,1,51.54639175257730000000
chr1,15326657,15327598,941,-1,0,23254,1,106.26992561105200000000
chr1,15374908,15375472,564,-1,0,23254,1,177.30496453900700000000
chr1,15365002,15365662,660,-1,0,23254,1,151.51515151515200000000
chr1,15365338,15365503,165,-1,0,23254,1,606.06060606060600000000
chr1,15365287,15365399,112,-1,0,23254,1,892.85714285714300000000
chr1,15486944,15491479,4535,-1,0,55092;727684,2,44.10143329658210000000
chr1,15489185,15490286,1101,-1,0,55092,1,90.82652134423250000000
chr1,15557841,15558594,753,-1,0,,0,0.00000000000000000000
chr1,15781001,15802468,21467,-1,0,63036,1,4.65831275911865000000
chr1,15794954,15814621,19667,-1,0,51032;63036,2,10.16931916408200000000
chr1,15920594,15937416,16822,-1,0,,0,0.00000000000000000000
chr1,15923851,15927279,3428,-1,0,,0,0.00000000000000000000
chr1,15935128,15938227,3099,-1,0,,0,0.00000000000000000000
chr1,16001490,16009852,8362,-1,0,,0,0.00000000000000000000
chr1,16153489,16195069,41580,-1,0,23013,1,2.40500240500241000000
chr1,16147401,16158718,11317,-1,0,,0,0.00000000000000000000
chr1,16185817,16193106,7289,-1,0,23013,1,13.71930305940460000000
chr1,16151690,16155602,3912,-1,0,,0,0.00000000000000000000
chr1,16152667,16155517,2850,-1,0,,0,0.00000000000000000000
chr1,16152276,16153956,1680,-1,0,,0,0.00000000000000000000
chr1,16364770,16387794,23024,-1,0,348487;1188,2,8.68658790826963000000
chr1,16350069,16372016,21947,-1,0,1187;1188,2,9.11286280585046000000
chr1,16369376,16380534,11158,-1,0,1188,1,8.96217960207922000000
chr1,16376515,16386256,9741,-1,0,348487;1188,2,20.53177291859150000000
chr1,16429777,16435212,5435,-1,0,,0,0.00000000000000000000
chr1,16541810,16567316,25506,-1,0,79363,1,3.92064612248098000000
chr1,16649733,16657344,7611,-1,0,54455,1,13.13887793982390000000
chr1,16750940,16755403,4463,-1,0,374955,1,22.40645305848080000000
chr1,16800667,17281224,480557,-1,0,9696;55672;11223,3,0.62427558021212900000
chr1,17026152,17242455,216303,-1,0,11223,1,0.46231443854223000000
chr1,16867601,17094938,227337,-1,0,55672;11223,2,0.87975120635884200000
chr1,17099489,17248749,149260,-1,0,9696,1,0.66997186118183000000
chr1,16842867,16990149,147282,-1,0,55672,1,0.67896959574150300000
chr1,17014395,17112159,97764,-1,0,11223,1,1.02287140460701000000
chr1,17055495,17179746,124251,-1,0,11223,1,0.80482249639841900000
chr1,16934378,17037845,103467,-1,0,55672,1,0.96649173166323600000
chr1,16890895,16971244,80349,-1,0,55672,1,1.24457056092795000000
chr1,17181659,17261670,80011,-1,0,9696,1,1.24982814862956000000
chr1,16972734,17051130,78396,-1,0,,0,0.00000000000000000000
chr1,17023255,17094820,71565,-1,0,11223,1,1.39733109760358000000
chr1,16882319,16940682,58363,-1,0,55672,1,1.71341432071689000000
chr1,16941268,16988562,47294,-1,0,,0,0.00000000000000000000
chr1,17225823,17277109,51286,-1,0,9696,1,1.94984986156066000000
chr1,17054908,17112451,57543,-1,0,11223,1,1.73783083954608000000
chr1,16965713,17012779,47066,-1,0,,0,0.00000000000000000000
chr1,16931201,16970401,39200,-1,0,55672,1,2.55102040816327000000
chr1,17015973,17059882,43909,-1,0,,0,0.00000000000000000000
chr1,17087248,17125416,38168,-1,0,11223,1,2.61999580800671000000
chr1,17008596,17051758,43162,-1,0,,0,0.00000000000000000000
chr1,17214735,17249707,34972,-1,0,9696,1,2.85943040146403000000
chr1,17230727,17257874,27147,-1,0,9696,1,3.68364828526172000000
chr1,17030062,17046790,16728,-1,0,,0,0.00000000000000000000
chr1,17009604,17032814,23210,-1,0,,0,0.00000000000000000000
chr1,17246097,17262307,16210,-1,0,9696,1,6.16903146206046000000
chr1,17231110,17247245,16135,-1,0,,0,0.00000000000000000000
chr1,17206145,17220161,14016,-1,0,,0,0.00000000000000000000
chr1,16953763,16970448,16685,-1,0,,0,0.00000000000000000000
chr1,16940223,16949654,9431,-1,0,,0,0.00000000000000000000
chr1,16813464,16820065,6601,-1,0,,0,0.00000000000000000000
chr1,17009445,17012777,3332,-1,0,,0,0.00000000000000000000
chr1,16834561,16836325,1764,-1,0,,0,0.00000000000000000000
chr1,16809856,16811589,1733,-1,0,,0,0.00000000000000000000
chr1,17361009,17363358,2349,-1,0,6390,1,42.57130693912300000000
chr1,17484104,17514588,30484,-1,0,,0,0.00000000000000000000
chr1,17676006,17681865,5859,-1,0,23569,1,17.06775900324290000000
chr1,17676268,17678930,2662,-1,0,23569,1,37.56574004507890000000
chr1,17676245,17677361,1116,-1,0,23569,1,89.60573476702510000000
chr1,17641965,17642963,998,-1,0,23569,1,100.20040080160300000000
chr1,17676474,17677168,694,-1,0,23569,1,144.09221902017300000000
chr1,17684735,17685089,354,-1,0,23569,1,282.48587570621500000000
chr1,17997693,18003873,6180,-1,0,55160,1,16.18122977346280000000
chr1,18009607,18009864,257,-1,0,55160,1,389.10505836575900000000
chr1,18061701,18063055,1354,-1,0,,0,0.00000000000000000000
chr1,18108495,18109752,1257,-1,0,81569,1,79.55449482895780000000
chr1,18577506,18601898,24392,-1,0,84966,1,4.09970482125287000000
chr1,19386425,19387238,813,-1,0,,0,0.00000000000000000000
chr1,19596703,19611819,15116,-1,0,22977,1,6.61550674781688000000
chr1,19647185,19648344,1159,-1,0,54896,1,86.28127696289910000000
chr1,19656625,19661202,4577,-1,0,,0,0.00000000000000000000
chr1,19720034,19731953,11919,-1,0,832,1,8.38996560114104000000
chr1,19761310,19761726,416,-1,0,832,1,240.38461538461500000000
chr1,19761426,19761593,167,-1,0,832,1,598.80239520958100000000
chr1,19895260,19901361,6101,-1,0,,0,0.00000000000000000000
chr1,19954877,19954943,66,-1,0,440574;100532736,2,3030.30303030303000000000
chr1,19969467,19969611,144,-1,0,100532736,1,694.44444444444400000000
chr1,20407119,20410746,3627,-1,0,5322,1,27.57099531293080000000
chr1,20496899,20497748,849,-1,0,391013,1,117.78563015312100000000
chr1,20497173,20497768,595,-1,0,391013,1,168.06722689075600000000
chr1,20498794,20500666,1872,-1,0,391013,1,53.41880341880340000000
chr1,20556029,20606320,50291,-1,0,,0,0.00000000000000000000
chr1,20864018,20864735,717,-1,0,,0,0.00000000000000000000
chr1,20932591,20933796,1205,-1,0,978,1,82.98755186721990000000
chr1,20932019,20932703,684,-1,0,978,1,146.19883040935700000000
chr1,21246359,21246520,161,-1,0,8672,1,621.11801242236000000000
chr1,21344014,21344997,983,-1,0,8672,1,101.72939979654100000000
chr1,21346297,21346913,616,-1,0,8672,1,162.33766233766200000000
chr1,21694677,21728780,34103,-1,0,,0,0.00000000000000000000
chr1,21757257,21760191,2934,-1,0,,0,0.00000000000000000000
chr1,21787496,21787981,485,-1,0,84224,1,206.18556701030900000000
chr1,21786417,21786696,279,-1,0,84224,1,358.42293906810000000000
chr1,21787745,21787818,73,-1,0,84224,1,1369.86301369863000000000
chr1,21822927,21828053,5126,-1,0,,0,0.00000000000000000000
chr1,22113060,22121364,8304,-1,0,,0,0.00000000000000000000
chr1,22117410,22121969,4559,-1,0,,0,0.00000000000000000000
chr1,22144620,22144756,136,-1,0,401944,1,735.29411764705900000000
chr1,22286404,22286458,54,-1,0,,0,0.00000000000000000000
chr1,22293885,22342339,48454,-1,0,23436;10136,2,4.12762620217113000000
chr1,22302343,22325696,23353,-1,0,23436,1,4.28210508285873000000
chr1,22313123,22335712,22589,-1,0,23436;10136,2,8.85386692638010000000
chr1,22318187,22330170,11983,-1,0,10136,1,8.34515563715263000000
chr1,22499758,22509307,9549,-1,0,,0,0.00000000000000000000
chr1,22886018,22888181,2163,-1,0,,0,0.00000000000000000000
chr1,22904445,22905621,1176,-1,0,2046,1,85.03401360544220000000
chr1,22904970,22905856,886,-1,0,2046,1,112.86681715575600000000
chr1,22905430,22905548,118,-1,0,2046,1,847.45762711864400000000
chr1,22926130,22926227,97,-1,0,2046,1,1030.92783505155000000000
chr1,23434047,23437447,3400,-1,0,7798,1,29.41176470588240000000
chr1,23475214,23480094,4880,-1,0,7798,1,20.49180327868850000000
chr1,23595951,23597229,1278,-1,0,,0,0.00000000000000000000
chr1,23718859,23719060,201,-1,0,6920,1,497.51243781094500000000
chr1,23736156,23737779,1623,-1,0,6920,1,61.61429451632780000000
chr1,23867347,23875056,7709,-1,0,,0,0.00000000000000000000
chr1,24091436,24099441,8005,-1,0,,0,0.00000000000000000000
chr1,24161895,24166251,4356,-1,0,,0,0.00000000000000000000
chr1,24200442,24201328,886,-1,0,1269,1,112.86681715575600000000
chr1,24200730,24201268,538,-1,0,1269,1,185.87360594795500000000
chr1,24223592,24224178,586,-1,0,1269,1,170.64846416382300000000
chr1,24367685,24368474,789,-1,0,,0,0.00000000000000000000
chr1,24402934,24403444,510,-1,0,127294,1,196.07843137254900000000
chr1,24402984,24403310,326,-1,0,127294,1,306.74846625766900000000
chr1,24520414,24523689,3275,-1,0,,0,0.00000000000000000000
chr1,24804193,24809313,5120,-1,0,,0,0.00000000000000000000
chr1,24805234,24807260,2026,-1,0,,0,0.00000000000000000000
chr1,24805517,24806821,1304,-1,0,,0,0.00000000000000000000
chr1,24895796,24900780,4984,-1,0,400746,1,20.06420545746390000000
chr1,25158495,25161653,3158,-1,0,25932,1,31.66561114629510000000
chr1,25178284,25184586,6302,-1,0,,0,0.00000000000000000000
chr1,25201823,25203634,1811,-1,0,,0,0.00000000000000000000
chr1,25588503,25670674,82171,-1,0,23585;6007;57035,3,3.65092307505081000000
chr1,25613924,25655555,41631,-1,0,6007;57035,2,4.80411232014604000000
chr1,25585344,25636420,51076,-1,0,6007;57035,2,3.91573341686898000000
chr1,25634401,25659704,25303,-1,0,6007;57035,2,7.90420108287555000000
chr1,25592102,25610972,18870,-1,0,6007;57035,2,10.59883412824590000000
chr1,25688926,25700415,11489,-1,0,6006,1,8.70397771781704000000
chr1,25578410,25578623,213,-1,0,57035,1,469.48356807511700000000
chr1,25900306,25908082,7776,-1,0,,0,0.00000000000000000000
chr1,26094168,26094946,778,-1,0,57134,1,128.53470437018000000000
chr1,26134599,26135036,437,-1,0,57190,1,228.83295194508000000000
chr1,26268410,26269109,699,-1,0,,0,0.00000000000000000000
chr1,26456910,26464112,7202,-1,0,,0,0.00000000000000000000
chr1,26459772,26464665,4893,-1,0,,0,0.00000000000000000000
chr1,26489796,26490197,401,-1,0,,0,0.00000000000000000000
chr1,26961131,26963882,2751,-1,0,,0,0.00000000000000000000
chr1,27464853,27466118,1265,-1,0,6548,1,79.05138339920950000000
chr1,27571391,27572426,1035,-1,0,23038,1,96.61835748792270000000
chr1,27804039,27804516,477,-1,0,10163,1,209.64360587002100000000
chr1,27804111,27804441,330,-1,0,10163,1,303.03030303030300000000
chr1,27935167,27935760,593,-1,0,,0,0.00000000000000000000
chr1,27935391,27935519,128,-1,0,,0,0.00000000000000000000
chr1,28094160,28096031,1871,-1,0,,0,0.00000000000000000000
chr1,28247747,28248212,465,-1,0,,0,0.00000000000000000000
chr1,28247813,28248132,319,-1,0,,0,0.00000000000000000000
chr1,28457866,28458457,591,-1,0,,0,0.00000000000000000000
chr1,28551350,28554069,2719,-1,0,22826,1,36.77822728944470000000
chr1,28621506,28621835,329,-1,0,,0,0.00000000000000000000
chr1,28653040,28655039,1999,-1,0,,0,0.00000000000000000000
chr1,28833934,28835181,1247,-1,0,1104,1,80.19246190858060000000
chr1,28949642,28960146,10504,-1,0,6883,1,9.52018278750952000000
chr1,29227582,29227902,320,-1,0,2035,1,312.50000000000000000000
chr1,29304423,29306321,1898,-1,0,2035,1,52.68703898840890000000
chr1,29440969,29441763,794,-1,0,2035,1,125.94458438287200000000
chr1,30030063,30030359,296,-1,0,,0,0.00000000000000000000
chr1,30151030,30151081,51,-1,0,,0,0.00000000000000000000
chr1,30167190,30979636,812446,-1,0,,0,0.00000000000000000000
chr1,30728125,31141951,413826,-1,0,,0,0.00000000000000000000
chr1,31155603,31166082,10479,-1,0,,0,0.00000000000000000000
chr1,30479761,30489508,9747,-1,0,,0,0.00000000000000000000
chr1,30199894,30204059,4165,-1,0,,0,0.00000000000000000000
chr1,30947098,30950772,3674,-1,0,,0,0.00000000000000000000
chr1,30617812,30621484,3672,-1,0,,0,0.00000000000000000000
chr1,31169469,31171952,2483,-1,0,,0,0.00000000000000000000
chr1,30738180,30740170,1990,-1,0,,0,0.00000000000000000000
chr1,31122673,31124357,1684,-1,0,,0,0.00000000000000000000
chr1,30738631,30739953,1322,-1,0,,0,0.00000000000000000000
chr1,31040643,31041659,1016,-1,0,,0,0.00000000000000000000
chr1,30435742,30436238,496,-1,0,,0,0.00000000000000000000
chr1,31244433,31244757,324,-1,0,,0,0.00000000000000000000
chr1,31244574,31244667,93,-1,0,,0,0.00000000000000000000
chr1,31244657,31244751,94,-1,0,,0,0.00000000000000000000
chr1,31249014,31249457,443,-1,0,,0,0.00000000000000000000
chr1,31249147,31249307,160,-1,0,,0,0.00000000000000000000
chr1,31249151,31249223,72,-1,0,,0,0.00000000000000000000
chr1,31367292,31367742,450,-1,0,9672,1,222.22222222222200000000
chr1,31399298,31400015,717,-1,0,,0,0.00000000000000000000
chr1,31547345,31550778,3433,-1,0,,0,0.00000000000000000000
chr1,31574931,31577275,2344,-1,0,,0,0.00000000000000000000
chr1,31720007,31722559,2552,-1,0,,0,0.00000000000000000000
chr1,32011658,32012298,640,-1,0,,0,0.00000000000000000000
chr1,32011912,32012061,149,-1,0,,0,0.00000000000000000000
chr1,32186522,32187829,1307,-1,0,,0,0.00000000000000000000
chr1,32373496,32374023,527,-1,0,8073,1,189.75332068311200000000
chr1,32373712,32373798,86,-1,0,8073,1,1162.79069767442000000000
chr1,32404744,32410889,6145,-1,0,,0,0.00000000000000000000
chr1,32448713,32452193,3480,-1,0,,0,0.00000000000000000000
chr1,32462990,32464876,1886,-1,0,,0,0.00000000000000000000
chr1,32535957,32537644,1687,-1,0,55116,1,59.27682276229990000000
chr1,32547544,32553786,6242,-1,0,55116,1,16.02050624799740000000
chr1,32544346,32548671,4325,-1,0,55116,1,23.12138728323700000000
chr1,32551065,32552940,1875,-1,0,55116,1,53.33333333333330000000
chr1,32874304,32875500,1196,-1,0,,0,0.00000000000000000000
chr1,32969352,32974066,4714,-1,0,,0,0.00000000000000000000
chr1,33049926,33056997,7071,-1,0,653121,1,14.14227124876250000000
chr1,33102049,33102922,873,-1,0,339487,1,114.54753722795000000000
chr1,33156688,33156923,235,-1,0,81493,1,425.53191489361700000000
chr1,33216347,33216827,480,-1,0,57648,1,208.33333333333300000000
chr1,33418196,33421164,2968,-1,0,127544,1,33.69272237196770000000
chr1,33473752,33478873,5121,-1,0,204,1,19.52743604764690000000
chr1,33476435,33478822,2387,-1,0,204,1,41.89359028068710000000
chr1,33785172,33788186,3014,-1,0,127550,1,33.17850033178500000000
chr1,33870800,33877060,6260,-1,0,,0,0.00000000000000000000
chr1,33898088,33899109,1021,-1,0,,0,0.00000000000000000000
chr1,34028750,34029749,999,-1,0,114784,1,100.10010010010000000000
chr1,34567683,34569085,1402,-1,0,114784,1,71.32667617689020000000
chr1,34567988,34568501,513,-1,0,114784,1,194.93177387914200000000
chr1,34568182,34568277,95,-1,0,114784,1,1052.63157894737000000000
chr1,34926086,34932550,6464,-1,0,,0,0.00000000000000000000
chr1,35090088,35106460,16372,-1,0,,0,0.00000000000000000000
chr1,35101405,35111993,10588,-1,0,,0,0.00000000000000000000
chr1,35103866,35111970,8104,-1,0,,0,0.00000000000000000000
chr1,35102654,35104491,1837,-1,0,,0,0.00000000000000000000
chr1,35267724,35268213,489,-1,0,,0,0.00000000000000000000
chr1,35349256,35350195,939,-1,0,58512,1,106.49627263045800000000
chr1,35504827,35507248,2421,-1,0,,0,0.00000000000000000000
chr1,35627107,35627433,326,-1,0,,0,0.00000000000000000000
chr1,36733249,36733581,332,-1,0,9967,1,301.20481927710800000000
chr1,36733281,36733514,233,-1,0,9967,1,429.18454935622300000000
chr1,36749022,36749487,465,-1,0,9967,1,215.05376344086000000000
chr1,36749272,36749327,55,-1,0,9967,1,1818.18181818182000000000
chr1,37009654,37009864,210,-1,0,,0,0.00000000000000000000
chr1,37050230,37052034,1804,-1,0,,0,0.00000000000000000000
chr1,37206202,37206292,90,-1,0,,0,0.00000000000000000000
chr1,37422402,37425588,3186,-1,0,2899,1,31.38731952291270000000
chr1,37424222,37425749,1527,-1,0,2899,1,65.48788474132290000000
chr1,37424333,37425217,884,-1,0,2899,1,113.12217194570100000000
chr1,37423328,37423689,361,-1,0,2899,1,277.00831024930700000000
chr1,37521872,37522704,832,-1,0,,0,0.00000000000000000000
chr1,37632460,37687364,54904,-1,0,,0,0.00000000000000000000
chr1,37816307,37816854,547,-1,0,,0,0.00000000000000000000
chr1,37816476,37816721,245,-1,0,,0,0.00000000000000000000
chr1,37846157,37847580,1423,-1,0,,0,0.00000000000000000000
chr1,37918911,37927771,8860,-1,0,,0,0.00000000000000000000
chr1,38077193,38077563,370,-1,0,284654,1,270.27027027027000000000
chr1,38077349,38077420,71,-1,0,284654,1,1408.45070422535000000000
chr1,38132306,38132987,681,-1,0,,0,0.00000000000000000000
chr1,38175571,38182835,7264,-1,0,284656,1,13.76651982378850000000
chr1,38208082,38208589,507,-1,0,284656,1,197.23865877712000000000
chr1,38208244,38208408,164,-1,0,284656,1,609.75609756097600000000
chr1,38366012,38366675,663,-1,0,3633,1,150.82956259426800000000
chr1,38602501,38604780,2279,-1,0,,0,0.00000000000000000000
chr1,38642135,38645110,2975,-1,0,,0,0.00000000000000000000
chr1,39032419,39040370,7951,-1,0,,0,0.00000000000000000000
chr1,39082046,39086127,4081,-1,0,,0,0.00000000000000000000
chr1,39084351,39087407,3056,-1,0,,0,0.00000000000000000000
chr1,39084228,39085821,1593,-1,0,,0,0.00000000000000000000
chr1,39128474,39137475,9001,-1,0,,0,0.00000000000000000000
chr1,39252598,39253505,907,-1,0,,0,0.00000000000000000000
chr1,39277037,39277939,902,-1,0,,0,0.00000000000000000000
chr1,39408247,39410002,1755,-1,0,,0,0.00000000000000000000
chr1,39433033,39440856,7823,-1,0,,0,0.00000000000000000000
chr1,39561555,39562131,576,-1,0,23499,1,173.61111111111100000000
chr1,39998250,40001291,3041,-1,0,,0,0.00000000000000000000
chr1,40285163,40287175,2012,-1,0,,0,0.00000000000000000000
chr1,40441765,40442030,265,-1,0,,0,0.00000000000000000000
chr1,40552354,40553631,1277,-1,0,5538,1,78.30853563038370000000
chr1,40575438,40587373,11935,-1,0,,0,0.00000000000000000000
chr1,40693890,40694187,297,-1,0,6018,1,336.70033670033700000000
chr1,40733001,40733316,315,-1,0,10269,1,317.46031746031700000000
chr1,40962345,40962777,432,-1,0,,0,0.00000000000000000000
chr1,40966798,40970579,3781,-1,0,,0,0.00000000000000000000
chr1,40968196,40970016,1820,-1,0,,0,0.00000000000000000000
chr1,41021490,41029415,7925,-1,0,,0,0.00000000000000000000
chr1,41021839,41026306,4467,-1,0,,0,0.00000000000000000000
chr1,41026647,41028481,1834,-1,0,,0,0.00000000000000000000
chr1,41024194,41024480,286,-1,0,,0,0.00000000000000000000
chr1,41024267,41024431,164,-1,0,,0,0.00000000000000000000
chr1,41108427,41108573,146,-1,0,9783,1,684.93150684931500000000
chr1,41571629,41573237,1608,-1,0,22955,1,62.18905472636820000000
chr1,41761815,41765791,3976,-1,0,,0,0.00000000000000000000
chr1,41994020,41994292,272,-1,0,59269,1,367.64705882352900000000
chr1,42071689,42072603,914,-1,0,59269,1,109.40919037199100000000
chr1,42101043,42101500,457,-1,0,59269,1,218.81838074398200000000
chr1,42101275,42101331,56,-1,0,59269,1,1785.71428571429000000000
chr1,42144091,42144415,324,-1,0,59269,1,308.64197530864200000000
chr1,42239870,42245705,5835,-1,0,59269,1,17.13796058269070000000
chr1,42648668,42652849,4181,-1,0,22887,1,23.91772303276730000000
chr1,42743124,42743583,459,-1,0,22887,1,217.86492374727700000000
chr1,42838154,42839558,1404,-1,0,,0,0.00000000000000000000
chr1,43008121,43008560,439,-1,0,728621,1,227.79043280182200000000
chr1,43385216,43386581,1365,-1,0,,0,0.00000000000000000000
chr1,43384699,43385087,388,-1,0,,0,0.00000000000000000000
chr1,43538304,43539041,737,-1,0,,0,0.00000000000000000000
chr1,43693873,43695712,1839,-1,0,149465,1,54.37737901033170000000
chr1,43694170,43695522,1352,-1,0,149465,1,73.96449704142010000000
chr1,43857356,43857877,521,-1,0,23334,1,191.93857965451100000000
chr1,43857453,43857794,341,-1,0,23334,1,293.25513196480900000000
chr1,44009358,44009980,622,-1,0,5792,1,160.77170418006400000000
chr1,44337001,44338000,999,-1,0,6487,1,100.10010010010000000000
chr1,44370484,44371701,1217,-1,0,6487,1,82.16926869350860000000
chr1,44371052,44371477,425,-1,0,6487,1,235.29411764705900000000
chr1,44604609,44605433,824,-1,0,,0,0.00000000000000000000
chr1,44630296,44630495,199,-1,0,,0,0.00000000000000000000
chr1,44823391,44823691,300,-1,0,,0,0.00000000000000000000
chr1,45021216,45022307,1091,-1,0,55182,1,91.65902841429880000000
chr1,45175098,45176092,994,-1,0,339541,1,100.60362173038200000000
chr1,45417564,45417969,405,-1,0,8891,1,246.91358024691400000000
chr1,45537743,45541058,3315,-1,0,57643,1,30.16591251885370000000
chr1,45617810,45623587,5777,-1,0,57643,1,17.31002250302930000000
chr1,45629511,45649209,19698,-1,0,57643,1,5.07665752868312000000
chr1,45634577,45645451,10874,-1,0,57643,1,9.19624793084422000000
chr1,45708600,45709262,662,-1,0,,0,0.00000000000000000000
chr1,45766882,45768573,1691,-1,0,,0,0.00000000000000000000
chr1,45822581,45823486,905,-1,0,10420,1,110.49723756906100000000
chr1,45870225,45871207,982,-1,0,10420,1,101.83299389002000000000
chr1,46207191,46207711,520,-1,0,3652,1,192.30769230769200000000
chr1,46207285,46207603,318,-1,0,3652,1,314.46540880503100000000
chr1,46243614,46251849,8235,-1,0,,0,0.00000000000000000000
chr1,46366090,46366475,385,-1,0,23139,1,259.74025974026000000000
chr1,46457778,46461774,3996,-1,0,23139,1,25.02502502502500000000
chr1,46803326,46803629,303,-1,0,,0,0.00000000000000000000
chr1,47193390,47198248,4858,-1,0,,0,0.00000000000000000000
chr1,47347166,47363821,16655,-1,0,,0,0.00000000000000000000
chr1,47393749,47399460,5711,-1,0,1579,1,17.51006828926630000000
chr1,47413407,47419550,6143,-1,0,,0,0.00000000000000000000
chr1,47441034,47444430,3396,-1,0,260293,1,29.44640753828030000000
chr1,47623404,47625591,2187,-1,0,,0,0.00000000000000000000
chr1,48057325,48057512,187,-1,0,,0,0.00000000000000000000
chr1,48352569,48353252,683,-1,0,388630,1,146.41288433382100000000
chr1,48722093,48723679,1586,-1,0,,0,0.00000000000000000000
chr1,48748135,48779526,31391,-1,0,54558,1,3.18562645344207000000
chr1,49068900,49069533,633,-1,0,84871,1,157.97788309636600000000
chr1,49721399,49884848,163449,-1,0,84871,1,0.61181163543368300000
chr1,49851083,49958660,107577,-1,0,84871,1,0.92956672894763800000
chr1,49913650,49998796,85146,-1,0,84871,1,1.17445329199258000000
chr1,49777181,49851052,73871,-1,0,84871,1,1.35371119925275000000
chr1,49931824,49947391,15567,-1,0,84871,1,6.42384531380484000000
chr1,49597880,49610904,13024,-1,0,84871,1,7.67813267813268000000
chr1,50021158,50029541,8383,-1,0,84871,1,11.92890373374690000000
chr1,49535078,49537571,2493,-1,0,84871,1,40.11231448054550000000
chr1,49619258,49620061,803,-1,0,84871,1,124.53300124533000000000
chr1,49549786,49549840,54,-1,0,84871,1,1851.85185185185000000000
chr1,50528661,50541919,13258,-1,0,1996,1,7.54261577915221000000
chr1,50769443,50771458,2015,-1,0,,0,0.00000000000000000000
chr1,50861089,50877149,16060,-1,0,,0,0.00000000000000000000
chr1,51102469,51103515,1046,-1,0,11124,1,95.60229445506690000000
chr1,51128264,51130301,2037,-1,0,11124,1,49.09180166912130000000
chr1,51608506,51609468,962,-1,0,284546,1,103.95010395010400000000
chr1,51714060,51720319,6259,-1,0,26994,1,15.97699312989300000000
chr1,51915152,51917452,2300,-1,0,2060,1,43.47826086956520000000
chr1,52094371,52096228,1857,-1,0,114883,1,53.85029617662900000000
chr1,52455037,52456002,965,-1,0,5865,1,103.62694300518100000000
chr1,52607549,52608219,670,-1,0,9372,1,149.25373134328400000000
chr1,52748243,52751885,3642,-1,0,9372,1,27.45744096650190000000
chr1,53025337,53027238,1901,-1,0,,0,0.00000000000000000000
chr1,53355284,53357895,2611,-1,0,440590,1,38.29950210647260000000
chr1,53417086,53419812,2726,-1,0,6342,1,36.68378576669110000000
chr1,53488160,53489740,1580,-1,0,6342,1,63.29113924050630000000
chr1,53588463,53595966,7503,-1,0,6512,1,13.32800213248030000000
chr1,53560640,53567605,6965,-1,0,6512,1,14.35750179468770000000
chr1,53594164,53595598,1434,-1,0,6512,1,69.73500697350070000000
chr1,53594101,53594943,842,-1,0,6512,1,118.76484560570100000000
chr1,53595115,53595602,487,-1,0,6512,1,205.33880903490800000000
chr1,53933584,53933931,347,-1,0,,0,0.00000000000000000000
chr1,53999368,54002661,3293,-1,0,148979,1,30.36744609778320000000
chr1,54174838,54175254,416,-1,0,148979,1,240.38461538461500000000
chr1,54244570,54247586,3016,-1,0,55706,1,33.15649867374010000000
chr1,54351278,54353399,2121,-1,0,54432,1,47.14757190004710000000
chr1,54367613,54369745,2132,-1,0,1733,1,46.90431519699810000000
chr1,54412327,54413211,884,-1,0,115353,1,113.12217194570100000000
chr1,54611818,54615211,3393,-1,0,200008,1,29.47244326554670000000
chr1,54894035,54897576,3541,-1,0,,0,0.00000000000000000000
chr1,55092102,55095995,3893,-1,0,26027,1,25.68713074749550000000
chr1,55287469,55287981,512,-1,0,163747,1,195.31250000000000000000
chr1,55287550,55287869,319,-1,0,163747,1,313.47962382445100000000
chr1,55300961,55305597,4636,-1,0,163747,1,21.57031924072480000000
chr1,55334191,55334541,350,-1,0,1718,1,285.71428571428600000000
chr1,55334343,55334419,76,-1,0,1718,1,1315.78947368421000000000
chr1,55342081,55343472,1391,-1,0,1718,1,71.89072609633360000000
chr1,55363922,55369187,5265,-1,0,,0,0.00000000000000000000
chr1,55371410,55372195,785,-1,0,,0,0.00000000000000000000
chr1,55851362,55855439,4077,-1,0,,0,0.00000000000000000000
chr1,55927715,55929227,1512,-1,0,,0,0.00000000000000000000
chr1,55974584,55975025,441,-1,0,,0,0.00000000000000000000
chr1,55886231,55886599,368,-1,0,,0,0.00000000000000000000
chr1,56129801,56134685,4884,-1,0,,0,0.00000000000000000000
chr1,56132396,56132861,465,-1,0,,0,0.00000000000000000000
chr1,56131267,56131408,141,-1,0,,0,0.00000000000000000000
chr1,56129402,56129498,96,-1,0,,0,0.00000000000000000000
chr1,56401194,56401736,542,-1,0,,0,0.00000000000000000000
chr1,56401297,56401631,334,-1,0,,0,0.00000000000000000000
chr1,56831105,56834961,3856,-1,0,,0,0.00000000000000000000
chr1,56887667,56888108,441,-1,0,,0,0.00000000000000000000
chr1,56887713,56888046,333,-1,0,,0,0.00000000000000000000
chr1,57208746,57210377,1631,-1,0,199920,1,61.31207847946050000000
chr1,57242530,57243068,538,-1,0,199920,1,185.87360594795500000000
chr1,57242620,57242959,339,-1,0,199920,1,294.98525073746300000000
chr1,57384818,57385641,823,-1,0,,0,0.00000000000000000000
chr1,57861215,57861653,438,-1,0,1600,1,228.31050228310500000000
chr1,58343185,58343587,402,-1,0,1600,1,248.75621890547300000000
chr1,58567891,58581747,13856,-1,0,1600,1,7.21709006928406000000
chr1,58647370,58649133,1763,-1,0,1600,1,56.72149744753260000000
chr1,58743566,58745173,1607,-1,0,,0,0.00000000000000000000
chr1,58743909,58744826,917,-1,0,,0,0.00000000000000000000
chr1,59017907,59018180,273,-1,0,,0,0.00000000000000000000
chr1,59059615,59059941,326,-1,0,,0,0.00000000000000000000
chr1,59446648,59447111,463,-1,0,,0,0.00000000000000000000
chr1,59446737,59446909,172,-1,0,,0,0.00000000000000000000
chr1,60003474,60048726,45252,-1,0,55277,1,2.20984707858216000000
chr1,60044002,60058289,14287,-1,0,55277,1,6.99937005669490000000
chr1,60046731,60052368,5637,-1,0,55277,1,17.73993258825620000000
chr1,60043098,60047807,4709,-1,0,55277,1,21.23593119558290000000
chr1,60048750,60052398,3648,-1,0,55277,1,27.41228070175440000000
chr1,60046782,60049712,2930,-1,0,55277,1,34.12969283276450000000
chr1,60048681,60049825,1144,-1,0,55277,1,87.41258741258740000000
chr1,60106247,60107103,856,-1,0,55277,1,116.82242990654200000000
chr1,60048628,60049654,1026,-1,0,55277,1,97.46588693957110000000
chr1,60487916,60488492,576,-1,0,127795,1,173.61111111111100000000
chr1,61198205,61198558,353,-1,0,,0,0.00000000000000000000
chr1,62082821,62083701,880,-1,0,,0,0.00000000000000000000
chr1,62082889,62083628,739,-1,0,,0,0.00000000000000000000
chr1,62107654,62120107,12453,-1,0,,0,0.00000000000000000000
chr1,62113387,62119521,6134,-1,0,,0,0.00000000000000000000
chr1,62114995,62120142,5147,-1,0,,0,0.00000000000000000000
chr1,62390466,62391086,620,-1,0,10207,1,161.29032258064500000000
chr1,62390591,62390944,353,-1,0,10207,1,283.28611898017000000000
chr1,62436983,62452405,15422,-1,0,10207,1,6.48424328880820000000
chr1,62438366,62453185,14819,-1,0,10207,1,6.74809366354005000000
chr1,62654661,62657211,2550,-1,0,,0,0.00000000000000000000
chr1,62622895,62624327,1432,-1,0,10207,1,69.83240223463690000000
chr1,62479204,62480633,1429,-1,0,10207,1,69.97900629811060000000
chr1,62682814,62683116,302,-1,0,,0,0.00000000000000000000
chr1,62743987,62744048,61,-1,0,163782,1,1639.34426229508000000000
chr1,62765274,62771172,5898,-1,0,163782,1,16.95489996609020000000
chr1,63151725,63152294,569,-1,0,85440,1,175.74692442882200000000
chr1,63151832,63152170,338,-1,0,85440,1,295.85798816568000000000
chr1,63611038,63616535,5497,-1,0,,0,0.00000000000000000000
chr1,63614623,63615961,1338,-1,0,,0,0.00000000000000000000
chr1,63705355,63708146,2791,-1,0,,0,0.00000000000000000000
chr1,64388049,64389746,1697,-1,0,4919,1,58.92751915144370000000
chr1,64446576,64448025,1449,-1,0,4919,1,69.01311249137340000000
chr1,64814301,64823700,9399,-1,0,,0,0.00000000000000000000
chr1,64839912,64851868,11956,-1,0,,0,0.00000000000000000000
chr1,64843818,64847076,3258,-1,0,,0,0.00000000000000000000
chr1,64846772,64848459,1687,-1,0,,0,0.00000000000000000000
chr1,65199959,65200929,970,-1,0,,0,0.00000000000000000000
chr1,65200148,65200681,533,-1,0,,0,0.00000000000000000000
chr1,65412503,65413810,1307,-1,0,3716,1,76.51109410864580000000
chr1,65682233,65682602,369,-1,0,205,1,271.00271002710000000000
chr1,65909517,65910029,512,-1,0,3953,1,195.31250000000000000000
chr1,65909624,65909909,285,-1,0,3953,1,350.87719298245600000000
chr1,66024156,66030322,6166,-1,0,3953,1,16.21796951021730000000
chr1,66040925,66043891,2966,-1,0,3953,1,33.71544167228590000000
chr1,66078228,66078408,180,-1,0,3953,1,555.55555555555600000000
chr1,66079096,66079498,402,-1,0,3953,1,248.75621890547300000000
chr1,66135607,66136167,560,-1,0,,0,0.00000000000000000000
chr1,66135716,66136042,326,-1,0,,0,0.00000000000000000000
chr1,66170974,66173033,2059,-1,0,,0,0.00000000000000000000
chr1,66263905,66264243,338,-1,0,5142,1,295.85798816568000000000
chr1,66584516,66585309,793,-1,0,5142,1,126.10340479192900000000
chr1,66624442,66631306,6864,-1,0,5142,1,14.56876456876460000000
chr1,66655469,66669562,14093,-1,0,5142,1,7.09572128006812000000
chr1,66694579,66694640,61,-1,0,5142,1,1639.34426229508000000000
chr1,67201101,67201621,520,-1,0,84251,1,192.30769230769200000000
chr1,67201218,67201530,312,-1,0,84251,1,320.51282051282000000000
chr1,67321678,67324278,2600,-1,0,79819,1,38.46153846153850000000
chr1,68007699,68009158,1459,-1,0,,0,0.00000000000000000000
chr1,68007968,68008812,844,-1,0,,0,0.00000000000000000000
chr1,68175787,68175898,111,-1,0,55970,1,900.90090090090100000000
chr1,68375761,68376875,1114,-1,0,,0,0.00000000000000000000
chr1,68482292,68489000,6708,-1,0,,0,0.00000000000000000000
chr1,68561179,68564644,3465,-1,0,79971,1,28.86002886002890000000
chr1,68594523,68594725,202,-1,0,79971,1,495.04950495049500000000
chr1,69019998,69021235,1237,-1,0,,0,0.00000000000000000000
chr1,69073845,69075086,1241,-1,0,,0,0.00000000000000000000
chr1,69230622,69230774,152,-1,0,,0,0.00000000000000000000
chr1,69479742,69480630,888,-1,0,,0,0.00000000000000000000
chr1,69806885,69807432,547,-1,0,,0,0.00000000000000000000
chr1,69806998,69807327,329,-1,0,,0,0.00000000000000000000
chr1,69943629,69944115,486,-1,0,,0,0.00000000000000000000
chr1,69943715,69944031,316,-1,0,,0,0.00000000000000000000
chr1,69996369,70002695,6326,-1,0,,0,0.00000000000000000000
chr1,70027193,70027716,523,-1,0,,0,0.00000000000000000000
chr1,70648206,70650285,2079,-1,0,55631,1,48.10004810004810000000
chr1,70768023,70768530,507,-1,0,81573,1,197.23865877712000000000
chr1,70768111,70768434,323,-1,0,81573,1,309.59752321981400000000
chr1,70820464,70825042,4578,-1,0,11147,1,21.84359982525120000000
chr1,70946103,70946637,534,-1,0,,0,0.00000000000000000000
chr1,70946182,70946523,341,-1,0,,0,0.00000000000000000000
chr1,71113064,71113427,363,-1,0,,0,0.00000000000000000000
chr1,71148342,71149479,1137,-1,0,,0,0.00000000000000000000
chr1,71148797,71149047,250,-1,0,,0,0.00000000000000000000
chr1,71163765,71168030,4265,-1,0,,0,0.00000000000000000000
chr1,71237361,71240330,2969,-1,0,,0,0.00000000000000000000
chr1,71244091,71249625,5534,-1,0,,0,0.00000000000000000000
chr1,71302605,71315344,12739,-1,0,,0,0.00000000000000000000
chr1,71419341,71463476,44135,-1,0,5733,1,2.26577546165175000000
chr1,71487185,71489781,2596,-1,0,5733,1,38.52080123266560000000
chr1,71590976,71675798,84822,-1,0,,0,0.00000000000000000000
chr1,71740184,71742373,2189,-1,0,,0,0.00000000000000000000
chr1,71741218,71741739,521,-1,0,,0,0.00000000000000000000
chr1,71741319,71741637,318,-1,0,,0,0.00000000000000000000
chr1,71820465,71823683,3218,-1,0,,0,0.00000000000000000000
chr1,71828461,71828877,416,-1,0,,0,0.00000000000000000000
chr1,72449619,72450028,409,-1,0,257194,1,244.49877750611200000000
chr1,72507513,72654910,147397,-1,0,257194,1,0.67843985969863700000
chr1,72589250,72666232,76982,-1,0,257194,1,1.29900496219896000000
chr1,72618692,72657815,39123,-1,0,257194,1,2.55604120338420000000
chr1,72516792,72546532,29740,-1,0,257194,1,3.36247478143914000000
chr1,72754437,72810928,56491,-1,0,,0,0.00000000000000000000
chr1,72758422,72794919,36497,-1,0,,0,0.00000000000000000000
chr1,72780922,72809052,28130,-1,0,,0,0.00000000000000000000
chr1,72739709,72763362,23653,-1,0,257194,1,4.22779351456475000000
chr1,72756008,72774874,18866,-1,0,,0,0.00000000000000000000
chr1,72787661,72811701,24040,-1,0,,0,0.00000000000000000000
chr1,72754739,72764388,9649,-1,0,,0,0.00000000000000000000
chr1,72756067,72762960,6893,-1,0,,0,0.00000000000000000000
chr1,72755344,72755492,148,-1,0,,0,0.00000000000000000000
chr1,73011409,73093620,82211,-1,0,,0,0.00000000000000000000
chr1,73335295,73335849,554,-1,0,,0,0.00000000000000000000
chr1,73656899,73767648,110749,-1,0,,0,0.00000000000000000000
chr1,73711322,73773275,61953,-1,0,,0,0.00000000000000000000
chr1,73753506,73754014,508,-1,0,,0,0.00000000000000000000
chr1,73768761,73769152,391,-1,0,,0,0.00000000000000000000
chr1,73753606,73753927,321,-1,0,,0,0.00000000000000000000
chr1,73784833,73815843,31010,-1,0,,0,0.00000000000000000000
chr1,74312426,74312678,252,-1,0,,0,0.00000000000000000000
chr1,74351398,74364352,12954,-1,0,,0,0.00000000000000000000
chr1,74432324,74435264,2940,-1,0,,0,0.00000000000000000000
chr1,74754987,74755465,478,-1,0,100526835;51086,2,418.41004184100400000000
chr1,74755169,74755290,121,-1,0,100526835;51086,2,1652.89256198347000000000
chr1,74829750,74830512,762,-1,0,100526835;51086,2,262.46719160105000000000
chr1,74984308,74985473,1165,-1,0,100526835;51086,2,171.67381974248900000000
chr1,75136875,75136979,104,-1,0,127254,1,961.53846153846200000000
chr1,75180008,75192595,12587,-1,0,1429,1,7.94470485421467000000
chr1,75183567,75186083,2516,-1,0,1429,1,39.74562798092210000000
chr1,75534651,75539884,5233,-1,0,,0,0.00000000000000000000
chr1,75840734,75849522,8788,-1,0,204962,1,11.37915339098770000000
chr1,76011738,76012332,594,-1,0,204962,1,168.35016835016800000000
chr1,76011850,76012184,334,-1,0,204962,1,299.40119760479000000000
chr1,76086569,76122898,36329,-1,0,,0,0.00000000000000000000
chr1,76133949,76135002,1053,-1,0,,0,0.00000000000000000000
chr1,76222448,76244630,22182,-1,0,34,1,4.50815976918222000000
chr1,76351757,76351923,166,-1,0,4438,1,602.40963855421700000000
chr1,76692493,76723077,30584,-1,0,256435,1,3.26968349463772000000
chr1,76742982,76743516,534,-1,0,256435,1,187.26591760299600000000
chr1,76900596,76903365,2769,-1,0,256435,1,36.11412062116290000000
chr1,77343682,77353381,9699,-1,0,81849,1,10.31034127229610000000
chr1,77253890,77260233,6343,-1,0,,0,0.00000000000000000000
chr1,77111524,77112788,1264,-1,0,,0,0.00000000000000000000
chr1,77111948,77112489,541,-1,0,,0,0.00000000000000000000
chr1,77100250,77100774,524,-1,0,,0,0.00000000000000000000
chr1,77100357,77100653,296,-1,0,,0,0.00000000000000000000
chr1,77240062,77240139,77,-1,0,,0,0.00000000000000000000
chr1,77774514,77781592,7078,-1,0,26289,1,14.12828482622210000000
chr1,77825358,77840740,15382,-1,0,26289,1,6.50110518788194000000
chr1,77830607,77832681,2074,-1,0,26289,1,48.21600771456120000000
chr1,78527306,78527452,146,-1,0,54810,1,684.93150684931500000000
chr1,78564256,78565617,1361,-1,0,54810,1,73.47538574577520000000
chr1,78642584,78665853,23269,-1,0,,0,0.00000000000000000000
chr1,78649267,78659589,10322,-1,0,,0,0.00000000000000000000
chr1,78649151,78654105,4954,-1,0,,0,0.00000000000000000000
chr1,78649193,78651590,2397,-1,0,,0,0.00000000000000000000
chr1,78774623,78812428,37805,-1,0,,0,0.00000000000000000000
chr1,78833896,78835876,1980,-1,0,,0,0.00000000000000000000
chr1,78884249,78889720,5471,-1,0,,0,0.00000000000000000000
chr1,78960308,78964806,4498,-1,0,5737,1,22.23210315695860000000
chr1,79042111,79043022,911,-1,0,,0,0.00000000000000000000
chr1,80172429,80333904,161475,-1,0,,0,0.00000000000000000000
chr1,79966446,80124962,158516,-1,0,,0,0.00000000000000000000
chr1,79393604,79399513,5909,-1,0,64123,1,16.92333728211200000000
chr1,80221056,80224790,3734,-1,0,,0,0.00000000000000000000
chr1,79094565,79097580,3015,-1,0,10964,1,33.16749585406300000000
chr1,80221780,80223034,1254,-1,0,,0,0.00000000000000000000
chr1,80115015,80117306,2291,-1,0,,0,0.00000000000000000000
chr1,80219626,80221288,1662,-1,0,,0,0.00000000000000000000
chr1,80221815,80222961,1146,-1,0,,0,0.00000000000000000000
chr1,80116487,80117280,793,-1,0,,0,0.00000000000000000000
chr1,80114074,80114588,514,-1,0,,0,0.00000000000000000000
chr1,79401469,79401891,422,-1,0,64123,1,236.96682464455000000000
chr1,79897743,79898209,466,-1,0,,0,0.00000000000000000000
chr1,80796222,80796617,395,-1,0,,0,0.00000000000000000000
chr1,79928823,79929145,322,-1,0,,0,0.00000000000000000000
chr1,80503984,80504059,75,-1,0,,0,0.00000000000000000000
chr1,81049863,81049966,103,-1,0,,0,0.00000000000000000000
chr1,81119387,81119724,337,-1,0,,0,0.00000000000000000000
chr1,81193261,81194752,1491,-1,0,,0,0.00000000000000000000
chr1,81194241,81194785,544,-1,0,,0,0.00000000000000000000
chr1,81194335,81194660,325,-1,0,,0,0.00000000000000000000
chr1,81404794,81413939,9145,-1,0,,0,0.00000000000000000000
chr1,81403999,81411102,7103,-1,0,,0,0.00000000000000000000
chr1,81401153,81403802,2649,-1,0,,0,0.00000000000000000000
chr1,81422437,81424602,2165,-1,0,,0,0.00000000000000000000
chr1,81436347,81444070,7723,-1,0,,0,0.00000000000000000000
chr1,81687690,81688250,560,-1,0,,0,0.00000000000000000000
chr1,81687785,81688113,328,-1,0,,0,0.00000000000000000000
chr1,81979558,81980073,515,-1,0,,0,0.00000000000000000000
chr1,81979731,81979852,121,-1,0,,0,0.00000000000000000000
chr1,82085248,82085299,51,-1,0,,0,0.00000000000000000000
chr1,82963289,82963615,326,-1,0,,0,0.00000000000000000000
chr1,83042552,83043063,511,-1,0,,0,0.00000000000000000000
chr1,83042639,83042966,327,-1,0,,0,0.00000000000000000000
chr1,83125924,83127787,1863,-1,0,,0,0.00000000000000000000
chr1,83149653,83150091,438,-1,0,,0,0.00000000000000000000
chr1,83302314,83304308,1994,-1,0,,0,0.00000000000000000000
chr1,83373493,83375046,1553,-1,0,,0,0.00000000000000000000
chr1,83479062,83479495,433,-1,0,,0,0.00000000000000000000
chr1,83484963,83485020,57,-1,0,,0,0.00000000000000000000
chr1,83806855,83816081,9226,-1,0,,0,0.00000000000000000000
chr1,83761324,83761381,57,-1,0,,0,0.00000000000000000000
chr1,84056668,84057349,681,-1,0,,0,0.00000000000000000000
chr1,84126157,84127092,935,-1,0,,0,0.00000000000000000000
chr1,84271654,84272223,569,-1,0,,0,0.00000000000000000000
chr1,84271873,84272073,200,-1,0,,0,0.00000000000000000000
chr1,84271902,84272033,131,-1,0,,0,0.00000000000000000000
chr1,84314368,84319243,4875,-1,0,,0,0.00000000000000000000
chr1,84388332,84388948,616,-1,0,79739,1,162.33766233766200000000
chr1,84517857,84524769,6912,-1,0,,0,0.00000000000000000000
chr1,84711740,84715819,4079,-1,0,,0,0.00000000000000000000
chr1,84713641,84715618,1977,-1,0,,0,0.00000000000000000000
chr1,84882972,84884736,1764,-1,0,,0,0.00000000000000000000
chr1,84895834,84899546,3712,-1,0,,0,0.00000000000000000000
chr1,85666191,85667558,1367,-1,0,84144,1,73.15288953913680000000
chr1,85748534,85749089,555,-1,0,,0,0.00000000000000000000
chr1,85748634,85748965,331,-1,0,,0,0.00000000000000000000
chr1,85910951,85915283,4332,-1,0,23576,1,23.08402585410900000000
chr1,86401590,86406142,4552,-1,0,255631,1,21.96836555360280000000
chr1,86680466,86684934,4468,-1,0,,0,0.00000000000000000000
chr1,86400832,86404542,3710,-1,0,255631,1,26.95417789757410000000
chr1,86680725,86683023,2298,-1,0,,0,0.00000000000000000000
chr1,86740667,86742483,1816,-1,0,,0,0.00000000000000000000
chr1,86405323,86406456,1133,-1,0,255631,1,88.26125330979700000000
chr1,86296704,86297551,847,-1,0,255631,1,118.06375442739100000000
chr1,86740944,86741734,790,-1,0,,0,0.00000000000000000000
chr1,86405710,86406242,532,-1,0,255631,1,187.96992481203000000000
chr1,86882430,86882752,322,-1,0,,0,0.00000000000000000000
chr1,86405793,86406131,338,-1,0,255631,1,295.85798816568000000000
chr1,86851524,86851680,156,-1,0,57489,1,641.02564102564100000000
chr1,86994125,86994526,401,-1,0,,0,0.00000000000000000000
chr1,87027673,87039772,12099,-1,0,22802,1,8.26514587982478000000
chr1,87096975,87098435,1460,-1,0,,0,0.00000000000000000000
chr1,87299936,87300856,920,-1,0,,0,0.00000000000000000000
chr1,87523399,87524643,1244,-1,0,9653,1,80.38585209003220000000
chr1,88046858,88047410,552,-1,0,,0,0.00000000000000000000
chr1,88285840,88286000,160,-1,0,,0,0.00000000000000000000
chr1,89075395,89076783,1388,-1,0,,0,0.00000000000000000000
chr1,89094510,89095344,834,-1,0,,0,0.00000000000000000000
chr1,89257864,89259811,1947,-1,0,5586,1,51.36106831022090000000
chr1,89380088,89385153,5065,-1,0,,0,0.00000000000000000000
chr1,89475923,89478616,2693,-1,0,2635,1,37.13330857779430000000
chr1,89476928,89479002,2074,-1,0,2635,1,48.21600771456120000000
chr1,89767736,89768483,747,-1,0,,0,0.00000000000000000000
chr1,89811423,89812283,860,-1,0,,0,0.00000000000000000000
chr1,90022064,90022847,783,-1,0,23507,1,127.71392081736900000000
chr1,90069768,90075309,5541,-1,0,,0,0.00000000000000000000
chr1,90169024,90174194,5170,-1,0,84230,1,19.34235976789170000000
chr1,91132696,91132833,137,-1,0,,0,0.00000000000000000000
chr1,92892965,92901361,8396,-1,0,,0,0.00000000000000000000
chr1,92579193,92585050,5857,-1,0,284697,1,17.07358716066250000000
chr1,93187833,93193159,5326,-1,0,7813,1,18.77581674802850000000
chr1,93236078,93237902,1824,-1,0,7813,1,54.82456140350880000000
chr1,92133932,92135317,1385,-1,0,,0,0.00000000000000000000
chr1,92232081,92233296,1215,-1,0,7049,1,82.30452674897120000000
chr1,93184647,93186052,1405,-1,0,7813,1,71.17437722419930000000
chr1,92483050,92484120,1070,-1,0,,0,0.00000000000000000000
chr1,91561076,91562169,1093,-1,0,,0,0.00000000000000000000
chr1,93291973,93292789,816,-1,0,,0,0.00000000000000000000
chr1,92383245,92384147,902,-1,0,,0,0.00000000000000000000
chr1,92134206,92134946,740,-1,0,,0,0.00000000000000000000
chr1,91624692,91625213,521,-1,0,,0,0.00000000000000000000
chr1,91914096,91914562,466,-1,0,,0,0.00000000000000000000
chr1,92681181,92681572,391,-1,0,,0,0.00000000000000000000
chr1,91624785,91625071,286,-1,0,,0,0.00000000000000000000
chr1,92681335,92681398,63,-1,0,,0,0.00000000000000000000
chr1,91634301,91634345,44,-1,0,,0,0.00000000000000000000
chr1,94212859,94213642,783,-1,0,8412,1,127.71392081736900000000
chr1,94251340,94251891,551,-1,0,8412,1,181.48820326678800000000
chr1,94251457,94251770,313,-1,0,8412,1,319.48881789137400000000
chr1,94288445,94293422,4977,-1,0,8412,1,20.09242515571630000000
chr1,94288371,94291259,2888,-1,0,8412,1,34.62603878116340000000
chr1,94849807,94850266,459,-1,0,,0,0.00000000000000000000
chr1,94850017,94850067,50,-1,0,,0,0.00000000000000000000
chr1,94943088,94943497,409,-1,0,5825,1,244.49877750611200000000
chr1,94943204,94943383,179,-1,0,5825,1,558.65921787709500000000
chr1,95129096,95155063,25967,-1,0,,0,0.00000000000000000000
chr1,95522242,95526085,3843,-1,0,199857,1,26.02133749674730000000
chr1,95627770,95680058,52288,-1,0,148534;100527978,2,3.82496940024480000000
chr1,95690408,95690851,443,-1,0,100527978,1,225.73363431151200000000
chr1,95891709,95895296,3587,-1,0,,0,0.00000000000000000000
chr1,96482940,96483378,438,-1,0,,0,0.00000000000000000000
chr1,96483114,96483216,102,-1,0,,0,0.00000000000000000000
chr1,96483081,96483164,83,-1,0,,0,0.00000000000000000000
chr1,96989713,96990071,358,-1,0,,0,0.00000000000000000000
chr1,96996366,96997214,848,-1,0,,0,0.00000000000000000000
chr1,97390754,97395521,4767,-1,0,,0,0.00000000000000000000
chr1,97596088,97596630,542,-1,0,1806,1,184.50184501845000000000
chr1,98038327,98042575,4248,-1,0,1806,1,23.54048964218460000000
chr1,98698430,98705994,7564,-1,0,,0,0.00000000000000000000
chr1,98903485,98904143,658,-1,0,,0,0.00000000000000000000
chr1,98973803,98975228,1425,-1,0,,0,0.00000000000000000000
chr1,99044267,99044757,490,-1,0,,0,0.00000000000000000000
chr1,99179942,99180049,107,-1,0,51375,1,934.57943925233600000000
chr1,99404787,99407763,2976,-1,0,163404,1,33.60215053763440000000
chr1,99533275,99536667,3392,-1,0,,0,0.00000000000000000000
chr1,99890883,99891681,798,-1,0,,0,0.00000000000000000000
chr1,100390536,100390863,327,-1,0,,0,0.00000000000000000000
chr1,100390617,100390798,181,-1,0,,0,0.00000000000000000000
chr1,100779696,100780651,955,-1,0,,0,0.00000000000000000000
chr1,101004688,101005733,1045,-1,0,54112,1,95.69377990430620000000
chr1,101037979,101039693,1714,-1,0,,0,0.00000000000000000000
chr1,101119934,101122331,2397,-1,0,,0,0.00000000000000000000
chr1,101231398,101232439,1041,-1,0,,0,0.00000000000000000000
chr1,101388550,101388871,321,-1,0,148867,1,311.52647975077900000000
chr1,101684381,101688228,3847,-1,0,,0,0.00000000000000000000
chr1,101693235,101699116,5881,-1,0,,0,0.00000000000000000000
chr1,101695345,101697781,2436,-1,0,,0,0.00000000000000000000
chr1,101718735,101718836,101,-1,0,,0,0.00000000000000000000
chr1,101722714,101724055,1341,-1,0,,0,0.00000000000000000000
chr1,101723952,101724420,468,-1,0,,0,0.00000000000000000000
chr1,101724127,101724209,82,-1,0,,0,0.00000000000000000000
chr1,101848109,101858517,10408,-1,0,,0,0.00000000000000000000
chr1,101979149,101986955,7806,-1,0,,0,0.00000000000000000000
chr1,102018274,102018360,86,-1,0,,0,0.00000000000000000000
chr1,102096673,102098788,2115,-1,0,,0,0.00000000000000000000
chr1,102288341,102289583,1242,-1,0,118427,1,80.51529790660230000000
chr1,102321436,102326963,5527,-1,0,118427,1,18.09299800977020000000
chr1,102323621,102326159,2538,-1,0,118427,1,39.40110323089050000000
chr1,102325352,102326992,1640,-1,0,118427,1,60.97560975609760000000
chr1,102401638,102414355,12717,-1,0,118427,1,7.86348981678069000000
chr1,102653678,102859134,205456,-1,0,,0,0.00000000000000000000
chr1,102674052,102678228,4176,-1,0,,0,0.00000000000000000000
chr1,102983323,102984809,1486,-1,0,,0,0.00000000000000000000
chr1,103047596,103048157,561,-1,0,,0,0.00000000000000000000
chr1,103047692,103048022,330,-1,0,,0,0.00000000000000000000
chr1,103095600,103097166,1566,-1,0,,0,0.00000000000000000000
chr1,103095976,103096504,528,-1,0,,0,0.00000000000000000000
chr1,103096072,103096391,319,-1,0,,0,0.00000000000000000000
chr1,103110847,103111269,422,-1,0,,0,0.00000000000000000000
chr1,103111058,103111125,67,-1,0,,0,0.00000000000000000000
chr1,104650531,105440268,789737,-1,0,,0,0.00000000000000000000
chr1,104150739,104303840,153101,-1,0,279;277;278;276,4,2.61265439154545000000
chr1,104137867,104224334,86467,-1,0,279;276,2,2.31302115257844000000
chr1,104214236,104302762,88526,-1,0,277;278,2,2.25922327903667000000
chr1,104144327,104219165,74838,-1,0,279;276,2,2.67243913519870000000
chr1,105105154,105172611,67457,-1,0,,0,0.00000000000000000000
chr1,104221548,104266433,44885,-1,0,277,1,2.22791578478334000000
chr1,104153799,104171825,18026,-1,0,279,1,5.54754243869966000000
chr1,104139370,104157926,18556,-1,0,,0,0.00000000000000000000
chr1,104145392,104161322,15930,-1,0,279,1,6.27746390458255000000
chr1,104208541,104220267,11726,-1,0,,0,0.00000000000000000000
chr1,104153625,104165134,11509,-1,0,279,1,8.68885220262403000000
chr1,104114236,104122175,7939,-1,0,280,1,12.59604484191960000000
chr1,104221050,104226620,5570,-1,0,,0,0.00000000000000000000
chr1,105038823,105042474,3651,-1,0,,0,0.00000000000000000000
chr1,104869226,104871417,2191,-1,0,,0,0.00000000000000000000
chr1,104861972,104865200,3228,-1,0,,0,0.00000000000000000000
chr1,105255036,105256195,1159,-1,0,,0,0.00000000000000000000
chr1,104359759,104361471,1712,-1,0,,0,0.00000000000000000000
chr1,105091169,105092746,1577,-1,0,,0,0.00000000000000000000
chr1,104706646,104708049,1403,-1,0,,0,0.00000000000000000000
chr1,104451035,104452223,1188,-1,0,,0,0.00000000000000000000
chr1,104677154,104678378,1224,-1,0,,0,0.00000000000000000000
chr1,105255085,105256187,1102,-1,0,,0,0.00000000000000000000
chr1,104669109,104670173,1064,-1,0,,0,0.00000000000000000000
chr1,105218654,105219460,806,-1,0,,0,0.00000000000000000000
chr1,105428211,105428763,552,-1,0,,0,0.00000000000000000000
chr1,104809268,104809955,687,-1,0,,0,0.00000000000000000000
chr1,104384836,104385508,672,-1,0,,0,0.00000000000000000000
chr1,104443182,104443722,540,-1,0,,0,0.00000000000000000000
chr1,104891798,104892191,393,-1,0,,0,0.00000000000000000000
chr1,105269142,105269596,454,-1,0,,0,0.00000000000000000000
chr1,105428304,105428650,346,-1,0,,0,0.00000000000000000000
chr1,104719847,104720194,347,-1,0,,0,0.00000000000000000000
chr1,104451498,104451652,154,-1,0,,0,0.00000000000000000000
chr1,105625092,105630830,5738,-1,0,,0,0.00000000000000000000
chr1,105667554,105668448,894,-1,0,,0,0.00000000000000000000
chr1,105667637,105668371,734,-1,0,,0,0.00000000000000000000
chr1,105833281,105843912,10631,-1,0,,0,0.00000000000000000000
chr1,105866679,105867242,563,-1,0,,0,0.00000000000000000000
chr1,105866776,105867060,284,-1,0,,0,0.00000000000000000000
chr1,106080808,106134781,53973,-1,0,,0,0.00000000000000000000
chr1,106164409,106215587,51178,-1,0,,0,0.00000000000000000000
chr1,105998321,106023609,25288,-1,0,,0,0.00000000000000000000
chr1,106012659,106024462,11803,-1,0,,0,0.00000000000000000000
chr1,106019461,106027162,7701,-1,0,,0,0.00000000000000000000
chr1,106013640,106022799,9159,-1,0,,0,0.00000000000000000000
chr1,106134900,106143229,8329,-1,0,,0,0.00000000000000000000
chr1,106018005,106022541,4536,-1,0,,0,0.00000000000000000000
chr1,106135043,106137358,2315,-1,0,,0,0.00000000000000000000
chr1,106173509,106173628,119,-1,0,,0,0.00000000000000000000
chr1,106296293,106322478,26185,-1,0,,0,0.00000000000000000000
chr1,106307424,106318246,10822,-1,0,,0,0.00000000000000000000
chr1,106309357,106315137,5780,-1,0,,0,0.00000000000000000000
chr1,106404280,106407910,3630,-1,0,,0,0.00000000000000000000
chr1,106540369,106578086,37717,-1,0,,0,0.00000000000000000000
chr1,106978444,106981591,3147,-1,0,,0,0.00000000000000000000
chr1,106983339,106987949,4610,-1,0,,0,0.00000000000000000000
chr1,107081794,107082334,540,-1,0,,0,0.00000000000000000000
chr1,107095215,107102345,7130,-1,0,,0,0.00000000000000000000
chr1,107220681,107224672,3991,-1,0,,0,0.00000000000000000000
chr1,107221932,107223420,1488,-1,0,,0,0.00000000000000000000
chr1,107488144,107488864,720,-1,0,,0,0.00000000000000000000
chr1,107654676,107664196,9520,-1,0,,0,0.00000000000000000000
chr1,107759242,107763207,3965,-1,0,22854,1,25.22068095838590000000
chr1,107777564,107777966,402,-1,0,22854,1,248.75621890547300000000
chr1,107896838,107899369,2531,-1,0,22854,1,39.51007506914260000000
chr1,108222810,108225237,2427,-1,0,10451,1,41.20313143798930000000
chr1,108201044,108202431,1387,-1,0,10451,1,72.09805335255950000000
chr1,108369391,108369995,604,-1,0,10451,1,165.56291390728500000000
chr1,108402947,108405489,2542,-1,0,10451,1,39.33910306845000000000
chr1,108450509,108457248,6739,-1,0,10451,1,14.83899688381070000000
chr1,108598997,108609964,10967,-1,0,,0,0.00000000000000000000
chr1,108645204,108661831,16627,-1,0,,0,0.00000000000000000000
chr1,108656222,108657777,1555,-1,0,,0,0.00000000000000000000
chr1,108723859,108967429,243570,-1,0,29957;148545,2,0.82111918544976800000
chr1,108768029,108853844,85815,-1,0,148545,1,1.16529744217211000000
chr1,108916707,109004084,87377,-1,0,653149,1,1.14446593497145000000
chr1,108777765,108854286,76521,-1,0,148545,1,1.30683080461573000000
chr1,108730295,108738404,8109,-1,0,29957,1,12.33197681588360000000
chr1,108733287,108737259,3972,-1,0,29957,1,25.17623363544810000000
chr1,108733325,108735803,2478,-1,0,29957,1,40.35512510088780000000
chr1,109024729,109026167,1438,-1,0,,0,0.00000000000000000000
chr1,109025824,109026295,471,-1,0,,0,0.00000000000000000000
chr1,109348923,109350130,1207,-1,0,6814,1,82.85004142502070000000
chr1,109366980,109371992,5012,-1,0,254268,1,19.95211492418200000000
chr1,109369798,109371894,2096,-1,0,254268,1,47.70992366412210000000
chr1,109410001,109459158,49157,-1,0,29899,1,2.03429826881217000000
chr1,109496500,109501668,5168,-1,0,23155,1,19.34984520123840000000
chr1,109494584,109499878,5294,-1,0,23155,1,18.88930865130340000000
chr1,109496697,109500757,4060,-1,0,23155,1,24.63054187192120000000
chr1,109496991,109498132,1141,-1,0,23155,1,87.64241893076250000000
chr1,109475727,109476107,380,-1,0,29899;23155,2,526.31578947368400000000
chr1,109573220,109578317,5097,-1,0,22911,1,19.61938395134390000000
chr1,109571045,109575392,4347,-1,0,22911,1,23.00437083045780000000
chr1,109573261,109575018,1757,-1,0,22911,1,56.91519635742740000000
chr1,109573287,109574383,1096,-1,0,22911,1,91.24087591240880000000
chr1,109573261,109574099,838,-1,0,22911,1,119.33174224343700000000
chr1,109597728,109598149,421,-1,0,,0,0.00000000000000000000
chr1,109602611,109603309,698,-1,0,,0,0.00000000000000000000
chr1,110178181,110251893,73712,-1,0,2948;2946;2944,3,4.06989364011287000000
chr1,110229285,110254838,25553,-1,0,2944,1,3.91343482174304000000
chr1,110222723,110245460,22737,-1,0,2946;2944,2,8.79623521132955000000
chr1,110225022,110245322,20300,-1,0,2946;2944,2,9.85221674876847000000
chr1,110225797,110239924,14127,-1,0,2946;2944,2,14.15728746372200000000
chr1,110229996,110241225,11229,-1,0,2944,1,8.90551251224508000000
chr1,110186897,110191614,4717,-1,0,,0,0.00000000000000000000
chr1,110187273,110189051,1778,-1,0,,0,0.00000000000000000000
chr1,110186997,110188108,1111,-1,0,,0,0.00000000000000000000
chr1,110187749,110188538,789,-1,0,,0,0.00000000000000000000
chr1,110462284,110463015,731,-1,0,1435,1,136.79890560875500000000
chr1,110484107,110485824,1717,-1,0,,0,0.00000000000000000000
chr1,111013732,111014896,1164,-1,0,,0,0.00000000000000000000
chr1,111112151,111112577,426,-1,0,,0,0.00000000000000000000
chr1,111195218,111195392,174,-1,0,,0,0.00000000000000000000
chr1,111221115,111229006,7891,-1,0,,0,0.00000000000000000000
chr1,111264925,111265083,158,-1,0,,0,0.00000000000000000000
chr1,111316262,111316732,470,-1,0,,0,0.00000000000000000000
chr1,111368029,111388117,20088,-1,0,,0,0.00000000000000000000
chr1,111376750,111392646,15896,-1,0,,0,0.00000000000000000000
chr1,111373298,111383436,10138,-1,0,,0,0.00000000000000000000
chr1,111378978,111387577,8599,-1,0,,0,0.00000000000000000000
chr1,111383249,111384514,1265,-1,0,,0,0.00000000000000000000
chr1,111359572,111360436,864,-1,0,,0,0.00000000000000000000
chr1,111472633,111477741,5108,-1,0,,0,0.00000000000000000000
chr1,111841161,111880963,39802,-1,0,27159,1,2.51243656097684000000
chr1,111827765,111836100,8335,-1,0,27159,1,11.99760047990400000000
chr1,111838260,111838328,68,-1,0,27159,1,1470.58823529412000000000
chr1,111928762,111935175,6413,-1,0,,0,0.00000000000000000000
chr1,111957320,111957785,465,-1,0,5016,1,215.05376344086000000000
chr1,112074694,112074805,111,-1,0,57413,1,900.90090090090100000000
chr1,112681071,112706436,25365,-1,0,,0,0.00000000000000000000
chr1,112684998,112697207,12209,-1,0,,0,0.00000000000000000000
chr1,112691737,112704757,13020,-1,0,,0,0.00000000000000000000
chr1,112695091,112697211,2120,-1,0,,0,0.00000000000000000000
chr1,112695675,112697390,1715,-1,0,,0,0.00000000000000000000
chr1,112834896,112837823,2927,-1,0,,0,0.00000000000000000000
chr1,112983546,112987595,4049,-1,0,55917,1,24.69745616201530000000
chr1,113036688,113037953,1265,-1,0,7482,1,79.05138339920950000000
chr1,113220144,113225122,4978,-1,0,4343,1,20.08838891120930000000
chr1,113246318,113350775,104457,-1,0,284467;333926;389,3,2.87199517504811000000
chr1,113342098,113433367,91269,-1,0,,0,0.00000000000000000000
chr1,114039826,114045877,6051,-1,0,260425,1,16.52619401751780000000
chr1,113610302,113614361,4059,-1,0,,0,0.00000000000000000000
chr1,113529220,113532708,3488,-1,0,,0,0.00000000000000000000
chr1,113402157,113406603,4446,-1,0,,0,0.00000000000000000000
chr1,114813947,114817773,3826,-1,0,,0,0.00000000000000000000
chr1,114099343,114102345,3002,-1,0,260425,1,33.31112591605600000000
chr1,113611322,113613777,2455,-1,0,,0,0.00000000000000000000
chr1,113955935,113958024,2089,-1,0,260425,1,47.86979415988510000000
chr1,113577208,113578950,1742,-1,0,,0,0.00000000000000000000
chr1,113799625,113800089,464,-1,0,,0,0.00000000000000000000
chr1,113248891,113249312,421,-1,0,389,1,237.52969121140100000000
chr1,113715629,113715920,291,-1,0,,0,0.00000000000000000000
chr1,114886342,114886606,264,-1,0,,0,0.00000000000000000000
chr1,114767884,114767990,106,-1,0,,0,0.00000000000000000000
chr1,115316965,115321770,4805,-1,0,80143,1,20.81165452653490000000
chr1,114925695,114927003,1308,-1,0,,0,0.00000000000000000000
chr1,115445068,115445438,370,-1,0,6847,1,270.27027027027000000000
chr1,115043513,115043849,336,-1,0,51592,1,297.61904761904800000000
chr1,115796734,115797406,672,-1,0,,0,0.00000000000000000000
chr1,115796856,115797180,324,-1,0,,0,0.00000000000000000000
chr1,116111007,116111400,393,-1,0,,0,0.00000000000000000000
chr1,116486544,116493142,6598,-1,0,,0,0.00000000000000000000
chr1,116229554,116232881,3327,-1,0,81839,1,30.05710850616170000000
chr1,116229569,116231373,1804,-1,0,81839,1,55.43237250554320000000
chr1,116831318,116836094,4776,-1,0,,0,0.00000000000000000000
chr1,117002162,117002292,130,-1,0,,0,0.00000000000000000000
chr1,117078084,117078619,535,-1,0,965,1,186.91588785046700000000
chr1,117078164,117078485,321,-1,0,965,1,311.52647975077900000000
chr1,117297804,117301362,3558,-1,0,914,1,28.10567734682410000000
chr1,117593373,117594969,1596,-1,0,,0,0.00000000000000000000
chr1,117880404,117881842,1438,-1,0,,0,0.00000000000000000000
chr1,118058745,118061285,2540,-1,0,10905,1,39.37007874015750000000
chr1,118091026,118091295,269,-1,0,,0,0.00000000000000000000
chr1,118368991,118369664,673,-1,0,,0,0.00000000000000000000
chr1,118983649,118986284,2635,-1,0,,0,0.00000000000000000000
chr1,118989799,118990341,542,-1,0,,0,0.00000000000000000000
chr1,119071238,119108830,37592,-1,0,,0,0.00000000000000000000
chr1,119199703,119222086,22383,-1,0,,0,0.00000000000000000000
chr1,119482211,119483650,1439,-1,0,6913,1,69.49270326615710000000
chr1,119558711,119559261,550,-1,0,,0,0.00000000000000000000
chr1,119558786,119559082,296,-1,0,,0,0.00000000000000000000
chr1,120077730,120136464,58734,-1,0,,0,0.00000000000000000000
chr1,120115694,120153284,37590,-1,0,,0,0.00000000000000000000
chr1,119998716,120035750,37034,-1,0,,0,0.00000000000000000000
chr1,120126640,120157765,31125,-1,0,,0,0.00000000000000000000
chr1,120098784,120127858,29074,-1,0,,0,0.00000000000000000000
chr1,120151903,120154464,2561,-1,0,,0,0.00000000000000000000
chr1,120012583,120013932,1349,-1,0,,0,0.00000000000000000000
chr1,120012852,120013649,797,-1,0,,0,0.00000000000000000000
chr1,120675933,120676677,744,-1,0,,0,0.00000000000000000000
chr1,120696548,120769192,72644,-1,0,,0,0.00000000000000000000
chr1,121358049,121389603,31554,-1,0,,0,0.00000000000000000000
chr1,121476918,121483514,6596,-1,0,,0,0.00000000000000000000
chr1,142535521,142542713,7192,-1,0,,0,0.00000000000000000000
chr1,142535521,142540079,4558,-1,0,,0,0.00000000000000000000
chr1,142535776,142537613,1837,-1,0,,0,0.00000000000000000000
chr1,142538849,142540350,1501,-1,0,,0,0.00000000000000000000
chr1,142540027,142541820,1793,-1,0,,0,0.00000000000000000000
chr1,142948249,143525556,577307,-1,0,,0,0.00000000000000000000
chr1,142803596,142833053,29457,-1,0,,0,0.00000000000000000000
chr1,143404092,143426083,21991,-1,0,,0,0.00000000000000000000
chr1,142671821,142691590,19769,-1,0,,0,0.00000000000000000000
chr1,143168733,143176287,7554,-1,0,,0,0.00000000000000000000
chr1,143542100,143543637,1537,-1,0,,0,0.00000000000000000000
chr1,142727430,142728200,770,-1,0,,0,0.00000000000000000000
chr1,142653650,142653855,205,-1,0,,0,0.00000000000000000000
chr1,143663045,143726092,63047,-1,0,,0,0.00000000000000000000
chr1,143985877,144093322,107445,-1,0,,0,0.00000000000000000000
chr1,147844439,149224104,1379665,-1,0,728945;284565;644591;730262;645142,5,0.36240681614739800000
chr1,148819784,149491581,671797,-1,0,554282;388692,2,0.29770898054025200000
chr1,144853493,145512985,659492,-1,0,388677;148738;128077;84265;284615;9659;10628;100132406;9939,9,1.36468675889927000000
chr1,148665891,149244351,578460,-1,0,728945,1,0.17287280019361800000
chr1,149063763,149650869,587106,-1,0,554282;653598;388692,3,0.51098098128787700000
chr1,145560372,145972493,412121,-1,0,10401;200035;27246;11126;148741;10623;653519;5174,8,1.94117746972370000000
chr1,149022714,149415039,392325,-1,0,388692,1,0.25489071560568400000
chr1,148525729,148863578,337849,-1,0,728945;730262;284565,3,0.88797066144934600000
chr1,149294658,149680253,385595,-1,0,554282;653598;644634,3,0.77801838716788300000
chr1,148945333,149232544,287211,-1,0,,0,0.00000000000000000000
chr1,149101797,149406741,304944,-1,0,388692,1,0.32792906238522500000
chr1,148798515,149033839,235324,-1,0,728945,1,0.42494603185395500000
chr1,149053912,149228626,174714,-1,0,,0,0.00000000000000000000
chr1,149254059,149442285,188226,-1,0,388692,1,0.53127623176394300000
chr1,145644917,145781351,136434,-1,0,653519;11126;27246;5174,4,2.93182051394814000000
chr1,145830581,145977594,147013,-1,0,,0,0.00000000000000000000
chr1,149143393,149252110,108717,-1,0,,0,0.00000000000000000000
chr1,149071204,149170650,99446,-1,0,,0,0.00000000000000000000
chr1,147714538,147821185,106647,-1,0,,0,0.00000000000000000000
chr1,148526522,148650567,124045,-1,0,730262;284565,2,1.61231811036317000000
chr1,146817699,146930859,113160,-1,0,,0,0.00000000000000000000
chr1,148934109,149045129,111020,-1,0,,0,0.00000000000000000000
chr1,149040331,149120410,80079,-1,0,,0,0.00000000000000000000
chr1,149133592,149208338,74746,-1,0,,0,0.00000000000000000000
chr1,147940289,148004088,63799,-1,0,644591,1,1.56742268687597000000
chr1,147856152,147913592,57440,-1,0,,0,0.00000000000000000000
chr1,149173206,149246114,72908,-1,0,,0,0.00000000000000000000
chr1,149514223,149592330,78107,-1,0,653598,1,1.28029497996338000000
chr1,149132411,149184314,51903,-1,0,,0,0.00000000000000000000
chr1,149152064,149204067,52003,-1,0,,0,0.00000000000000000000
chr1,149249837,149287203,37366,-1,0,,0,0.00000000000000000000
chr1,149041206,149086340,45134,-1,0,,0,0.00000000000000000000
chr1,149065223,149114879,49656,-1,0,,0,0.00000000000000000000
chr1,149229086,149256854,27768,-1,0,,0,0.00000000000000000000
chr1,146877177,146898849,21672,-1,0,,0,0.00000000000000000000
chr1,149242651,149257650,14999,-1,0,,0,0.00000000000000000000
chr1,149207851,149218151,10300,-1,0,,0,0.00000000000000000000
chr1,144896300,144906810,10510,-1,0,9659,1,9.51474785918173000000
chr1,149240213,149249881,9668,-1,0,,0,0.00000000000000000000
chr1,146660622,146670229,9607,-1,0,2330,1,10.40907671489540000000
chr1,145361426,145366591,5165,-1,0,100132406,1,19.36108422071640000000
chr1,145294804,145301171,6367,-1,0,100132406,1,15.70598397989630000000
chr1,149226620,149230843,4223,-1,0,,0,0.00000000000000000000
chr1,145092810,145097242,4432,-1,0,,0,0.00000000000000000000
chr1,144896168,144901119,4951,-1,0,9659,1,20.19793981013940000000
chr1,149328930,149332759,3829,-1,0,,0,0.00000000000000000000
chr1,145719690,145722909,3219,-1,0,,0,0.00000000000000000000
chr1,147807350,147810491,3141,-1,0,,0,0.00000000000000000000
chr1,145684357,145686976,2619,-1,0,27246,1,38.18251240931650000000
chr1,145026047,145027478,1431,-1,0,9659,1,69.88120195667360000000
chr1,144894063,144895237,1174,-1,0,9659,1,85.17887563884160000000
chr1,148849117,148850327,1210,-1,0,,0,0.00000000000000000000
chr1,144954626,144955376,750,-1,0,9659,1,133.33333333333300000000
chr1,145142707,145143423,716,-1,0,,0,0.00000000000000000000
chr1,147390091,147390561,470,-1,0,,0,0.00000000000000000000
chr1,149337413,149337838,425,-1,0,,0,0.00000000000000000000
chr1,145026736,145027068,332,-1,0,9659,1,301.20481927710800000000
chr1,144949058,144949391,333,-1,0,9659,1,300.30030030030000000000
chr1,144860687,144860861,174,-1,0,9659,1,574.71264367816100000000
chr1,145291842,145291955,113,-1,0,,0,0.00000000000000000000
chr1,149891660,149892021,361,-1,0,,0,0.00000000000000000000
chr1,150037594,150038144,550,-1,0,,0,0.00000000000000000000
chr1,150037842,150037904,62,-1,0,,0,0.00000000000000000000
chr1,150383883,150384214,331,-1,0,23248,1,302.11480362537800000000
chr1,150417775,150418347,572,-1,0,23248,1,174.82517482517500000000
chr1,150691346,150691883,537,-1,0,84072,1,186.21973929236500000000
chr1,150691439,150691786,347,-1,0,84072,1,288.18443804034600000000
chr1,150715963,150716533,570,-1,0,1520,1,175.43859649122800000000
chr1,150853045,150862881,9836,-1,0,,0,0.00000000000000000000
chr1,150859320,150862876,3556,-1,0,,0,0.00000000000000000000
chr1,151423645,151426019,2374,-1,0,23126,1,42.12299915754000000000
chr1,151752575,151753002,427,-1,0,11022,1,234.19203747072600000000
chr1,152053084,152054197,1113,-1,0,100131107,1,89.84725965858040000000
chr1,152084218,152084810,592,-1,0,7062,1,168.91891891891900000000
chr1,152080466,152081311,845,-1,0,7062,1,118.34319526627200000000
chr1,152128942,152129307,365,-1,0,126638,1,273.97260273972600000000
chr1,152142923,152143360,437,-1,0,,0,0.00000000000000000000
chr1,152185618,152193233,7615,-1,0,388697,1,13.13197636244250000000
chr1,152187774,152191169,3395,-1,0,388697,1,29.45508100147280000000
chr1,152275923,152286734,10811,-1,0,2312,1,9.24983812783276000000
chr1,152280739,152284629,3890,-1,0,2312,1,25.70694087403600000000
chr1,152278661,152279633,972,-1,0,2312,1,102.88065843621400000000
chr1,152327436,152327667,231,-1,0,388698,1,432.90043290043300000000
chr1,152407115,152437059,29944,-1,0,,0,0.00000000000000000000
chr1,152414907,152419057,4150,-1,0,,0,0.00000000000000000000
chr1,152544421,152590921,46500,-1,0,353144;84648;353143,3,6.45161290322581000000
chr1,152555127,152591098,35971,-1,0,353144;353143,2,5.56003447221373000000
chr1,152521556,152555596,34040,-1,0,84648;353145,2,5.87544065804935000000
chr1,152554926,152575348,20422,-1,0,353144,1,4.89668005092547000000
chr1,152755550,152773470,17920,-1,0,353135;353134,2,11.16071428571430000000
chr1,152759620,152772176,12556,-1,0,353135;353134,2,15.92863969417010000000
chr1,152572590,152586829,14239,-1,0,353144;353143,2,14.04593019172690000000
chr1,152759898,152770401,10503,-1,0,353135;353134,2,19.04217842521180000000
chr1,152643712,152646740,3028,-1,0,,0,0.00000000000000000000
chr1,152495213,152497872,2659,-1,0,,0,0.00000000000000000000
chr1,153043412,153066335,22923,-1,0,6701;6704,2,8.72486149282380000000
chr1,153215634,153217137,1503,-1,0,,0,0.00000000000000000000
chr1,153215971,153216473,502,-1,0,,0,0.00000000000000000000
chr1,153133703,153133960,257,-1,0,,0,0.00000000000000000000
chr1,153226281,153227456,1175,-1,0,,0,0.00000000000000000000
chr1,153270176,153323462,53286,-1,0,114771;57115,2,3.75333108133468000000
chr1,153960715,153961968,1253,-1,0,,0,0.00000000000000000000
chr1,154008323,154009196,873,-1,0,91181,1,114.54753722795000000000
chr1,154080942,154084690,3748,-1,0,91181,1,26.68089647812170000000
chr1,154157615,154161359,3744,-1,0,7170,1,26.70940170940170000000
chr1,154352421,154352509,88,-1,0,,0,0.00000000000000000000
chr1,154474148,154475093,945,-1,0,126669;126668,2,211.64021164021200000000
chr1,154608499,154609084,585,-1,0,,0,0.00000000000000000000
chr1,154728437,154728760,323,-1,0,3782,1,309.59752321981400000000
chr1,154854901,154856417,1516,-1,0,,0,0.00000000000000000000
chr1,154969430,154969573,143,-1,0,,0,0.00000000000000000000
chr1,154993329,154994396,1067,-1,0,127579,1,93.72071227741330000000
chr1,154999758,154999863,105,-1,0,127579,1,952.38095238095300000000
chr1,155183614,155217972,34358,-1,0,10712;4580;2629,3,8.73159089586123000000
chr1,155182541,155205990,23449,-1,0,4580;2629,2,8.52914836453580000000
chr1,155551251,155660386,109135,-1,0,55154;7818;55249,3,2.74888899069959000000
chr1,155659562,155664375,4813,-1,0,7818,1,20.77706212341570000000
chr1,155661229,155663356,2127,-1,0,7818,1,47.01457451810060000000
chr1,155844261,155845012,751,-1,0,23208,1,133.15579227696400000000
chr1,156526389,156529117,2728,-1,0,128239,1,36.65689149560120000000
chr1,156671964,156672786,822,-1,0,1382,1,121.65450121654500000000
chr1,157018859,157019253,394,-1,0,,0,0.00000000000000000000
chr1,157033392,157036406,3014,-1,0,,0,0.00000000000000000000
chr1,157087254,157088496,1242,-1,0,,0,0.00000000000000000000
chr1,157172888,157176035,3147,-1,0,,0,0.00000000000000000000
chr1,157173861,157175391,1530,-1,0,,0,0.00000000000000000000
chr1,157223043,157243618,20575,-1,0,,0,0.00000000000000000000
chr1,157540653,157540872,219,-1,0,,0,0.00000000000000000000
chr1,158329321,158354954,25633,-1,0,,0,0.00000000000000000000
chr1,158050675,158051120,445,-1,0,55243,1,224.71910112359600000000
chr1,158050713,158051038,325,-1,0,55243,1,307.69230769230800000000
chr1,158455170,158513839,58669,-1,0,,0,0.00000000000000000000
chr1,158514951,158526338,11387,-1,0,391112,1,8.78194432247300000000
chr1,158517087,158521742,4655,-1,0,391112,1,21.48227712137490000000
chr1,158492253,158497864,5611,-1,0,,0,0.00000000000000000000
chr1,158489620,158491973,2353,-1,0,,0,0.00000000000000000000
chr1,158487993,158489141,1148,-1,0,,0,0.00000000000000000000
chr1,158488409,158488678,269,-1,0,,0,0.00000000000000000000
chr1,158629269,158629821,552,-1,0,6708,1,181.15942028985500000000
chr1,158629374,158629704,330,-1,0,6708,1,303.03030303030300000000
chr1,158869480,158929632,60152,-1,0,149628,1,1.66245511371193000000
chr1,158695080,158726904,31824,-1,0,128371,1,3.14228255404726000000
chr1,158697260,158709450,12190,-1,0,,0,0.00000000000000000000
chr1,158962576,158971274,8698,-1,0,107181291,1,11.49689583812370000000
chr1,158961350,158966223,4873,-1,0,,0,0.00000000000000000000
chr1,158867463,158870341,2878,-1,0,,0,0.00000000000000000000
chr1,158725775,158727975,2200,-1,0,,0,0.00000000000000000000
chr1,158786137,158787351,1214,-1,0,,0,0.00000000000000000000
chr1,158726920,158728009,1089,-1,0,,0,0.00000000000000000000
chr1,158711926,158712471,545,-1,0,,0,0.00000000000000000000
chr1,158851481,158851922,441,-1,0,,0,0.00000000000000000000
chr1,158712030,158712353,323,-1,0,,0,0.00000000000000000000
chr1,158851702,158851749,47,-1,0,,0,0.00000000000000000000
chr1,159012766,159019503,6737,-1,0,3428,1,14.84340210776310000000
chr1,159014973,159018915,3942,-1,0,3428,1,25.36783358701170000000
chr1,159013540,159016495,2955,-1,0,3428,1,33.84094754653130000000
chr1,159066088,159068292,2204,-1,0,,0,0.00000000000000000000
chr1,159119653,159123958,4305,-1,0,,0,0.00000000000000000000
chr1,159648707,159649658,951,-1,0,,0,0.00000000000000000000
chr1,159648758,159649623,865,-1,0,,0,0.00000000000000000000
chr1,159920150,159933583,13433,-1,0,89886,1,7.44435345790218000000
chr1,159946748,159946799,51,-1,0,,0,0.00000000000000000000
chr1,159997326,160007672,10346,-1,0,3766;93183,2,19.33114247052000000000
chr1,160205005,160205615,610,-1,0,50717,1,163.93442622950800000000
chr1,160434463,160437577,3114,-1,0,,0,0.00000000000000000000
chr1,160564310,160565871,1561,-1,0,,0,0.00000000000000000000
chr1,160694239,160694590,351,-1,0,,0,0.00000000000000000000
chr1,160846551,160851699,5148,-1,0,55600,1,19.42501942501940000000
chr1,160935076,160940007,4931,-1,0,,0,0.00000000000000000000
chr1,160934942,160935407,465,-1,0,,0,0.00000000000000000000
chr1,160935005,160935327,322,-1,0,,0,0.00000000000000000000
chr1,160954056,160960778,6722,-1,0,,0,0.00000000000000000000
chr1,160954838,160955160,322,-1,0,,0,0.00000000000000000000
chr1,160979498,160979991,493,-1,0,50848,1,202.83975659229200000000
chr1,160997460,160999062,1602,-1,0,,0,0.00000000000000000000
chr1,161344937,161346858,1921,-1,0,,0,0.00000000000000000000
chr1,161410153,161443643,33490,-1,0,,0,0.00000000000000000000
chr1,161492336,161644971,152635,-1,0,2213;2214;2215;3310,4,2.62063091689324000000
chr1,161543953,161625984,82031,-1,0,2215,1,1.21905133425169000000
chr1,161564656,161646628,81972,-1,0,2215;2213,2,2.43985751232128000000
chr1,161513244,161588460,75216,-1,0,2214,1,1.32950436077430000000
chr1,161488659,161520615,31956,-1,0,2214;3310;2212,3,9.38790837401427000000
chr1,161616466,161638716,22250,-1,0,2213,1,4.49438202247191000000
chr1,161570323,161598180,27857,-1,0,2215,1,3.58976199877948000000
chr1,161590277,161598097,7820,-1,0,2215,1,12.78772378516620000000
chr1,162052576,162053126,550,-1,0,9722,1,181.81818181818200000000
chr1,162052682,162053006,324,-1,0,9722,1,308.64197530864200000000
chr1,162230747,162231295,548,-1,0,9722,1,182.48175182481800000000
chr1,162283209,162296816,13607,-1,0,9722,1,7.34915852134931000000
chr1,162327304,162327768,464,-1,0,9722,1,215.51724137931000000000
chr1,163343717,163344164,447,-1,0,,0,0.00000000000000000000
chr1,163343858,163343954,96,-1,0,,0,0.00000000000000000000
chr1,163547901,163791974,244073,-1,0,,0,0.00000000000000000000
chr1,163805878,163867603,61725,-1,0,,0,0.00000000000000000000
chr1,163771300,163772032,732,-1,0,,0,0.00000000000000000000
chr1,164175989,164176473,484,-1,0,,0,0.00000000000000000000
chr1,164176123,164176334,211,-1,0,,0,0.00000000000000000000
chr1,164184235,164184357,122,-1,0,,0,0.00000000000000000000
chr1,164748358,164751209,2851,-1,0,5087,1,35.07541213609260000000
chr1,164845199,164845255,56,-1,0,,0,0.00000000000000000000
chr1,164850405,164850804,399,-1,0,,0,0.00000000000000000000
chr1,165317169,165317254,85,-1,0,4009,1,1176.47058823529000000000
chr1,165322581,165326686,4105,-1,0,4009,1,24.36053593179050000000
chr1,165421785,165424233,2448,-1,0,,0,0.00000000000000000000
chr1,165552181,165552379,198,-1,0,,0,0.00000000000000000000
chr1,165603494,165604275,781,-1,0,4259,1,128.04097311139600000000
chr1,165731136,165731630,494,-1,0,54499,1,202.42914979757100000000
chr1,165731190,165731488,298,-1,0,54499,1,335.57046979865800000000
chr1,166368631,166371103,2472,-1,0,,0,0.00000000000000000000
chr1,166372938,166380124,7186,-1,0,,0,0.00000000000000000000
chr1,166396577,166397091,514,-1,0,,0,0.00000000000000000000
chr1,166464504,166471277,6773,-1,0,,0,0.00000000000000000000
chr1,166534010,166582868,48858,-1,0,,0,0.00000000000000000000
chr1,166575357,166579952,4595,-1,0,,0,0.00000000000000000000
chr1,166551471,166552834,1363,-1,0,,0,0.00000000000000000000
chr1,167765313,167767568,2255,-1,0,,0,0.00000000000000000000
chr1,168024251,168025994,1743,-1,0,55827,1,57.37234652897300000000
chr1,168024558,168025732,1174,-1,0,55827,1,85.17887563884160000000
chr1,168089035,168091474,2439,-1,0,23432,1,41.00041000410000000000
chr1,168178349,168180332,1983,-1,0,,0,0.00000000000000000000
chr1,168287999,168290157,2158,-1,0,,0,0.00000000000000000000
chr1,168427020,168428846,1826,-1,0,,0,0.00000000000000000000
chr1,168546344,168548100,1756,-1,0,6375,1,56.94760820045560000000
chr1,168572265,168574697,2432,-1,0,,0,0.00000000000000000000
chr1,169004356,169005229,873,-1,0,,0,0.00000000000000000000
chr1,169007717,169007843,126,-1,0,,0,0.00000000000000000000
chr1,169024557,169025008,451,-1,0,,0,0.00000000000000000000
chr1,169144203,169148085,3882,-1,0,29922,1,25.75991756826380000000
chr1,169159980,169160427,447,-1,0,29922,1,223.71364653243800000000
chr1,169225016,169245592,20576,-1,0,29922,1,4.86003110419907000000
chr1,169235346,169254583,19237,-1,0,29922,1,5.19831574569839000000
chr1,169225666,169243157,17491,-1,0,29922,1,5.71722600194386000000
chr1,169234090,169241924,7834,-1,0,29922,1,12.76487107480210000000
chr1,169320180,169327884,7704,-1,0,29922,1,12.98026998961580000000
chr1,169471788,169472131,343,-1,0,,0,0.00000000000000000000
chr1,169575747,169581845,6098,-1,0,6403,1,16.39881928501150000000
chr1,169637742,169637903,161,-1,0,,0,0.00000000000000000000
chr1,169730439,169730818,379,-1,0,,0,0.00000000000000000000
chr1,169849517,169849756,239,-1,0,57147,1,418.41004184100400000000
chr1,170123713,170128280,4567,-1,0,149281,1,21.89621195533170000000
chr1,170367420,170388124,20704,-1,0,,0,0.00000000000000000000
chr1,170560249,170611843,51594,-1,0,,0,0.00000000000000000000
chr1,170617662,170618553,891,-1,0,,0,0.00000000000000000000
chr1,171179918,171180000,82,-1,0,2327,1,1219.51219512195000000000
chr1,171190122,171190237,115,-1,0,,0,0.00000000000000000000
chr1,171408904,171412007,3103,-1,0,,0,0.00000000000000000000
chr1,171423108,171424974,1866,-1,0,,0,0.00000000000000000000
chr1,171457151,171457201,50,-1,0,23215,1,2000.00000000000000000000
chr1,172759295,172762004,2709,-1,0,,0,0.00000000000000000000
chr1,172918528,172923671,5143,-1,0,,0,0.00000000000000000000
chr1,173075626,173089144,13518,-1,0,,0,0.00000000000000000000
chr1,173078011,173079783,1772,-1,0,,0,0.00000000000000000000
chr1,173083713,173084955,1242,-1,0,,0,0.00000000000000000000
chr1,173207590,173207880,290,-1,0,,0,0.00000000000000000000
chr1,173944645,173945184,539,-1,0,149041,1,185.52875695732800000000
chr1,173944737,173945067,330,-1,0,149041,1,303.03030303030300000000
chr1,173963359,173968157,4798,-1,0,,0,0.00000000000000000000
chr1,173972260,173976256,3996,-1,0,,0,0.00000000000000000000
chr1,174159273,174162537,3264,-1,0,9910,1,30.63725490196080000000
chr1,174803415,174819205,15790,-1,0,9910,1,6.33312222925903000000
chr1,174796128,174806802,10674,-1,0,9910,1,9.36855911560802000000
chr1,174796497,174801836,5339,-1,0,9910,1,18.73009926952610000000
chr1,174797754,174802590,4836,-1,0,9910,1,20.67824648469810000000
chr1,174894053,174898956,4903,-1,0,9910,1,20.39567611666330000000
chr1,175022466,175026198,3732,-1,0,,0,0.00000000000000000000
chr1,175070798,175077818,7020,-1,0,63923,1,14.24501424501420000000
chr1,175091432,175091855,423,-1,0,63923,1,236.40661938534300000000
chr1,175091593,175091645,52,-1,0,63923,1,1923.07692307692000000000
chr1,175396016,175396110,94,-1,0,7143,1,1063.82978723404000000000
chr1,175411523,175412144,621,-1,0,7143,1,161.03059581320500000000
chr1,175516703,175516763,60,-1,0,7143,1,1666.66666666667000000000
chr1,176101487,176102486,999,-1,0,64326,1,100.10010010010000000000
chr1,176269860,176270279,419,-1,0,,0,0.00000000000000000000
chr1,176477201,176479405,2204,-1,0,60676,1,45.37205081669690000000
chr1,176478183,176478836,653,-1,0,60676,1,153.13935681470100000000
chr1,176590628,176613322,22694,-1,0,60676,1,4.40645104432890000000
chr1,177114953,177117571,2618,-1,0,460,1,38.19709702062640000000
chr1,177509007,177560107,51100,-1,0,,0,0.00000000000000000000
chr1,177502960,177506192,3232,-1,0,,0,0.00000000000000000000
chr1,177759149,177759914,765,-1,0,,0,0.00000000000000000000
chr1,177932044,177932561,517,-1,0,89866,1,193.42359767891700000000
chr1,177946282,177951938,5656,-1,0,,0,0.00000000000000000000
chr1,178495285,178495719,434,-1,0,,0,0.00000000000000000000
chr1,178659660,178676315,16655,-1,0,,0,0.00000000000000000000
chr1,178892140,178896938,4798,-1,0,,0,0.00000000000000000000
chr1,178899079,178900596,1517,-1,0,,0,0.00000000000000000000
chr1,178948071,178975787,27716,-1,0,,0,0.00000000000000000000
chr1,178977403,178979796,2393,-1,0,,0,0.00000000000000000000
chr1,179064382,179066712,2330,-1,0,64222,1,42.91845493562230000000
chr1,179323034,179336423,13389,-1,0,6646;126859,2,14.93763537232060000000
chr1,179329927,179333716,3789,-1,0,,0,0.00000000000000000000
chr1,179455594,179458304,2710,-1,0,126859,1,36.90036900369000000000
chr1,179455707,179457680,1973,-1,0,126859,1,50.68423720223010000000
chr1,179467423,179469886,2463,-1,0,126859,1,40.60089321965080000000
chr1,179606655,179608520,1865,-1,0,163589,1,53.61930294906170000000
chr1,179607265,179608063,798,-1,0,163589,1,125.31328320802000000000
chr1,179607299,179607936,637,-1,0,163589,1,156.98587127158600000000
chr1,179806408,179807810,1402,-1,0,,0,0.00000000000000000000
chr1,180133701,180169400,35699,-1,0,5768,1,2.80119891313482000000
chr1,180183677,180184090,413,-1,0,,0,0.00000000000000000000
chr1,180183801,180184124,323,-1,0,,0,0.00000000000000000000
chr1,180228416,180230419,2003,-1,0,89884,1,49.92511233150280000000
chr1,180272306,180273838,1532,-1,0,84320,1,65.27415143603130000000
chr1,180292912,180293410,498,-1,0,84320,1,200.80321285140600000000
chr1,180292992,180293324,332,-1,0,84320,1,301.20481927710800000000
chr1,180401026,180406773,5747,-1,0,84320,1,17.40038280842180000000
chr1,180749661,180755414,5753,-1,0,9213,1,17.38223535546670000000
chr1,181038165,181038943,778,-1,0,,0,0.00000000000000000000
chr1,181057682,181059314,1632,-1,0,51278,1,61.27450980392160000000
chr1,181418209,181426322,8113,-1,0,,0,0.00000000000000000000
chr1,182083775,182087648,3873,-1,0,,0,0.00000000000000000000
chr1,182289323,182289636,313,-1,0,,0,0.00000000000000000000
chr1,182674678,182674860,182,-1,0,,0,0.00000000000000000000
chr1,182776891,182782156,5265,-1,0,80896,1,18.99335232668570000000
chr1,182951720,182952519,799,-1,0,,0,0.00000000000000000000
chr1,182952005,182952307,302,-1,0,,0,0.00000000000000000000
chr1,183118565,183118747,182,-1,0,,0,0.00000000000000000000
chr1,183308637,183309115,478,-1,0,23057,1,209.20502092050200000000
chr1,183581865,183588798,6933,-1,0,,0,0.00000000000000000000
chr1,184402326,184403489,1163,-1,0,81563,1,85.98452278589850000000
chr1,184814570,184820931,6361,-1,0,116496,1,15.72079861656970000000
chr1,184936932,184937477,545,-1,0,116496,1,183.48623853211000000000
chr1,184937030,184937360,330,-1,0,116496,1,303.03030303030300000000
chr1,184961183,184971001,9818,-1,0,,0,0.00000000000000000000
chr1,185009805,185011736,1931,-1,0,,0,0.00000000000000000000
chr1,185009898,185011077,1179,-1,0,,0,0.00000000000000000000
chr1,185372977,185373555,578,-1,0,,0,0.00000000000000000000
chr1,185373079,185373424,345,-1,0,,0,0.00000000000000000000
chr1,185416345,185418602,2257,-1,0,,0,0.00000000000000000000
chr1,185437377,185437594,217,-1,0,,0,0.00000000000000000000
chr1,185766731,185767223,492,-1,0,83872,1,203.25203252032500000000
chr1,185766810,185767133,323,-1,0,83872,1,309.59752321981400000000
chr1,185783511,185785502,1991,-1,0,83872,1,50.22601707684580000000
chr1,186551948,186553847,1899,-1,0,,0,0.00000000000000000000
chr1,186765009,186765504,495,-1,0,,0,0.00000000000000000000
chr1,186784061,186791489,7428,-1,0,,0,0.00000000000000000000
chr1,186839736,186840061,325,-1,0,5321,1,307.69230769230800000000
chr1,187115664,187116072,408,-1,0,,0,0.00000000000000000000
chr1,187295944,187301350,5406,-1,0,,0,0.00000000000000000000
chr1,187298420,187300638,2218,-1,0,,0,0.00000000000000000000
chr1,187399807,187405046,5239,-1,0,,0,0.00000000000000000000
chr1,187464746,187466829,2083,-1,0,,0,0.00000000000000000000
chr1,187464835,187466483,1648,-1,0,,0,0.00000000000000000000
chr1,187613970,187778401,164431,-1,0,,0,0.00000000000000000000
chr1,187748007,187771216,23209,-1,0,,0,0.00000000000000000000
chr1,187715963,187723577,7614,-1,0,,0,0.00000000000000000000
chr1,187593607,187596902,3295,-1,0,,0,0.00000000000000000000
chr1,187716140,187722084,5944,-1,0,,0,0.00000000000000000000
chr1,187753842,187754842,1000,-1,0,,0,0.00000000000000000000
chr1,187939347,187947685,8338,-1,0,,0,0.00000000000000000000
chr1,188083897,188235085,151188,-1,0,,0,0.00000000000000000000
chr1,188149816,188149931,115,-1,0,,0,0.00000000000000000000
chr1,188539526,188552504,12978,-1,0,,0,0.00000000000000000000
chr1,188539237,188540465,1228,-1,0,,0,0.00000000000000000000
chr1,188539453,188540229,776,-1,0,,0,0.00000000000000000000
chr1,188648504,189047199,398695,-1,0,,0,0.00000000000000000000
chr1,189321512,189545020,223508,-1,0,,0,0.00000000000000000000
chr1,188887277,189047481,160204,-1,0,,0,0.00000000000000000000
chr1,189423131,189589339,166208,-1,0,,0,0.00000000000000000000
chr1,189361721,189453719,91998,-1,0,,0,0.00000000000000000000
chr1,189533375,189621964,88589,-1,0,,0,0.00000000000000000000
chr1,189707960,189792734,84774,-1,0,,0,0.00000000000000000000
chr1,188979817,189038565,58748,-1,0,,0,0.00000000000000000000
chr1,189173235,189252936,79701,-1,0,,0,0.00000000000000000000
chr1,189684041,189763124,79083,-1,0,,0,0.00000000000000000000
chr1,189326649,189370335,43686,-1,0,,0,0.00000000000000000000
chr1,189462666,189517150,54484,-1,0,,0,0.00000000000000000000
chr1,189414402,189439451,25049,-1,0,,0,0.00000000000000000000
chr1,188830139,188864535,34396,-1,0,,0,0.00000000000000000000
chr1,188995550,189038554,43004,-1,0,,0,0.00000000000000000000
chr1,189416431,189436922,20491,-1,0,,0,0.00000000000000000000
chr1,189791141,189806453,15312,-1,0,,0,0.00000000000000000000
chr1,189025890,189031275,5385,-1,0,,0,0.00000000000000000000
chr1,188958994,188966462,7468,-1,0,,0,0.00000000000000000000
chr1,189087086,189093624,6538,-1,0,,0,0.00000000000000000000
chr1,189771464,189777753,6289,-1,0,,0,0.00000000000000000000
chr1,189071856,189077868,6012,-1,0,,0,0.00000000000000000000
chr1,188759398,188765251,5853,-1,0,,0,0.00000000000000000000
chr1,189027457,189031511,4054,-1,0,,0,0.00000000000000000000
chr1,189243964,189247024,3060,-1,0,,0,0.00000000000000000000
chr1,189785826,189787575,1749,-1,0,,0,0.00000000000000000000
chr1,189200857,189201831,974,-1,0,,0,0.00000000000000000000
chr1,189032780,189033298,518,-1,0,,0,0.00000000000000000000
chr1,189853332,189854117,785,-1,0,,0,0.00000000000000000000
chr1,188994859,188995390,531,-1,0,,0,0.00000000000000000000
chr1,189084865,189085346,481,-1,0,,0,0.00000000000000000000
chr1,189530169,189530739,570,-1,0,,0,0.00000000000000000000
chr1,189661508,189661845,337,-1,0,,0,0.00000000000000000000
chr1,188994957,188995299,342,-1,0,,0,0.00000000000000000000
chr1,189032966,189033038,72,-1,0,,0,0.00000000000000000000
chr1,189829495,189829542,47,-1,0,,0,0.00000000000000000000
chr1,189897857,189935789,37932,-1,0,,0,0.00000000000000000000
chr1,189969109,189989544,20435,-1,0,,0,0.00000000000000000000
chr1,190052657,190053874,1217,-1,0,,0,0.00000000000000000000
chr1,190252722,190304792,52070,-1,0,339479,1,1.92049164586134000000
chr1,190309743,190311634,1891,-1,0,339479,1,52.88207297726070000000
chr1,190368375,190370938,2563,-1,0,339479,1,39.01677721420210000000
chr1,191006793,191010243,3450,-1,0,,0,0.00000000000000000000
chr1,190597851,190598242,391,-1,0,,0,0.00000000000000000000
chr1,190837288,190837495,207,-1,0,,0,0.00000000000000000000
chr1,190910592,190910775,183,-1,0,,0,0.00000000000000000000
chr1,190597949,190598033,84,-1,0,,0,0.00000000000000000000
chr1,191487545,191513767,26222,-1,0,,0,0.00000000000000000000
chr1,191197533,191201029,3496,-1,0,,0,0.00000000000000000000
chr1,191545989,191546051,62,-1,0,,0,0.00000000000000000000
chr1,191676818,191741681,64863,-1,0,,0,0.00000000000000000000
chr1,191724026,191756301,32275,-1,0,,0,0.00000000000000000000
chr1,191699579,191731238,31659,-1,0,,0,0.00000000000000000000
chr1,191716932,191726618,9686,-1,0,,0,0.00000000000000000000
chr1,191657096,191661114,4018,-1,0,,0,0.00000000000000000000
chr1,191767285,191892602,125317,-1,0,,0,0.00000000000000000000
chr1,191826474,191870927,44453,-1,0,,0,0.00000000000000000000
chr1,191835729,191865809,30080,-1,0,,0,0.00000000000000000000
chr1,191867753,191868886,1133,-1,0,,0,0.00000000000000000000
chr1,191786712,191787199,487,-1,0,,0,0.00000000000000000000
chr1,191915540,191919309,3769,-1,0,,0,0.00000000000000000000
chr1,191916440,191918546,2106,-1,0,,0,0.00000000000000000000
chr1,191917135,191918242,1107,-1,0,,0,0.00000000000000000000
chr1,192090893,192092029,1136,-1,0,,0,0.00000000000000000000
chr1,192539172,192540175,1003,-1,0,,0,0.00000000000000000000
chr1,192609623,192610021,398,-1,0,6003,1,251.25628140703500000000
chr1,192609799,192609865,66,-1,0,6003,1,1515.15151515152000000000
chr1,192675028,192683623,8595,-1,0,,0,0.00000000000000000000
chr1,192860399,192861923,1524,-1,0,,0,0.00000000000000000000
chr1,192874378,192896994,22616,-1,0,,0,0.00000000000000000000
chr1,193531528,193534392,2864,-1,0,,0,0.00000000000000000000
chr1,193465838,193466745,907,-1,0,,0,0.00000000000000000000
chr1,193235214,193235775,561,-1,0,,0,0.00000000000000000000
chr1,193235417,193235662,245,-1,0,,0,0.00000000000000000000
chr1,193661438,193711929,50491,-1,0,,0,0.00000000000000000000
chr1,193999052,194000219,1167,-1,0,,0,0.00000000000000000000
chr1,194060070,194060239,169,-1,0,,0,0.00000000000000000000
chr1,194349979,194351942,1963,-1,0,,0,0.00000000000000000000
chr1,194350476,194351272,796,-1,0,,0,0.00000000000000000000
chr1,194451056,194454312,3256,-1,0,,0,0.00000000000000000000
chr1,194451505,194453006,1501,-1,0,,0,0.00000000000000000000
chr1,194517516,194517941,425,-1,0,,0,0.00000000000000000000
chr1,194517606,194517871,265,-1,0,,0,0.00000000000000000000
chr1,194575584,194578100,2516,-1,0,,0,0.00000000000000000000
chr1,194759376,194760572,1196,-1,0,,0,0.00000000000000000000
chr1,194802521,194808013,5492,-1,0,,0,0.00000000000000000000
chr1,194936113,194946165,10052,-1,0,,0,0.00000000000000000000
chr1,195013817,195019754,5937,-1,0,,0,0.00000000000000000000
chr1,195040090,195040543,453,-1,0,,0,0.00000000000000000000
chr1,195043196,195043556,360,-1,0,,0,0.00000000000000000000
chr1,195144343,195145919,1576,-1,0,,0,0.00000000000000000000
chr1,195825815,195875445,49630,-1,0,,0,0.00000000000000000000
chr1,195409277,195416568,7291,-1,0,,0,0.00000000000000000000
chr1,196004609,196013402,8793,-1,0,,0,0.00000000000000000000
chr1,195359352,195365472,6120,-1,0,,0,0.00000000000000000000
chr1,195409720,195415700,5980,-1,0,,0,0.00000000000000000000
chr1,195526145,195531466,5321,-1,0,,0,0.00000000000000000000
chr1,195904508,195906953,2445,-1,0,,0,0.00000000000000000000
chr1,196013155,196015042,1887,-1,0,,0,0.00000000000000000000
chr1,196158044,196158353,309,-1,0,,0,0.00000000000000000000
chr1,196547129,196547551,422,-1,0,343450,1,236.96682464455000000000
chr1,196602667,196604033,1366,-1,0,,0,0.00000000000000000000
chr1,196765376,196894460,129084,-1,0,10877;3078,2,1.54937869914164000000
chr1,196808435,196902770,94335,-1,0,10877,1,1.06005194254518000000
chr1,196711400,196820800,109400,-1,0,3078;10878;3075,3,2.74223034734918000000
chr1,196773920,196842682,68762,-1,0,3078,1,1.45429161455455000000
chr1,196715981,196789149,73168,-1,0,3078;10878;3075,3,4.10015307238137000000
chr1,196814384,196878886,64502,-1,0,10877,1,1.55033952435583000000
chr1,196762819,196807443,44624,-1,0,3078;10878,2,4.48189315166726000000
chr1,196715693,196768705,53012,-1,0,10878;3075,2,3.77273070248246000000
chr1,196853420,196898039,44619,-1,0,10877,1,2.24119769604877000000
chr1,196880793,196917126,36333,-1,0,10877;3080,2,5.50463765722621000000
chr1,196783819,196822291,38472,-1,0,3078,1,2.59929299230609000000
chr1,196748244,196787612,39368,-1,0,10878,1,2.54013411908149000000
chr1,196736214,196765620,29406,-1,0,10878,1,3.40066653064001000000
chr1,196711623,196742688,31065,-1,0,3075,1,3.21905681635281000000
chr1,196773650,196796014,22364,-1,0,3078,1,4.47147200858523000000
chr1,196738851,196758095,19244,-1,0,10878,1,5.19642485969653000000
chr1,196770610,196790713,20103,-1,0,3078,1,4.97438193304482000000
chr1,196842276,196859000,16724,-1,0,10877,1,5.97943075819182000000
chr1,196798925,196813700,14775,-1,0,3078,1,6.76818950930626000000
chr1,196788302,196801464,13162,-1,0,3078,1,7.59762953958365000000
chr1,196939175,196952302,13127,-1,0,81494,1,7.61788679820218000000
chr1,196768240,196779016,10776,-1,0,,0,0.00000000000000000000
chr1,196735099,196744938,9839,-1,0,10878,1,10.16363451570280000000
chr1,196711173,196717100,5927,-1,0,3075,1,16.87194196051970000000
chr1,196852281,196858334,6053,-1,0,10877,1,16.52073352056830000000
chr1,196772364,196774587,2223,-1,0,,0,0.00000000000000000000
chr1,196956263,196978168,21905,-1,0,81494,1,4.56516776991554000000
chr1,197229895,197233844,3949,-1,0,23418,1,25.32286654849330000000
chr1,197268845,197269748,903,-1,0,23418,1,110.74197120708700000000
chr1,197500348,197503554,3206,-1,0,163486,1,31.19151590767310000000
chr1,197720718,197722868,2150,-1,0,163486,1,46.51162790697670000000
chr1,197893915,197894454,539,-1,0,56956,1,185.52875695732800000000
chr1,197894023,197894310,287,-1,0,56956,1,348.43205574912900000000
chr1,197907936,197909866,1930,-1,0,,0,0.00000000000000000000
chr1,198003598,198007021,3423,-1,0,,0,0.00000000000000000000
chr1,198017207,198019184,1977,-1,0,,0,0.00000000000000000000
chr1,198304606,198310290,5684,-1,0,,0,0.00000000000000000000
chr1,198305141,198310680,5539,-1,0,,0,0.00000000000000000000
chr1,198461537,198462094,557,-1,0,,0,0.00000000000000000000
chr1,198461668,198462005,337,-1,0,,0,0.00000000000000000000
chr1,198461745,198461887,142,-1,0,,0,0.00000000000000000000
chr1,198773748,198775414,1666,-1,0,,0,0.00000000000000000000
chr1,198886120,198886813,693,-1,0,,0,0.00000000000000000000
chr1,198948599,198956635,8036,-1,0,,0,0.00000000000000000000
chr1,199110049,199113807,3758,-1,0,,0,0.00000000000000000000
chr1,199110954,199113410,2456,-1,0,,0,0.00000000000000000000
chr1,199111886,199114019,2133,-1,0,,0,0.00000000000000000000
chr1,199124821,199151595,26774,-1,0,,0,0.00000000000000000000
chr1,199438547,199440586,2039,-1,0,,0,0.00000000000000000000
chr1,199447590,199447776,186,-1,0,,0,0.00000000000000000000
chr1,199540895,199545842,4947,-1,0,,0,0.00000000000000000000
chr1,199564005,199566653,2648,-1,0,,0,0.00000000000000000000
chr1,199725911,199727183,1272,-1,0,,0,0.00000000000000000000
chr1,200063798,200064850,1052,-1,0,2494,1,95.05703422053230000000
chr1,200189929,200190695,766,-1,0,,0,0.00000000000000000000
chr1,200258953,200259145,192,-1,0,,0,0.00000000000000000000
chr1,200386642,200388621,1979,-1,0,,0,0.00000000000000000000
chr1,200652468,200655406,2938,-1,0,,0,0.00000000000000000000
chr1,200785900,200786070,170,-1,0,23271,1,588.23529411764700000000
chr1,201179032,201180072,1040,-1,0,91156,1,96.15384615384620000000
chr1,201218825,201222411,3586,-1,0,,0,0.00000000000000000000
chr1,201220095,201221813,1718,-1,0,,0,0.00000000000000000000
chr1,201226478,201226866,388,-1,0,,0,0.00000000000000000000
chr1,201276335,201281457,5122,-1,0,5317,1,19.52362358453730000000
chr1,201555932,201559249,3317,-1,0,,0,0.00000000000000000000
chr1,201659250,201659655,405,-1,0,89796,1,246.91358024691400000000
chr1,202001480,202001813,333,-1,0,,0,0.00000000000000000000
chr1,202295106,202297676,2570,-1,0,,0,0.00000000000000000000
chr1,202338461,202401031,62570,-1,0,4660,1,1.59821000479463000000
chr1,202360753,202361213,460,-1,0,4660,1,217.39130434782600000000
chr1,202423747,202530257,106510,-1,0,4660,1,0.93887897849967100000
chr1,202427251,202427546,295,-1,0,4660,1,338.98305084745800000000
chr1,203064263,203065195,932,-1,0,,0,0.00000000000000000000
chr1,203165467,203166831,1364,-1,0,,0,0.00000000000000000000
chr1,203342340,203342397,57,-1,0,,0,0.00000000000000000000
chr1,203543443,203549350,5907,-1,0,,0,0.00000000000000000000
chr1,203684263,203686359,2096,-1,0,493,1,47.70992366412210000000
chr1,203749617,203756134,6517,-1,0,,0,0.00000000000000000000
chr1,203786445,203787472,1027,-1,0,9877,1,97.37098344693280000000
chr1,203887550,203889881,2331,-1,0,,0,0.00000000000000000000
chr1,203894276,203895890,1614,-1,0,,0,0.00000000000000000000
chr1,203906782,203922060,15278,-1,0,,0,0.00000000000000000000
chr1,203935831,203945456,9625,-1,0,,0,0.00000000000000000000
chr1,204315383,204316856,1473,-1,0,22874,1,67.88866259334690000000
chr1,204381106,204386596,5490,-1,0,,0,0.00000000000000000000
chr1,204381829,204384640,2811,-1,0,,0,0.00000000000000000000
chr1,204440220,204440370,150,-1,0,5287,1,666.66666666666700000000
chr1,205106092,205108213,2121,-1,0,,0,0.00000000000000000000
chr1,205249976,205252318,2342,-1,0,,0,0.00000000000000000000
chr1,205251509,205252484,975,-1,0,,0,0.00000000000000000000
chr1,205439853,205440023,170,-1,0,,0,0.00000000000000000000
chr1,205616177,205617145,968,-1,0,,0,0.00000000000000000000
chr1,205651320,205651823,503,-1,0,,0,0.00000000000000000000
chr1,205853571,205853710,139,-1,0,,0,0.00000000000000000000
chr1,206199926,206205934,6008,-1,0,,0,0.00000000000000000000
chr1,206316086,206332140,16054,-1,0,1510,1,6.22897720194344000000
chr1,206286094,206292179,6085,-1,0,440712,1,16.43385373870170000000
chr1,206281067,206283096,2029,-1,0,440712,1,49.28536224741250000000
chr1,206792773,206793748,975,-1,0,,0,0.00000000000000000000
chr1,206814663,206815691,1028,-1,0,8444,1,97.27626459143970000000
chr1,206857702,206859174,1472,-1,0,9261,1,67.93478260869570000000
chr1,206955011,206955574,563,-1,0,,0,0.00000000000000000000
chr1,207040563,207045247,4684,-1,0,50604,1,21.34927412467980000000
chr1,207292465,207293516,1051,-1,0,722,1,95.14747859181730000000
chr1,207292404,207293149,745,-1,0,722,1,134.22818791946300000000
chr1,207322004,207347292,25288,-1,0,,0,0.00000000000000000000
chr1,207376017,207376575,558,-1,0,,0,0.00000000000000000000
chr1,207544564,207553545,8981,-1,0,,0,0.00000000000000000000
chr1,207541844,207545792,3948,-1,0,,0,0.00000000000000000000
chr1,207543302,207545425,2123,-1,0,,0,0.00000000000000000000
chr1,207698361,207874220,175859,-1,0,1378;1379,2,1.13727474852012000000
chr1,207699584,207737992,38408,-1,0,1378,1,2.60362424494897000000
chr1,207715319,207736855,21536,-1,0,1378,1,4.64338781575037000000
chr1,207841042,207845842,4800,-1,0,1379,1,20.83333333333330000000
chr1,207949987,207951799,1812,-1,0,4179,1,55.18763796909490000000
chr1,208019885,208020388,503,-1,0,,0,0.00000000000000000000
chr1,208643548,208643755,207,-1,0,,0,0.00000000000000000000
chr1,208778518,208794630,16112,-1,0,,0,0.00000000000000000000
chr1,209854805,209856744,1939,-1,0,,0,0.00000000000000000000
chr1,209935248,209936163,915,-1,0,80342,1,109.28961748633900000000
chr1,210076752,210090669,13917,-1,0,,0,0.00000000000000000000
chr1,210077864,210086001,8137,-1,0,,0,0.00000000000000000000
chr1,210081613,210083984,2371,-1,0,,0,0.00000000000000000000
chr1,210141640,210144773,3133,-1,0,255928,1,31.91828917970000000000
chr1,210261537,210262234,697,-1,0,255928,1,143.47202295552400000000
chr1,210284593,210289357,4764,-1,0,255928,1,20.99076406381190000000
chr1,210295288,210295722,434,-1,0,255928,1,230.41474654377900000000
chr1,210295329,210295656,327,-1,0,255928,1,305.81039755351700000000
chr1,210601364,210614340,12976,-1,0,55733,1,7.70653514180025000000
chr1,210638837,210640006,1169,-1,0,55733,1,85.54319931565440000000
chr1,210722503,210725993,3490,-1,0,55733,1,28.65329512893980000000
chr1,210722460,210724880,2420,-1,0,55733,1,41.32231404958680000000
chr1,210706474,210706898,424,-1,0,55733,1,235.84905660377400000000
chr1,210706591,210706692,101,-1,0,55733,1,990.09900990099000000000
chr1,211285073,211285352,279,-1,0,3756,1,358.42293906810000000000
chr1,211369256,211370440,1184,-1,0,,0,0.00000000000000000000
chr1,211655456,211656771,1315,-1,0,343035,1,76.04562737642590000000
chr1,211751180,211753141,1961,-1,0,7779,1,50.99439061703210000000
chr1,211965018,211965792,774,-1,0,9926,1,129.19896640826900000000
chr1,212384242,212386732,2490,-1,0,,0,0.00000000000000000000
chr1,212458325,212460102,1777,-1,0,5525,1,56.27462014631400000000
chr1,212470839,212472963,2124,-1,0,5525,1,47.08097928436910000000
chr1,212471135,212472616,1481,-1,0,5525,1,67.52194463200540000000
chr1,212700067,212703766,3699,-1,0,,0,0.00000000000000000000
chr1,213002169,213014035,11866,-1,0,149643,1,8.42743974380583000000
chr1,213002399,213009631,7232,-1,0,149643,1,13.82743362831860000000
chr1,213004811,213010363,5552,-1,0,149643,1,18.01152737752160000000
chr1,213039225,213039395,170,-1,0,28982,1,588.23529411764700000000
chr1,213083986,213086563,2577,-1,0,,0,0.00000000000000000000
chr1,213312535,213320224,7689,-1,0,26750,1,13.00559240473400000000
chr1,213440151,213441613,1462,-1,0,26750,1,68.39945280437760000000
chr1,213571708,213576334,4626,-1,0,,0,0.00000000000000000000
chr1,213616162,213617527,1365,-1,0,,0,0.00000000000000000000
chr1,213667164,213668344,1180,-1,0,,0,0.00000000000000000000
chr1,213751994,213755453,3459,-1,0,,0,0.00000000000000000000
chr1,213834023,213834077,54,-1,0,,0,0.00000000000000000000
chr1,213973680,213975099,1419,-1,0,,0,0.00000000000000000000
chr1,214770102,214770439,337,-1,0,,0,0.00000000000000000000
chr1,214778841,214782576,3735,-1,0,1063,1,26.77376171352080000000
chr1,214853316,214856880,3564,-1,0,,0,0.00000000000000000000
chr1,215004516,215010467,5951,-1,0,,0,0.00000000000000000000
chr1,215368609,215382172,13563,-1,0,3776,1,7.37300007373000000000
chr1,215451947,215530786,78839,-1,0,,0,0.00000000000000000000
chr1,215500102,215528849,28747,-1,0,,0,0.00000000000000000000
chr1,215492422,215501001,8579,-1,0,,0,0.00000000000000000000
chr1,215492236,215496397,4161,-1,0,,0,0.00000000000000000000
chr1,215857466,215867398,9932,-1,0,7399,1,10.06846556584780000000
chr1,215857571,215862339,4768,-1,0,7399,1,20.97315436241610000000
chr1,216085805,216085867,62,-1,0,7399,1,1612.90322580645000000000
chr1,216185310,216185558,248,-1,0,7399,1,403.22580645161300000000
chr1,216231481,216232003,522,-1,0,7399,1,191.57088122605400000000
chr1,216288541,216414758,126217,-1,0,7399,1,0.79228630057757700000
chr1,216373682,216377684,4002,-1,0,7399,1,24.98750624687660000000
chr1,216631182,216650533,19351,-1,0,,0,0.00000000000000000000
chr1,217269958,217270023,65,-1,0,2104,1,1538.46153846154000000000
chr1,217290099,217295630,5531,-1,0,2104,1,18.07991321641660000000
chr1,217404368,217404698,330,-1,0,,0,0.00000000000000000000
chr1,217457937,217458378,441,-1,0,,0,0.00000000000000000000
chr1,217497125,217497181,56,-1,0,,0,0.00000000000000000000
chr1,217542670,217543226,556,-1,0,,0,0.00000000000000000000
chr1,217695946,217697560,1614,-1,0,55105,1,61.95786864931850000000
chr1,217753949,217754506,557,-1,0,55105,1,179.53321364452400000000
chr1,217754074,217754391,317,-1,0,55105,1,315.45741324921100000000
chr1,217917510,217917824,314,-1,0,128153,1,318.47133757961800000000
chr1,218082662,218082897,235,-1,0,,0,0.00000000000000000000
chr1,218181600,218190352,8752,-1,0,,0,0.00000000000000000000
chr1,218182411,218188699,6288,-1,0,,0,0.00000000000000000000
chr1,218177827,218182225,4398,-1,0,,0,0.00000000000000000000
chr1,218245626,218246489,863,-1,0,,0,0.00000000000000000000
chr1,218417937,218421744,3807,-1,0,,0,0.00000000000000000000
chr1,218785897,218786273,376,-1,0,,0,0.00000000000000000000
chr1,219923202,219923774,572,-1,0,,0,0.00000000000000000000
chr1,219923308,219923626,318,-1,0,,0,0.00000000000000000000
chr1,220114641,220115165,524,-1,0,,0,0.00000000000000000000
chr1,220114712,220115091,379,-1,0,,0,0.00000000000000000000
chr1,220221426,220224304,2878,-1,0,,0,0.00000000000000000000
chr1,220225824,220226280,456,-1,0,,0,0.00000000000000000000
chr1,220225930,220226156,226,-1,0,,0,0.00000000000000000000
chr1,220226008,220226123,115,-1,0,,0,0.00000000000000000000
chr1,220230693,220245501,14808,-1,0,10380,1,6.75310642895732000000
chr1,220285339,220285860,521,-1,0,55699,1,191.93857965451100000000
chr1,220285453,220285773,320,-1,0,55699,1,312.50000000000000000000
chr1,220288637,220291371,2734,-1,0,55699,1,36.57644476956840000000
chr1,220291654,220293733,2079,-1,0,55699,1,48.10004810004810000000
chr1,220436373,220440885,4512,-1,0,25782,1,22.16312056737590000000
chr1,220484958,220503500,18542,-1,0,,0,0.00000000000000000000
chr1,220502888,220503586,698,-1,0,,0,0.00000000000000000000
chr1,220503081,220503574,493,-1,0,,0,0.00000000000000000000
chr1,220879678,220879729,51,-1,0,,0,0.00000000000000000000
chr1,221113785,221118699,4914,-1,0,,0,0.00000000000000000000
chr1,221325084,221326355,1271,-1,0,,0,0.00000000000000000000
chr1,221379116,221382508,3392,-1,0,,0,0.00000000000000000000
chr1,221672228,221674722,2494,-1,0,,0,0.00000000000000000000
chr1,221743889,221754440,10551,-1,0,,0,0.00000000000000000000
chr1,221744072,221749422,5350,-1,0,,0,0.00000000000000000000
chr1,221803907,221805874,1967,-1,0,,0,0.00000000000000000000
chr1,222034036,222034569,533,-1,0,,0,0.00000000000000000000
chr1,222034158,222034490,332,-1,0,,0,0.00000000000000000000
chr1,222373208,222381462,8254,-1,0,,0,0.00000000000000000000
chr1,222374158,222380582,6424,-1,0,,0,0.00000000000000000000
chr1,222374333,222378652,4319,-1,0,,0,0.00000000000000000000
chr1,222471220,222494258,23038,-1,0,,0,0.00000000000000000000
chr1,222479865,222481769,1904,-1,0,,0,0.00000000000000000000
chr1,222549826,222551260,1434,-1,0,,0,0.00000000000000000000
chr1,222550298,222551188,890,-1,0,,0,0.00000000000000000000
chr1,222893320,222894109,789,-1,0,148362,1,126.74271229404300000000
chr1,222941628,222942053,425,-1,0,,0,0.00000000000000000000
chr1,222984670,222985963,1293,-1,0,,0,0.00000000000000000000
chr1,223060785,223061194,409,-1,0,84976,1,244.49877750611200000000
chr1,223204561,223204989,428,-1,0,,0,0.00000000000000000000
chr1,223204699,223204778,79,-1,0,,0,0.00000000000000000000
chr1,223263055,223264849,1794,-1,0,,0,0.00000000000000000000
chr1,223823268,223824625,1357,-1,0,388743,1,73.69196757553430000000
chr1,223823152,223823668,516,-1,0,388743,1,193.79844961240300000000
chr1,223824118,223824482,364,-1,0,388743,1,274.72527472527500000000
chr1,224076179,224102439,26260,-1,0,,0,0.00000000000000000000
chr1,224199647,224203990,4343,-1,0,,0,0.00000000000000000000
chr1,224201703,224203622,1919,-1,0,,0,0.00000000000000000000
chr1,224245890,224248192,2302,-1,0,,0,0.00000000000000000000
chr1,224247009,224247652,643,-1,0,,0,0.00000000000000000000
chr1,224324262,224327254,2992,-1,0,23219,1,33.42245989304810000000
chr1,224661476,224662311,835,-1,0,149111,1,119.76047904191600000000
chr1,224392656,224393314,658,-1,0,,0,0.00000000000000000000
chr1,224464438,224464894,456,-1,0,4931,1,219.29824561403500000000
chr1,224392816,224393155,339,-1,0,,0,0.00000000000000000000
chr1,224756770,224757756,986,-1,0,149111,1,101.41987829614600000000
chr1,224815630,224818340,2710,-1,0,149111,1,36.90036900369000000000
chr1,224860237,224861277,1040,-1,0,149111,1,96.15384615384620000000
chr1,224938553,224938999,446,-1,0,,0,0.00000000000000000000
chr1,224938695,224938817,122,-1,0,,0,0.00000000000000000000
chr1,224993618,224996294,2676,-1,0,,0,0.00000000000000000000
chr1,225133631,225248662,115031,-1,0,127602,1,0.86933087602472400000
chr1,225256440,225256904,464,-1,0,127602,1,215.51724137931000000000
chr1,225256524,225256807,283,-1,0,127602,1,353.35689045936400000000
chr1,225344280,225344827,547,-1,0,127602,1,182.81535648994500000000
chr1,225344394,225344716,322,-1,0,127602,1,310.55900621118000000000
chr1,225673452,225673805,353,-1,0,,0,0.00000000000000000000
chr1,225762162,225762618,456,-1,0,55740,1,219.29824561403500000000
chr1,225762263,225762594,331,-1,0,55740,1,302.11480362537800000000
chr1,226002813,226003141,328,-1,0,2052,1,304.87804878048800000000
chr1,226006747,226007011,264,-1,0,2052,1,378.78787878787900000000
chr1,226192320,226193889,1569,-1,0,,0,0.00000000000000000000
chr1,226197156,226200565,3409,-1,0,,0,0.00000000000000000000
chr1,226612686,226612895,209,-1,0,,0,0.00000000000000000000
chr1,226985769,226986113,344,-1,0,,0,0.00000000000000000000
chr1,227118095,227146768,28673,-1,0,56997,1,3.48760157639591000000
chr1,227143249,227144910,1661,-1,0,56997,1,60.20469596628540000000
chr1,227165907,227166665,758,-1,0,56997,1,131.92612137203200000000
chr1,227166206,227166566,360,-1,0,56997,1,277.77777777777800000000
chr1,227263361,227266379,3018,-1,0,8476,1,33.13452617627570000000
chr1,227444951,227449317,4366,-1,0,8476,1,22.90426019239580000000
chr1,227482162,227482739,577,-1,0,8476,1,173.31022530329300000000
chr1,227482240,227482587,347,-1,0,8476,1,288.18443804034600000000
chr1,227776743,227779042,2299,-1,0,339500,1,43.49717268377560000000
chr1,227842494,227843007,513,-1,0,339500,1,194.93177387914200000000
chr1,228023988,228024532,544,-1,0,339501,1,183.82352941176500000000
chr1,228024099,228024421,322,-1,0,339501,1,310.55900621118000000000
chr1,228094223,228094694,471,-1,0,,0,0.00000000000000000000
chr1,228097416,228097722,306,-1,0,,0,0.00000000000000000000
chr1,228255275,228261200,5925,-1,0,,0,0.00000000000000000000
chr1,228255273,228257649,2376,-1,0,,0,0.00000000000000000000
chr1,228461874,228515453,53579,-1,0,84033,1,1.86640288172605000000
chr1,228328150,228370849,42699,-1,0,2987;57165;200205,3,7.02592566570646000000
chr1,228479611,228481065,1454,-1,0,84033,1,68.77579092159560000000
chr1,228572053,228572609,556,-1,0,,0,0.00000000000000000000
chr1,228431314,228431927,613,-1,0,84033,1,163.13213703099500000000
chr1,228361873,228362157,284,-1,0,200205,1,352.11267605633800000000
chr1,228572160,228572495,335,-1,0,,0,0.00000000000000000000
chr1,228725743,228783467,57724,-1,0,,0,0.00000000000000000000
chr1,228741006,228742214,1208,-1,0,,0,0.00000000000000000000
chr1,228814623,228815295,672,-1,0,,0,0.00000000000000000000
chr1,228814806,228815233,427,-1,0,,0,0.00000000000000000000
chr1,228824969,228826367,1398,-1,0,,0,0.00000000000000000000
chr1,229026694,229027716,1022,-1,0,,0,0.00000000000000000000
chr1,229120151,229120606,455,-1,0,,0,0.00000000000000000000
chr1,229373392,229373768,376,-1,0,,0,0.00000000000000000000
chr1,229411564,229413804,2240,-1,0,5867,1,44.64285714285710000000
chr1,229466856,229468150,1294,-1,0,126731,1,77.27975270479130000000
chr1,229530811,229532051,1240,-1,0,,0,0.00000000000000000000
chr1,229561438,229561539,101,-1,0,,0,0.00000000000000000000
chr1,229761387,229762105,718,-1,0,27097;9816,2,278.55153203342600000000
chr1,229810014,229822104,12090,-1,0,,0,0.00000000000000000000
chr1,229812483,229818550,6067,-1,0,,0,0.00000000000000000000
chr1,229815540,229820386,4846,-1,0,,0,0.00000000000000000000
chr1,229812492,229816332,3840,-1,0,,0,0.00000000000000000000
chr1,230131997,230134436,2439,-1,0,,0,0.00000000000000000000
chr1,230132738,230133976,1238,-1,0,,0,0.00000000000000000000
chr1,230105158,230105303,145,-1,0,,0,0.00000000000000000000
chr1,230428029,230428429,400,-1,0,,0,0.00000000000000000000
chr1,230531789,230532191,402,-1,0,79605,1,248.75621890547300000000
chr1,230580037,230589427,9390,-1,0,,0,0.00000000000000000000
chr1,230739504,230751532,12028,-1,0,,0,0.00000000000000000000
chr1,231181457,231181847,390,-1,0,,0,0.00000000000000000000
chr1,231181635,231181698,63,-1,0,,0,0.00000000000000000000
chr1,231182832,231183519,687,-1,0,,0,0.00000000000000000000
chr1,231302947,231303477,530,-1,0,440730,1,188.67924528301900000000
chr1,231303065,231303371,306,-1,0,440730,1,326.79738562091500000000
chr1,231319877,231321981,2104,-1,0,440730;149373,2,95.05703422053230000000
chr1,231346625,231346802,177,-1,0,440730,1,564.97175141242900000000
chr1,231535369,231546040,10671,-1,0,54583,1,9.37119295286290000000
chr1,231568414,231582593,14179,-1,0,,0,0.00000000000000000000
chr1,231980505,231981832,1327,-1,0,27185,1,75.35795026375280000000
chr1,232423035,232423583,548,-1,0,,0,0.00000000000000000000
chr1,232423137,232423479,342,-1,0,,0,0.00000000000000000000
chr1,232457844,232461635,3791,-1,0,,0,0.00000000000000000000
chr1,232458572,232460295,1723,-1,0,,0,0.00000000000000000000
chr1,232775507,232775873,366,-1,0,,0,0.00000000000000000000
chr1,232818535,232818908,373,-1,0,,0,0.00000000000000000000
chr1,232836574,232836759,185,-1,0,,0,0.00000000000000000000
chr1,232852269,232852883,614,-1,0,,0,0.00000000000000000000
chr1,232891038,232908012,16974,-1,0,,0,0.00000000000000000000
chr1,232892531,232899625,7094,-1,0,,0,0.00000000000000000000
chr1,232890253,232897159,6906,-1,0,,0,0.00000000000000000000
chr1,233710257,233748890,38633,-1,0,,0,0.00000000000000000000
chr1,233725100,233747534,22434,-1,0,,0,0.00000000000000000000
chr1,233865092,233865559,467,-1,0,,0,0.00000000000000000000
chr1,233865126,233865464,338,-1,0,,0,0.00000000000000000000
chr1,233961961,233964229,2268,-1,0,,0,0.00000000000000000000
chr1,233962115,233963557,1442,-1,0,,0,0.00000000000000000000
chr1,234142464,234143226,762,-1,0,148641,1,131.23359580052500000000
chr1,234158710,234170702,11992,-1,0,148641,1,8.33889259506337000000
chr1,234318644,234319749,1105,-1,0,148641,1,90.49773755656110000000
chr1,234318692,234319668,976,-1,0,148641,1,102.45901639344300000000
chr1,234319208,234319681,473,-1,0,148641,1,211.41649048625800000000
chr1,234570411,234571876,1465,-1,0,6894,1,68.25938566552900000000
chr1,234614066,234614836,770,-1,0,6894,1,129.87012987013000000000
chr1,234587162,234587566,404,-1,0,6894,1,247.52475247524800000000
chr1,234646584,234647746,1162,-1,0,,0,0.00000000000000000000
chr1,234702723,234709339,6616,-1,0,,0,0.00000000000000000000
chr1,234744325,234746738,2413,-1,0,359948,1,41.44218814753420000000
chr1,234798687,234799172,485,-1,0,,0,0.00000000000000000000
chr1,234912374,234956640,44266,-1,0,,0,0.00000000000000000000
chr1,234965261,234965894,633,-1,0,,0,0.00000000000000000000
chr1,234992630,235003806,11176,-1,0,,0,0.00000000000000000000
chr1,235119040,235120027,987,-1,0,,0,0.00000000000000000000
chr1,235243324,235246712,3388,-1,0,,0,0.00000000000000000000
chr1,235254620,235256607,1987,-1,0,,0,0.00000000000000000000
chr1,235254965,235256112,1147,-1,0,,0,0.00000000000000000000
chr1,235298399,235298583,184,-1,0,23029,1,543.47826086956500000000
chr1,235457755,235457912,157,-1,0,51742,1,636.94267515923600000000
chr1,235509776,235515555,5779,-1,0,,0,0.00000000000000000000
chr1,235537060,235538345,1285,-1,0,6905,1,77.82101167315180000000
chr1,235872731,235873255,524,-1,0,1130,1,190.83969465648900000000
chr1,236280622,236291217,10595,-1,0,,0,0.00000000000000000000
chr1,236548997,236551425,2428,-1,0,,0,0.00000000000000000000
chr1,236362888,236366067,3179,-1,0,7107,1,31.45643284051590000000
chr1,236476233,236478428,2195,-1,0,,0,0.00000000000000000000
chr1,236538684,236540885,2201,-1,0,,0,0.00000000000000000000
chr1,236701631,236703163,1532,-1,0,3964,1,65.27415143603130000000
chr1,236584236,236585158,922,-1,0,128178,1,108.45986984815600000000
chr1,236584118,236584880,762,-1,0,128178,1,131.23359580052500000000
chr1,236702272,236702993,721,-1,0,3964,1,138.69625520111000000000
chr1,236054467,236055038,571,-1,0,,0,0.00000000000000000000
chr1,236279278,236279831,553,-1,0,,0,0.00000000000000000000
chr1,236594912,236595271,359,-1,0,128178,1,278.55153203342600000000
chr1,236054574,236054913,339,-1,0,,0,0.00000000000000000000
chr1,236876939,236878352,1413,-1,0,88,1,70.77140835102620000000
chr1,236881381,236891208,9827,-1,0,88,1,10.17604558868420000000
chr1,236918791,236920715,1924,-1,0,88,1,51.97505197505200000000
chr1,237342429,237343573,1144,-1,0,6262,1,87.41258741258740000000
chr1,237633439,237634304,865,-1,0,6262,1,115.60693641618500000000
chr1,237741846,237742238,392,-1,0,6262,1,255.10204081632700000000
chr1,237741970,237742044,74,-1,0,6262,1,1351.35135135135000000000
chr1,237754052,237754900,848,-1,0,6262,1,117.92452830188700000000
chr1,237772409,237772566,157,-1,0,6262,1,636.94267515923600000000
chr1,238083500,238086133,2633,-1,0,,0,0.00000000000000000000
chr1,238316701,238318146,1445,-1,0,,0,0.00000000000000000000
chr1,238351652,238351793,141,-1,0,,0,0.00000000000000000000
chr1,238483783,238486640,2857,-1,0,,0,0.00000000000000000000
chr1,238527706,238530121,2415,-1,0,,0,0.00000000000000000000
chr1,238693431,238701201,7770,-1,0,,0,0.00000000000000000000
chr1,238750630,238752218,1588,-1,0,,0,0.00000000000000000000
chr1,238840119,238883317,43198,-1,0,,0,0.00000000000000000000
chr1,239071132,239082653,11521,-1,0,,0,0.00000000000000000000
chr1,238852266,238856086,3820,-1,0,,0,0.00000000000000000000
chr1,238854613,238856228,1615,-1,0,,0,0.00000000000000000000
chr1,238852131,238853532,1401,-1,0,,0,0.00000000000000000000
chr1,238852306,238853250,944,-1,0,,0,0.00000000000000000000
chr1,248048987,248835449,786462,-1,0,401993;127077;81466;127059;391194;127062;127069;127074;343563;127066;127068;391196;343172;391190;403244;391195;401992;343171;26245;254879;343173;127064;26246;403239;284521;391211;26696;391191;391192,29,3.68740002695617000000
chr1,248336219,248669969,333750,-1,0,401993;254879;391196;401992;127062;343173;391194;127064;127074;127066;26696;391195;26245,13,3.89513108614232000000
chr1,246340640,246505302,164662,-1,0,64754,1,0.60730466045596400000
chr1,248257952,248443362,185410,-1,0,127062;127059;284521;391194;391195;26245,6,3.23607140930910000000
chr1,248685254,248798551,113297,-1,0,127069;127077;343563;391211;127068,5,4.41317951931649000000
chr1,246221599,246356735,135136,-1,0,64754,1,0.73999526403031000000
chr1,243059363,243205447,146084,-1,0,,0,0.00000000000000000000
chr1,243045269,243156918,111649,-1,0,,0,0.00000000000000000000
chr1,246384497,246508892,124395,-1,0,64754,1,0.80389083162506500000
chr1,248127317,248222950,95633,-1,0,81466;284521;391191;26246,4,4.18265661434860000000
chr1,248733063,248813627,80564,-1,0,403244;127069;127077;403239;127068,5,6.20624596594012000000
chr1,248710184,248795842,85658,-1,0,127069;127068;127077;343563,4,4.66973312475192000000
chr1,246300688,246383653,82965,-1,0,64754,1,1.20532754776110000000
chr1,247187956,247269821,81865,-1,0,93474;79862,2,2.44304647895926000000
chr1,246373588,246447453,73865,-1,0,64754,1,1.35382116022473000000
chr1,248732813,248797091,64278,-1,0,127069;127068;127077,3,4.66722673387473000000
chr1,243029307,243086143,56836,-1,0,,0,0.00000000000000000000
chr1,248155821,248202473,46652,-1,0,284521;81466;26246,3,6.43059247191975000000
chr1,248756880,248797809,40929,-1,0,127069;127077,2,4.88651078697256000000
chr1,248747966,248775634,27668,-1,0,127069,1,3.61428364898077000000
chr1,245343355,245377484,34129,-1,0,55083,1,2.93005948020745000000
chr1,248757845,248789613,31768,-1,0,127077,1,3.14782170737849000000
chr1,248736995,248754791,17796,-1,0,127068,1,5.61924027871432000000
chr1,249177466,249196600,19134,-1,0,,0,0.00000000000000000000
chr1,248619943,248634983,15040,-1,0,,0,0.00000000000000000000
chr1,245627524,245648202,20678,-1,0,55083,1,4.83605764580714000000
chr1,241195379,241215466,20087,-1,0,6000,1,4.97834420271818000000
chr1,246368905,246388786,19881,-1,0,64754,1,5.02992807202857000000
chr1,247275001,247293200,18199,-1,0,7678;388759,2,10.98961481400080000000
chr1,242311678,242329817,18139,-1,0,200150,1,5.51298307514196000000
chr1,248863716,248875467,11751,-1,0,,0,0.00000000000000000000
chr1,241732667,241744833,12166,-1,0,8564,1,8.21962847279303000000
chr1,241355327,241370996,15669,-1,0,6000,1,6.38202820856468000000
chr1,245636795,245648150,11355,-1,0,55083,1,8.80669308674593000000
chr1,243069873,243082121,12248,-1,0,,0,0.00000000000000000000
chr1,242058867,242069470,10603,-1,0,,0,0.00000000000000000000
chr1,243120356,243130355,9999,-1,0,,0,0.00000000000000000000
chr1,248867047,248876854,9807,-1,0,,0,0.00000000000000000000
chr1,248692687,248700761,8074,-1,0,,0,0.00000000000000000000
chr1,247849438,247858622,9184,-1,0,,0,0.00000000000000000000
chr1,247339400,247348976,9576,-1,0,,0,0.00000000000000000000
chr1,248622713,248629862,7149,-1,0,,0,0.00000000000000000000
chr1,246585703,246594569,8866,-1,0,64754,1,11.27904353710810000000
chr1,248673987,248682583,8596,-1,0,,0,0.00000000000000000000
chr1,247384443,247390967,6524,-1,0,,0,0.00000000000000000000
chr1,246029182,246037391,8209,-1,0,64754,1,12.18175173589960000000
chr1,244893659,244899988,6329,-1,0,,0,0.00000000000000000000
chr1,246393573,246400716,7143,-1,0,64754,1,13.99972000559990000000
chr1,248051265,248057839,6574,-1,0,,0,0.00000000000000000000
chr1,240219317,240225042,5725,-1,0,,0,0.00000000000000000000
chr1,245172997,245177917,4920,-1,0,84288,1,20.32520325203250000000
chr1,247296799,247301839,5040,-1,0,7678,1,19.84126984126980000000
chr1,245438490,245443495,5005,-1,0,55083,1,19.98001998002000000000
chr1,239659074,239663687,4613,-1,0,1131,1,21.67786689789720000000
chr1,241518946,241521606,2660,-1,0,6000,1,37.59398496240600000000
chr1,248605895,248610253,4358,-1,0,,0,0.00000000000000000000
chr1,248869953,248874273,4320,-1,0,,0,0.00000000000000000000
chr1,246682858,246686957,4099,-1,0,,0,0.00000000000000000000
chr1,249089526,249093391,3865,-1,0,,0,0.00000000000000000000
chr1,246187237,246190941,3704,-1,0,64754,1,26.99784017278620000000
chr1,243127416,243130079,2663,-1,0,,0,0.00000000000000000000
chr1,247279208,247282393,3185,-1,0,,0,0.00000000000000000000
chr1,246137862,246140404,2542,-1,0,64754,1,39.33910306845000000000
chr1,240392995,240394784,1789,-1,0,56776,1,55.89714924538850000000
chr1,246739474,246741936,2462,-1,0,163882,1,40.61738424045490000000
chr1,246682920,246685429,2509,-1,0,,0,0.00000000000000000000
chr1,242185410,242188152,2742,-1,0,,0,0.00000000000000000000
chr1,245359658,245361811,2153,-1,0,55083,1,46.44681839294010000000
chr1,246846467,246848779,2312,-1,0,,0,0.00000000000000000000
chr1,244619007,244621772,2765,-1,0,,0,0.00000000000000000000
chr1,248755655,248758478,2823,-1,0,127069,1,35.42330853701740000000
chr1,241593937,241596428,2491,-1,0,,0,0.00000000000000000000
chr1,243127673,243129253,1580,-1,0,,0,0.00000000000000000000
chr1,248546271,248548246,1975,-1,0,,0,0.00000000000000000000
chr1,248595017,248597372,2355,-1,0,,0,0.00000000000000000000
chr1,245217536,245219702,2166,-1,0,84288,1,46.16805170821790000000
chr1,242122481,242124666,2185,-1,0,,0,0.00000000000000000000
chr1,247231006,247232769,1763,-1,0,93474,1,56.72149744753260000000
chr1,248351005,248352104,1099,-1,0,,0,0.00000000000000000000
chr1,247186228,247187153,925,-1,0,,0,0.00000000000000000000
chr1,243782624,243783954,1330,-1,0,10000,1,75.18796992481200000000
chr1,240393550,240394773,1223,-1,0,56776,1,81.76614881439080000000
chr1,248571181,248572631,1450,-1,0,,0,0.00000000000000000000
chr1,246155051,246156433,1382,-1,0,64754,1,72.35890014471780000000
chr1,248839453,248841008,1555,-1,0,,0,0.00000000000000000000
chr1,247292191,247293300,1109,-1,0,7678,1,90.17132551848510000000
chr1,246647356,246648633,1277,-1,0,64754,1,78.30853563038370000000
chr1,247653747,247655206,1459,-1,0,441932,1,68.54009595613430000000
chr1,247596412,247597712,1300,-1,0,114548,1,76.92307692307690000000
chr1,248154513,248155589,1076,-1,0,284521,1,92.93680297397770000000
chr1,246139095,246140220,1125,-1,0,64754,1,88.88888888888890000000
chr1,246558592,246559520,928,-1,0,64754,1,107.75862068965500000000
chr1,246035330,246036181,851,-1,0,64754,1,117.50881316098700000000
chr1,244679912,244681246,1334,-1,0,257044,1,74.96251874062970000000
chr1,245768433,245769771,1338,-1,0,55083,1,74.73841554559040000000
chr1,245055089,245056339,1250,-1,0,,0,0.00000000000000000000
chr1,243094525,243095715,1190,-1,0,,0,0.00000000000000000000
chr1,244985056,244986271,1215,-1,0,,0,0.00000000000000000000
chr1,241096243,241097344,1101,-1,0,6000,1,90.82652134423250000000
chr1,248546597,248547808,1211,-1,0,,0,0.00000000000000000000
chr1,246414531,246415609,1078,-1,0,64754,1,92.76437847866420000000
chr1,240393940,240395143,1203,-1,0,56776,1,83.12551953449710000000
chr1,249089597,249090744,1147,-1,0,,0,0.00000000000000000000
chr1,247494711,247495773,1062,-1,0,84838,1,94.16195856873820000000
chr1,243636964,243637628,664,-1,0,10806,1,150.60240963855400000000
chr1,240557208,240558173,965,-1,0,56776,1,103.62694300518100000000
chr1,246235024,246235744,720,-1,0,64754,1,138.88888888888900000000
chr1,243836801,243837744,943,-1,0,10000,1,106.04453870625700000000
chr1,241360376,241361068,692,-1,0,6000,1,144.50867052023100000000
chr1,248351490,248352058,568,-1,0,,0,0.00000000000000000000
chr1,245777968,245778534,566,-1,0,55083,1,176.67844522968200000000
chr1,243782865,243783678,813,-1,0,10000,1,123.00123001230000000000
chr1,241853700,241854394,694,-1,0,128025,1,144.09221902017300000000
chr1,241186100,241186686,586,-1,0,6000,1,170.64846416382300000000
chr1,240699743,240700211,468,-1,0,64388,1,213.67521367521400000000
chr1,247103858,247104526,668,-1,0,,0,0.00000000000000000000
chr1,245266258,245267003,745,-1,0,84288,1,134.22818791946300000000
chr1,247621516,247622188,672,-1,0,,0,0.00000000000000000000
chr1,247596804,247597419,615,-1,0,114548,1,162.60162601626000000000
chr1,246702956,246703587,631,-1,0,,0,0.00000000000000000000
chr1,239895596,239896009,413,-1,0,1131,1,242.13075060532700000000
chr1,248207634,248208330,696,-1,0,284521,1,143.67816091954000000000
chr1,248154602,248155315,713,-1,0,284521,1,140.25245441795200000000
chr1,241149737,241150338,601,-1,0,6000,1,166.38935108153100000000
chr1,240616887,240617425,538,-1,0,56776,1,185.87360594795500000000
chr1,248327651,248328277,626,-1,0,,0,0.00000000000000000000
chr1,247027815,247028293,478,-1,0,25909,1,209.20502092050200000000
chr1,240838647,240839259,612,-1,0,,0,0.00000000000000000000
chr1,246558772,246559253,481,-1,0,64754,1,207.90020790020800000000
chr1,246035486,246035963,477,-1,0,64754,1,209.64360587002100000000
chr1,248546166,248546656,490,-1,0,,0,0.00000000000000000000
chr1,240641198,240641602,404,-1,0,,0,0.00000000000000000000
chr1,247925408,247926023,615,-1,0,,0,0.00000000000000000000
chr1,247292271,247292859,588,-1,0,7678,1,170.06802721088400000000
chr1,246155830,246156263,433,-1,0,64754,1,230.94688221709000000000
chr1,247490866,247491320,454,-1,0,84838,1,220.26431718061700000000
chr1,243660648,243661221,573,-1,0,10806;10000,2,349.04013961605600000000
chr1,244287342,244287946,604,-1,0,,0,0.00000000000000000000
chr1,240122815,240123256,441,-1,0,,0,0.00000000000000000000
chr1,245002390,245002801,411,-1,0,116228,1,243.30900243309000000000
chr1,246125820,246126291,471,-1,0,64754,1,212.31422505307900000000
chr1,245433376,245433830,454,-1,0,55083,1,220.26431718061700000000
chr1,240756232,240756751,519,-1,0,64388,1,192.67822736030800000000
chr1,240122514,240122934,420,-1,0,,0,0.00000000000000000000
chr1,246439188,246439682,494,-1,0,64754,1,202.42914979757100000000
chr1,245077387,245077812,425,-1,0,,0,0.00000000000000000000
chr1,246155131,246155552,421,-1,0,64754,1,237.52969121140100000000
chr1,246972730,246973143,413,-1,0,,0,0.00000000000000000000
chr1,240302398,240302827,429,-1,0,56776,1,233.10023310023300000000
chr1,247569528,247569894,366,-1,0,,0,0.00000000000000000000
chr1,246969778,246970124,346,-1,0,,0,0.00000000000000000000
chr1,244746077,244746462,385,-1,0,257044,1,259.74025974026000000000
chr1,247984835,247985241,406,-1,0,,0,0.00000000000000000000
chr1,245778087,245778429,342,-1,0,55083,1,292.39766081871300000000
chr1,241691688,241692052,364,-1,0,,0,0.00000000000000000000
chr1,240528337,240528738,401,-1,0,56776,1,249.37655860349100000000
chr1,243425352,243425649,297,-1,0,10806,1,336.70033670033700000000
chr1,241360530,241360874,344,-1,0,6000,1,290.69767441860500000000
chr1,241586224,241586488,264,-1,0,,0,0.00000000000000000000
chr1,244439105,244439428,323,-1,0,,0,0.00000000000000000000
chr1,248207825,248208161,336,-1,0,284521,1,297.61904761904800000000
chr1,241149860,241150195,335,-1,0,6000,1,298.50746268656700000000
chr1,240616984,240617319,335,-1,0,56776,1,298.50746268656700000000
chr1,248849860,248850138,278,-1,0,,0,0.00000000000000000000
chr1,248866146,248866455,309,-1,0,,0,0.00000000000000000000
chr1,247027878,247028188,310,-1,0,25909,1,322.58064516129000000000
chr1,246125964,246126155,191,-1,0,64754,1,523.56020942408400000000
chr1,247621726,247621989,263,-1,0,,0,0.00000000000000000000
chr1,246877788,246878022,234,-1,0,,0,0.00000000000000000000
chr1,247597038,247597254,216,-1,0,114548,1,462.96296296296300000000
chr1,245433446,245433657,211,-1,0,55083,1,473.93364928910000000000
chr1,247536758,247536953,195,-1,0,,0,0.00000000000000000000
chr1,240528415,240528535,120,-1,0,56776,1,833.33333333333300000000
chr1,240302554,240302669,115,-1,0,56776,1,869.56521739130400000000
chr1,246558924,246559035,111,-1,0,64754,1,900.90090090090100000000
chr1,246928424,246928556,132,-1,0,51097,1,757.57575757575800000000
chr1,246167281,246167378,97,-1,0,64754,1,1030.92783505155000000000
chr1,245433551,245433649,98,-1,0,55083,1,1020.40816326531000000000
chr1,246969894,246969986,92,-1,0,,0,0.00000000000000000000
chr1,246035672,246035757,85,-1,0,64754,1,1176.47058823529000000000
chr1,242860265,242860346,81,-1,0,,0,0.00000000000000000000
chr1,240122688,240122756,68,-1,0,,0,0.00000000000000000000
chr1,242307463,242307538,75,-1,0,200150,1,1333.33333333333000000000
chr1,246657114,246657179,65,-1,0,64754,1,1538.46153846154000000000
chr1,245859104,245859168,64,-1,0,55083,1,1562.50000000000000000000
chr1,246558914,246558970,56,-1,0,64754,1,1785.71428571429000000000
chr1,244746233,244746286,53,-1,0,257044,1,1886.79245283019000000000
chr10,131300,143389,12089,-1,0,,0,0.00000000000000000000
chr10,119431,120726,1295,-1,0,,0,0.00000000000000000000
chr10,171831,174623,2792,-1,0,,0,0.00000000000000000000
chr10,367482,369429,1947,-1,0,22982,1,51.36106831022090000000
chr10,413874,414166,292,-1,0,22982,1,342.46575342465800000000
chr10,446487,450099,3612,-1,0,22982,1,27.68549280177190000000
chr10,463092,464611,1519,-1,0,22982,1,65.83278472679390000000
chr10,463610,464252,642,-1,0,22982,1,155.76323987538900000000
chr10,463442,463988,546,-1,0,22982,1,183.15018315018300000000
chr10,493067,495106,2039,-1,0,22982,1,49.04364884747430000000
chr10,490029,490512,483,-1,0,22982,1,207.03933747412000000000
chr10,500288,500799,511,-1,0,22982,1,195.69471624266100000000
chr10,501228,502278,1050,-1,0,22982,1,95.23809523809520000000
chr10,575997,640302,64305,-1,0,22982,1,1.55508902884690000000
chr10,997711,1023128,25417,-1,0,,0,0.00000000000000000000
chr10,960919,972298,11379,-1,0,23185,1,8.78811846383689000000
chr10,1064152,1077227,13075,-1,0,91734,1,7.64818355640535000000
chr10,824048,826808,2760,-1,0,,0,0.00000000000000000000
chr10,1092237,1094677,2440,-1,0,3422,1,40.98360655737710000000
chr10,781700,784331,2631,-1,0,,0,0.00000000000000000000
chr10,693541,695313,1772,-1,0,22982,1,56.43340857787810000000
chr10,723901,725600,1699,-1,0,22982,1,58.85815185403180000000
chr10,1234926,1236334,1408,-1,0,105,1,71.02272727272730000000
chr10,1281409,1282392,983,-1,0,105,1,101.72939979654100000000
chr10,774700,775235,535,-1,0,,0,0.00000000000000000000
chr10,669352,669830,478,-1,0,22982,1,209.20502092050200000000
chr10,829748,830460,712,-1,0,,0,0.00000000000000000000
chr10,703053,703744,691,-1,0,22982,1,144.71780028943600000000
chr10,839654,840250,596,-1,0,,0,0.00000000000000000000
chr10,763692,764352,660,-1,0,,0,0.00000000000000000000
chr10,824143,824617,474,-1,0,,0,0.00000000000000000000
chr10,1061178,1061686,508,-1,0,23560,1,196.85039370078700000000
chr10,1000624,1001162,538,-1,0,,0,0.00000000000000000000
chr10,769292,769553,261,-1,0,,0,0.00000000000000000000
chr10,823590,823813,223,-1,0,,0,0.00000000000000000000
chr10,824277,824493,216,-1,0,,0,0.00000000000000000000
chr10,763950,764163,213,-1,0,,0,0.00000000000000000000
chr10,1021935,1022098,163,-1,0,,0,0.00000000000000000000
chr10,769706,769862,156,-1,0,,0,0.00000000000000000000
chr10,1368952,1369904,952,-1,0,105,1,105.04201680672300000000
chr10,1369294,1369726,432,-1,0,105,1,231.48148148148100000000
chr10,1369038,1369146,108,-1,0,105,1,925.92592592592600000000
chr10,1410313,1410451,138,-1,0,105,1,724.63768115942000000000
chr10,1417983,1418192,209,-1,0,105,1,478.46889952153100000000
chr10,1439070,1453689,14619,-1,0,105,1,6.84041316095492000000
chr10,1451524,1452771,1247,-1,0,105,1,80.19246190858060000000
chr10,1451788,1452459,671,-1,0,105,1,149.03129657228000000000
chr10,1451853,1452298,445,-1,0,105,1,224.71910112359600000000
chr10,1452031,1452292,261,-1,0,105,1,383.14176245210700000000
chr10,1501966,1503104,1138,-1,0,105,1,87.87346221441120000000
chr10,1506837,1506903,66,-1,0,105,1,1515.15151515152000000000
chr10,1537791,1537907,116,-1,0,105,1,862.06896551724100000000
chr10,1556763,1557200,437,-1,0,105,1,228.83295194508000000000
chr10,1582693,1585116,2423,-1,0,105,1,41.27115146512590000000
chr10,1582712,1582815,103,-1,0,105,1,970.87378640776700000000
chr10,1600373,1601201,828,-1,0,105,1,120.77294685990300000000
chr10,1602413,1602994,581,-1,0,105,1,172.11703958691900000000
chr10,1602529,1602888,359,-1,0,105,1,278.55153203342600000000
chr10,1631066,1638961,7895,-1,0,105,1,12.66624445851810000000
chr10,1633931,1636079,2148,-1,0,105,1,46.55493482309120000000
chr10,1634533,1635352,819,-1,0,105,1,122.10012210012200000000
chr10,1634587,1634881,294,-1,0,105,1,340.13605442176900000000
chr10,1701824,1702323,499,-1,0,105,1,200.40080160320600000000
chr10,1741461,1744090,2629,-1,0,105,1,38.03727653100040000000
chr10,1743318,1743935,617,-1,0,105,1,162.07455429497600000000
chr10,1792304,1792848,544,-1,0,,0,0.00000000000000000000
chr10,1792378,1792665,287,-1,0,,0,0.00000000000000000000
chr10,1842539,1842845,306,-1,0,,0,0.00000000000000000000
chr10,1842503,1842711,208,-1,0,,0,0.00000000000000000000
chr10,1866169,1872446,6277,-1,0,,0,0.00000000000000000000
chr10,1883939,1910174,26235,-1,0,,0,0.00000000000000000000
chr10,1891414,1900428,9014,-1,0,,0,0.00000000000000000000
chr10,1910035,1910246,211,-1,0,,0,0.00000000000000000000
chr10,2013589,2014070,481,-1,0,,0,0.00000000000000000000
chr10,2013697,2013938,241,-1,0,,0,0.00000000000000000000
chr10,2013786,2013870,84,-1,0,,0,0.00000000000000000000
chr10,2035110,2036838,1728,-1,0,,0,0.00000000000000000000
chr10,2090958,2091262,304,-1,0,,0,0.00000000000000000000
chr10,2359532,2359948,416,-1,0,,0,0.00000000000000000000
chr10,2332935,2333296,361,-1,0,,0,0.00000000000000000000
chr10,2274555,2274621,66,-1,0,,0,0.00000000000000000000
chr10,2379361,2379910,549,-1,0,,0,0.00000000000000000000
chr10,2379470,2379797,327,-1,0,,0,0.00000000000000000000
chr10,2538237,2539399,1162,-1,0,,0,0.00000000000000000000
chr10,2519533,2520021,488,-1,0,,0,0.00000000000000000000
chr10,2434481,2434806,325,-1,0,,0,0.00000000000000000000
chr10,2543339,2544191,852,-1,0,,0,0.00000000000000000000
chr10,2543600,2544072,472,-1,0,,0,0.00000000000000000000
chr10,2543504,2543743,239,-1,0,,0,0.00000000000000000000
chr10,2563011,2565974,2963,-1,0,,0,0.00000000000000000000
chr10,2600715,2604471,3756,-1,0,,0,0.00000000000000000000
chr10,2622311,2624043,1732,-1,0,,0,0.00000000000000000000
chr10,2711961,2712010,49,-1,0,,0,0.00000000000000000000
chr10,2812440,3748579,936139,-1,0,10531;5214,2,0.21364348670443200000
chr10,3305686,3310748,5062,-1,0,,0,0.00000000000000000000
chr10,2860732,2865253,4521,-1,0,,0,0.00000000000000000000
chr10,3627327,3631375,4048,-1,0,,0,0.00000000000000000000
chr10,2874417,2878363,3946,-1,0,,0,0.00000000000000000000
chr10,3163307,3166329,3022,-1,0,5214,1,33.09066843150230000000
chr10,3573631,3575747,2116,-1,0,,0,0.00000000000000000000
chr10,2932779,2934429,1650,-1,0,,0,0.00000000000000000000
chr10,3226701,3228333,1632,-1,0,,0,0.00000000000000000000
chr10,3114717,3116364,1647,-1,0,5214,1,60.71645415907710000000
chr10,3574222,3575397,1175,-1,0,,0,0.00000000000000000000
chr10,3127080,3127940,860,-1,0,5214,1,116.27906976744200000000
chr10,3721313,3721844,531,-1,0,,0,0.00000000000000000000
chr10,3103106,3103706,600,-1,0,,0,0.00000000000000000000
chr10,3257953,3258437,484,-1,0,,0,0.00000000000000000000
chr10,3448962,3449465,503,-1,0,,0,0.00000000000000000000
chr10,3095638,3096060,422,-1,0,,0,0.00000000000000000000
chr10,3127077,3127576,499,-1,0,5214,1,200.40080160320600000000
chr10,3157362,3157782,420,-1,0,5214,1,238.09523809523800000000
chr10,3258040,3258374,334,-1,0,,0,0.00000000000000000000
chr10,3148316,3148607,291,-1,0,5214,1,343.64261168384900000000
chr10,3144155,3144466,311,-1,0,5214,1,321.54340836012900000000
chr10,3095720,3095978,258,-1,0,,0,0.00000000000000000000
chr10,3095667,3095886,219,-1,0,,0,0.00000000000000000000
chr10,3210616,3210815,199,-1,0,10531,1,502.51256281407000000000
chr10,3500450,3500575,125,-1,0,,0,0.00000000000000000000
chr10,3148446,3148565,119,-1,0,5214,1,840.33613445378100000000
chr10,3090730,3090816,86,-1,0,,0,0.00000000000000000000
chr10,3090787,3090872,85,-1,0,,0,0.00000000000000000000
chr10,3258219,3258293,74,-1,0,,0,0.00000000000000000000
chr10,3721553,3721612,59,-1,0,,0,0.00000000000000000000
chr10,3449261,3449312,51,-1,0,,0,0.00000000000000000000
chr10,3946635,3949125,2490,-1,0,,0,0.00000000000000000000
chr10,4018332,4018793,461,-1,0,,0,0.00000000000000000000
chr10,4293462,4312063,18601,-1,0,,0,0.00000000000000000000
chr10,4290057,4291690,1633,-1,0,,0,0.00000000000000000000
chr10,4437585,4441469,3884,-1,0,,0,0.00000000000000000000
chr10,4483757,4484211,454,-1,0,,0,0.00000000000000000000
chr10,4548375,4612179,63804,-1,0,,0,0.00000000000000000000
chr10,4634680,4635230,550,-1,0,,0,0.00000000000000000000
chr10,4634811,4635130,319,-1,0,,0,0.00000000000000000000
chr10,4636544,4637167,623,-1,0,,0,0.00000000000000000000
chr10,4649573,4649623,50,-1,0,,0,0.00000000000000000000
chr10,4687045,4687655,610,-1,0,,0,0.00000000000000000000
chr10,4704241,4710481,6240,-1,0,,0,0.00000000000000000000
chr10,4708522,4710520,1998,-1,0,,0,0.00000000000000000000
chr10,4721440,4724157,2717,-1,0,,0,0.00000000000000000000
chr10,4857721,4858278,557,-1,0,,0,0.00000000000000000000
chr10,4869508,4869695,187,-1,0,83592,1,534.75935828877000000000
chr10,4935022,5244733,309711,-1,0,1645;1646;8644;1109,4,1.29152661674916000000
chr10,5143422,5326389,182967,-1,0,8644;1109,2,1.09309329004684000000
chr10,5286869,5293529,6660,-1,0,,0,0.00000000000000000000
chr10,5249899,5251055,1156,-1,0,1109,1,86.50519031141870000000
chr10,5108631,5109142,511,-1,0,8644,1,195.69471624266100000000
chr10,5465397,5466835,1438,-1,0,10276,1,69.54102920723230000000
chr10,5523003,5523089,86,-1,0,,0,0.00000000000000000000
chr10,5602324,5604507,2183,-1,0,,0,0.00000000000000000000
chr10,5644125,5644255,130,-1,0,,0,0.00000000000000000000
chr10,5813926,5814687,761,-1,0,2665,1,131.40604467805500000000
chr10,5889123,5893036,3913,-1,0,,0,0.00000000000000000000
chr10,5890563,5892678,2115,-1,0,,0,0.00000000000000000000
chr10,5891457,5892373,916,-1,0,,0,0.00000000000000000000
chr10,5903755,5906706,2951,-1,0,54522,1,33.88681802778720000000
chr10,5914715,5916020,1305,-1,0,54522,1,76.62835249042150000000
chr10,6064610,6064997,387,-1,0,3559,1,258.39793281653700000000
chr10,6064771,6064837,66,-1,0,3559,1,1515.15151515152000000000
chr10,6097368,6097891,523,-1,0,3559,1,191.20458891013400000000
chr10,6169245,6169835,590,-1,0,,0,0.00000000000000000000
chr10,6169324,6169761,437,-1,0,,0,0.00000000000000000000
chr10,6169496,6169683,187,-1,0,,0,0.00000000000000000000
chr10,6251721,6252941,1220,-1,0,5209,1,81.96721311475410000000
chr10,6251890,6252974,1084,-1,0,5209,1,92.25092250922510000000
chr10,6252482,6252899,417,-1,0,5209,1,239.80815347721800000000
chr10,6252594,6252796,202,-1,0,5209,1,495.04950495049500000000
chr10,6411402,6417770,6368,-1,0,,0,0.00000000000000000000
chr10,6639109,6641576,2467,-1,0,,0,0.00000000000000000000
chr10,6647872,6648834,962,-1,0,,0,0.00000000000000000000
chr10,6653852,6664222,10370,-1,0,,0,0.00000000000000000000
chr10,6661023,6663926,2903,-1,0,,0,0.00000000000000000000
chr10,6875657,6880929,5272,-1,0,,0,0.00000000000000000000
chr10,6894491,6895931,1440,-1,0,,0,0.00000000000000000000
chr10,6876952,6877579,627,-1,0,,0,0.00000000000000000000
chr10,6976166,6987645,11479,-1,0,,0,0.00000000000000000000
chr10,7077040,7078302,1262,-1,0,,0,0.00000000000000000000
chr10,7420115,7420522,407,-1,0,57713,1,245.70024570024600000000
chr10,7558741,7559705,964,-1,0,,0,0.00000000000000000000
chr10,7670705,7671158,453,-1,0,80760,1,220.75055187638000000000
chr10,7716097,7717476,1379,-1,0,,0,0.00000000000000000000
chr10,7708926,7709615,689,-1,0,80760,1,145.13788098693800000000
chr10,7793693,7794193,500,-1,0,22944,1,200.00000000000000000000
chr10,7793813,7794055,242,-1,0,22944,1,413.22314049586800000000
chr10,7995820,7997078,1258,-1,0,83860,1,79.49125596184420000000
chr10,7995891,7996330,439,-1,0,83860,1,227.79043280182200000000
chr10,8065908,8067318,1410,-1,0,,0,0.00000000000000000000
chr10,8604762,8604838,76,-1,0,,0,0.00000000000000000000
chr10,8781977,8782307,330,-1,0,,0,0.00000000000000000000
chr10,8788943,8792220,3277,-1,0,,0,0.00000000000000000000
chr10,8936460,8943408,6948,-1,0,,0,0.00000000000000000000
chr10,9083082,9083491,409,-1,0,,0,0.00000000000000000000
chr10,9097737,9097798,61,-1,0,,0,0.00000000000000000000
chr10,9228063,9231258,3195,-1,0,,0,0.00000000000000000000
chr10,9469451,9593789,124338,-1,0,,0,0.00000000000000000000
chr10,9631342,9632381,1039,-1,0,,0,0.00000000000000000000
chr10,9437928,9438623,695,-1,0,,0,0.00000000000000000000
chr10,9519747,9520222,475,-1,0,,0,0.00000000000000000000
chr10,9519828,9520134,306,-1,0,,0,0.00000000000000000000
chr10,9438183,9438386,203,-1,0,,0,0.00000000000000000000
chr10,9438264,9438376,112,-1,0,,0,0.00000000000000000000
chr10,9436189,9436251,62,-1,0,,0,0.00000000000000000000
chr10,10307873,10308486,613,-1,0,,0,0.00000000000000000000
chr10,10308745,10309177,432,-1,0,,0,0.00000000000000000000
chr10,10428341,10432913,4572,-1,0,,0,0.00000000000000000000
chr10,10493315,10493825,510,-1,0,,0,0.00000000000000000000
chr10,10493408,10493731,323,-1,0,,0,0.00000000000000000000
chr10,10656056,10661019,4963,-1,0,10659,1,20.14910336490030000000
chr10,10708420,10708956,536,-1,0,10659,1,186.56716417910400000000
chr10,10708526,10708849,323,-1,0,10659,1,309.59752321981400000000
chr10,10809757,10810001,244,-1,0,10659,1,409.83606557377000000000
chr10,10980943,10981246,303,-1,0,10659,1,330.03300330033000000000
chr10,10981112,10981290,178,-1,0,10659,1,561.79775280898900000000
chr10,11104352,11110992,6640,-1,0,10659,1,15.06024096385540000000
chr10,11374410,11374803,393,-1,0,10659,1,254.45292620865100000000
chr10,11407506,11409060,1554,-1,0,,0,0.00000000000000000000
chr10,11408825,11408984,159,-1,0,,0,0.00000000000000000000
chr10,11419376,11423681,4305,-1,0,,0,0.00000000000000000000
chr10,11484965,11485147,182,-1,0,,0,0.00000000000000000000
chr10,11520385,11522468,2083,-1,0,9712,1,48.00768122899660000000
chr10,11945430,11945770,340,-1,0,,0,0.00000000000000000000
chr10,11956467,11959538,3071,-1,0,,0,0.00000000000000000000
chr10,11957187,11957923,736,-1,0,,0,0.00000000000000000000
chr10,12158541,12164560,6019,-1,0,55526,1,16.61405549094530000000
chr10,12336925,12346734,9809,-1,0,,0,0.00000000000000000000
chr10,12318304,12323198,4894,-1,0,,0,0.00000000000000000000
chr10,12365466,12368984,3518,-1,0,,0,0.00000000000000000000
chr10,12296117,12297632,1515,-1,0,,0,0.00000000000000000000
chr10,12528325,12533797,5472,-1,0,57118,1,18.27485380116960000000
chr10,12559879,12563157,3278,-1,0,57118,1,30.50640634533250000000
chr10,12556289,12558944,2655,-1,0,57118,1,37.66478342749530000000
chr10,12596187,12596574,387,-1,0,57118,1,258.39793281653700000000
chr10,12600565,12602573,2008,-1,0,57118,1,49.80079681274900000000
chr10,12705038,12706488,1450,-1,0,57118,1,68.96551724137930000000
chr10,12816864,12818299,1435,-1,0,57118,1,69.68641114982580000000
chr10,12883183,12884670,1487,-1,0,,0,0.00000000000000000000
chr10,12892813,12894352,1539,-1,0,,0,0.00000000000000000000
chr10,12898462,12903402,4940,-1,0,,0,0.00000000000000000000
chr10,12981461,12981899,438,-1,0,83643,1,228.31050228310500000000
chr10,13056560,13066890,10330,-1,0,83643,1,9.68054211035818000000
chr10,13055546,13060888,5342,-1,0,83643,1,18.71958068139270000000
chr10,13056902,13061053,4151,-1,0,83643,1,24.09058058299210000000
chr10,13056570,13058900,2330,-1,0,83643,1,42.91845493562230000000
chr10,13257911,13258430,519,-1,0,,0,0.00000000000000000000
chr10,13258020,13258333,313,-1,0,,0,0.00000000000000000000
chr10,13259247,13260742,1495,-1,0,,0,0.00000000000000000000
chr10,13570265,13571415,1150,-1,0,,0,0.00000000000000000000
chr10,14094873,14097213,2340,-1,0,55691,1,42.73504273504270000000
chr10,14166014,14168859,2845,-1,0,55691,1,35.14938488576450000000
chr10,14241645,14242441,796,-1,0,55691,1,125.62814070351800000000
chr10,14247238,14249148,1910,-1,0,55691,1,52.35602094240840000000
chr10,14533641,14535855,2214,-1,0,,0,0.00000000000000000000
chr10,14683219,14684799,1580,-1,0,83641,1,63.29113924050630000000
chr10,14750708,14751143,435,-1,0,83641,1,229.88505747126400000000
chr10,14936259,14936801,542,-1,0,79723,1,184.50184501845000000000
chr10,14936364,14936667,303,-1,0,79723,1,330.03300330033000000000
chr10,14954814,14955170,356,-1,0,64421,1,280.89887640449400000000
chr10,15005232,15060740,55508,-1,0,644890,1,1.80154212005477000000
chr10,15059080,15070089,11009,-1,0,,0,0.00000000000000000000
chr10,15163095,15166195,3100,-1,0,9397,1,32.25806451612900000000
chr10,15271356,15272249,893,-1,0,221061,1,111.98208286674100000000
chr10,15271504,15272071,567,-1,0,221061,1,176.36684303351000000000
chr10,15271757,15271866,109,-1,0,221061,1,917.43119266055100000000
chr10,15472700,15477643,4943,-1,0,,0,0.00000000000000000000
chr10,15532445,15532861,416,-1,0,,0,0.00000000000000000000
chr10,15669822,15674338,4516,-1,0,8516,1,22.14348981399470000000
chr10,15792844,15794051,1207,-1,0,,0,0.00000000000000000000
chr10,15797029,15804739,7710,-1,0,,0,0.00000000000000000000
chr10,15918556,15931066,12510,-1,0,,0,0.00000000000000000000
chr10,15957710,15963765,6055,-1,0,,0,0.00000000000000000000
chr10,16025145,16025475,330,-1,0,,0,0.00000000000000000000
chr10,16368044,16371365,3321,-1,0,,0,0.00000000000000000000
chr10,16377832,16394829,16997,-1,0,,0,0.00000000000000000000
chr10,16419987,16436600,16613,-1,0,,0,0.00000000000000000000
chr10,16687867,16688149,282,-1,0,6251,1,354.60992907801400000000
chr10,17094321,17101732,7411,-1,0,8029,1,13.49345567399810000000
chr10,17312417,17316693,4276,-1,0,,0,0.00000000000000000000
chr10,17310708,17315527,4819,-1,0,,0,0.00000000000000000000
chr10,17400473,17400897,424,-1,0,338596,1,235.84905660377400000000
chr10,17610408,17628425,18017,-1,0,,0,0.00000000000000000000
chr10,17632901,17635548,2647,-1,0,9200,1,37.77861730260670000000
chr10,17870097,17874291,4194,-1,0,,0,0.00000000000000000000
chr10,18503073,18503589,516,-1,0,783,1,193.79844961240300000000
chr10,18614042,18614872,830,-1,0,783,1,120.48192771084300000000
chr10,18670512,18671316,804,-1,0,783,1,124.37810945273600000000
chr10,18703930,18708805,4875,-1,0,783,1,20.51282051282050000000
chr10,18841789,18862454,20665,-1,0,221078,1,4.83909992741350000000
chr10,18852661,18862255,9594,-1,0,221078,1,10.42318115488850000000
chr10,19069113,19269003,199890,-1,0,,0,0.00000000000000000000
chr10,19177899,19186885,8986,-1,0,,0,0.00000000000000000000
chr10,18999547,19005367,5820,-1,0,,0,0.00000000000000000000
chr10,19030271,19030768,497,-1,0,,0,0.00000000000000000000
chr10,19030336,19030576,240,-1,0,,0,0.00000000000000000000
chr10,19397235,19397746,511,-1,0,340895,1,195.69471624266100000000
chr10,19397298,19397663,365,-1,0,340895,1,273.97260273972600000000
chr10,19822913,20035910,212997,-1,0,340895,1,0.46949018061287300000
chr10,19657276,19689001,31725,-1,0,340895,1,3.15208825847124000000
chr10,20291469,20322022,30553,-1,0,84898,1,3.27300101463031000000
chr10,19512271,19538402,26131,-1,0,340895,1,3.82687229727144000000
chr10,19749801,19758983,9182,-1,0,340895,1,10.89087344805050000000
chr10,19713632,19719533,5901,-1,0,340895,1,16.94628029147600000000
chr10,19996057,19998303,2246,-1,0,340895,1,44.52359750667850000000
chr10,19996546,19998129,1583,-1,0,340895,1,63.17119393556540000000
chr10,19781465,19783079,1614,-1,0,340895,1,61.95786864931850000000
chr10,19585690,19587267,1577,-1,0,340895,1,63.41154090044390000000
chr10,19997076,19998012,936,-1,0,340895,1,106.83760683760700000000
chr10,19460614,19461253,639,-1,0,340895,1,156.49452269170600000000
chr10,19998835,19999501,666,-1,0,340895,1,150.15015015015000000000
chr10,19504491,19504932,441,-1,0,340895,1,226.75736961451200000000
chr10,20415370,20415590,220,-1,0,84898,1,454.54545454545500000000
chr10,20477945,20478123,178,-1,0,84898,1,561.79775280898900000000
chr10,19504656,19504798,142,-1,0,340895,1,704.22535211267600000000
chr10,19460896,19460969,73,-1,0,340895,1,1369.86301369863000000000
chr10,20667163,20667619,456,-1,0,,0,0.00000000000000000000
chr10,20667218,20667560,342,-1,0,,0,0.00000000000000000000
chr10,20824342,20824706,364,-1,0,,0,0.00000000000000000000
chr10,20824450,20824567,117,-1,0,,0,0.00000000000000000000
chr10,20830145,20850262,20117,-1,0,,0,0.00000000000000000000
chr10,20849427,20860207,10780,-1,0,,0,0.00000000000000000000
chr10,20849988,20860765,10777,-1,0,,0,0.00000000000000000000
chr10,20850228,20856037,5809,-1,0,,0,0.00000000000000000000
chr10,20850564,20854029,3465,-1,0,,0,0.00000000000000000000
chr10,21011249,21013520,2271,-1,0,,0,0.00000000000000000000
chr10,21116640,21118346,1706,-1,0,10529,1,58.61664712778430000000
chr10,21609471,21610493,1022,-1,0,,0,0.00000000000000000000
chr10,21685105,21687100,1995,-1,0,,0,0.00000000000000000000
chr10,21727919,21728934,1015,-1,0,,0,0.00000000000000000000
chr10,21762506,21845875,83369,-1,0,399726;8028;387640,3,3.59845985918027000000
chr10,22151556,22161197,9641,-1,0,64215,1,10.37236801161710000000
chr10,22868693,22869570,877,-1,0,5305,1,114.02508551881400000000
chr10,23015561,23016756,1195,-1,0,,0,0.00000000000000000000
chr10,23133921,23135919,1998,-1,0,,0,0.00000000000000000000
chr10,23635302,23635860,558,-1,0,,0,0.00000000000000000000
chr10,23635492,23635622,130,-1,0,,0,0.00000000000000000000
chr10,23699287,23708458,9171,-1,0,,0,0.00000000000000000000
chr10,23803331,23807048,3717,-1,0,,0,0.00000000000000000000
chr10,24073857,24079464,5607,-1,0,56243,1,17.83484929552350000000
chr10,24251532,24284638,33106,-1,0,56243,1,3.02060049537848000000
chr10,24281522,24281969,447,-1,0,56243,1,223.71364653243800000000
chr10,24378104,24382677,4573,-1,0,56243,1,21.86748305270060000000
chr10,24375251,24379108,3857,-1,0,56243,1,25.92688618096970000000
chr10,24376837,24378444,1607,-1,0,56243,1,62.22775357809580000000
chr10,24377673,24379024,1351,-1,0,56243,1,74.01924500370100000000
chr10,24569530,24570750,1220,-1,0,56243,1,81.96721311475410000000
chr10,24604558,24606976,2418,-1,0,56243,1,41.35649296939620000000
chr10,25035058,25035547,489,-1,0,,0,0.00000000000000000000
chr10,25035154,25035316,162,-1,0,,0,0.00000000000000000000
chr10,25035186,25035282,96,-1,0,,0,0.00000000000000000000
chr10,25097552,25100013,2461,-1,0,,0,0.00000000000000000000
chr10,25097981,25098520,539,-1,0,,0,0.00000000000000000000
chr10,25098079,25098422,343,-1,0,,0,0.00000000000000000000
chr10,25145577,25146714,1137,-1,0,56952,1,87.95074758135440000000
chr10,25277451,25277815,364,-1,0,219670,1,274.72527472527500000000
chr10,25475493,25492592,17099,-1,0,57512,1,5.84829522194280000000
chr10,25492524,25492951,427,-1,0,57512,1,234.19203747072600000000
chr10,25638225,25638833,608,-1,0,57512,1,164.47368421052600000000
chr10,25732484,25733111,627,-1,0,57512,1,159.48963317384400000000
chr10,25793901,25812198,18297,-1,0,57512,1,5.46537683773296000000
chr10,26139960,26143467,3507,-1,0,,0,0.00000000000000000000
chr10,26187848,26192073,4225,-1,0,,0,0.00000000000000000000
chr10,26350507,26352066,1559,-1,0,53904,1,64.14368184733800000000
chr10,26354753,26355098,345,-1,0,53904,1,289.85507246376800000000
chr10,26608229,26611060,2831,-1,0,,0,0.00000000000000000000
chr10,26607996,26608513,517,-1,0,,0,0.00000000000000000000
chr10,26608208,26608328,120,-1,0,,0,0.00000000000000000000
chr10,26684595,26689822,5227,-1,0,,0,0.00000000000000000000
chr10,26767818,26768392,574,-1,0,54518,1,174.21602787456400000000
chr10,26767946,26768255,309,-1,0,54518,1,323.62459546925600000000
chr10,26873872,26954679,80807,-1,0,,0,0.00000000000000000000
chr10,26899252,26977825,78573,-1,0,,0,0.00000000000000000000
chr10,26864423,26920534,56111,-1,0,,0,0.00000000000000000000
chr10,26871393,26874391,2998,-1,0,,0,0.00000000000000000000
chr10,26892648,26894568,1920,-1,0,,0,0.00000000000000000000
chr10,26999007,27002145,3138,-1,0,23590,1,31.86743148502230000000
chr10,27000126,27001812,1686,-1,0,23590,1,59.31198102016610000000
chr10,27001269,27001814,545,-1,0,23590,1,183.48623853211000000000
chr10,27205780,27206217,437,-1,0,,0,0.00000000000000000000
chr10,27600701,27696761,96060,-1,0,374308,1,1.04101603164689000000
chr10,27655927,27700310,44383,-1,0,374308,1,2.25311493139265000000
chr10,28564180,28575365,11185,-1,0,143098,1,8.94054537326777000000
chr10,28939558,28948024,8466,-1,0,,0,0.00000000000000000000
chr10,28503272,28511810,8538,-1,0,143098,1,11.71234481143120000000
chr10,28657743,28664094,6351,-1,0,,0,0.00000000000000000000
chr10,27613086,27619741,6655,-1,0,,0,0.00000000000000000000
chr10,28564572,28569835,5263,-1,0,143098,1,19.00057001710050000000
chr10,27625107,27630056,4949,-1,0,,0,0.00000000000000000000
chr10,27224103,27228200,4097,-1,0,,0,0.00000000000000000000
chr10,27225955,27228680,2725,-1,0,,0,0.00000000000000000000
chr10,27638256,27642180,3924,-1,0,,0,0.00000000000000000000
chr10,27618231,27621995,3764,-1,0,,0,0.00000000000000000000
chr10,28661762,28665290,3528,-1,0,,0,0.00000000000000000000
chr10,27793932,27795886,1954,-1,0,22931,1,51.17707267144320000000
chr10,29290539,29293574,3035,-1,0,,0,0.00000000000000000000
chr10,27638350,27640498,2148,-1,0,,0,0.00000000000000000000
chr10,29711755,29713145,1390,-1,0,,0,0.00000000000000000000
chr10,28663821,28665101,1280,-1,0,,0,0.00000000000000000000
chr10,28925254,28926125,871,-1,0,,0,0.00000000000000000000
chr10,27228256,27229421,1165,-1,0,,0,0.00000000000000000000
chr10,27731747,27732395,648,-1,0,,0,0.00000000000000000000
chr10,29595047,29595620,573,-1,0,84569,1,174.52006980802800000000
chr10,29712144,29712720,576,-1,0,,0,0.00000000000000000000
chr10,28650520,28651029,509,-1,0,,0,0.00000000000000000000
chr10,29110717,29111235,518,-1,0,,0,0.00000000000000000000
chr10,28112740,28113153,413,-1,0,55130,1,242.13075060532700000000
chr10,27995966,27996203,237,-1,0,283078,1,421.94092827004200000000
chr10,28432506,28432805,299,-1,0,143098,1,334.44816053511700000000
chr10,28041468,28041618,150,-1,0,,0,0.00000000000000000000
chr10,29458568,29458763,195,-1,0,,0,0.00000000000000000000
chr10,28042103,28042228,125,-1,0,,0,0.00000000000000000000
chr10,27395686,27395772,86,-1,0,,0,0.00000000000000000000
chr10,27732099,27732184,85,-1,0,,0,0.00000000000000000000
chr10,27945180,27945231,51,-1,0,,0,0.00000000000000000000
chr10,29742221,29742944,723,-1,0,,0,0.00000000000000000000
chr10,29883211,29883272,61,-1,0,6840,1,1639.34426229508000000000
chr10,29918525,29918995,470,-1,0,6840,1,212.76595744680900000000
chr10,30323404,30332430,9026,-1,0,57608,1,11.07910480833150000000
chr10,30621942,30624754,2812,-1,0,55149,1,35.56187766714080000000
chr10,30758261,30759243,982,-1,0,,0,0.00000000000000000000
chr10,30935094,30936602,1508,-1,0,,0,0.00000000000000000000
chr10,30966175,30966662,487,-1,0,,0,0.00000000000000000000
chr10,31199279,31204564,5285,-1,0,220929,1,18.92147587511830000000
chr10,31246678,31251760,5082,-1,0,220929,1,19.67729240456510000000
chr10,31247126,31251728,4602,-1,0,220929,1,21.72968274663190000000
chr10,31443352,31444866,1514,-1,0,,0,0.00000000000000000000
chr10,31443538,31444770,1232,-1,0,,0,0.00000000000000000000
chr10,31443803,31444139,336,-1,0,,0,0.00000000000000000000
chr10,31498963,31499953,990,-1,0,,0,0.00000000000000000000
chr10,31576974,31582436,5462,-1,0,,0,0.00000000000000000000
chr10,32042147,32048154,6007,-1,0,,0,0.00000000000000000000
chr10,32252462,32284571,32109,-1,0,,0,0.00000000000000000000
chr10,32254334,32272138,17804,-1,0,,0,0.00000000000000000000
chr10,32257879,32260612,2733,-1,0,,0,0.00000000000000000000
chr10,32552179,32553682,1503,-1,0,,0,0.00000000000000000000
chr10,32553516,32554335,819,-1,0,,0,0.00000000000000000000
chr10,32704291,32706786,2495,-1,0,,0,0.00000000000000000000
chr10,32705630,32706160,530,-1,0,,0,0.00000000000000000000
chr10,32705722,32706066,344,-1,0,,0,0.00000000000000000000
chr10,32988391,32989349,958,-1,0,79741,1,104.38413361169100000000
chr10,32992071,32995611,3540,-1,0,79741,1,28.24858757062150000000
chr10,33189406,33190528,1122,-1,0,3688,1,89.12655971479500000000
chr10,33264472,33266263,1791,-1,0,,0,0.00000000000000000000
chr10,33378186,33379226,1040,-1,0,,0,0.00000000000000000000
chr10,33492469,33493303,834,-1,0,8829,1,119.90407673860900000000
chr10,33492639,33492929,290,-1,0,8829,1,344.82758620689700000000
chr10,34017757,34017857,100,-1,0,,0,0.00000000000000000000
chr10,34197052,34203408,6356,-1,0,,0,0.00000000000000000000
chr10,34487064,34489473,2409,-1,0,56288,1,41.51100041511000000000
chr10,34517434,34522205,4771,-1,0,56288,1,20.95996646405370000000
chr10,34684354,34684922,568,-1,0,56288,1,176.05633802816900000000
chr10,34684468,34684793,325,-1,0,56288,1,307.69230769230800000000
chr10,34754552,34756511,1959,-1,0,56288,1,51.04645227156710000000
chr10,35120234,35124063,3829,-1,0,,0,0.00000000000000000000
chr10,35215143,35221050,5907,-1,0,,0,0.00000000000000000000
chr10,35331056,35332331,1275,-1,0,8453,1,78.43137254901960000000
chr10,35480272,35481709,1437,-1,0,1390,1,69.58942240779400000000
chr10,35593116,35593643,527,-1,0,219771,1,189.75332068311200000000
chr10,35593207,35593531,324,-1,0,219771,1,308.64197530864200000000
chr10,35695018,35699195,4177,-1,0,219771,1,23.94062724443380000000
chr10,35838748,35838988,240,-1,0,219771,1,416.66666666666700000000
chr10,35895209,35899205,3996,-1,0,219770,1,25.02502502502500000000
chr10,35927325,35931832,4507,-1,0,8325,1,22.18770800976260000000
chr10,35929071,35931263,2192,-1,0,8325,1,45.62043795620440000000
chr10,36031811,36031893,82,-1,0,,0,0.00000000000000000000
chr10,36176404,36178089,1685,-1,0,,0,0.00000000000000000000
chr10,36219664,36221081,1417,-1,0,,0,0.00000000000000000000
chr10,36391470,36394988,3518,-1,0,,0,0.00000000000000000000
chr10,36392445,36394609,2164,-1,0,,0,0.00000000000000000000
chr10,36411867,36412188,321,-1,0,,0,0.00000000000000000000
chr10,36534104,36534220,116,-1,0,,0,0.00000000000000000000
chr10,37199114,37333844,134730,-1,0,,0,0.00000000000000000000
chr10,37445834,37488035,42201,-1,0,91074,1,2.36961209450013000000
chr10,37453711,37479916,26205,-1,0,91074,1,3.81606563632895000000
chr10,37661400,37685214,23814,-1,0,,0,0.00000000000000000000
chr10,37816504,37823569,7065,-1,0,,0,0.00000000000000000000
chr10,36892656,36898173,5517,-1,0,,0,0.00000000000000000000
chr10,37768129,37773324,5195,-1,0,,0,0.00000000000000000000
chr10,36787154,36791524,4370,-1,0,,0,0.00000000000000000000
chr10,37136240,37138050,1810,-1,0,,0,0.00000000000000000000
chr10,36825946,36827126,1180,-1,0,,0,0.00000000000000000000
chr10,37794879,37795157,278,-1,0,,0,0.00000000000000000000
chr10,38271991,38272152,161,-1,0,,0,0.00000000000000000000
chr10,38743110,38900673,157563,-1,0,,0,0.00000000000000000000
chr10,38818455,38907610,89155,-1,0,,0,0.00000000000000000000
chr10,39077037,39154671,77634,-1,0,,0,0.00000000000000000000
chr10,38772885,38818622,45737,-1,0,,0,0.00000000000000000000
chr10,39113341,39151984,38643,-1,0,,0,0.00000000000000000000
chr10,39076908,39113525,36617,-1,0,,0,0.00000000000000000000
chr10,39122129,39148060,25931,-1,0,,0,0.00000000000000000000
chr10,39076844,39104278,27434,-1,0,,0,0.00000000000000000000
chr10,38868867,38888524,19657,-1,0,,0,0.00000000000000000000
chr10,38790516,38806538,16022,-1,0,,0,0.00000000000000000000
chr10,39097742,39110973,13231,-1,0,,0,0.00000000000000000000
chr10,38877620,38887442,9822,-1,0,,0,0.00000000000000000000
chr10,38791501,38801643,10142,-1,0,,0,0.00000000000000000000
chr10,38868944,38876999,8055,-1,0,,0,0.00000000000000000000
chr10,39079060,39085874,6814,-1,0,,0,0.00000000000000000000
chr10,38869050,38874240,5190,-1,0,,0,0.00000000000000000000
chr10,38868867,38873446,4579,-1,0,,0,0.00000000000000000000
chr10,38749129,38752667,3538,-1,0,,0,0.00000000000000000000
chr10,38737859,38740114,2255,-1,0,,0,0.00000000000000000000
chr10,42401249,42503182,101933,-1,0,,0,0.00000000000000000000
chr10,42355001,42394290,39289,-1,0,,0,0.00000000000000000000
chr10,42610659,42647949,37290,-1,0,,0,0.00000000000000000000
chr10,42355001,42382563,27562,-1,0,,0,0.00000000000000000000
chr10,42790866,42816716,25850,-1,0,,0,0.00000000000000000000
chr10,42367300,42383337,16037,-1,0,,0,0.00000000000000000000
chr10,42699906,42715683,15777,-1,0,,0,0.00000000000000000000
chr10,42399434,42408155,8721,-1,0,,0,0.00000000000000000000
chr10,42530315,42539714,9399,-1,0,,0,0.00000000000000000000
chr10,42383280,42390249,6969,-1,0,,0,0.00000000000000000000
chr10,42662502,42667255,4753,-1,0,,0,0.00000000000000000000
chr10,42399931,42404837,4906,-1,0,,0,0.00000000000000000000
chr10,42597447,42602151,4704,-1,0,,0,0.00000000000000000000
chr10,42385355,42387277,1922,-1,0,,0,0.00000000000000000000
chr10,42454505,42457171,2666,-1,0,,0,0.00000000000000000000
chr10,42663417,42665774,2357,-1,0,,0,0.00000000000000000000
chr10,42394880,42396586,1706,-1,0,,0,0.00000000000000000000
chr10,42398692,42400347,1655,-1,0,,0,0.00000000000000000000
chr10,42528103,42529253,1150,-1,0,,0,0.00000000000000000000
chr10,42457995,42458853,858,-1,0,,0,0.00000000000000000000
chr10,42381491,42382021,530,-1,0,,0,0.00000000000000000000
chr10,42386047,42386276,229,-1,0,,0,0.00000000000000000000
chr10,42827548,42890552,63004,-1,0,,0,0.00000000000000000000
chr10,42900744,42911854,11110,-1,0,,0,0.00000000000000000000
chr10,42874005,42880151,6146,-1,0,,0,0.00000000000000000000
chr10,43218612,43240514,21902,-1,0,,0,0.00000000000000000000
chr10,43101996,43108198,6202,-1,0,7582,1,16.12383102225090000000
chr10,43182711,43186575,3864,-1,0,,0,0.00000000000000000000
chr10,43174412,43176103,1691,-1,0,,0,0.00000000000000000000
chr10,43274199,43274532,333,-1,0,,0,0.00000000000000000000
chr10,43384260,43387598,3338,-1,0,,0,0.00000000000000000000
chr10,43547746,43548707,961,-1,0,,0,0.00000000000000000000
chr10,43739683,43740163,480,-1,0,221002,1,208.33333333333300000000
chr10,43986005,43987956,1951,-1,0,,0,0.00000000000000000000
chr10,44095423,44095606,183,-1,0,,0,0.00000000000000000000
chr10,44204257,44206033,1776,-1,0,,0,0.00000000000000000000
chr10,44204510,44205754,1244,-1,0,,0,0.00000000000000000000
chr10,44204430,44204798,368,-1,0,,0,0.00000000000000000000
chr10,44383342,44384084,742,-1,0,,0,0.00000000000000000000
chr10,44757223,44761262,4039,-1,0,,0,0.00000000000000000000
chr10,44808590,44810588,1998,-1,0,,0,0.00000000000000000000
chr10,44674950,44675574,624,-1,0,,0,0.00000000000000000000
chr10,44687297,44687938,641,-1,0,,0,0.00000000000000000000
chr10,44855788,44856282,494,-1,0,,0,0.00000000000000000000
chr10,44675119,44675437,318,-1,0,,0,0.00000000000000000000
chr10,44675225,44675325,100,-1,0,,0,0.00000000000000000000
chr10,44901270,44901620,350,-1,0,,0,0.00000000000000000000
chr10,45031395,45033386,1991,-1,0,,0,0.00000000000000000000
chr10,45094372,45096771,2399,-1,0,,0,0.00000000000000000000
chr10,45157968,45158603,635,-1,0,,0,0.00000000000000000000
chr10,45158135,45158436,301,-1,0,,0,0.00000000000000000000
chr10,45336661,45337455,794,-1,0,,0,0.00000000000000000000
chr10,45410918,45414452,3534,-1,0,643236,1,28.29654782116580000000
chr10,45423211,45424276,1065,-1,0,643236,1,93.89671361502350000000
chr10,45583575,45583700,125,-1,0,,0,0.00000000000000000000
chr10,45728765,45731648,2883,-1,0,,0,0.00000000000000000000
chr10,45752220,45752900,680,-1,0,,0,0.00000000000000000000
chr10,45990189,46027701,37512,-1,0,220972,1,2.66581360631265000000
chr10,46072354,46088951,16597,-1,0,220972,1,6.02518527444719000000
chr10,46174678,46192733,18055,-1,0,,0,0.00000000000000000000
chr10,46719449,49176867,2457418,-1,0,83849;642517;2658;2662;26095;118738;195977;653145;5949;100133093;728113;9721;5540,13,0.52901053056500800000
chr10,46794787,47748159,953372,-1,0,195977;83849;728113;9721;5540,5,0.52445425290442800000
chr10,46463825,47242930,779105,-1,0,728113;9721;83849;5540,4,0.51340961744565900000
chr10,46287822,47028678,740856,-1,0,253725;9721;119016;83849,4,0.53991598907210000000
chr10,48703842,49323692,619850,-1,0,26095;644054,2,0.32265870775187500000
chr10,46998307,47587348,589041,-1,0,728113;9721;5540,3,0.50930240849109000000
chr10,47587331,48116214,528883,-1,0,195977,1,0.18907773552940800000
chr10,46765731,47170765,405034,-1,0,728113;9721;83849;5540,4,0.98757141375785700000
chr10,46381209,46686712,305503,-1,0,,0,0.00000000000000000000
chr10,47373245,47657802,284557,-1,0,,0,0.00000000000000000000
chr10,47036780,47311536,274756,-1,0,728113;5540,2,0.72791858958494100000
chr10,47236543,47461104,224561,-1,0,,0,0.00000000000000000000
chr10,47144693,47326191,181498,-1,0,728113,1,0.55097025862543900000
chr10,46886358,47122110,235752,-1,0,9721;83849;5540,3,1.27252366894024000000
chr10,47564420,47712286,147866,-1,0,195977,1,0.67628799047786500000
chr10,48940444,49094200,153756,-1,0,,0,0.00000000000000000000
chr10,46966859,47168239,201380,-1,0,728113;9721;83849;5540,4,1.98629456748436000000
chr10,48664595,48872432,207837,-1,0,26095,1,0.48114628290439100000
chr10,49195571,49390268,194697,-1,0,143162;644054,2,1.02723719420433000000
chr10,48111525,48290336,178811,-1,0,100133093;653145;642517,3,1.67774913176482000000
chr10,51861706,52000736,139030,-1,0,387680;56624,2,1.43853844493994000000
chr10,46700101,46844000,143899,-1,0,,0,0.00000000000000000000
chr10,48902069,48986229,84160,-1,0,,0,0.00000000000000000000
chr10,47542126,47656045,113919,-1,0,,0,0.00000000000000000000
chr10,47056789,47165339,108550,-1,0,728113;5540,2,1.84246890833717000000
chr10,47598821,47707812,108991,-1,0,195977,1,0.91750695011514700000
chr10,46971534,47058665,87131,-1,0,9721,1,1.14769714567720000000
chr10,48105747,48192700,86953,-1,0,,0,0.00000000000000000000
chr10,49000433,49095498,95065,-1,0,,0,0.00000000000000000000
chr10,49287712,49373004,85292,-1,0,143162,1,1.17244290203067000000
chr10,49198695,49279459,80764,-1,0,644054,1,1.23817542469417000000
chr10,47677798,47750479,72681,-1,0,195977,1,1.37587540072371000000
chr10,46970574,47027132,56558,-1,0,9721;83849,2,3.53619293468652000000
chr10,47897568,47959586,62018,-1,0,,0,0.00000000000000000000
chr10,51448886,51499336,50450,-1,0,100652748,1,1.98216055500496000000
chr10,47005471,47057134,51663,-1,0,,0,0.00000000000000000000
chr10,48872867,48910562,37695,-1,0,,0,0.00000000000000000000
chr10,47057086,47108696,51610,-1,0,5540,1,1.93760899050572000000
chr10,47645964,47697149,51185,-1,0,195977,1,1.95369737227703000000
chr10,51213113,51261873,48760,-1,0,8505,1,2.05086136177194000000
chr10,48105806,48147023,41217,-1,0,,0,0.00000000000000000000
chr10,48146385,48186291,39906,-1,0,,0,0.00000000000000000000
chr10,51679938,51720426,40488,-1,0,100652748,1,2.46986761509583000000
chr10,51733535,51777450,43915,-1,0,414189;100652748,2,4.55425253330297000000
chr10,47035138,47063125,27987,-1,0,,0,0.00000000000000000000
chr10,51052310,51092857,40547,-1,0,8505,1,2.46627370705601000000
chr10,46989079,47028298,39219,-1,0,9721,1,2.54978454320610000000
chr10,46682728,46714895,32167,-1,0,,0,0.00000000000000000000
chr10,47260843,47285731,24888,-1,0,,0,0.00000000000000000000
chr10,48257171,48279190,22019,-1,0,653145,1,4.54153231300241000000
chr10,47748754,47770045,21291,-1,0,,0,0.00000000000000000000
chr10,47153487,47173676,20189,-1,0,728113,1,4.95319233245827000000
chr10,48110038,48126991,16953,-1,0,,0,0.00000000000000000000
chr10,47056092,47067901,11809,-1,0,,0,0.00000000000000000000
chr10,48105918,48115972,10054,-1,0,,0,0.00000000000000000000
chr10,51003268,51011152,7884,-1,0,,0,0.00000000000000000000
chr10,50197957,50207194,9237,-1,0,,0,0.00000000000000000000
chr10,51003380,51010864,7484,-1,0,,0,0.00000000000000000000
chr10,47056075,47062434,6359,-1,0,,0,0.00000000000000000000
chr10,48590250,48594421,4171,-1,0,,0,0.00000000000000000000
chr10,48591248,48594311,3063,-1,0,,0,0.00000000000000000000
chr10,51515831,51518374,2543,-1,0,100652748,1,39.32363350373570000000
chr10,47148769,47150403,1634,-1,0,,0,0.00000000000000000000
chr10,51516720,51518224,1504,-1,0,100652748,1,66.48936170212770000000
chr10,51501721,51502790,1069,-1,0,100652748,1,93.54536950420950000000
chr10,47139238,47140704,1466,-1,0,,0,0.00000000000000000000
chr10,47642365,47643381,1016,-1,0,,0,0.00000000000000000000
chr10,50985011,50985863,852,-1,0,,0,0.00000000000000000000
chr10,49917069,49917600,531,-1,0,57705,1,188.32391713747600000000
chr10,47088271,47088822,551,-1,0,5540,1,181.48820326678800000000
chr10,50277979,50278465,486,-1,0,196740,1,205.76131687242800000000
chr10,47642616,47643151,535,-1,0,,0,0.00000000000000000000
chr10,47589847,47590208,361,-1,0,,0,0.00000000000000000000
chr10,51002686,51003099,413,-1,0,,0,0.00000000000000000000
chr10,47036093,47036306,213,-1,0,,0,0.00000000000000000000
chr10,47088376,47088703,327,-1,0,,0,0.00000000000000000000
chr10,49917171,49917494,323,-1,0,57705,1,309.59752321981400000000
chr10,50543500,50543654,154,-1,0,,0,0.00000000000000000000
chr10,50335219,50335278,59,-1,0,,0,0.00000000000000000000
chr10,52718526,52720166,1640,-1,0,,0,0.00000000000000000000
chr10,53203543,53214408,10865,-1,0,5592,1,9.20386562356190000000
chr10,53203716,53212090,8374,-1,0,5592,1,11.94172438500120000000
chr10,53207572,53211449,3877,-1,0,5592,1,25.79313902501930000000
chr10,53382615,53410903,28288,-1,0,5592,1,3.53506787330317000000
chr10,53578469,53578799,330,-1,0,5592,1,303.03030303030300000000
chr10,53699483,53706938,7455,-1,0,5592,1,13.41381623071760000000
chr10,53827653,53828014,361,-1,0,5592,1,277.00831024930700000000
chr10,53828729,53828789,60,-1,0,5592,1,1666.66666666667000000000
chr10,53869353,53869917,564,-1,0,5592,1,177.30496453900700000000
chr10,53947964,53948032,68,-1,0,5592,1,1470.58823529412000000000
chr10,53983715,54033968,50253,-1,0,5592,1,1.98993094939606000000
chr10,54014783,54018901,4118,-1,0,5592,1,24.28363283147160000000
chr10,54015777,54018108,2331,-1,0,5592,1,42.90004290004290000000
chr10,54061981,54062247,266,-1,0,,0,0.00000000000000000000
chr10,54068664,54069140,476,-1,0,,0,0.00000000000000000000
chr10,54363693,54364219,526,-1,0,,0,0.00000000000000000000
chr10,54363768,54364162,394,-1,0,,0,0.00000000000000000000
chr10,54411191,54416244,5053,-1,0,,0,0.00000000000000000000
chr10,54441109,54441531,422,-1,0,,0,0.00000000000000000000
chr10,57462495,57730560,268065,-1,0,,0,0.00000000000000000000
chr10,55074621,55249703,175082,-1,0,,0,0.00000000000000000000
chr10,54979029,55083637,104608,-1,0,,0,0.00000000000000000000
chr10,55372378,55459887,87509,-1,0,,0,0.00000000000000000000
chr10,56609134,56696422,87288,-1,0,,0,0.00000000000000000000
chr10,57219515,57291791,72276,-1,0,,0,0.00000000000000000000
chr10,57714099,57763293,49194,-1,0,,0,0.00000000000000000000
chr10,56949886,56997312,47426,-1,0,,0,0.00000000000000000000
chr10,55117473,55140682,23209,-1,0,,0,0.00000000000000000000
chr10,54926906,54951774,24868,-1,0,,0,0.00000000000000000000
chr10,56446084,56469560,23476,-1,0,65217,1,4.25966944965071000000
chr10,57168655,57183077,14422,-1,0,,0,0.00000000000000000000
chr10,54929050,54938142,9092,-1,0,,0,0.00000000000000000000
chr10,54520036,54532522,12486,-1,0,4153,1,8.00897004645203000000
chr10,56677171,56689178,12007,-1,0,,0,0.00000000000000000000
chr10,57350430,57362029,11599,-1,0,100463289,1,8.62143288214501000000
chr10,54543640,54550062,6422,-1,0,,0,0.00000000000000000000
chr10,55318849,55327743,8894,-1,0,,0,0.00000000000000000000
chr10,55284683,55294034,9351,-1,0,,0,0.00000000000000000000
chr10,55082008,55090352,8344,-1,0,,0,0.00000000000000000000
chr10,54782454,54789837,7383,-1,0,,0,0.00000000000000000000
chr10,54930002,54938158,8156,-1,0,,0,0.00000000000000000000
chr10,55176445,55183607,7162,-1,0,,0,0.00000000000000000000
chr10,54563947,54570749,6802,-1,0,,0,0.00000000000000000000
chr10,57030474,57035828,5354,-1,0,,0,0.00000000000000000000
chr10,57637123,57642275,5152,-1,0,,0,0.00000000000000000000
chr10,57353031,57357864,4833,-1,0,,0,0.00000000000000000000
chr10,54544561,54549329,4768,-1,0,,0,0.00000000000000000000
chr10,57689108,57693035,3927,-1,0,,0,0.00000000000000000000
chr10,55748455,55751893,3438,-1,0,65217,1,29.08667830133800000000
chr10,57354231,57357613,3382,-1,0,,0,0.00000000000000000000
chr10,54526510,54529233,2723,-1,0,4153,1,36.72420124862280000000
chr10,57282557,57284654,2097,-1,0,,0,0.00000000000000000000
chr10,56682777,56684358,1581,-1,0,,0,0.00000000000000000000
chr10,57576996,57578501,1505,-1,0,,0,0.00000000000000000000
chr10,56183028,56184377,1349,-1,0,65217,1,74.12898443291330000000
chr10,55521361,55522377,1016,-1,0,,0,0.00000000000000000000
chr10,57302205,57303058,853,-1,0,,0,0.00000000000000000000
chr10,57701956,57702505,549,-1,0,,0,0.00000000000000000000
chr10,54860711,54861236,525,-1,0,,0,0.00000000000000000000
chr10,55591808,55592506,698,-1,0,65217,1,143.26647564469900000000
chr10,55893656,55894113,457,-1,0,65217,1,218.81838074398200000000
chr10,56516913,56517460,547,-1,0,65217,1,182.81535648994500000000
chr10,55958147,55958663,516,-1,0,65217,1,193.79844961240300000000
chr10,55725581,55726029,448,-1,0,65217,1,223.21428571428600000000
chr10,57223520,57223929,409,-1,0,,0,0.00000000000000000000
chr10,57383759,57384255,496,-1,0,,0,0.00000000000000000000
chr10,57702047,57702387,340,-1,0,,0,0.00000000000000000000
chr10,54860812,54861141,329,-1,0,,0,0.00000000000000000000
chr10,56517027,56517340,313,-1,0,65217,1,319.48881789137400000000
chr10,55958255,55958546,291,-1,0,65217,1,343.64261168384900000000
chr10,55086500,55086727,227,-1,0,,0,0.00000000000000000000
chr10,55725747,55725836,89,-1,0,65217,1,1123.59550561798000000000
chr10,57774547,57780014,5467,-1,0,,0,0.00000000000000000000
chr10,58327278,58484346,157068,-1,0,,0,0.00000000000000000000
chr10,58271130,58342704,71574,-1,0,,0,0.00000000000000000000
chr10,58302307,58309756,7449,-1,0,,0,0.00000000000000000000
chr10,58513994,58543128,29134,-1,0,,0,0.00000000000000000000
chr10,58512509,58527407,14898,-1,0,,0,0.00000000000000000000
chr10,58512272,58522949,10677,-1,0,,0,0.00000000000000000000
chr10,58834147,58869971,35824,-1,0,,0,0.00000000000000000000
chr10,58844092,58857103,13011,-1,0,,0,0.00000000000000000000
chr10,58845432,58851162,5730,-1,0,,0,0.00000000000000000000
chr10,58863546,58863866,320,-1,0,,0,0.00000000000000000000
chr10,58896786,58938212,41426,-1,0,,0,0.00000000000000000000
chr10,58888716,58897642,8926,-1,0,,0,0.00000000000000000000
chr10,58952054,58953409,1355,-1,0,,0,0.00000000000000000000
chr10,59015186,59015595,409,-1,0,,0,0.00000000000000000000
chr10,59070837,59072019,1182,-1,0,,0,0.00000000000000000000
chr10,59238869,59245689,6820,-1,0,,0,0.00000000000000000000
chr10,59208917,59212327,3410,-1,0,,0,0.00000000000000000000
chr10,59209847,59211644,1797,-1,0,,0,0.00000000000000000000
chr10,59256852,59258099,1247,-1,0,,0,0.00000000000000000000
chr10,59296693,59297011,318,-1,0,,0,0.00000000000000000000
chr10,59452837,59454094,1257,-1,0,,0,0.00000000000000000000
chr10,59453350,59453904,554,-1,0,,0,0.00000000000000000000
chr10,59453654,59453794,140,-1,0,,0,0.00000000000000000000
chr10,59467362,59557630,90268,-1,0,,0,0.00000000000000000000
chr10,59674344,59712782,38438,-1,0,,0,0.00000000000000000000
chr10,60089881,60094716,4835,-1,0,,0,0.00000000000000000000
chr10,60517705,60522675,4970,-1,0,80114,1,20.12072434607650000000
chr10,60584819,60585891,1072,-1,0,80114,1,93.28358208955220000000
chr10,61096678,61099315,2637,-1,0,220965,1,37.92188092529390000000
chr10,61202683,61203530,847,-1,0,,0,0.00000000000000000000
chr10,61361932,61365005,3073,-1,0,,0,0.00000000000000000000
chr10,61364104,61365301,1197,-1,0,,0,0.00000000000000000000
chr10,61365397,61365910,513,-1,0,,0,0.00000000000000000000
chr10,61365498,61365823,325,-1,0,,0,0.00000000000000000000
chr10,61441229,61441510,281,-1,0,220963,1,355.87188612099600000000
chr10,61450927,61452120,1193,-1,0,220963,1,83.82229673093040000000
chr10,61641701,61642380,679,-1,0,8030,1,147.27540500736400000000
chr10,62427212,62428340,1128,-1,0,288,1,88.65248226950360000000
chr10,62618381,62619685,1304,-1,0,,0,0.00000000000000000000
chr10,62900395,62902819,2424,-1,0,,0,0.00000000000000000000
chr10,63312293,63315569,3276,-1,0,,0,0.00000000000000000000
chr10,63285842,63286314,472,-1,0,,0,0.00000000000000000000
chr10,63743402,63744079,677,-1,0,84159,1,147.71048744460900000000
chr10,63743608,63743831,223,-1,0,84159,1,448.43049327354300000000
chr10,63743635,63743781,146,-1,0,84159,1,684.93150684931500000000
chr10,63824243,63825585,1342,-1,0,84159,1,74.51564828614010000000
chr10,63895515,63898890,3375,-1,0,,0,0.00000000000000000000
chr10,64167637,64173473,5836,-1,0,22891,1,17.13502398903360000000
chr10,64425664,64430909,5245,-1,0,22891,1,19.06577693040990000000
chr10,65143350,65172102,28752,-1,0,221037,1,3.47801892042293000000
chr10,65095542,65098248,2706,-1,0,221037,1,36.95491500369550000000
chr10,65029999,65031440,1441,-1,0,221037,1,69.39625260235950000000
chr10,65280969,65281816,847,-1,0,221035;221037,2,236.12750885478200000000
chr10,65402251,65403162,911,-1,0,,0,0.00000000000000000000
chr10,65509250,65511404,2154,-1,0,,0,0.00000000000000000000
chr10,65633497,65634362,865,-1,0,,0,0.00000000000000000000
chr10,66225885,66226756,871,-1,0,,0,0.00000000000000000000
chr10,66248085,66248934,849,-1,0,,0,0.00000000000000000000
chr10,66319344,66327109,7765,-1,0,,0,0.00000000000000000000
chr10,66394836,66400628,5792,-1,0,,0,0.00000000000000000000
chr10,66398674,66400715,2041,-1,0,,0,0.00000000000000000000
chr10,66398788,66399933,1145,-1,0,,0,0.00000000000000000000
chr10,66420079,66420419,340,-1,0,,0,0.00000000000000000000
chr10,66428988,66430170,1182,-1,0,,0,0.00000000000000000000
chr10,66435139,66439068,3929,-1,0,,0,0.00000000000000000000
chr10,66684458,66684532,74,-1,0,,0,0.00000000000000000000
chr10,66841804,66842061,257,-1,0,,0,0.00000000000000000000
chr10,67030166,67032331,2165,-1,0,,0,0.00000000000000000000
chr10,67031849,67033056,1207,-1,0,,0,0.00000000000000000000
chr10,67032311,67032904,593,-1,0,,0,0.00000000000000000000
chr10,67032409,67032772,363,-1,0,,0,0.00000000000000000000
chr10,67495968,67636573,140605,-1,0,,0,0.00000000000000000000
chr10,67301405,67326665,25260,-1,0,,0,0.00000000000000000000
chr10,67174782,67200697,25915,-1,0,,0,0.00000000000000000000
chr10,67319829,67338223,18394,-1,0,,0,0.00000000000000000000
chr10,67324285,67337346,13061,-1,0,,0,0.00000000000000000000
chr10,67307884,67322859,14975,-1,0,,0,0.00000000000000000000
chr10,67305298,67315024,9726,-1,0,,0,0.00000000000000000000
chr10,67306906,67315294,8388,-1,0,,0,0.00000000000000000000
chr10,67180580,67187398,6818,-1,0,,0,0.00000000000000000000
chr10,67330926,67337818,6892,-1,0,,0,0.00000000000000000000
chr10,67310479,67315112,4633,-1,0,,0,0.00000000000000000000
chr10,67229815,67233684,3869,-1,0,,0,0.00000000000000000000
chr10,67343092,67344175,1083,-1,0,,0,0.00000000000000000000
chr10,67343323,67344138,815,-1,0,,0,0.00000000000000000000
chr10,67242532,67243271,739,-1,0,,0,0.00000000000000000000
chr10,67343454,67343955,501,-1,0,,0,0.00000000000000000000
chr10,67602879,67603194,315,-1,0,,0,0.00000000000000000000
chr10,67602984,67603097,113,-1,0,,0,0.00000000000000000000
chr10,68161377,68516719,355342,-1,0,29119,1,0.28141902730327400000
chr10,68367546,68593672,226126,-1,0,29119,1,0.44223132236010000000
chr10,68170438,68402817,232379,-1,0,29119,1,0.43033148434238900000
chr10,67941005,68085160,144155,-1,0,29119,1,0.69369775588776000000
chr10,68302864,68409500,106636,-1,0,29119,1,0.93776960876251900000
chr10,68042126,68171281,129155,-1,0,29119,1,0.77426348186287800000
chr10,68456386,68550118,93732,-1,0,29119,1,1.06687150599582000000
chr10,68357310,68457086,99776,-1,0,29119,1,1.00224502886466000000
chr10,68291129,68375231,84102,-1,0,29119,1,1.18903236546099000000
chr10,68152046,68244866,92820,-1,0,29119,1,1.07735401853049000000
chr10,68225620,68291719,66099,-1,0,29119,1,1.51288219186372000000
chr10,68417239,68488839,71600,-1,0,29119,1,1.39664804469274000000
chr10,68248533,68309737,61204,-1,0,29119,1,1.63388013855304000000
chr10,68023591,68097059,73468,-1,0,29119,1,1.36113682147329000000
chr10,68189713,68247077,57364,-1,0,29119,1,1.74325360853497000000
chr10,68339608,68410427,70819,-1,0,29119,1,1.41205043844166000000
chr10,68449377,68514264,64887,-1,0,29119,1,1.54114075238492000000
chr10,68108006,68149325,41319,-1,0,29119,1,2.42019409956678000000
chr10,68079006,68125644,46638,-1,0,29119,1,2.14417427848536000000
chr10,68496461,68544304,47843,-1,0,29119,1,2.09016993081537000000
chr10,68368475,68416907,48432,-1,0,29119,1,2.06475057813016000000
chr10,68215155,68264184,49029,-1,0,29119,1,2.03960921087520000000
chr10,68285398,68329716,44318,-1,0,29119,1,2.25641951351595000000
chr10,68327183,68362265,35082,-1,0,29119,1,2.85046462573399000000
chr10,68424239,68449774,25535,-1,0,29119,1,3.91619345995692000000
chr10,68076901,68109300,32399,-1,0,29119,1,3.08651501589555000000
chr10,68386958,68416917,29959,-1,0,29119,1,3.33789512333523000000
chr10,68340544,68366261,25717,-1,0,29119,1,3.88847843838706000000
chr10,68298329,68320174,21845,-1,0,29119,1,4.57770656900893000000
chr10,68078481,68092746,14265,-1,0,29119,1,7.01016473887136000000
chr10,68260290,68275879,15589,-1,0,29119,1,6.41477965231894000000
chr10,68412141,68429245,17104,-1,0,29119,1,5.84658559401310000000
chr10,67987979,67995961,7982,-1,0,29119,1,12.52818842395390000000
chr10,68388857,68397153,8296,-1,0,29119,1,12.05400192864030000000
chr10,68272530,68279245,6715,-1,0,29119,1,14.89203276247210000000
chr10,68053231,68054595,1364,-1,0,29119,1,73.31378299120230000000
chr10,68241174,68241550,376,-1,0,29119,1,265.95744680851100000000
chr10,68838777,68840474,1697,-1,0,347731;29119,2,117.85503830288700000000
chr10,69039298,69040226,928,-1,0,29119,1,107.75862068965500000000
chr10,68954195,68954864,669,-1,0,29119,1,149.47683109118100000000
chr10,69325894,69346602,20708,-1,0,29119,1,4.82905157427081000000
chr10,69547011,69557430,10419,-1,0,56521,1,9.59785008158173000000
chr10,69687131,69687186,55,-1,0,26091,1,1818.18181818182000000000
chr10,69760995,69762153,1158,-1,0,26091,1,86.35578583765110000000
chr10,70018671,70020436,1765,-1,0,,0,0.00000000000000000000
chr10,70068227,70070647,2420,-1,0,64081,1,41.32231404958680000000
chr10,70211891,70213296,1405,-1,0,1763,1,71.17437722419930000000
chr10,70254062,70254544,482,-1,0,8034,1,207.46887966805000000000
chr10,70272095,70272418,323,-1,0,8034,1,309.59752321981400000000
chr10,70292875,70296452,3577,-1,0,,0,0.00000000000000000000
chr10,70297660,70302217,4557,-1,0,,0,0.00000000000000000000
chr10,70330055,70331350,1295,-1,0,80312,1,77.22007722007720000000
chr10,70559476,70562872,3396,-1,0,,0,0.00000000000000000000
chr10,70576467,70583429,6962,-1,0,,0,0.00000000000000000000
chr10,70578890,70580595,1705,-1,0,,0,0.00000000000000000000
chr10,70586952,70588175,1223,-1,0,219736,1,81.76614881439080000000
chr10,70612123,70624150,12027,-1,0,219736,1,8.31462542612455000000
chr10,70634324,70634454,130,-1,0,219736,1,769.23076923076900000000
chr10,70786311,70787465,1154,-1,0,,0,0.00000000000000000000
chr10,70998019,70998566,547,-1,0,80201,1,182.81535648994500000000
chr10,70998128,70998460,332,-1,0,80201,1,301.20481927710800000000
chr10,71057370,71060524,3154,-1,0,3098,1,31.70577045022190000000
chr10,71085705,71086866,1161,-1,0,3098,1,86.13264427217910000000
chr10,71230925,71237975,7050,-1,0,23555,1,14.18439716312060000000
chr10,71280815,71291303,10488,-1,0,,0,0.00000000000000000000
chr10,71282906,71291092,8186,-1,0,,0,0.00000000000000000000
chr10,71314811,71315245,434,-1,0,,0,0.00000000000000000000
chr10,71314962,71315070,108,-1,0,,0,0.00000000000000000000
chr10,71399743,71401070,1327,-1,0,,0,0.00000000000000000000
chr10,71797301,71801183,3882,-1,0,,0,0.00000000000000000000
chr10,72385942,72425743,39801,-1,0,,0,0.00000000000000000000
chr10,72598953,72602758,3805,-1,0,8879,1,26.28120893561100000000
chr10,72448734,72451340,2606,-1,0,140766,1,38.37298541826550000000
chr10,72448970,72450243,1273,-1,0,140766,1,78.55459544383350000000
chr10,72448668,72449925,1257,-1,0,140766,1,79.55449482895780000000
chr10,72342602,72343017,415,-1,0,,0,0.00000000000000000000
chr10,72856602,72858361,1759,-1,0,,0,0.00000000000000000000
chr10,73216158,73216304,146,-1,0,64072,1,684.93150684931500000000
chr10,73256289,73256944,655,-1,0,64072,1,152.67175572519100000000
chr10,73256581,73256701,120,-1,0,64072,1,833.33333333333300000000
chr10,73636654,73637170,516,-1,0,,0,0.00000000000000000000
chr10,73699213,73705935,6722,-1,0,,0,0.00000000000000000000
chr10,73824654,73824960,306,-1,0,9806,1,326.79738562091500000000
chr10,73862007,73866073,4066,-1,0,51008,1,24.59419576979830000000
chr10,73860381,73863223,2842,-1,0,51008,1,35.18648838845880000000
chr10,74240155,74261446,21291,-1,0,10367,1,4.69682025268893000000
chr10,74798341,74798726,385,-1,0,5033,1,259.74025974026000000000
chr10,74842494,74842979,485,-1,0,5033,1,206.18556701030900000000
chr10,74842592,74842846,254,-1,0,5033,1,393.70078740157500000000
chr10,75123699,75127835,4136,-1,0,,0,0.00000000000000000000
chr10,75374026,75382164,8138,-1,0,,0,0.00000000000000000000
chr10,75633676,75635000,1324,-1,0,818,1,75.52870090634440000000
chr10,76052430,76053360,930,-1,0,132,1,107.52688172043000000000
chr10,76367534,76374550,7016,-1,0,132,1,14.25313568985180000000
chr10,76471082,76472341,1259,-1,0,,0,0.00000000000000000000
chr10,76536905,76538464,1559,-1,0,,0,0.00000000000000000000
chr10,76575637,76576516,879,-1,0,,0,0.00000000000000000000
chr10,76585444,76587638,2194,-1,0,23522,1,45.57885141294440000000
chr10,76759774,76762418,2644,-1,0,23522,1,37.82148260211800000000
chr10,76888488,76895630,7142,-1,0,142891,1,14.00168020162420000000
chr10,78113725,78116322,2597,-1,0,83938,1,38.50596842510590000000
chr10,78247633,78258792,11159,-1,0,83938,1,8.96137646742540000000
chr10,78255188,78261155,5967,-1,0,83938,1,16.75884028825210000000
chr10,78256184,78258858,2674,-1,0,83938,1,37.39715781600600000000
chr10,78346267,78351760,5493,-1,0,,0,0.00000000000000000000
chr10,78457398,78466570,9172,-1,0,,0,0.00000000000000000000
chr10,78504806,78530011,25205,-1,0,,0,0.00000000000000000000
chr10,78800831,78801245,414,-1,0,3778,1,241.54589371980700000000
chr10,79685784,79687008,1224,-1,0,9231,1,81.69934640522880000000
chr10,79694565,79695332,767,-1,0,,0,0.00000000000000000000
chr10,80143307,80144402,1095,-1,0,,0,0.00000000000000000000
chr10,80404493,80405650,1157,-1,0,,0,0.00000000000000000000
chr10,80446010,80447267,1257,-1,0,,0,0.00000000000000000000
chr10,80666035,80667199,1164,-1,0,,0,0.00000000000000000000
chr10,80709199,80709628,429,-1,0,,0,0.00000000000000000000
chr10,80879691,80879748,57,-1,0,57178,1,1754.38596491228000000000
chr10,80935210,80936457,1247,-1,0,57178,1,80.19246190858060000000
chr10,81002357,81003538,1181,-1,0,57178,1,84.67400508044030000000
chr10,81092145,81092815,670,-1,0,,0,0.00000000000000000000
chr10,81154264,81155586,1322,-1,0,219654,1,75.64296520423600000000
chr10,81176701,81177356,655,-1,0,219654,1,152.67175572519100000000
chr10,81176902,81177142,240,-1,0,219654,1,416.66666666666700000000
chr10,81187916,81188447,531,-1,0,219654,1,188.32391713747600000000
chr10,81251577,81541398,289821,-1,0,729262;143244;653509;729238,4,1.38016223807109000000
chr10,81683983,81903655,219672,-1,0,6441;80195;219348,3,1.36567245711788000000
chr10,81439094,81556708,117614,-1,0,729262,1,0.85023891713571500000
chr10,81505304,81602509,97205,-1,0,,0,0.00000000000000000000
chr10,81561459,81622291,60832,-1,0,,0,0.00000000000000000000
chr10,81473792,81503301,29509,-1,0,,0,0.00000000000000000000
chr10,81562375,81596657,34282,-1,0,,0,0.00000000000000000000
chr10,81781977,81811446,29469,-1,0,,0,0.00000000000000000000
chr10,81482850,81502356,19506,-1,0,,0,0.00000000000000000000
chr10,81846343,81862988,16645,-1,0,80195,1,6.00781015319916000000
chr10,81971063,81985191,14128,-1,0,,0,0.00000000000000000000
chr10,81780682,81794068,13386,-1,0,,0,0.00000000000000000000
chr10,81784174,81792277,8103,-1,0,,0,0.00000000000000000000
chr10,81672294,81679650,7356,-1,0,,0,0.00000000000000000000
chr10,81725283,81727425,2142,-1,0,,0,0.00000000000000000000
chr10,81662653,81663560,907,-1,0,,0,0.00000000000000000000
chr10,81695836,81695991,155,-1,0,,0,0.00000000000000000000
chr10,82213750,82214470,720,-1,0,81619,1,138.88888888888900000000
chr10,82750275,82752647,2372,-1,0,,0,0.00000000000000000000
chr10,82711775,82712799,1024,-1,0,,0,0.00000000000000000000
chr10,82737736,82738056,320,-1,0,,0,0.00000000000000000000
chr10,82879339,82891659,12320,-1,0,,0,0.00000000000000000000
chr10,82878420,82889311,10891,-1,0,,0,0.00000000000000000000
chr10,82904557,82905015,458,-1,0,,0,0.00000000000000000000
chr10,82904659,82904913,254,-1,0,,0,0.00000000000000000000
chr10,83248655,83251702,3047,-1,0,,0,0.00000000000000000000
chr10,83295903,83310930,15027,-1,0,,0,0.00000000000000000000
chr10,83461047,83462304,1257,-1,0,,0,0.00000000000000000000
chr10,83634119,83635177,1058,-1,0,10718,1,94.51795841209830000000
chr10,83844078,83849074,4996,-1,0,10718,1,20.01601281024820000000
chr10,83883158,83889042,5884,-1,0,10718,1,16.99524133242690000000
chr10,83885386,83888488,3102,-1,0,10718,1,32.23726627981950000000
chr10,83941834,83961066,19232,-1,0,10718,1,5.19966722129784000000
chr10,84042684,84064093,21409,-1,0,10718,1,4.67093278527722000000
chr10,84172318,84240172,67854,-1,0,10718,1,1.47375246853538000000
chr10,84125822,84131993,6171,-1,0,10718,1,16.20482903905360000000
chr10,84127815,84130359,2544,-1,0,10718,1,39.30817610062890000000
chr10,84237948,84238493,545,-1,0,10718,1,183.48623853211000000000
chr10,84400630,84401043,413,-1,0,10718,1,242.13075060532700000000
chr10,84400763,84400912,149,-1,0,10718,1,671.14093959731500000000
chr10,84712335,84717565,5230,-1,0,10718,1,19.12045889101340000000
chr10,84817525,84818452,927,-1,0,,0,0.00000000000000000000
chr10,84936578,84939799,3221,-1,0,,0,0.00000000000000000000
chr10,84946523,84947881,1358,-1,0,,0,0.00000000000000000000
chr10,84947146,84947741,595,-1,0,,0,0.00000000000000000000
chr10,85129402,85129626,224,-1,0,,0,0.00000000000000000000
chr10,85350564,85352012,1448,-1,0,,0,0.00000000000000000000
chr10,85375924,85376144,220,-1,0,,0,0.00000000000000000000
chr10,85522721,85523924,1203,-1,0,,0,0.00000000000000000000
chr10,85545460,85553055,7595,-1,0,,0,0.00000000000000000000
chr10,85626115,85626552,437,-1,0,,0,0.00000000000000000000
chr10,85626209,85626450,241,-1,0,,0,0.00000000000000000000
chr10,85634842,85642720,7878,-1,0,,0,0.00000000000000000000
chr10,85650104,85653488,3384,-1,0,,0,0.00000000000000000000
chr10,86285184,86290215,5031,-1,0,,0,0.00000000000000000000
chr10,86346007,86381784,35777,-1,0,,0,0.00000000000000000000
chr10,86445678,86446819,1141,-1,0,,0,0.00000000000000000000
chr10,86738637,86748774,10137,-1,0,,0,0.00000000000000000000
chr10,86863688,86866252,2564,-1,0,,0,0.00000000000000000000
chr10,87021859,87022571,712,-1,0,,0,0.00000000000000000000
chr10,87024996,87033567,8571,-1,0,,0,0.00000000000000000000
chr10,87256212,87257290,1078,-1,0,,0,0.00000000000000000000
chr10,87380154,87382083,1929,-1,0,2894,1,51.84033177812340000000
chr10,87569823,87570022,199,-1,0,2894,1,502.51256281407000000000
chr10,87755783,87761701,5918,-1,0,2894,1,16.89760054072320000000
chr10,87801019,87808561,7542,-1,0,2894,1,13.25908247149300000000
chr10,87952269,87959897,7628,-1,0,2894,1,13.10959622443630000000
chr10,87956566,87956992,426,-1,0,2894,1,234.74178403755900000000
chr10,87998043,88064402,66359,-1,0,2894,1,1.50695459545804000000
chr10,88125658,88127381,1723,-1,0,2894,1,58.03830528148580000000
chr10,88321646,88326601,4955,-1,0,,0,0.00000000000000000000
chr10,88666150,88666587,437,-1,0,657,1,228.83295194508000000000
chr10,88702202,88703062,860,-1,0,79812,1,116.27906976744200000000
chr10,88742584,88784503,41919,-1,0,119385;643161,2,4.77110618096806000000
chr10,88785766,88787983,2217,-1,0,,0,0.00000000000000000000
chr10,88828505,88846699,18194,-1,0,2746,1,5.49631746729691000000
chr10,88873926,88978162,104236,-1,0,54537,1,0.95936144901953300000
chr10,88982271,89119069,136798,-1,0,728118,1,0.73100483925203600000
chr10,89156342,89259264,102922,-1,0,,0,0.00000000000000000000
chr10,89057554,89113229,55675,-1,0,,0,0.00000000000000000000
chr10,89150009,89189844,39835,-1,0,,0,0.00000000000000000000
chr10,88996685,89025955,29270,-1,0,,0,0.00000000000000000000
chr10,89079429,89114090,34661,-1,0,,0,0.00000000000000000000
chr10,89232671,89258852,26181,-1,0,,0,0.00000000000000000000
chr10,89228130,89244931,16801,-1,0,,0,0.00000000000000000000
chr10,89003545,89019504,15959,-1,0,,0,0.00000000000000000000
chr10,89274414,89278054,3640,-1,0,9562,1,27.47252747252750000000
chr10,89275799,89276562,763,-1,0,9562,1,131.06159895150700000000
chr10,89275944,89276461,517,-1,0,9562,1,193.42359767891700000000
chr10,89618276,89619826,1550,-1,0,100144748,1,64.51612903225810000000
chr10,89652822,89653724,902,-1,0,5728,1,110.86474501108600000000
chr10,90100156,90103130,2974,-1,0,55328,1,33.62474781439140000000
chr10,90454890,90455221,331,-1,0,,0,0.00000000000000000000
chr10,90941386,90963571,22185,-1,0,,0,0.00000000000000000000
chr10,90940134,90948158,8024,-1,0,,0,0.00000000000000000000
chr10,90942713,90947711,4998,-1,0,,0,0.00000000000000000000
chr10,90943326,90950094,6768,-1,0,,0,0.00000000000000000000
chr10,90949069,90950308,1239,-1,0,,0,0.00000000000000000000
chr10,90963736,90964450,714,-1,0,,0,0.00000000000000000000
chr10,91499116,91499454,338,-1,0,9585,1,295.85798816568000000000
chr10,91547381,91547804,423,-1,0,,0,0.00000000000000000000
chr10,91996445,92004242,7797,-1,0,,0,0.00000000000000000000
chr10,91998554,92002033,3479,-1,0,,0,0.00000000000000000000
chr10,91809895,91810297,402,-1,0,,0,0.00000000000000000000
chr10,92087638,92088292,654,-1,0,,0,0.00000000000000000000
chr10,92274334,92275227,893,-1,0,,0,0.00000000000000000000
chr10,92391507,92396818,5311,-1,0,,0,0.00000000000000000000
chr10,92461856,92465621,3765,-1,0,,0,0.00000000000000000000
chr10,92463911,92465016,1105,-1,0,,0,0.00000000000000000000
chr10,92815382,92815704,322,-1,0,,0,0.00000000000000000000
chr10,92924477,92933889,9412,-1,0,84333,1,10.62473438164050000000
chr10,92969124,92969658,534,-1,0,84333,1,187.26591760299600000000
chr10,92969229,92969569,340,-1,0,84333,1,294.11764705882400000000
chr10,93070582,93079391,8809,-1,0,,0,0.00000000000000000000
chr10,93104560,93110116,5556,-1,0,,0,0.00000000000000000000
chr10,93199230,93216206,16976,-1,0,143279,1,5.89066918001885000000
chr10,93395878,93396458,580,-1,0,,0,0.00000000000000000000
chr10,93631545,93634792,3247,-1,0,,0,0.00000000000000000000
chr10,93633333,93634562,1229,-1,0,,0,0.00000000000000000000
chr10,93634028,93634625,597,-1,0,,0,0.00000000000000000000
chr10,93668098,93668730,632,-1,0,143282,1,158.22784810126600000000
chr10,93957546,93980451,22905,-1,0,22849,1,4.36585898275486000000
chr10,94079569,94082764,3195,-1,0,54708,1,31.29890453834120000000
chr10,94134431,94137765,3334,-1,0,,0,0.00000000000000000000
chr10,94159863,94169359,9496,-1,0,,0,0.00000000000000000000
chr10,94202726,94205127,2401,-1,0,,0,0.00000000000000000000
chr10,94433334,94435814,2480,-1,0,,0,0.00000000000000000000
chr10,94449208,94450485,1277,-1,0,3087,1,78.30853563038370000000
chr10,94624368,94633292,8924,-1,0,54536,1,11.20573733751680000000
chr10,95041739,95045764,4025,-1,0,,0,0.00000000000000000000
chr10,95086496,95087627,1131,-1,0,26509,1,88.41732979664010000000
chr10,95186636,95187994,1358,-1,0,26509,1,73.63770250368190000000
chr10,95416399,95417009,610,-1,0,5146,1,163.93442622950800000000
chr10,95545481,95546496,1015,-1,0,9211,1,98.52216748768470000000
chr10,96162411,96163346,935,-1,0,23232,1,106.95187165775400000000
chr10,96241029,96241215,186,-1,0,23232,1,537.63440860215100000000
chr10,96251418,96251907,489,-1,0,23232,1,204.49897750511200000000
chr10,96251540,96251717,177,-1,0,23232,1,564.97175141242900000000
chr10,96518463,96704940,186477,-1,0,1559;1557,2,1.07251832665691000000
chr10,96440166,96662263,222097,-1,0,1557;1562,2,0.90050743594015200000
chr10,96570102,96725910,155808,-1,0,1559;1557,2,1.28363113575683000000
chr10,96404171,96499227,95056,-1,0,1562,1,1.05201144588453000000
chr10,96496566,96564496,67930,-1,0,1557,1,1.47210363609598000000
chr10,96865481,96875599,10118,-1,0,,0,0.00000000000000000000
chr10,96870437,96874705,4268,-1,0,,0,0.00000000000000000000
chr10,96870714,96872866,2152,-1,0,,0,0.00000000000000000000
chr10,96870593,96872319,1726,-1,0,,0,0.00000000000000000000
chr10,96871261,96872585,1324,-1,0,,0,0.00000000000000000000
chr10,97207044,97208239,1195,-1,0,10580,1,83.68200836820080000000
chr10,97425809,97439472,13663,-1,0,26123,1,7.31903681475518000000
chr10,97569586,97570005,419,-1,0,953,1,238.66348448687400000000
chr10,98161362,98163114,1752,-1,0,7093,1,57.07762557077630000000
chr10,98417589,98420701,3112,-1,0,118788,1,32.13367609254500000000
chr10,98537088,98537530,442,-1,0,,0,0.00000000000000000000
chr10,98537147,98537455,308,-1,0,,0,0.00000000000000000000
chr10,98968783,98971607,2824,-1,0,,0,0.00000000000000000000
chr10,99034660,99037672,3012,-1,0,84986,1,33.20053120849930000000
chr10,99108165,99108717,552,-1,0,,0,0.00000000000000000000
chr10,99108270,99108600,330,-1,0,,0,0.00000000000000000000
chr10,99418896,99420160,1264,-1,0,55361,1,79.11392405063290000000
chr10,99443600,99444451,851,-1,0,60370,1,117.50881316098700000000
chr10,99484906,99494356,9450,-1,0,,0,0.00000000000000000000
chr10,99589607,99589678,71,-1,0,,0,0.00000000000000000000
chr10,99743004,99743341,337,-1,0,55118,1,296.73590504451000000000
chr10,99804084,99804331,247,-1,0,,0,0.00000000000000000000
chr10,99834963,99837410,2447,-1,0,,0,0.00000000000000000000
chr10,100025123,100025461,338,-1,0,84171,1,295.85798816568000000000
chr10,100167342,100167733,391,-1,0,84795,1,255.75447570332500000000
chr10,100375784,100378981,3197,-1,0,60495,1,31.27932436659370000000
chr10,100496977,100497288,311,-1,0,60495,1,321.54340836012900000000
chr10,100686978,100703811,16833,-1,0,60495,1,5.94071169726133000000
chr10,100688622,100696372,7750,-1,0,60495,1,12.90322580645160000000
chr10,100688866,100689687,821,-1,0,60495,1,121.80267965895200000000
chr10,101445711,101447069,1358,-1,0,57089,1,73.63770250368190000000
chr10,101577147,101639872,62725,-1,0,23268;1244,2,3.18852132323635000000
chr10,101707564,101709309,1745,-1,0,23268,1,57.30659025787970000000
chr10,102009710,102050514,40804,-1,0,9033;282991;55280,3,7.35222037055191000000
chr10,102158280,102159561,1281,-1,0,,0,0.00000000000000000000
chr10,102158612,102159668,1056,-1,0,,0,0.00000000000000000000
chr10,102179793,102180362,569,-1,0,,0,0.00000000000000000000
chr10,102191915,102211789,19874,-1,0,,0,0.00000000000000000000
chr10,102200477,102207192,6715,-1,0,,0,0.00000000000000000000
chr10,102354535,102362053,7518,-1,0,,0,0.00000000000000000000
chr10,102410610,102411056,446,-1,0,,0,0.00000000000000000000
chr10,102956985,102957621,636,-1,0,,0,0.00000000000000000000
chr10,103042878,103044696,1818,-1,0,,0,0.00000000000000000000
chr10,103355971,103356623,652,-1,0,25911,1,153.37423312883400000000
chr10,103394011,103395092,1081,-1,0,6468,1,92.50693802035150000000
chr10,103445644,103446257,613,-1,0,6468,1,163.13213703099500000000
chr10,103943490,103970408,26918,-1,0,,0,0.00000000000000000000
chr10,103976066,103976788,722,-1,0,,0,0.00000000000000000000
chr10,104289661,104290965,1304,-1,0,51684,1,76.68711656441720000000
chr10,104528191,104528640,449,-1,0,54838,1,222.71714922049000000000
chr10,104645182,104645620,438,-1,0,57412,1,228.31050228310500000000
chr10,105053194,105054209,1015,-1,0,,0,0.00000000000000000000
chr10,105069751,105070961,1210,-1,0,84108,1,82.64462809917350000000
chr10,105097482,105097887,405,-1,0,84108,1,246.91358024691400000000
chr10,105116563,105122711,6148,-1,0,,0,0.00000000000000000000
chr10,105221248,105222663,1415,-1,0,,0,0.00000000000000000000
chr10,105248723,105252392,3669,-1,0,,0,0.00000000000000000000
chr10,105460619,105461059,440,-1,0,9644,1,227.27272727272700000000
chr10,105460764,105460851,87,-1,0,9644,1,1149.42528735632000000000
chr10,105570649,105570709,60,-1,0,9644,1,1666.66666666667000000000
chr10,105715794,105720701,4907,-1,0,,0,0.00000000000000000000
chr10,106016912,106052341,35429,-1,0,9446;119391,2,5.64509300290722000000
chr10,106104326,106107870,3544,-1,0,,0,0.00000000000000000000
chr10,106739577,106741171,1594,-1,0,22986,1,62.73525721455460000000
chr10,106850981,106851272,291,-1,0,22986,1,343.64261168384900000000
chr10,107056483,107062298,5815,-1,0,,0,0.00000000000000000000
chr10,107056654,107059170,2516,-1,0,,0,0.00000000000000000000
chr10,107252921,107253429,508,-1,0,,0,0.00000000000000000000
chr10,107252998,107253351,353,-1,0,,0,0.00000000000000000000
chr10,107431796,107431898,102,-1,0,,0,0.00000000000000000000
chr10,107616187,107688477,72290,-1,0,,0,0.00000000000000000000
chr10,107698688,107699234,546,-1,0,,0,0.00000000000000000000
chr10,107677542,107677868,326,-1,0,,0,0.00000000000000000000
chr10,107888108,107888292,184,-1,0,,0,0.00000000000000000000
chr10,107950677,107951606,929,-1,0,,0,0.00000000000000000000
chr10,107984422,108021001,36579,-1,0,,0,0.00000000000000000000
chr10,107995980,107997744,1764,-1,0,,0,0.00000000000000000000
chr10,107996743,107997659,916,-1,0,,0,0.00000000000000000000
chr10,107996946,107997616,670,-1,0,,0,0.00000000000000000000
chr10,107997217,107997339,122,-1,0,,0,0.00000000000000000000
chr10,108010505,108010630,125,-1,0,,0,0.00000000000000000000
chr10,107997186,107997290,104,-1,0,,0,0.00000000000000000000
chr10,108030362,108032534,2172,-1,0,,0,0.00000000000000000000
chr10,108110936,108111995,1059,-1,0,,0,0.00000000000000000000
chr10,109183196,109191051,7855,-1,0,,0,0.00000000000000000000
chr10,109638472,109639697,1225,-1,0,,0,0.00000000000000000000
chr10,109728756,109729141,385,-1,0,,0,0.00000000000000000000
chr10,109825331,109884123,58792,-1,0,,0,0.00000000000000000000
chr10,110257410,110268228,10818,-1,0,,0,0.00000000000000000000
chr10,110302890,110314669,11779,-1,0,,0,0.00000000000000000000
chr10,110695832,110696175,343,-1,0,,0,0.00000000000000000000
chr10,110916884,110919349,2465,-1,0,,0,0.00000000000000000000
chr10,110924821,111046932,122111,-1,0,,0,0.00000000000000000000
chr10,111036261,111036830,569,-1,0,,0,0.00000000000000000000
chr10,111036378,111036697,319,-1,0,,0,0.00000000000000000000
chr10,111202340,111333964,131624,-1,0,,0,0.00000000000000000000
chr10,111284431,111397463,113032,-1,0,,0,0.00000000000000000000
chr10,111571869,111578362,6493,-1,0,,0,0.00000000000000000000
chr10,111789853,111790836,983,-1,0,120,1,101.72939979654100000000
chr10,111903766,111906205,2439,-1,0,,0,0.00000000000000000000
chr10,111936883,111938457,1574,-1,0,,0,0.00000000000000000000
chr10,112011843,112014818,2975,-1,0,4601,1,33.61344537815130000000
chr10,112438441,112441984,3543,-1,0,282996,1,28.22466836014680000000
chr10,112480237,112480652,415,-1,0,282996,1,240.96385542168700000000
chr10,112842308,112845220,2912,-1,0,,0,0.00000000000000000000
chr10,112908855,112910036,1181,-1,0,,0,0.00000000000000000000
chr10,112917336,113002053,84717,-1,0,,0,0.00000000000000000000
chr10,113139572,113141933,2361,-1,0,,0,0.00000000000000000000
chr10,113350803,113367788,16985,-1,0,,0,0.00000000000000000000
chr10,113189828,113191893,2065,-1,0,,0,0.00000000000000000000
chr10,113191498,113191950,452,-1,0,,0,0.00000000000000000000
chr10,113409550,113412527,2977,-1,0,,0,0.00000000000000000000
chr10,113539708,113541162,1454,-1,0,,0,0.00000000000000000000
chr10,113996136,114001234,5098,-1,0,,0,0.00000000000000000000
chr10,114112176,114116662,4486,-1,0,,0,0.00000000000000000000
chr10,114157725,114158187,462,-1,0,51703,1,216.45021645021600000000
chr10,114157784,114158122,338,-1,0,51703,1,295.85798816568000000000
chr10,114877148,114877205,57,-1,0,6934,1,1754.38596491228000000000
chr10,115136646,115136730,84,-1,0,,0,0.00000000000000000000
chr10,115207430,115217433,10003,-1,0,,0,0.00000000000000000000
chr10,115208213,115210176,1963,-1,0,,0,0.00000000000000000000
chr10,115427092,115433938,6846,-1,0,,0,0.00000000000000000000
chr10,115438417,115438845,428,-1,0,,0,0.00000000000000000000
chr10,115509097,115509468,371,-1,0,,0,0.00000000000000000000
chr10,115861720,115862030,310,-1,0,,0,0.00000000000000000000
chr10,116270067,116271570,1503,-1,0,3983,1,66.53359946773120000000
chr10,116488139,116491399,3260,-1,0,3983,1,30.67484662576690000000
chr10,116541412,116544731,3319,-1,0,,0,0.00000000000000000000
chr10,116719598,116730831,11233,-1,0,142940,1,8.90234131576605000000
chr10,117384846,117390500,5654,-1,0,26033,1,17.68659356207990000000
chr10,117473527,117474397,870,-1,0,26033,1,114.94252873563200000000
chr10,117711613,117711999,386,-1,0,,0,0.00000000000000000000
chr10,118265297,118265732,435,-1,0,,0,0.00000000000000000000
chr10,118457392,118457780,388,-1,0,259217,1,257.73195876288700000000
chr10,118765983,118769115,3132,-1,0,57698,1,31.92848020434230000000
chr10,119050892,119059967,9075,-1,0,118987,1,11.01928374655650000000
chr10,119154236,119155156,920,-1,0,,0,0.00000000000000000000
chr10,119219111,119219451,340,-1,0,,0,0.00000000000000000000
chr10,119330093,119330685,592,-1,0,,0,0.00000000000000000000
chr10,119330248,119330432,184,-1,0,,0,0.00000000000000000000
chr10,119634159,119634728,569,-1,0,,0,0.00000000000000000000
chr10,119634283,119634614,331,-1,0,,0,0.00000000000000000000
chr10,119979068,119979641,573,-1,0,,0,0.00000000000000000000
chr10,119979190,119979505,315,-1,0,,0,0.00000000000000000000
chr10,120105662,120107194,1532,-1,0,,0,0.00000000000000000000
chr10,120175182,120178349,3167,-1,0,,0,0.00000000000000000000
chr10,120225115,120226351,1236,-1,0,,0,0.00000000000000000000
chr10,120575735,120576529,794,-1,0,,0,0.00000000000000000000
chr10,120602692,120602867,175,-1,0,,0,0.00000000000000000000
chr10,120707059,120707864,805,-1,0,,0,0.00000000000000000000
chr10,121046781,121046916,135,-1,0,2869,1,740.74074074074100000000
chr10,121046817,121046885,68,-1,0,2869,1,1470.58823529412000000000
chr10,121065240,121067917,2677,-1,0,2869,1,37.35524841240190000000
chr10,121153002,121154858,1856,-1,0,2869,1,53.87931034482760000000
chr10,121154087,121154624,537,-1,0,2869,1,186.21973929236500000000
chr10,121154357,121154650,293,-1,0,2869,1,341.29692832764500000000
chr10,121154018,121154247,229,-1,0,2869,1,436.68122270742400000000
chr10,121186472,121186930,458,-1,0,2869,1,218.34061135371200000000
chr10,121187112,121187342,230,-1,0,2869,1,434.78260869565200000000
chr10,121315614,121317122,1508,-1,0,,0,0.00000000000000000000
chr10,121533527,121539837,6310,-1,0,22876,1,15.84786053882730000000
chr10,121712915,121713349,434,-1,0,,0,0.00000000000000000000
chr10,121874384,121884097,9713,-1,0,,0,0.00000000000000000000
chr10,122117982,122118478,496,-1,0,,0,0.00000000000000000000
chr10,122118131,122118361,230,-1,0,,0,0.00000000000000000000
chr10,122132120,122138655,6535,-1,0,,0,0.00000000000000000000
chr10,122226030,122230390,4360,-1,0,196051,1,22.93577981651380000000
chr10,122226691,122228857,2166,-1,0,196051,1,46.16805170821790000000
chr10,122425987,122427475,1488,-1,0,,0,0.00000000000000000000
chr10,122570633,122572220,1587,-1,0,,0,0.00000000000000000000
chr10,122701013,122701560,547,-1,0,,0,0.00000000000000000000
chr10,122701142,122701437,295,-1,0,,0,0.00000000000000000000
chr10,122769619,122787706,18087,-1,0,,0,0.00000000000000000000
chr10,122762378,122777679,15301,-1,0,,0,0.00000000000000000000
chr10,122769815,122781172,11357,-1,0,,0,0.00000000000000000000
chr10,122770681,122771341,660,-1,0,,0,0.00000000000000000000
chr10,123362445,123363335,890,-1,0,,0,0.00000000000000000000
chr10,123402935,123409651,6716,-1,0,,0,0.00000000000000000000
chr10,123433367,123461737,28370,-1,0,,0,0.00000000000000000000
chr10,123471624,123476625,5001,-1,0,,0,0.00000000000000000000
chr10,123489154,123489554,400,-1,0,,0,0.00000000000000000000
chr10,123489181,123489494,313,-1,0,,0,0.00000000000000000000
chr10,123944846,123946230,1384,-1,0,10579,1,72.25433526011560000000
chr10,124216798,124217447,649,-1,0,387715,1,154.08320493066300000000
chr10,124339835,124381544,41709,-1,0,1755,1,2.39756407489990000000
chr10,124341036,124359619,18583,-1,0,1755,1,5.38126244416940000000
chr10,124360450,124376939,16489,-1,0,1755,1,6.06464916004609000000
chr10,124358168,124373173,15005,-1,0,1755,1,6.66444518493835000000
chr10,124344415,124353319,8904,-1,0,1755,1,11.23090745732260000000
chr10,124342403,124351140,8737,-1,0,1755,1,11.44557628476590000000
chr10,124369219,124377456,8237,-1,0,1755,1,12.14034235765450000000
chr10,124964699,124997512,32813,-1,0,,0,0.00000000000000000000
chr10,125051673,125053123,1450,-1,0,,0,0.00000000000000000000
chr10,125290272,125291591,1319,-1,0,,0,0.00000000000000000000
chr10,125442629,125442690,61,-1,0,2849,1,1639.34426229508000000000
chr10,125742267,125744303,2036,-1,0,,0,0.00000000000000000000
chr10,125955743,125959276,3533,-1,0,,0,0.00000000000000000000
chr10,126068925,126074503,5578,-1,0,,0,0.00000000000000000000
chr10,126124164,126128881,4717,-1,0,,0,0.00000000000000000000
chr10,126129371,126129911,540,-1,0,,0,0.00000000000000000000
chr10,126188330,126194432,6102,-1,0,64077,1,16.38806948541460000000
chr10,126195241,126196435,1194,-1,0,64077,1,83.75209380234510000000
chr10,126298944,126299534,590,-1,0,64077,1,169.49152542372900000000
chr10,126486610,126489466,2856,-1,0,,0,0.00000000000000000000
chr10,126577732,126579582,1850,-1,0,,0,0.00000000000000000000
chr10,126611800,126612609,809,-1,0,,0,0.00000000000000000000
chr10,126855921,126859397,3476,-1,0,,0,0.00000000000000000000
chr10,126880460,126882000,1540,-1,0,,0,0.00000000000000000000
chr10,127002416,127004966,2550,-1,0,,0,0.00000000000000000000
chr10,127032452,127033486,1034,-1,0,,0,0.00000000000000000000
chr10,127191621,127197281,5660,-1,0,,0,0.00000000000000000000
chr10,127303220,127397197,93977,-1,0,387718,1,1.06409014971748000000
chr10,127573848,127617466,43618,-1,0,92565,1,2.29263148241552000000
chr10,127745010,127746208,1198,-1,0,8038,1,83.47245409015030000000
chr10,127745183,127745984,801,-1,0,8038,1,124.84394506866400000000
chr10,128037126,128040710,3584,-1,0,8038,1,27.90178571428570000000
chr10,128106261,128107244,983,-1,0,,0,0.00000000000000000000
chr10,128106456,128106831,375,-1,0,,0,0.00000000000000000000
chr10,128371489,128569679,198190,-1,0,,0,0.00000000000000000000
chr10,128611548,128833854,222306,-1,0,1793,1,0.44983041393394700000
chr10,128588854,128592213,3359,-1,0,,0,0.00000000000000000000
chr10,128856284,128856948,664,-1,0,1793,1,150.60240963855400000000
chr10,128605280,128605797,517,-1,0,1793,1,193.42359767891700000000
chr10,128605426,128605684,258,-1,0,1793,1,387.59689922480600000000
chr10,129145728,129146842,1114,-1,0,1793,1,89.76660682226210000000
chr10,129355096,129355308,212,-1,0,,0,0.00000000000000000000
chr10,129565182,129565740,558,-1,0,,0,0.00000000000000000000
chr10,129565313,129565619,306,-1,0,,0,0.00000000000000000000
chr10,129744649,129744864,215,-1,0,5791,1,465.11627906976700000000
chr10,129808740,129813728,4988,-1,0,5791,1,20.04811547714510000000
chr10,129935564,129935877,313,-1,0,,0,0.00000000000000000000
chr10,129946607,129950133,3526,-1,0,,0,0.00000000000000000000
chr10,129946563,129946884,321,-1,0,,0,0.00000000000000000000
chr10,130007552,130007603,51,-1,0,,0,0.00000000000000000000
chr10,130180981,130181418,437,-1,0,,0,0.00000000000000000000
chr10,130181023,130181282,259,-1,0,,0,0.00000000000000000000
chr10,130255983,130262424,6441,-1,0,,0,0.00000000000000000000
chr10,130447035,130447094,59,-1,0,,0,0.00000000000000000000
chr10,130774718,130775180,462,-1,0,,0,0.00000000000000000000
chr10,130836823,130837289,466,-1,0,,0,0.00000000000000000000
chr10,130906995,130907193,198,-1,0,,0,0.00000000000000000000
chr10,131017558,131021151,3593,-1,0,,0,0.00000000000000000000
chr10,131047811,131047983,172,-1,0,,0,0.00000000000000000000
chr10,131416114,131417045,931,-1,0,4255,1,107.41138560687400000000
chr10,131595066,131595550,484,-1,0,,0,0.00000000000000000000
chr10,131595172,131595472,300,-1,0,,0,0.00000000000000000000
chr10,131854017,131901584,47567,-1,0,,0,0.00000000000000000000
chr10,131985881,131986521,640,-1,0,,0,0.00000000000000000000
chr10,132158361,132159076,715,-1,0,,0,0.00000000000000000000
chr10,132158489,132158884,395,-1,0,,0,0.00000000000000000000
chr10,132158427,132158752,325,-1,0,,0,0.00000000000000000000
chr10,132158753,132159019,266,-1,0,,0,0.00000000000000000000
chr10,132181786,132182833,1047,-1,0,,0,0.00000000000000000000
chr10,132181957,132182613,656,-1,0,,0,0.00000000000000000000
chr10,132182186,132182368,182,-1,0,,0,0.00000000000000000000
chr10,132256972,132258342,1370,-1,0,,0,0.00000000000000000000
chr10,132257683,132258500,817,-1,0,,0,0.00000000000000000000
chr10,132257725,132258266,541,-1,0,,0,0.00000000000000000000
chr10,132257669,132257749,80,-1,0,,0,0.00000000000000000000
chr10,132258768,132259699,931,-1,0,,0,0.00000000000000000000
chr10,132317196,132321009,3813,-1,0,,0,0.00000000000000000000
chr10,132371984,132372514,530,-1,0,,0,0.00000000000000000000
chr10,132372179,132372324,145,-1,0,,0,0.00000000000000000000
chr10,132557278,132559052,1774,-1,0,,0,0.00000000000000000000
chr10,132586647,132586834,187,-1,0,,0,0.00000000000000000000
chr10,132635397,132638422,3025,-1,0,,0,0.00000000000000000000
chr10,132660731,132663351,2620,-1,0,,0,0.00000000000000000000
chr10,132636363,132638496,2133,-1,0,,0,0.00000000000000000000
chr10,132714282,132715394,1112,-1,0,,0,0.00000000000000000000
chr10,132716732,132716835,103,-1,0,,0,0.00000000000000000000
chr10,132825952,132826453,501,-1,0,,0,0.00000000000000000000
chr10,132826081,132826232,151,-1,0,,0,0.00000000000000000000
chr10,132839395,132841842,2447,-1,0,,0,0.00000000000000000000
chr10,132840665,132841515,850,-1,0,,0,0.00000000000000000000
chr10,132840244,132841315,1071,-1,0,,0,0.00000000000000000000
chr10,132840678,132841346,668,-1,0,,0,0.00000000000000000000
chr10,132840383,132840942,559,-1,0,,0,0.00000000000000000000
chr10,132858400,132858958,558,-1,0,,0,0.00000000000000000000
chr10,132858490,132858823,333,-1,0,,0,0.00000000000000000000
chr10,133005817,133018721,12904,-1,0,256536,1,7.74953502789833000000
chr10,132908893,132913267,4374,-1,0,256536,1,22.86236854138090000000
chr10,132988055,132991798,3743,-1,0,256536,1,26.71653753673520000000
chr10,132988473,132991141,2668,-1,0,256536,1,37.48125937031480000000
chr10,133026467,133027073,606,-1,0,256536,1,165.01650165016500000000
chr10,133087557,133088559,1002,-1,0,256536,1,99.80039920159680000000
chr10,133099001,133104166,5165,-1,0,256536,1,19.36108422071640000000
chr10,133142501,133143033,532,-1,0,,0,0.00000000000000000000
chr10,133142553,133142848,295,-1,0,,0,0.00000000000000000000
chr10,133161882,133162291,409,-1,0,,0,0.00000000000000000000
chr10,133184065,133184894,829,-1,0,,0,0.00000000000000000000
chr10,133192705,133193172,467,-1,0,,0,0.00000000000000000000
chr10,133260763,133260824,61,-1,0,,0,0.00000000000000000000
chr10,133447501,133458100,10599,-1,0,,0,0.00000000000000000000
chr10,133455067,133459247,4180,-1,0,,0,0.00000000000000000000
chr10,133449086,133449488,402,-1,0,,0,0.00000000000000000000
chr10,133471771,133474208,2437,-1,0,,0,0.00000000000000000000
chr10,133528645,133529948,1303,-1,0,,0,0.00000000000000000000
chr10,133526710,133528433,1723,-1,0,,0,0.00000000000000000000
chr10,133572585,133573029,444,-1,0,,0,0.00000000000000000000
chr10,133572785,133572843,58,-1,0,,0,0.00000000000000000000
chr10,133644080,133669401,25321,-1,0,,0,0.00000000000000000000
chr10,133647132,133659314,12182,-1,0,,0,0.00000000000000000000
chr10,133655298,133656759,1461,-1,0,,0,0.00000000000000000000
chr10,133656321,133656740,419,-1,0,,0,0.00000000000000000000
chr10,133729577,133734327,4750,-1,0,,0,0.00000000000000000000
chr10,133752391,133753254,863,-1,0,55844,1,115.87485515643100000000
chr10,133765487,133767363,1876,-1,0,55844,1,53.30490405117270000000
chr10,133839166,133841652,2486,-1,0,,0,0.00000000000000000000
chr10,133972134,133975314,3180,-1,0,282973,1,31.44654088050310000000
chr10,134004426,134005658,1232,-1,0,10570,1,81.16883116883120000000
chr10,133975333,133975641,308,-1,0,282973,1,324.67532467532500000000
chr10,133937814,133938189,375,-1,0,282973,1,266.66666666666700000000
chr10,134067889,134068406,517,-1,0,282974,1,193.42359767891700000000
chr10,134035078,134035512,434,-1,0,282974,1,230.41474654377900000000
chr10,134067912,134068227,315,-1,0,282974,1,317.46031746031700000000
chr10,134072528,134072590,62,-1,0,282974,1,1612.90322580645000000000
chr10,134165388,134166311,923,-1,0,80313,1,108.34236186348900000000
chr10,134171937,134173089,1152,-1,0,80313,1,86.80555555555560000000
chr10,134171805,134172568,763,-1,0,80313,1,131.06159895150700000000
chr10,134177864,134178429,565,-1,0,80313,1,176.99115044247800000000
chr10,134176190,134176746,556,-1,0,80313,1,179.85611510791400000000
chr10,134171886,134172352,466,-1,0,80313,1,214.59227467811200000000
chr10,134175976,134176428,452,-1,0,80313,1,221.23893805309700000000
chr10,134178044,134178232,188,-1,0,80313,1,531.91489361702100000000
chr10,134178118,134178241,123,-1,0,80313,1,813.00813008130100000000
chr10,134249212,134249988,776,-1,0,,0,0.00000000000000000000
chr10,134217320,134217761,441,-1,0,170394,1,226.75736961451200000000
chr10,134249511,134250081,570,-1,0,,0,0.00000000000000000000
chr10,134253742,134254258,516,-1,0,,0,0.00000000000000000000
chr10,134256624,134256828,204,-1,0,,0,0.00000000000000000000
chr10,134318768,134320259,1491,-1,0,,0,0.00000000000000000000
chr10,134319349,134320114,765,-1,0,,0,0.00000000000000000000
chr10,134335397,134336063,666,-1,0,,0,0.00000000000000000000
chr10,134335450,134335717,267,-1,0,,0,0.00000000000000000000
chr10,134335668,134335867,199,-1,0,,0,0.00000000000000000000
chr10,134354499,134354629,130,-1,0,3632,1,769.23076923076900000000
chr10,134435524,134436507,983,-1,0,3632,1,101.72939979654100000000
chr10,134435803,134436557,754,-1,0,3632,1,132.62599469496000000000
chr10,134634548,134637862,3314,-1,0,54777,1,30.17501508750750000000
chr10,134585145,134586451,1306,-1,0,3632,1,76.56967840735070000000
chr10,134555033,134555521,488,-1,0,3632,1,204.91803278688500000000
chr10,134611617,134612171,554,-1,0,,0,0.00000000000000000000
chr10,134585108,134585697,589,-1,0,3632,1,169.77928692699500000000
chr10,134612740,134613148,408,-1,0,,0,0.00000000000000000000
chr10,134577994,134578371,377,-1,0,3632,1,265.25198938992000000000
chr10,134605963,134606232,269,-1,0,,0,0.00000000000000000000
chr10,134571641,134571910,269,-1,0,3632,1,371.74721189591100000000
chr10,134611744,134611893,149,-1,0,,0,0.00000000000000000000
chr10,134665837,134666112,275,-1,0,54777,1,363.63636363636400000000
chr10,134672803,134711516,38713,-1,0,54777,1,2.58311161625294000000
chr10,134702021,134702425,404,-1,0,54777,1,247.52475247524800000000
chr10,134709571,134709734,163,-1,0,54777,1,613.49693251533700000000
chr10,134727502,134728357,855,-1,0,54777,1,116.95906432748500000000
chr10,134778712,134779278,566,-1,0,,0,0.00000000000000000000
chr10,134801881,134802741,860,-1,0,,0,0.00000000000000000000
chr10,134802233,134802548,315,-1,0,,0,0.00000000000000000000
chr10,134830840,134832224,1384,-1,0,,0,0.00000000000000000000
chr10,134831215,134831937,722,-1,0,,0,0.00000000000000000000
chr10,134948891,134953444,4553,-1,0,,0,0.00000000000000000000
chr10,134924380,134928321,3941,-1,0,84435,1,25.37427048972340000000
chr10,134876463,134878477,2014,-1,0,,0,0.00000000000000000000
chr10,134924590,134925600,1010,-1,0,84435,1,99.00990099009900000000
chr10,134854939,134855708,769,-1,0,,0,0.00000000000000000000
chr10,134894248,134894770,522,-1,0,,0,0.00000000000000000000
chr10,134924689,134925307,618,-1,0,84435,1,161.81229773462800000000
chr10,134924697,134925113,416,-1,0,84435,1,240.38461538461500000000
chr10,134876800,134877280,480,-1,0,,0,0.00000000000000000000
chr10,134925734,134926067,333,-1,0,84435,1,300.30030030030000000000
chr10,134879046,134879415,369,-1,0,,0,0.00000000000000000000
chr10,134953622,134953898,276,-1,0,,0,0.00000000000000000000
chr10,134879335,134879518,183,-1,0,,0,0.00000000000000000000
chr10,134867543,134867623,80,-1,0,,0,0.00000000000000000000
chr10,134964948,134965285,337,-1,0,,0,0.00000000000000000000
chr10,134969096,134970047,951,-1,0,,0,0.00000000000000000000
chr10,134977188,134977879,691,-1,0,85442,1,144.71780028943600000000
chr10,134977358,134977758,400,-1,0,85442,1,250.00000000000000000000
chr10,134977410,134977626,216,-1,0,85442,1,462.96296296296300000000
chr10,135016619,135016727,108,-1,0,85442,1,925.92592592592600000000
chr10,135035299,135038119,2820,-1,0,85442,1,35.46099290780140000000
chr10,135129879,135132160,2281,-1,0,,0,0.00000000000000000000
chr10,135104688,135105986,1298,-1,0,10844,1,77.04160246533130000000
chr10,135035923,135037463,1540,-1,0,85442,1,64.93506493506490000000
chr10,135104840,135105871,1031,-1,0,10844,1,96.99321047526670000000
chr10,135035312,135035481,169,-1,0,85442,1,591.71597633136100000000
chr10,135244423,135391245,146822,-1,0,93426;1571,2,1.36219367669695000000
chr10,135389740,135443839,54099,-1,0,441581,1,1.84846300301299000000
chr10,135273198,135338534,65336,-1,0,,0,0.00000000000000000000
chr10,135477697,135502328,24631,-1,0,,0,0.00000000000000000000
chr10,135448601,135471741,23140,-1,0,,0,0.00000000000000000000
chr10,135377075,135400250,23175,-1,0,93426,1,4.31499460625674000000
chr10,135381954,135392076,10122,-1,0,,0,0.00000000000000000000
chr10,135290122,135294776,4654,-1,0,,0,0.00000000000000000000
chr10,135244572,135245524,952,-1,0,,0,0.00000000000000000000
chr10,135379944,135380678,734,-1,0,93426,1,136.23978201634900000000
chr10,135244773,135245457,684,-1,0,,0,0.00000000000000000000
chr10,135380322,135380393,71,-1,0,93426,1,1408.45070422535000000000
chr11,175513,193007,17494,-1,0,,0,0.00000000000000000000
chr11,197262,205275,8013,-1,0,113746;51272,2,24.95944090852360000000
chr11,196044,196546,502,-1,0,,0,0.00000000000000000000
chr11,223767,224079,312,-1,0,23410,1,320.51282051282000000000
chr11,223822,223967,145,-1,0,23410,1,689.65517241379300000000
chr11,864811,1510870,646059,-1,0,54472;7106;4583;101927503;4588;9024;81532;161;66005;4586;727897,11,1.70263087427000000000
chr11,751201,911500,160299,-1,0,6181;977;6888;5441;283229;7106;347862;51286;66005;57104;79751;101927423;55367,13,8.10984472766518000000
chr11,1069501,1117300,47799,-1,0,4583,1,2.09209397686144000000
chr11,966917,1003507,36590,-1,0,161,1,2.73298715496037000000
chr11,1002638,1016158,13520,-1,0,161;4588,2,14.79289940828400000000
chr11,1263589,1272764,9175,-1,0,727897,1,10.89918256130790000000
chr11,740173,744730,4557,-1,0,,0,0.00000000000000000000
chr11,397562,403191,5629,-1,0,11187,1,17.76514478593000000000
chr11,1450715,1454421,3706,-1,0,9024,1,26.98327037236910000000
chr11,749135,753186,4051,-1,0,6888,1,24.68526289804990000000
chr11,1016451,1019071,2620,-1,0,4588,1,38.16793893129770000000
chr11,921406,924922,3516,-1,0,,0,0.00000000000000000000
chr11,1373057,1375748,2691,-1,0,,0,0.00000000000000000000
chr11,400571,402993,2422,-1,0,11187,1,41.28819157720890000000
chr11,410416,412702,2286,-1,0,59307,1,43.74453193350830000000
chr11,1058212,1060517,2305,-1,0,,0,0.00000000000000000000
chr11,734757,736525,1768,-1,0,,0,0.00000000000000000000
chr11,676595,678409,1814,-1,0,10522,1,55.12679162072770000000
chr11,1016623,1018422,1799,-1,0,4588,1,55.58643690939410000000
chr11,1372906,1374466,1560,-1,0,,0,0.00000000000000000000
chr11,858239,859589,1350,-1,0,7106,1,74.07407407407410000000
chr11,430803,431863,1060,-1,0,338440,1,94.33962264150940000000
chr11,1438764,1439879,1115,-1,0,9024,1,89.68609865470850000000
chr11,602903,604009,1106,-1,0,57661,1,90.41591320072330000000
chr11,1078779,1079617,838,-1,0,4583,1,119.33174224343700000000
chr11,631483,632333,850,-1,0,,0,0.00000000000000000000
chr11,363090,363935,845,-1,0,,0,0.00000000000000000000
chr11,654246,655176,930,-1,0,10522,1,107.52688172043000000000
chr11,1059218,1060093,875,-1,0,,0,0.00000000000000000000
chr11,1148609,1149372,763,-1,0,,0,0.00000000000000000000
chr11,677312,677769,457,-1,0,10522,1,218.81838074398200000000
chr11,635687,636226,539,-1,0,,0,0.00000000000000000000
chr11,1078648,1079309,661,-1,0,4583,1,151.28593040847200000000
chr11,585087,585655,568,-1,0,57661,1,176.05633802816900000000
chr11,390457,390987,530,-1,0,,0,0.00000000000000000000
chr11,362989,363516,527,-1,0,,0,0.00000000000000000000
chr11,779701,780180,479,-1,0,,0,0.00000000000000000000
chr11,1079007,1079465,458,-1,0,4583,1,218.34061135371200000000
chr11,424883,425345,462,-1,0,338440,1,216.45021645021600000000
chr11,1433315,1433746,431,-1,0,9024,1,232.01856148491900000000
chr11,421348,421727,379,-1,0,338440,1,263.85224274406300000000
chr11,1086475,1086760,285,-1,0,4583,1,350.87719298245600000000
chr11,1462981,1463229,248,-1,0,9024,1,403.22580645161300000000
chr11,491642,491866,224,-1,0,,0,0.00000000000000000000
chr11,1078765,1079027,262,-1,0,4583,1,381.67938931297700000000
chr11,1079243,1079455,212,-1,0,4583,1,471.69811320754700000000
chr11,772175,772382,207,-1,0,347862,1,483.09178743961300000000
chr11,647879,648012,133,-1,0,10522,1,751.87969924812000000000
chr11,1079367,1079454,87,-1,0,4583,1,1149.42528735632000000000
chr11,1450465,1450560,95,-1,0,9024,1,1052.63157894737000000000
chr11,772175,772259,84,-1,0,347862,1,1190.47619047619000000000
chr11,1142286,1142350,64,-1,0,,0,0.00000000000000000000
chr11,1531183,1532001,818,-1,0,,0,0.00000000000000000000
chr11,1543385,1544135,750,-1,0,,0,0.00000000000000000000
chr11,1659308,1664249,4941,-1,0,,0,0.00000000000000000000
chr11,1654287,1656618,2331,-1,0,,0,0.00000000000000000000
chr11,1654504,1656471,1967,-1,0,,0,0.00000000000000000000
chr11,1662669,1663859,1190,-1,0,,0,0.00000000000000000000
chr11,1662847,1663550,703,-1,0,,0,0.00000000000000000000
chr11,1663000,1663490,490,-1,0,,0,0.00000000000000000000
chr11,1663161,1663361,200,-1,0,,0,0.00000000000000000000
chr11,1681438,1682706,1268,-1,0,,0,0.00000000000000000000
chr11,1682173,1682597,424,-1,0,,0,0.00000000000000000000
chr11,1691692,1692382,690,-1,0,,0,0.00000000000000000000
chr11,1691575,1691976,401,-1,0,,0,0.00000000000000000000
chr11,1705737,1706153,416,-1,0,,0,0.00000000000000000000
chr11,1815797,1816776,979,-1,0,,0,0.00000000000000000000
chr11,1828154,1832908,4754,-1,0,,0,0.00000000000000000000
chr11,1874780,1910364,35584,-1,0,4046,1,2.81025179856115000000
chr11,1915245,1937002,21757,-1,0,,0,0.00000000000000000000
chr11,1961125,1977019,15894,-1,0,6150,1,6.29168239587266000000
chr11,1905458,1907545,2087,-1,0,4046,1,47.91566842357450000000
chr11,1935529,1937236,1707,-1,0,,0,0.00000000000000000000
chr11,1962746,1963252,506,-1,0,,0,0.00000000000000000000
chr11,1971651,1972129,478,-1,0,6150,1,209.20502092050200000000
chr11,1935939,1936341,402,-1,0,,0,0.00000000000000000000
chr11,1962885,1963065,180,-1,0,,0,0.00000000000000000000
chr11,1914279,1914521,242,-1,0,,0,0.00000000000000000000
chr11,1971844,1971962,118,-1,0,6150,1,847.45762711864400000000
chr11,2063301,2091803,28502,-1,0,,0,0.00000000000000000000
chr11,2215035,2215811,776,-1,0,,0,0.00000000000000000000
chr11,2215302,2215677,375,-1,0,,0,0.00000000000000000000
chr11,2320854,2321373,519,-1,0,29125,1,192.67822736030800000000
chr11,2329711,2329890,179,-1,0,10077,1,558.65921787709500000000
chr11,2321038,2321081,43,-1,0,29125,1,2325.58139534884000000000
chr11,2396201,2417800,21599,-1,0,975,1,4.62984397425807000000
chr11,2449865,2450980,1115,-1,0,,0,0.00000000000000000000
chr11,2557864,2558945,1081,-1,0,3784,1,92.50693802035150000000
chr11,2645269,2650593,5324,-1,0,3784,1,18.78287002253940000000
chr11,2918906,2919347,441,-1,0,5003,1,226.75736961451200000000
chr11,3065874,3066760,886,-1,0,833,1,112.86681715575600000000
chr11,3238050,3244077,6027,-1,0,386746,1,16.59200265472040000000
chr11,3242244,3244495,2251,-1,0,,0,0.00000000000000000000
chr11,3268205,3359873,91668,-1,0,,0,0.00000000000000000000
chr11,3373520,3379174,5654,-1,0,7748,1,17.68659356207990000000
chr11,3416746,3615433,198687,-1,0,,0,0.00000000000000000000
chr11,3482446,3534939,52493,-1,0,,0,0.00000000000000000000
chr11,3488281,3492386,4105,-1,0,,0,0.00000000000000000000
chr11,3417831,3420421,2590,-1,0,,0,0.00000000000000000000
chr11,3648924,3651825,2901,-1,0,,0,0.00000000000000000000
chr11,3675009,3676753,1744,-1,0,417,1,57.33944954128440000000
chr11,3648967,3650757,1790,-1,0,,0,0.00000000000000000000
chr11,3674965,3675989,1024,-1,0,417,1,97.65625000000000000000
chr11,3651798,3652262,464,-1,0,,0,0.00000000000000000000
chr11,3767354,3768003,649,-1,0,4928,1,154.08320493066300000000
chr11,4186701,4191600,4899,-1,0,,0,0.00000000000000000000
chr11,4395838,4563748,167910,-1,0,390036;119774;6737,3,1.78667143112382000000
chr11,4245322,4397948,152626,-1,0,143496,1,0.65519636234979600000
chr11,4523204,4601320,78116,-1,0,143501;119772,2,2.56029494597778000000
chr11,4584792,4686022,101230,-1,0,55128;390037;390038;143501;143502;143503,6,5.92709671046133000000
chr11,4265155,4330269,65114,-1,0,,0,0.00000000000000000000
chr11,4504882,4559820,54938,-1,0,390036,1,1.82023371800939000000
chr11,4318885,4371175,52290,-1,0,,0,0.00000000000000000000
chr11,4509001,4562285,53284,-1,0,390036,1,1.87673598078222000000
chr11,4264092,4309730,45638,-1,0,,0,0.00000000000000000000
chr11,4555631,4589314,33683,-1,0,119772,1,2.96885669328741000000
chr11,4255449,4278126,22677,-1,0,,0,0.00000000000000000000
chr11,4582302,4594481,12179,-1,0,143501,1,8.21085474997947000000
chr11,4519984,4522596,2612,-1,0,,0,0.00000000000000000000
chr11,4542828,4543898,1070,-1,0,,0,0.00000000000000000000
chr11,4559442,4560332,890,-1,0,,0,0.00000000000000000000
chr11,4805417,4911328,105911,-1,0,119694;119695;401665;119692,4,3.77675595547205000000
chr11,4819741,4820635,894,-1,0,,0,0.00000000000000000000
chr11,4802409,4802969,560,-1,0,,0,0.00000000000000000000
chr11,4802521,4802832,311,-1,0,,0,0.00000000000000000000
chr11,4967571,4991115,23544,-1,0,401666;401667,2,8.49473326537547000000
chr11,4968688,4980232,11544,-1,0,401667,1,8.66250866250866000000
chr11,4966292,4975882,9590,-1,0,401666,1,10.42752867570390000000
chr11,4972857,4983161,10304,-1,0,401667,1,9.70496894409938000000
chr11,4994233,4998571,4338,-1,0,,0,0.00000000000000000000
chr11,4968953,4975701,6748,-1,0,,0,0.00000000000000000000
chr11,5270768,5275223,4455,-1,0,3047;3048,2,44.89337822671160000000
chr11,4971471,4975718,4247,-1,0,,0,0.00000000000000000000
chr11,4975372,4979906,4534,-1,0,401667,1,22.05558006175560000000
chr11,4970230,4972168,1938,-1,0,,0,0.00000000000000000000
chr11,5106844,5107354,510,-1,0,,0,0.00000000000000000000
chr11,5106947,5107219,272,-1,0,,0,0.00000000000000000000
chr11,5429846,5493011,63165,-1,0,390061;282763;390063;390064,4,6.33262091348057000000
chr11,5775405,5808296,32891,-1,0,390072;390075,2,6.08069076647107000000
chr11,5403579,5443278,39699,-1,0,390059;282763,2,5.03791027481801000000
chr11,5785895,5815023,29128,-1,0,79473;390075,2,6.86624553694040000000
chr11,5499358,5529640,30282,-1,0,390066;282763;50613,3,9.90687537150783000000
chr11,5784447,5809227,24780,-1,0,79473;390075,2,8.07102502017756000000
chr11,5793241,5809302,16061,-1,0,79473;390075,2,12.45252474939290000000
chr11,5789628,5802053,12425,-1,0,390075,1,8.04828973843058000000
chr11,5799358,5809056,9698,-1,0,390075,1,10.31140441328110000000
chr11,5519680,5523453,3773,-1,0,282763,1,26.50410813676120000000
chr11,5760081,5762385,2304,-1,0,,0,0.00000000000000000000
chr11,5637146,5639875,2729,-1,0,445372,1,36.64345914254310000000
chr11,5760157,5762304,2147,-1,0,,0,0.00000000000000000000
chr11,5637074,5638936,1862,-1,0,445372,1,53.70569280343720000000
chr11,5521616,5523186,1570,-1,0,282763,1,63.69426751592360000000
chr11,5721902,5722912,1010,-1,0,10346,1,99.00990099009900000000
chr11,5458546,5459702,1156,-1,0,282763,1,86.50519031141870000000
chr11,5521944,5522917,973,-1,0,282763,1,102.77492291880800000000
chr11,5623482,5624035,553,-1,0,117854;445372,2,361.66365280289300000000
chr11,5497976,5498501,525,-1,0,282763,1,190.47619047619000000000
chr11,5720453,5720797,344,-1,0,10346,1,290.69767441860500000000
chr11,5871564,5892596,21032,-1,0,390079,1,4.75465956637505000000
chr11,5873984,5883499,9515,-1,0,390079,1,10.50972149238050000000
chr11,5890496,5893462,2966,-1,0,,0,0.00000000000000000000
chr11,5896558,5935504,38946,-1,0,390081,1,2.56765778257074000000
chr11,6144950,6171842,26892,-1,0,,0,0.00000000000000000000
chr11,6189620,6193059,3439,-1,0,255725,1,29.07822041291070000000
chr11,6573061,6573512,451,-1,0,144132,1,221.72949002217300000000
chr11,6600444,6601671,1227,-1,0,,0,0.00000000000000000000
chr11,6600864,6601075,211,-1,0,,0,0.00000000000000000000
chr11,6776133,6893903,117770,-1,0,144125;8590;338755;144124;341276,5,4.24556338626136000000
chr11,6881393,6881949,556,-1,0,,0,0.00000000000000000000
chr11,7132847,7136518,3671,-1,0,,0,0.00000000000000000000
chr11,7134709,7136513,1804,-1,0,,0,0.00000000000000000000
chr11,7209294,7209612,318,-1,0,,0,0.00000000000000000000
chr11,7258982,7259868,886,-1,0,,0,0.00000000000000000000
chr11,7428470,7429040,570,-1,0,143425,1,175.43859649122800000000
chr11,7428603,7428925,322,-1,0,143425,1,310.55900621118000000000
chr11,7685805,7686670,865,-1,0,51700,1,115.60693641618500000000
chr11,7716457,7717788,1331,-1,0,341277,1,75.13148009015780000000
chr11,7716816,7717350,534,-1,0,341277,1,187.26591760299600000000
chr11,7716911,7717232,321,-1,0,341277,1,311.52647975077900000000
chr11,7800819,7874023,73204,-1,0,120065;120066,2,2.73209114256052000000
chr11,7835759,7889178,53419,-1,0,120066,1,1.87199311106535000000
chr11,7809752,7834885,25133,-1,0,120065,1,3.97883261051208000000
chr11,7814788,7828288,13500,-1,0,120065,1,7.40740740740741000000
chr11,7790072,7792492,2420,-1,0,,0,0.00000000000000000000
chr11,7790334,7792009,1675,-1,0,,0,0.00000000000000000000
chr11,7846661,7847581,920,-1,0,120066,1,108.69565217391300000000
chr11,7905859,7906660,801,-1,0,,0,0.00000000000000000000
chr11,8326075,8326275,200,-1,0,,0,0.00000000000000000000
chr11,8326067,8326212,145,-1,0,,0,0.00000000000000000000
chr11,8444419,8446851,2432,-1,0,65975,1,41.11842105263160000000
chr11,8871222,8871602,380,-1,0,6764,1,263.15789473684200000000
chr11,8957995,8965267,7272,-1,0,56676,1,13.75137513751380000000
chr11,9323277,9325420,2143,-1,0,440026,1,46.66355576294910000000
chr11,9323626,9324638,1012,-1,0,440026,1,98.81422924901180000000
chr11,9338351,9338631,280,-1,0,,0,0.00000000000000000000
chr11,9439499,9439870,371,-1,0,10527,1,269.54177897574100000000
chr11,9503762,9509097,5335,-1,0,7702,1,18.74414245548270000000
chr11,9525771,9526790,1019,-1,0,7702,1,98.13542688910700000000
chr11,9637197,9639107,1910,-1,0,,0,0.00000000000000000000
chr11,10128391,10213898,85507,-1,0,81846,1,1.16949489515478000000
chr11,10155214,10168122,12908,-1,0,81846,1,7.74713356058258000000
chr11,9938143,9940017,1874,-1,0,81846,1,53.36179295624330000000
chr11,9726589,9727916,1327,-1,0,23075,1,75.35795026375280000000
chr11,9794552,9795043,491,-1,0,,0,0.00000000000000000000
chr11,9794633,9794960,327,-1,0,,0,0.00000000000000000000
chr11,10225098,10232033,6935,-1,0,81846,1,14.41961067051190000000
chr11,10259524,10261595,2071,-1,0,81846,1,48.28585224529210000000
chr11,10260038,10261325,1287,-1,0,81846,1,77.70007770007770000000
chr11,10292735,10293839,1104,-1,0,81846,1,90.57971014492750000000
chr11,10374942,10375013,71,-1,0,,0,0.00000000000000000000
chr11,10402768,10429998,27230,-1,0,,0,0.00000000000000000000
chr11,11023869,11024147,278,-1,0,,0,0.00000000000000000000
chr11,11301314,11306048,4734,-1,0,374378,1,21.12378538234050000000
chr11,11379440,11381000,1560,-1,0,374378,1,64.10256410256410000000
chr11,11581454,11581805,351,-1,0,374378,1,284.90028490028500000000
chr11,11823307,11827425,4118,-1,0,,0,0.00000000000000000000
chr11,11822877,11824514,1637,-1,0,,0,0.00000000000000000000
chr11,11822914,11823973,1059,-1,0,,0,0.00000000000000000000
chr11,11823605,11824620,1015,-1,0,,0,0.00000000000000000000
chr11,11870965,11890439,19474,-1,0,55031,1,5.13505186402383000000
chr11,11875092,11883788,8696,-1,0,55031,1,11.49954001839930000000
chr11,11875576,11876543,967,-1,0,55031,1,103.41261633919300000000
chr11,11875693,11876488,795,-1,0,55031,1,125.78616352201300000000
chr11,12152493,12152996,503,-1,0,9645,1,198.80715705765400000000
chr11,12192460,12208076,15616,-1,0,9645,1,6.40368852459016000000
chr11,12401670,12402432,762,-1,0,55742,1,131.23359580052500000000
chr11,12695055,12697883,2828,-1,0,7003,1,35.36067892503540000000
chr11,12927572,12928685,1113,-1,0,7003,1,89.84725965858040000000
chr11,12943514,12944225,711,-1,0,7003,1,140.64697609001400000000
chr11,12943717,12944016,299,-1,0,7003,1,334.44816053511700000000
chr11,13298664,13299563,899,-1,0,406,1,111.23470522803100000000
chr11,13565878,13566333,455,-1,0,,0,0.00000000000000000000
chr11,13628222,13629406,1184,-1,0,,0,0.00000000000000000000
chr11,13767249,13767757,508,-1,0,,0,0.00000000000000000000
chr11,13767500,13767591,91,-1,0,,0,0.00000000000000000000
chr11,13789690,13790521,831,-1,0,,0,0.00000000000000000000
chr11,13928371,13929332,961,-1,0,,0,0.00000000000000000000
chr11,13983604,14048685,65081,-1,0,10418,1,1.53654676480079000000
chr11,14348282,14348658,376,-1,0,22800,1,265.95744680851100000000
chr11,14380039,14381016,977,-1,0,22800,1,102.35414534288600000000
chr11,14451042,14464391,13349,-1,0,,0,0.00000000000000000000
chr11,14924079,14927124,3045,-1,0,,0,0.00000000000000000000
chr11,15529773,15536587,6814,-1,0,,0,0.00000000000000000000
chr11,15617460,15617869,409,-1,0,,0,0.00000000000000000000
chr11,15617629,15617676,47,-1,0,,0,0.00000000000000000000
chr11,15808008,15816284,8276,-1,0,,0,0.00000000000000000000
chr11,16223159,16223479,320,-1,0,55553,1,312.50000000000000000000
chr11,16587161,16587299,138,-1,0,,0,0.00000000000000000000
chr11,16597444,16598012,568,-1,0,,0,0.00000000000000000000
chr11,16597572,16597895,323,-1,0,,0,0.00000000000000000000
chr11,16790538,16792133,1595,-1,0,,0,0.00000000000000000000
chr11,16852814,16861965,9151,-1,0,144100,1,10.92776745710850000000
chr11,16905538,16905595,57,-1,0,144100,1,1754.38596491228000000000
chr11,16915882,16927299,11417,-1,0,144100,1,8.75886835420864000000
chr11,16996171,16996597,426,-1,0,144100,1,234.74178403755900000000
chr11,17134360,17135502,1142,-1,0,5286,1,87.56567425569180000000
chr11,17195718,17203621,7903,-1,0,5286,1,12.65342275085410000000
chr11,17209920,17211219,1299,-1,0,5286,1,76.98229407236330000000
chr11,17195802,17196232,430,-1,0,5286,1,232.55813953488400000000
chr11,17946608,17947020,412,-1,0,26297,1,242.71844660194200000000
chr11,17946729,17946813,84,-1,0,26297,1,1190.47619047619000000000
chr11,18093711,18099788,6077,-1,0,,0,0.00000000000000000000
chr11,18097605,18100066,2461,-1,0,,0,0.00000000000000000000
chr11,18098607,18100066,1459,-1,0,,0,0.00000000000000000000
chr11,18161064,18197122,36058,-1,0,117196,1,2.77330966775750000000
chr11,18164950,18165579,629,-1,0,,0,0.00000000000000000000
chr11,18165198,18165285,87,-1,0,,0,0.00000000000000000000
chr11,18290363,18290417,54,-1,0,6288,1,1851.85185185185000000000
chr11,18400957,18405364,4407,-1,0,,0,0.00000000000000000000
chr11,18443477,18444682,1205,-1,0,3948,1,82.98755186721990000000
chr11,18473791,18475329,1538,-1,0,,0,0.00000000000000000000
chr11,18606098,18621921,15823,-1,0,55293,1,6.31991404916893000000
chr11,18735744,18736576,832,-1,0,283284,1,120.19230769230800000000
chr11,18931377,18972369,40992,-1,0,259249,1,2.43950039032006000000
chr11,18941859,18964598,22739,-1,0,259249,1,4.39773077092220000000
chr11,18962219,18984484,22265,-1,0,,0,0.00000000000000000000
chr11,18952993,18967619,14626,-1,0,259249,1,6.83713934089977000000
chr11,18949423,18960314,10891,-1,0,259249,1,9.18189330639978000000
chr11,19094850,19095640,790,-1,0,,0,0.00000000000000000000
chr11,19181059,19183289,2230,-1,0,54503,1,44.84304932735430000000
chr11,19492212,19495601,3389,-1,0,89797,1,29.50722927117140000000
chr11,19541347,19542188,841,-1,0,89797,1,118.90606420927500000000
chr11,19676981,19685463,8482,-1,0,89797,1,11.78967224711150000000
chr11,19833628,19834440,812,-1,0,89797,1,123.15270935960600000000
chr11,19891937,19900955,9018,-1,0,89797,1,11.08893324462190000000
chr11,19919447,19924056,4609,-1,0,89797,1,21.69668040789760000000
chr11,20195701,20195842,141,-1,0,,0,0.00000000000000000000
chr11,20253293,20254384,1091,-1,0,,0,0.00000000000000000000
chr11,20436864,20437296,432,-1,0,10196,1,231.48148148148100000000
chr11,20437052,20437132,80,-1,0,10196,1,1250.00000000000000000000
chr11,20569186,20571251,2065,-1,0,,0,0.00000000000000000000
chr11,20604651,20606395,1744,-1,0,,0,0.00000000000000000000
chr11,20685899,20686306,407,-1,0,,0,0.00000000000000000000
chr11,20728751,20748918,20167,-1,0,4745,1,4.95859572569048000000
chr11,20770316,20770723,407,-1,0,4745,1,245.70024570024600000000
chr11,20820511,20820562,51,-1,0,4745,1,1960.78431372549000000000
chr11,20844513,20849956,5443,-1,0,4745,1,18.37222120154330000000
chr11,20846888,20849767,2879,-1,0,4745,1,34.73428273706150000000
chr11,20934123,20936843,2720,-1,0,4745,1,36.76470588235290000000
chr11,21186695,21216735,30040,-1,0,4745,1,3.32889480692410000000
chr11,21158911,21160349,1438,-1,0,4745,1,69.54102920723230000000
chr11,21340113,21341604,1491,-1,0,4745,1,67.06908115358820000000
chr11,21384568,21446077,61509,-1,0,4745,1,1.62577834138094000000
chr11,21422992,21425454,2462,-1,0,4745,1,40.61738424045490000000
chr11,21610017,21707533,97516,-1,0,,0,0.00000000000000000000
chr11,21668969,21676622,7653,-1,0,,0,0.00000000000000000000
chr11,21788890,21789250,360,-1,0,,0,0.00000000000000000000
chr11,21789056,21789131,75,-1,0,,0,0.00000000000000000000
chr11,21804083,22252650,448567,-1,0,203859,1,0.22293213722810600000
chr11,21806032,21844037,38005,-1,0,,0,0.00000000000000000000
chr11,22249780,22254776,4996,-1,0,203859,1,20.01601281024820000000
chr11,21827100,21829900,2800,-1,0,,0,0.00000000000000000000
chr11,21847270,21849380,2110,-1,0,,0,0.00000000000000000000
chr11,22470794,22472845,2051,-1,0,,0,0.00000000000000000000
chr11,22298186,22299488,1302,-1,0,203859,1,76.80491551459290000000
chr11,21842405,21843046,641,-1,0,,0,0.00000000000000000000
chr11,22290647,22291010,363,-1,0,203859,1,275.48209366391200000000
chr11,22433874,22433991,117,-1,0,,0,0.00000000000000000000
chr11,22290829,22290937,108,-1,0,203859,1,925.92592592592600000000
chr11,22922682,22960924,38242,-1,0,,0,0.00000000000000000000
chr11,23015428,23047158,31730,-1,0,,0,0.00000000000000000000
chr11,23374656,23378555,3899,-1,0,,0,0.00000000000000000000
chr11,23025825,23027549,1724,-1,0,,0,0.00000000000000000000
chr11,22980416,22981236,820,-1,0,,0,0.00000000000000000000
chr11,23098402,23098782,380,-1,0,,0,0.00000000000000000000
chr11,23450377,23463030,12653,-1,0,,0,0.00000000000000000000
chr11,23576098,23583029,6931,-1,0,,0,0.00000000000000000000
chr11,23581954,23582461,507,-1,0,,0,0.00000000000000000000
chr11,23591029,23591892,863,-1,0,,0,0.00000000000000000000
chr11,23591257,23591858,601,-1,0,,0,0.00000000000000000000
chr11,23749858,23754748,4890,-1,0,,0,0.00000000000000000000
chr11,23859948,23861288,1340,-1,0,,0,0.00000000000000000000
chr11,23860539,23861170,631,-1,0,,0,0.00000000000000000000
chr11,23860741,23860886,145,-1,0,,0,0.00000000000000000000
chr11,23882966,23883210,244,-1,0,,0,0.00000000000000000000
chr11,24070753,24134663,63910,-1,0,,0,0.00000000000000000000
chr11,24284295,24300560,16265,-1,0,,0,0.00000000000000000000
chr11,24282478,24289793,7315,-1,0,,0,0.00000000000000000000
chr11,24284805,24288207,3402,-1,0,,0,0.00000000000000000000
chr11,24284935,24287756,2821,-1,0,,0,0.00000000000000000000
chr11,24307581,24309186,1605,-1,0,,0,0.00000000000000000000
chr11,24349471,24355549,6078,-1,0,,0,0.00000000000000000000
chr11,24443021,24452372,9351,-1,0,,0,0.00000000000000000000
chr11,24443523,24452007,8484,-1,0,,0,0.00000000000000000000
chr11,24446680,24450643,3963,-1,0,,0,0.00000000000000000000
chr11,24460013,24460817,804,-1,0,,0,0.00000000000000000000
chr11,24658410,24664357,5947,-1,0,338645,1,16.81520094165130000000
chr11,24902951,24904253,1302,-1,0,338645,1,76.80491551459290000000
chr11,25040700,25052727,12027,-1,0,338645,1,8.31462542612455000000
chr11,25082540,25085978,3438,-1,0,338645,1,29.08667830133800000000
chr11,25082693,25085724,3031,-1,0,338645,1,32.99241174529860000000
chr11,25076617,25079730,3113,-1,0,338645,1,32.12335367812400000000
chr11,25084264,25085645,1381,-1,0,338645,1,72.41129616220130000000
chr11,25068600,25069193,593,-1,0,338645,1,168.63406408094400000000
chr11,25068861,25068957,96,-1,0,338645,1,1041.66666666667000000000
chr11,25128076,25311368,183292,-1,0,,0,0.00000000000000000000
chr11,25808980,25904483,95503,-1,0,,0,0.00000000000000000000
chr11,25606560,25629377,22817,-1,0,,0,0.00000000000000000000
chr11,25702285,25721786,19501,-1,0,,0,0.00000000000000000000
chr11,25609108,25626156,17048,-1,0,,0,0.00000000000000000000
chr11,25702527,25716585,14058,-1,0,,0,0.00000000000000000000
chr11,25656208,25669302,13094,-1,0,,0,0.00000000000000000000
chr11,25245558,25255972,10414,-1,0,,0,0.00000000000000000000
chr11,26371240,26380323,9083,-1,0,63982,1,11.00957833314980000000
chr11,25750495,25753639,3144,-1,0,,0,0.00000000000000000000
chr11,25355120,25356920,1800,-1,0,,0,0.00000000000000000000
chr11,25772629,25773575,946,-1,0,,0,0.00000000000000000000
chr11,26195188,26196573,1385,-1,0,,0,0.00000000000000000000
chr11,25557336,25558585,1249,-1,0,,0,0.00000000000000000000
chr11,25773021,25773886,865,-1,0,,0,0.00000000000000000000
chr11,25434982,25435544,562,-1,0,,0,0.00000000000000000000
chr11,25772843,25773392,549,-1,0,,0,0.00000000000000000000
chr11,25432281,25432926,645,-1,0,,0,0.00000000000000000000
chr11,25377195,25377868,673,-1,0,,0,0.00000000000000000000
chr11,25564470,25564813,343,-1,0,,0,0.00000000000000000000
chr11,25679878,25680281,403,-1,0,,0,0.00000000000000000000
chr11,25923329,25923621,292,-1,0,,0,0.00000000000000000000
chr11,26029427,26029664,237,-1,0,,0,0.00000000000000000000
chr11,25609479,25609812,333,-1,0,,0,0.00000000000000000000
chr11,25432491,25432745,254,-1,0,,0,0.00000000000000000000
chr11,26322471,26322715,244,-1,0,63982,1,409.83606557377000000000
chr11,25773074,25773210,136,-1,0,,0,0.00000000000000000000
chr11,25680026,25680080,54,-1,0,,0,0.00000000000000000000
chr11,25680082,25680136,54,-1,0,,0,0.00000000000000000000
chr11,26679804,26680216,412,-1,0,63982,1,242.71844660194200000000
chr11,26679945,26680076,131,-1,0,63982,1,763.35877862595400000000
chr11,27253885,27255035,1150,-1,0,,0,0.00000000000000000000
chr11,27307781,27308283,502,-1,0,,0,0.00000000000000000000
chr11,27307852,27308201,349,-1,0,,0,0.00000000000000000000
chr11,27589435,27589829,394,-1,0,,0,0.00000000000000000000
chr11,27657118,27657753,635,-1,0,,0,0.00000000000000000000
chr11,27657261,27657596,335,-1,0,,0,0.00000000000000000000
chr11,27789523,27789821,298,-1,0,,0,0.00000000000000000000
chr11,27821975,27822621,646,-1,0,,0,0.00000000000000000000
chr11,27822216,27822446,230,-1,0,,0,0.00000000000000000000
chr11,27830963,27832065,1102,-1,0,,0,0.00000000000000000000
chr11,27859392,27861442,2050,-1,0,,0,0.00000000000000000000
chr11,28119090,28178390,59300,-1,0,196074;81930,2,3.37268128161889000000
chr11,28464736,28469680,4944,-1,0,,0,0.00000000000000000000
chr11,28570806,28571271,465,-1,0,,0,0.00000000000000000000
chr11,28709919,28710039,120,-1,0,,0,0.00000000000000000000
chr11,29007155,29012796,5641,-1,0,,0,0.00000000000000000000
chr11,29007409,29012264,4855,-1,0,,0,0.00000000000000000000
chr11,29139354,29140318,964,-1,0,,0,0.00000000000000000000
chr11,29139538,29140014,476,-1,0,,0,0.00000000000000000000
chr11,29360236,29360941,705,-1,0,,0,0.00000000000000000000
chr11,29530001,29530823,822,-1,0,,0,0.00000000000000000000
chr11,29748172,29748716,544,-1,0,,0,0.00000000000000000000
chr11,29748310,29748654,344,-1,0,,0,0.00000000000000000000
chr11,29884145,29886018,1873,-1,0,,0,0.00000000000000000000
chr11,29967555,29968466,911,-1,0,,0,0.00000000000000000000
chr11,29967596,29968238,642,-1,0,,0,0.00000000000000000000
chr11,30164546,30178148,13602,-1,0,,0,0.00000000000000000000
chr11,30171992,30177463,5471,-1,0,,0,0.00000000000000000000
chr11,30172271,30176583,4312,-1,0,,0,0.00000000000000000000
chr11,31152334,31152875,541,-1,0,341019,1,184.84288354898300000000
chr11,31152429,31152756,327,-1,0,341019,1,305.81039755351700000000
chr11,31262590,31531894,269304,-1,0,120526;26610;341019;196294,4,1.48531028131777000000
chr11,31623730,31692405,68675,-1,0,26610,1,1.45613396432472000000
chr11,31550386,31609618,59232,-1,0,26610,1,1.68827660723933000000
chr11,31393761,31397648,3887,-1,0,120526,1,25.72678157962440000000
chr11,31566461,31570668,4207,-1,0,26610,1,23.76990729736150000000
chr11,31617327,31620161,2834,-1,0,26610,1,35.28581510232890000000
chr11,31860025,31860578,553,-1,0,,0,0.00000000000000000000
chr11,31916705,31917119,414,-1,0,,0,0.00000000000000000000
chr11,31967171,31969302,2131,-1,0,,0,0.00000000000000000000
chr11,32227591,32229119,1528,-1,0,,0,0.00000000000000000000
chr11,32286621,32287018,397,-1,0,,0,0.00000000000000000000
chr11,32389270,32390643,1373,-1,0,,0,0.00000000000000000000
chr11,32777494,32777931,437,-1,0,493860,1,228.83295194508000000000
chr11,32868351,32872554,4203,-1,0,79056,1,23.79252914584820000000
chr11,33426226,33427344,1118,-1,0,,0,0.00000000000000000000
chr11,33537649,33538027,378,-1,0,,0,0.00000000000000000000
chr11,33659957,33660020,63,-1,0,25758,1,1587.30158730159000000000
chr11,33797298,33801994,4696,-1,0,,0,0.00000000000000000000
chr11,33870084,33872861,2777,-1,0,,0,0.00000000000000000000
chr11,34014825,34018052,3227,-1,0,,0,0.00000000000000000000
chr11,34048472,34048890,418,-1,0,,0,0.00000000000000000000
chr11,34048564,34048852,288,-1,0,,0,0.00000000000000000000
chr11,34108849,34109224,375,-1,0,4076,1,266.66666666666700000000
chr11,34172145,34174046,1901,-1,0,25841,1,52.60389268805890000000
chr11,34220722,34226093,5371,-1,0,25841,1,18.61850679575500000000
chr11,34238091,34257975,19884,-1,0,25841,1,5.02916918125126000000
chr11,34427035,34427543,508,-1,0,,0,0.00000000000000000000
chr11,34510786,34513097,2311,-1,0,2001,1,43.27131112072700000000
chr11,34728118,34728613,495,-1,0,,0,0.00000000000000000000
chr11,34838057,34838172,115,-1,0,,0,0.00000000000000000000
chr11,34921799,34922974,1175,-1,0,51074,1,85.10638297872340000000
chr11,36711834,36825618,113784,-1,0,,0,0.00000000000000000000
chr11,36557238,36583619,26381,-1,0,,0,0.00000000000000000000
chr11,35564130,35579889,15759,-1,0,,0,0.00000000000000000000
chr11,36647455,36654814,7359,-1,0,119710,1,13.58880282647100000000
chr11,36179996,36182352,2356,-1,0,143458,1,42.44482173174870000000
chr11,36506536,36508680,2144,-1,0,7189,1,46.64179104477610000000
chr11,37210790,37212065,1275,-1,0,,0,0.00000000000000000000
chr11,36123510,36124867,1357,-1,0,143458,1,73.69196757553430000000
chr11,37121072,37121591,519,-1,0,,0,0.00000000000000000000
chr11,36777872,36778409,537,-1,0,,0,0.00000000000000000000
chr11,36777801,36778171,370,-1,0,,0,0.00000000000000000000
chr11,36778026,36778395,369,-1,0,,0,0.00000000000000000000
chr11,37121337,37121400,63,-1,0,,0,0.00000000000000000000
chr11,37344281,37382021,37740,-1,0,,0,0.00000000000000000000
chr11,37448524,37449181,657,-1,0,,0,0.00000000000000000000
chr11,37448784,37448965,181,-1,0,,0,0.00000000000000000000
chr11,37448804,37448896,92,-1,0,,0,0.00000000000000000000
chr11,37637639,37799925,162286,-1,0,,0,0.00000000000000000000
chr11,37708535,37713381,4846,-1,0,,0,0.00000000000000000000
chr11,37706292,37709160,2868,-1,0,,0,0.00000000000000000000
chr11,38026809,38029429,2620,-1,0,,0,0.00000000000000000000
chr11,38085033,38087088,2055,-1,0,,0,0.00000000000000000000
chr11,37874137,37875249,1112,-1,0,,0,0.00000000000000000000
chr11,37961944,37962485,541,-1,0,,0,0.00000000000000000000
chr11,38099477,38100029,552,-1,0,,0,0.00000000000000000000
chr11,37666523,37667050,527,-1,0,,0,0.00000000000000000000
chr11,37593093,37593737,644,-1,0,,0,0.00000000000000000000
chr11,37962045,37962370,325,-1,0,,0,0.00000000000000000000
chr11,37666634,37666942,308,-1,0,,0,0.00000000000000000000
chr11,38099630,38099883,253,-1,0,,0,0.00000000000000000000
chr11,38179731,38189092,9361,-1,0,,0,0.00000000000000000000
chr11,38300616,38301204,588,-1,0,,0,0.00000000000000000000
chr11,38278966,38279022,56,-1,0,,0,0.00000000000000000000
chr11,38457940,38471564,13624,-1,0,,0,0.00000000000000000000
chr11,38457148,38463935,6787,-1,0,,0,0.00000000000000000000
chr11,38814850,38972300,157450,-1,0,,0,0.00000000000000000000
chr11,38934921,38966839,31918,-1,0,,0,0.00000000000000000000
chr11,38797724,38808641,10917,-1,0,,0,0.00000000000000000000
chr11,39103600,39109375,5775,-1,0,,0,0.00000000000000000000
chr11,39032228,39034279,2051,-1,0,,0,0.00000000000000000000
chr11,38847655,38849554,1899,-1,0,,0,0.00000000000000000000
chr11,39010563,39011011,448,-1,0,,0,0.00000000000000000000
chr11,39115469,39115795,326,-1,0,,0,0.00000000000000000000
chr11,39010740,39010807,67,-1,0,,0,0.00000000000000000000
chr11,39225970,39227616,1646,-1,0,,0,0.00000000000000000000
chr11,39657322,39660960,3638,-1,0,,0,0.00000000000000000000
chr11,39716707,39718986,2279,-1,0,,0,0.00000000000000000000
chr11,39725401,39728556,3155,-1,0,,0,0.00000000000000000000
chr11,39785679,39786181,502,-1,0,,0,0.00000000000000000000
chr11,39785788,39786084,296,-1,0,,0,0.00000000000000000000
chr11,39785894,39785982,88,-1,0,,0,0.00000000000000000000
chr11,39795381,39796879,1498,-1,0,,0,0.00000000000000000000
chr11,39805101,39805479,378,-1,0,,0,0.00000000000000000000
chr11,39821001,39826476,5475,-1,0,,0,0.00000000000000000000
chr11,40036391,40041878,5487,-1,0,,0,0.00000000000000000000
chr11,40187337,40189454,2117,-1,0,57689,1,47.23665564478030000000
chr11,40334305,40338921,4616,-1,0,57689,1,21.66377816291160000000
chr11,40411885,40604366,192481,-1,0,57689,1,0.51953179794369300000
chr11,40547396,40602032,54636,-1,0,57689,1,1.83029504356102000000
chr11,40773843,40797570,23727,-1,0,57689,1,4.21460783074135000000
chr11,40541516,40552368,10852,-1,0,57689,1,9.21489126428308000000
chr11,41096311,41096855,544,-1,0,57689,1,183.82352941176500000000
chr11,40881761,40882223,462,-1,0,57689,1,216.45021645021600000000
chr11,41006891,41007467,576,-1,0,57689,1,173.61111111111100000000
chr11,41007010,41007339,329,-1,0,57689,1,303.95136778115500000000
chr11,41096563,41096686,123,-1,0,57689,1,813.00813008130100000000
chr11,40686868,40686919,51,-1,0,57689,1,1960.78431372549000000000
chr11,41307985,41308462,477,-1,0,57689,1,209.64360587002100000000
chr11,41632630,41635545,2915,-1,0,,0,0.00000000000000000000
chr11,41709843,41716959,7116,-1,0,,0,0.00000000000000000000
chr11,41729749,41729939,190,-1,0,,0,0.00000000000000000000
chr11,41780155,41780310,155,-1,0,,0,0.00000000000000000000
chr11,41818239,41830475,12236,-1,0,,0,0.00000000000000000000
chr11,41813466,41818998,5532,-1,0,,0,0.00000000000000000000
chr11,41817971,41819270,1299,-1,0,,0,0.00000000000000000000
chr11,41818198,41819023,825,-1,0,,0,0.00000000000000000000
chr11,41822180,41822729,549,-1,0,,0,0.00000000000000000000
chr11,41822282,41822608,326,-1,0,,0,0.00000000000000000000
chr11,42156148,42156478,330,-1,0,,0,0.00000000000000000000
chr11,42272430,42275462,3032,-1,0,,0,0.00000000000000000000
chr11,42282145,42325626,43481,-1,0,,0,0.00000000000000000000
chr11,42297963,42299986,2023,-1,0,,0,0.00000000000000000000
chr11,42464005,42464543,538,-1,0,,0,0.00000000000000000000
chr11,42464101,42464414,313,-1,0,,0,0.00000000000000000000
chr11,42673686,42679556,5870,-1,0,,0,0.00000000000000000000
chr11,42812826,42818735,5909,-1,0,,0,0.00000000000000000000
chr11,43189707,43193763,4056,-1,0,,0,0.00000000000000000000
chr11,43771603,43782644,11041,-1,0,51144,1,9.05715062041482000000
chr11,43882005,43883421,1416,-1,0,,0,0.00000000000000000000
chr11,43891741,43892287,546,-1,0,,0,0.00000000000000000000
chr11,43891844,43892180,336,-1,0,,0,0.00000000000000000000
chr11,43909599,43909908,309,-1,0,221120,1,323.62459546925600000000
chr11,44113512,44115334,1822,-1,0,,0,0.00000000000000000000
chr11,44300563,44306543,5980,-1,0,60529,1,16.72240802675590000000
chr11,44400490,44400886,396,-1,0,,0,0.00000000000000000000
chr11,44643148,44644667,1519,-1,0,,0,0.00000000000000000000
chr11,44742475,44747301,4826,-1,0,,0,0.00000000000000000000
chr11,44729753,44733697,3944,-1,0,,0,0.00000000000000000000
chr11,44743003,44743466,463,-1,0,,0,0.00000000000000000000
chr11,44743178,44743240,62,-1,0,,0,0.00000000000000000000
chr11,44743206,44743269,63,-1,0,,0,0.00000000000000000000
chr11,45123188,45124045,857,-1,0,,0,0.00000000000000000000
chr11,45132762,45132956,194,-1,0,,0,0.00000000000000000000
chr11,45356501,45357233,732,-1,0,,0,0.00000000000000000000
chr11,45429847,45431614,1767,-1,0,,0,0.00000000000000000000
chr11,45429839,45430905,1066,-1,0,,0,0.00000000000000000000
chr11,45844196,45845404,1208,-1,0,,0,0.00000000000000000000
chr11,46036167,46036606,439,-1,0,51317,1,227.79043280182200000000
chr11,46161015,46162402,1387,-1,0,,0,0.00000000000000000000
chr11,46385912,46423453,37541,-1,0,1132;55626;8525;4192,4,10.65501718121520000000
chr11,46408528,46408688,160,-1,0,,0,0.00000000000000000000
chr11,46579041,46591747,12706,-1,0,55626,1,7.87029749724540000000
chr11,46969973,46970786,813,-1,0,79096,1,123.00123001230000000000
chr11,47053044,47064705,11661,-1,0,79096,1,8.57559385987480000000
chr11,47057760,47063569,5809,-1,0,79096,1,17.21466689619560000000
chr11,47061629,47063629,2000,-1,0,79096,1,50.00000000000000000000
chr11,47216156,47219260,3104,-1,0,,0,0.00000000000000000000
chr11,47401426,47403056,1630,-1,0,,0,0.00000000000000000000
chr11,47405706,47406511,805,-1,0,,0,0.00000000000000000000
chr11,47526094,47527953,1859,-1,0,10658,1,53.79236148466920000000
chr11,47761891,47763252,1361,-1,0,23360,1,73.47538574577520000000
chr11,47875248,47877038,1790,-1,0,,0,0.00000000000000000000
chr11,47887666,47888196,530,-1,0,,0,0.00000000000000000000
chr11,47939356,47942809,3453,-1,0,,0,0.00000000000000000000
chr11,48119966,48120492,526,-1,0,5795,1,190.11406844106500000000
chr11,48120081,48120364,283,-1,0,5795,1,353.35689045936400000000
chr11,48220851,48220932,81,-1,0,,0,0.00000000000000000000
chr11,48249234,48255025,5791,-1,0,,0,0.00000000000000000000
chr11,48327527,48328291,764,-1,0,256148,1,130.89005235602100000000
chr11,48347604,48347840,236,-1,0,,0,0.00000000000000000000
chr11,48351634,48352138,504,-1,0,,0,0.00000000000000000000
chr11,48354268,48355136,868,-1,0,,0,0.00000000000000000000
chr11,48354561,48354968,407,-1,0,,0,0.00000000000000000000
chr11,48944436,49913257,968821,-1,0,646754;2346;283116,3,0.30965472466018000000
chr11,48377818,48971127,593309,-1,0,403253,1,0.16854623813223800000
chr11,48382342,48645411,263069,-1,0,403253,1,0.38012840737601200000
chr11,48690503,48934751,244248,-1,0,,0,0.00000000000000000000
chr11,48709715,48849435,139720,-1,0,,0,0.00000000000000000000
chr11,48796355,48901204,104849,-1,0,,0,0.00000000000000000000
chr11,48795725,48849293,53568,-1,0,,0,0.00000000000000000000
chr11,49709621,49757056,47435,-1,0,,0,0.00000000000000000000
chr11,48605360,48664500,59140,-1,0,,0,0.00000000000000000000
chr11,49361114,49403444,42330,-1,0,,0,0.00000000000000000000
chr11,49306630,49360231,53601,-1,0,,0,0.00000000000000000000
chr11,49077468,49104640,27172,-1,0,646754,1,3.68025909023995000000
chr11,49720992,49759082,38090,-1,0,,0,0.00000000000000000000
chr11,49843779,49877987,34208,-1,0,,0,0.00000000000000000000
chr11,48561725,48591514,29789,-1,0,,0,0.00000000000000000000
chr11,49026866,49053303,26437,-1,0,283116,1,3.78257744827325000000
chr11,48834039,48857813,23774,-1,0,,0,0.00000000000000000000
chr11,48771467,48786822,15355,-1,0,,0,0.00000000000000000000
chr11,49081704,49098520,16816,-1,0,,0,0.00000000000000000000
chr11,49083028,49094890,11862,-1,0,,0,0.00000000000000000000
chr11,48738433,48748661,10228,-1,0,,0,0.00000000000000000000
chr11,48883174,48893724,10550,-1,0,,0,0.00000000000000000000
chr11,48952634,48960251,7617,-1,0,,0,0.00000000000000000000
chr11,48367351,48374004,6653,-1,0,,0,0.00000000000000000000
chr11,49702474,49709960,7486,-1,0,,0,0.00000000000000000000
chr11,49759332,49766404,7072,-1,0,,0,0.00000000000000000000
chr11,49497744,49504546,6802,-1,0,,0,0.00000000000000000000
chr11,48815158,48821305,6147,-1,0,,0,0.00000000000000000000
chr11,48600664,48604609,3945,-1,0,,0,0.00000000000000000000
chr11,49116301,49119663,3362,-1,0,,0,0.00000000000000000000
chr11,49006277,49011363,5086,-1,0,,0,0.00000000000000000000
chr11,48836966,48840066,3100,-1,0,,0,0.00000000000000000000
chr11,48734743,48736963,2220,-1,0,,0,0.00000000000000000000
chr11,49834429,49837855,3426,-1,0,,0,0.00000000000000000000
chr11,49758343,49760794,2451,-1,0,,0,0.00000000000000000000
chr11,48878753,48881833,3080,-1,0,,0,0.00000000000000000000
chr11,49043275,49045889,2614,-1,0,,0,0.00000000000000000000
chr11,49125560,49127712,2152,-1,0,,0,0.00000000000000000000
chr11,48955331,48956592,1261,-1,0,,0,0.00000000000000000000
chr11,48960376,48962460,2084,-1,0,,0,0.00000000000000000000
chr11,48942395,48943611,1216,-1,0,,0,0.00000000000000000000
chr11,48735394,48736982,1588,-1,0,,0,0.00000000000000000000
chr11,49759262,49760857,1595,-1,0,,0,0.00000000000000000000
chr11,48809959,48811335,1376,-1,0,,0,0.00000000000000000000
chr11,48714038,48715072,1034,-1,0,,0,0.00000000000000000000
chr11,48880634,48881843,1209,-1,0,,0,0.00000000000000000000
chr11,48932956,48933809,853,-1,0,,0,0.00000000000000000000
chr11,48944636,48945406,770,-1,0,,0,0.00000000000000000000
chr11,49425010,49425475,465,-1,0,,0,0.00000000000000000000
chr11,49442186,49442784,598,-1,0,,0,0.00000000000000000000
chr11,48695819,48696340,521,-1,0,,0,0.00000000000000000000
chr11,48446697,48447203,506,-1,0,,0,0.00000000000000000000
chr11,48948709,48949233,524,-1,0,,0,0.00000000000000000000
chr11,48928943,48929253,310,-1,0,,0,0.00000000000000000000
chr11,48934561,48934914,353,-1,0,,0,0.00000000000000000000
chr11,49425087,49425432,345,-1,0,,0,0.00000000000000000000
chr11,48680178,48680466,288,-1,0,,0,0.00000000000000000000
chr11,49442331,49442643,312,-1,0,,0,0.00000000000000000000
chr11,48446830,48447126,296,-1,0,,0,0.00000000000000000000
chr11,48814075,48814271,196,-1,0,,0,0.00000000000000000000
chr11,48690010,48690179,169,-1,0,,0,0.00000000000000000000
chr11,48814117,48814213,96,-1,0,,0,0.00000000000000000000
chr11,50431464,51246232,814768,-1,0,,0,0.00000000000000000000
chr11,50776553,51179528,402975,-1,0,,0,0.00000000000000000000
chr11,50469393,50755407,286014,-1,0,,0,0.00000000000000000000
chr11,50455148,50597529,142381,-1,0,,0,0.00000000000000000000
chr11,50609225,50733407,124182,-1,0,,0,0.00000000000000000000
chr11,51119115,51207172,88057,-1,0,,0,0.00000000000000000000
chr11,51183549,51273210,89661,-1,0,,0,0.00000000000000000000
chr11,50332408,50407302,74894,-1,0,,0,0.00000000000000000000
chr11,51281809,51358766,76957,-1,0,,0,0.00000000000000000000
chr11,50366344,50416417,50073,-1,0,,0,0.00000000000000000000
chr11,51340011,51365436,25425,-1,0,,0,0.00000000000000000000
chr11,50727111,50761106,33995,-1,0,,0,0.00000000000000000000
chr11,50441941,50467223,25282,-1,0,,0,0.00000000000000000000
chr11,51345250,51360616,15366,-1,0,,0,0.00000000000000000000
chr11,51180126,51198295,18169,-1,0,,0,0.00000000000000000000
chr11,51353224,51367675,14451,-1,0,,0,0.00000000000000000000
chr11,50603842,50615208,11366,-1,0,,0,0.00000000000000000000
chr11,50749100,50757108,8008,-1,0,,0,0.00000000000000000000
chr11,51279408,51288810,9402,-1,0,,0,0.00000000000000000000
chr11,50694113,50699486,5373,-1,0,,0,0.00000000000000000000
chr11,50526064,50533467,7403,-1,0,,0,0.00000000000000000000
chr11,50589454,50596583,7129,-1,0,,0,0.00000000000000000000
chr11,50745989,50753034,7045,-1,0,,0,0.00000000000000000000
chr11,50767103,50771966,4863,-1,0,,0,0.00000000000000000000
chr11,50475419,50480118,4699,-1,0,,0,0.00000000000000000000
chr11,51352990,51357245,4255,-1,0,,0,0.00000000000000000000
chr11,50779550,50783290,3740,-1,0,,0,0.00000000000000000000
chr11,51348287,51351371,3084,-1,0,,0,0.00000000000000000000
chr11,51288392,51290678,2286,-1,0,,0,0.00000000000000000000
chr11,51271055,51273920,2865,-1,0,,0,0.00000000000000000000
chr11,50612616,50615496,2880,-1,0,,0,0.00000000000000000000
chr11,50467889,50470306,2417,-1,0,,0,0.00000000000000000000
chr11,51346696,51348982,2286,-1,0,,0,0.00000000000000000000
chr11,50578917,50580808,1891,-1,0,,0,0.00000000000000000000
chr11,50640266,50641121,855,-1,0,,0,0.00000000000000000000
chr11,50460203,50460875,672,-1,0,,0,0.00000000000000000000
chr11,50365861,50366455,594,-1,0,,0,0.00000000000000000000
chr11,50370995,50371439,444,-1,0,,0,0.00000000000000000000
chr11,50640451,50640964,513,-1,0,,0,0.00000000000000000000
chr11,50765599,50765892,293,-1,0,,0,0.00000000000000000000
chr11,51494327,51501303,6976,-1,0,,0,0.00000000000000000000
chr11,51527781,51564673,36892,-1,0,,0,0.00000000000000000000
chr11,51562060,51566374,4314,-1,0,,0,0.00000000000000000000
chr11,51576638,51591261,14623,-1,0,,0,0.00000000000000000000
chr11,51582200,51593234,11034,-1,0,,0,0.00000000000000000000
chr11,51567804,51571581,3777,-1,0,,0,0.00000000000000000000
chr11,51577839,51581765,3926,-1,0,,0,0.00000000000000000000
chr11,51571605,51575044,3439,-1,0,,0,0.00000000000000000000
chr11,51575688,51576596,908,-1,0,,0,0.00000000000000000000
chr11,54701961,54940612,238651,-1,0,,0,0.00000000000000000000
chr11,55412500,55605524,193024,-1,0,390142;219432;219437;26338;219436;219431;219438,7,3.62649204244032000000
chr11,55055145,55335774,280629,-1,0,81327;81309;81328,3,1.06902707845590000000
chr11,54813715,54951831,138116,-1,0,,0,0.00000000000000000000
chr11,55459122,55609227,150105,-1,0,390142;219437;26338;219436;390144;219438,6,3.99720195862896000000
chr11,55223712,55363996,140284,-1,0,219428;81309,2,1.42567933620370000000
chr11,54886477,55013146,126669,-1,0,,0,0.00000000000000000000
chr11,55693045,55828257,135212,-1,0,338674;282770;10798;219447,4,2.95831730911458000000
chr11,55752698,55880394,127696,-1,0,338674;390151;120586;219447,4,3.13243954391680000000
chr11,55357920,55479824,121904,-1,0,219432;219429;219431;81300,4,3.28127050794067000000
chr11,55043197,55129285,86088,-1,0,81327,1,1.16160208159093000000
chr11,55365414,55461331,95917,-1,0,219432;219429;219431;81300,4,4.17027221451880000000
chr11,54875446,54951385,75939,-1,0,,0,0.00000000000000000000
chr11,54699272,54764218,64946,-1,0,,0,0.00000000000000000000
chr11,55661427,55734781,73354,-1,0,10798;390148,2,2.72650434877444000000
chr11,55088150,55152420,64270,-1,0,81327;81328,2,3.11187179088222000000
chr11,54964911,55030078,65167,-1,0,79097,1,1.53451900501788000000
chr11,55122635,55193264,70629,-1,0,81328,1,1.41584901386116000000
chr11,55402844,55451275,48431,-1,0,219432;219431;81300,3,6.19437963287977000000
chr11,55365909,55417028,51119,-1,0,219429;81300,2,3.91243960171365000000
chr11,55385565,55429159,43594,-1,0,219431;81300,2,4.58778731018030000000
chr11,55414146,55451600,37454,-1,0,219432;219431,2,5.33988359053773000000
chr11,54931448,54965209,33761,-1,0,,0,0.00000000000000000000
chr11,55369181,55399906,30725,-1,0,219429,1,3.25467860048820000000
chr11,54951210,54983316,32106,-1,0,,0,0.00000000000000000000
chr11,55406977,55432136,25159,-1,0,219431,1,3.97472077586550000000
chr11,55433973,55457345,23372,-1,0,,0,0.00000000000000000000
chr11,55367426,55385356,17930,-1,0,219429,1,5.57724484104852000000
chr11,55077950,55097296,19346,-1,0,,0,0.00000000000000000000
chr11,55869645,55889742,20097,-1,0,390151,1,4.97586704483256000000
chr11,55400758,55416837,16079,-1,0,81300,1,6.21929224454257000000
chr11,54999459,55015740,16281,-1,0,,0,0.00000000000000000000
chr11,54956866,54972886,16020,-1,0,,0,0.00000000000000000000
chr11,55579360,55595084,15724,-1,0,219437;219438;26338,3,19.07911472907660000000
chr11,55445709,55457776,12067,-1,0,,0,0.00000000000000000000
chr11,54969848,54982199,12351,-1,0,,0,0.00000000000000000000
chr11,55434253,55443984,9731,-1,0,,0,0.00000000000000000000
chr11,55029923,55038526,8603,-1,0,79097,1,11.62385214460070000000
chr11,55444054,55451951,7897,-1,0,,0,0.00000000000000000000
chr11,54894436,54899793,5357,-1,0,,0,0.00000000000000000000
chr11,54885378,54892283,6905,-1,0,,0,0.00000000000000000000
chr11,54914386,54919423,5037,-1,0,,0,0.00000000000000000000
chr11,55248886,55253790,4904,-1,0,,0,0.00000000000000000000
chr11,55031456,55035009,3553,-1,0,79097,1,28.14522938361950000000
chr11,55590670,55595209,4539,-1,0,26338,1,22.03128442388190000000
chr11,55391324,55395115,3791,-1,0,,0,0.00000000000000000000
chr11,55783865,55787326,3461,-1,0,,0,0.00000000000000000000
chr11,55069579,55072788,3209,-1,0,,0,0.00000000000000000000
chr11,54869896,54871609,1713,-1,0,,0,0.00000000000000000000
chr11,55315255,55316326,1071,-1,0,,0,0.00000000000000000000
chr11,54884448,54885313,865,-1,0,,0,0.00000000000000000000
chr11,55363155,55363833,678,-1,0,,0,0.00000000000000000000
chr11,55309443,55309951,508,-1,0,,0,0.00000000000000000000
chr11,54993963,54994337,374,-1,0,,0,0.00000000000000000000
chr11,55012637,55013027,390,-1,0,,0,0.00000000000000000000
chr11,54948469,54948857,388,-1,0,,0,0.00000000000000000000
chr11,55488932,55489301,369,-1,0,,0,0.00000000000000000000
chr11,55305131,55305212,81,-1,0,,0,0.00000000000000000000
chr11,56078073,56237487,159414,-1,0,219479;390162;390157;219473;219477;219482;219417,7,4.39108233906683000000
chr11,56332759,56369736,36977,-1,0,390167,1,2.70438380614977000000
chr11,56322774,56353544,30770,-1,0,390167,1,3.24991875203120000000
chr11,56345812,56356554,10742,-1,0,,0,0.00000000000000000000
chr11,56407939,56408257,318,-1,0,,0,0.00000000000000000000
chr11,56439738,56440297,559,-1,0,,0,0.00000000000000000000
chr11,56447976,56449293,1317,-1,0,,0,0.00000000000000000000
chr11,56467981,56507714,39733,-1,0,390174,1,2.51679963758085000000
chr11,56628741,56629573,832,-1,0,,0,0.00000000000000000000
chr11,56707551,56712242,4691,-1,0,,0,0.00000000000000000000
chr11,57215079,57216842,1763,-1,0,,0,0.00000000000000000000
chr11,57502408,57504206,1798,-1,0,51075,1,55.61735261401560000000
chr11,57642434,57650986,8552,-1,0,,0,0.00000000000000000000
chr11,57728468,57729790,1322,-1,0,,0,0.00000000000000000000
chr11,57754444,57762114,7670,-1,0,,0,0.00000000000000000000
chr11,57760689,57761546,857,-1,0,,0,0.00000000000000000000
chr11,57851054,57857442,6388,-1,0,219956,1,15.65435190983090000000
chr11,57962722,57963290,568,-1,0,,0,0.00000000000000000000
chr11,57962828,57963152,324,-1,0,,0,0.00000000000000000000
chr11,57987584,57987642,58,-1,0,,0,0.00000000000000000000
chr11,58166759,58168315,1556,-1,0,,0,0.00000000000000000000
chr11,58166969,58168146,1177,-1,0,,0,0.00000000000000000000
chr11,58220606,58220934,328,-1,0,,0,0.00000000000000000000
chr11,58437755,58438290,535,-1,0,,0,0.00000000000000000000
chr11,58457883,58462019,4136,-1,0,,0,0.00000000000000000000
chr11,58459125,58461236,2111,-1,0,,0,0.00000000000000000000
chr11,58557596,58563786,6190,-1,0,,0,0.00000000000000000000
chr11,58587132,58587988,856,-1,0,,0,0.00000000000000000000
chr11,58594193,58596024,1831,-1,0,,0,0.00000000000000000000
chr11,58595258,58595976,718,-1,0,,0,0.00000000000000000000
chr11,58806840,58849233,42393,-1,0,,0,0.00000000000000000000
chr11,58627918,58636166,8248,-1,0,,0,0.00000000000000000000
chr11,58631774,58636562,4788,-1,0,,0,0.00000000000000000000
chr11,58632380,58635515,3135,-1,0,,0,0.00000000000000000000
chr11,58809166,58809660,494,-1,0,,0,0.00000000000000000000
chr11,58809284,58809617,333,-1,0,,0,0.00000000000000000000
chr11,59032833,59033227,394,-1,0,,0,0.00000000000000000000
chr11,59112471,59119135,6664,-1,0,,0,0.00000000000000000000
chr11,59383294,59383871,577,-1,0,5007,1,173.31022530329300000000
chr11,59398735,59399183,448,-1,0,,0,0.00000000000000000000
chr11,59398789,59399116,327,-1,0,,0,0.00000000000000000000
chr11,59615293,59626669,11376,-1,0,6947,1,8.79043600562588000000
chr11,59621390,59621935,545,-1,0,6947,1,183.48623853211000000000
chr11,59942299,59942690,391,-1,0,64231,1,255.75447570332500000000
chr11,60228005,60229397,1392,-1,0,931,1,71.83908045977010000000
chr11,60097420,60097943,523,-1,0,,0,0.00000000000000000000
chr11,60445385,60445808,423,-1,0,,0,0.00000000000000000000
chr11,60451049,60451781,732,-1,0,,0,0.00000000000000000000
chr11,60571189,60572278,1089,-1,0,,0,0.00000000000000000000
chr11,60571429,60571921,492,-1,0,,0,0.00000000000000000000
chr11,60572561,60574420,1859,-1,0,,0,0.00000000000000000000
chr11,60591316,60591806,490,-1,0,,0,0.00000000000000000000
chr11,60808852,60813998,5146,-1,0,,0,0.00000000000000000000
chr11,60837409,60846992,9583,-1,0,,0,0.00000000000000000000
chr11,60851826,60853895,2069,-1,0,,0,0.00000000000000000000
chr11,60866846,60867623,777,-1,0,921,1,128.70012870012900000000
chr11,60868520,60868927,407,-1,0,921,1,245.70024570024600000000
chr11,60867445,60867656,211,-1,0,921,1,473.93364928910000000000
chr11,60952061,60954685,2624,-1,0,,0,0.00000000000000000000
chr11,60965998,61021656,55658,-1,0,5222;643847;643834,3,5.39006072801754000000
chr11,61107697,61108252,555,-1,0,26007,1,180.18018018018000000000
chr11,61107703,61108068,365,-1,0,26007,1,273.97260273972600000000
chr11,61263644,61269282,5638,-1,0,,0,0.00000000000000000000
chr11,61436521,61445918,9397,-1,0,,0,0.00000000000000000000
chr11,61441333,61441465,132,-1,0,,0,0.00000000000000000000
chr11,61441409,61441504,95,-1,0,,0,0.00000000000000000000
chr11,61635390,61635668,278,-1,0,,0,0.00000000000000000000
chr11,61768960,61770164,1204,-1,0,,0,0.00000000000000000000
chr11,61890289,61890381,92,-1,0,,0,0.00000000000000000000
chr11,61900702,61900907,205,-1,0,3619,1,487.80487804878000000000
chr11,61944785,61945082,297,-1,0,,0,0.00000000000000000000
chr11,62133860,62152089,18229,-1,0,80150,1,5.48576444127489000000
chr11,62182678,62183392,714,-1,0,,0,0.00000000000000000000
chr11,62218456,62218985,529,-1,0,79026,1,189.03591682419700000000
chr11,62259963,62264847,4884,-1,0,79026,1,20.47502047502050000000
chr11,62261040,62262472,1432,-1,0,79026,1,69.83240223463690000000
chr11,62296033,62296247,214,-1,0,79026,1,467.28971962616800000000
chr11,62512324,62513139,815,-1,0,,0,0.00000000000000000000
chr11,62805871,62825880,20009,-1,0,,0,0.00000000000000000000
chr11,62827618,62829854,2236,-1,0,,0,0.00000000000000000000
chr11,62836413,62844247,7834,-1,0,,0,0.00000000000000000000
chr11,62880505,62880724,219,-1,0,283238,1,456.62100456621000000000
chr11,63040002,63041102,1100,-1,0,,0,0.00000000000000000000
chr11,63086800,63086854,54,-1,0,,0,0.00000000000000000000
chr11,63188131,63204066,15935,-1,0,,0,0.00000000000000000000
chr11,63197999,63202725,4726,-1,0,,0,0.00000000000000000000
chr11,63440734,63445038,4304,-1,0,,0,0.00000000000000000000
chr11,63454968,63460118,5150,-1,0,10313,1,19.41747572815530000000
chr11,63568318,63569314,996,-1,0,,0,0.00000000000000000000
chr11,63622165,63622671,506,-1,0,2011,1,197.62845849802400000000
chr11,63697506,63701703,4197,-1,0,,0,0.00000000000000000000
chr11,63698946,63701631,2685,-1,0,,0,0.00000000000000000000
chr11,63785884,63786855,971,-1,0,28992,1,102.98661174047400000000
chr11,64190344,64192946,2602,-1,0,,0,0.00000000000000000000
chr11,64201199,64203168,1969,-1,0,,0,0.00000000000000000000
chr11,64268227,64268684,457,-1,0,,0,0.00000000000000000000
chr11,64268439,64268499,60,-1,0,,0,0.00000000000000000000
chr11,64349427,64349857,430,-1,0,,0,0.00000000000000000000
chr11,64623176,64623642,466,-1,0,10938,1,214.59227467811200000000
chr11,64623400,64623502,102,-1,0,10938,1,980.39215686274500000000
chr11,64655601,64684600,28999,-1,0,23130,1,3.44839477223353000000
chr11,65017413,65025061,7648,-1,0,,0,0.00000000000000000000
chr11,65137245,65137969,724,-1,0,,0,0.00000000000000000000
chr11,65266763,65273450,6687,-1,0,,0,0.00000000000000000000
chr11,65451290,65454808,3518,-1,0,,0,0.00000000000000000000
chr11,65573233,65580313,7080,-1,0,,0,0.00000000000000000000
chr11,65610238,65610517,279,-1,0,254122,1,358.42293906810000000000
chr11,65642107,65643519,1412,-1,0,,0,0.00000000000000000000
chr11,65884101,65884732,631,-1,0,55690,1,158.47860538827300000000
chr11,65903669,65904757,1088,-1,0,55690,1,91.91176470588230000000
chr11,65933943,65939417,5474,-1,0,55690,1,18.26817683595180000000
chr11,66304105,66305161,1056,-1,0,,0,0.00000000000000000000
chr11,66305129,66305490,361,-1,0,,0,0.00000000000000000000
chr11,66319867,66330222,10355,-1,0,89,1,9.65717044905842000000
chr11,66527647,66527984,337,-1,0,79703,1,296.73590504451000000000
chr11,66658047,66658928,881,-1,0,5091,1,113.50737797956900000000
chr11,66711486,66713545,2059,-1,0,5091,1,48.56726566294320000000
chr11,66711949,66713416,1467,-1,0,5091,1,68.16632583503750000000
chr11,66772107,66773910,1803,-1,0,,0,0.00000000000000000000
chr11,66842793,66844959,2166,-1,0,,0,0.00000000000000000000
chr11,66854127,66857301,3174,-1,0,,0,0.00000000000000000000
chr11,66907266,66917331,10065,-1,0,22992,1,9.93541977148534000000
chr11,66930051,66933883,3832,-1,0,22992,1,26.09603340292280000000
chr11,67153428,67155375,1947,-1,0,,0,0.00000000000000000000
chr11,67212338,67216207,3869,-1,0,,0,0.00000000000000000000
chr11,67330084,67332461,2377,-1,0,,0,0.00000000000000000000
chr11,67436007,67436524,517,-1,0,222,1,193.42359767891700000000
chr11,67437500,67437771,271,-1,0,222,1,369.00369003690000000000
chr11,67501350,67738972,237622,-1,0,,0,0.00000000000000000000
chr11,67509782,67576087,66305,-1,0,,0,0.00000000000000000000
chr11,67484799,67505619,20820,-1,0,,0,0.00000000000000000000
chr11,67547477,67550740,3263,-1,0,,0,0.00000000000000000000
chr11,67642222,67644893,2671,-1,0,,0,0.00000000000000000000
chr11,67802294,67803318,1024,-1,0,4728,1,97.65625000000000000000
chr11,67662361,67662886,525,-1,0,,0,0.00000000000000000000
chr11,67662506,67662588,82,-1,0,,0,0.00000000000000000000
chr11,67986720,67988682,1962,-1,0,,0,0.00000000000000000000
chr11,68067243,68069162,1919,-1,0,,0,0.00000000000000000000
chr11,68227511,68228757,1246,-1,0,55291,1,80.25682182985550000000
chr11,68183086,68183404,318,-1,0,4041,1,314.46540880503100000000
chr11,68115883,68116131,248,-1,0,4041,1,403.22580645161300000000
chr11,68401622,68406831,5209,-1,0,,0,0.00000000000000000000
chr11,68434679,68434868,189,-1,0,,0,0.00000000000000000000
chr11,68485551,68485609,58,-1,0,9633,1,1724.13793103448000000000
chr11,68546238,68546925,687,-1,0,1374,1,145.56040756914100000000
chr11,68797438,68797889,451,-1,0,,0,0.00000000000000000000
chr11,68797620,68797724,104,-1,0,,0,0.00000000000000000000
chr11,68843844,68844847,1003,-1,0,219931,1,99.70089730807580000000
chr11,68907241,68909034,1793,-1,0,,0,0.00000000000000000000
chr11,68962203,68962539,336,-1,0,,0,0.00000000000000000000
chr11,68962408,68962523,115,-1,0,,0,0.00000000000000000000
chr11,69400048,69401855,1807,-1,0,,0,0.00000000000000000000
chr11,69400835,69401399,564,-1,0,,0,0.00000000000000000000
chr11,69414017,69431659,17642,-1,0,,0,0.00000000000000000000
chr11,69408621,69413503,4882,-1,0,,0,0.00000000000000000000
chr11,69491960,69496890,4930,-1,0,,0,0.00000000000000000000
chr11,69520876,69524035,3159,-1,0,,0,0.00000000000000000000
chr11,69660838,69661144,306,-1,0,,0,0.00000000000000000000
chr11,69686837,69687102,265,-1,0,,0,0.00000000000000000000
chr11,69815785,69822359,6574,-1,0,,0,0.00000000000000000000
chr11,69902066,69903205,1139,-1,0,,0,0.00000000000000000000
chr11,69983700,69992712,9012,-1,0,55107,1,11.09631602308030000000
chr11,69982470,69984425,1955,-1,0,55107,1,51.15089514066500000000
chr11,69983000,69984115,1115,-1,0,55107,1,89.68609865470850000000
chr11,69982566,69983380,814,-1,0,55107,1,122.85012285012300000000
chr11,70040399,70040703,304,-1,0,,0,0.00000000000000000000
chr11,70074541,70083771,9230,-1,0,,0,0.00000000000000000000
chr11,70451508,70452577,1069,-1,0,22941,1,93.54536950420950000000
chr11,70644980,70645815,835,-1,0,22941,1,119.76047904191600000000
chr11,70712841,70713309,468,-1,0,22941,1,213.67521367521400000000
chr11,70797551,70797929,378,-1,0,22941,1,264.55026455026500000000
chr11,70797683,70797757,74,-1,0,22941,1,1351.35135135135000000000
chr11,70806810,70807275,465,-1,0,22941,1,215.05376344086000000000
chr11,70849139,70849235,96,-1,0,22941,1,1041.66666666667000000000
chr11,70931024,70932096,1072,-1,0,22941,1,93.28358208955220000000
chr11,71053385,71100214,46829,-1,0,,0,0.00000000000000000000
chr11,71062757,71067431,4674,-1,0,,0,0.00000000000000000000
chr11,71132865,71134402,1537,-1,0,,0,0.00000000000000000000
chr11,71212741,71215724,2983,-1,0,,0,0.00000000000000000000
chr11,71282223,71287450,5227,-1,0,,0,0.00000000000000000000
chr11,71311836,71610624,298788,-1,0,245911;100129216;100131539;55199,4,1.33874185040899000000
chr11,71598529,71614794,16265,-1,0,,0,0.00000000000000000000
chr11,71476967,71481731,4764,-1,0,,0,0.00000000000000000000
chr11,71850646,71889330,38684,-1,0,2352,1,2.58504808189432000000
chr11,71875409,71876387,978,-1,0,,0,0.00000000000000000000
chr11,71872311,71873034,723,-1,0,,0,0.00000000000000000000
chr11,71861559,71862049,490,-1,0,,0,0.00000000000000000000
chr11,71861606,71861931,325,-1,0,,0,0.00000000000000000000
chr11,71911785,71913159,1374,-1,0,,0,0.00000000000000000000
chr11,71912204,71912710,506,-1,0,,0,0.00000000000000000000
chr11,71912231,71912590,359,-1,0,,0,0.00000000000000000000
chr11,71974794,71975596,802,-1,0,,0,0.00000000000000000000
chr11,72083318,72087895,4577,-1,0,81570,1,21.84837229626390000000
chr11,72147980,72161530,13550,-1,0,,0,0.00000000000000000000
chr11,72260252,72261577,1325,-1,0,,0,0.00000000000000000000
chr11,72914096,72915037,941,-1,0,,0,0.00000000000000000000
chr11,73420192,73426969,6777,-1,0,5870,1,14.75579164822190000000
chr11,73560780,73561419,639,-1,0,51642,1,156.49452269170600000000
chr11,73761759,73762329,570,-1,0,26005,1,175.43859649122800000000
chr11,73790682,73792165,1483,-1,0,26005,1,67.43088334457180000000
chr11,73948020,73948209,189,-1,0,51400,1,529.10052910052900000000
chr11,74025273,74028403,3130,-1,0,,0,0.00000000000000000000
chr11,74024867,74027363,2496,-1,0,,0,0.00000000000000000000
chr11,74134955,74140834,5879,-1,0,,0,0.00000000000000000000
chr11,74145057,74145428,371,-1,0,,0,0.00000000000000000000
chr11,74183317,74189323,6006,-1,0,,0,0.00000000000000000000
chr11,74532316,74532808,492,-1,0,254225,1,203.25203252032500000000
chr11,74532397,74532722,325,-1,0,254225,1,307.69230769230800000000
chr11,75252853,75253421,568,-1,0,,0,0.00000000000000000000
chr11,75253042,75253162,120,-1,0,,0,0.00000000000000000000
chr11,75256624,75261220,4596,-1,0,,0,0.00000000000000000000
chr11,75285501,75287904,2403,-1,0,,0,0.00000000000000000000
chr11,75886619,75887444,825,-1,0,,0,0.00000000000000000000
chr11,76107247,76111858,4611,-1,0,100506127,1,21.68726957276080000000
chr11,76142301,76148602,6301,-1,0,,0,0.00000000000000000000
chr11,76143016,76147503,4487,-1,0,,0,0.00000000000000000000
chr11,76403584,76403895,311,-1,0,,0,0.00000000000000000000
chr11,76445152,76445719,567,-1,0,,0,0.00000000000000000000
chr11,76445334,76445512,178,-1,0,,0,0.00000000000000000000
chr11,76566950,76568089,1139,-1,0,,0,0.00000000000000000000
chr11,76672826,76677823,4997,-1,0,55331,1,20.01200720432260000000
chr11,76903865,76904229,364,-1,0,4647,1,274.72527472527500000000
chr11,77162604,77162989,385,-1,0,5058,1,259.74025974026000000000
chr11,77230212,77232873,2661,-1,0,,0,0.00000000000000000000
chr11,77241202,77241252,50,-1,0,,0,0.00000000000000000000
chr11,77254355,77256067,1712,-1,0,,0,0.00000000000000000000
chr11,77403177,77403715,538,-1,0,51773,1,185.87360594795500000000
chr11,77519465,77520017,552,-1,0,51773,1,181.15942028985500000000
chr11,78890547,78892050,1503,-1,0,26011,1,66.53359946773120000000
chr11,79342626,79349035,6409,-1,0,,0,0.00000000000000000000
chr11,79390450,79395889,5439,-1,0,,0,0.00000000000000000000
chr11,79623170,79624603,1433,-1,0,,0,0.00000000000000000000
chr11,79970686,79984825,14139,-1,0,,0,0.00000000000000000000
chr11,79971373,79981939,10566,-1,0,,0,0.00000000000000000000
chr11,80242899,80243027,128,-1,0,,0,0.00000000000000000000
chr11,80306163,80313125,6962,-1,0,,0,0.00000000000000000000
chr11,80711432,80712276,844,-1,0,,0,0.00000000000000000000
chr11,80871019,80884114,13095,-1,0,,0,0.00000000000000000000
chr11,80870431,80879500,9069,-1,0,,0,0.00000000000000000000
chr11,80872492,80879193,6701,-1,0,,0,0.00000000000000000000
chr11,80983353,81017832,34479,-1,0,,0,0.00000000000000000000
chr11,80944705,80945224,519,-1,0,,0,0.00000000000000000000
chr11,81518321,81728163,209842,-1,0,,0,0.00000000000000000000
chr11,81470541,81608444,137903,-1,0,,0,0.00000000000000000000
chr11,81428361,81528339,99978,-1,0,,0,0.00000000000000000000
chr11,81545702,81601287,55585,-1,0,,0,0.00000000000000000000
chr11,81644074,81692058,47984,-1,0,,0,0.00000000000000000000
chr11,81500533,81521353,20820,-1,0,,0,0.00000000000000000000
chr11,81505606,81516943,11337,-1,0,,0,0.00000000000000000000
chr11,81509914,81517512,7598,-1,0,,0,0.00000000000000000000
chr11,81751746,81754814,3068,-1,0,,0,0.00000000000000000000
chr11,81330329,81333931,3602,-1,0,,0,0.00000000000000000000
chr11,81675652,81676956,1304,-1,0,,0,0.00000000000000000000
chr11,81157231,81158817,1586,-1,0,,0,0.00000000000000000000
chr11,81187947,81189476,1529,-1,0,,0,0.00000000000000000000
chr11,81556050,81556669,619,-1,0,,0,0.00000000000000000000
chr11,81556171,81556538,367,-1,0,,0,0.00000000000000000000
chr11,81148131,81148244,113,-1,0,,0,0.00000000000000000000
chr11,81906578,82044741,138163,-1,0,,0,0.00000000000000000000
chr11,81853081,81863961,10880,-1,0,,0,0.00000000000000000000
chr11,81856410,81863345,6935,-1,0,,0,0.00000000000000000000
chr11,82132212,82132582,370,-1,0,,0,0.00000000000000000000
chr11,82221826,82221934,108,-1,0,,0,0.00000000000000000000
chr11,82460306,82463458,3152,-1,0,,0,0.00000000000000000000
chr11,82600046,82600164,118,-1,0,5547,1,847.45762711864400000000
chr11,82837344,82846218,8874,-1,0,,0,0.00000000000000000000
chr11,83128402,83135982,7580,-1,0,,0,0.00000000000000000000
chr11,83143374,83143660,286,-1,0,,0,0.00000000000000000000
chr11,83464597,83467935,3338,-1,0,1740,1,29.95805871779510000000
chr11,83532733,83538815,6082,-1,0,1740,1,16.44195988161790000000
chr11,83850436,83855886,5450,-1,0,1740,1,18.34862385321100000000
chr11,84125496,84241504,116008,-1,0,1740,1,0.86200951658506300000
chr11,84043262,84106092,62830,-1,0,1740,1,1.59159637116027000000
chr11,84189137,84228421,39284,-1,0,1740,1,2.54556562468180000000
chr11,84094418,84098244,3826,-1,0,1740,1,26.13695765812860000000
chr11,84457969,84508563,50594,-1,0,1740,1,1.97651895481678000000
chr11,84538127,84571745,33618,-1,0,1740,1,2.97459694211434000000
chr11,84723154,84723461,307,-1,0,1740,1,325.73289902280100000000
chr11,84723182,84723394,212,-1,0,1740,1,471.69811320754700000000
chr11,85055926,85060987,5061,-1,0,1740,1,19.75894092076660000000
chr11,85262919,85274912,11993,-1,0,1740,1,8.33819728174769000000
chr11,85248518,85250386,1868,-1,0,1740,1,53.53319057815850000000
chr11,85428747,85473897,45150,-1,0,54843,1,2.21483942414175000000
chr11,85434614,85435169,555,-1,0,54843,1,180.18018018018000000000
chr11,85502649,85504328,1679,-1,0,54843,1,59.55926146515780000000
chr11,85617808,85618046,238,-1,0,220047,1,420.16806722689100000000
chr11,85794736,85800045,5309,-1,0,,0,0.00000000000000000000
chr11,85887671,85899310,11639,-1,0,,0,0.00000000000000000000
chr11,86303733,86306673,2940,-1,0,10873,1,34.01360544217690000000
chr11,86304739,86306363,1624,-1,0,10873,1,61.57635467980300000000
chr11,86285999,86286695,696,-1,0,10873,1,143.67816091954000000000
chr11,86332362,86334053,1691,-1,0,10873,1,59.13660555884090000000
chr11,86624322,86625100,778,-1,0,,0,0.00000000000000000000
chr11,86753709,86756610,2901,-1,0,65084,1,34.47087211306450000000
chr11,86964162,86965199,1037,-1,0,65084,1,96.43201542912250000000
chr11,86964681,86964733,52,-1,0,65084,1,1923.07692307692000000000
chr11,87545139,87662792,117653,-1,0,,0,0.00000000000000000000
chr11,87877771,87879758,1987,-1,0,23682,1,50.32712632108710000000
chr11,87918474,87918940,466,-1,0,,0,0.00000000000000000000
chr11,87922419,87922968,549,-1,0,,0,0.00000000000000000000
chr11,87918544,87918861,317,-1,0,,0,0.00000000000000000000
chr11,88146485,88153815,7330,-1,0,,0,0.00000000000000000000
chr11,88235647,88236787,1140,-1,0,,0,0.00000000000000000000
chr11,88369003,88383087,14084,-1,0,2915,1,7.10025560920193000000
chr11,88371362,88379499,8137,-1,0,2915,1,12.28954160009830000000
chr11,88373023,88379360,6337,-1,0,2915,1,15.78033769922680000000
chr11,88964456,88967914,3458,-1,0,7299,1,28.91844997108150000000
chr11,89381592,89396174,14582,-1,0,219595,1,6.85776985324372000000
chr11,89370625,89381710,11085,-1,0,,0,0.00000000000000000000
chr11,89379232,89389849,10617,-1,0,,0,0.00000000000000000000
chr11,89438693,89465297,26604,-1,0,390231,1,3.75883325815667000000
chr11,89602377,89748825,146448,-1,0,642446;399939;120146;729384,4,2.73134491423577000000
chr11,90261713,90374886,113173,-1,0,,0,0.00000000000000000000
chr11,90955290,91047729,92439,-1,0,,0,0.00000000000000000000
chr11,90747911,90828697,80786,-1,0,,0,0.00000000000000000000
chr11,90811084,90897374,86290,-1,0,,0,0.00000000000000000000
chr11,89479537,89549760,70223,-1,0,57093,1,1.42403486037338000000
chr11,89963412,90017454,54042,-1,0,,0,0.00000000000000000000
chr11,89624526,89656775,32249,-1,0,399939,1,3.10087134484790000000
chr11,89787544,89838063,50519,-1,0,642623,1,1.97945327500544000000
chr11,89474419,89514075,39656,-1,0,,0,0.00000000000000000000
chr11,90538648,90568717,30069,-1,0,,0,0.00000000000000000000
chr11,90218611,90243619,25008,-1,0,,0,0.00000000000000000000
chr11,89495665,89507429,11764,-1,0,,0,0.00000000000000000000
chr11,89828179,89840487,12308,-1,0,,0,0.00000000000000000000
chr11,89799032,89810501,11469,-1,0,,0,0.00000000000000000000
chr11,90573309,90585380,12071,-1,0,,0,0.00000000000000000000
chr11,90904552,90913242,8690,-1,0,,0,0.00000000000000000000
chr11,89677078,89686106,9028,-1,0,,0,0.00000000000000000000
chr11,89684730,89691950,7220,-1,0,,0,0.00000000000000000000
chr11,89609516,89617182,7666,-1,0,,0,0.00000000000000000000
chr11,90407768,90415546,7778,-1,0,,0,0.00000000000000000000
chr11,89620515,89626401,5886,-1,0,,0,0.00000000000000000000
chr11,90568428,90574664,6236,-1,0,,0,0.00000000000000000000
chr11,89684267,89689857,5590,-1,0,,0,0.00000000000000000000
chr11,91227668,91231618,3950,-1,0,,0,0.00000000000000000000
chr11,90567585,90571062,3477,-1,0,,0,0.00000000000000000000
chr11,90192504,90196166,3662,-1,0,,0,0.00000000000000000000
chr11,89804891,89808317,3426,-1,0,,0,0.00000000000000000000
chr11,89684516,89687737,3221,-1,0,,0,0.00000000000000000000
chr11,91275337,91278450,3113,-1,0,,0,0.00000000000000000000
chr11,89851086,89854080,2994,-1,0,,0,0.00000000000000000000
chr11,90568938,90570897,1959,-1,0,,0,0.00000000000000000000
chr11,90194075,90196035,1960,-1,0,,0,0.00000000000000000000
chr11,90742120,90743883,1763,-1,0,,0,0.00000000000000000000
chr11,90083643,90085194,1551,-1,0,,0,0.00000000000000000000
chr11,90582274,90583535,1261,-1,0,,0,0.00000000000000000000
chr11,90004069,90004624,555,-1,0,,0,0.00000000000000000000
chr11,91161909,91162536,627,-1,0,,0,0.00000000000000000000
chr11,89932470,89932906,436,-1,0,,0,0.00000000000000000000
chr11,90004305,90004463,158,-1,0,,0,0.00000000000000000000
chr11,91370033,91371832,1799,-1,0,,0,0.00000000000000000000
chr11,91370806,91371550,744,-1,0,,0,0.00000000000000000000
chr11,91482189,91489596,7407,-1,0,,0,0.00000000000000000000
chr11,91781089,91781608,519,-1,0,,0,0.00000000000000000000
chr11,91788447,91788988,541,-1,0,,0,0.00000000000000000000
chr11,91810711,91827560,16849,-1,0,,0,0.00000000000000000000
chr11,92024456,92027844,3388,-1,0,,0,0.00000000000000000000
chr11,92052348,92052752,404,-1,0,,0,0.00000000000000000000
chr11,92245845,92246491,646,-1,0,120114,1,154.79876160990700000000
chr11,92245999,92246315,316,-1,0,120114,1,316.45569620253200000000
chr11,92321802,92322160,358,-1,0,120114,1,279.32960893854700000000
chr11,93020158,93029959,9801,-1,0,,0,0.00000000000000000000
chr11,92869597,92876016,6419,-1,0,,0,0.00000000000000000000
chr11,93154150,93160211,6061,-1,0,159989,1,16.49892756970800000000
chr11,92967846,92972719,4873,-1,0,,0,0.00000000000000000000
chr11,92934782,92938750,3968,-1,0,,0,0.00000000000000000000
chr11,93021016,93022314,1298,-1,0,,0,0.00000000000000000000
chr11,92771860,92773358,1498,-1,0,,0,0.00000000000000000000
chr11,93021189,93022122,933,-1,0,,0,0.00000000000000000000
chr11,92976242,92976787,545,-1,0,,0,0.00000000000000000000
chr11,93102697,93103247,550,-1,0,159989,1,181.81818181818200000000
chr11,93102809,93103134,325,-1,0,159989,1,307.69230769230800000000
chr11,93577734,93578443,709,-1,0,387804,1,141.04372355430200000000
chr11,93578000,93578212,212,-1,0,387804,1,471.69811320754700000000
chr11,93694851,93702361,7510,-1,0,,0,0.00000000000000000000
chr11,93683285,93688560,5275,-1,0,,0,0.00000000000000000000
chr11,93698060,93702069,4009,-1,0,,0,0.00000000000000000000
chr11,93678895,93681668,2773,-1,0,,0,0.00000000000000000000
chr11,93900735,93910171,9436,-1,0,24145,1,10.59771089444680000000
chr11,93967987,93973620,5633,-1,0,,0,0.00000000000000000000
chr11,93910799,93911296,497,-1,0,24145,1,201.20724346076500000000
chr11,94091791,94091840,49,-1,0,,0,0.00000000000000000000
chr11,94407377,94408038,661,-1,0,,0,0.00000000000000000000
chr11,94763212,94789928,26716,-1,0,,0,0.00000000000000000000
chr11,94883618,94884207,589,-1,0,,0,0.00000000000000000000
chr11,94940266,94943191,2925,-1,0,143686,1,34.18803418803420000000
chr11,95037914,95038430,516,-1,0,,0,0.00000000000000000000
chr11,95038133,95038234,101,-1,0,,0,0.00000000000000000000
chr11,95104748,95105521,773,-1,0,,0,0.00000000000000000000
chr11,95169315,95175633,6318,-1,0,,0,0.00000000000000000000
chr11,95175422,95181507,6085,-1,0,,0,0.00000000000000000000
chr11,95480186,95480753,567,-1,0,,0,0.00000000000000000000
chr11,95565792,95567130,1338,-1,0,9702;8898,2,149.47683109118100000000
chr11,95735833,95735989,156,-1,0,84441,1,641.02564102564100000000
chr11,95832103,95833068,965,-1,0,84441,1,103.62694300518100000000
chr11,95931749,95940113,8364,-1,0,84441,1,11.95600191296030000000
chr11,95979099,95981577,2478,-1,0,84441,1,40.35512510088780000000
chr11,96001922,96003397,1475,-1,0,84441,1,67.79661016949150000000
chr11,96002119,96003399,1280,-1,0,84441,1,78.12500000000000000000
chr11,96001914,96002796,882,-1,0,84441,1,113.37868480725600000000
chr11,96203582,96278851,75269,-1,0,,0,0.00000000000000000000
chr11,96233026,96233552,526,-1,0,,0,0.00000000000000000000
chr11,96233127,96233442,315,-1,0,,0,0.00000000000000000000
chr11,96745377,96753586,8209,-1,0,,0,0.00000000000000000000
chr11,96614765,96615107,342,-1,0,,0,0.00000000000000000000
chr11,96493121,96493286,165,-1,0,,0,0.00000000000000000000
chr11,97091355,97296022,204667,-1,0,,0,0.00000000000000000000
chr11,96971064,97048429,77365,-1,0,,0,0.00000000000000000000
chr11,97517709,97521160,3451,-1,0,,0,0.00000000000000000000
chr11,97172222,97172970,748,-1,0,,0,0.00000000000000000000
chr11,97101758,97102139,381,-1,0,,0,0.00000000000000000000
chr11,97131931,97132027,96,-1,0,,0,0.00000000000000000000
chr11,97623928,97703890,79962,-1,0,,0,0.00000000000000000000
chr11,97817697,97879231,61534,-1,0,,0,0.00000000000000000000
chr11,98264639,98268853,4214,-1,0,,0,0.00000000000000000000
chr11,97700068,97706695,6627,-1,0,,0,0.00000000000000000000
chr11,98266710,98269842,3132,-1,0,,0,0.00000000000000000000
chr11,98248207,98248607,400,-1,0,,0,0.00000000000000000000
chr11,97576909,97577256,347,-1,0,,0,0.00000000000000000000
chr11,98248210,98248602,392,-1,0,,0,0.00000000000000000000
chr11,97785696,97785785,89,-1,0,,0,0.00000000000000000000
chr11,98112012,98112092,80,-1,0,,0,0.00000000000000000000
chr11,98390619,98392044,1425,-1,0,,0,0.00000000000000000000
chr11,98473569,98476485,2916,-1,0,,0,0.00000000000000000000
chr11,98771869,98816515,44646,-1,0,,0,0.00000000000000000000
chr11,99042049,99096722,54673,-1,0,53942,1,1.82905638980850000000
chr11,99059043,99070556,11513,-1,0,53942,1,8.68583340571528000000
chr11,99056433,99056849,416,-1,0,53942,1,240.38461538461500000000
chr11,99056557,99056643,86,-1,0,53942,1,1162.79069767442000000000
chr11,99184950,99186917,1967,-1,0,53942,1,50.83884087442810000000
chr11,99276255,99276757,502,-1,0,53942,1,199.20318725099600000000
chr11,99276329,99276663,334,-1,0,53942,1,299.40119760479000000000
chr11,99411396,99411761,365,-1,0,53942,1,273.97260273972600000000
chr11,99519100,99571461,52361,-1,0,53942,1,1.90981837627242000000
chr11,99592885,99636183,43298,-1,0,53942,1,2.30957550002310000000
chr11,99647105,99658869,11764,-1,0,53942,1,8.50051003060184000000
chr11,99667232,99669013,1781,-1,0,53942,1,56.14823133071310000000
chr11,99689975,99690588,613,-1,0,53942,1,163.13213703099500000000
chr11,100267540,100267850,310,-1,0,,0,0.00000000000000000000
chr11,100284773,100378296,93523,-1,0,,0,0.00000000000000000000
chr11,100438522,100438997,475,-1,0,,0,0.00000000000000000000
chr11,100438649,100438795,146,-1,0,,0,0.00000000000000000000
chr11,100567262,100568149,887,-1,0,143872,1,112.73957158962800000000
chr11,100784352,100787857,3505,-1,0,143872,1,28.53067047075610000000
chr11,100794180,100796314,2134,-1,0,143872,1,46.86035613870670000000
chr11,100868998,100893320,24322,-1,0,,0,0.00000000000000000000
chr11,100908928,100913215,4287,-1,0,5241,1,23.32633543270350000000
chr11,101072464,101074355,1891,-1,0,,0,0.00000000000000000000
chr11,101289992,101290317,325,-1,0,,0,0.00000000000000000000
chr11,101376969,101383705,6736,-1,0,7225,1,14.84560570071260000000
chr11,101416669,101417209,540,-1,0,7225,1,185.18518518518500000000
chr11,101416784,101417121,337,-1,0,7225,1,296.73590504451000000000
chr11,101444633,101445460,827,-1,0,7225,1,120.91898428053200000000
chr11,101565788,101575254,9466,-1,0,,0,0.00000000000000000000
chr11,101888827,101894040,5213,-1,0,,0,0.00000000000000000000
chr11,101959679,101968796,9117,-1,0,,0,0.00000000000000000000
chr11,102303700,102307487,3787,-1,0,114908,1,26.40612622128330000000
chr11,102471830,102472184,354,-1,0,9313,1,282.48587570621500000000
chr11,102601762,102602126,364,-1,0,,0,0.00000000000000000000
chr11,102699571,102699643,72,-1,0,,0,0.00000000000000000000
chr11,102707974,102709459,1485,-1,0,4314,1,67.34006734006730000000
chr11,102749116,102753362,4246,-1,0,,0,0.00000000000000000000
chr11,102751106,102752862,1756,-1,0,,0,0.00000000000000000000
chr11,102751322,102752262,940,-1,0,,0,0.00000000000000000000
chr11,103025043,103124054,99011,-1,0,79659,1,1.00998878912444000000
chr11,103087399,103088514,1115,-1,0,79659,1,89.68609865470850000000
chr11,103087773,103088249,476,-1,0,79659,1,210.08403361344500000000
chr11,103087934,103088092,158,-1,0,79659,1,632.91139240506300000000
chr11,103294875,103456601,161726,-1,0,79659,1,0.61832976763167300000
chr11,103372953,103377852,4899,-1,0,,0,0.00000000000000000000
chr11,103410737,103411276,539,-1,0,,0,0.00000000000000000000
chr11,103410831,103411144,313,-1,0,,0,0.00000000000000000000
chr11,104327468,104561131,233663,-1,0,,0,0.00000000000000000000
chr11,105029324,105125447,96123,-1,0,,0,0.00000000000000000000
chr11,104940828,104996577,55749,-1,0,440068,1,1.79375414805647000000
chr11,103986515,104026596,40081,-1,0,80310,1,2.49494773084504000000
chr11,104942834,104974891,32057,-1,0,440068,1,3.11944349128116000000
chr11,106214012,106238704,24692,-1,0,,0,0.00000000000000000000
chr11,104757729,104781765,24036,-1,0,,0,0.00000000000000000000
chr11,105048498,105069540,21042,-1,0,,0,0.00000000000000000000
chr11,104923266,104931409,8143,-1,0,,0,0.00000000000000000000
chr11,106786344,106795021,8677,-1,0,2977,1,11.52472052552730000000
chr11,106396504,106405178,8674,-1,0,,0,0.00000000000000000000
chr11,104267741,104273236,5495,-1,0,,0,0.00000000000000000000
chr11,105293423,105298915,5492,-1,0,,0,0.00000000000000000000
chr11,104315975,104320839,4864,-1,0,,0,0.00000000000000000000
chr11,106785847,106790032,4185,-1,0,2977,1,23.89486260454000000000
chr11,103851790,103856475,4685,-1,0,80310,1,21.34471718249730000000
chr11,104581208,104584867,3659,-1,0,,0,0.00000000000000000000
chr11,103915837,103918972,3135,-1,0,80310,1,31.89792663476870000000
chr11,105413144,105416518,3374,-1,0,,0,0.00000000000000000000
chr11,106619476,106622318,2842,-1,0,2977,1,35.18648838845880000000
chr11,103916428,103917321,893,-1,0,80310,1,111.98208286674100000000
chr11,104180259,104180851,592,-1,0,,0,0.00000000000000000000
chr11,104010403,104010930,527,-1,0,80310,1,189.75332068311200000000
chr11,105723381,105723941,560,-1,0,2893,1,178.57142857142900000000
chr11,106595758,106596278,520,-1,0,2977,1,192.30769230769200000000
chr11,103949380,103949926,546,-1,0,80310,1,183.15018315018300000000
chr11,105762748,105763371,623,-1,0,2893,1,160.51364365971100000000
chr11,104277901,104278355,454,-1,0,,0,0.00000000000000000000
chr11,106160306,106160816,510,-1,0,,0,0.00000000000000000000
chr11,106274882,106275417,535,-1,0,,0,0.00000000000000000000
chr11,105765504,105765824,320,-1,0,2893,1,312.50000000000000000000
chr11,106878594,106878977,383,-1,0,2977,1,261.09660574412500000000
chr11,104180383,104180737,354,-1,0,,0,0.00000000000000000000
chr11,104010472,104010823,351,-1,0,80310,1,284.90028490028500000000
chr11,105723492,105723823,331,-1,0,2893,1,302.11480362537800000000
chr11,106595867,106596164,297,-1,0,2977,1,336.70033670033700000000
chr11,105357008,105357299,291,-1,0,,0,0.00000000000000000000
chr11,103949527,103949636,109,-1,0,80310,1,917.43119266055100000000
chr11,106583240,106583381,141,-1,0,2977,1,709.21985815602800000000
chr11,106160571,106160621,50,-1,0,,0,0.00000000000000000000
chr11,107113486,107128014,14528,-1,0,,0,0.00000000000000000000
chr11,107124679,107128855,4176,-1,0,,0,0.00000000000000000000
chr11,107158250,107158840,590,-1,0,,0,0.00000000000000000000
chr11,107158609,107158666,57,-1,0,,0,0.00000000000000000000
chr11,107228203,107251257,23054,-1,0,143884,1,4.33764205777739000000
chr11,107239301,107251199,11898,-1,0,143884,1,8.40477391158178000000
chr11,107224959,107239118,14159,-1,0,143884,1,7.06264566706688000000
chr11,107232103,107243470,11367,-1,0,143884,1,8.79739597079265000000
chr11,107238403,107246003,7600,-1,0,143884,1,13.15789473684210000000
chr11,107238779,107243442,4663,-1,0,143884,1,21.44542140253060000000
chr11,107238677,107241197,2520,-1,0,143884,1,39.68253968253970000000
chr11,107334474,107348124,13650,-1,0,,0,0.00000000000000000000
chr11,107331557,107343854,12297,-1,0,,0,0.00000000000000000000
chr11,107338151,107347406,9255,-1,0,,0,0.00000000000000000000
chr11,107733054,107733262,208,-1,0,,0,0.00000000000000000000
chr11,107781876,107788283,6407,-1,0,,0,0.00000000000000000000
chr11,107784099,107788435,4336,-1,0,,0,0.00000000000000000000
chr11,107785170,107787982,2812,-1,0,,0,0.00000000000000000000
chr11,107784638,107786870,2232,-1,0,,0,0.00000000000000000000
chr11,108079898,108088047,8149,-1,0,4863,1,12.27144434899990000000
chr11,108339729,108341522,1793,-1,0,,0,0.00000000000000000000
chr11,108615747,108616901,1154,-1,0,1662,1,86.65511265164640000000
chr11,108664151,108668082,3931,-1,0,1662,1,25.43881963876880000000
chr11,108802462,108804130,1668,-1,0,1662,1,59.95203836930460000000
chr11,108835031,108835184,153,-1,0,,0,0.00000000000000000000
chr11,109396674,109400885,4211,-1,0,,0,0.00000000000000000000
chr11,109559273,109560144,871,-1,0,,0,0.00000000000000000000
chr11,109930697,109931178,481,-1,0,,0,0.00000000000000000000
chr11,109930920,109930995,75,-1,0,,0,0.00000000000000000000
chr11,109976591,109977122,531,-1,0,85463,1,188.32391713747600000000
chr11,109976699,109977025,326,-1,0,85463,1,306.74846625766900000000
chr11,110026670,110027069,399,-1,0,85463,1,250.62656641604000000000
chr11,110026825,110026885,60,-1,0,85463,1,1666.66666666667000000000
chr11,110489063,110490408,1345,-1,0,57569,1,74.34944237918220000000
chr11,110911646,110911819,173,-1,0,,0,0.00000000000000000000
chr11,111160310,111162696,2386,-1,0,,0,0.00000000000000000000
chr11,111215191,111219325,4134,-1,0,,0,0.00000000000000000000
chr11,111223703,111223762,59,-1,0,5450,1,1694.91525423729000000000
chr11,111461836,111464521,2685,-1,0,,0,0.00000000000000000000
chr11,112044042,112087799,43757,-1,0,83875,1,2.28534862993350000000
chr11,112163534,112168637,5103,-1,0,,0,0.00000000000000000000
chr11,112263739,112267343,3604,-1,0,,0,0.00000000000000000000
chr11,112340394,112379845,39451,-1,0,,0,0.00000000000000000000
chr11,112549709,112553542,3833,-1,0,,0,0.00000000000000000000
chr11,112617742,112618148,406,-1,0,,0,0.00000000000000000000
chr11,112987389,112989994,2605,-1,0,4684,1,38.38771593090210000000
chr11,113805809,113806182,373,-1,0,9177,1,268.09651474530800000000
chr11,114386459,114386570,111,-1,0,,0,0.00000000000000000000
chr11,114396961,114397476,515,-1,0,120400,1,194.17475728155300000000
chr11,114397161,114397230,69,-1,0,120400,1,1449.27536231884000000000
chr11,114470540,114511678,41138,-1,0,,0,0.00000000000000000000
chr11,114424929,114431888,6959,-1,0,120400,1,14.36988072998990000000
chr11,114486193,114487753,1560,-1,0,,0,0.00000000000000000000
chr11,114538613,114539132,519,-1,0,,0,0.00000000000000000000
chr11,114822415,114825648,3233,-1,0,,0,0.00000000000000000000
chr11,115659628,115660838,1210,-1,0,,0,0.00000000000000000000
chr11,115886567,115890753,4186,-1,0,,0,0.00000000000000000000
chr11,116668297,116673657,5360,-1,0,,0,0.00000000000000000000
chr11,116681259,116684898,3639,-1,0,,0,0.00000000000000000000
chr11,116682362,116684158,1796,-1,0,,0,0.00000000000000000000
chr11,116712367,116712842,475,-1,0,,0,0.00000000000000000000
chr11,116735833,116737206,1373,-1,0,23387,1,72.83321194464680000000
chr11,116880702,116881431,729,-1,0,23387,1,137.17421124828500000000
chr11,116991773,116992487,714,-1,0,,0,0.00000000000000000000
chr11,117180911,117182931,2020,-1,0,23621,1,49.50495049504950000000
chr11,117191130,117191411,281,-1,0,,0,0.00000000000000000000
chr11,117278198,117287162,8964,-1,0,22897,1,11.15573404730030000000
chr11,118059946,118061849,1903,-1,0,,0,0.00000000000000000000
chr11,118234539,118235487,948,-1,0,9354,1,105.48523206751100000000
chr11,118281662,118283014,1352,-1,0,,0,0.00000000000000000000
chr11,118478787,118482752,3965,-1,0,23187,1,25.22068095838590000000
chr11,118746205,118746607,402,-1,0,,0,0.00000000000000000000
chr11,118902068,118904075,2007,-1,0,,0,0.00000000000000000000
chr11,119519990,119523230,3240,-1,0,5818,1,30.86419753086420000000
chr11,119719506,119719800,294,-1,0,,0,0.00000000000000000000
chr11,119932385,119932729,344,-1,0,,0,0.00000000000000000000
chr11,119951629,119956591,4962,-1,0,,0,0.00000000000000000000
chr11,119952585,119954770,2185,-1,0,,0,0.00000000000000000000
chr11,120000328,120002437,2109,-1,0,23650,1,47.41583688952110000000
chr11,120073608,120074653,1045,-1,0,,0,0.00000000000000000000
chr11,120194422,120194760,338,-1,0,,0,0.00000000000000000000
chr11,120228525,120230204,1679,-1,0,23365,1,59.55926146515780000000
chr11,120387634,120388362,728,-1,0,2900,1,137.36263736263700000000
chr11,120387801,120388376,575,-1,0,2900,1,173.91304347826100000000
chr11,120406997,120409707,2710,-1,0,2900,1,36.90036900369000000000
chr11,120658977,120665257,6280,-1,0,2900,1,15.92356687898090000000
chr11,120834941,120837331,2390,-1,0,2900,1,41.84100418410040000000
chr11,121055961,121056954,993,-1,0,7007,1,100.70493454179300000000
chr11,121056265,121056712,447,-1,0,7007,1,223.71364653243800000000
chr11,121351252,121352687,1435,-1,0,6653,1,69.68641114982580000000
chr11,122347347,122349518,2171,-1,0,,0,0.00000000000000000000
chr11,122555037,122565615,10578,-1,0,84959,1,9.45358290792210000000
chr11,122788582,122789630,1048,-1,0,79864,1,95.41984732824430000000
chr11,123229806,123230283,477,-1,0,,0,0.00000000000000000000
chr11,123230019,123230075,56,-1,0,,0,0.00000000000000000000
chr11,123314704,123320571,5867,-1,0,,0,0.00000000000000000000
chr11,123678964,123681793,2829,-1,0,,0,0.00000000000000000000
chr11,123804697,123804868,171,-1,0,,0,0.00000000000000000000
chr11,123907442,123921559,14117,-1,0,390265,1,7.08365800099171000000
chr11,123926540,123929592,3052,-1,0,,0,0.00000000000000000000
chr11,124078703,124079499,796,-1,0,,0,0.00000000000000000000
chr11,124253570,124268351,14781,-1,0,390271,1,6.76544212164265000000
chr11,124189622,124192736,3114,-1,0,283160,1,32.11303789338470000000
chr11,124681772,124682784,1012,-1,0,,0,0.00000000000000000000
chr11,124775011,124778356,3345,-1,0,,0,0.00000000000000000000
chr11,124829811,124830743,932,-1,0,80071,1,107.29613733905600000000
chr11,124829916,124830464,548,-1,0,80071,1,182.48175182481800000000
chr11,124830102,124830240,138,-1,0,80071,1,724.63768115942000000000
chr11,124830151,124830259,108,-1,0,80071,1,925.92592592592600000000
chr11,125053074,125053407,333,-1,0,63876,1,300.30030030030000000000
chr11,125075199,125087375,12176,-1,0,63876,1,8.21287779237845000000
chr11,125075591,125084958,9367,-1,0,63876,1,10.67577666275220000000
chr11,125076471,125082606,6135,-1,0,63876,1,16.29991850040750000000
chr11,125075986,125079677,3691,-1,0,63876,1,27.09292874559740000000
chr11,125285947,125290363,4416,-1,0,63876,1,22.64492753623190000000
chr11,125296357,125296665,308,-1,0,63876,1,324.67532467532500000000
chr11,125296461,125296608,147,-1,0,63876,1,680.27210884353700000000
chr11,125391418,125394373,2955,-1,0,,0,0.00000000000000000000
chr11,125719333,125719689,356,-1,0,,0,0.00000000000000000000
chr11,125719437,125719593,156,-1,0,,0,0.00000000000000000000
chr11,126160857,126162661,1804,-1,0,114609,1,55.43237250554320000000
chr11,126184293,126187147,2854,-1,0,28960,1,35.03854239663630000000
chr11,126245528,126266800,21272,-1,0,6484,1,4.70101541933058000000
chr11,126265854,126267437,1583,-1,0,6484,1,63.17119393556540000000
chr11,126437574,126438255,681,-1,0,84623,1,146.84287812041100000000
chr11,126959261,126966927,7666,-1,0,,0,0.00000000000000000000
chr11,126956171,126961324,5153,-1,0,,0,0.00000000000000000000
chr11,127193896,127204074,10178,-1,0,,0,0.00000000000000000000
chr11,127221433,127228347,6914,-1,0,,0,0.00000000000000000000
chr11,127275002,127279997,4995,-1,0,,0,0.00000000000000000000
chr11,127300127,127300605,478,-1,0,,0,0.00000000000000000000
chr11,127456080,127456643,563,-1,0,,0,0.00000000000000000000
chr11,127456297,127456432,135,-1,0,,0,0.00000000000000000000
chr11,127685593,127686077,484,-1,0,,0,0.00000000000000000000
chr11,127749524,127751592,2068,-1,0,,0,0.00000000000000000000
chr11,127855711,127881697,25986,-1,0,,0,0.00000000000000000000
chr11,128042964,128043292,328,-1,0,,0,0.00000000000000000000
chr11,128084279,128086660,2381,-1,0,,0,0.00000000000000000000
chr11,128311488,128316094,4606,-1,0,,0,0.00000000000000000000
chr11,128343675,128345903,2228,-1,0,2113,1,44.88330341113110000000
chr11,128683325,128687680,4355,-1,0,,0,0.00000000000000000000
chr11,128682713,128683409,696,-1,0,2313,1,143.67816091954000000000
chr11,128760695,128762794,2099,-1,0,3762,1,47.64173415912340000000
chr11,128830910,128834820,3910,-1,0,,0,0.00000000000000000000
chr11,128907189,128908762,1573,-1,0,9743,1,63.57279084551810000000
chr11,129013517,129015281,1764,-1,0,9743,1,56.68934240362810000000
chr11,129148770,129149850,1080,-1,0,,0,0.00000000000000000000
chr11,129616641,129698754,82113,-1,0,120224,1,1.21783396051782000000
chr11,129675588,129684635,9047,-1,0,,0,0.00000000000000000000
chr11,129635329,129639526,4197,-1,0,,0,0.00000000000000000000
chr11,129939516,129941209,1693,-1,0,334,1,59.06674542232720000000
chr11,130225329,130230395,5066,-1,0,,0,0.00000000000000000000
chr11,130257425,130257812,387,-1,0,,0,0.00000000000000000000
chr11,130301187,130301686,499,-1,0,,0,0.00000000000000000000
chr11,130402262,130402708,446,-1,0,,0,0.00000000000000000000
chr11,130496396,130496642,246,-1,0,,0,0.00000000000000000000
chr11,130599994,130601470,1476,-1,0,,0,0.00000000000000000000
chr11,130623794,130629259,5465,-1,0,,0,0.00000000000000000000
chr11,130920045,130922088,2043,-1,0,,0,0.00000000000000000000
chr11,130929938,130933200,3262,-1,0,,0,0.00000000000000000000
chr11,130978565,130984885,6320,-1,0,,0,0.00000000000000000000
chr11,131201877,131205244,3367,-1,0,,0,0.00000000000000000000
chr11,131499994,131500526,532,-1,0,50863,1,187.96992481203000000000
chr11,131550823,131551753,930,-1,0,50863,1,107.52688172043000000000
chr11,131596192,131597235,1043,-1,0,50863,1,95.87727708533080000000
chr11,131719661,131724559,4898,-1,0,50863,1,20.41649652919560000000
chr11,131938962,131941316,2354,-1,0,50863,1,42.48088360237890000000
chr11,131939025,131940031,1006,-1,0,50863,1,99.40357852882700000000
chr11,131939237,131939601,364,-1,0,50863,1,274.72527472527500000000
chr11,132083497,132084049,552,-1,0,50863,1,181.15942028985500000000
chr11,132083612,132083926,314,-1,0,50863,1,318.47133757961800000000
chr11,132558444,132559030,586,-1,0,4978,1,170.64846416382300000000
chr11,132558582,132558874,292,-1,0,4978,1,342.46575342465800000000
chr11,132586071,132586536,465,-1,0,4978,1,215.05376344086000000000
chr11,132992183,133004841,12658,-1,0,4978,1,7.90014220255965000000
chr11,133010642,133011180,538,-1,0,4978,1,185.87360594795500000000
chr11,133020573,133025055,4482,-1,0,4978,1,22.31146809460060000000
chr11,133101617,133102099,482,-1,0,4978,1,207.46887966805000000000
chr11,133101616,133102023,407,-1,0,4978,1,245.70024570024600000000
chr11,133319426,133322948,3522,-1,0,4978,1,28.39295854628050000000
chr11,133915757,133916311,554,-1,0,,0,0.00000000000000000000
chr11,133961817,133964627,2810,-1,0,83700,1,35.58718861209960000000
chr11,134003867,134008051,4184,-1,0,83700,1,23.90057361376670000000
chr11,134033370,134037911,4541,-1,0,23310,1,22.02158114952650000000
chr11,134150014,134209545,59531,-1,0,89944;112937,2,3.35959416102535000000
chr11,134191446,134195837,4391,-1,0,,0,0.00000000000000000000
chr11,134178034,134178246,212,-1,0,112937,1,471.69811320754700000000
chr11,134258276,134283388,25112,-1,0,27087,1,3.98215992354253000000
chr11,134327575,134327919,344,-1,0,,0,0.00000000000000000000
chr11,134354223,134474373,120150,-1,0,,0,0.00000000000000000000
chr11,134396588,134404678,8090,-1,0,,0,0.00000000000000000000
chr11,134403909,134407554,3645,-1,0,,0,0.00000000000000000000
chr11,134362423,134365435,3012,-1,0,,0,0.00000000000000000000
chr11,134377574,134378076,502,-1,0,,0,0.00000000000000000000
chr11,134401433,134401878,445,-1,0,,0,0.00000000000000000000
chr11,134359298,134359638,340,-1,0,,0,0.00000000000000000000
chr11,134359365,134359563,198,-1,0,,0,0.00000000000000000000
chr11,134401611,134401691,80,-1,0,,0,0.00000000000000000000
chr11,134849098,134942670,93572,-1,0,,0,0.00000000000000000000
chr11,134893915,134940416,46501,-1,0,,0,0.00000000000000000000
chr11,134760144,134777534,17390,-1,0,,0,0.00000000000000000000
chr11,134752532,134763029,10497,-1,0,,0,0.00000000000000000000
chr11,134794751,134800338,5587,-1,0,,0,0.00000000000000000000
chr11,134742195,134748769,6574,-1,0,,0,0.00000000000000000000
chr11,134601642,134607732,6090,-1,0,,0,0.00000000000000000000
chr11,134887132,134892209,5077,-1,0,,0,0.00000000000000000000
chr11,134679604,134684542,4938,-1,0,,0,0.00000000000000000000
chr11,134796449,134799896,3447,-1,0,,0,0.00000000000000000000
chr11,134730745,134734392,3647,-1,0,,0,0.00000000000000000000
chr11,134909735,134912643,2908,-1,0,,0,0.00000000000000000000
chr11,134603907,134606696,2789,-1,0,,0,0.00000000000000000000
chr11,134803518,134805498,1980,-1,0,,0,0.00000000000000000000
chr11,134605344,134607519,2175,-1,0,,0,0.00000000000000000000
chr11,134603314,134605144,1830,-1,0,,0,0.00000000000000000000
chr11,134732881,134734115,1234,-1,0,,0,0.00000000000000000000
chr11,134605137,134606007,870,-1,0,,0,0.00000000000000000000
chr11,134709366,134710218,852,-1,0,,0,0.00000000000000000000
chr11,134733382,134733981,599,-1,0,,0,0.00000000000000000000
chr11,134605038,134605601,563,-1,0,,0,0.00000000000000000000
chr11,134630106,134630313,207,-1,0,,0,0.00000000000000000000
chr12,152859,192077,39218,-1,0,440073,1,2.54984955887603000000
chr12,171293,189518,18225,-1,0,440073,1,5.48696844993141000000
chr12,177352,188208,10856,-1,0,440073,1,9.21149594694178000000
chr12,240264,242267,2003,-1,0,440073,1,49.92511233150280000000
chr12,377028,384899,7871,-1,0,,0,0.00000000000000000000
chr12,762260,769602,7342,-1,0,4815,1,13.62026695723240000000
chr12,292191,297985,5794,-1,0,,0,0.00000000000000000000
chr12,528662,531448,2786,-1,0,84318,1,35.89375448671930000000
chr12,620246,622392,2146,-1,0,283358,1,46.59832246039140000000
chr12,529702,531061,1359,-1,0,84318,1,73.58351729212660000000
chr12,518319,519137,818,-1,0,84318,1,122.24938875305600000000
chr12,699735,700407,672,-1,0,4815,1,148.80952380952400000000
chr12,522693,523529,836,-1,0,84318,1,119.61722488038300000000
chr12,620294,620842,548,-1,0,283358,1,182.48175182481800000000
chr12,325177,325380,203,-1,0,,0,0.00000000000000000000
chr12,699926,700183,257,-1,0,4815,1,389.10505836575900000000
chr12,853219,874018,20799,-1,0,65125,1,4.80792345785855000000
chr12,867312,880840,13528,-1,0,65125,1,7.39207569485512000000
chr12,866670,875096,8426,-1,0,65125,1,11.86802753382390000000
chr12,868381,874497,6116,-1,0,65125,1,16.35055591890120000000
chr12,1028768,1029610,842,-1,0,5893,1,118.76484560570100000000
chr12,1453372,1464662,11290,-1,0,23085,1,8.85739592559787000000
chr12,1194253,1200053,5800,-1,0,23085,1,17.24137931034480000000
chr12,1073532,1079282,5750,-1,0,5893,1,17.39130434782610000000
chr12,1230709,1231858,1149,-1,0,23085,1,87.03220191470840000000
chr12,1230869,1231688,819,-1,0,23085,1,122.10012210012200000000
chr12,1365580,1366373,793,-1,0,23085,1,126.10340479192900000000
chr12,1437989,1438610,621,-1,0,23085,1,161.03059581320500000000
chr12,1480524,1481080,556,-1,0,23085,1,179.85611510791400000000
chr12,1402213,1402760,547,-1,0,23085,1,182.81535648994500000000
chr12,1230715,1231158,443,-1,0,23085,1,225.73363431151200000000
chr12,1160882,1161271,389,-1,0,23085,1,257.06940874036000000000
chr12,1402552,1402781,229,-1,0,23085,1,436.68122270742400000000
chr12,1480684,1480923,239,-1,0,23085,1,418.41004184100400000000
chr12,1594811,1630564,35753,-1,0,23085,1,2.79696808659413000000
chr12,1581630,1587859,6229,-1,0,23085,1,16.05394124257510000000
chr12,1639121,1640644,1523,-1,0,,0,0.00000000000000000000
chr12,1687564,1688617,1053,-1,0,144699,1,94.96676163342830000000
chr12,1702480,1705128,2648,-1,0,144699,1,37.76435045317220000000
chr12,1708510,1708704,194,-1,0,,0,0.00000000000000000000
chr12,1770303,1770583,280,-1,0,,0,0.00000000000000000000
chr12,1863982,1864403,421,-1,0,79602,1,237.52969121140100000000
chr12,1864005,1864321,316,-1,0,79602,1,316.45569620253200000000
chr12,1883987,1884209,222,-1,0,79602,1,450.45045045045000000000
chr12,1924407,1924880,473,-1,0,93589,1,211.41649048625800000000
chr12,1948014,1985667,37653,-1,0,93589,1,2.65583087668977000000
chr12,2017759,2018115,356,-1,0,93589,1,280.89887640449400000000
chr12,2017891,2018055,164,-1,0,93589,1,609.75609756097600000000
chr12,2030727,2031208,481,-1,0,,0,0.00000000000000000000
chr12,2161293,2163766,2473,-1,0,775,1,40.43671653861710000000
chr12,2214565,2216674,2109,-1,0,775,1,47.41583688952110000000
chr12,2215093,2215625,532,-1,0,775,1,187.96992481203000000000
chr12,2235816,2259049,23233,-1,0,775,1,4.30422244221581000000
chr12,2245897,2262138,16241,-1,0,775,1,6.15725632658087000000
chr12,2245351,2257965,12614,-1,0,775,1,7.92769938163945000000
chr12,2247818,2255848,8030,-1,0,775,1,12.45330012453300000000
chr12,2331529,2332327,798,-1,0,775,1,125.31328320802000000000
chr12,2365243,2367243,2000,-1,0,775,1,50.00000000000000000000
chr12,2461758,2461893,135,-1,0,775,1,740.74074074074100000000
chr12,2516426,2516911,485,-1,0,775,1,206.18556701030900000000
chr12,2546919,2547287,368,-1,0,775,1,271.73913043478300000000
chr12,2800601,2852184,51583,-1,0,775,1,1.93862318981060000000
chr12,2864882,2870167,5285,-1,0,,0,0.00000000000000000000
chr12,2868185,2871018,2833,-1,0,,0,0.00000000000000000000
chr12,2868137,2869457,1320,-1,0,,0,0.00000000000000000000
chr12,2877419,2877786,367,-1,0,,0,0.00000000000000000000
chr12,2903730,2905945,2215,-1,0,2288,1,45.14672686230250000000
chr12,2952914,2953430,516,-1,0,,0,0.00000000000000000000
chr12,2987464,2991845,4381,-1,0,83695,1,22.82583884957770000000
chr12,3079112,3092517,13405,-1,0,7004,1,7.45990302126072000000
chr12,3075916,3077364,1448,-1,0,7004,1,69.06077348066300000000
chr12,3143042,3143434,392,-1,0,7004,1,255.10204081632700000000
chr12,3152407,3152834,427,-1,0,,0,0.00000000000000000000
chr12,3306841,3310418,3577,-1,0,10867,1,27.95638803466590000000
chr12,3306798,3308118,1320,-1,0,10867,1,75.75757575757580000000
chr12,3306922,3307756,834,-1,0,10867,1,119.90407673860900000000
chr12,3307640,3308026,386,-1,0,10867,1,259.06735751295300000000
chr12,3340962,3346857,5895,-1,0,10867,1,16.96352841391010000000
chr12,3377309,3379044,1735,-1,0,10867,1,57.63688760806920000000
chr12,3570829,3572215,1386,-1,0,56341,1,72.15007215007210000000
chr12,3664694,3665396,702,-1,0,56341,1,142.45014245014200000000
chr12,4043664,4044814,1150,-1,0,,0,0.00000000000000000000
chr12,4043937,4044510,573,-1,0,,0,0.00000000000000000000
chr12,4074937,4075308,371,-1,0,,0,0.00000000000000000000
chr12,4388714,4389452,738,-1,0,894,1,135.50135501355000000000
chr12,4388814,4389265,451,-1,0,894,1,221.72949002217300000000
chr12,4562126,4563854,1728,-1,0,,0,0.00000000000000000000
chr12,4811282,4811336,54,-1,0,,0,0.00000000000000000000
chr12,4931294,4956958,25664,-1,0,3742,1,3.89650872817955000000
chr12,5081836,5083545,1709,-1,0,,0,0.00000000000000000000
chr12,5082189,5083174,985,-1,0,,0,0.00000000000000000000
chr12,5082182,5082679,497,-1,0,,0,0.00000000000000000000
chr12,5082890,5083104,214,-1,0,,0,0.00000000000000000000
chr12,5235862,5406692,170830,-1,0,,0,0.00000000000000000000
chr12,5221801,5223454,1653,-1,0,,0,0.00000000000000000000
chr12,5222011,5223399,1388,-1,0,,0,0.00000000000000000000
chr12,5320992,5321543,551,-1,0,,0,0.00000000000000000000
chr12,5321144,5321347,203,-1,0,,0,0.00000000000000000000
chr12,5321240,5321345,105,-1,0,,0,0.00000000000000000000
chr12,5470869,5471965,1096,-1,0,,0,0.00000000000000000000
chr12,5629375,5632242,2867,-1,0,,0,0.00000000000000000000
chr12,5658299,5660803,2504,-1,0,,0,0.00000000000000000000
chr12,6248073,6260032,11959,-1,0,,0,0.00000000000000000000
chr12,6241411,6248109,6698,-1,0,,0,0.00000000000000000000
chr12,6254520,6260675,6155,-1,0,,0,0.00000000000000000000
chr12,6255426,6260529,5103,-1,0,,0,0.00000000000000000000
chr12,6037697,6041890,4193,-1,0,57101,1,23.84927259718580000000
chr12,6243734,6247821,4087,-1,0,,0,0.00000000000000000000
chr12,6037698,6039392,1694,-1,0,57101,1,59.03187721369540000000
chr12,6040603,6041806,1203,-1,0,57101,1,83.12551953449710000000
chr12,6399188,6400844,1656,-1,0,,0,0.00000000000000000000
chr12,6506331,6508094,1763,-1,0,,0,0.00000000000000000000
chr12,6538357,6538767,410,-1,0,,0,0.00000000000000000000
chr12,6603342,6603705,363,-1,0,9918,1,275.48209366391200000000
chr12,6613332,6613397,65,-1,0,9918,1,1538.46153846154000000000
chr12,6688208,6688343,135,-1,0,1108,1,740.74074074074100000000
chr12,6818790,6821086,2296,-1,0,,0,0.00000000000000000000
chr12,6847721,6848510,789,-1,0,,0,0.00000000000000000000
chr12,6907383,6907639,256,-1,0,920,1,390.62500000000000000000
chr12,7062004,7070240,8236,-1,0,5777,1,12.14181641573580000000
chr12,7348744,7350002,1258,-1,0,5830,1,79.49125596184420000000
chr12,7349532,7349609,77,-1,0,5830,1,1298.70129870130000000000
chr12,7671031,7677366,6335,-1,0,,0,0.00000000000000000000
chr12,7716291,7721286,4995,-1,0,,0,0.00000000000000000000
chr12,7822610,7824368,1758,-1,0,339,1,56.88282138794080000000
chr12,7799640,7800593,953,-1,0,,0,0.00000000000000000000
chr12,7832612,7833169,557,-1,0,,0,0.00000000000000000000
chr12,7832761,7832952,191,-1,0,,0,0.00000000000000000000
chr12,7844033,7852732,8699,-1,0,9573,1,11.49557420393150000000
chr12,7858943,7859088,145,-1,0,,0,0.00000000000000000000
chr12,7875600,7881712,6112,-1,0,,0,0.00000000000000000000
chr12,7885022,7886564,1542,-1,0,170482,1,64.85084306095980000000
chr12,7999826,8212102,212276,-1,0,144195;719;55810;6515,4,1.88433925643973000000
chr12,7951681,8058711,107030,-1,0,144195,1,0.93431748108007100000
chr12,8033570,8112879,79309,-1,0,144195;6515,2,2.52178189108424000000
chr12,8132144,8134000,1856,-1,0,,0,0.00000000000000000000
chr12,8151681,8152160,479,-1,0,,0,0.00000000000000000000
chr12,7968677,7969196,519,-1,0,144195,1,192.67822736030800000000
chr12,8151841,8152174,333,-1,0,,0,0.00000000000000000000
chr12,7977844,7978146,302,-1,0,144195,1,331.12582781457000000000
chr12,8376218,8399067,22849,-1,0,55138,1,4.37655914919690000000
chr12,8362028,8379372,17344,-1,0,55138,1,5.76568265682657000000
chr12,8357986,8369760,11774,-1,0,,0,0.00000000000000000000
chr12,8361506,8371323,9817,-1,0,,0,0.00000000000000000000
chr12,8388919,8398375,9456,-1,0,,0,0.00000000000000000000
chr12,8371192,8379562,8370,-1,0,55138,1,11.94743130227000000000
chr12,8406113,8408828,2715,-1,0,,0,0.00000000000000000000
chr12,8498824,8506136,7312,-1,0,,0,0.00000000000000000000
chr12,8558514,8591569,33055,-1,0,,0,0.00000000000000000000
chr12,8568916,8587030,18114,-1,0,,0,0.00000000000000000000
chr12,8575843,8596693,20850,-1,0,,0,0.00000000000000000000
chr12,8558500,8568269,9769,-1,0,,0,0.00000000000000000000
chr12,8538977,8546383,7406,-1,0,,0,0.00000000000000000000
chr12,8625458,8626007,549,-1,0,93978,1,182.14936247723100000000
chr12,8599441,8599878,437,-1,0,,0,0.00000000000000000000
chr12,8625580,8625909,329,-1,0,93978,1,303.95136778115500000000
chr12,8825611,8827346,1735,-1,0,,0,0.00000000000000000000
chr12,8850160,8851893,1733,-1,0,57494,1,57.70340450086550000000
chr12,8893792,8899185,5393,-1,0,57494,1,18.54255516410160000000
chr12,9009996,9014381,4385,-1,0,144568,1,22.80501710376280000000
chr12,9016604,9018118,1514,-1,0,144568,1,66.05019815059450000000
chr12,9016852,9017886,1034,-1,0,144568,1,96.71179883945840000000
chr12,9053007,9053974,967,-1,0,,0,0.00000000000000000000
chr12,9129772,9132945,3173,-1,0,10219,1,31.51591553734640000000
chr12,9180892,9181950,1058,-1,0,,0,0.00000000000000000000
chr12,9493785,9708683,214898,-1,0,,0,0.00000000000000000000
chr12,9631892,9733437,101545,-1,0,,0,0.00000000000000000000
chr12,9637284,9704461,67177,-1,0,,0,0.00000000000000000000
chr12,9635126,9688883,53757,-1,0,,0,0.00000000000000000000
chr12,9555401,9592000,36599,-1,0,,0,0.00000000000000000000
chr12,9521233,9552212,30979,-1,0,,0,0.00000000000000000000
chr12,9634047,9663173,29126,-1,0,,0,0.00000000000000000000
chr12,9555403,9561169,5766,-1,0,,0,0.00000000000000000000
chr12,9555118,9558973,3855,-1,0,,0,0.00000000000000000000
chr12,9558619,9561168,2549,-1,0,,0,0.00000000000000000000
chr12,9557548,9558943,1395,-1,0,,0,0.00000000000000000000
chr12,9555953,9557489,1536,-1,0,,0,0.00000000000000000000
chr12,9559148,9560663,1515,-1,0,,0,0.00000000000000000000
chr12,9555111,9556461,1350,-1,0,,0,0.00000000000000000000
chr12,9557759,9558799,1040,-1,0,,0,0.00000000000000000000
chr12,9722036,9723012,976,-1,0,,0,0.00000000000000000000
chr12,9555952,9556702,750,-1,0,,0,0.00000000000000000000
chr12,9559291,9559845,554,-1,0,,0,0.00000000000000000000
chr12,9504776,9505192,416,-1,0,,0,0.00000000000000000000
chr12,9615517,9615909,392,-1,0,,0,0.00000000000000000000
chr12,9620631,9620700,69,-1,0,,0,0.00000000000000000000
chr12,9861540,9876300,14760,-1,0,160365,1,6.77506775067751000000
chr12,10245956,10247223,1267,-1,0,51267,1,78.92659826361480000000
chr12,10407411,10407721,310,-1,0,,0,0.00000000000000000000
chr12,10566993,10598861,31868,-1,0,3823;3821;3822,3,9.41383205723610000000
chr12,10581251,10597043,15792,-1,0,3821;3822,2,12.66464032421480000000
chr12,10571918,10587542,15624,-1,0,3823;3822,2,12.80081925243220000000
chr12,10584510,10599984,15474,-1,0,3821;3822,2,12.92490629442940000000
chr12,10581398,10586846,5448,-1,0,3822,1,18.35535976505140000000
chr12,10629029,10630132,1103,-1,0,,0,0.00000000000000000000
chr12,10703383,10703930,547,-1,0,,0,0.00000000000000000000
chr12,10721202,10722944,1742,-1,0,,0,0.00000000000000000000
chr12,10741575,10741834,259,-1,0,,0,0.00000000000000000000
chr12,10741646,10741744,98,-1,0,,0,0.00000000000000000000
chr12,10813065,10813239,174,-1,0,55359,1,574.71264367816100000000
chr12,11161991,11276176,114185,-1,0,5554;259289;259294;259290;106707243;259292,6,5.25463064325437000000
chr12,11215351,11287550,72199,-1,0,259289;5554;259293;106707243,4,5.54024293965290000000
chr12,11160203,11223393,63190,-1,0,5554;259294;259290;106707243;259292,5,7.91264440576041000000
chr12,11497200,11568886,71686,-1,0,653247;5542,2,2.78994503808275000000
chr12,11187295,11248263,60968,-1,0,259289;5554;106707243;259292,4,6.56081879018502000000
chr12,11235631,11278553,42922,-1,0,259289;5554;106707243,3,6.98942267368715000000
chr12,11505247,11545500,40253,-1,0,653247;5542,2,4.96857377089906000000
chr12,11479465,11510834,31369,-1,0,5542,1,3.18786062673340000000
chr12,11219813,11254335,34522,-1,0,259289;5554;106707243,3,8.69011065407566000000
chr12,11525297,11563520,38223,-1,0,653247,1,2.61622583261387000000
chr12,11504479,11533692,29213,-1,0,5542,1,3.42313353643926000000
chr12,11191681,11217625,25944,-1,0,5554;106707243;259292,3,11.56336725254390000000
chr12,11178256,11205129,26873,-1,0,5554;259290;106707243,3,11.16362147880770000000
chr12,11227081,11251139,24058,-1,0,259289;5554;106707243,3,12.46986449413920000000
chr12,11523586,11544818,21232,-1,0,653247,1,4.70987189148455000000
chr12,11224984,11240896,15912,-1,0,5554;106707243,2,12.56913021618900000000
chr12,11490831,11503680,12849,-1,0,,0,0.00000000000000000000
chr12,11511610,11526289,14679,-1,0,,0,0.00000000000000000000
chr12,11218246,11228232,9986,-1,0,5554;106707243,2,20.02803925495690000000
chr12,11556634,11567033,10399,-1,0,,0,0.00000000000000000000
chr12,11186579,11192346,5767,-1,0,5554;106707243,2,34.68007629616790000000
chr12,11113753,11114323,570,-1,0,5554;106707243,2,350.87719298245600000000
chr12,11341897,11342212,315,-1,0,,0,0.00000000000000000000
chr12,11258498,11258850,352,-1,0,5554;106707243,2,568.18181818181800000000
chr12,11068045,11068299,254,-1,0,5554,1,393.70078740157500000000
chr12,11288103,11288156,53,-1,0,5554;106707243,2,3773.58490566038000000000
chr12,11581881,11583088,1207,-1,0,,0,0.00000000000000000000
chr12,12510135,12542035,31900,-1,0,118426,1,3.13479623824451000000
chr12,12531479,12542555,11076,-1,0,118426,1,9.02853015529072000000
chr12,12536384,12542562,6178,-1,0,118426,1,16.18646811265780000000
chr12,12541492,12549196,7704,-1,0,118426,1,12.98026998961580000000
chr12,12537737,12541875,4138,-1,0,118426,1,24.16626389560170000000
chr12,12536907,12539778,2871,-1,0,118426,1,34.83106931382790000000
chr12,12026210,12027732,1522,-1,0,2120,1,65.70302233902760000000
chr12,12252799,12254698,1899,-1,0,,0,0.00000000000000000000
chr12,12569769,12571072,1303,-1,0,118426,1,76.74597083653110000000
chr12,12898143,12899170,1027,-1,0,81575,1,97.37098344693280000000
chr12,12026413,12027154,741,-1,0,2120,1,134.95276653171400000000
chr12,12253382,12254214,832,-1,0,,0,0.00000000000000000000
chr12,13177427,13178188,761,-1,0,,0,0.00000000000000000000
chr12,11770818,11771558,740,-1,0,,0,0.00000000000000000000
chr12,12807247,12807941,694,-1,0,,0,0.00000000000000000000
chr12,13017539,13018083,544,-1,0,,0,0.00000000000000000000
chr12,13198843,13199320,477,-1,0,57613,1,209.64360587002100000000
chr12,12026486,12026932,446,-1,0,2120,1,224.21524663677100000000
chr12,13017634,13017948,314,-1,0,,0,0.00000000000000000000
chr12,12201023,12201230,207,-1,0,,0,0.00000000000000000000
chr12,13199078,13199184,106,-1,0,57613,1,943.39622641509400000000
chr12,13257285,13259836,2551,-1,0,,0,0.00000000000000000000
chr12,13545223,13552503,7280,-1,0,,0,0.00000000000000000000
chr12,13725909,13726559,650,-1,0,2904,1,153.84615384615400000000
chr12,13941591,13941767,176,-1,0,2904,1,568.18181818181800000000
chr12,13941609,13941706,97,-1,0,2904,1,1030.92783505155000000000
chr12,14052327,14052820,493,-1,0,2904,1,202.83975659229200000000
chr12,14213815,14216709,2894,-1,0,,0,0.00000000000000000000
chr12,14258600,14258932,332,-1,0,,0,0.00000000000000000000
chr12,14738969,14739221,252,-1,0,,0,0.00000000000000000000
chr12,14853549,14854280,731,-1,0,,0,0.00000000000000000000
chr12,14945386,14945508,122,-1,0,51729,1,819.67213114754100000000
chr12,15243948,15244523,575,-1,0,,0,0.00000000000000000000
chr12,15425234,15448400,23166,-1,0,,0,0.00000000000000000000
chr12,15455942,15461351,5409,-1,0,,0,0.00000000000000000000
chr12,15567937,15573640,5703,-1,0,5800,1,17.53463089601960000000
chr12,15666014,15666131,117,-1,0,5800,1,854.70085470085500000000
chr12,15899295,15906500,7205,-1,0,2059,1,13.87925052047190000000
chr12,16018653,16021656,3003,-1,0,,0,0.00000000000000000000
chr12,16018882,16020170,1288,-1,0,,0,0.00000000000000000000
chr12,16420100,16421461,1361,-1,0,729025,1,73.47538574577520000000
chr12,16307233,16309190,1957,-1,0,,0,0.00000000000000000000
chr12,16942279,16943664,1385,-1,0,,0,0.00000000000000000000
chr12,16631091,16632298,1207,-1,0,,0,0.00000000000000000000
chr12,16420167,16420965,798,-1,0,729025,1,125.31328320802000000000
chr12,16883241,16884052,811,-1,0,,0,0.00000000000000000000
chr12,16306765,16307384,619,-1,0,,0,0.00000000000000000000
chr12,16420127,16420637,510,-1,0,729025,1,196.07843137254900000000
chr12,17444399,17446234,1835,-1,0,,0,0.00000000000000000000
chr12,17444750,17445950,1200,-1,0,,0,0.00000000000000000000
chr12,17589210,17601325,12115,-1,0,,0,0.00000000000000000000
chr12,17616372,17617614,1242,-1,0,,0,0.00000000000000000000
chr12,17607453,17608195,742,-1,0,,0,0.00000000000000000000
chr12,17607308,17607811,503,-1,0,,0,0.00000000000000000000
chr12,17894040,17894509,469,-1,0,,0,0.00000000000000000000
chr12,17894159,17894410,251,-1,0,,0,0.00000000000000000000
chr12,18056257,18290019,233762,-1,0,79785,1,0.42778552544896100000
chr12,18225931,18316914,90983,-1,0,79785,1,1.09910642647528000000
chr12,18032234,18034691,2457,-1,0,,0,0.00000000000000000000
chr12,18249683,18250150,467,-1,0,,0,0.00000000000000000000
chr12,18317486,18317915,429,-1,0,,0,0.00000000000000000000
chr12,18348605,18355726,7121,-1,0,,0,0.00000000000000000000
chr12,18385010,18393783,8773,-1,0,,0,0.00000000000000000000
chr12,18521854,18523185,1331,-1,0,5288,1,75.13148009015780000000
chr12,18723006,18725089,2083,-1,0,5288,1,48.00768122899660000000
chr12,18803479,18803859,380,-1,0,,0,0.00000000000000000000
chr12,19458891,19463394,4503,-1,0,54477,1,22.20741727737060000000
chr12,19683963,19687784,3821,-1,0,,0,0.00000000000000000000
chr12,19686043,19688166,2123,-1,0,,0,0.00000000000000000000
chr12,19901584,19901933,349,-1,0,,0,0.00000000000000000000
chr12,20336907,20339680,2773,-1,0,,0,0.00000000000000000000
chr12,20336937,20336995,58,-1,0,,0,0.00000000000000000000
chr12,20487382,20489598,2216,-1,0,,0,0.00000000000000000000
chr12,20862422,20862958,536,-1,0,53919,1,186.56716417910400000000
chr12,20862508,20862855,347,-1,0,53919,1,288.18443804034600000000
chr12,21069193,21486864,417671,-1,0,338821;28234;10599;6579,4,0.95769158021505000000
chr12,21007075,21147386,140311,-1,0,28234,1,0.71270249659684600000
chr12,21254933,21321386,66453,-1,0,10599,1,1.50482295757904000000
chr12,21242299,21300475,58176,-1,0,10599;338821,2,3.43784378437844000000
chr12,21017348,21037222,19874,-1,0,28234,1,5.03169970816142000000
chr12,21008127,21025667,17540,-1,0,28234,1,5.70125427594071000000
chr12,21194824,21196356,1532,-1,0,338821,1,65.27415143603130000000
chr12,20884957,20885792,835,-1,0,53919,1,119.76047904191600000000
chr12,21775420,21775750,330,-1,0,,0,0.00000000000000000000
chr12,21815499,21816988,1489,-1,0,,0,0.00000000000000000000
chr12,22016030,22016492,462,-1,0,10060,1,216.45021645021600000000
chr12,22047473,22047575,102,-1,0,10060,1,980.39215686274500000000
chr12,22129503,22131311,1808,-1,0,,0,0.00000000000000000000
chr12,22248578,22252007,3429,-1,0,,0,0.00000000000000000000
chr12,22322330,22326787,4457,-1,0,,0,0.00000000000000000000
chr12,22344132,22345047,915,-1,0,,0,0.00000000000000000000
chr12,22573513,22583509,9996,-1,0,,0,0.00000000000000000000
chr12,22592630,22599948,7318,-1,0,,0,0.00000000000000000000
chr12,23097452,23098002,550,-1,0,,0,0.00000000000000000000
chr12,23097547,23097879,332,-1,0,,0,0.00000000000000000000
chr12,23153695,23157687,3992,-1,0,,0,0.00000000000000000000
chr12,23795704,23796135,431,-1,0,6660,1,232.01856148491900000000
chr12,23939461,23940185,724,-1,0,6660,1,138.12154696132600000000
chr12,24442373,24442688,315,-1,0,6660,1,317.46031746031700000000
chr12,24456728,24459332,2604,-1,0,6660,1,38.40245775729650000000
chr12,24460411,24460701,290,-1,0,6660,1,344.82758620689700000000
chr12,24940864,24941664,800,-1,0,,0,0.00000000000000000000
chr12,25091777,25132849,41072,-1,0,586,1,2.43474873393066000000
chr12,25263891,25267979,4088,-1,0,55259,1,24.46183953033270000000
chr12,25285419,25285878,459,-1,0,55259,1,217.86492374727700000000
chr12,25316897,25322359,5462,-1,0,55259,1,18.30831197363600000000
chr12,25603607,25604074,467,-1,0,,0,0.00000000000000000000
chr12,25633791,25637206,3415,-1,0,160492,1,29.28257686676430000000
chr12,25647166,25654969,7803,-1,0,160492,1,12.81558374983980000000
chr12,25855170,25862171,7001,-1,0,,0,0.00000000000000000000
chr12,25955931,25959135,3204,-1,0,,0,0.00000000000000000000
chr12,26105393,26106488,1095,-1,0,,0,0.00000000000000000000
chr12,26303485,26303556,71,-1,0,,0,0.00000000000000000000
chr12,26510933,26511483,550,-1,0,3709,1,181.81818181818200000000
chr12,26511037,26511369,332,-1,0,3709,1,301.20481927710800000000
chr12,27161008,27162391,1383,-1,0,51768,1,72.30657989877080000000
chr12,27257209,27791472,534263,-1,0,341346;23012;8496;56938,4,0.74869493114814200000
chr12,27646555,27658697,12142,-1,0,341346,1,8.23587547356284000000
chr12,27647940,27654731,6791,-1,0,341346,1,14.72537181563830000000
chr12,27646326,27651313,4987,-1,0,341346,1,20.05213555243630000000
chr12,27878931,27882869,3938,-1,0,60488,1,25.39360081259520000000
chr12,27914138,27916776,2638,-1,0,100287284,1,37.90750568612590000000
chr12,27932805,27933945,1140,-1,0,57542,1,87.71929824561400000000
chr12,27425651,27426440,789,-1,0,23012,1,126.74271229404300000000
chr12,27433902,27434458,556,-1,0,23012,1,179.85611510791400000000
chr12,27788701,27789400,699,-1,0,8496,1,143.06151645207400000000
chr12,27711258,27711685,427,-1,0,8496,1,234.19203747072600000000
chr12,27434003,27434334,331,-1,0,23012,1,302.11480362537800000000
chr12,27711400,27711530,130,-1,0,8496,1,769.23076923076900000000
chr12,28095574,28098393,2819,-1,0,,0,0.00000000000000000000
chr12,28096440,28098809,2369,-1,0,,0,0.00000000000000000000
chr12,28999893,29019335,19442,-1,0,,0,0.00000000000000000000
chr12,29011018,29017391,6373,-1,0,,0,0.00000000000000000000
chr12,29111725,29112457,732,-1,0,,0,0.00000000000000000000
chr12,29161621,29164824,3203,-1,0,,0,0.00000000000000000000
chr12,29243913,29243994,81,-1,0,,0,0.00000000000000000000
chr12,29280233,29280554,321,-1,0,,0,0.00000000000000000000
chr12,29558508,29566219,7711,-1,0,,0,0.00000000000000000000
chr12,29573311,29573863,552,-1,0,,0,0.00000000000000000000
chr12,29573401,29573746,345,-1,0,,0,0.00000000000000000000
chr12,29843441,29846259,2818,-1,0,83857,1,35.48616039744500000000
chr12,29844651,29846399,1748,-1,0,83857,1,57.20823798627000000000
chr12,29844467,29845571,1104,-1,0,83857,1,90.57971014492750000000
chr12,30232874,30243380,10506,-1,0,,0,0.00000000000000000000
chr12,30014747,30022341,7594,-1,0,,0,0.00000000000000000000
chr12,30237079,30244248,7169,-1,0,,0,0.00000000000000000000
chr12,30209014,30215096,6082,-1,0,,0,0.00000000000000000000
chr12,30288782,30295322,6540,-1,0,,0,0.00000000000000000000
chr12,30151931,30156099,4168,-1,0,,0,0.00000000000000000000
chr12,29956399,29960350,3951,-1,0,,0,0.00000000000000000000
chr12,30239419,30242877,3458,-1,0,,0,0.00000000000000000000
chr12,30009494,30009961,467,-1,0,,0,0.00000000000000000000
chr12,30043760,30043947,187,-1,0,,0,0.00000000000000000000
chr12,30233700,30233849,149,-1,0,,0,0.00000000000000000000
chr12,30371304,30371731,427,-1,0,,0,0.00000000000000000000
chr12,30394917,30405749,10832,-1,0,,0,0.00000000000000000000
chr12,30478311,30485379,7068,-1,0,,0,0.00000000000000000000
chr12,30478280,30480994,2714,-1,0,,0,0.00000000000000000000
chr12,30478330,30478936,606,-1,0,,0,0.00000000000000000000
chr12,30504376,30507799,3423,-1,0,,0,0.00000000000000000000
chr12,30508162,30508633,471,-1,0,,0,0.00000000000000000000
chr12,30615554,30616294,740,-1,0,,0,0.00000000000000000000
chr12,30744574,30746295,1721,-1,0,,0,0.00000000000000000000
chr12,30918295,30918794,499,-1,0,,0,0.00000000000000000000
chr12,31022817,31023129,312,-1,0,,0,0.00000000000000000000
chr12,31022861,31023099,238,-1,0,,0,0.00000000000000000000
chr12,31112831,31115241,2410,-1,0,441631,1,41.49377593361000000000
chr12,31152433,31153019,586,-1,0,,0,0.00000000000000000000
chr12,31269899,31355338,85439,-1,0,,0,0.00000000000000000000
chr12,31309064,31356207,47143,-1,0,,0,0.00000000000000000000
chr12,31271817,31273416,1599,-1,0,,0,0.00000000000000000000
chr12,31270749,31271826,1077,-1,0,,0,0.00000000000000000000
chr12,31275493,31276119,626,-1,0,,0,0.00000000000000000000
chr12,31272175,31272908,733,-1,0,,0,0.00000000000000000000
chr12,31272479,31272794,315,-1,0,,0,0.00000000000000000000
chr12,31275686,31275951,265,-1,0,,0,0.00000000000000000000
chr12,31275739,31275897,158,-1,0,,0,0.00000000000000000000
chr12,31275362,31275442,80,-1,0,,0,0.00000000000000000000
chr12,31723442,31724187,745,-1,0,160518,1,134.22818791946300000000
chr12,31743202,31744209,1007,-1,0,160518,1,99.30486593843100000000
chr12,31773620,31774149,529,-1,0,,0,0.00000000000000000000
chr12,31828002,31830069,2067,-1,0,196394,1,48.37929366231250000000
chr12,31900285,31915110,14825,-1,0,,0,0.00000000000000000000
chr12,31906784,31912086,5302,-1,0,,0,0.00000000000000000000
chr12,31943520,31943809,289,-1,0,,0,0.00000000000000000000
chr12,31945947,31964956,19009,-1,0,,0,0.00000000000000000000
chr12,31952107,31954799,2692,-1,0,,0,0.00000000000000000000
chr12,32023158,32024548,1390,-1,0,,0,0.00000000000000000000
chr12,32051343,32059341,7998,-1,0,,0,0.00000000000000000000
chr12,32052875,32057109,4234,-1,0,,0,0.00000000000000000000
chr12,32148632,32153017,4385,-1,0,,0,0.00000000000000000000
chr12,32327503,32336420,8917,-1,0,636,1,11.21453403611080000000
chr12,32330430,32335920,5490,-1,0,636,1,18.21493624772310000000
chr12,32407025,32407218,193,-1,0,636,1,518.13471502590700000000
chr12,32433904,32442616,8712,-1,0,636,1,11.47842056932970000000
chr12,32443055,32443160,105,-1,0,636,1,952.38095238095300000000
chr12,32449922,32455754,5832,-1,0,636,1,17.14677640603570000000
chr12,32554382,32560021,5639,-1,0,,0,0.00000000000000000000
chr12,32644313,32646809,2496,-1,0,121512,1,40.06410256410260000000
chr12,32808261,32808441,180,-1,0,,0,0.00000000000000000000
chr12,32963583,32963962,379,-1,0,5318,1,263.85224274406300000000
chr12,33296425,33307384,10959,-1,0,,0,0.00000000000000000000
chr12,33300430,33307751,7321,-1,0,,0,0.00000000000000000000
chr12,33301378,33305285,3907,-1,0,,0,0.00000000000000000000
chr12,33264407,33266391,1984,-1,0,,0,0.00000000000000000000
chr12,33380271,33446428,66157,-1,0,,0,0.00000000000000000000
chr12,33383279,33398886,15607,-1,0,,0,0.00000000000000000000
chr12,33379938,33395418,15480,-1,0,,0,0.00000000000000000000
chr12,33387060,33394249,7189,-1,0,,0,0.00000000000000000000
chr12,33387067,33391486,4419,-1,0,,0,0.00000000000000000000
chr12,33509990,33511063,1073,-1,0,,0,0.00000000000000000000
chr12,33620537,33650838,30301,-1,0,,0,0.00000000000000000000
chr12,33721856,33736136,14280,-1,0,,0,0.00000000000000000000
chr12,33713903,33725403,11500,-1,0,,0,0.00000000000000000000
chr12,33715150,33719800,4650,-1,0,,0,0.00000000000000000000
chr12,33770161,33774945,4784,-1,0,,0,0.00000000000000000000
chr12,33715109,33716973,1864,-1,0,,0,0.00000000000000000000
chr12,33823639,33825242,1603,-1,0,,0,0.00000000000000000000
chr12,33859016,33859928,912,-1,0,,0,0.00000000000000000000
chr12,33823940,33824598,658,-1,0,,0,0.00000000000000000000
chr12,33853138,33853354,216,-1,0,,0,0.00000000000000000000
chr12,34447639,34807947,360308,-1,0,,0,0.00000000000000000000
chr12,34582456,34729796,147340,-1,0,,0,0.00000000000000000000
chr12,34696542,34853748,157206,-1,0,,0,0.00000000000000000000
chr12,34422722,34558121,135399,-1,0,,0,0.00000000000000000000
chr12,34228039,34330092,102053,-1,0,,0,0.00000000000000000000
chr12,34463530,34527223,63693,-1,0,,0,0.00000000000000000000
chr12,34669114,34734177,65063,-1,0,,0,0.00000000000000000000
chr12,34482824,34546114,63290,-1,0,,0,0.00000000000000000000
chr12,34517446,34562156,44710,-1,0,,0,0.00000000000000000000
chr12,34464749,34506968,42219,-1,0,,0,0.00000000000000000000
chr12,34683431,34718890,35459,-1,0,,0,0.00000000000000000000
chr12,34252982,34275785,22803,-1,0,,0,0.00000000000000000000
chr12,34248250,34262789,14539,-1,0,,0,0.00000000000000000000
chr12,34742124,34760761,18637,-1,0,,0,0.00000000000000000000
chr12,34698430,34713364,14934,-1,0,,0,0.00000000000000000000
chr12,34791860,34807967,16107,-1,0,,0,0.00000000000000000000
chr12,34255928,34269369,13441,-1,0,,0,0.00000000000000000000
chr12,34254090,34265179,11089,-1,0,,0,0.00000000000000000000
chr12,34098803,34109015,10212,-1,0,,0,0.00000000000000000000
chr12,34206780,34217039,10259,-1,0,,0,0.00000000000000000000
chr12,34405220,34412547,7327,-1,0,,0,0.00000000000000000000
chr12,34070466,34079369,8903,-1,0,,0,0.00000000000000000000
chr12,34256709,34263576,6867,-1,0,,0,0.00000000000000000000
chr12,34355893,34361543,5650,-1,0,,0,0.00000000000000000000
chr12,34733094,34739445,6351,-1,0,,0,0.00000000000000000000
chr12,34314039,34319751,5712,-1,0,,0,0.00000000000000000000
chr12,34840843,34846223,5380,-1,0,,0,0.00000000000000000000
chr12,34845069,34849186,4117,-1,0,,0,0.00000000000000000000
chr12,34490432,34492553,2121,-1,0,,0,0.00000000000000000000
chr12,34463009,34463392,383,-1,0,,0,0.00000000000000000000
chr12,34548450,34548823,373,-1,0,,0,0.00000000000000000000
chr12,34632672,34632813,141,-1,0,,0,0.00000000000000000000
chr12,38016968,38412431,395463,-1,0,,0,0.00000000000000000000
chr12,38044859,38243885,199026,-1,0,,0,0.00000000000000000000
chr12,38217359,38388956,171597,-1,0,,0,0.00000000000000000000
chr12,37992838,38120199,127361,-1,0,,0,0.00000000000000000000
chr12,38294531,38417859,123328,-1,0,,0,0.00000000000000000000
chr12,38094338,38220564,126226,-1,0,,0,0.00000000000000000000
chr12,38067236,38161882,94646,-1,0,,0,0.00000000000000000000
chr12,37987892,38072423,84531,-1,0,,0,0.00000000000000000000
chr12,38047348,38108306,60958,-1,0,,0,0.00000000000000000000
chr12,38310842,38345521,34679,-1,0,,0,0.00000000000000000000
chr12,38024198,38065312,41114,-1,0,,0,0.00000000000000000000
chr12,38072084,38107541,35457,-1,0,,0,0.00000000000000000000
chr12,37991952,38016419,24467,-1,0,,0,0.00000000000000000000
chr12,38278934,38295965,17031,-1,0,,0,0.00000000000000000000
chr12,38313897,38329198,15301,-1,0,,0,0.00000000000000000000
chr12,38155055,38168153,13098,-1,0,,0,0.00000000000000000000
chr12,38103969,38114760,10791,-1,0,,0,0.00000000000000000000
chr12,38180039,38190717,10678,-1,0,,0,0.00000000000000000000
chr12,38009912,38018191,8279,-1,0,,0,0.00000000000000000000
chr12,37999483,38008887,9404,-1,0,,0,0.00000000000000000000
chr12,38342211,38349199,6988,-1,0,,0,0.00000000000000000000
chr12,38141663,38146137,4474,-1,0,,0,0.00000000000000000000
chr12,37993395,37999733,6338,-1,0,,0,0.00000000000000000000
chr12,38335665,38341330,5665,-1,0,,0,0.00000000000000000000
chr12,38136639,38140733,4094,-1,0,,0,0.00000000000000000000
chr12,38061836,38065487,3651,-1,0,,0,0.00000000000000000000
chr12,38143787,38146491,2704,-1,0,,0,0.00000000000000000000
chr12,37991226,37994637,3411,-1,0,,0,0.00000000000000000000
chr12,37976329,37979289,2960,-1,0,,0,0.00000000000000000000
chr12,38147283,38150128,2845,-1,0,,0,0.00000000000000000000
chr12,38084722,38086522,1800,-1,0,,0,0.00000000000000000000
chr12,38068262,38069286,1024,-1,0,,0,0.00000000000000000000
chr12,37993311,37994191,880,-1,0,,0,0.00000000000000000000
chr12,38085925,38086480,555,-1,0,,0,0.00000000000000000000
chr12,38372094,38372281,187,-1,0,,0,0.00000000000000000000
chr12,38660563,38670791,10228,-1,0,,0,0.00000000000000000000
chr12,38729409,38730903,1494,-1,0,,0,0.00000000000000000000
chr12,38745021,38755683,10662,-1,0,,0,0.00000000000000000000
chr12,38921267,38923549,2282,-1,0,,0,0.00000000000000000000
chr12,38974619,38974904,285,-1,0,,0,0.00000000000000000000
chr12,39477795,39483306,5511,-1,0,,0,0.00000000000000000000
chr12,39555922,39556762,840,-1,0,,0,0.00000000000000000000
chr12,39846990,39853332,6342,-1,0,,0,0.00000000000000000000
chr12,39893367,39894715,1348,-1,0,,0,0.00000000000000000000
chr12,40006786,40007329,543,-1,0,225,1,184.16206261510100000000
chr12,40006889,40007216,327,-1,0,225,1,305.81039755351700000000
chr12,40107125,40107197,72,-1,0,283461,1,1388.88888888889000000000
chr12,40179941,40186033,6092,-1,0,114134,1,16.41497045305320000000
chr12,40277919,40280995,3076,-1,0,114134,1,32.50975292587780000000
chr12,40301628,40315950,14322,-1,0,114134,1,6.98226504678118000000
chr12,40298830,40304829,5999,-1,0,114134,1,16.66944490748460000000
chr12,40446322,40456455,10133,-1,0,114134,1,9.86874568242376000000
chr12,40817508,40821585,4077,-1,0,283463,1,24.52783909737550000000
chr12,40864794,40865280,486,-1,0,283463,1,205.76131687242800000000
chr12,40864960,40865118,158,-1,0,283463,1,632.91139240506300000000
chr12,40876482,40885157,8675,-1,0,283463,1,11.52737752161380000000
chr12,40876046,40880202,4156,-1,0,283463,1,24.06159769008660000000
chr12,40875325,40878457,3132,-1,0,283463,1,31.92848020434230000000
chr12,40874459,40876615,2156,-1,0,283463,1,46.38218923933210000000
chr12,40874881,40876567,1686,-1,0,283463,1,59.31198102016610000000
chr12,40881902,40883689,1787,-1,0,283463,1,55.95970900951320000000
chr12,40874364,40875898,1534,-1,0,283463,1,65.18904823989570000000
chr12,40874854,40875972,1118,-1,0,283463,1,89.44543828264760000000
chr12,40876957,40877687,730,-1,0,283463,1,136.98630136986300000000
chr12,40875486,40875959,473,-1,0,283463,1,211.41649048625800000000
chr12,40899194,40904973,5779,-1,0,283463,1,17.30403183941860000000
chr12,41027236,41029186,1950,-1,0,,0,0.00000000000000000000
chr12,41028035,41029015,980,-1,0,,0,0.00000000000000000000
chr12,41143348,41143606,258,-1,0,1272,1,387.59689922480600000000
chr12,41148003,41151202,3199,-1,0,1272,1,31.25976867771180000000
chr12,41167437,41167498,61,-1,0,1272,1,1639.34426229508000000000
chr12,41183094,41183603,509,-1,0,1272,1,196.46365422396900000000
chr12,41183193,41183502,309,-1,0,1272,1,323.62459546925600000000
chr12,41494637,41517839,23202,-1,0,,0,0.00000000000000000000
chr12,41525526,41542040,16514,-1,0,,0,0.00000000000000000000
chr12,41659304,41660508,1204,-1,0,29951,1,83.05647840531560000000
chr12,41659754,41660235,481,-1,0,29951,1,207.90020790020800000000
chr12,41659823,41660143,320,-1,0,29951,1,312.50000000000000000000
chr12,41674860,41675213,353,-1,0,29951,1,283.28611898017000000000
chr12,41752778,41754301,1523,-1,0,29951,1,65.65988181221270000000
chr12,41757294,41757690,396,-1,0,29951,1,252.52525252525300000000
chr12,41757437,41757525,88,-1,0,29951,1,1136.36363636364000000000
chr12,41884776,41912832,28056,-1,0,29951,1,3.56429997148560000000
chr12,41893103,41894929,1826,-1,0,29951,1,54.76451259583790000000
chr12,41899444,41899690,246,-1,0,29951,1,406.50406504065000000000
chr12,42238009,42238927,918,-1,0,,0,0.00000000000000000000
chr12,42506548,42507727,1179,-1,0,283464,1,84.81764206955050000000
chr12,42697826,42700088,2262,-1,0,,0,0.00000000000000000000
chr12,43001290,43002220,930,-1,0,,0,0.00000000000000000000
chr12,43020060,43027458,7398,-1,0,,0,0.00000000000000000000
chr12,43020826,43027419,6593,-1,0,,0,0.00000000000000000000
chr12,43045290,43045903,613,-1,0,,0,0.00000000000000000000
chr12,43152124,43153106,982,-1,0,,0,0.00000000000000000000
chr12,43167811,43176181,8370,-1,0,,0,0.00000000000000000000
chr12,43211842,43212814,972,-1,0,,0,0.00000000000000000000
chr12,43654308,43654865,557,-1,0,,0,0.00000000000000000000
chr12,43654414,43654753,339,-1,0,,0,0.00000000000000000000
chr12,43976674,43979692,3018,-1,0,,0,0.00000000000000000000
chr12,44207114,44208621,1507,-1,0,,0,0.00000000000000000000
chr12,44259452,44260337,885,-1,0,84216,1,112.99435028248600000000
chr12,45902468,45910794,8326,-1,0,,0,0.00000000000000000000
chr12,45273172,45283501,10329,-1,0,4753,1,9.68147933004163000000
chr12,44586418,44594039,7621,-1,0,84216,1,13.12163758037000000000
chr12,45902952,45908448,5496,-1,0,,0,0.00000000000000000000
chr12,45905884,45909544,3660,-1,0,,0,0.00000000000000000000
chr12,44691569,44693359,1790,-1,0,84216,1,55.86592178770950000000
chr12,44691838,44692915,1077,-1,0,84216,1,92.85051067780870000000
chr12,45011064,45011616,552,-1,0,4753,1,181.15942028985500000000
chr12,45967242,45967628,386,-1,0,,0,0.00000000000000000000
chr12,45432257,45432661,404,-1,0,440097,1,247.52475247524800000000
chr12,45548892,45549322,430,-1,0,,0,0.00000000000000000000
chr12,45011173,45011495,322,-1,0,4753,1,310.55900621118000000000
chr12,46472956,46473858,902,-1,0,,0,0.00000000000000000000
chr12,46510656,46510786,130,-1,0,,0,0.00000000000000000000
chr12,46631157,46632071,914,-1,0,81539,1,109.40919037199100000000
chr12,46709216,46710458,1242,-1,0,,0,0.00000000000000000000
chr12,46981218,46990808,9590,-1,0,,0,0.00000000000000000000
chr12,47028556,47033324,4768,-1,0,,0,0.00000000000000000000
chr12,47033927,47035486,1559,-1,0,,0,0.00000000000000000000
chr12,47075254,47075806,552,-1,0,,0,0.00000000000000000000
chr12,47075361,47075708,347,-1,0,,0,0.00000000000000000000
chr12,47677012,47679826,2814,-1,0,,0,0.00000000000000000000
chr12,47732575,47733453,878,-1,0,,0,0.00000000000000000000
chr12,47910998,47911452,454,-1,0,,0,0.00000000000000000000
chr12,47988825,47989915,1090,-1,0,,0,0.00000000000000000000
chr12,48028253,48028386,133,-1,0,,0,0.00000000000000000000
chr12,48412515,48419829,7314,-1,0,,0,0.00000000000000000000
chr12,48672999,48702097,29098,-1,0,,0,0.00000000000000000000
chr12,48708486,48711017,2531,-1,0,,0,0.00000000000000000000
chr12,48709435,48710700,1265,-1,0,,0,0.00000000000000000000
chr12,48725465,48728380,2915,-1,0,,0,0.00000000000000000000
chr12,48910589,48911232,643,-1,0,,0,0.00000000000000000000
chr12,49470008,49470494,486,-1,0,,0,0.00000000000000000000
chr12,49709212,49710565,1353,-1,0,,0,0.00000000000000000000
chr12,49802557,49809399,6842,-1,0,65244,1,14.61560947091490000000
chr12,49824133,49827214,3081,-1,0,65244,1,32.45699448231090000000
chr12,49824021,49824684,663,-1,0,65244,1,150.82956259426800000000
chr12,49841213,49843214,2001,-1,0,65244,1,49.97501249375310000000
chr12,49878847,49879969,1122,-1,0,65244,1,89.12655971479500000000
chr12,50097239,50098481,1242,-1,0,91010,1,80.51529790660230000000
chr12,50272170,50273554,1384,-1,0,23017,1,72.25433526011560000000
chr12,50546205,50549880,3675,-1,0,91012,1,27.21088435374150000000
chr12,50553969,50559093,5124,-1,0,91012,1,19.51600312256050000000
chr12,50973713,50975511,1798,-1,0,57609,1,55.61735261401560000000
chr12,50973785,50975466,1681,-1,0,57609,1,59.48839976204640000000
chr12,51145539,51147586,2047,-1,0,,0,0.00000000000000000000
chr12,51152242,51153248,1006,-1,0,,0,0.00000000000000000000
chr12,51151653,51152209,556,-1,0,,0,0.00000000000000000000
chr12,51216455,51218457,2002,-1,0,,0,0.00000000000000000000
chr12,51340669,51366924,26255,-1,0,613227,1,3.80879832412874000000
chr12,51376739,51380354,3615,-1,0,4891,1,27.66251728907330000000
chr12,51438076,51438538,462,-1,0,,0,0.00000000000000000000
chr12,51590751,51591119,368,-1,0,5463,1,271.73913043478300000000
chr12,51796889,51796941,52,-1,0,9498,1,1923.07692307692000000000
chr12,51949213,51950915,1702,-1,0,,0,0.00000000000000000000
chr12,52096276,52096691,415,-1,0,6334,1,240.96385542168700000000
chr12,52211645,52215992,4347,-1,0,401720,1,23.00437083045780000000
chr12,52214397,52215826,1429,-1,0,401720,1,69.97900629811060000000
chr12,52354615,52355032,417,-1,0,91,1,239.80815347721800000000
chr12,52354756,52354890,134,-1,0,91,1,746.26865671641800000000
chr12,52395072,52395842,770,-1,0,,0,0.00000000000000000000
chr12,52441695,52442181,486,-1,0,3164,1,205.76131687242800000000
chr12,52845104,52874685,29581,-1,0,3854;286887,2,6.76109664987661000000
chr12,52864597,52883879,19282,-1,0,286887;3853,2,10.37236801161710000000
chr12,53086456,53087785,1329,-1,0,374454,1,75.24454477050410000000
chr12,53267306,53268504,1198,-1,0,,0,0.00000000000000000000
chr12,53283753,53285773,2020,-1,0,,0,0.00000000000000000000
chr12,53375633,53378827,3194,-1,0,,0,0.00000000000000000000
chr12,53376442,53378613,2171,-1,0,,0,0.00000000000000000000
chr12,53367424,53368150,726,-1,0,,0,0.00000000000000000000
chr12,53423892,53424105,213,-1,0,1975,1,469.48356807511700000000
chr12,53551313,53552147,834,-1,0,51380,1,119.90407673860900000000
chr12,53892513,53892960,447,-1,0,7786,1,223.71364653243800000000
chr12,53929032,53929810,778,-1,0,11016,1,128.53470437018000000000
chr12,54028669,54030842,2173,-1,0,,0,0.00000000000000000000
chr12,54074794,54076753,1959,-1,0,,0,0.00000000000000000000
chr12,54076222,54076674,452,-1,0,,0,0.00000000000000000000
chr12,54245308,54245798,490,-1,0,,0,0.00000000000000000000
chr12,54245397,54245696,299,-1,0,,0,0.00000000000000000000
chr12,54613258,54614240,982,-1,0,,0,0.00000000000000000000
chr12,54808399,54808760,361,-1,0,3678,1,277.00831024930700000000
chr12,54840582,54841240,658,-1,0,,0,0.00000000000000000000
chr12,54853493,54853831,338,-1,0,121355,1,295.85798816568000000000
chr12,55193019,55194997,1978,-1,0,,0,0.00000000000000000000
chr12,55449776,55450358,582,-1,0,,0,0.00000000000000000000
chr12,55584030,55584927,897,-1,0,,0,0.00000000000000000000
chr12,55610262,55614441,4179,-1,0,,0,0.00000000000000000000
chr12,55704367,55725304,20937,-1,0,390321,1,4.77623346229164000000
chr12,55727208,55728184,976,-1,0,,0,0.00000000000000000000
chr12,55751331,55753326,1995,-1,0,,0,0.00000000000000000000
chr12,55917477,55924773,7296,-1,0,,0,0.00000000000000000000
chr12,56002281,56004267,1986,-1,0,,0,0.00000000000000000000
chr12,56031874,56034678,2804,-1,0,,0,0.00000000000000000000
chr12,56061001,56062767,1766,-1,0,,0,0.00000000000000000000
chr12,56211376,56212111,735,-1,0,84324;29095,2,272.10884353741500000000
chr12,56270217,56272516,2299,-1,0,,0,0.00000000000000000000
chr12,56864042,56864776,734,-1,0,27165;283377,2,272.47956403269800000000
chr12,57110564,57115506,4942,-1,0,4666,1,20.23472278429790000000
chr12,57185322,57187480,2158,-1,0,,0,0.00000000000000000000
chr12,57333795,57382498,48703,-1,0,8608,1,2.05326160606123000000
chr12,57331527,57352203,20676,-1,0,8608,1,4.83652544012381000000
chr12,57951908,57952366,458,-1,0,3798,1,218.34061135371200000000
chr12,58027865,58030802,2937,-1,0,,0,0.00000000000000000000
chr12,58028009,58029242,1233,-1,0,,0,0.00000000000000000000
chr12,58028141,58028960,819,-1,0,,0,0.00000000000000000000
chr12,58385181,58394258,9077,-1,0,,0,0.00000000000000000000
chr12,58509538,58513797,4259,-1,0,,0,0.00000000000000000000
chr12,58544634,58545080,446,-1,0,,0,0.00000000000000000000
chr12,58721488,58731083,9595,-1,0,,0,0.00000000000000000000
chr12,58785522,58788137,2615,-1,0,,0,0.00000000000000000000
chr12,59373897,59374227,330,-1,0,,0,0.00000000000000000000
chr12,59685418,59689180,3762,-1,0,,0,0.00000000000000000000
chr12,59675063,59678748,3685,-1,0,,0,0.00000000000000000000
chr12,59797985,59798238,253,-1,0,,0,0.00000000000000000000
chr12,59834249,59834299,50,-1,0,,0,0.00000000000000000000
chr12,59921061,59939592,18531,-1,0,,0,0.00000000000000000000
chr12,59935725,59949714,13989,-1,0,,0,0.00000000000000000000
chr12,59936935,59945287,8352,-1,0,,0,0.00000000000000000000
chr12,59968939,59970783,1844,-1,0,,0,0.00000000000000000000
chr12,60064670,60066242,1572,-1,0,9194,1,63.61323155216290000000
chr12,60102337,60104064,1727,-1,0,9194,1,57.90387955993050000000
chr12,60432627,60515454,82827,-1,0,,0,0.00000000000000000000
chr12,60434894,60440159,5265,-1,0,,0,0.00000000000000000000
chr12,60521822,60525035,3213,-1,0,,0,0.00000000000000000000
chr12,60444177,60447662,3485,-1,0,,0,0.00000000000000000000
chr12,60412345,60413511,1166,-1,0,,0,0.00000000000000000000
chr12,60753225,60757927,4702,-1,0,,0,0.00000000000000000000
chr12,61086823,61240180,153357,-1,0,,0,0.00000000000000000000
chr12,60853956,60909376,55420,-1,0,,0,0.00000000000000000000
chr12,60873381,60879289,5908,-1,0,,0,0.00000000000000000000
chr12,61091863,61093456,1593,-1,0,,0,0.00000000000000000000
chr12,60933877,60936005,2128,-1,0,,0,0.00000000000000000000
chr12,61092367,61093303,936,-1,0,,0,0.00000000000000000000
chr12,61302181,61302426,245,-1,0,,0,0.00000000000000000000
chr12,61332512,61333365,853,-1,0,,0,0.00000000000000000000
chr12,61345401,61352463,7062,-1,0,,0,0.00000000000000000000
chr12,61400863,61400983,120,-1,0,,0,0.00000000000000000000
chr12,61517722,61600892,83170,-1,0,,0,0.00000000000000000000
chr12,61736464,61736809,345,-1,0,,0,0.00000000000000000000
chr12,62123420,62184467,61047,-1,0,338811,1,1.63808213343817000000
chr12,62267979,62278973,10994,-1,0,338811,1,9.09587047480444000000
chr12,62200765,62211059,10294,-1,0,338811,1,9.71439673596270000000
chr12,62129410,62131636,2226,-1,0,338811,1,44.92362982929020000000
chr12,62294814,62296750,1936,-1,0,338811,1,51.65289256198350000000
chr12,62294852,62295456,604,-1,0,338811,1,165.56291390728500000000
chr12,62393958,62394495,537,-1,0,338811,1,186.21973929236500000000
chr12,62295022,62295252,230,-1,0,338811,1,434.78260869565200000000
chr12,62907471,62907866,395,-1,0,23041,1,253.16455696202500000000
chr12,63232319,63232864,545,-1,0,57460,1,183.48623853211000000000
chr12,63232411,63232740,329,-1,0,57460,1,303.95136778115500000000
chr12,63339329,63339761,432,-1,0,,0,0.00000000000000000000
chr12,63537412,63582333,44921,-1,0,552,1,2.22613031766880000000
chr12,63577587,63607409,29822,-1,0,,0,0.00000000000000000000
chr12,63756904,63761814,4910,-1,0,,0,0.00000000000000000000
chr12,63802799,63804711,1912,-1,0,,0,0.00000000000000000000
chr12,63863535,63869368,5833,-1,0,,0,0.00000000000000000000
chr12,63911687,63912220,533,-1,0,,0,0.00000000000000000000
chr12,63943941,64137064,193123,-1,0,283417,1,0.51780471512973600000
chr12,63949928,63950434,506,-1,0,,0,0.00000000000000000000
chr12,63946727,63946955,228,-1,0,,0,0.00000000000000000000
chr12,64399339,64406051,6712,-1,0,57522,1,14.89868891537540000000
chr12,64420392,64421626,1234,-1,0,57522,1,81.03727714748780000000
chr12,64571519,64572051,532,-1,0,,0,0.00000000000000000000
chr12,64760261,64760530,269,-1,0,115749,1,371.74721189591100000000
chr12,64839273,64840136,863,-1,0,11260,1,115.87485515643100000000
chr12,65017429,65018504,1075,-1,0,283349,1,93.02325581395350000000
chr12,65096586,65098832,2246,-1,0,,0,0.00000000000000000000
chr12,65134626,65135234,608,-1,0,2799,1,164.47368421052600000000
chr12,65134821,65135065,244,-1,0,2799,1,409.83606557377000000000
chr12,65969579,65978548,8969,-1,0,,0,0.00000000000000000000
chr12,66206999,66207472,473,-1,0,,0,0.00000000000000000000
chr12,66207059,66207351,292,-1,0,,0,0.00000000000000000000
chr12,66451140,66451754,614,-1,0,,0,0.00000000000000000000
chr12,66451382,66451452,70,-1,0,,0,0.00000000000000000000
chr12,66526042,66530288,4246,-1,0,,0,0.00000000000000000000
chr12,66527633,66529881,2248,-1,0,,0,0.00000000000000000000
chr12,66678304,66678830,526,-1,0,,0,0.00000000000000000000
chr12,66678512,66678624,112,-1,0,,0,0.00000000000000000000
chr12,66678529,66678598,69,-1,0,,0,0.00000000000000000000
chr12,66756150,66756985,835,-1,0,23426,1,119.76047904191600000000
chr12,66791972,66794133,2161,-1,0,23426,1,46.27487274410000000000
chr12,66958860,66970947,12087,-1,0,23426,1,8.27335153470671000000
chr12,67117008,67117090,82,-1,0,,0,0.00000000000000000000
chr12,67536709,67537156,447,-1,0,,0,0.00000000000000000000
chr12,67536817,67537051,234,-1,0,,0,0.00000000000000000000
chr12,67728358,67733827,5469,-1,0,,0,0.00000000000000000000
chr12,67927292,67928148,856,-1,0,,0,0.00000000000000000000
chr12,68372223,68372298,75,-1,0,,0,0.00000000000000000000
chr12,68442614,68452445,9831,-1,0,,0,0.00000000000000000000
chr12,69022367,69033199,10832,-1,0,5908,1,9.23190546528804000000
chr12,69174849,69174903,54,-1,0,,0,0.00000000000000000000
chr12,69255169,69258352,3183,-1,0,1368,1,31.41690229343390000000
chr12,69255694,69256521,827,-1,0,1368,1,120.91898428053200000000
chr12,69435028,69435336,308,-1,0,,0,0.00000000000000000000
chr12,69557722,69559678,1956,-1,0,,0,0.00000000000000000000
chr12,69629978,69630266,288,-1,0,,0,0.00000000000000000000
chr12,69862253,69862791,538,-1,0,,0,0.00000000000000000000
chr12,70058779,70058998,219,-1,0,144453,1,456.62100456621000000000
chr12,70289881,70290746,865,-1,0,196446,1,115.60693641618500000000
chr12,70594245,70597693,3448,-1,0,,0,0.00000000000000000000
chr12,70679292,70682283,2991,-1,0,4848,1,33.43363423604150000000
chr12,70680967,70682052,1085,-1,0,4848,1,92.16589861751150000000
chr12,70852382,70877775,25393,-1,0,,0,0.00000000000000000000
chr12,70868611,70878968,10357,-1,0,,0,0.00000000000000000000
chr12,70872254,70878236,5982,-1,0,,0,0.00000000000000000000
chr12,70874117,70876453,2336,-1,0,,0,0.00000000000000000000
chr12,71126986,71127444,458,-1,0,5801,1,218.34061135371200000000
chr12,71213530,71214164,634,-1,0,5801,1,157.72870662460600000000
chr12,71532789,71533550,761,-1,0,7103,1,131.40604467805500000000
chr12,71528985,71529073,88,-1,0,7103,1,1136.36363636364000000000
chr12,71567194,71574819,7625,-1,0,,0,0.00000000000000000000
chr12,71602360,71604478,2118,-1,0,,0,0.00000000000000000000
chr12,71602473,71604401,1928,-1,0,,0,0.00000000000000000000
chr12,71603188,71604481,1293,-1,0,,0,0.00000000000000000000
chr12,71758923,71759559,636,-1,0,,0,0.00000000000000000000
chr12,71759167,71759319,152,-1,0,,0,0.00000000000000000000
chr12,71886479,71889779,3300,-1,0,8549,1,30.30303030303030000000
chr12,71958153,71958461,308,-1,0,8549,1,324.67532467532500000000
chr12,72121157,72121302,145,-1,0,,0,0.00000000000000000000
chr12,72326346,72333373,7027,-1,0,121278,1,14.23082396470760000000
chr12,72188813,72190833,2020,-1,0,,0,0.00000000000000000000
chr12,72356516,72358157,1641,-1,0,121278,1,60.93845216331510000000
chr12,72189180,72190763,1583,-1,0,,0,0.00000000000000000000
chr12,72189268,72190545,1277,-1,0,,0,0.00000000000000000000
chr12,72356751,72358101,1350,-1,0,121278,1,74.07407407407410000000
chr12,72243519,72244428,909,-1,0,64786,1,110.01100110011000000000
chr12,72222023,72222764,741,-1,0,,0,0.00000000000000000000
chr12,72397799,72398316,517,-1,0,121278,1,193.42359767891700000000
chr12,72655653,72657196,1543,-1,0,,0,0.00000000000000000000
chr12,72724838,72725568,730,-1,0,29953,1,136.98630136986300000000
chr12,72725140,72725309,169,-1,0,29953,1,591.71597633136100000000
chr12,72739803,72739856,53,-1,0,29953,1,1886.79245283019000000000
chr12,72756791,72765429,8638,-1,0,29953,1,11.57675387821250000000
chr12,72977696,72977860,164,-1,0,29953,1,609.75609756097600000000
chr12,73200139,73371750,171611,-1,0,,0,0.00000000000000000000
chr12,73351665,73441839,90174,-1,0,,0,0.00000000000000000000
chr12,73448362,73499867,51505,-1,0,,0,0.00000000000000000000
chr12,73424877,73447166,22289,-1,0,,0,0.00000000000000000000
chr12,73153179,73156910,3731,-1,0,,0,0.00000000000000000000
chr12,73293289,73293877,588,-1,0,,0,0.00000000000000000000
chr12,73293552,73293673,121,-1,0,,0,0.00000000000000000000
chr12,73388840,73388950,110,-1,0,,0,0.00000000000000000000
chr12,73792694,73819067,26373,-1,0,,0,0.00000000000000000000
chr12,73911164,73911708,544,-1,0,,0,0.00000000000000000000
chr12,73911369,73911480,111,-1,0,,0,0.00000000000000000000
chr12,73911402,73911463,61,-1,0,,0,0.00000000000000000000
chr12,74092608,74103260,10652,-1,0,,0,0.00000000000000000000
chr12,73988313,73998442,10129,-1,0,,0,0.00000000000000000000
chr12,74103236,74105507,2271,-1,0,,0,0.00000000000000000000
chr12,74104693,74105406,713,-1,0,,0,0.00000000000000000000
chr12,73938074,73938762,688,-1,0,,0,0.00000000000000000000
chr12,74103532,74104051,519,-1,0,,0,0.00000000000000000000
chr12,74104030,74104283,253,-1,0,,0,0.00000000000000000000
chr12,74103957,74104032,75,-1,0,,0,0.00000000000000000000
chr12,74140514,74141923,1409,-1,0,,0,0.00000000000000000000
chr12,74210709,74211414,705,-1,0,,0,0.00000000000000000000
chr12,74216027,74216454,427,-1,0,,0,0.00000000000000000000
chr12,74306941,74424389,117448,-1,0,,0,0.00000000000000000000
chr12,74452176,74464669,12493,-1,0,,0,0.00000000000000000000
chr12,74452994,74456268,3274,-1,0,,0,0.00000000000000000000
chr12,74571807,74572021,214,-1,0,,0,0.00000000000000000000
chr12,74644572,74648053,3481,-1,0,,0,0.00000000000000000000
chr12,74644576,74647220,2644,-1,0,,0,0.00000000000000000000
chr12,74678141,74679809,1668,-1,0,,0,0.00000000000000000000
chr12,74964709,74965281,572,-1,0,,0,0.00000000000000000000
chr12,74964906,74965057,151,-1,0,,0,0.00000000000000000000
chr12,75099193,75101472,2279,-1,0,,0,0.00000000000000000000
chr12,75111541,75115529,3988,-1,0,,0,0.00000000000000000000
chr12,75322493,75322717,224,-1,0,,0,0.00000000000000000000
chr12,75337871,75337985,114,-1,0,,0,0.00000000000000000000
chr12,75419776,75421098,1322,-1,0,,0,0.00000000000000000000
chr12,76223916,76230770,6854,-1,0,,0,0.00000000000000000000
chr12,76900693,76901814,1121,-1,0,114882,1,89.20606601248880000000
chr12,77010819,77011170,351,-1,0,,0,0.00000000000000000000
chr12,77105507,77111891,6384,-1,0,,0,0.00000000000000000000
chr12,77115293,77118189,2896,-1,0,,0,0.00000000000000000000
chr12,77674024,77674725,701,-1,0,,0,0.00000000000000000000
chr12,77908611,77909026,415,-1,0,,0,0.00000000000000000000
chr12,77941243,77950567,9324,-1,0,,0,0.00000000000000000000
chr12,78099009,78100734,1725,-1,0,,0,0.00000000000000000000
chr12,78375710,78376399,689,-1,0,89795,1,145.13788098693800000000
chr12,78375997,78376183,186,-1,0,89795,1,537.63440860215100000000
chr12,78625352,78625730,378,-1,0,,0,0.00000000000000000000
chr12,78674319,78674863,544,-1,0,,0,0.00000000000000000000
chr12,78757439,78855056,97617,-1,0,,0,0.00000000000000000000
chr12,79453961,79455062,1101,-1,0,6857,1,90.82652134423250000000
chr12,79598607,79598800,193,-1,0,6857,1,518.13471502590700000000
chr12,79850771,79876501,25730,-1,0,,0,0.00000000000000000000
chr12,79855938,79856864,926,-1,0,,0,0.00000000000000000000
chr12,79885267,79887730,2463,-1,0,,0,0.00000000000000000000
chr12,80088742,80089563,821,-1,0,,0,0.00000000000000000000
chr12,80150462,80165348,14886,-1,0,,0,0.00000000000000000000
chr12,80154914,80162515,7601,-1,0,,0,0.00000000000000000000
chr12,80157196,80162564,5368,-1,0,,0,0.00000000000000000000
chr12,80302687,80304023,1336,-1,0,4659,1,74.85029940119760000000
chr12,80435925,80438533,2608,-1,0,,0,0.00000000000000000000
chr12,80573751,80574237,486,-1,0,,0,0.00000000000000000000
chr12,80614358,80614535,177,-1,0,283310,1,564.97175141242900000000
chr12,80632217,80731302,99085,-1,0,283310,1,1.00923449563506000000
chr12,80680768,80681333,565,-1,0,283310,1,176.99115044247800000000
chr12,80777037,80777967,930,-1,0,,0,0.00000000000000000000
chr12,80823129,80828272,5143,-1,0,,0,0.00000000000000000000
chr12,80825175,80828351,3176,-1,0,,0,0.00000000000000000000
chr12,80853609,80870080,16471,-1,0,374462,1,6.07127678950883000000
chr12,80970963,80979809,8846,-1,0,374462,1,11.30454442685960000000
chr12,81078659,81091477,12818,-1,0,,0,0.00000000000000000000
chr12,81399891,81400296,405,-1,0,,0,0.00000000000000000000
chr12,81421052,81425464,4412,-1,0,,0,0.00000000000000000000
chr12,82011547,82128250,116703,-1,0,8499,1,0.85687600147382700000
chr12,82121585,82144873,23288,-1,0,8499,1,4.29405702507729000000
chr12,82130353,82144268,13915,-1,0,8499,1,7.18648939992814000000
chr12,82137745,82144418,6673,-1,0,8499,1,14.98576352465160000000
chr12,82104399,82109047,4648,-1,0,8499,1,21.51462994836490000000
chr12,82095869,82099252,3383,-1,0,8499,1,29.55956251847470000000
chr12,82026351,82028804,2453,-1,0,8499,1,40.76640847941300000000
chr12,82030096,82032536,2440,-1,0,8499,1,40.98360655737710000000
chr12,82215373,82229516,14143,-1,0,,0,0.00000000000000000000
chr12,82215645,82224117,8472,-1,0,,0,0.00000000000000000000
chr12,82591895,82592374,479,-1,0,,0,0.00000000000000000000
chr12,82971907,82972502,595,-1,0,,0,0.00000000000000000000
chr12,82994332,82994603,271,-1,0,,0,0.00000000000000000000
chr12,83165080,83214031,48951,-1,0,160335,1,2.04285918571633000000
chr12,83238779,83244578,5799,-1,0,160335,1,17.24435247456460000000
chr12,83241899,83243773,1874,-1,0,160335,1,53.36179295624330000000
chr12,83621802,83628527,6725,-1,0,,0,0.00000000000000000000
chr12,83780674,83785456,4782,-1,0,,0,0.00000000000000000000
chr12,83843541,83844958,1417,-1,0,,0,0.00000000000000000000
chr12,83959135,83959656,521,-1,0,,0,0.00000000000000000000
chr12,83844043,83844608,565,-1,0,,0,0.00000000000000000000
chr12,83959218,83959534,316,-1,0,,0,0.00000000000000000000
chr12,84030596,84032795,2199,-1,0,,0,0.00000000000000000000
chr12,84042266,84042613,347,-1,0,,0,0.00000000000000000000
chr12,84163668,84163931,263,-1,0,,0,0.00000000000000000000
chr12,84463346,84619866,156520,-1,0,,0,0.00000000000000000000
chr12,84516602,84581880,65278,-1,0,,0,0.00000000000000000000
chr12,84579588,84593752,14164,-1,0,,0,0.00000000000000000000
chr12,84711874,84719634,7760,-1,0,,0,0.00000000000000000000
chr12,84371205,84378385,7180,-1,0,,0,0.00000000000000000000
chr12,85036114,85040800,4686,-1,0,,0,0.00000000000000000000
chr12,84593113,84596024,2911,-1,0,,0,0.00000000000000000000
chr12,84593126,84595673,2547,-1,0,,0,0.00000000000000000000
chr12,85272567,85273622,1055,-1,0,55117,1,94.78672985781990000000
chr12,85074379,85074986,607,-1,0,,0,0.00000000000000000000
chr12,84484369,84484933,564,-1,0,,0,0.00000000000000000000
chr12,84484475,84484800,325,-1,0,,0,0.00000000000000000000
chr12,85074607,85074800,193,-1,0,,0,0.00000000000000000000
chr12,84707161,84707283,122,-1,0,,0,0.00000000000000000000
chr12,85009889,85009956,67,-1,0,,0,0.00000000000000000000
chr12,85363284,85364486,1202,-1,0,,0,0.00000000000000000000
chr12,85898901,86071871,172970,-1,0,,0,0.00000000000000000000
chr12,85919972,85985150,65178,-1,0,,0,0.00000000000000000000
chr12,86014319,86074073,59754,-1,0,,0,0.00000000000000000000
chr12,86153147,86153600,453,-1,0,,0,0.00000000000000000000
chr12,86143207,86143652,445,-1,0,,0,0.00000000000000000000
chr12,86290462,86290916,454,-1,0,,0,0.00000000000000000000
chr12,86292825,86294252,1427,-1,0,,0,0.00000000000000000000
chr12,86315610,86318754,3144,-1,0,,0,0.00000000000000000000
chr12,86735407,86775882,40475,-1,0,25834,1,2.47066090179123000000
chr12,86695172,86703317,8145,-1,0,25834,1,12.27747084100680000000
chr12,86426099,86432919,6820,-1,0,25834,1,14.66275659824050000000
chr12,86523280,86523679,399,-1,0,25834,1,250.62656641604000000000
chr12,87001744,87002554,810,-1,0,25834,1,123.45679012345700000000
chr12,87204637,87205631,994,-1,0,25834,1,100.60362173038200000000
chr12,87208076,87208218,142,-1,0,25834,1,704.22535211267600000000
chr12,87208035,87208155,120,-1,0,25834,1,833.33333333333300000000
chr12,87316590,87404504,87914,-1,0,,0,0.00000000000000000000
chr12,87315616,87385614,69998,-1,0,,0,0.00000000000000000000
chr12,87452745,87495491,42746,-1,0,,0,0.00000000000000000000
chr12,87410403,87427678,17275,-1,0,,0,0.00000000000000000000
chr12,87249793,87250029,236,-1,0,,0,0.00000000000000000000
chr12,87289654,87289882,228,-1,0,,0,0.00000000000000000000
chr12,87530504,87533520,3016,-1,0,,0,0.00000000000000000000
chr12,88140440,88143903,3463,-1,0,,0,0.00000000000000000000
chr12,89223589,89224974,1385,-1,0,,0,0.00000000000000000000
chr12,89439197,89445055,5858,-1,0,,0,0.00000000000000000000
chr12,89693660,89694515,855,-1,0,,0,0.00000000000000000000
chr12,89747406,89753556,6150,-1,0,,0,0.00000000000000000000
chr12,90101940,90103405,1465,-1,0,,0,0.00000000000000000000
chr12,90485226,90491670,6444,-1,0,,0,0.00000000000000000000
chr12,90487031,90491709,4678,-1,0,,0,0.00000000000000000000
chr12,90487850,90490435,2585,-1,0,,0,0.00000000000000000000
chr12,90489941,90491617,1676,-1,0,,0,0.00000000000000000000
chr12,90632082,90632519,437,-1,0,,0,0.00000000000000000000
chr12,90817105,90884258,67153,-1,0,,0,0.00000000000000000000
chr12,90846076,90846810,734,-1,0,,0,0.00000000000000000000
chr12,90846362,90846598,236,-1,0,,0,0.00000000000000000000
chr12,90890336,90899193,8857,-1,0,,0,0.00000000000000000000
chr12,90971883,90974658,2775,-1,0,,0,0.00000000000000000000
chr12,91241615,91246251,4636,-1,0,,0,0.00000000000000000000
chr12,91614100,91618493,4393,-1,0,,0,0.00000000000000000000
chr12,91658382,91659905,1523,-1,0,,0,0.00000000000000000000
chr12,91722033,91723870,1837,-1,0,,0,0.00000000000000000000
chr12,92475824,92509965,34141,-1,0,,0,0.00000000000000000000
chr12,92497622,92497919,297,-1,0,,0,0.00000000000000000000
chr12,92605984,92607632,1648,-1,0,,0,0.00000000000000000000
chr12,92628121,92636012,7891,-1,0,,0,0.00000000000000000000
chr12,92930859,92930925,66,-1,0,,0,0.00000000000000000000
chr12,93121866,93122133,267,-1,0,,0,0.00000000000000000000
chr12,93210459,93211061,602,-1,0,8411,1,166.11295681063100000000
chr12,93417888,93419860,1972,-1,0,,0,0.00000000000000000000
chr12,93467025,93467515,490,-1,0,,0,0.00000000000000000000
chr12,93467106,93467453,347,-1,0,,0,0.00000000000000000000
chr12,93502367,93505388,3021,-1,0,,0,0.00000000000000000000
chr12,93504292,93505386,1094,-1,0,,0,0.00000000000000000000
chr12,93619553,93619960,407,-1,0,,0,0.00000000000000000000
chr12,93750129,93751620,1491,-1,0,,0,0.00000000000000000000
chr12,93784263,93787903,3640,-1,0,11163,1,27.47252747252750000000
chr12,93894811,93895698,887,-1,0,28977,1,112.73957158962800000000
chr12,93948127,93948562,435,-1,0,,0,0.00000000000000000000
chr12,93964382,93965933,1551,-1,0,8835,1,64.47453255963890000000
chr12,94143270,94144102,832,-1,0,8738,1,120.19230769230800000000
chr12,94197395,94202890,5495,-1,0,8738,1,18.19836214740670000000
chr12,94358262,94358733,471,-1,0,,0,0.00000000000000000000
chr12,94358331,94358648,317,-1,0,,0,0.00000000000000000000
chr12,94443402,94447377,3975,-1,0,,0,0.00000000000000000000
chr12,94541147,94544097,2950,-1,0,10154,1,33.89830508474580000000
chr12,94541948,94543490,1542,-1,0,10154,1,64.85084306095980000000
chr12,94559370,94560079,709,-1,0,10154,1,141.04372355430200000000
chr12,94570852,94571011,159,-1,0,10154,1,628.93081761006300000000
chr12,94669281,94669726,445,-1,0,10154,1,224.71910112359600000000
chr12,95238056,95277380,39324,-1,0,,0,0.00000000000000000000
chr12,95243484,95244605,1121,-1,0,,0,0.00000000000000000000
chr12,95244022,95244449,427,-1,0,,0,0.00000000000000000000
chr12,95285605,95287035,1430,-1,0,,0,0.00000000000000000000
chr12,95343954,95344465,511,-1,0,,0,0.00000000000000000000
chr12,95344056,95344366,310,-1,0,,0,0.00000000000000000000
chr12,95387044,95387273,229,-1,0,55967,1,436.68122270742400000000
chr12,95387009,95387145,136,-1,0,55967,1,735.29411764705900000000
chr12,95588341,95589627,1286,-1,0,55785,1,77.76049766718510000000
chr12,95723144,95723432,288,-1,0,,0,0.00000000000000000000
chr12,96010445,96012433,1988,-1,0,,0,0.00000000000000000000
chr12,96010560,96012150,1590,-1,0,,0,0.00000000000000000000
chr12,96036919,96038964,2045,-1,0,,0,0.00000000000000000000
chr12,96036955,96038088,1133,-1,0,,0,0.00000000000000000000
chr12,96233489,96236775,3286,-1,0,,0,0.00000000000000000000
chr12,96339710,96343124,3414,-1,0,144193,1,29.29115407147040000000
chr12,96587781,96588872,1091,-1,0,2004,1,91.65902841429880000000
chr12,97058294,97058661,367,-1,0,144535,1,272.47956403269800000000
chr12,97220875,97221409,534,-1,0,144535,1,187.26591760299600000000
chr12,97372234,97372617,383,-1,0,,0,0.00000000000000000000
chr12,97554645,97555153,508,-1,0,,0,0.00000000000000000000
chr12,97554741,97555069,328,-1,0,,0,0.00000000000000000000
chr12,97701521,97702041,520,-1,0,,0,0.00000000000000000000
chr12,97701667,97701954,287,-1,0,,0,0.00000000000000000000
chr12,97701799,97701867,68,-1,0,,0,0.00000000000000000000
chr12,97802565,97802779,214,-1,0,,0,0.00000000000000000000
chr12,97992041,97993803,1762,-1,0,,0,0.00000000000000000000
chr12,97951048,97951909,861,-1,0,,0,0.00000000000000000000
chr12,98063011,98065928,2917,-1,0,,0,0.00000000000000000000
chr12,98111570,98112839,1269,-1,0,,0,0.00000000000000000000
chr12,98141576,98142492,916,-1,0,,0,0.00000000000000000000
chr12,98015439,98015830,391,-1,0,,0,0.00000000000000000000
chr12,98015578,98015648,70,-1,0,,0,0.00000000000000000000
chr12,98015644,98015704,60,-1,0,,0,0.00000000000000000000
chr12,98313235,98342834,29599,-1,0,,0,0.00000000000000000000
chr12,98347926,98348289,363,-1,0,,0,0.00000000000000000000
chr12,98670054,98672162,2108,-1,0,,0,0.00000000000000000000
chr12,98670837,98671973,1136,-1,0,,0,0.00000000000000000000
chr12,98631335,98631793,458,-1,0,,0,0.00000000000000000000
chr12,98951561,98958527,6966,-1,0,,0,0.00000000000000000000
chr12,98956811,98963112,6301,-1,0,,0,0.00000000000000000000
chr12,98955384,98959026,3642,-1,0,,0,0.00000000000000000000
chr12,98974050,98974363,313,-1,0,,0,0.00000000000000000000
chr12,99016626,99017951,1325,-1,0,121457,1,75.47169811320750000000
chr12,99288344,99289315,971,-1,0,56899,1,102.98661174047400000000
chr12,99446224,99446529,305,-1,0,56899,1,327.86885245901600000000
chr12,99777916,99798728,20812,-1,0,56899,1,4.80492023832404000000
chr12,99793933,99802776,8843,-1,0,56899,1,11.30837950921630000000
chr12,99791398,99798728,7330,-1,0,56899,1,13.64256480218280000000
chr12,99795455,99798695,3240,-1,0,56899,1,30.86419753086420000000
chr12,99818150,99819935,1785,-1,0,56899,1,56.02240896358540000000
chr12,99992358,100170724,178366,-1,0,196472;56899,2,1.12128993193770000000
chr12,100056644,100116380,59736,-1,0,56899,1,1.67403240926744000000
chr12,99978645,100028429,49784,-1,0,56899,1,2.00867748674273000000
chr12,99992189,100009350,17161,-1,0,56899,1,5.82716624905309000000
chr12,100143471,100157601,14130,-1,0,56899,1,7.07714083510262000000
chr12,100078159,100088153,9994,-1,0,56899,1,10.00600360216130000000
chr12,100156080,100156287,207,-1,0,56899,1,483.09178743961300000000
chr12,100288193,100291769,3576,-1,0,56899,1,27.96420581655480000000
chr12,100289132,100292280,3148,-1,0,56899,1,31.76620076238880000000
chr12,100290404,100291493,1089,-1,0,56899,1,91.82736455463730000000
chr12,100474782,100475930,1148,-1,0,23074,1,87.10801393728220000000
chr12,100675878,100676389,511,-1,0,55681,1,195.69471624266100000000
chr12,100675959,100676260,301,-1,0,55681,1,332.22591362126200000000
chr12,100936502,100944596,8094,-1,0,9971,1,12.35483073881890000000
chr12,101134906,101136863,1957,-1,0,,0,0.00000000000000000000
chr12,101286807,101290269,3462,-1,0,121601,1,28.88503755054880000000
chr12,101756301,101756957,656,-1,0,27340,1,152.43902439024400000000
chr12,101861459,101862046,587,-1,0,,0,0.00000000000000000000
chr12,102102408,102107115,4707,-1,0,56994,1,21.24495432334820000000
chr12,102275872,102277219,1347,-1,0,55332,1,74.23904974016330000000
chr12,102313656,102314746,1090,-1,0,55332,1,91.74311926605500000000
chr12,102313861,102314335,474,-1,0,55332,1,210.97046413502100000000
chr12,102314043,102314183,140,-1,0,55332,1,714.28571428571400000000
chr12,102835883,102839003,3120,-1,0,3479,1,32.05128205128210000000
chr12,103229311,103229646,335,-1,0,,0,0.00000000000000000000
chr12,103229425,103229574,149,-1,0,,0,0.00000000000000000000
chr12,103242057,103242407,350,-1,0,5053,1,285.71428571428600000000
chr12,103259491,103260697,1206,-1,0,5053,1,82.91873963515760000000
chr12,103261652,103262151,499,-1,0,5053,1,200.40080160320600000000
chr12,103261864,103261994,130,-1,0,5053,1,769.23076923076900000000
chr12,103320592,103320829,237,-1,0,,0,0.00000000000000000000
chr12,103839229,103847119,7890,-1,0,374470,1,12.67427122940430000000
chr12,104279566,104287336,7770,-1,0,,0,0.00000000000000000000
chr12,104283731,104287358,3627,-1,0,,0,0.00000000000000000000
chr12,104286656,104287472,816,-1,0,,0,0.00000000000000000000
chr12,104293375,104293762,387,-1,0,,0,0.00000000000000000000
chr12,104378889,104380732,1843,-1,0,6996,1,54.25935973955510000000
chr12,104376826,104378492,1666,-1,0,6996,1,60.02400960384150000000
chr12,104378682,104379370,688,-1,0,6996,1,145.34883720930200000000
chr12,104531219,104532194,975,-1,0,4801,1,102.56410256410300000000
chr12,104619468,104621434,1966,-1,0,7296,1,50.86469989827060000000
chr12,104730683,104732432,1749,-1,0,7296,1,57.17552887364210000000
chr12,104846679,104847994,1315,-1,0,,0,0.00000000000000000000
chr12,105369015,105374180,5165,-1,0,,0,0.00000000000000000000
chr12,105680974,105681597,623,-1,0,,0,0.00000000000000000000
chr12,105772474,105772522,48,-1,0,,0,0.00000000000000000000
chr12,105773487,105773900,413,-1,0,,0,0.00000000000000000000
chr12,105941249,105944499,3250,-1,0,,0,0.00000000000000000000
chr12,106346364,106348134,1770,-1,0,,0,0.00000000000000000000
chr12,106618474,106618981,507,-1,0,,0,0.00000000000000000000
chr12,106640998,106642229,1231,-1,0,10970,1,81.23476848090980000000
chr12,106670754,106671373,619,-1,0,,0,0.00000000000000000000
chr12,108002620,108002767,147,-1,0,121551,1,680.27210884353700000000
chr12,108222532,108222886,354,-1,0,,0,0.00000000000000000000
chr12,108399152,108485406,86254,-1,0,,0,0.00000000000000000000
chr12,108863824,108866430,2606,-1,0,,0,0.00000000000000000000
chr12,108862247,108862909,662,-1,0,,0,0.00000000000000000000
chr12,109632268,109632409,141,-1,0,32,1,709.21985815602800000000
chr12,110151021,110152748,1727,-1,0,84915,1,57.90387955993050000000
chr12,110307311,110307784,473,-1,0,51228,1,211.41649048625800000000
chr12,110679095,110694823,15728,-1,0,,0,0.00000000000000000000
chr12,111044687,111049245,4558,-1,0,,0,0.00000000000000000000
chr12,111226806,111238236,11430,-1,0,,0,0.00000000000000000000
chr12,111471755,111472879,1124,-1,0,23316,1,88.96797153024910000000
chr12,111510937,111512800,1863,-1,0,23316,1,53.67686527106820000000
chr12,111976281,111980010,3729,-1,0,6311,1,26.81684097613300000000
chr12,111976586,111979677,3091,-1,0,6311,1,32.35198964736330000000
chr12,112012856,112027521,14665,-1,0,6311,1,6.81895669962496000000
chr12,112296433,112297169,736,-1,0,8550,1,135.86956521739100000000
chr12,112592565,112593473,908,-1,0,,0,0.00000000000000000000
chr12,112670319,112671820,1501,-1,0,283450,1,66.62225183211190000000
chr12,112761582,112762107,525,-1,0,283450,1,190.47619047619000000000
chr12,112872108,112875350,3242,-1,0,5781,1,30.84515731030230000000
chr12,113019445,113020508,1063,-1,0,22895,1,94.07337723424270000000
chr12,113011838,113012682,844,-1,0,,0,0.00000000000000000000
chr12,113071945,113072258,313,-1,0,22895,1,319.48881789137400000000
chr12,113071986,113072200,214,-1,0,22895,1,467.28971962616800000000
chr12,113150648,113151108,460,-1,0,22895,1,217.39130434782600000000
chr12,113223054,113223847,793,-1,0,22895,1,126.10340479192900000000
chr12,113264139,113264940,801,-1,0,22895,1,124.84394506866400000000
chr12,113473790,113478870,5080,-1,0,,0,0.00000000000000000000
chr12,113683015,113683447,432,-1,0,53373,1,231.48148148148100000000
chr12,113683100,113683409,309,-1,0,53373,1,323.62459546925600000000
chr12,113847712,113848703,991,-1,0,,0,0.00000000000000000000
chr12,114268102,114268648,546,-1,0,9904,1,183.15018315018300000000
chr12,114501515,114502407,892,-1,0,,0,0.00000000000000000000
chr12,114501525,114502160,635,-1,0,,0,0.00000000000000000000
chr12,114501880,114502314,434,-1,0,,0,0.00000000000000000000
chr12,114501606,114501932,326,-1,0,,0,0.00000000000000000000
chr12,114630586,114639588,9002,-1,0,,0,0.00000000000000000000
chr12,114632238,114638301,6063,-1,0,,0,0.00000000000000000000
chr12,114631402,114637849,6447,-1,0,,0,0.00000000000000000000
chr12,114728332,114728398,66,-1,0,,0,0.00000000000000000000
chr12,114898181,114901695,3514,-1,0,,0,0.00000000000000000000
chr12,114950284,114952082,1798,-1,0,,0,0.00000000000000000000
chr12,115023766,115023829,63,-1,0,,0,0.00000000000000000000
chr12,115085823,115087114,1291,-1,0,,0,0.00000000000000000000
chr12,115230538,115233178,2640,-1,0,,0,0.00000000000000000000
chr12,115690081,115691664,1583,-1,0,,0,0.00000000000000000000
chr12,115690881,115691778,897,-1,0,,0,0.00000000000000000000
chr12,115893197,115897225,4028,-1,0,,0,0.00000000000000000000
chr12,116208763,116209203,440,-1,0,,0,0.00000000000000000000
chr12,116208912,116208987,75,-1,0,,0,0.00000000000000000000
chr12,116292534,116292918,384,-1,0,,0,0.00000000000000000000
chr12,116352532,116353448,916,-1,0,,0,0.00000000000000000000
chr12,116357936,116358090,154,-1,0,,0,0.00000000000000000000
chr12,116370267,116378359,8092,-1,0,,0,0.00000000000000000000
chr12,116526464,116528491,2027,-1,0,23389,1,49.33399111988160000000
chr12,116689245,116692586,3341,-1,0,23389,1,29.93115833582760000000
chr12,116714958,116715882,924,-1,0,23389,1,108.22510822510800000000
chr12,117005177,117007728,2551,-1,0,643246,1,39.20031360250880000000
chr12,117086854,117088200,1346,-1,0,,0,0.00000000000000000000
chr12,117087670,117088320,650,-1,0,,0,0.00000000000000000000
chr12,117085070,117085189,119,-1,0,,0,0.00000000000000000000
chr12,117217675,117219455,1780,-1,0,84900,1,56.17977528089890000000
chr12,117289353,117293374,4021,-1,0,84900,1,24.86943546381500000000
chr12,117464030,117464224,194,-1,0,26259,1,515.46391752577300000000
chr12,117641034,117643749,2715,-1,0,,0,0.00000000000000000000
chr12,117640993,117642506,1513,-1,0,,0,0.00000000000000000000
chr12,118005315,118005898,583,-1,0,283455,1,171.52658662092600000000
chr12,118049507,118051729,2222,-1,0,283455,1,45.00450045004500000000
chr12,118170640,118173412,2772,-1,0,283455,1,36.07503607503610000000
chr12,118447056,118448509,1453,-1,0,,0,0.00000000000000000000
chr12,118535869,118536377,508,-1,0,54621,1,196.85039370078700000000
chr12,118536122,118536224,102,-1,0,54621,1,980.39215686274500000000
chr12,118569129,118571137,2008,-1,0,,0,0.00000000000000000000
chr12,118754829,118783910,29081,-1,0,51347,1,3.43867129741068000000
chr12,119047203,119049148,1945,-1,0,,0,0.00000000000000000000
chr12,119353495,119353652,157,-1,0,,0,0.00000000000000000000
chr12,119440504,119442849,2345,-1,0,84530,1,42.64392324093820000000
chr12,119463316,119464439,1123,-1,0,84530,1,89.04719501335710000000
chr12,119474300,119499363,25063,-1,0,84530,1,3.98994533774887000000
chr12,119901714,119902188,474,-1,0,160777,1,210.97046413502100000000
chr12,119901803,119902118,315,-1,0,160777,1,317.46031746031700000000
chr12,119983861,119995623,11762,-1,0,,0,0.00000000000000000000
chr12,119988530,119993292,4762,-1,0,,0,0.00000000000000000000
chr12,119988887,119990761,1874,-1,0,,0,0.00000000000000000000
chr12,120426699,120428148,1449,-1,0,92558,1,69.01311249137340000000
chr12,120527901,120544300,16399,-1,0,92558;11021,2,12.19586560156110000000
chr12,120858984,120859284,300,-1,0,,0,0.00000000000000000000
chr12,121152183,121153422,1239,-1,0,84747,1,80.71025020177560000000
chr12,121290204,121290451,247,-1,0,121665,1,404.85829959514200000000
chr12,121316769,121320958,4189,-1,0,121665,1,23.87204583432800000000
chr12,121340524,121342237,1713,-1,0,121665,1,58.37711617046120000000
chr12,121401710,121402058,348,-1,0,,0,0.00000000000000000000
chr12,121401683,121401973,290,-1,0,,0,0.00000000000000000000
chr12,121425861,121426053,192,-1,0,6927,1,520.83333333333300000000
chr12,121535782,121542375,6593,-1,0,,0,0.00000000000000000000
chr12,121952501,121953500,999,-1,0,84678,1,100.10010010010000000000
chr12,122031888,122033333,1445,-1,0,,0,0.00000000000000000000
chr12,122115433,122129618,14185,-1,0,,0,0.00000000000000000000
chr12,122111197,122118634,7437,-1,0,,0,0.00000000000000000000
chr12,122138074,122141831,3757,-1,0,,0,0.00000000000000000000
chr12,122177388,122185665,8277,-1,0,144404,1,12.08167210341910000000
chr12,122185140,122186455,1315,-1,0,144404,1,76.04562737642590000000
chr12,122185214,122185893,679,-1,0,144404,1,147.27540500736400000000
chr12,122222875,122224766,1891,-1,0,54509,1,52.88207297726070000000
chr12,122289486,122290044,558,-1,0,3242,1,179.21146953405000000000
chr12,122289596,122289941,345,-1,0,3242,1,289.85507246376800000000
chr12,122342214,122343986,1772,-1,0,5715,1,56.43340857787810000000
chr12,122482984,122485126,2142,-1,0,605,1,46.68534080298790000000
chr12,122634954,122650683,15729,-1,0,,0,0.00000000000000000000
chr12,122697488,122699581,2093,-1,0,56616,1,47.77830864787390000000
chr12,122947416,122947466,50,-1,0,,0,0.00000000000000000000
chr12,123010237,123010795,558,-1,0,65117,1,179.21146953405000000000
chr12,123010346,123010678,332,-1,0,65117,1,301.20481927710800000000
chr12,123140543,123142324,1781,-1,0,,0,0.00000000000000000000
chr12,123185980,123199447,13467,-1,0,338442;8843,2,14.85111754659540000000
chr12,123324201,123352900,28699,-1,0,79720;9026,2,6.96888393323809000000
chr12,123337949,123338104,155,-1,0,9026,1,645.16129032258100000000
chr12,123391000,123395941,4941,-1,0,,0,0.00000000000000000000
chr12,123837913,123838803,890,-1,0,55206,1,112.35955056179800000000
chr12,123874402,123879568,5166,-1,0,387893,1,19.35733643050720000000
chr12,123932671,123935020,2349,-1,0,,0,0.00000000000000000000
chr12,124064338,124065227,889,-1,0,,0,0.00000000000000000000
chr12,124237502,124237931,429,-1,0,23545,1,233.10023310023300000000
chr12,124395903,124397052,1149,-1,0,196385,1,87.03220191470840000000
chr12,124496244,124499913,3669,-1,0,144348;100533183,2,54.51076587626060000000
chr12,124709000,124709118,118,-1,0,100533183,1,847.45762711864400000000
chr12,124725468,124726706,1238,-1,0,100533183,1,80.77544426494350000000
chr12,125024616,125026491,1875,-1,0,9612,1,53.33333333333330000000
chr12,124915582,124916045,463,-1,0,9612,1,215.98272138228900000000
chr12,124824144,124824277,133,-1,0,9612,1,751.87969924812000000000
chr12,124795816,124795936,120,-1,0,144347;100533183,2,1666.66666666667000000000
chr12,125100145,125103523,3378,-1,0,,0,0.00000000000000000000
chr12,125155919,125156496,577,-1,0,,0,0.00000000000000000000
chr12,125156549,125156853,304,-1,0,,0,0.00000000000000000000
chr12,125334396,125334714,318,-1,0,949,1,314.46540880503100000000
chr12,125574689,125574781,92,-1,0,65985,1,1086.95652173913000000000
chr12,125642357,125652992,10635,-1,0,,0,0.00000000000000000000
chr12,125688914,125689374,460,-1,0,,0,0.00000000000000000000
chr12,125894444,125895264,820,-1,0,114795,1,121.95121951219500000000
chr12,125952489,125952823,334,-1,0,114795,1,299.40119760479000000000
chr12,126019031,126019563,532,-1,0,114795,1,187.96992481203000000000
chr12,126238277,126243204,4927,-1,0,,0,0.00000000000000000000
chr12,126391324,126392954,1630,-1,0,,0,0.00000000000000000000
chr12,126980647,127111583,130936,-1,0,,0,0.00000000000000000000
chr12,126982803,127023743,40940,-1,0,,0,0.00000000000000000000
chr12,126994619,127014124,19505,-1,0,,0,0.00000000000000000000
chr12,126987787,127004491,16704,-1,0,,0,0.00000000000000000000
chr12,127004677,127016762,12085,-1,0,,0,0.00000000000000000000
chr12,126996074,127005635,9561,-1,0,,0,0.00000000000000000000
chr12,126820467,126829436,8969,-1,0,,0,0.00000000000000000000
chr12,127069685,127079251,9566,-1,0,,0,0.00000000000000000000
chr12,126783336,126789909,6573,-1,0,,0,0.00000000000000000000
chr12,126996324,126999059,2735,-1,0,,0,0.00000000000000000000
chr12,127002564,127005259,2695,-1,0,,0,0.00000000000000000000
chr12,127067579,127069434,1855,-1,0,,0,0.00000000000000000000
chr12,127067762,127068619,857,-1,0,,0,0.00000000000000000000
chr12,126905101,126905415,314,-1,0,,0,0.00000000000000000000
chr12,126825242,126825679,437,-1,0,,0,0.00000000000000000000
chr12,127067958,127068103,145,-1,0,,0,0.00000000000000000000
chr12,126825401,126825492,91,-1,0,,0,0.00000000000000000000
chr12,127353682,127809697,456015,-1,0,,0,0.00000000000000000000
chr12,127591904,127604797,12893,-1,0,,0,0.00000000000000000000
chr12,127443333,127456834,13501,-1,0,,0,0.00000000000000000000
chr12,127364640,127377547,12907,-1,0,,0,0.00000000000000000000
chr12,127486991,127495457,8466,-1,0,,0,0.00000000000000000000
chr12,127578215,127585747,7532,-1,0,,0,0.00000000000000000000
chr12,127309884,127316313,6429,-1,0,,0,0.00000000000000000000
chr12,127489128,127493963,4835,-1,0,,0,0.00000000000000000000
chr12,127659800,127661933,2133,-1,0,,0,0.00000000000000000000
chr12,127404661,127406355,1694,-1,0,,0,0.00000000000000000000
chr12,127542015,127543042,1027,-1,0,,0,0.00000000000000000000
chr12,127660337,127660850,513,-1,0,,0,0.00000000000000000000
chr12,127212927,127213393,466,-1,0,,0,0.00000000000000000000
chr12,127199962,127200310,348,-1,0,,0,0.00000000000000000000
chr12,127502632,127502918,286,-1,0,,0,0.00000000000000000000
chr12,127660440,127660770,330,-1,0,,0,0.00000000000000000000
chr12,127213029,127213250,221,-1,0,,0,0.00000000000000000000
chr12,127855885,127859045,3160,-1,0,,0,0.00000000000000000000
chr12,127947090,127947491,401,-1,0,,0,0.00000000000000000000
chr12,127947269,127947338,69,-1,0,,0,0.00000000000000000000
chr12,128037886,128038404,518,-1,0,,0,0.00000000000000000000
chr12,128037977,128038294,317,-1,0,,0,0.00000000000000000000
chr12,128180856,128181380,524,-1,0,,0,0.00000000000000000000
chr12,128276672,128277434,762,-1,0,,0,0.00000000000000000000
chr12,128281567,128291532,9965,-1,0,,0,0.00000000000000000000
chr12,128338834,128344048,5214,-1,0,,0,0.00000000000000000000
chr12,128424923,128429024,4101,-1,0,,0,0.00000000000000000000
chr12,128429410,128431522,2112,-1,0,,0,0.00000000000000000000
chr12,128561965,128563778,1813,-1,0,,0,0.00000000000000000000
chr12,128673221,128673985,764,-1,0,,0,0.00000000000000000000
chr12,128673657,128673951,294,-1,0,,0,0.00000000000000000000
chr12,128770179,128770685,506,-1,0,92293,1,197.62845849802400000000
chr12,128789254,128790714,1460,-1,0,92293,1,68.49315068493150000000
chr12,128811295,128812055,760,-1,0,92293,1,131.57894736842100000000
chr12,128932241,128932541,300,-1,0,92293,1,333.33333333333300000000
chr12,129192456,129193560,1104,-1,0,92293,1,90.57971014492750000000
chr12,129192724,129193464,740,-1,0,,0,0.00000000000000000000
chr12,129229094,129233346,4252,-1,0,,0,0.00000000000000000000
chr12,129229137,129232562,3425,-1,0,,0,0.00000000000000000000
chr12,129302425,129304420,1995,-1,0,121260,1,50.12531328320800000000
chr12,129386219,129389368,3149,-1,0,144423,1,31.75611305176250000000
chr12,129448140,129452945,4805,-1,0,144423,1,20.81165452653490000000
chr12,129453466,129453927,461,-1,0,144423,1,216.91973969631200000000
chr12,129522014,129547632,25618,-1,0,,0,0.00000000000000000000
chr12,129572214,129574167,1953,-1,0,121256,1,51.20327700972860000000
chr12,129572585,129573971,1386,-1,0,121256,1,72.15007215007210000000
chr12,129732026,129740998,8972,-1,0,121256,1,11.14578689255460000000
chr12,129755734,129758880,3146,-1,0,121256,1,31.78639542275910000000
chr12,129794682,129796099,1417,-1,0,121256,1,70.57163020465770000000
chr12,129795413,129795872,459,-1,0,121256,1,217.86492374727700000000
chr12,129795489,129795780,291,-1,0,121256,1,343.64261168384900000000
chr12,129840566,129841121,555,-1,0,121256,1,180.18018018018000000000
chr12,129840672,129840996,324,-1,0,121256,1,308.64197530864200000000
chr12,129870874,129874273,3399,-1,0,121256,1,29.42041776993230000000
chr12,129872472,129874606,2134,-1,0,121256,1,46.86035613870670000000
chr12,129872288,129873688,1400,-1,0,121256,1,71.42857142857140000000
chr12,129871290,129872172,882,-1,0,121256,1,113.37868480725600000000
chr12,129872908,129873741,833,-1,0,121256,1,120.04801920768300000000
chr12,129871811,129872669,858,-1,0,121256,1,116.55011655011700000000
chr12,129872539,129873178,639,-1,0,121256,1,156.49452269170600000000
chr12,129871591,129872194,603,-1,0,121256,1,165.83747927031500000000
chr12,129873260,129873630,370,-1,0,121256,1,270.27027027027000000000
chr12,129889198,129889922,724,-1,0,121256,1,138.12154696132600000000
chr12,129987750,129992236,4486,-1,0,121256,1,22.29157378510920000000
chr12,130058310,130062301,3991,-1,0,121256,1,25.05637684790780000000
chr12,130058374,130060904,2530,-1,0,121256,1,39.52569169960470000000
chr12,130060211,130060750,539,-1,0,121256,1,185.52875695732800000000
chr12,130060287,130060618,331,-1,0,121256,1,302.11480362537800000000
chr12,130122812,130123441,629,-1,0,121256,1,158.98251192368800000000
chr12,130122986,130123249,263,-1,0,121256,1,380.22813688212900000000
chr12,130123015,130123160,145,-1,0,121256,1,689.65517241379300000000
chr12,130232231,130234045,1814,-1,0,121256,1,55.12679162072770000000
chr12,130295423,130298460,3037,-1,0,121256,1,32.92723081988800000000
chr12,130283025,130283491,466,-1,0,121256,1,214.59227467811200000000
chr12,130283278,130283340,62,-1,0,121256,1,1612.90322580645000000000
chr12,130339248,130344409,5161,-1,0,121256,1,19.37608990505720000000
chr12,130339745,130343512,3767,-1,0,121256,1,26.54632333421820000000
chr12,130383659,130383974,315,-1,0,121256,1,317.46031746031700000000
chr12,130409113,130409445,332,-1,0,,0,0.00000000000000000000
chr12,130518139,130518527,388,-1,0,,0,0.00000000000000000000
chr12,130575204,130575710,506,-1,0,,0,0.00000000000000000000
chr12,130742772,130742831,59,-1,0,,0,0.00000000000000000000
chr12,130863924,130864909,985,-1,0,,0,0.00000000000000000000
chr12,130876538,130878085,1547,-1,0,,0,0.00000000000000000000
chr12,130876885,130877673,788,-1,0,,0,0.00000000000000000000
chr12,130877107,130877865,758,-1,0,,0,0.00000000000000000000
chr12,131024076,131024586,510,-1,0,,0,0.00000000000000000000
chr12,131048469,131048899,430,-1,0,,0,0.00000000000000000000
chr12,131048606,131048720,114,-1,0,,0,0.00000000000000000000
chr12,131048596,131048662,66,-1,0,,0,0.00000000000000000000
chr12,131100055,131157233,57178,-1,0,,0,0.00000000000000000000
chr12,131147887,131150318,2431,-1,0,,0,0.00000000000000000000
chr12,131131045,131134093,3048,-1,0,,0,0.00000000000000000000
chr12,131132415,131134026,1611,-1,0,,0,0.00000000000000000000
chr12,131130235,131131320,1085,-1,0,,0,0.00000000000000000000
chr12,131130484,131131087,603,-1,0,,0,0.00000000000000000000
chr12,131093926,131094224,298,-1,0,,0,0.00000000000000000000
chr12,131266381,131266647,266,-1,0,,0,0.00000000000000000000
chr12,131365692,131367582,1890,-1,0,,0,0.00000000000000000000
chr12,131366719,131367412,693,-1,0,,0,0.00000000000000000000
chr12,131410779,131412289,1510,-1,0,,0,0.00000000000000000000
chr12,131517263,131517531,268,-1,0,283383,1,373.13432835820900000000
chr12,131530531,131531626,1095,-1,0,283383,1,91.32420091324200000000
chr12,131530912,131531256,344,-1,0,283383,1,290.69767441860500000000
chr12,131664684,131674025,9341,-1,0,,0,0.00000000000000000000
chr12,131815394,132115770,300376,-1,0,,0,0.00000000000000000000
chr12,131729832,131829309,99477,-1,0,,0,0.00000000000000000000
chr12,131899681,131957886,58205,-1,0,,0,0.00000000000000000000
chr12,131731049,131772565,41516,-1,0,,0,0.00000000000000000000
chr12,132121844,132146850,25006,-1,0,,0,0.00000000000000000000
chr12,131797658,131823866,26208,-1,0,,0,0.00000000000000000000
chr12,132132498,132153408,20910,-1,0,,0,0.00000000000000000000
chr12,131793488,131809436,15948,-1,0,,0,0.00000000000000000000
chr12,132130020,132138126,8106,-1,0,,0,0.00000000000000000000
chr12,131816452,131825701,9249,-1,0,,0,0.00000000000000000000
chr12,132060445,132067816,7371,-1,0,,0,0.00000000000000000000
chr12,132129077,132135778,6701,-1,0,,0,0.00000000000000000000
chr12,131756089,131762309,6220,-1,0,,0,0.00000000000000000000
chr12,132132261,132136835,4574,-1,0,,0,0.00000000000000000000
chr12,131968472,131971418,2946,-1,0,,0,0.00000000000000000000
chr12,132132856,132135405,2549,-1,0,,0,0.00000000000000000000
chr12,132054965,132057395,2430,-1,0,,0,0.00000000000000000000
chr12,132132582,132134689,2107,-1,0,,0,0.00000000000000000000
chr12,132110680,132112445,1765,-1,0,,0,0.00000000000000000000
chr12,131917535,131919001,1466,-1,0,,0,0.00000000000000000000
chr12,131866709,131868001,1292,-1,0,,0,0.00000000000000000000
chr12,131790385,131791388,1003,-1,0,,0,0.00000000000000000000
chr12,132111233,132112108,875,-1,0,,0,0.00000000000000000000
chr12,131851331,131852028,697,-1,0,,0,0.00000000000000000000
chr12,131815649,131816202,553,-1,0,,0,0.00000000000000000000
chr12,132116024,132116586,562,-1,0,,0,0.00000000000000000000
chr12,132132584,132133335,751,-1,0,,0,0.00000000000000000000
chr12,131851420,131851854,434,-1,0,,0,0.00000000000000000000
chr12,131917753,131918227,474,-1,0,,0,0.00000000000000000000
chr12,131815734,131816141,407,-1,0,,0,0.00000000000000000000
chr12,131851575,131851899,324,-1,0,,0,0.00000000000000000000
chr12,132116135,132116370,235,-1,0,,0,0.00000000000000000000
chr12,131851722,131851936,214,-1,0,,0,0.00000000000000000000
chr12,131851868,131851975,107,-1,0,,0,0.00000000000000000000
chr12,131816834,131816909,75,-1,0,,0,0.00000000000000000000
chr12,132067256,132067337,81,-1,0,,0,0.00000000000000000000
chr12,132059179,132059227,48,-1,0,,0,0.00000000000000000000
chr12,132170923,132171302,379,-1,0,,0,0.00000000000000000000
chr12,132185664,132186377,713,-1,0,,0,0.00000000000000000000
chr12,132285876,132286251,375,-1,0,,0,0.00000000000000000000
chr12,132285941,132286074,133,-1,0,,0,0.00000000000000000000
chr12,132401553,132401971,418,-1,0,8408,1,239.23444976076600000000
chr12,132566142,132568082,1940,-1,0,,0,0.00000000000000000000
chr12,132572878,132573427,549,-1,0,,0,0.00000000000000000000
chr12,133143576,133176517,32941,-1,0,57666,1,3.03573054855651000000
chr12,132810336,132818799,8463,-1,0,50614,1,11.81614084839890000000
chr12,132811886,132816161,4275,-1,0,50614,1,23.39181286549710000000
chr12,133268470,133272600,4130,-1,0,5827,1,24.21307506053270000000
chr12,133086270,133089968,3698,-1,0,57666,1,27.04164413196320000000
chr12,132988146,132990795,2649,-1,0,,0,0.00000000000000000000
chr12,133085197,133088397,3200,-1,0,57666,1,31.25000000000000000000
chr12,132633454,132635367,1913,-1,0,79050,1,52.27391531625720000000
chr12,133168764,133171610,2846,-1,0,,0,0.00000000000000000000
chr12,132879983,132882238,2255,-1,0,50614,1,44.34589800443460000000
chr12,133049284,133050866,1582,-1,0,,0,0.00000000000000000000
chr12,132873175,132875176,2001,-1,0,50614,1,49.97501249375310000000
chr12,132875242,132877356,2114,-1,0,50614,1,47.30368968779560000000
chr12,132619223,132620923,1700,-1,0,,0,0.00000000000000000000
chr12,132866673,132868611,1938,-1,0,50614,1,51.59958720330240000000
chr12,132953431,132955125,1694,-1,0,,0,0.00000000000000000000
chr12,132988614,132990176,1562,-1,0,,0,0.00000000000000000000
chr12,132987091,132988589,1498,-1,0,,0,0.00000000000000000000
chr12,133139345,133140792,1447,-1,0,57666,1,69.10850034554250000000
chr12,132880884,132882144,1260,-1,0,50614,1,79.36507936507940000000
chr12,132875365,132876548,1183,-1,0,50614,1,84.53085376162300000000
chr12,133264539,133265761,1222,-1,0,5827,1,81.83306055646480000000
chr12,132942057,132942923,866,-1,0,,0,0.00000000000000000000
chr12,132880055,132881143,1088,-1,0,50614,1,91.91176470588230000000
chr12,133049578,133050557,979,-1,0,,0,0.00000000000000000000
chr12,132957592,132958266,674,-1,0,,0,0.00000000000000000000
chr12,132696772,132697735,963,-1,0,50614,1,103.84215991692600000000
chr12,132959201,132960034,833,-1,0,,0,0.00000000000000000000
chr12,133140165,133140698,533,-1,0,57666,1,187.61726078799300000000
chr12,132620068,132620836,768,-1,0,,0,0.00000000000000000000
chr12,133046037,133046560,523,-1,0,,0,0.00000000000000000000
chr12,133050006,133050761,755,-1,0,,0,0.00000000000000000000
chr12,133197285,133197735,450,-1,0,22953,1,222.22222222222200000000
chr12,132697454,132697903,449,-1,0,50614,1,222.71714922049000000000
chr12,133075663,133076138,475,-1,0,57666,1,210.52631578947400000000
chr12,132942240,132942710,470,-1,0,,0,0.00000000000000000000
chr12,132867115,132867567,452,-1,0,50614,1,221.23893805309700000000
chr12,133140312,133140566,254,-1,0,57666,1,393.70078740157500000000
chr12,132987001,132987429,428,-1,0,,0,0.00000000000000000000
chr12,133032377,133032745,368,-1,0,,0,0.00000000000000000000
chr12,133141176,133141411,235,-1,0,57666,1,425.53191489361700000000
chr12,132942418,132942659,241,-1,0,,0,0.00000000000000000000
chr12,133140317,133140488,171,-1,0,57666,1,584.79532163742700000000
chr12,132836494,132836588,94,-1,0,50614,1,1063.82978723404000000000
chr12,132836536,132836629,93,-1,0,50614,1,1075.26881720430000000000
chr12,133075810,133075899,89,-1,0,57666,1,1123.59550561798000000000
chr12,133046243,133046322,79,-1,0,,0,0.00000000000000000000
chr12,132824168,132824239,71,-1,0,50614,1,1408.45070422535000000000
chr12,133197449,133197510,61,-1,0,22953,1,1639.34426229508000000000
chr12,133373363,133421664,48301,-1,0,2802;55743,2,4.14070102068280000000
chr12,133311724,133371074,59350,-1,0,23141;2802,2,3.36983993260320000000
chr12,133306735,133307187,452,-1,0,23141,1,221.23893805309700000000
chr12,133368223,133368637,414,-1,0,2802,1,241.54589371980700000000
chr12,133335491,133335816,325,-1,0,23141,1,307.69230769230800000000
chr12,133445406,133445962,556,-1,0,55743,1,179.85611510791400000000
chr12,133456866,133461114,4248,-1,0,55743,1,23.54048964218460000000
chr12,133494644,133536040,41396,-1,0,100289635,1,2.41569233742391000000
chr12,133516748,133527235,10487,-1,0,100289635,1,9.53561552398207000000
chr12,133771504,133771657,153,-1,0,10795,1,653.59477124183000000000
chr13,19067181,19338220,271039,-1,0,,0,0.00000000000000000000
chr13,19060448,19249304,188856,-1,0,,0,0.00000000000000000000
chr13,19322879,19382839,59960,-1,0,,0,0.00000000000000000000
chr13,19145791,19203250,57459,-1,0,,0,0.00000000000000000000
chr13,19357446,19401365,43919,-1,0,,0,0.00000000000000000000
chr13,19342627,19361250,18623,-1,0,,0,0.00000000000000000000
chr13,19327689,19347011,19322,-1,0,,0,0.00000000000000000000
chr13,19360682,19377266,16584,-1,0,,0,0.00000000000000000000
chr13,19341210,19354762,13552,-1,0,,0,0.00000000000000000000
chr13,19339837,19348517,8680,-1,0,,0,0.00000000000000000000
chr13,19347557,19358180,10623,-1,0,,0,0.00000000000000000000
chr13,19369644,19376343,6699,-1,0,,0,0.00000000000000000000
chr13,19201286,19204264,2978,-1,0,,0,0.00000000000000000000
chr13,19409781,19411740,1959,-1,0,,0,0.00000000000000000000
chr13,19476788,19477134,346,-1,0,,0,0.00000000000000000000
chr13,19552477,19610126,57649,-1,0,,0,0.00000000000000000000
chr13,19517516,19518396,880,-1,0,,0,0.00000000000000000000
chr13,19642475,19642704,229,-1,0,,0,0.00000000000000000000
chr13,19711572,19712527,955,-1,0,,0,0.00000000000000000000
chr13,19748082,19748858,776,-1,0,7278,1,128.86597938144300000000
chr13,19769448,19770952,1504,-1,0,,0,0.00000000000000000000
chr13,19750971,19752973,2002,-1,0,7278,1,49.95004995005000000000
chr13,19778412,20282108,503696,-1,0,54737;55269;93492,3,0.59559734442997400000
chr13,19938534,20183017,244483,-1,0,93492,1,0.40902639447323500000
chr13,19947076,19978771,31695,-1,0,,0,0.00000000000000000000
chr13,20078035,20080500,2465,-1,0,93492,1,40.56795131845840000000
chr13,20249620,20250735,1115,-1,0,,0,0.00000000000000000000
chr13,19927137,19928026,889,-1,0,,0,0.00000000000000000000
chr13,20342584,20343471,887,-1,0,55269,1,112.73957158962800000000
chr13,20459877,20471160,11283,-1,0,,0,0.00000000000000000000
chr13,20462314,20470111,7797,-1,0,,0,0.00000000000000000000
chr13,20465152,20468060,2908,-1,0,,0,0.00000000000000000000
chr13,20650105,20651782,1677,-1,0,7750,1,59.63029218843170000000
chr13,20724996,20733813,8817,-1,0,2700,1,11.34172621072930000000
chr13,20798042,21097597,299555,-1,0,51084;10804,2,0.66765702458647000000
chr13,20831270,20897355,66085,-1,0,,0,0.00000000000000000000
chr13,20825475,20828828,3353,-1,0,,0,0.00000000000000000000
chr13,20826238,20828834,2596,-1,0,,0,0.00000000000000000000
chr13,20939593,20939865,272,-1,0,,0,0.00000000000000000000
chr13,21486083,21487030,947,-1,0,,0,0.00000000000000000000
chr13,21494514,21495272,758,-1,0,,0,0.00000000000000000000
chr13,21531958,21535652,3694,-1,0,,0,0.00000000000000000000
chr13,21680358,21682032,1674,-1,0,,0,0.00000000000000000000
chr13,21729270,21732128,2858,-1,0,221150,1,34.98950314905530000000
chr13,21730800,21731335,535,-1,0,221150,1,186.91588785046700000000
chr13,21730923,21731246,323,-1,0,221150,1,309.59752321981400000000
chr13,21742366,21746494,4128,-1,0,221150,1,24.22480620155040000000
chr13,21893900,21900126,6226,-1,0,,0,0.00000000000000000000
chr13,21951294,21951839,545,-1,0,253832,1,183.48623853211000000000
chr13,22052141,22054916,2775,-1,0,,0,0.00000000000000000000
chr13,22281756,22288725,6969,-1,0,,0,0.00000000000000000000
chr13,22317461,22317620,159,-1,0,,0,0.00000000000000000000
chr13,22417773,22421958,4185,-1,0,,0,0.00000000000000000000
chr13,22418828,22419914,1086,-1,0,,0,0.00000000000000000000
chr13,22523530,22523872,342,-1,0,,0,0.00000000000000000000
chr13,22574676,22574770,94,-1,0,,0,0.00000000000000000000
chr13,22804792,22805165,373,-1,0,,0,0.00000000000000000000
chr13,22929112,22933279,4167,-1,0,,0,0.00000000000000000000
chr13,23055121,23055616,495,-1,0,,0,0.00000000000000000000
chr13,23055208,23055528,320,-1,0,,0,0.00000000000000000000
chr13,23134875,23284470,149595,-1,0,,0,0.00000000000000000000
chr13,23285699,23296495,10796,-1,0,,0,0.00000000000000000000
chr13,23325513,23327177,1664,-1,0,,0,0.00000000000000000000
chr13,23415573,23489906,74333,-1,0,,0,0.00000000000000000000
chr13,23474303,23474353,50,-1,0,,0,0.00000000000000000000
chr13,23519917,24936848,1416931,-1,0,6445;4285;55504;221178;338872;387911;542767;26278,8,0.56460053453555600000
chr13,24212643,24434709,222066,-1,0,4285;55504,2,0.90063314510100600000
chr13,25160869,25177201,16332,-1,0,,0,0.00000000000000000000
chr13,23630817,23638496,7679,-1,0,,0,0.00000000000000000000
chr13,23545622,23553576,7954,-1,0,,0,0.00000000000000000000
chr13,23632245,23637551,5306,-1,0,,0,0.00000000000000000000
chr13,23791326,23795752,4426,-1,0,6445,1,22.59376412110260000000
chr13,23635414,23637875,2461,-1,0,,0,0.00000000000000000000
chr13,24631698,24633595,1897,-1,0,221178,1,52.71481286241430000000
chr13,23632678,23633515,837,-1,0,,0,0.00000000000000000000
chr13,24057537,24058092,555,-1,0,,0,0.00000000000000000000
chr13,24710853,24711373,520,-1,0,221178,1,192.30769230769200000000
chr13,24813660,24814240,580,-1,0,221178,1,172.41379310344800000000
chr13,23557591,23558048,457,-1,0,,0,0.00000000000000000000
chr13,24069352,24069660,308,-1,0,,0,0.00000000000000000000
chr13,24057656,24057988,332,-1,0,,0,0.00000000000000000000
chr13,23624437,23624564,127,-1,0,,0,0.00000000000000000000
chr13,25270505,25270966,461,-1,0,479,1,216.91973969631200000000
chr13,25309487,25309864,377,-1,0,,0,0.00000000000000000000
chr13,25452841,25453270,429,-1,0,56163,1,233.10023310023300000000
chr13,25570267,25580901,10634,-1,0,,0,0.00000000000000000000
chr13,25569778,25570955,1177,-1,0,,0,0.00000000000000000000
chr13,26210810,26236648,25838,-1,0,51761,1,3.87026859664061000000
chr13,25928898,25942026,13128,-1,0,,0,0.00000000000000000000
chr13,26771114,26773329,2215,-1,0,6049,1,45.14672686230250000000
chr13,25604228,25606147,1919,-1,0,,0,0.00000000000000000000
chr13,25720950,25721461,511,-1,0,,0,0.00000000000000000000
chr13,26449352,26449905,553,-1,0,51761,1,180.83182640144700000000
chr13,25645185,25645505,320,-1,0,,0,0.00000000000000000000
chr13,25721012,25721353,341,-1,0,,0,0.00000000000000000000
chr13,27049827,27055912,6085,-1,0,,0,0.00000000000000000000
chr13,27049782,27052296,2514,-1,0,,0,0.00000000000000000000
chr13,27084603,27085310,707,-1,0,,0,0.00000000000000000000
chr13,27556927,27557346,419,-1,0,,0,0.00000000000000000000
chr13,27861814,27862203,389,-1,0,,0,0.00000000000000000000
chr13,27861895,27862086,191,-1,0,,0,0.00000000000000000000
chr13,27919286,27919640,354,-1,0,,0,0.00000000000000000000
chr13,27988401,27988465,64,-1,0,,0,0.00000000000000000000
chr13,28268147,28269056,909,-1,0,,0,0.00000000000000000000
chr13,28332187,28333350,1163,-1,0,,0,0.00000000000000000000
chr13,28332809,28333300,491,-1,0,,0,0.00000000000000000000
chr13,28531807,28532691,884,-1,0,,0,0.00000000000000000000
chr13,28565262,28565589,327,-1,0,,0,0.00000000000000000000
chr13,28669637,28670813,1176,-1,0,2322,1,85.03401360544220000000
chr13,28663493,28664482,989,-1,0,2322,1,101.11223458038400000000
chr13,28693870,28697217,3347,-1,0,,0,0.00000000000000000000
chr13,28698174,28699339,1165,-1,0,,0,0.00000000000000000000
chr13,28839768,28840340,572,-1,0,255967,1,174.82517482517500000000
chr13,28839861,28840186,325,-1,0,255967,1,307.69230769230800000000
chr13,29617360,29918761,301401,-1,0,23281,1,0.33178390250861800000
chr13,29915326,29920082,4756,-1,0,23281,1,21.02607232968880000000
chr13,29750825,29751680,855,-1,0,23281,1,116.95906432748500000000
chr13,29891452,29892036,584,-1,0,23281,1,171.23287671232900000000
chr13,29722594,29722915,321,-1,0,23281,1,311.52647975077900000000
chr13,29891563,29891881,318,-1,0,23281,1,314.46540880503100000000
chr13,29948332,29949441,1109,-1,0,23281,1,90.17132551848510000000
chr13,29954662,29955217,555,-1,0,23281,1,180.18018018018000000000
chr13,29954760,29955086,326,-1,0,23281,1,306.74846625766900000000
chr13,30131948,30133609,1661,-1,0,6541,1,60.20469596628540000000
chr13,30133480,30133628,148,-1,0,6541,1,675.67567567567600000000
chr13,30215837,30228124,12287,-1,0,,0,0.00000000000000000000
chr13,30215822,30221844,6022,-1,0,,0,0.00000000000000000000
chr13,30436508,30436930,422,-1,0,,0,0.00000000000000000000
chr13,30577972,30578354,382,-1,0,,0,0.00000000000000000000
chr13,30969990,30970495,505,-1,0,,0,0.00000000000000000000
chr13,30985678,30986932,1254,-1,0,,0,0.00000000000000000000
chr13,31043600,31043824,224,-1,0,3146,1,446.42857142857100000000
chr13,31175547,31176012,465,-1,0,3146,1,215.05376344086000000000
chr13,31175600,31175919,319,-1,0,3146,1,313.47962382445100000000
chr13,31196960,31197774,814,-1,0,10208,1,122.85012285012300000000
chr13,31417817,31418802,985,-1,0,,0,0.00000000000000000000
chr13,31418158,31418547,389,-1,0,,0,0.00000000000000000000
chr13,31418162,31418397,235,-1,0,,0,0.00000000000000000000
chr13,31426177,31426586,409,-1,0,,0,0.00000000000000000000
chr13,31426211,31426446,235,-1,0,,0,0.00000000000000000000
chr13,31510655,31514667,4012,-1,0,122046,1,24.92522432701890000000
chr13,31703526,31705674,2148,-1,0,,0,0.00000000000000000000
chr13,31943659,31945995,2336,-1,0,,0,0.00000000000000000000
chr13,32014699,32014830,131,-1,0,,0,0.00000000000000000000
chr13,32151260,32154394,3134,-1,0,,0,0.00000000000000000000
chr13,32532609,32547719,15110,-1,0,,0,0.00000000000000000000
chr13,32530349,32539456,9107,-1,0,,0,0.00000000000000000000
chr13,32532701,32538765,6064,-1,0,,0,0.00000000000000000000
chr13,32571812,32573042,1230,-1,0,,0,0.00000000000000000000
chr13,32671724,32674726,3002,-1,0,10129,1,33.31112591605600000000
chr13,33138847,33140383,1536,-1,0,,0,0.00000000000000000000
chr13,33392794,33443099,50305,-1,0,,0,0.00000000000000000000
chr13,33575740,33576796,1056,-1,0,,0,0.00000000000000000000
chr13,33751777,33752264,487,-1,0,90627,1,205.33880903490800000000
chr13,33751897,33752157,260,-1,0,90627,1,384.61538461538500000000
chr13,33963184,33966706,3522,-1,0,90627,1,28.39295854628050000000
chr13,34135726,34144821,9095,-1,0,90627,1,10.99505222649810000000
chr13,34135019,34143387,8368,-1,0,90627,1,11.95028680688340000000
chr13,34132756,34138962,6206,-1,0,90627,1,16.11343860779890000000
chr13,34132582,34135893,3311,-1,0,90627,1,30.20235578375110000000
chr13,34192561,34193359,798,-1,0,90627,1,125.31328320802000000000
chr13,34390306,34390662,356,-1,0,,0,0.00000000000000000000
chr13,34641612,34644359,2747,-1,0,,0,0.00000000000000000000
chr13,34811550,34815507,3957,-1,0,,0,0.00000000000000000000
chr13,35459803,35460328,525,-1,0,,0,0.00000000000000000000
chr13,35460002,35460209,207,-1,0,,0,0.00000000000000000000
chr13,35563586,35578257,14671,-1,0,26960,1,6.81616795037830000000
chr13,35558610,35564878,6268,-1,0,26960,1,15.95405232929160000000
chr13,35564125,35569557,5432,-1,0,26960,1,18.40942562592050000000
chr13,35562690,35564727,2037,-1,0,26960,1,49.09180166912130000000
chr13,35694799,35694961,162,-1,0,26960,1,617.28395061728400000000
chr13,36335569,36336818,1249,-1,0,,0,0.00000000000000000000
chr13,36337149,36337460,311,-1,0,,0,0.00000000000000000000
chr13,36438403,36438722,319,-1,0,9201,1,313.47962382445100000000
chr13,36621810,36625740,3930,-1,0,9201,1,25.44529262086510000000
chr13,36630206,36641035,10829,-1,0,9201,1,9.23446301597562000000
chr13,36806583,36807071,488,-1,0,728591;100526761,2,409.83606557377000000000
chr13,36806779,36806872,93,-1,0,728591;100526761,2,2150.53763440860000000000
chr13,36818921,36818982,61,-1,0,728591;100526761,2,3278.68852459016000000000
chr13,36971971,36972144,173,-1,0,,0,0.00000000000000000000
chr13,37414450,37414779,329,-1,0,,0,0.00000000000000000000
chr13,37497343,37500734,3391,-1,0,,0,0.00000000000000000000
chr13,37871694,37875547,3853,-1,0,,0,0.00000000000000000000
chr13,38023167,38023413,246,-1,0,,0,0.00000000000000000000
chr13,38048420,38049311,891,-1,0,,0,0.00000000000000000000
chr13,38070390,38120730,50340,-1,0,,0,0.00000000000000000000
chr13,38090834,38115110,24276,-1,0,,0,0.00000000000000000000
chr13,38071922,38085633,13711,-1,0,,0,0.00000000000000000000
chr13,38075486,38086631,11145,-1,0,,0,0.00000000000000000000
chr13,38425299,38433119,7820,-1,0,7223,1,12.78772378516620000000
chr13,38476652,38478367,1715,-1,0,,0,0.00000000000000000000
chr13,38683190,38684397,1207,-1,0,,0,0.00000000000000000000
chr13,39056008,39066128,10120,-1,0,,0,0.00000000000000000000
chr13,39057315,39060203,2888,-1,0,,0,0.00000000000000000000
chr13,39119963,39180969,61006,-1,0,,0,0.00000000000000000000
chr13,39154251,39154703,452,-1,0,,0,0.00000000000000000000
chr13,39379122,39383445,4323,-1,0,341640,1,23.13208420078650000000
chr13,39379297,39380543,1246,-1,0,341640,1,80.25682182985550000000
chr13,39528208,39529989,1781,-1,0,,0,0.00000000000000000000
chr13,39747517,39751377,3860,-1,0,,0,0.00000000000000000000
chr13,39933712,39935603,1891,-1,0,10186,1,52.88207297726070000000
chr13,39934235,39935551,1316,-1,0,10186,1,75.98784194528870000000
chr13,39934517,39935149,632,-1,0,10186,1,158.22784810126600000000
chr13,40028380,40028922,542,-1,0,10186,1,184.50184501845000000000
chr13,40028469,40028791,322,-1,0,10186,1,310.55900621118000000000
chr13,40060818,40074357,13539,-1,0,10186,1,7.38606987222099000000
chr13,40058283,40068689,10406,-1,0,10186,1,9.60984047664809000000
chr13,40083843,40097949,14106,-1,0,10186,1,7.08918190840777000000
chr13,40118736,40125609,6873,-1,0,10186,1,14.54968718172560000000
chr13,40193620,40194615,995,-1,0,,0,0.00000000000000000000
chr13,40432618,40439474,6856,-1,0,,0,0.00000000000000000000
chr13,41083164,41085050,1886,-1,0,,0,0.00000000000000000000
chr13,41271015,41271488,473,-1,0,,0,0.00000000000000000000
chr13,41271110,41271423,313,-1,0,,0,0.00000000000000000000
chr13,41577530,41577668,138,-1,0,1997,1,724.63768115942000000000
chr13,41848920,41850520,1600,-1,0,,0,0.00000000000000000000
chr13,41930187,41931108,921,-1,0,79612,1,108.57763300760000000000
chr13,41930358,41930875,517,-1,0,79612,1,193.42359767891700000000
chr13,41930604,41930699,95,-1,0,79612,1,1052.63157894737000000000
chr13,42003507,42004440,933,-1,0,,0,0.00000000000000000000
chr13,42001937,42002434,497,-1,0,,0,0.00000000000000000000
chr13,42103906,42105924,2018,-1,0,,0,0.00000000000000000000
chr13,42155004,42155564,560,-1,0,23078,1,178.57142857142900000000
chr13,42155100,42155437,337,-1,0,23078,1,296.73590504451000000000
chr13,42400328,42546409,146081,-1,0,23078,1,0.68455172130530300000
chr13,42518975,42524002,5027,-1,0,23078,1,19.89258006763480000000
chr13,42590767,42592507,1740,-1,0,,0,0.00000000000000000000
chr13,42755518,42756523,1005,-1,0,160851,1,99.50248756218900000000
chr13,42755789,42756402,613,-1,0,160851,1,163.13213703099500000000
chr13,42755954,42756238,284,-1,0,160851,1,352.11267605633800000000
chr13,42946034,42946436,402,-1,0,,0,0.00000000000000000000
chr13,43053224,43053908,684,-1,0,,0,0.00000000000000000000
chr13,43112663,43113050,387,-1,0,,0,0.00000000000000000000
chr13,43203367,43228570,25203,-1,0,,0,0.00000000000000000000
chr13,43300190,43302619,2429,-1,0,,0,0.00000000000000000000
chr13,43324643,43326931,2288,-1,0,,0,0.00000000000000000000
chr13,43539762,43541510,1748,-1,0,94240,1,57.20823798627000000000
chr13,43617958,43621659,3701,-1,0,29103,1,27.01972439881110000000
chr13,43855590,43858490,2900,-1,0,55068,1,34.48275862068970000000
chr13,43923410,43924117,707,-1,0,55068,1,141.44271570014100000000
chr13,44044370,44044571,201,-1,0,55068,1,497.51243781094500000000
chr13,44164101,44168478,4377,-1,0,55068,1,22.84669865204480000000
chr13,44380193,44380773,580,-1,0,,0,0.00000000000000000000
chr13,44380314,44380634,320,-1,0,,0,0.00000000000000000000
chr13,44569435,44569876,441,-1,0,,0,0.00000000000000000000
chr13,44680114,44685688,5574,-1,0,,0,0.00000000000000000000
chr13,44817793,44819694,1901,-1,0,,0,0.00000000000000000000
chr13,45042430,45043106,676,-1,0,8848,1,147.92899408284000000000
chr13,45089838,45099412,9574,-1,0,8848,1,10.44495508669310000000
chr13,45395997,45397238,1241,-1,0,,0,0.00000000000000000000
chr13,45407827,45427683,19856,-1,0,,0,0.00000000000000000000
chr13,45755050,45759601,4551,-1,0,2963,1,21.97319270490000000000
chr13,45867928,45868858,930,-1,0,,0,0.00000000000000000000
chr13,45888583,45888941,358,-1,0,,0,0.00000000000000000000
chr13,45925203,45934524,9321,-1,0,,0,0.00000000000000000000
chr13,45951713,45955073,3360,-1,0,,0,0.00000000000000000000
chr13,45954994,45957355,2361,-1,0,,0,0.00000000000000000000
chr13,46620522,46623021,2499,-1,0,23091,1,40.01600640256100000000
chr13,47038244,47039808,1564,-1,0,,0,0.00000000000000000000
chr13,46252087,46253595,1508,-1,0,,0,0.00000000000000000000
chr13,47039107,47040277,1170,-1,0,,0,0.00000000000000000000
chr13,46634490,46635396,906,-1,0,1361,1,110.37527593819000000000
chr13,46906684,46907307,623,-1,0,,0,0.00000000000000000000
chr13,45955606,45956336,730,-1,0,,0,0.00000000000000000000
chr13,46719630,46720197,567,-1,0,3936,1,176.36684303351000000000
chr13,46005266,46005733,467,-1,0,,0,0.00000000000000000000
chr13,47038226,47038464,238,-1,0,,0,0.00000000000000000000
chr13,46906887,46907036,149,-1,0,,0,0.00000000000000000000
chr13,47450372,47463283,12911,-1,0,3356,1,7.74533343660445000000
chr13,48014954,48016312,1358,-1,0,,0,0.00000000000000000000
chr13,47754492,47755825,1333,-1,0,,0,0.00000000000000000000
chr13,47689397,47689912,515,-1,0,,0,0.00000000000000000000
chr13,48015532,48016003,471,-1,0,,0,0.00000000000000000000
chr13,47979455,47979883,428,-1,0,,0,0.00000000000000000000
chr13,47689475,47689790,315,-1,0,,0,0.00000000000000000000
chr13,47517875,47518025,150,-1,0,,0,0.00000000000000000000
chr13,48015694,48015798,104,-1,0,,0,0.00000000000000000000
chr13,48419661,48420345,684,-1,0,,0,0.00000000000000000000
chr13,48419929,48420088,159,-1,0,,0,0.00000000000000000000
chr13,48491669,48496112,4443,-1,0,,0,0.00000000000000000000
chr13,48664588,48665049,461,-1,0,29079,1,216.91973969631200000000
chr13,48778651,48785786,7135,-1,0,,0,0.00000000000000000000
chr13,48782540,48785371,2831,-1,0,,0,0.00000000000000000000
chr13,48881737,48882545,808,-1,0,5925,1,123.76237623762400000000
chr13,49305563,49306034,471,-1,0,,0,0.00000000000000000000
chr13,49309005,49312041,3036,-1,0,,0,0.00000000000000000000
chr13,49309842,49310293,451,-1,0,,0,0.00000000000000000000
chr13,49309911,49310082,171,-1,0,,0,0.00000000000000000000
chr13,49310053,49310162,109,-1,0,,0,0.00000000000000000000
chr13,49373078,49373609,531,-1,0,,0,0.00000000000000000000
chr13,49373203,49373549,346,-1,0,,0,0.00000000000000000000
chr13,49398403,49398498,95,-1,0,,0,0.00000000000000000000
chr13,49532848,49538245,5397,-1,0,,0,0.00000000000000000000
chr13,49533274,49536680,3406,-1,0,,0,0.00000000000000000000
chr13,49533506,49536622,3116,-1,0,,0,0.00000000000000000000
chr13,49843195,49843670,475,-1,0,81602,1,210.52631578947400000000
chr13,49892519,49892862,343,-1,0,81617,1,291.54518950437300000000
chr13,49892683,49892810,127,-1,0,81617,1,787.40157480315000000000
chr13,49951399,49953862,2463,-1,0,81617,1,40.60089321965080000000
chr13,50031411,50031742,331,-1,0,83852;107303344,2,604.22960725075500000000
chr13,50072376,50072811,435,-1,0,51131;107303344,2,459.77011494252900000000
chr13,50195263,50197658,2395,-1,0,,0,0.00000000000000000000
chr13,50474510,50478009,3499,-1,0,,0,0.00000000000000000000
chr13,50474661,50474999,338,-1,0,,0,0.00000000000000000000
chr13,50580928,51404018,823090,-1,0,10206;220107;283518,3,0.36448019050164600000
chr13,51069301,51075357,6056,-1,0,,0,0.00000000000000000000
chr13,50513100,50514891,1791,-1,0,,0,0.00000000000000000000
chr13,51264833,51267757,2924,-1,0,,0,0.00000000000000000000
chr13,51444431,51446545,2114,-1,0,,0,0.00000000000000000000
chr13,50579055,50581770,2715,-1,0,10206,1,36.83241252302030000000
chr13,50976405,50978225,1820,-1,0,,0,0.00000000000000000000
chr13,51173419,51173820,401,-1,0,,0,0.00000000000000000000
chr13,50596829,50596972,143,-1,0,,0,0.00000000000000000000
chr13,50609217,50609318,101,-1,0,,0,0.00000000000000000000
chr13,51235707,51235778,71,-1,0,,0,0.00000000000000000000
chr13,51512928,51515927,2999,-1,0,79621,1,33.34444814938310000000
chr13,51551842,51552376,534,-1,0,,0,0.00000000000000000000
chr13,51551948,51552266,318,-1,0,,0,0.00000000000000000000
chr13,51760754,51760872,118,-1,0,,0,0.00000000000000000000
chr13,52544891,52581507,36616,-1,0,540,1,2.73104653703299000000
chr13,52348390,52350413,2023,-1,0,79758,1,49.43153732081070000000
chr13,52858792,52890010,31218,-1,0,,0,0.00000000000000000000
chr13,53051663,53160957,109294,-1,0,,0,0.00000000000000000000
chr13,53159441,53178049,18608,-1,0,,0,0.00000000000000000000
chr13,53097699,53112028,14329,-1,0,,0,0.00000000000000000000
chr13,53281412,53281752,340,-1,0,11061,1,294.11764705882400000000
chr13,53281495,53281671,176,-1,0,11061,1,568.18181818181800000000
chr13,53281433,53281545,112,-1,0,11061,1,892.85714285714300000000
chr13,53357978,53364110,6132,-1,0,,0,0.00000000000000000000
chr13,53420121,53422640,2519,-1,0,5100,1,39.69829297340210000000
chr13,53522254,53523309,1055,-1,0,,0,0.00000000000000000000
chr13,53774005,53776499,2494,-1,0,,0,0.00000000000000000000
chr13,53908277,53908669,392,-1,0,,0,0.00000000000000000000
chr13,54106621,54115505,8884,-1,0,,0,0.00000000000000000000
chr13,54234737,54240271,5534,-1,0,,0,0.00000000000000000000
chr13,54239148,54241732,2584,-1,0,,0,0.00000000000000000000
chr13,54524031,54524413,382,-1,0,,0,0.00000000000000000000
chr13,54600594,54600935,341,-1,0,,0,0.00000000000000000000
chr13,54785694,54823944,38250,-1,0,,0,0.00000000000000000000
chr13,54899476,54901725,2249,-1,0,,0,0.00000000000000000000
chr13,55033653,55034027,374,-1,0,,0,0.00000000000000000000
chr13,55143520,55475957,332437,-1,0,,0,0.00000000000000000000
chr13,55351094,55397821,46727,-1,0,,0,0.00000000000000000000
chr13,56137423,56417270,279847,-1,0,,0,0.00000000000000000000
chr13,56322807,56527495,204688,-1,0,,0,0.00000000000000000000
chr13,55898609,56042341,143732,-1,0,,0,0.00000000000000000000
chr13,56152663,56252573,99910,-1,0,,0,0.00000000000000000000
chr13,56241318,56248160,6842,-1,0,,0,0.00000000000000000000
chr13,55652790,55659512,6722,-1,0,,0,0.00000000000000000000
chr13,55953589,55959620,6031,-1,0,,0,0.00000000000000000000
chr13,55622334,55625063,2729,-1,0,,0,0.00000000000000000000
chr13,55941013,55941718,705,-1,0,,0,0.00000000000000000000
chr13,55725084,55725818,734,-1,0,,0,0.00000000000000000000
chr13,56366137,56366739,602,-1,0,,0,0.00000000000000000000
chr13,56150985,56151358,373,-1,0,,0,0.00000000000000000000
chr13,55941169,55941468,299,-1,0,,0,0.00000000000000000000
chr13,55634119,55634375,256,-1,0,,0,0.00000000000000000000
chr13,56366306,56366503,197,-1,0,,0,0.00000000000000000000
chr13,55952536,55952711,175,-1,0,,0,0.00000000000000000000
chr13,56151096,56151219,123,-1,0,,0,0.00000000000000000000
chr13,55952606,55952695,89,-1,0,,0,0.00000000000000000000
chr13,56800431,57801139,1000708,-1,0,729250;729240;729233;122183;729246,5,0.49964625045467800000
chr13,57790896,57970282,179386,-1,0,,0,0.00000000000000000000
chr13,57715783,57826094,110311,-1,0,729250;729240;729233;122183;729246,5,4.53263953730816000000
chr13,58026562,58142191,115629,-1,0,,0,0.00000000000000000000
chr13,57805514,57886769,81255,-1,0,,0,0.00000000000000000000
chr13,57024674,57090450,65776,-1,0,,0,0.00000000000000000000
chr13,57755856,57802946,47090,-1,0,,0,0.00000000000000000000
chr13,57713067,57765784,52717,-1,0,729250;729240;729233;122183;729246,5,9.48460648367699000000
chr13,57752428,57790190,37762,-1,0,,0,0.00000000000000000000
chr13,57791810,57823733,31923,-1,0,,0,0.00000000000000000000
chr13,57861871,57884555,22684,-1,0,,0,0.00000000000000000000
chr13,57768508,57786942,18434,-1,0,,0,0.00000000000000000000
chr13,57758207,57777872,19665,-1,0,,0,0.00000000000000000000
chr13,57866633,57893788,27155,-1,0,,0,0.00000000000000000000
chr13,57803325,57821229,17904,-1,0,,0,0.00000000000000000000
chr13,57750437,57766439,16002,-1,0,,0,0.00000000000000000000
chr13,57660387,57673754,13367,-1,0,,0,0.00000000000000000000
chr13,57706472,57717064,10592,-1,0,122183,1,9.44108761329305000000
chr13,57763739,57778007,14268,-1,0,,0,0.00000000000000000000
chr13,58141966,58150663,8697,-1,0,,0,0.00000000000000000000
chr13,57971826,57979973,8147,-1,0,,0,0.00000000000000000000
chr13,57944657,57951807,7150,-1,0,,0,0.00000000000000000000
chr13,57706345,57713592,7247,-1,0,,0,0.00000000000000000000
chr13,57251107,57256293,5186,-1,0,,0,0.00000000000000000000
chr13,57445364,57449193,3829,-1,0,,0,0.00000000000000000000
chr13,57908775,57911691,2916,-1,0,,0,0.00000000000000000000
chr13,56824062,56825206,1144,-1,0,,0,0.00000000000000000000
chr13,57787095,57788378,1283,-1,0,,0,0.00000000000000000000
chr13,56851590,56852458,868,-1,0,,0,0.00000000000000000000
chr13,57977660,57978568,908,-1,0,,0,0.00000000000000000000
chr13,57975401,57975968,567,-1,0,,0,0.00000000000000000000
chr13,57975517,57975882,365,-1,0,,0,0.00000000000000000000
chr13,58339512,58340792,1280,-1,0,,0,0.00000000000000000000
chr13,58339858,58340013,155,-1,0,,0,0.00000000000000000000
chr13,58365535,58373185,7650,-1,0,,0,0.00000000000000000000
chr13,58370002,58373812,3810,-1,0,,0,0.00000000000000000000
chr13,58386042,58386447,405,-1,0,,0,0.00000000000000000000
chr13,58588951,58599867,10916,-1,0,,0,0.00000000000000000000
chr13,58590281,58599078,8797,-1,0,,0,0.00000000000000000000
chr13,58450882,58454564,3682,-1,0,,0,0.00000000000000000000
chr13,58724199,58727313,3114,-1,0,,0,0.00000000000000000000
chr13,59044763,59045132,369,-1,0,,0,0.00000000000000000000
chr13,59086462,59088390,1928,-1,0,,0,0.00000000000000000000
chr13,59227232,59235011,7779,-1,0,,0,0.00000000000000000000
chr13,59374074,59377622,3548,-1,0,,0,0.00000000000000000000
chr13,59468049,59471629,3580,-1,0,,0,0.00000000000000000000
chr13,59706138,59706508,370,-1,0,,0,0.00000000000000000000
chr13,59920694,59921695,1001,-1,0,,0,0.00000000000000000000
chr13,60172398,60172920,522,-1,0,,0,0.00000000000000000000
chr13,60172490,60172823,333,-1,0,,0,0.00000000000000000000
chr13,60786160,60786488,328,-1,0,,0,0.00000000000000000000
chr13,60881444,60881694,250,-1,0,,0,0.00000000000000000000
chr13,61207373,61225702,18329,-1,0,,0,0.00000000000000000000
chr13,61234617,61237872,3255,-1,0,,0,0.00000000000000000000
chr13,61300628,61301086,458,-1,0,,0,0.00000000000000000000
chr13,61314997,61316322,1325,-1,0,,0,0.00000000000000000000
chr13,61324173,61392350,68177,-1,0,,0,0.00000000000000000000
chr13,61470066,61470784,718,-1,0,,0,0.00000000000000000000
chr13,61505668,61507183,1515,-1,0,,0,0.00000000000000000000
chr13,61552911,61554079,1168,-1,0,,0,0.00000000000000000000
chr13,61553071,61553808,737,-1,0,,0,0.00000000000000000000
chr13,61551472,61551991,519,-1,0,,0,0.00000000000000000000
chr13,61711878,61718619,6741,-1,0,,0,0.00000000000000000000
chr13,61958421,61959049,628,-1,0,,0,0.00000000000000000000
chr13,61958651,61959021,370,-1,0,,0,0.00000000000000000000
chr13,62015481,62015639,158,-1,0,,0,0.00000000000000000000
chr13,62199173,62205980,6807,-1,0,,0,0.00000000000000000000
chr13,62410925,62414427,3502,-1,0,,0,0.00000000000000000000
chr13,62654374,62657657,3283,-1,0,,0,0.00000000000000000000
chr13,62654834,62657565,2731,-1,0,,0,0.00000000000000000000
chr13,62785066,62787177,2111,-1,0,,0,0.00000000000000000000
chr13,63102169,63102879,710,-1,0,,0,0.00000000000000000000
chr13,63283523,63293170,9647,-1,0,,0,0.00000000000000000000
chr13,63315757,63632892,317135,-1,0,,0,0.00000000000000000000
chr13,63530493,63606192,75699,-1,0,,0,0.00000000000000000000
chr13,63391261,63425179,33918,-1,0,,0,0.00000000000000000000
chr13,63654332,63664409,10077,-1,0,,0,0.00000000000000000000
chr13,63656084,63656639,555,-1,0,,0,0.00000000000000000000
chr13,63523711,63524232,521,-1,0,,0,0.00000000000000000000
chr13,63631619,63632009,390,-1,0,,0,0.00000000000000000000
chr13,63523809,63524121,312,-1,0,,0,0.00000000000000000000
chr13,63656185,63656515,330,-1,0,,0,0.00000000000000000000
chr13,64018726,64500082,481356,-1,0,,0,0.00000000000000000000
chr13,63784286,63972811,188525,-1,0,,0,0.00000000000000000000
chr13,64269504,64388107,118603,-1,0,,0,0.00000000000000000000
chr13,64258931,64338535,79604,-1,0,,0,0.00000000000000000000
chr13,64416859,64509786,92927,-1,0,,0,0.00000000000000000000
chr13,64331061,64386965,55904,-1,0,,0,0.00000000000000000000
chr13,64254372,64299327,44955,-1,0,,0,0.00000000000000000000
chr13,64667972,64704065,36093,-1,0,,0,0.00000000000000000000
chr13,64221803,64245179,23376,-1,0,,0,0.00000000000000000000
chr13,64224575,64237605,13030,-1,0,,0,0.00000000000000000000
chr13,63945978,63949698,3720,-1,0,,0,0.00000000000000000000
chr13,64413078,64415090,2012,-1,0,,0,0.00000000000000000000
chr13,64313688,64315764,2076,-1,0,,0,0.00000000000000000000
chr13,64311705,64313274,1569,-1,0,,0,0.00000000000000000000
chr13,64415361,64416509,1148,-1,0,,0,0.00000000000000000000
chr13,64412715,64413729,1014,-1,0,,0,0.00000000000000000000
chr13,64448490,64449015,525,-1,0,,0,0.00000000000000000000
chr13,64903247,64903636,389,-1,0,,0,0.00000000000000000000
chr13,63964270,63964497,227,-1,0,,0,0.00000000000000000000
chr13,65184904,65195967,11063,-1,0,,0,0.00000000000000000000
chr13,65259019,65271829,12810,-1,0,,0,0.00000000000000000000
chr13,65341584,65354710,13126,-1,0,,0,0.00000000000000000000
chr13,65341361,65344906,3545,-1,0,,0,0.00000000000000000000
chr13,65342499,65344246,1747,-1,0,,0,0.00000000000000000000
chr13,65352163,65353700,1537,-1,0,,0,0.00000000000000000000
chr13,65525908,65530888,4980,-1,0,,0,0.00000000000000000000
chr13,65553744,65562861,9117,-1,0,,0,0.00000000000000000000
chr13,65637802,65638214,412,-1,0,,0,0.00000000000000000000
chr13,66192707,66207452,14745,-1,0,,0,0.00000000000000000000
chr13,65870972,65871130,158,-1,0,,0,0.00000000000000000000
chr13,66322945,66325578,2633,-1,0,,0,0.00000000000000000000
chr13,66454067,66456256,2189,-1,0,,0,0.00000000000000000000
chr13,66583084,66584495,1411,-1,0,,0,0.00000000000000000000
chr13,66715450,66720795,5345,-1,0,,0,0.00000000000000000000
chr13,66892641,66900724,8083,-1,0,5101,1,12.37164419151310000000
chr13,67097766,67144025,46259,-1,0,5101,1,2.16174149895156000000
chr13,67140826,67170019,29193,-1,0,5101,1,3.42547871064981000000
chr13,67170543,67178215,7672,-1,0,5101,1,13.03441084462980000000
chr13,67174780,67177424,2644,-1,0,5101,1,37.82148260211800000000
chr13,67176206,67178025,1819,-1,0,5101,1,54.97526113249040000000
chr13,67174859,67176279,1420,-1,0,5101,1,70.42253521126760000000
chr13,67133807,67134595,788,-1,0,5101,1,126.90355329949200000000
chr13,67219650,67222605,2955,-1,0,5101,1,33.84094754653130000000
chr13,67237818,67320804,82986,-1,0,5101,1,1.20502253392138000000
chr13,67346760,67423957,77197,-1,0,5101,1,1.29538712644274000000
chr13,67282350,67335523,53173,-1,0,5101,1,1.88065371523141000000
chr13,67512197,67527816,15619,-1,0,5101,1,6.40245854408093000000
chr13,67336013,67341406,5393,-1,0,5101,1,18.54255516410160000000
chr13,68047240,68096939,49699,-1,0,,0,0.00000000000000000000
chr13,68047139,68057471,10332,-1,0,,0,0.00000000000000000000
chr13,67947846,67953718,5872,-1,0,,0,0.00000000000000000000
chr13,68135358,68136549,1191,-1,0,,0,0.00000000000000000000
chr13,67950354,67950807,453,-1,0,,0,0.00000000000000000000
chr13,67950542,67950594,52,-1,0,,0,0.00000000000000000000
chr13,67950594,67950646,52,-1,0,,0,0.00000000000000000000
chr13,68321125,68329828,8703,-1,0,,0,0.00000000000000000000
chr13,68397291,68397948,657,-1,0,,0,0.00000000000000000000
chr13,68842977,68845829,2852,-1,0,,0,0.00000000000000000000
chr13,68968417,68999589,31172,-1,0,,0,0.00000000000000000000
chr13,69050400,69074287,23887,-1,0,,0,0.00000000000000000000
chr13,69199230,69202972,3742,-1,0,,0,0.00000000000000000000
chr13,68971850,68973903,2053,-1,0,,0,0.00000000000000000000
chr13,68966097,68966535,438,-1,0,,0,0.00000000000000000000
chr13,68936887,68937266,379,-1,0,,0,0.00000000000000000000
chr13,68977874,68978198,324,-1,0,,0,0.00000000000000000000
chr13,69244555,69268777,24222,-1,0,,0,0.00000000000000000000
chr13,69248405,69264616,16211,-1,0,,0,0.00000000000000000000
chr13,69251857,69267102,15245,-1,0,,0,0.00000000000000000000
chr13,69258863,69269089,10226,-1,0,,0,0.00000000000000000000
chr13,69385826,69393681,7855,-1,0,,0,0.00000000000000000000
chr13,69390588,69391669,1081,-1,0,,0,0.00000000000000000000
chr13,69487565,69488370,805,-1,0,,0,0.00000000000000000000
chr13,69511460,69574981,63521,-1,0,,0,0.00000000000000000000
chr13,69737891,69741962,4071,-1,0,,0,0.00000000000000000000
chr13,69699225,69699710,485,-1,0,,0,0.00000000000000000000
chr13,69936934,69941886,4952,-1,0,,0,0.00000000000000000000
chr13,69945229,69946260,1031,-1,0,,0,0.00000000000000000000
chr13,69966598,69967059,461,-1,0,,0,0.00000000000000000000
chr13,69966632,69966947,315,-1,0,,0,0.00000000000000000000
chr13,70079642,70079696,54,-1,0,,0,0.00000000000000000000
chr13,70125482,70128119,2637,-1,0,,0,0.00000000000000000000
chr13,70207704,70208436,732,-1,0,,0,0.00000000000000000000
chr13,70207868,70208093,225,-1,0,,0,0.00000000000000000000
chr13,70393816,70405435,11619,-1,0,57626,1,8.60659264996988000000
chr13,70401731,70407176,5445,-1,0,57626,1,18.36547291092750000000
chr13,70459050,70459396,346,-1,0,57626,1,289.01734104046200000000
chr13,70735598,70775901,40303,-1,0,,0,0.00000000000000000000
chr13,70745684,70770018,24334,-1,0,,0,0.00000000000000000000
chr13,70807226,70825271,18045,-1,0,,0,0.00000000000000000000
chr13,70644304,70652451,8147,-1,0,57626,1,12.27445685528420000000
chr13,70747968,70750716,2748,-1,0,,0,0.00000000000000000000
chr13,70734749,70734929,180,-1,0,,0,0.00000000000000000000
chr13,71069263,71089677,20414,-1,0,,0,0.00000000000000000000
chr13,70834637,70839595,4958,-1,0,,0,0.00000000000000000000
chr13,70861558,70862123,565,-1,0,,0,0.00000000000000000000
chr13,71123950,71124541,591,-1,0,,0,0.00000000000000000000
chr13,70861673,70861998,325,-1,0,,0,0.00000000000000000000
chr13,71169271,71172568,3297,-1,0,,0,0.00000000000000000000
chr13,71197684,71200275,2591,-1,0,,0,0.00000000000000000000
chr13,71197944,71199995,2051,-1,0,,0,0.00000000000000000000
chr13,71416323,71431913,15590,-1,0,,0,0.00000000000000000000
chr13,71455961,71501548,45587,-1,0,,0,0.00000000000000000000
chr13,71786925,71792246,5321,-1,0,,0,0.00000000000000000000
chr13,71994568,72003007,8439,-1,0,,0,0.00000000000000000000
chr13,72308332,72308587,255,-1,0,1602,1,392.15686274509800000000
chr13,72309359,72309650,291,-1,0,1602,1,343.64261168384900000000
chr13,72476988,72489787,12799,-1,0,,0,0.00000000000000000000
chr13,72475578,72480777,5199,-1,0,,0,0.00000000000000000000
chr13,72478298,72482431,4133,-1,0,,0,0.00000000000000000000
chr13,72477357,72479967,2610,-1,0,,0,0.00000000000000000000
chr13,72522630,72525147,2517,-1,0,,0,0.00000000000000000000
chr13,72708056,72709157,1101,-1,0,,0,0.00000000000000000000
chr13,72807600,72812447,4847,-1,0,,0,0.00000000000000000000
chr13,72839899,72847499,7600,-1,0,,0,0.00000000000000000000
chr13,72893605,72898445,4840,-1,0,,0,0.00000000000000000000
chr13,72843032,72846923,3891,-1,0,,0,0.00000000000000000000
chr13,72845584,72846900,1316,-1,0,,0,0.00000000000000000000
chr13,72956608,72957121,513,-1,0,,0,0.00000000000000000000
chr13,72956702,72957029,327,-1,0,,0,0.00000000000000000000
chr13,73299591,73300304,713,-1,0,440145,1,140.25245441795200000000
chr13,73721758,73724523,2765,-1,0,,0,0.00000000000000000000
chr13,74074551,74075907,1356,-1,0,,0,0.00000000000000000000
chr13,74074809,74075341,532,-1,0,,0,0.00000000000000000000
chr13,74074928,74075259,331,-1,0,,0,0.00000000000000000000
chr13,74357222,74360267,3045,-1,0,11278,1,32.84072249589490000000
chr13,74383451,74383897,446,-1,0,11278,1,224.21524663677100000000
chr13,74383626,74383695,69,-1,0,11278,1,1449.27536231884000000000
chr13,74479413,74479951,538,-1,0,11278,1,185.87360594795500000000
chr13,74915109,74916753,1644,-1,0,,0,0.00000000000000000000
chr13,74930713,74931135,422,-1,0,,0,0.00000000000000000000
chr13,75000212,75006509,6297,-1,0,,0,0.00000000000000000000
chr13,74993411,74993515,104,-1,0,,0,0.00000000000000000000
chr13,75561958,75562304,346,-1,0,,0,0.00000000000000000000
chr13,75625203,75625284,81,-1,0,,0,0.00000000000000000000
chr13,75629789,75634547,4758,-1,0,,0,0.00000000000000000000
chr13,75809239,75810942,1703,-1,0,,0,0.00000000000000000000
chr13,76209734,76211000,1266,-1,0,4008,1,78.98894154818320000000
chr13,76275103,76275503,400,-1,0,4008,1,250.00000000000000000000
chr13,76363064,76368112,5048,-1,0,4008,1,19.80982567353410000000
chr13,76386563,76386947,384,-1,0,4008,1,260.41666666666700000000
chr13,76589452,76592023,2571,-1,0,,0,0.00000000000000000000
chr13,76608852,76612775,3923,-1,0,,0,0.00000000000000000000
chr13,76611359,76612842,1483,-1,0,,0,0.00000000000000000000
chr13,76639241,76639665,424,-1,0,,0,0.00000000000000000000
chr13,76963993,76964276,283,-1,0,,0,0.00000000000000000000
chr13,77054063,77054471,408,-1,0,,0,0.00000000000000000000
chr13,77459443,77460910,1467,-1,0,115207,1,68.16632583503750000000
chr13,77965826,77973097,7271,-1,0,,0,0.00000000000000000000
chr13,78171271,78172186,915,-1,0,8796,1,109.28961748633900000000
chr13,78234260,78235349,1089,-1,0,,0,0.00000000000000000000
chr13,78271676,78272671,995,-1,0,122060,1,100.50251256281400000000
chr13,78454451,78459682,5231,-1,0,,0,0.00000000000000000000
chr13,78503624,78509607,5983,-1,0,1910,1,16.71402306535180000000
chr13,78579039,78581115,2076,-1,0,,0,0.00000000000000000000
chr13,78594149,78594474,325,-1,0,,0,0.00000000000000000000
chr13,78764971,78767836,2865,-1,0,,0,0.00000000000000000000
chr13,78806446,78808704,2258,-1,0,,0,0.00000000000000000000
chr13,78852291,78855965,3674,-1,0,,0,0.00000000000000000000
chr13,78966859,78970945,4086,-1,0,,0,0.00000000000000000000
chr13,78997600,78998717,1117,-1,0,,0,0.00000000000000000000
chr13,79175746,79177653,1907,-1,0,5457,1,52.43838489774520000000
chr13,79202998,79208528,5530,-1,0,79596,1,18.08318264014470000000
chr13,79484976,79495369,10393,-1,0,,0,0.00000000000000000000
chr13,79660983,79661501,518,-1,0,,0,0.00000000000000000000
chr13,79661077,79661413,336,-1,0,,0,0.00000000000000000000
chr13,79757405,79757469,64,-1,0,,0,0.00000000000000000000
chr13,79966336,79966441,105,-1,0,64062,1,952.38095238095300000000
chr13,80081349,80081798,449,-1,0,54602,1,222.71714922049000000000
chr13,80081391,80081717,326,-1,0,54602,1,306.74846625766900000000
chr13,80454908,80460139,5231,-1,0,,0,0.00000000000000000000
chr13,80531731,80532066,335,-1,0,,0,0.00000000000000000000
chr13,80681026,80686313,5287,-1,0,,0,0.00000000000000000000
chr13,80678250,80678738,488,-1,0,,0,0.00000000000000000000
chr13,80678305,80678640,335,-1,0,,0,0.00000000000000000000
chr13,81848669,81998240,149571,-1,0,,0,0.00000000000000000000
chr13,82532931,82588897,55966,-1,0,,0,0.00000000000000000000
chr13,82692429,82748550,56121,-1,0,,0,0.00000000000000000000
chr13,82322595,82360415,37820,-1,0,,0,0.00000000000000000000
chr13,82366876,82395869,28993,-1,0,,0,0.00000000000000000000
chr13,81805806,81814905,9099,-1,0,,0,0.00000000000000000000
chr13,81037166,81045957,8791,-1,0,,0,0.00000000000000000000
chr13,81738627,81746276,7649,-1,0,,0,0.00000000000000000000
chr13,81867480,81873854,6374,-1,0,,0,0.00000000000000000000
chr13,80998729,81002570,3841,-1,0,,0,0.00000000000000000000
chr13,81027709,81030513,2804,-1,0,,0,0.00000000000000000000
chr13,82693736,82694970,1234,-1,0,,0,0.00000000000000000000
chr13,81280263,81281194,931,-1,0,,0,0.00000000000000000000
chr13,81747147,81747672,525,-1,0,,0,0.00000000000000000000
chr13,82355507,82355896,389,-1,0,,0,0.00000000000000000000
chr13,81747255,81747583,328,-1,0,,0,0.00000000000000000000
chr13,81889192,81889387,195,-1,0,,0,0.00000000000000000000
chr13,82759255,82761514,2259,-1,0,,0,0.00000000000000000000
chr13,82889129,82889666,537,-1,0,,0,0.00000000000000000000
chr13,82889212,82889555,343,-1,0,,0,0.00000000000000000000
chr13,82968434,82968774,340,-1,0,,0,0.00000000000000000000
chr13,83065135,83068529,3394,-1,0,,0,0.00000000000000000000
chr13,83166476,83188983,22507,-1,0,,0,0.00000000000000000000
chr13,83165119,83180186,15067,-1,0,,0,0.00000000000000000000
chr13,83165927,83172204,6277,-1,0,,0,0.00000000000000000000
chr13,83179360,83179882,522,-1,0,,0,0.00000000000000000000
chr13,83179450,83179755,305,-1,0,,0,0.00000000000000000000
chr13,83202896,83203205,309,-1,0,,0,0.00000000000000000000
chr13,83209730,83214141,4411,-1,0,,0,0.00000000000000000000
chr13,83557603,83564027,6424,-1,0,,0,0.00000000000000000000
chr13,83580194,83580792,598,-1,0,,0,0.00000000000000000000
chr13,83580394,83580606,212,-1,0,,0,0.00000000000000000000
chr13,83639070,83641765,2695,-1,0,,0,0.00000000000000000000
chr13,83649455,83649582,127,-1,0,,0,0.00000000000000000000
chr13,83710027,83715544,5517,-1,0,,0,0.00000000000000000000
chr13,83788206,83792581,4375,-1,0,,0,0.00000000000000000000
chr13,83801226,83801438,212,-1,0,,0,0.00000000000000000000
chr13,83946225,83954797,8572,-1,0,,0,0.00000000000000000000
chr13,83921689,83928195,6506,-1,0,,0,0.00000000000000000000
chr13,83949289,83949524,235,-1,0,,0,0.00000000000000000000
chr13,84050420,84051497,1077,-1,0,,0,0.00000000000000000000
chr13,84101977,84159991,58014,-1,0,,0,0.00000000000000000000
chr13,84127634,84130132,2498,-1,0,,0,0.00000000000000000000
chr13,84258699,84261363,2664,-1,0,,0,0.00000000000000000000
chr13,84531738,84669741,138003,-1,0,,0,0.00000000000000000000
chr13,84628596,84699533,70937,-1,0,,0,0.00000000000000000000
chr13,84530546,84602472,71926,-1,0,,0,0.00000000000000000000
chr13,84478907,84479464,557,-1,0,,0,0.00000000000000000000
chr13,85045699,85057078,11379,-1,0,,0,0.00000000000000000000
chr13,85048216,85049645,1429,-1,0,,0,0.00000000000000000000
chr13,85056655,85057038,383,-1,0,,0,0.00000000000000000000
chr13,85182866,85193708,10842,-1,0,,0,0.00000000000000000000
chr13,85223237,85223355,118,-1,0,,0,0.00000000000000000000
chr13,85270038,85270090,52,-1,0,,0,0.00000000000000000000
chr13,85274861,85282777,7916,-1,0,,0,0.00000000000000000000
chr13,85363372,85370914,7542,-1,0,,0,0.00000000000000000000
chr13,85414606,85419780,5174,-1,0,,0,0.00000000000000000000
chr13,85547745,85555600,7855,-1,0,,0,0.00000000000000000000
chr13,85712687,85713914,1227,-1,0,,0,0.00000000000000000000
chr13,85800306,85803540,3234,-1,0,,0,0.00000000000000000000
chr13,85800172,85801971,1799,-1,0,,0,0.00000000000000000000
chr13,85874617,85883876,9259,-1,0,,0,0.00000000000000000000
chr13,85936455,85937900,1445,-1,0,,0,0.00000000000000000000
chr13,85936698,85937631,933,-1,0,,0,0.00000000000000000000
chr13,85929514,85929694,180,-1,0,,0,0.00000000000000000000
chr13,86008687,86008826,139,-1,0,,0,0.00000000000000000000
chr13,87952873,88097558,144685,-1,0,,0,0.00000000000000000000
chr13,87235770,87320766,84996,-1,0,,0,0.00000000000000000000
chr13,88200037,88276181,76144,-1,0,,0,0.00000000000000000000
chr13,89799508,89842341,42833,-1,0,,0,0.00000000000000000000
chr13,87763502,87802870,39368,-1,0,,0,0.00000000000000000000
chr13,87943918,87963792,19874,-1,0,,0,0.00000000000000000000
chr13,89611746,89624011,12265,-1,0,,0,0.00000000000000000000
chr13,86985077,86994806,9729,-1,0,,0,0.00000000000000000000
chr13,87410286,87417923,7637,-1,0,,0,0.00000000000000000000
chr13,87831227,87838060,6833,-1,0,,0,0.00000000000000000000
chr13,86673729,86676153,2424,-1,0,,0,0.00000000000000000000
chr13,88469272,88472114,2842,-1,0,,0,0.00000000000000000000
chr13,90210887,90213128,2241,-1,0,,0,0.00000000000000000000
chr13,90011334,90013525,2191,-1,0,,0,0.00000000000000000000
chr13,87451419,87453550,2131,-1,0,,0,0.00000000000000000000
chr13,87683395,87685440,2045,-1,0,,0,0.00000000000000000000
chr13,86674317,86675122,805,-1,0,,0,0.00000000000000000000
chr13,89421966,89422932,966,-1,0,,0,0.00000000000000000000
chr13,90248490,90249618,1128,-1,0,,0,0.00000000000000000000
chr13,86579414,86580272,858,-1,0,,0,0.00000000000000000000
chr13,87604544,87605427,883,-1,0,,0,0.00000000000000000000
chr13,89003176,89003711,535,-1,0,,0,0.00000000000000000000
chr13,89372142,89372587,445,-1,0,,0,0.00000000000000000000
chr13,89073168,89073586,418,-1,0,,0,0.00000000000000000000
chr13,86652031,86652540,509,-1,0,,0,0.00000000000000000000
chr13,87155170,87155583,413,-1,0,,0,0.00000000000000000000
chr13,89253455,89253812,357,-1,0,,0,0.00000000000000000000
chr13,89522799,89523158,359,-1,0,,0,0.00000000000000000000
chr13,89003283,89003619,336,-1,0,,0,0.00000000000000000000
chr13,89073248,89073553,305,-1,0,,0,0.00000000000000000000
chr13,86915653,86915869,216,-1,0,,0,0.00000000000000000000
chr13,89372366,89372448,82,-1,0,,0,0.00000000000000000000
chr13,89926214,89926274,60,-1,0,,0,0.00000000000000000000
chr13,86600641,86600698,57,-1,0,,0,0.00000000000000000000
chr13,90536709,90549572,12863,-1,0,,0,0.00000000000000000000
chr13,91024101,91027619,3518,-1,0,,0,0.00000000000000000000
chr13,90910972,90914129,3157,-1,0,,0,0.00000000000000000000
chr13,90862719,90864951,2232,-1,0,,0,0.00000000000000000000
chr13,90863064,90864477,1413,-1,0,,0,0.00000000000000000000
chr13,90421148,90421771,623,-1,0,,0,0.00000000000000000000
chr13,90421352,90421547,195,-1,0,,0,0.00000000000000000000
chr13,90421373,90421502,129,-1,0,,0,0.00000000000000000000
chr13,91148118,91148229,111,-1,0,,0,0.00000000000000000000
chr13,91159923,91160418,495,-1,0,,0,0.00000000000000000000
chr13,91160027,91160307,280,-1,0,,0,0.00000000000000000000
chr13,91475860,91510785,34925,-1,0,,0,0.00000000000000000000
chr13,91573107,91702831,129724,-1,0,,0,0.00000000000000000000
chr13,91538975,91540009,1034,-1,0,,0,0.00000000000000000000
chr13,91901975,91904755,2780,-1,0,,0,0.00000000000000000000
chr13,91999879,92001315,1436,-1,0,,0,0.00000000000000000000
chr13,92111502,92112056,554,-1,0,2262,1,180.50541516245500000000
chr13,92279214,92279615,401,-1,0,2262,1,249.37655860349100000000
chr13,92111708,92111830,122,-1,0,2262,1,819.67213114754100000000
chr13,92386372,92392637,6265,-1,0,2262,1,15.96169193934560000000
chr13,92493060,92499671,6611,-1,0,2262,1,15.12630464377550000000
chr13,92641015,92641367,352,-1,0,2262,1,284.09090909090900000000
chr13,92679445,92726406,46961,-1,0,2262,1,2.12942654543132000000
chr13,92711486,92715377,3891,-1,0,2262,1,25.70033410434340000000
chr13,93000106,93000325,219,-1,0,2262,1,456.62100456621000000000
chr13,93009212,93018904,9692,-1,0,2262,1,10.31778786628150000000
chr13,93056848,93057421,573,-1,0,2262,1,174.52006980802800000000
chr13,93244507,93245938,1431,-1,0,2262,1,69.88120195667360000000
chr13,93244587,93245936,1349,-1,0,2262,1,74.12898443291330000000
chr13,93462398,93471642,9244,-1,0,2262,1,10.81782778018170000000
chr13,93540293,93558533,18240,-1,0,,0,0.00000000000000000000
chr13,93747780,93748227,447,-1,0,,0,0.00000000000000000000
chr13,93883080,93884110,1030,-1,0,10082,1,97.08737864077670000000
chr13,93883568,93883653,85,-1,0,10082,1,1176.47058823529000000000
chr13,94040798,94045555,4757,-1,0,10082,1,21.02165230187090000000
chr13,94392145,94392734,589,-1,0,10082,1,169.77928692699500000000
chr13,94392427,94392525,98,-1,0,10082,1,1020.40816326531000000000
chr13,94758394,94883920,125526,-1,0,10082,1,0.79664770645125300000
chr13,94769505,94770323,818,-1,0,10082,1,122.24938875305600000000
chr13,95003327,95004674,1347,-1,0,10082,1,74.23904974016330000000
chr13,95044885,95045023,138,-1,0,10082,1,724.63768115942000000000
chr13,95154170,95154618,448,-1,0,1638,1,223.21428571428600000000
chr13,95154277,95154497,220,-1,0,1638,1,454.54545454545500000000
chr13,95196981,95201300,4319,-1,0,1638,1,23.15350775642510000000
chr13,95363143,95365755,2612,-1,0,11166,1,38.28483920367530000000
chr13,95639513,95644952,5439,-1,0,,0,0.00000000000000000000
chr13,95781154,95783032,1878,-1,0,10257,1,53.24813631522900000000
chr13,95848712,95849097,385,-1,0,10257,1,259.74025974026000000000
chr13,95893193,95894044,851,-1,0,10257,1,117.50881316098700000000
chr13,95984224,95996091,11867,-1,0,,0,0.00000000000000000000
chr13,96020155,96024651,4496,-1,0,,0,0.00000000000000000000
chr13,96012541,96015473,2932,-1,0,,0,0.00000000000000000000
chr13,96164078,96164480,402,-1,0,9071,1,248.75621890547300000000
chr13,96417908,96420006,2098,-1,0,5611,1,47.66444232602480000000
chr13,96919683,96925983,6300,-1,0,266722,1,15.87301587301590000000
chr13,96859127,96860561,1434,-1,0,266722,1,69.73500697350070000000
chr13,96742275,96743321,1046,-1,0,266722,1,95.60229445506690000000
chr13,96633328,96633872,544,-1,0,55757,1,183.82352941176500000000
chr13,96633440,96633766,326,-1,0,55757,1,306.74846625766900000000
chr13,97188397,97439210,250813,-1,0,266722,1,0.39870341648957600000
chr13,97347818,97347916,98,-1,0,266722,1,1020.40816326531000000000
chr13,97490443,97491016,573,-1,0,266722,1,174.52006980802800000000
chr13,97627403,97632710,5307,-1,0,,0,0.00000000000000000000
chr13,97941668,97944210,2542,-1,0,10150,1,39.33910306845000000000
chr13,98085518,98087040,1522,-1,0,5911,1,65.70302233902760000000
chr13,98103799,98108407,4608,-1,0,5911,1,21.70138888888890000000
chr13,98409906,98410408,502,-1,0,,0,0.00000000000000000000
chr13,98529504,98536552,7048,-1,0,,0,0.00000000000000000000
chr13,98525452,98532512,7060,-1,0,,0,0.00000000000000000000
chr13,98529858,98533058,3200,-1,0,,0,0.00000000000000000000
chr13,98600670,98602053,1383,-1,0,,0,0.00000000000000000000
chr13,98721224,98721642,418,-1,0,,0,0.00000000000000000000
chr13,98721236,98721556,320,-1,0,,0,0.00000000000000000000
chr13,98794802,98796306,1504,-1,0,10160,1,66.48936170212770000000
chr13,99228448,99229921,1473,-1,0,8428,1,67.88866259334690000000
chr13,99235817,99240415,4598,-1,0,,0,0.00000000000000000000
chr13,99254075,99258340,4265,-1,0,,0,0.00000000000000000000
chr13,99254697,99256901,2204,-1,0,,0,0.00000000000000000000
chr13,99313347,99316180,2833,-1,0,,0,0.00000000000000000000
chr13,99330251,99330620,369,-1,0,,0,0.00000000000000000000
chr13,99545453,99548749,3296,-1,0,23348,1,30.33980582524270000000
chr13,99623702,99623837,135,-1,0,23348,1,740.74074074074100000000
chr13,99631047,99631772,725,-1,0,23348,1,137.93103448275900000000
chr13,99678053,99678606,553,-1,0,23348,1,180.83182640144700000000
chr13,99678272,99678359,87,-1,0,23348,1,1149.42528735632000000000
chr13,99738395,99740049,1654,-1,0,23348,1,60.45949214026600000000
chr13,100129160,100129599,439,-1,0,,0,0.00000000000000000000
chr13,100129366,100129558,192,-1,0,,0,0.00000000000000000000
chr13,100505367,100505670,303,-1,0,171425,1,330.03300330033000000000
chr13,100778540,100783344,4804,-1,0,5095,1,20.81598667776850000000
chr13,101205425,101208768,3343,-1,0,87769,1,29.91325157044570000000
chr13,101209228,101211535,2307,-1,0,87769,1,43.34633723450370000000
chr13,101625505,101626136,631,-1,0,,0,0.00000000000000000000
chr13,101625782,101625916,134,-1,0,,0,0.00000000000000000000
chr13,101638537,101638960,423,-1,0,,0,0.00000000000000000000
chr13,101892547,101896806,4259,-1,0,259232,1,23.47969006809110000000
chr13,101894122,101896491,2369,-1,0,259232,1,42.21190375685940000000
chr13,101906931,101907293,362,-1,0,259232,1,276.24309392265200000000
chr13,102121830,102133956,12126,-1,0,9358,1,8.24674253669800000000
chr13,102440068,102443751,3683,-1,0,2259,1,27.15177844148790000000
chr13,102455753,102456088,335,-1,0,2259,1,298.50746268656700000000
chr13,102562811,102565982,3171,-1,0,2259,1,31.53579312519710000000
chr13,102790541,102790944,403,-1,0,2259,1,248.13895781637700000000
chr13,102790569,102790884,315,-1,0,2259,1,317.46031746031700000000
chr13,102813761,102814178,417,-1,0,2259,1,239.80815347721800000000
chr13,102813913,102814041,128,-1,0,2259,1,781.25000000000000000000
chr13,102886569,102886837,268,-1,0,2259,1,373.13432835820900000000
chr13,103097002,103097232,230,-1,0,,0,0.00000000000000000000
chr13,103500927,103501929,1002,-1,0,2073;100533467,2,199.60079840319400000000
chr13,103599026,103603529,4503,-1,0,,0,0.00000000000000000000
chr13,103687338,103688902,1564,-1,0,,0,0.00000000000000000000
chr13,103875493,103875570,77,-1,0,,0,0.00000000000000000000
chr13,104009712,104010298,586,-1,0,,0,0.00000000000000000000
chr13,103931532,103932062,530,-1,0,,0,0.00000000000000000000
chr13,103931644,103931965,321,-1,0,,0,0.00000000000000000000
chr13,104009853,104010173,320,-1,0,,0,0.00000000000000000000
chr13,104026089,104041425,15336,-1,0,,0,0.00000000000000000000
chr13,104041395,104042737,1342,-1,0,,0,0.00000000000000000000
chr13,104091530,104093444,1914,-1,0,,0,0.00000000000000000000
chr13,104091763,104092246,483,-1,0,,0,0.00000000000000000000
chr13,104144257,104144792,535,-1,0,,0,0.00000000000000000000
chr13,104144387,104144683,296,-1,0,,0,0.00000000000000000000
chr13,104276500,104279174,2674,-1,0,,0,0.00000000000000000000
chr13,104276876,104278267,1391,-1,0,,0,0.00000000000000000000
chr13,104253376,104253574,198,-1,0,,0,0.00000000000000000000
chr13,104527992,104534227,6235,-1,0,,0,0.00000000000000000000
chr13,104606365,104607654,1289,-1,0,,0,0.00000000000000000000
chr13,104807315,104810132,2817,-1,0,,0,0.00000000000000000000
chr13,104883069,104883809,740,-1,0,,0,0.00000000000000000000
chr13,104983218,104989978,6760,-1,0,,0,0.00000000000000000000
chr13,105161121,105161659,538,-1,0,,0,0.00000000000000000000
chr13,105161217,105161549,332,-1,0,,0,0.00000000000000000000
chr13,105176557,105177816,1259,-1,0,,0,0.00000000000000000000
chr13,105177247,105177570,323,-1,0,,0,0.00000000000000000000
chr13,105177024,105177322,298,-1,0,,0,0.00000000000000000000
chr13,105235751,105238768,3017,-1,0,,0,0.00000000000000000000
chr13,105422843,105448324,25481,-1,0,,0,0.00000000000000000000
chr13,105390966,105392846,1880,-1,0,,0,0.00000000000000000000
chr13,105707976,105708556,580,-1,0,,0,0.00000000000000000000
chr13,105708104,105708421,317,-1,0,,0,0.00000000000000000000
chr13,105420772,105420965,193,-1,0,,0,0.00000000000000000000
chr13,105953550,105956534,2984,-1,0,,0,0.00000000000000000000
chr13,106226136,106308599,82463,-1,0,,0,0.00000000000000000000
chr13,106286618,106357562,70944,-1,0,,0,0.00000000000000000000
chr13,106249942,106250602,660,-1,0,,0,0.00000000000000000000
chr13,106250152,106250499,347,-1,0,,0,0.00000000000000000000
chr13,106250149,106250299,150,-1,0,,0,0.00000000000000000000
chr13,106449326,106449920,594,-1,0,,0,0.00000000000000000000
chr13,106706281,106720037,13756,-1,0,,0,0.00000000000000000000
chr13,107012250,107014131,1881,-1,0,,0,0.00000000000000000000
chr13,107086278,107088706,2428,-1,0,,0,0.00000000000000000000
chr13,107222693,107223158,465,-1,0,,0,0.00000000000000000000
chr13,107510025,107518132,8107,-1,0,,0,0.00000000000000000000
chr13,107700908,107701448,540,-1,0,,0,0.00000000000000000000
chr13,107711726,107713642,1916,-1,0,,0,0.00000000000000000000
chr13,107924432,107924992,560,-1,0,728215,1,178.57142857142900000000
chr13,107924537,107924868,331,-1,0,728215,1,302.11480362537800000000
chr13,108191307,108191836,529,-1,0,728215,1,189.03591682419700000000
chr13,108305416,108305676,260,-1,0,728215,1,384.61538461538500000000
chr13,108332296,108490799,158503,-1,0,728215,1,0.63090288511889400000
chr13,108444008,108448601,4593,-1,0,728215,1,21.77226213803610000000
chr13,108332909,108333161,252,-1,0,728215,1,396.82539682539700000000
chr13,108560167,108561875,1708,-1,0,,0,0.00000000000000000000
chr13,108560555,108561476,921,-1,0,,0,0.00000000000000000000
chr13,108891563,108908350,16787,-1,0,,0,0.00000000000000000000
chr13,108937950,108952468,14518,-1,0,10673,1,6.88800110208018000000
chr13,108946329,108952969,6640,-1,0,10673,1,15.06024096385540000000
chr13,108947057,108951743,4686,-1,0,10673,1,21.34016218523260000000
chr13,109361524,109362796,1272,-1,0,23026,1,78.61635220125790000000
chr13,109361751,109362441,690,-1,0,23026,1,144.92753623188400000000
chr13,109267187,109267257,70,-1,0,23026,1,1428.57142857143000000000
chr13,108910547,108910621,74,-1,0,,0,0.00000000000000000000
chr13,109649538,109649863,325,-1,0,23026,1,307.69230769230800000000
chr13,109649663,109649715,52,-1,0,23026,1,1923.07692307692000000000
chr13,109678304,109686500,8196,-1,0,23026,1,12.20107369448510000000
chr13,109794698,109796061,1363,-1,0,23026,1,73.36757153338220000000
chr13,110221210,110222514,1304,-1,0,,0,0.00000000000000000000
chr13,110221789,110222461,672,-1,0,,0,0.00000000000000000000
chr13,110221540,110222040,500,-1,0,,0,0.00000000000000000000
chr13,110213178,110213232,54,-1,0,,0,0.00000000000000000000
chr13,110433953,110439859,5906,-1,0,8660,1,16.93193362682020000000
chr13,110417822,110419253,1431,-1,0,8660,1,69.88120195667360000000
chr13,110418293,110419403,1110,-1,0,8660,1,90.09009009009010000000
chr13,110417938,110418828,890,-1,0,8660,1,112.35955056179800000000
chr13,110473014,110481823,8809,-1,0,,0,0.00000000000000000000
chr13,110673610,110675199,1589,-1,0,,0,0.00000000000000000000
chr13,110737848,110762696,24848,-1,0,,0,0.00000000000000000000
chr13,110812455,110812853,398,-1,0,1282,1,251.25628140703500000000
chr13,110959300,110961245,1945,-1,0,1284;1282,2,102.82776349614400000000
chr13,111037721,111038494,773,-1,0,1284,1,129.36610608020700000000
chr13,111007620,111008291,671,-1,0,1284,1,149.03129657228000000000
chr13,111149847,111150452,605,-1,0,1284,1,165.28925619834700000000
chr13,111109094,111109726,632,-1,0,1284;100129836,2,316.45569620253200000000
chr13,111232739,111233277,538,-1,0,,0,0.00000000000000000000
chr13,111061108,111061559,451,-1,0,1284,1,221.72949002217300000000
chr13,110965861,110966195,334,-1,0,1284,1,299.40119760479000000000
chr13,111061194,111061357,163,-1,0,1284,1,613.49693251533700000000
chr13,111148895,111149123,228,-1,0,1284,1,438.59649122807000000000
chr13,110905643,110905817,174,-1,0,1282,1,574.71264367816100000000
chr13,111329227,111330410,1183,-1,0,79587,1,84.53085376162300000000
chr13,111329474,111330232,758,-1,0,79587,1,131.92612137203200000000
chr13,111329772,111330103,331,-1,0,79587,1,302.11480362537800000000
chr13,111329974,111330147,173,-1,0,79587,1,578.03468208092500000000
chr13,111410324,111428690,18366,-1,0,,0,0.00000000000000000000
chr13,111479418,111479616,198,-1,0,,0,0.00000000000000000000
chr13,111559309,111559797,488,-1,0,55608,1,204.91803278688500000000
chr13,111559405,111559672,267,-1,0,55608,1,374.53183520599300000000
chr13,111565996,111568215,2219,-1,0,55608,1,45.06534474988730000000
chr13,111587202,111588996,1794,-1,0,,0,0.00000000000000000000
chr13,111681643,111702332,20689,-1,0,,0,0.00000000000000000000
chr13,111704253,111705285,1032,-1,0,,0,0.00000000000000000000
chr13,111704387,111704888,501,-1,0,,0,0.00000000000000000000
chr13,111704529,111704771,242,-1,0,,0,0.00000000000000000000
chr13,111992372,111994171,1799,-1,0,121793,1,55.58643690939410000000
chr13,112054294,112054800,506,-1,0,,0,0.00000000000000000000
chr13,112093759,112094097,338,-1,0,,0,0.00000000000000000000
chr13,112093756,112093879,123,-1,0,,0,0.00000000000000000000
chr13,112154522,112155607,1085,-1,0,,0,0.00000000000000000000
chr13,112220189,112220745,556,-1,0,,0,0.00000000000000000000
chr13,112573108,112573180,72,-1,0,,0,0.00000000000000000000
chr13,112590741,112598394,7653,-1,0,,0,0.00000000000000000000
chr13,112614179,112614662,483,-1,0,,0,0.00000000000000000000
chr13,112669387,112670619,1232,-1,0,,0,0.00000000000000000000
chr13,112669599,112670208,609,-1,0,,0,0.00000000000000000000
chr13,112690937,112691663,726,-1,0,,0,0.00000000000000000000
chr13,112800343,112804424,4081,-1,0,,0,0.00000000000000000000
chr13,112818615,112818807,192,-1,0,,0,0.00000000000000000000
chr13,112832732,112833002,270,-1,0,,0,0.00000000000000000000
chr13,112849204,112851939,2735,-1,0,,0,0.00000000000000000000
chr13,112850747,112851773,1026,-1,0,,0,0.00000000000000000000
chr13,112850726,112851233,507,-1,0,,0,0.00000000000000000000
chr13,112850931,112851237,306,-1,0,,0,0.00000000000000000000
chr13,112868967,112869752,785,-1,0,,0,0.00000000000000000000
chr13,112868963,112869097,134,-1,0,,0,0.00000000000000000000
chr13,112931839,112966250,34411,-1,0,,0,0.00000000000000000000
chr13,112932436,112943312,10876,-1,0,,0,0.00000000000000000000
chr13,112943253,112943629,376,-1,0,,0,0.00000000000000000000
chr13,113104220,113104608,388,-1,0,,0,0.00000000000000000000
chr13,113194068,113195061,993,-1,0,10426,1,100.70493454179300000000
chr13,113194077,113194506,429,-1,0,10426,1,233.10023310023300000000
chr13,113263258,113267811,4553,-1,0,,0,0.00000000000000000000
chr13,113311731,113312194,463,-1,0,400165,1,215.98272138228900000000
chr13,113325012,113326230,1218,-1,0,400165,1,82.10180623973730000000
chr13,113330648,113331078,430,-1,0,400165,1,232.55813953488400000000
chr13,113410108,113410281,173,-1,0,23250,1,578.03468208092500000000
chr13,113419734,113441090,21356,-1,0,23250,1,4.68252481738153000000
chr13,113420069,113422121,2052,-1,0,23250,1,48.73294346978560000000
chr13,113440189,113441066,877,-1,0,23250,1,114.02508551881400000000
chr13,113415677,113416201,524,-1,0,23250,1,190.83969465648900000000
chr13,113421157,113421758,601,-1,0,23250,1,166.38935108153100000000
chr13,113440305,113440730,425,-1,0,23250,1,235.29411764705900000000
chr13,113415867,113415948,81,-1,0,23250,1,1234.56790123457000000000
chr13,113444345,113444443,98,-1,0,23250,1,1020.40816326531000000000
chr13,113454384,113456756,2372,-1,0,23250,1,42.15851602023610000000
chr13,113458222,113458652,430,-1,0,23250,1,232.55813953488400000000
chr13,113458018,113458199,181,-1,0,23250,1,552.48618784530400000000
chr13,113498838,113500367,1529,-1,0,23250,1,65.40222367560500000000
chr13,113517970,113519283,1313,-1,0,23250,1,76.16146230007620000000
chr13,113549165,113549245,80,-1,0,,0,0.00000000000000000000
chr13,113559755,113562282,2527,-1,0,,0,0.00000000000000000000
chr13,113768401,113781400,12999,-1,0,2159;2155,2,15.38579890760830000000
chr13,113759173,113764283,5110,-1,0,2155,1,19.56947162426610000000
chr13,113761575,113765278,3703,-1,0,2155,1,27.00513097488520000000
chr13,113665642,113667636,1994,-1,0,23263,1,50.15045135406220000000
chr13,113761624,113763443,1819,-1,0,2155,1,54.97526113249040000000
chr13,113679157,113680563,1406,-1,0,23263,1,71.12375533428170000000
chr13,113765584,113766354,770,-1,0,2155,1,129.87012987013000000000
chr13,113643416,113644052,636,-1,0,23263,1,157.23270440251600000000
chr13,113679507,113680076,569,-1,0,23263,1,175.74692442882200000000
chr13,113766795,113767338,543,-1,0,2155,1,184.16206261510100000000
chr13,113739991,113740195,204,-1,0,23263,1,490.19607843137300000000
chr13,113616381,113616441,60,-1,0,,0,0.00000000000000000000
chr13,113790897,113791307,410,-1,0,2159,1,243.90243902439000000000
chr13,113796707,113797090,383,-1,0,2159,1,261.09660574412500000000
chr13,113862087,113864817,2730,-1,0,8451;55795,2,73.26007326007330000000
chr13,113938751,113939727,976,-1,0,,0,0.00000000000000000000
chr13,114029791,114038545,8754,-1,0,,0,0.00000000000000000000
chr13,114086265,114094997,8732,-1,0,113622,1,11.45213009619790000000
chr13,114050049,114054631,4582,-1,0,101928841,1,21.82453077258840000000
chr13,114031893,114036377,4484,-1,0,,0,0.00000000000000000000
chr13,114087865,114091040,3175,-1,0,113622,1,31.49606299212600000000
chr13,114000302,114002261,1959,-1,0,79774,1,51.04645227156710000000
chr13,114000255,114000727,472,-1,0,79774,1,211.86440677966100000000
chr13,113990847,113991280,433,-1,0,79774,1,230.94688221709000000000
chr13,114067026,114067501,475,-1,0,101928841,1,210.52631578947400000000
chr13,114089795,114090208,413,-1,0,113622,1,242.13075060532700000000
chr13,114090692,114091124,432,-1,0,113622,1,231.48148148148100000000
chr13,113991058,113991128,70,-1,0,79774,1,1428.57142857143000000000
chr13,114135936,114137075,1139,-1,0,55208,1,87.79631255487270000000
chr13,114168708,114169092,384,-1,0,55002,1,260.41666666666700000000
chr13,114160433,114160693,260,-1,0,55002,1,384.61538461538500000000
chr13,114168811,114168928,117,-1,0,55002,1,854.70085470085500000000
chr13,114195644,114196734,1090,-1,0,55002,1,91.74311926605500000000
chr13,114195424,114195908,484,-1,0,55002,1,206.61157024793400000000
chr13,114214544,114214747,203,-1,0,,0,0.00000000000000000000
chr13,114219005,114220096,1091,-1,0,,0,0.00000000000000000000
chr13,114219590,114220118,528,-1,0,,0,0.00000000000000000000
chr13,114237864,114238125,261,-1,0,,0,0.00000000000000000000
chr13,114511455,114542818,31363,-1,0,348013;2621,2,6.37694098141122000000
chr13,114502416,114506843,4427,-1,0,348013,1,22.58866049243280000000
chr13,114544797,114548932,4135,-1,0,2621,1,24.18379685610640000000
chr13,114505556,114506639,1083,-1,0,348013,1,92.33610341643580000000
chr13,114492707,114493794,1087,-1,0,348013,1,91.99632014719410000000
chr13,114578930,114579771,841,-1,0,,0,0.00000000000000000000
chr13,114505615,114506577,962,-1,0,348013,1,103.95010395010400000000
chr13,114544387,114545146,759,-1,0,2621,1,131.75230566534900000000
chr13,114542125,114542604,479,-1,0,2621,1,208.76826722338200000000
chr13,114579267,114579655,388,-1,0,,0,0.00000000000000000000
chr13,114493077,114493603,526,-1,0,348013,1,190.11406844106500000000
chr13,114531890,114532200,310,-1,0,2621,1,322.58064516129000000000
chr13,114544617,114544893,276,-1,0,2621,1,362.31884057971000000000
chr13,114440320,114440467,147,-1,0,,0,0.00000000000000000000
chr13,114503864,114503971,107,-1,0,348013,1,934.57943925233600000000
chr13,114601301,114603600,2299,-1,0,643365,1,43.49717268377560000000
chr13,114616589,114617479,890,-1,0,643365,1,112.35955056179800000000
chr13,114740081,114931732,191651,-1,0,22821,1,0.52178178042379100000
chr13,114868151,114892121,23970,-1,0,22821,1,4.17188151856487000000
chr13,114763695,114770816,7121,-1,0,22821,1,14.04297149276790000000
chr13,114849123,114852717,3594,-1,0,22821,1,27.82415136338340000000
chr13,114903735,114906453,2718,-1,0,,0,0.00000000000000000000
chr13,114770875,114773047,2172,-1,0,22821,1,46.04051565377530000000
chr13,114920298,114922397,2099,-1,0,,0,0.00000000000000000000
chr13,114771806,114772930,1124,-1,0,22821,1,88.96797153024910000000
chr13,114869027,114869771,744,-1,0,22821,1,134.40860215053800000000
chr13,114885106,114885845,739,-1,0,22821,1,135.31799729364000000000
chr13,114795929,114796020,91,-1,0,22821,1,1098.90109890110000000000
chr13,114753683,114753761,78,-1,0,22821,1,1282.05128205128000000000
chr13,114964067,114965676,1609,-1,0,,0,0.00000000000000000000
chr13,114995759,114997779,2020,-1,0,,0,0.00000000000000000000
chr13,114990594,114991882,1288,-1,0,,0,0.00000000000000000000
chr13,114996505,114997052,547,-1,0,,0,0.00000000000000000000
chr14,19308028,20392596,1084568,-1,0,441669;390429;79317;441670;440153;390431;79334;641455;404785,9,0.82982348732398500000
chr14,19723206,20261627,538421,-1,0,79334;441669;641455;441670,4,0.74291307359854100000
chr14,19376545,19749903,373358,-1,0,440153;404785,2,0.53567889264459300000
chr14,20040300,20387241,346941,-1,0,441669;390429;390431;79334;441670,5,1.44116723016305000000
chr14,19796165,20085252,289087,-1,0,641455,1,0.34591662717451800000
chr14,20190699,20425231,234532,-1,0,441669;390429;390431;79317;79544;441670,6,2.55828628929101000000
chr14,19374773,19552588,177815,-1,0,440153,1,0.56238225121615200000
chr14,20020589,20197401,176812,-1,0,79334,1,0.56557247245662100000
chr14,20021829,20178324,156495,-1,0,,0,0.00000000000000000000
chr14,19814148,19940741,126593,-1,0,,0,0.00000000000000000000
chr14,20297283,20425252,127969,-1,0,79317;79544;390431,3,2.34431776445858000000
chr14,20201226,20313345,112119,-1,0,441669;390429;441670,3,2.67572846707516000000
chr14,19504070,19617230,113160,-1,0,404785,1,0.88370448921880500000
chr14,20321821,20419546,97725,-1,0,79317;79544;390431,3,3.06983883346124000000
chr14,19368903,19471918,103015,-1,0,440153,1,0.97073241760908600000
chr14,19866861,19947147,80286,-1,0,,0,0.00000000000000000000
chr14,20227088,20291772,64684,-1,0,390429;441670,2,3.09195473378270000000
chr14,19491749,19552644,60895,-1,0,,0,0.00000000000000000000
chr14,20191821,20252027,60206,-1,0,441669;441670,2,3.32192804703850000000
chr14,20353435,20401000,47565,-1,0,79317,1,2.10238620834647000000
chr14,20241694,20280727,39033,-1,0,390429;441670,2,5.12386954628135000000
chr14,19429393,19472195,42802,-1,0,,0,0.00000000000000000000
chr14,19788611,19815786,27175,-1,0,,0,0.00000000000000000000
chr14,19720202,19743377,23175,-1,0,,0,0.00000000000000000000
chr14,19275559,19303197,27638,-1,0,,0,0.00000000000000000000
chr14,19829772,19854112,24340,-1,0,,0,0.00000000000000000000
chr14,19780579,19799320,18741,-1,0,,0,0.00000000000000000000
chr14,19449821,19468195,18374,-1,0,,0,0.00000000000000000000
chr14,19458151,19472868,14717,-1,0,,0,0.00000000000000000000
chr14,20417892,20425550,7658,-1,0,,0,0.00000000000000000000
chr14,19462304,19469872,7568,-1,0,,0,0.00000000000000000000
chr14,20376082,20379489,3407,-1,0,,0,0.00000000000000000000
chr14,19817501,19819207,1706,-1,0,,0,0.00000000000000000000
chr14,20511673,20698504,186831,-1,0,390439;122748;390436;122742;390437,5,2.67621540322537000000
chr14,20680491,20736066,55575,-1,0,122748;390442,2,3.59874044084570000000
chr14,20550607,20555957,5350,-1,0,,0,0.00000000000000000000
chr14,20550138,20552643,2505,-1,0,,0,0.00000000000000000000
chr14,20679910,20681980,2070,-1,0,,0,0.00000000000000000000
chr14,20554013,20555206,1193,-1,0,,0,0.00000000000000000000
chr14,20839501,20855300,15799,-1,0,7011,1,6.32951452623584000000
chr14,21298854,21302288,3434,-1,0,,0,0.00000000000000000000
chr14,21349751,21420826,71075,-1,0,6037,1,1.40696447414703000000
chr14,21369957,21398166,28209,-1,0,,0,0.00000000000000000000
chr14,21346176,21359120,12944,-1,0,,0,0.00000000000000000000
chr14,21377306,21379522,2216,-1,0,,0,0.00000000000000000000
chr14,21536115,21536515,400,-1,0,57447,1,250.00000000000000000000
chr14,21651034,21651861,827,-1,0,,0,0.00000000000000000000
chr14,21690516,21695465,4949,-1,0,3183,1,20.20610224287730000000
chr14,21753105,21754656,1551,-1,0,,0,0.00000000000000000000
chr14,21778184,21778397,213,-1,0,57096,1,469.48356807511700000000
chr14,21895560,21895684,124,-1,0,57680,1,806.45161290322600000000
chr14,21895511,21895605,94,-1,0,57680,1,1063.82978723404000000000
chr14,21920960,21922161,1201,-1,0,,0,0.00000000000000000000
chr14,21952623,21954665,2042,-1,0,9878,1,48.97159647404510000000
chr14,22019252,22023602,4350,-1,0,,0,0.00000000000000000000
chr14,22026325,22036270,9945,-1,0,,0,0.00000000000000000000
chr14,22029961,22031609,1648,-1,0,,0,0.00000000000000000000
chr14,22070046,22102823,32777,-1,0,26534,1,3.05091985233548000000
chr14,22190991,22196286,5295,-1,0,,0,0.00000000000000000000
chr14,22372273,23000256,627983,-1,0,,0,0.00000000000000000000
chr14,22735067,22924866,189799,-1,0,,0,0.00000000000000000000
chr14,22597856,22804704,206848,-1,0,,0,0.00000000000000000000
chr14,22812868,22946008,133140,-1,0,,0,0.00000000000000000000
chr14,22685796,22809394,123598,-1,0,,0,0.00000000000000000000
chr14,22849843,22942411,92568,-1,0,,0,0.00000000000000000000
chr14,22917991,23009190,91199,-1,0,,0,0.00000000000000000000
chr14,22889988,22941901,51913,-1,0,,0,0.00000000000000000000
chr14,22787215,22847289,60074,-1,0,,0,0.00000000000000000000
chr14,22761088,22808516,47428,-1,0,,0,0.00000000000000000000
chr14,22322167,22374003,51836,-1,0,,0,0.00000000000000000000
chr14,22633187,22655955,22768,-1,0,,0,0.00000000000000000000
chr14,22891905,22918394,26489,-1,0,,0,0.00000000000000000000
chr14,22721567,22735855,14288,-1,0,,0,0.00000000000000000000
chr14,22907947,22918194,10247,-1,0,,0,0.00000000000000000000
chr14,22831655,22840552,8897,-1,0,,0,0.00000000000000000000
chr14,22910707,22917851,7144,-1,0,,0,0.00000000000000000000
chr14,22793877,22798313,4436,-1,0,,0,0.00000000000000000000
chr14,22774530,22775644,1114,-1,0,,0,0.00000000000000000000
chr14,22881312,22882449,1137,-1,0,,0,0.00000000000000000000
chr14,22582683,22583753,1070,-1,0,,0,0.00000000000000000000
chr14,22535488,22536469,981,-1,0,,0,0.00000000000000000000
chr14,22392844,22393482,638,-1,0,,0,0.00000000000000000000
chr14,22881665,22882261,596,-1,0,,0,0.00000000000000000000
chr14,22774760,22775371,611,-1,0,,0,0.00000000000000000000
chr14,23023158,23023240,82,-1,0,,0,0.00000000000000000000
chr14,23052217,23053555,1338,-1,0,1603,1,74.73841554559040000000
chr14,23092919,23099057,6138,-1,0,,0,0.00000000000000000000
chr14,23094851,23098172,3321,-1,0,,0,0.00000000000000000000
chr14,23105118,23108494,3376,-1,0,,0,0.00000000000000000000
chr14,23108118,23110573,2455,-1,0,,0,0.00000000000000000000
chr14,23108020,23109341,1321,-1,0,,0,0.00000000000000000000
chr14,23109551,23110796,1245,-1,0,,0,0.00000000000000000000
chr14,23172815,23174075,1260,-1,0,,0,0.00000000000000000000
chr14,23173137,23173376,239,-1,0,,0,0.00000000000000000000
chr14,23173165,23173357,192,-1,0,,0,0.00000000000000000000
chr14,23505496,23505686,190,-1,0,,0,0.00000000000000000000
chr14,23922249,23922649,400,-1,0,,0,0.00000000000000000000
chr14,24174887,24175452,565,-1,0,,0,0.00000000000000000000
chr14,24175017,24175328,311,-1,0,,0,0.00000000000000000000
chr14,24186806,24187394,588,-1,0,,0,0.00000000000000000000
chr14,24197882,24208864,10982,-1,0,,0,0.00000000000000000000
chr14,24264868,24272048,7180,-1,0,,0,0.00000000000000000000
chr14,24394337,24394794,457,-1,0,,0,0.00000000000000000000
chr14,24394563,24394616,53,-1,0,,0,0.00000000000000000000
chr14,24428440,24506256,77816,-1,0,728635;10901;317749,3,3.85524827798910000000
chr14,24438174,24483409,45235,-1,0,728635;10901;317749,3,6.63203271802808000000
chr14,24457818,24507193,49375,-1,0,728635;317749,2,4.05063291139241000000
chr14,24426244,24463159,36915,-1,0,10901;317749,2,5.41785182175268000000
chr14,24453257,24479697,26440,-1,0,728635;317749,2,7.56429652042360000000
chr14,24487483,24500577,13094,-1,0,728635,1,7.63708568810142000000
chr14,24478151,24484301,6150,-1,0,728635,1,16.26016260162600000000
chr14,24446331,24451797,5466,-1,0,317749,1,18.29491401390410000000
chr14,24471168,24473272,2104,-1,0,317749,1,47.52851711026620000000
chr14,24668886,24674448,5562,-1,0,,0,0.00000000000000000000
chr14,24932435,24933149,714,-1,0,,0,0.00000000000000000000
chr14,24932618,24932783,165,-1,0,,0,0.00000000000000000000
chr14,25000557,25019188,18631,-1,0,,0,0.00000000000000000000
chr14,25224410,25231442,7032,-1,0,,0,0.00000000000000000000
chr14,25262333,25263126,793,-1,0,,0,0.00000000000000000000
chr14,25497696,25499208,1512,-1,0,29091,1,66.13756613756610000000
chr14,25611441,25613717,2276,-1,0,,0,0.00000000000000000000
chr14,25806806,25809102,2296,-1,0,,0,0.00000000000000000000
chr14,25910076,25911973,1897,-1,0,,0,0.00000000000000000000
chr14,25954025,25958959,4934,-1,0,,0,0.00000000000000000000
chr14,26005796,26006046,250,-1,0,,0,0.00000000000000000000
chr14,26146994,26147579,585,-1,0,,0,0.00000000000000000000
chr14,26147100,26147457,357,-1,0,,0,0.00000000000000000000
chr14,26283844,26284793,949,-1,0,,0,0.00000000000000000000
chr14,26284292,26284779,487,-1,0,,0,0.00000000000000000000
chr14,27100955,27146284,45329,-1,0,,0,0.00000000000000000000
chr14,26760519,26793600,33081,-1,0,,0,0.00000000000000000000
chr14,26590928,26592464,1536,-1,0,,0,0.00000000000000000000
chr14,26591199,26592232,1033,-1,0,,0,0.00000000000000000000
chr14,26701580,26701944,364,-1,0,,0,0.00000000000000000000
chr14,26821873,26821969,96,-1,0,,0,0.00000000000000000000
chr14,27643447,27940232,296785,-1,0,,0,0.00000000000000000000
chr14,27507375,27741529,234154,-1,0,,0,0.00000000000000000000
chr14,27913931,28019953,106022,-1,0,,0,0.00000000000000000000
chr14,28011137,28092096,80959,-1,0,,0,0.00000000000000000000
chr14,27824234,27887656,63422,-1,0,,0,0.00000000000000000000
chr14,27533471,27601242,67771,-1,0,,0,0.00000000000000000000
chr14,27466316,27531010,64694,-1,0,,0,0.00000000000000000000
chr14,27679636,27713959,34323,-1,0,,0,0.00000000000000000000
chr14,27479659,27493208,13549,-1,0,,0,0.00000000000000000000
chr14,28111351,28115366,4015,-1,0,,0,0.00000000000000000000
chr14,27469962,27472460,2498,-1,0,,0,0.00000000000000000000
chr14,28466767,28521196,54429,-1,0,,0,0.00000000000000000000
chr14,28556307,28614067,57760,-1,0,,0,0.00000000000000000000
chr14,28667191,28673770,6579,-1,0,,0,0.00000000000000000000
chr14,28668565,28671157,2592,-1,0,,0,0.00000000000000000000
chr14,28869770,28872666,2896,-1,0,,0,0.00000000000000000000
chr14,28869865,28871422,1557,-1,0,,0,0.00000000000000000000
chr14,28963749,28965495,1746,-1,0,,0,0.00000000000000000000
chr14,29117644,29118557,913,-1,0,,0,0.00000000000000000000
chr14,29126899,29128077,1178,-1,0,,0,0.00000000000000000000
chr14,29147573,29152304,4731,-1,0,,0,0.00000000000000000000
chr14,29727605,29729063,1458,-1,0,,0,0.00000000000000000000
chr14,29728037,29728802,765,-1,0,,0,0.00000000000000000000
chr14,30295431,30295570,139,-1,0,5587,1,719.42446043165500000000
chr14,30458336,30459971,1635,-1,0,,0,0.00000000000000000000
chr14,30558473,30558941,468,-1,0,,0,0.00000000000000000000
chr14,30558640,30558879,239,-1,0,,0,0.00000000000000000000
chr14,30682749,30683203,454,-1,0,,0,0.00000000000000000000
chr14,30817205,30819449,2244,-1,0,,0,0.00000000000000000000
chr14,30864197,30864754,557,-1,0,,0,0.00000000000000000000
chr14,30954976,30961745,6769,-1,0,,0,0.00000000000000000000
chr14,30986506,30986761,255,-1,0,,0,0.00000000000000000000
chr14,31219833,31225649,5816,-1,0,,0,0.00000000000000000000
chr14,31262897,31263426,529,-1,0,,0,0.00000000000000000000
chr14,31262995,31263326,331,-1,0,,0,0.00000000000000000000
chr14,31267552,31268802,1250,-1,0,,0,0.00000000000000000000
chr14,31458799,31459511,712,-1,0,29966,1,140.44943820224700000000
chr14,31542485,31543448,963,-1,0,11154,1,103.84215991692600000000
chr14,31813515,31814581,1066,-1,0,25938,1,93.80863039399630000000
chr14,31813779,31814187,408,-1,0,25938,1,245.09803921568600000000
chr14,31813875,31814050,175,-1,0,25938,1,571.42857142857100000000
chr14,31942892,31943370,478,-1,0,,0,0.00000000000000000000
chr14,31942961,31943290,329,-1,0,,0,0.00000000000000000000
chr14,32214712,32216561,1849,-1,0,80224,1,54.08328826392640000000
chr14,32363847,32381475,17628,-1,0,,0,0.00000000000000000000
chr14,32952474,32958739,6265,-1,0,9472,1,15.96169193934560000000
chr14,32953276,32954360,1084,-1,0,9472,1,92.25092250922510000000
chr14,33236111,33237665,1554,-1,0,9472,1,64.35006435006430000000
chr14,33310146,33315874,5728,-1,0,,0,0.00000000000000000000
chr14,33336408,33350372,13964,-1,0,,0,0.00000000000000000000
chr14,33391977,33392317,340,-1,0,,0,0.00000000000000000000
chr14,33435658,33436133,475,-1,0,64067,1,210.52631578947400000000
chr14,33652126,33678055,25929,-1,0,64067,1,3.85668556442593000000
chr14,33941759,33942545,786,-1,0,64067,1,127.22646310432600000000
chr14,34012945,34013390,445,-1,0,64067,1,224.71910112359600000000
chr14,34013139,34013189,50,-1,0,64067,1,2000.00000000000000000000
chr14,34289962,34290525,563,-1,0,,0,0.00000000000000000000
chr14,34290044,34290388,344,-1,0,,0,0.00000000000000000000
chr14,34472140,34472480,340,-1,0,,0,0.00000000000000000000
chr14,34514027,34514837,810,-1,0,,0,0.00000000000000000000
chr14,34674473,34674967,494,-1,0,,0,0.00000000000000000000
chr14,34698601,34699351,750,-1,0,,0,0.00000000000000000000
chr14,34780265,34782191,1926,-1,0,,0,0.00000000000000000000
chr14,34837559,34845124,7565,-1,0,,0,0.00000000000000000000
chr14,35019245,35022677,3432,-1,0,,0,0.00000000000000000000
chr14,35019763,35022632,2869,-1,0,,0,0.00000000000000000000
chr14,35108600,35159142,50542,-1,0,,0,0.00000000000000000000
chr14,35111941,35125619,13678,-1,0,,0,0.00000000000000000000
chr14,35115084,35122341,7257,-1,0,,0,0.00000000000000000000
chr14,35255908,35257356,1448,-1,0,11177,1,69.06077348066300000000
chr14,35304149,35306815,2666,-1,0,11177,1,37.50937734433610000000
chr14,35305228,35305755,527,-1,0,11177,1,189.75332068311200000000
chr14,35305291,35305621,330,-1,0,11177,1,303.03030303030300000000
chr14,35398711,35399019,308,-1,0,,0,0.00000000000000000000
chr14,35401400,35401723,323,-1,0,,0,0.00000000000000000000
chr14,35428790,35432432,3642,-1,0,,0,0.00000000000000000000
chr14,35428820,35429712,892,-1,0,,0,0.00000000000000000000
chr14,35507699,35509507,1808,-1,0,,0,0.00000000000000000000
chr14,35605396,35615320,9924,-1,0,9692,1,10.07658202337770000000
chr14,35606020,35610285,4265,-1,0,9692,1,23.44665885111370000000
chr14,35690070,35719212,29142,-1,0,9692,1,3.43147347471004000000
chr14,35702291,35703388,1097,-1,0,9692,1,91.15770282588880000000
chr14,35702319,35702837,518,-1,0,9692,1,193.05019305019300000000
chr14,35850504,35852141,1637,-1,0,,0,0.00000000000000000000
chr14,35896952,35898789,1837,-1,0,,0,0.00000000000000000000
chr14,36002608,36004777,2169,-1,0,84684,1,46.10419548178880000000
chr14,36417329,36418947,1618,-1,0,,0,0.00000000000000000000
chr14,36672123,36675396,3273,-1,0,,0,0.00000000000000000000
chr14,37224817,37226626,1809,-1,0,89874,1,55.27915975677170000000
chr14,37636631,37639472,2841,-1,0,89874,1,35.19887363604360000000
chr14,37769627,37771199,1572,-1,0,145282,1,63.61323155216290000000
chr14,38132585,38138099,5514,-1,0,319089,1,18.13565469713460000000
chr14,38134996,38138676,3680,-1,0,319089,1,27.17391304347830000000
chr14,38159485,38160039,554,-1,0,319089,1,180.50541516245500000000
chr14,38245116,38245577,461,-1,0,319089,1,216.91973969631200000000
chr14,38245237,38245461,224,-1,0,319089,1,446.42857142857100000000
chr14,38247549,38247611,62,-1,0,319089,1,1612.90322580645000000000
chr14,38392377,38565862,173485,-1,0,,0,0.00000000000000000000
chr14,38358830,38365886,7056,-1,0,,0,0.00000000000000000000
chr14,38643494,38643812,318,-1,0,,0,0.00000000000000000000
chr14,38793394,38807943,14549,-1,0,,0,0.00000000000000000000
chr14,38799459,38803682,4223,-1,0,,0,0.00000000000000000000
chr14,38801335,38803614,2279,-1,0,,0,0.00000000000000000000
chr14,38902495,38904056,1561,-1,0,,0,0.00000000000000000000
chr14,38951596,39045152,93556,-1,0,,0,0.00000000000000000000
chr14,38946020,38952848,6828,-1,0,,0,0.00000000000000000000
chr14,38962318,38966282,3964,-1,0,,0,0.00000000000000000000
chr14,39004246,39005311,1065,-1,0,,0,0.00000000000000000000
chr14,39004503,39005026,523,-1,0,,0,0.00000000000000000000
chr14,39059037,39059452,415,-1,0,,0,0.00000000000000000000
chr14,39116739,39326084,209345,-1,0,,0,0.00000000000000000000
chr14,39308746,39333906,25160,-1,0,,0,0.00000000000000000000
chr14,39458225,39458290,65,-1,0,,0,0.00000000000000000000
chr14,39631995,39633311,1316,-1,0,122553,1,75.98784194528870000000
chr14,39746884,39746940,56,-1,0,4253,1,1785.71428571429000000000
chr14,40098243,40100396,2153,-1,0,,0,0.00000000000000000000
chr14,40608201,40647881,39680,-1,0,,0,0.00000000000000000000
chr14,40608959,40618899,9940,-1,0,,0,0.00000000000000000000
chr14,40613912,40617508,3596,-1,0,,0,0.00000000000000000000
chr14,40869916,40873927,4011,-1,0,,0,0.00000000000000000000
chr14,41203738,41517939,314201,-1,0,,0,0.00000000000000000000
chr14,41051431,41176791,125360,-1,0,,0,0.00000000000000000000
chr14,40955111,41041855,86744,-1,0,,0,0.00000000000000000000
chr14,41210074,41237892,27818,-1,0,,0,0.00000000000000000000
chr14,41471342,41485679,14337,-1,0,,0,0.00000000000000000000
chr14,40977119,40981764,4645,-1,0,,0,0.00000000000000000000
chr14,40987771,40991021,3250,-1,0,,0,0.00000000000000000000
chr14,41062908,41065648,2740,-1,0,,0,0.00000000000000000000
chr14,41390683,41393038,2355,-1,0,,0,0.00000000000000000000
chr14,41122390,41122494,104,-1,0,,0,0.00000000000000000000
chr14,41608546,41670807,62261,-1,0,,0,0.00000000000000000000
chr14,41622015,41660388,38373,-1,0,,0,0.00000000000000000000
chr14,41602365,41602430,65,-1,0,,0,0.00000000000000000000
chr14,41701639,41738150,36511,-1,0,,0,0.00000000000000000000
chr14,43851645,45412080,1560435,-1,0,84075;54813;122525,3,0.19225408299608800000
chr14,42865840,42967182,101342,-1,0,,0,0.00000000000000000000
chr14,42967794,43109890,142096,-1,0,,0,0.00000000000000000000
chr14,41835616,41992389,156773,-1,0,,0,0.00000000000000000000
chr14,45081100,45217989,136889,-1,0,,0,0.00000000000000000000
chr14,44068154,44195844,127690,-1,0,,0,0.00000000000000000000
chr14,44010480,44129617,119137,-1,0,,0,0.00000000000000000000
chr14,43748679,43830922,82243,-1,0,,0,0.00000000000000000000
chr14,42922940,43019803,96863,-1,0,,0,0.00000000000000000000
chr14,44664464,44745579,81115,-1,0,,0,0.00000000000000000000
chr14,45052558,45129470,76912,-1,0,,0,0.00000000000000000000
chr14,41900977,41972391,71414,-1,0,,0,0.00000000000000000000
chr14,45176032,45226542,50510,-1,0,,0,0.00000000000000000000
chr14,44496026,44533626,37600,-1,0,,0,0.00000000000000000000
chr14,41814199,41859659,45460,-1,0,,0,0.00000000000000000000
chr14,43441246,43466778,25532,-1,0,,0,0.00000000000000000000
chr14,45186626,45214500,27874,-1,0,,0,0.00000000000000000000
chr14,42831271,42859134,27863,-1,0,,0,0.00000000000000000000
chr14,43064109,43077989,13880,-1,0,,0,0.00000000000000000000
chr14,42986133,42995332,9199,-1,0,,0,0.00000000000000000000
chr14,44715583,44724584,9001,-1,0,,0,0.00000000000000000000
chr14,43109288,43118276,8988,-1,0,,0,0.00000000000000000000
chr14,42988330,42996115,7785,-1,0,,0,0.00000000000000000000
chr14,42500657,42508109,7452,-1,0,,0,0.00000000000000000000
chr14,44714213,44721112,6899,-1,0,,0,0.00000000000000000000
chr14,43726971,43733586,6615,-1,0,,0,0.00000000000000000000
chr14,42717615,42723985,6370,-1,0,,0,0.00000000000000000000
chr14,42987521,42992935,5414,-1,0,,0,0.00000000000000000000
chr14,43595749,43601452,5703,-1,0,,0,0.00000000000000000000
chr14,44804231,44808166,3935,-1,0,,0,0.00000000000000000000
chr14,43481910,43485256,3346,-1,0,,0,0.00000000000000000000
chr14,44588837,44591742,2905,-1,0,,0,0.00000000000000000000
chr14,43182834,43185198,2364,-1,0,,0,0.00000000000000000000
chr14,42878920,42880186,1266,-1,0,,0,0.00000000000000000000
chr14,42210189,42211630,1441,-1,0,145581,1,69.39625260235950000000
chr14,43779229,43780554,1325,-1,0,,0,0.00000000000000000000
chr14,42504599,42505510,911,-1,0,,0,0.00000000000000000000
chr14,43899239,43899762,523,-1,0,,0,0.00000000000000000000
chr14,42519417,42520189,772,-1,0,,0,0.00000000000000000000
chr14,41951726,41952184,458,-1,0,,0,0.00000000000000000000
chr14,42486223,42486753,530,-1,0,,0,0.00000000000000000000
chr14,42761071,42761423,352,-1,0,,0,0.00000000000000000000
chr14,42115807,42116403,596,-1,0,145581,1,167.78523489932900000000
chr14,43372916,43373325,409,-1,0,,0,0.00000000000000000000
chr14,43549811,43550206,395,-1,0,,0,0.00000000000000000000
chr14,42650927,42651245,318,-1,0,,0,0.00000000000000000000
chr14,42277559,42277779,220,-1,0,145581,1,454.54545454545500000000
chr14,42486335,42486650,315,-1,0,,0,0.00000000000000000000
chr14,45067015,45067262,247,-1,0,,0,0.00000000000000000000
chr14,42879145,42879410,265,-1,0,,0,0.00000000000000000000
chr14,45385470,45385691,221,-1,0,,0,0.00000000000000000000
chr14,43899444,43899528,84,-1,0,,0,0.00000000000000000000
chr14,43549920,43550002,82,-1,0,,0,0.00000000000000000000
chr14,41951862,41951928,66,-1,0,,0,0.00000000000000000000
chr14,41951929,41951995,66,-1,0,,0,0.00000000000000000000
chr14,45595482,45597337,1855,-1,0,2287,1,53.90835579514830000000
chr14,45610958,45613059,2101,-1,0,57697,1,47.59638267491670000000
chr14,45802806,46014714,211908,-1,0,,0,0.00000000000000000000
chr14,45934845,46016691,81846,-1,0,,0,0.00000000000000000000
chr14,45754574,45833541,78967,-1,0,,0,0.00000000000000000000
chr14,45921298,45935203,13905,-1,0,,0,0.00000000000000000000
chr14,46048991,46060576,11585,-1,0,,0,0.00000000000000000000
chr14,46100797,46101185,388,-1,0,,0,0.00000000000000000000
chr14,46447887,46733803,285916,-1,0,,0,0.00000000000000000000
chr14,46838610,46946416,107806,-1,0,,0,0.00000000000000000000
chr14,46465895,46563137,97242,-1,0,,0,0.00000000000000000000
chr14,46121036,46204025,82989,-1,0,,0,0.00000000000000000000
chr14,46568882,46634630,65748,-1,0,,0,0.00000000000000000000
chr14,46841476,46877393,35917,-1,0,,0,0.00000000000000000000
chr14,46529860,46563195,33335,-1,0,,0,0.00000000000000000000
chr14,46751125,46775020,23895,-1,0,,0,0.00000000000000000000
chr14,46775872,46784697,8825,-1,0,,0,0.00000000000000000000
chr14,46601721,46608933,7212,-1,0,,0,0.00000000000000000000
chr14,46425002,46431873,6871,-1,0,,0,0.00000000000000000000
chr14,46215128,46220632,5504,-1,0,,0,0.00000000000000000000
chr14,46588961,46591068,2107,-1,0,,0,0.00000000000000000000
chr14,46824226,46825422,1196,-1,0,,0,0.00000000000000000000
chr14,46629383,46630405,1022,-1,0,,0,0.00000000000000000000
chr14,46577834,46578376,542,-1,0,,0,0.00000000000000000000
chr14,46577925,46578258,333,-1,0,,0,0.00000000000000000000
chr14,46830457,46830590,133,-1,0,,0,0.00000000000000000000
chr14,46403074,46403161,87,-1,0,,0,0.00000000000000000000
chr14,47434085,47434451,366,-1,0,161357,1,273.22404371584700000000
chr14,47697050,47719153,22103,-1,0,161357,1,4.52427272315975000000
chr14,47708093,47723791,15698,-1,0,161357,1,6.37023824691043000000
chr14,47707410,47717923,10513,-1,0,161357,1,9.51203272139256000000
chr14,47671971,47678239,6268,-1,0,161357,1,15.95405232929160000000
chr14,47965116,47971110,5994,-1,0,161357,1,16.68335001668340000000
chr14,48275278,48366381,91103,-1,0,,0,0.00000000000000000000
chr14,48228267,48278389,50122,-1,0,,0,0.00000000000000000000
chr14,48334232,48334586,354,-1,0,,0,0.00000000000000000000
chr14,48413472,48436055,22583,-1,0,,0,0.00000000000000000000
chr14,48472704,48473734,1030,-1,0,,0,0.00000000000000000000
chr14,48783142,48919522,136380,-1,0,,0,0.00000000000000000000
chr14,48747522,48858528,111006,-1,0,,0,0.00000000000000000000
chr14,48730090,48732016,1926,-1,0,,0,0.00000000000000000000
chr14,48826711,48827236,525,-1,0,,0,0.00000000000000000000
chr14,48763745,48764261,516,-1,0,,0,0.00000000000000000000
chr14,48826809,48827135,326,-1,0,,0,0.00000000000000000000
chr14,48763836,48764158,322,-1,0,,0,0.00000000000000000000
chr14,49390662,49473539,82877,-1,0,,0,0.00000000000000000000
chr14,49080345,49136165,55820,-1,0,,0,0.00000000000000000000
chr14,49331365,49333937,2572,-1,0,,0,0.00000000000000000000
chr14,49293679,49295032,1353,-1,0,,0,0.00000000000000000000
chr14,49086981,49087304,323,-1,0,,0,0.00000000000000000000
chr14,49084554,49084868,314,-1,0,,0,0.00000000000000000000
chr14,49726904,49728471,1567,-1,0,,0,0.00000000000000000000
chr14,49882041,49882324,283,-1,0,,0,0.00000000000000000000
chr14,49940811,49943143,2332,-1,0,,0,0.00000000000000000000
chr14,49958178,49958908,730,-1,0,,0,0.00000000000000000000
chr14,49958435,49958589,154,-1,0,,0,0.00000000000000000000
chr14,50000947,50001076,129,-1,0,,0,0.00000000000000000000
chr14,50003037,50003606,569,-1,0,,0,0.00000000000000000000
chr14,50118870,50119065,195,-1,0,5427,1,512.82051282051300000000
chr14,50540118,50541659,1541,-1,0,,0,0.00000000000000000000
chr14,50717857,50727045,9188,-1,0,79944,1,10.88376142794950000000
chr14,50825109,50827370,2261,-1,0,8814,1,44.22821760283060000000
chr14,51090730,51091764,1034,-1,0,51062,1,96.71179883945840000000
chr14,51408907,51409542,635,-1,0,5836,1,157.48031496063000000000
chr14,51601310,51601793,483,-1,0,,0,0.00000000000000000000
chr14,51601418,51601705,287,-1,0,,0,0.00000000000000000000
chr14,52378336,52378898,562,-1,0,54331,1,177.93594306049800000000
chr14,52404136,52404671,535,-1,0,54331,1,186.91588785046700000000
chr14,52404332,52404457,125,-1,0,54331,1,800.00000000000000000000
chr14,52446805,52450299,3494,-1,0,,0,0.00000000000000000000
chr14,52594663,52594981,318,-1,0,,0,0.00000000000000000000
chr14,52756782,52757113,331,-1,0,,0,0.00000000000000000000
chr14,53026221,53031646,5425,-1,0,283554,1,18.43317972350230000000
chr14,53252465,53255092,2627,-1,0,64841,1,38.06623524933380000000
chr14,53709236,53710896,1660,-1,0,,0,0.00000000000000000000
chr14,54186083,54215536,29453,-1,0,,0,0.00000000000000000000
chr14,54316354,54317567,1213,-1,0,,0,0.00000000000000000000
chr14,54563967,54564532,565,-1,0,,0,0.00000000000000000000
chr14,54564064,54564404,340,-1,0,,0,0.00000000000000000000
chr14,54710342,54713691,3349,-1,0,,0,0.00000000000000000000
chr14,55249684,55252854,3170,-1,0,23034,1,31.54574132492110000000
chr14,55319848,55326234,6386,-1,0,2643,1,15.65925461948010000000
chr14,55328370,55330135,1765,-1,0,2643,1,56.65722379603400000000
chr14,55751166,55752032,866,-1,0,55030,1,115.47344110854500000000
chr14,56202421,56205827,3406,-1,0,,0,0.00000000000000000000
chr14,56295322,56297209,1887,-1,0,,0,0.00000000000000000000
chr14,57031139,57031608,469,-1,0,,0,0.00000000000000000000
chr14,57031208,57031527,319,-1,0,,0,0.00000000000000000000
chr14,57180147,57199035,18888,-1,0,,0,0.00000000000000000000
chr14,57509655,57510305,650,-1,0,,0,0.00000000000000000000
chr14,57566757,57572971,6214,-1,0,,0,0.00000000000000000000
chr14,58006213,58008285,2072,-1,0,,0,0.00000000000000000000
chr14,58133634,58148308,14674,-1,0,341880,1,6.81477443096634000000
chr14,58273941,58275409,1468,-1,0,341880,1,68.11989100817440000000
chr14,58322607,58325603,2996,-1,0,341880,1,33.37783711615490000000
chr14,58360490,58363700,3210,-1,0,,0,0.00000000000000000000
chr14,58401396,58405279,3883,-1,0,,0,0.00000000000000000000
chr14,58566895,58569554,2659,-1,0,145407,1,37.60812335464460000000
chr14,59040779,59042182,1403,-1,0,,0,0.00000000000000000000
chr14,59045070,59056682,11612,-1,0,,0,0.00000000000000000000
chr14,59524555,59524890,335,-1,0,,0,0.00000000000000000000
chr14,59524691,59524865,174,-1,0,,0,0.00000000000000000000
chr14,59524783,59524951,168,-1,0,,0,0.00000000000000000000
chr14,59545212,59545688,476,-1,0,,0,0.00000000000000000000
chr14,59545297,59545604,307,-1,0,,0,0.00000000000000000000
chr14,59555748,59555964,216,-1,0,,0,0.00000000000000000000
chr14,59853232,59860627,7395,-1,0,,0,0.00000000000000000000
chr14,59864224,59868391,4167,-1,0,,0,0.00000000000000000000
chr14,59883502,59884059,557,-1,0,,0,0.00000000000000000000
chr14,60143066,60144552,1486,-1,0,6252,1,67.29475100942130000000
chr14,60341397,60343243,1846,-1,0,,0,0.00000000000000000000
chr14,60624472,60625285,813,-1,0,51635,1,123.00123001230000000000
chr14,60737235,60737470,235,-1,0,5494,1,425.53191489361700000000
chr14,61009728,61057180,47452,-1,0,,0,0.00000000000000000000
chr14,61058056,61059485,1429,-1,0,,0,0.00000000000000000000
chr14,61149967,61156570,6603,-1,0,,0,0.00000000000000000000
chr14,61377717,61515210,137493,-1,0,145389;4331;57570,3,2.18192926185333000000
chr14,61655307,61655432,125,-1,0,,0,0.00000000000000000000
chr14,61830515,61850013,19498,-1,0,5583,1,5.12873115191302000000
chr14,61831850,61838334,6484,-1,0,5583,1,15.42257865515110000000
chr14,61963577,61984046,20469,-1,0,5583,1,4.88543651375250000000
chr14,62277100,62277609,509,-1,0,,0,0.00000000000000000000
chr14,62292772,62293885,1113,-1,0,,0,0.00000000000000000000
chr14,62630093,62630504,411,-1,0,,0,0.00000000000000000000
chr14,62654054,62665183,11129,-1,0,,0,0.00000000000000000000
chr14,63061275,63065844,4569,-1,0,,0,0.00000000000000000000
chr14,63621560,63621901,341,-1,0,,0,0.00000000000000000000
chr14,63629261,63629864,603,-1,0,,0,0.00000000000000000000
chr14,63721901,63725200,3299,-1,0,57381,1,30.31221582297670000000
chr14,63723569,63725816,2247,-1,0,57381,1,44.50378282153980000000
chr14,63723708,63724871,1163,-1,0,57381,1,85.98452278589850000000
chr14,63724095,63724654,559,-1,0,57381,1,178.89087656529500000000
chr14,63787178,63787519,341,-1,0,,0,0.00000000000000000000
chr14,63887382,63887946,564,-1,0,5529,1,177.30496453900700000000
chr14,63887472,63887802,330,-1,0,5529,1,303.03030303030300000000
chr14,63955215,63964492,9277,-1,0,5529,1,10.77934677158560000000
chr14,64016328,64017773,1445,-1,0,,0,0.00000000000000000000
chr14,64033752,64034163,411,-1,0,,0,0.00000000000000000000
chr14,67032150,67139739,107589,-1,0,10243,1,0.92946304919647900000
chr14,67064522,67119910,55388,-1,0,10243,1,1.80544522279194000000
chr14,66983179,67041439,58260,-1,0,10243,1,1.71644352900790000000
chr14,64598505,64612111,13606,-1,0,23224,1,7.34969866235484000000
chr14,66068940,66078003,9063,-1,0,2530,1,11.03387399315900000000
chr14,66664675,66674777,10102,-1,0,,0,0.00000000000000000000
chr14,66039242,66045960,6718,-1,0,2530,1,14.88538255433160000000
chr14,65709148,65712971,3823,-1,0,,0,0.00000000000000000000
chr14,64361086,64365547,4461,-1,0,23224,1,22.41649854292760000000
chr14,65852910,65856217,3307,-1,0,,0,0.00000000000000000000
chr14,65360330,65363567,3237,-1,0,,0,0.00000000000000000000
chr14,65533539,65535794,2255,-1,0,4149,1,44.34589800443460000000
chr14,64888461,64890613,2152,-1,0,4522,1,46.46840148698880000000
chr14,65606353,65608022,1669,-1,0,,0,0.00000000000000000000
chr14,65555560,65557333,1773,-1,0,4149,1,56.40157924421880000000
chr14,65619134,65620351,1217,-1,0,,0,0.00000000000000000000
chr14,66448927,66449727,800,-1,0,,0,0.00000000000000000000
chr14,65834932,65835401,469,-1,0,,0,0.00000000000000000000
chr14,64794001,64794371,370,-1,0,2100,1,270.27027027027000000000
chr14,65527142,65527432,290,-1,0,4149;100529261;2342,3,1034.48275862069000000000
chr14,66810628,66810941,313,-1,0,,0,0.00000000000000000000
chr14,66077907,66077966,59,-1,0,2530,1,1694.91525423729000000000
chr14,67605740,67606857,1117,-1,0,10243,1,89.52551477170990000000
chr14,67932019,67932170,151,-1,0,,0,0.00000000000000000000
chr14,67984105,67984804,699,-1,0,,0,0.00000000000000000000
chr14,68002812,68004284,1472,-1,0,57475,1,67.93478260869570000000
chr14,68129478,68130250,772,-1,0,10490,1,129.53367875647700000000
chr14,68177609,68185005,7396,-1,0,145226,1,13.52082206598160000000
chr14,68370658,68374607,3949,-1,0,5890,1,25.32286654849330000000
chr14,68377001,68377158,157,-1,0,5890,1,636.94267515923600000000
chr14,68602894,68603992,1098,-1,0,5890,1,91.07468123861570000000
chr14,68603031,68603740,709,-1,0,5890,1,141.04372355430200000000
chr14,68857912,68861863,3951,-1,0,5890,1,25.31004808909140000000
chr14,68900344,68905947,5603,-1,0,5890,1,17.84758165268610000000
chr14,68995169,68995669,500,-1,0,5890,1,200.00000000000000000000
chr14,68995384,68995458,74,-1,0,5890,1,1351.35135135135000000000
chr14,70016202,70032710,16508,-1,0,,0,0.00000000000000000000
chr14,70012178,70022879,10701,-1,0,,0,0.00000000000000000000
chr14,70016616,70023183,6567,-1,0,,0,0.00000000000000000000
chr14,70280267,70282514,2247,-1,0,,0,0.00000000000000000000
chr14,70287139,70297740,10601,-1,0,,0,0.00000000000000000000
chr14,70391546,70391899,353,-1,0,64093,1,283.28611898017000000000
chr14,70572604,70574873,2269,-1,0,6547,1,44.07227853680040000000
chr14,70682032,70689138,7106,-1,0,,0,0.00000000000000000000
chr14,70687811,70689454,1643,-1,0,,0,0.00000000000000000000
chr14,70687940,70689409,1469,-1,0,,0,0.00000000000000000000
chr14,70690041,70690284,243,-1,0,,0,0.00000000000000000000
chr14,70798453,70798559,106,-1,0,100529257;51241,2,1886.79245283019000000000
chr14,70951234,71011734,60500,-1,0,8748,1,1.65289256198347000000
chr14,71047172,71049303,2131,-1,0,,0,0.00000000000000000000
chr14,71121897,71124550,2653,-1,0,23508,1,37.69317753486620000000
chr14,71168472,71168516,44,-1,0,,0,0.00000000000000000000
chr14,71320859,71321289,430,-1,0,,0,0.00000000000000000000
chr14,71320965,71321270,305,-1,0,,0,0.00000000000000000000
chr14,71437715,71438267,552,-1,0,22990,1,181.15942028985500000000
chr14,71437827,71438168,341,-1,0,22990,1,293.25513196480900000000
chr14,71450294,71451349,1055,-1,0,22990,1,94.78672985781990000000
chr14,71535351,71535556,205,-1,0,22990,1,487.80487804878000000000
chr14,71689956,71690264,308,-1,0,,0,0.00000000000000000000
chr14,71830045,71843843,13798,-1,0,,0,0.00000000000000000000
chr14,71935605,71935932,327,-1,0,,0,0.00000000000000000000
chr14,72210437,72212321,1884,-1,0,,0,0.00000000000000000000
chr14,72490625,72491029,404,-1,0,9628,1,247.52475247524800000000
chr14,72490793,72490843,50,-1,0,9628,1,2000.00000000000000000000
chr14,72805750,72811221,5471,-1,0,9628,1,18.27819411442150000000
chr14,73063644,73064443,799,-1,0,,0,0.00000000000000000000
chr14,73332947,73333808,861,-1,0,8110,1,116.14401858304300000000
chr14,73526852,73531953,5101,-1,0,58517,1,19.60399921584000000000
chr14,73545768,73546933,1165,-1,0,58517,1,85.83690987124460000000
chr14,73551997,73552262,265,-1,0,58517,1,377.35849056603800000000
chr14,73884582,73885334,752,-1,0,8650,1,132.97872340425500000000
chr14,73895715,73900617,4902,-1,0,8650,1,20.39983680130560000000
chr14,73953732,73954082,350,-1,0,399671,1,285.71428571428600000000
chr14,74006815,74039021,32206,-1,0,641371;399671;10965,3,9.31503446562752000000
chr14,74020471,74050665,30194,-1,0,399671;10965,2,6.62383254951315000000
chr14,73998307,74027321,29014,-1,0,641371;399671,2,6.89322396084649000000
chr14,73996302,74015974,19672,-1,0,641371;399671,2,10.16673444489630000000
chr14,74027716,74040590,12874,-1,0,10965,1,7.76759359950287000000
chr14,74011070,74023998,12928,-1,0,399671,1,7.73514851485149000000
chr14,74031374,74045506,14132,-1,0,10965,1,7.07613925842061000000
chr14,73998090,74006892,8802,-1,0,641371;399671,2,22.72210861167920000000
chr14,74005378,74014640,9262,-1,0,641371;399671,2,21.59360829194560000000
chr14,74006383,74010663,4280,-1,0,641371;399671,2,46.72897196261680000000
chr14,74001048,74005448,4400,-1,0,641371;399671,2,45.45454545454550000000
chr14,74012525,74016339,3814,-1,0,399671,1,26.21919244887260000000
chr14,74001884,74003666,1782,-1,0,399671,1,56.11672278338950000000
chr14,74002504,74003207,703,-1,0,399671,1,142.24751066856300000000
chr14,74232267,74245607,13340,-1,0,91748,1,7.49625187406297000000
chr14,74239792,74246945,7153,-1,0,91748,1,13.98014818957080000000
chr14,74240149,74245681,5532,-1,0,91748,1,18.07664497469270000000
chr14,74288219,74288403,184,-1,0,,0,0.00000000000000000000
chr14,74323881,74327880,3999,-1,0,145482,1,25.00625156289070000000
chr14,74460467,74469269,8802,-1,0,957,1,11.36105430583960000000
chr14,74503702,74512291,8589,-1,0,80127,1,11.64279892886250000000
chr14,74517798,74519221,1423,-1,0,80127,1,70.27406886858750000000
chr14,74545333,74546054,721,-1,0,4329,1,138.69625520111000000000
chr14,74831816,74833431,1615,-1,0,,0,0.00000000000000000000
chr14,75103520,75116391,12871,-1,0,,0,0.00000000000000000000
chr14,75520940,75525516,4576,-1,0,97,1,21.85314685314690000000
chr14,75658931,75659370,439,-1,0,,0,0.00000000000000000000
chr14,75692588,75694432,1844,-1,0,,0,0.00000000000000000000
chr14,75698760,75700862,2102,-1,0,,0,0.00000000000000000000
chr14,75784609,75785966,1357,-1,0,,0,0.00000000000000000000
chr14,75874518,75875360,842,-1,0,,0,0.00000000000000000000
chr14,76091546,76093711,2165,-1,0,55640,1,46.18937644341800000000
chr14,76313059,76314913,1854,-1,0,23093,1,53.93743257820930000000
chr14,76390389,76392519,2130,-1,0,23093,1,46.94835680751170000000
chr14,76538139,76539539,1400,-1,0,112752,1,71.42857142857140000000
chr14,76559998,76560470,472,-1,0,,0,0.00000000000000000000
chr14,76753484,76753551,67,-1,0,,0,0.00000000000000000000
chr14,76813774,76814213,439,-1,0,,0,0.00000000000000000000
chr14,76898945,76899175,230,-1,0,2103,1,434.78260869565200000000
chr14,76997948,76999318,1370,-1,0,,0,0.00000000000000000000
chr14,77193481,77193962,481,-1,0,,0,0.00000000000000000000
chr14,77193671,77193739,68,-1,0,,0,0.00000000000000000000
chr14,77193734,77193794,60,-1,0,,0,0.00000000000000000000
chr14,77434256,77435337,1081,-1,0,,0,0.00000000000000000000
chr14,77443712,77445735,2023,-1,0,,0,0.00000000000000000000
chr14,77701679,77701969,290,-1,0,57156,1,344.82758620689700000000
chr14,77815462,77817625,2163,-1,0,283578,1,46.23208506703650000000
chr14,78124955,78125062,107,-1,0,,0,0.00000000000000000000
chr14,78207157,78211890,4733,-1,0,22938,1,21.12824846820200000000
chr14,78249925,78250393,468,-1,0,,0,0.00000000000000000000
chr14,78249904,78250243,339,-1,0,,0,0.00000000000000000000
chr14,78294082,78300551,6469,-1,0,57143,1,15.45833977430820000000
chr14,78295159,78297079,1920,-1,0,57143,1,52.08333333333330000000
chr14,78549096,78549557,461,-1,0,,0,0.00000000000000000000
chr14,78617463,78617647,184,-1,0,,0,0.00000000000000000000
chr14,78720197,78720538,341,-1,0,9369,1,293.25513196480900000000
chr14,78786815,78791727,4912,-1,0,9369,1,20.35830618892510000000
chr14,78828129,78828701,572,-1,0,9369,1,174.82517482517500000000
chr14,78828233,78828587,354,-1,0,9369,1,282.48587570621500000000
chr14,79158818,79165650,6832,-1,0,9369,1,14.63700234192040000000
chr14,79161593,79165350,3757,-1,0,9369,1,26.61698163428270000000
chr14,79347308,79349279,1971,-1,0,9369,1,50.73566717402330000000
chr14,79554297,79554917,620,-1,0,9369,1,161.29032258064500000000
chr14,79653751,79654219,468,-1,0,9369,1,213.67521367521400000000
chr14,79653925,79654041,116,-1,0,9369,1,862.06896551724100000000
chr14,79747360,79747992,632,-1,0,9369,1,158.22784810126600000000
chr14,79807109,79814780,7671,-1,0,9369,1,13.03611002476860000000
chr14,79981215,79981988,773,-1,0,9369,1,129.36610608020700000000
chr14,80070810,80072110,1300,-1,0,9369,1,76.92307692307690000000
chr14,80104364,80124480,20116,-1,0,9369,1,4.97116723006562000000
chr14,80106270,80115058,8788,-1,0,9369,1,11.37915339098770000000
chr14,80098982,80099861,879,-1,0,9369,1,113.76564277588200000000
chr14,80225357,80230517,5160,-1,0,9369,1,19.37984496124030000000
chr14,80286102,80287508,1406,-1,0,9369,1,71.12375533428170000000
chr14,80312048,80312138,90,-1,0,9369,1,1111.11111111111000000000
chr14,80481240,80481692,452,-1,0,,0,0.00000000000000000000
chr14,80556743,80562604,5861,-1,0,,0,0.00000000000000000000
chr14,80644678,80654916,10238,-1,0,,0,0.00000000000000000000
chr14,80823281,80826357,3076,-1,0,,0,0.00000000000000000000
chr14,80884165,80884215,50,-1,0,,0,0.00000000000000000000
chr14,80951105,80952030,925,-1,0,,0,0.00000000000000000000
chr14,81334776,81342021,7245,-1,0,145508,1,13.80262249827470000000
chr14,81469010,81469535,525,-1,0,7253,1,190.47619047619000000000
chr14,81469130,81469418,288,-1,0,7253,1,347.22222222222200000000
chr14,81597031,81597413,382,-1,0,7253,1,261.78010471204200000000
chr14,81775167,81775285,118,-1,0,85439,1,847.45762711864400000000
chr14,81878163,81880584,2421,-1,0,85439,1,41.30524576621230000000
chr14,81922479,81924636,2157,-1,0,,0,0.00000000000000000000
chr14,82457391,82497655,40264,-1,0,,0,0.00000000000000000000
chr14,82499042,82503913,4871,-1,0,,0,0.00000000000000000000
chr14,83203928,83206861,2933,-1,0,,0,0.00000000000000000000
chr14,82995487,82997463,1976,-1,0,,0,0.00000000000000000000
chr14,83154521,83155462,941,-1,0,,0,0.00000000000000000000
chr14,83019511,83019982,471,-1,0,,0,0.00000000000000000000
chr14,83019598,83019885,287,-1,0,,0,0.00000000000000000000
chr14,83337360,83339212,1852,-1,0,,0,0.00000000000000000000
chr14,83352124,83352406,282,-1,0,,0,0.00000000000000000000
chr14,83386735,83386899,164,-1,0,,0,0.00000000000000000000
chr14,83427265,83437065,9800,-1,0,,0,0.00000000000000000000
chr14,83435003,83437281,2278,-1,0,,0,0.00000000000000000000
chr14,83635432,83637028,1596,-1,0,,0,0.00000000000000000000
chr14,83635842,83636518,676,-1,0,,0,0.00000000000000000000
chr14,83652278,83740370,88092,-1,0,,0,0.00000000000000000000
chr14,83798735,83799703,968,-1,0,,0,0.00000000000000000000
chr14,83852036,83852359,323,-1,0,,0,0.00000000000000000000
chr14,83900401,83900497,96,-1,0,,0,0.00000000000000000000
chr14,84042910,84050242,7332,-1,0,,0,0.00000000000000000000
chr14,84119969,84122145,2176,-1,0,,0,0.00000000000000000000
chr14,84168183,84172391,4208,-1,0,,0,0.00000000000000000000
chr14,84241779,84250809,9030,-1,0,,0,0.00000000000000000000
chr14,84370307,84371373,1066,-1,0,,0,0.00000000000000000000
chr14,84407213,84409856,2643,-1,0,,0,0.00000000000000000000
chr14,84433921,84441076,7155,-1,0,,0,0.00000000000000000000
chr14,84605669,84605879,210,-1,0,,0,0.00000000000000000000
chr14,85062257,85062945,688,-1,0,,0,0.00000000000000000000
chr14,85139128,85139627,499,-1,0,,0,0.00000000000000000000
chr14,85153957,85154337,380,-1,0,,0,0.00000000000000000000
chr14,85139248,85139622,374,-1,0,,0,0.00000000000000000000
chr14,85154054,85154290,236,-1,0,,0,0.00000000000000000000
chr14,85296695,85303080,6385,-1,0,,0,0.00000000000000000000
chr14,85297064,85302127,5063,-1,0,,0,0.00000000000000000000
chr14,85332785,85716093,383308,-1,0,,0,0.00000000000000000000
chr14,85359969,85365012,5043,-1,0,,0,0.00000000000000000000
chr14,85404189,85407111,2922,-1,0,,0,0.00000000000000000000
chr14,85886959,85893669,6710,-1,0,,0,0.00000000000000000000
chr14,86130515,86132163,1648,-1,0,,0,0.00000000000000000000
chr14,86195335,86362545,167210,-1,0,,0,0.00000000000000000000
chr14,86285288,86318478,33190,-1,0,,0,0.00000000000000000000
chr14,86282213,86309997,27784,-1,0,,0,0.00000000000000000000
chr14,86201034,86204896,3862,-1,0,,0,0.00000000000000000000
chr14,86342834,86343156,322,-1,0,,0,0.00000000000000000000
chr14,86314184,86314425,241,-1,0,,0,0.00000000000000000000
chr14,86193010,86193073,63,-1,0,,0,0.00000000000000000000
chr14,86457775,86492601,34826,-1,0,,0,0.00000000000000000000
chr14,86467240,86486411,19171,-1,0,,0,0.00000000000000000000
chr14,86544482,86574322,29840,-1,0,,0,0.00000000000000000000
chr14,86630873,86633035,2162,-1,0,,0,0.00000000000000000000
chr14,86753376,86753551,175,-1,0,,0,0.00000000000000000000
chr14,86886086,86972337,86251,-1,0,,0,0.00000000000000000000
chr14,87052894,87054467,1573,-1,0,,0,0.00000000000000000000
chr14,87309019,87349925,40906,-1,0,,0,0.00000000000000000000
chr14,87410157,87410482,325,-1,0,,0,0.00000000000000000000
chr14,87453472,87463086,9614,-1,0,,0,0.00000000000000000000
chr14,87600472,87600915,443,-1,0,,0,0.00000000000000000000
chr14,87663534,87667841,4307,-1,0,,0,0.00000000000000000000
chr14,87857958,87858482,524,-1,0,,0,0.00000000000000000000
chr14,87858062,87858390,328,-1,0,,0,0.00000000000000000000
chr14,87962188,88393132,430944,-1,0,,0,0.00000000000000000000
chr14,88391510,88423411,31901,-1,0,2581,1,3.13469797185041000000
chr14,88400174,88415076,14902,-1,0,2581,1,6.71050865655617000000
chr14,88058687,88058851,164,-1,0,,0,0.00000000000000000000
chr14,88390604,88390685,81,-1,0,,0,0.00000000000000000000
chr14,88568083,88568233,150,-1,0,,0,0.00000000000000000000
chr14,88889535,88890685,1150,-1,0,55812,1,86.95652173913040000000
chr14,88889893,88890367,474,-1,0,55812,1,210.97046413502100000000
chr14,88890012,88890197,185,-1,0,55812,1,540.54054054054100000000
chr14,89345333,89358962,13629,-1,0,,0,0.00000000000000000000
chr14,89408826,89409115,289,-1,0,,0,0.00000000000000000000
chr14,89640338,89642396,2058,-1,0,1112,1,48.59086491739550000000
chr14,89827116,89829348,2232,-1,0,1112,1,44.80286738351250000000
chr14,89927446,89938305,10859,-1,0,1112,1,9.20895110046966000000
chr14,90142191,90147437,5246,-1,0,,0,0.00000000000000000000
chr14,90415817,90417467,1650,-1,0,90141,1,60.60606060606060000000
chr14,90720338,90721874,1536,-1,0,,0,0.00000000000000000000
chr14,90876462,90877276,814,-1,0,,0,0.00000000000000000000
chr14,90900390,90901694,1304,-1,0,,0,0.00000000000000000000
chr14,90991731,90992338,607,-1,0,,0,0.00000000000000000000
chr14,91039789,91039914,125,-1,0,145567,1,800.00000000000000000000
chr14,91256208,91267158,10950,-1,0,145567,1,9.13242009132420000000
chr14,91759350,91760126,776,-1,0,440193,1,128.86597938144300000000
chr14,92668203,92670990,2787,-1,0,,0,0.00000000000000000000
chr14,92800185,92802543,2358,-1,0,123041,1,42.40882103477520000000
chr14,92866597,92869777,3180,-1,0,123041,1,31.44654088050310000000
chr14,92954661,92955152,491,-1,0,123041,1,203.66598778004100000000
chr14,92954885,92955044,159,-1,0,123041,1,628.93081761006300000000
chr14,93317277,93318960,1683,-1,0,,0,0.00000000000000000000
chr14,93443903,93445172,1269,-1,0,3705,1,78.80220646178090000000
chr14,93523892,93526042,2150,-1,0,3705,1,46.51162790697670000000
chr14,93581439,93582728,1289,-1,0,3705,1,77.57951900698220000000
chr14,93621928,93626795,4867,-1,0,,0,0.00000000000000000000
chr14,93611976,93613348,1372,-1,0,,0,0.00000000000000000000
chr14,93696881,93697642,761,-1,0,,0,0.00000000000000000000
chr14,93712558,93713136,578,-1,0,55727,1,173.01038062283700000000
chr14,93884151,93888743,4592,-1,0,57578,1,21.77700348432060000000
chr14,94188415,94188711,296,-1,0,145270,1,337.83783783783800000000
chr14,94235338,94235394,56,-1,0,145270,1,1785.71428571429000000000
chr14,94347863,94351265,3402,-1,0,,0,0.00000000000000000000
chr14,94360247,94360687,440,-1,0,,0,0.00000000000000000000
chr14,94360432,94360485,53,-1,0,,0,0.00000000000000000000
chr14,94638737,94639883,1146,-1,0,,0,0.00000000000000000000
chr14,95404790,95405189,399,-1,0,,0,0.00000000000000000000
chr14,95416346,95421093,4747,-1,0,,0,0.00000000000000000000
chr14,95415673,95418859,3186,-1,0,,0,0.00000000000000000000
chr14,95796192,95796975,783,-1,0,,0,0.00000000000000000000
chr14,95832719,95832778,59,-1,0,,0,0.00000000000000000000
chr14,95841308,95841633,325,-1,0,,0,0.00000000000000000000
chr14,95889792,95890054,262,-1,0,161176,1,381.67938931297700000000
chr14,96080304,96082643,2339,-1,0,,0,0.00000000000000000000
chr14,96081199,96082494,1295,-1,0,,0,0.00000000000000000000
chr14,96132485,96143476,10991,-1,0,,0,0.00000000000000000000
chr14,96253738,96254169,431,-1,0,,0,0.00000000000000000000
chr14,96393900,96394379,479,-1,0,,0,0.00000000000000000000
chr14,96394051,96394295,244,-1,0,,0,0.00000000000000000000
chr14,96527316,96535690,8374,-1,0,56967,1,11.94172438500120000000
chr14,96581537,96581876,339,-1,0,,0,0.00000000000000000000
chr14,96831189,96832694,1505,-1,0,51527,1,66.44518272425250000000
chr14,97174367,97176062,1695,-1,0,,0,0.00000000000000000000
chr14,97175241,97175544,303,-1,0,,0,0.00000000000000000000
chr14,97175224,97175398,174,-1,0,,0,0.00000000000000000000
chr14,97212830,97212900,70,-1,0,,0,0.00000000000000000000
chr14,97212047,97212121,74,-1,0,,0,0.00000000000000000000
chr14,97212862,97212923,61,-1,0,,0,0.00000000000000000000
chr14,97352874,97363750,10876,-1,0,,0,0.00000000000000000000
chr14,97390100,97390357,257,-1,0,,0,0.00000000000000000000
chr14,97803715,97804452,737,-1,0,,0,0.00000000000000000000
chr14,98024388,98025661,1273,-1,0,,0,0.00000000000000000000
chr14,98129900,98142515,12615,-1,0,,0,0.00000000000000000000
chr14,98153059,98156205,3146,-1,0,,0,0.00000000000000000000
chr14,98220964,98222992,2028,-1,0,,0,0.00000000000000000000
chr14,98744592,98745603,1011,-1,0,,0,0.00000000000000000000
chr14,98774515,98774846,331,-1,0,,0,0.00000000000000000000
chr14,98783968,98785085,1117,-1,0,,0,0.00000000000000000000
chr14,98800952,98808502,7550,-1,0,,0,0.00000000000000000000
chr14,99034574,99057372,22798,-1,0,,0,0.00000000000000000000
chr14,98956671,98958719,2048,-1,0,,0,0.00000000000000000000
chr14,98997755,98998113,358,-1,0,,0,0.00000000000000000000
chr14,99177708,99195094,17386,-1,0,283598,1,5.75175428505694000000
chr14,99503185,99505472,2287,-1,0,,0,0.00000000000000000000
chr14,99504214,99506233,2019,-1,0,,0,0.00000000000000000000
chr14,99503961,99505365,1404,-1,0,,0,0.00000000000000000000
chr14,99572327,99580033,7706,-1,0,,0,0.00000000000000000000
chr14,99637645,99642792,5147,-1,0,64919,1,19.42879347192540000000
chr14,99640536,99642292,1756,-1,0,64919,1,56.94760820045560000000
chr14,100069135,100070724,1589,-1,0,317762,1,62.93266205160480000000
chr14,100069493,100070925,1432,-1,0,317762;84439,2,139.66480446927400000000
chr14,100277581,100279014,1433,-1,0,2009,1,69.78367062107470000000
chr14,100427291,100429871,2580,-1,0,,0,0.00000000000000000000
chr14,100428227,100429238,1011,-1,0,,0,0.00000000000000000000
chr14,100704466,100707396,2930,-1,0,7528,1,34.12969283276450000000
chr14,100844912,100845419,507,-1,0,79446,1,197.23865877712000000000
chr14,100844997,100845330,333,-1,0,79446,1,300.30030030030000000000
chr14,101144235,101152157,7922,-1,0,,0,0.00000000000000000000
chr14,101148210,101152852,4642,-1,0,,0,0.00000000000000000000
chr14,101110281,101110808,527,-1,0,,0,0.00000000000000000000
chr14,101012653,101012784,131,-1,0,57596,1,763.35877862595400000000
chr14,101172121,101172524,403,-1,0,,0,0.00000000000000000000
chr14,101335329,101337500,2171,-1,0,,0,0.00000000000000000000
chr14,101486318,101487462,1144,-1,0,,0,0.00000000000000000000
chr14,101504427,101505030,603,-1,0,,0,0.00000000000000000000
chr14,101662686,101663175,489,-1,0,,0,0.00000000000000000000
chr14,101662918,101662992,74,-1,0,,0,0.00000000000000000000
chr14,101662863,101662918,55,-1,0,,0,0.00000000000000000000
chr14,101923778,101925983,2205,-1,0,,0,0.00000000000000000000
chr14,101990798,101991308,510,-1,0,,0,0.00000000000000000000
chr14,102026707,102027542,835,-1,0,,0,0.00000000000000000000
chr14,102074008,102074203,195,-1,0,,0,0.00000000000000000000
chr14,102164397,102183271,18874,-1,0,,0,0.00000000000000000000
chr14,102182827,102197594,14767,-1,0,,0,0.00000000000000000000
chr14,102174210,102179523,5313,-1,0,,0,0.00000000000000000000
chr14,102247701,102250000,2299,-1,0,5527,1,43.49717268377560000000
chr14,102390141,102390264,123,-1,0,5527,1,813.00813008130100000000
chr14,102573014,102575088,2074,-1,0,3320,1,48.21600771456120000000
chr14,102622368,102630539,8171,-1,0,91833,1,12.23840411210380000000
chr14,102637484,102639701,2217,-1,0,91833,1,45.10599909788000000000
chr14,102638534,102639239,705,-1,0,91833,1,141.84397163120600000000
chr14,102644471,102646241,1770,-1,0,91833,1,56.49717514124290000000
chr14,102758583,102760622,2039,-1,0,5891,1,49.04364884747430000000
chr14,102876606,102878067,1461,-1,0,9895,1,68.44626967830250000000
chr14,102950250,102951164,914,-1,0,9895,1,109.40919037199100000000
chr14,103002234,103003524,1290,-1,0,,0,0.00000000000000000000
chr14,103020355,103020778,423,-1,0,,0,0.00000000000000000000
chr14,103159617,103160084,467,-1,0,23186,1,214.13276231263400000000
chr14,103197674,103204150,6476,-1,0,,0,0.00000000000000000000
chr14,103243211,103244549,1338,-1,0,7187,1,74.73841554559040000000
chr14,106327524,106890854,563330,-1,0,,0,0.00000000000000000000
chr14,106661277,107130698,469421,-1,0,,0,0.00000000000000000000
chr14,106329936,106815179,485243,-1,0,,0,0.00000000000000000000
chr14,106146057,106521232,375175,-1,0,,0,0.00000000000000000000
chr14,106806849,107227339,420490,-1,0,,0,0.00000000000000000000
chr14,106476175,106781633,305458,-1,0,,0,0.00000000000000000000
chr14,106084579,106326970,242391,-1,0,,0,0.00000000000000000000
chr14,106944341,107160087,215746,-1,0,,0,0.00000000000000000000
chr14,106650811,106846916,196105,-1,0,,0,0.00000000000000000000
chr14,106827023,107059822,232799,-1,0,,0,0.00000000000000000000
chr14,106372545,106594197,221652,-1,0,,0,0.00000000000000000000
chr14,106484294,106716840,232546,-1,0,,0,0.00000000000000000000
chr14,106017315,106204008,186693,-1,0,,0,0.00000000000000000000
chr14,106771908,106921388,149480,-1,0,,0,0.00000000000000000000
chr14,106361633,106515068,153435,-1,0,,0,0.00000000000000000000
chr14,106633596,106767735,134139,-1,0,,0,0.00000000000000000000
chr14,106963971,107081875,117904,-1,0,,0,0.00000000000000000000
chr14,106086899,106231160,144261,-1,0,,0,0.00000000000000000000
chr14,106209958,106355510,145552,-1,0,,0,0.00000000000000000000
chr14,106535767,106666803,131036,-1,0,,0,0.00000000000000000000
chr14,107067569,107170215,102646,-1,0,,0,0.00000000000000000000
chr14,106814648,106929059,114411,-1,0,,0,0.00000000000000000000
chr14,106726147,106841358,115211,-1,0,,0,0.00000000000000000000
chr14,106135365,106237344,101979,-1,0,,0,0.00000000000000000000
chr14,106486071,106595327,109256,-1,0,,0,0.00000000000000000000
chr14,106619541,106715869,96328,-1,0,,0,0.00000000000000000000
chr14,106046565,106164476,117911,-1,0,,0,0.00000000000000000000
chr14,107013284,107127106,113822,-1,0,,0,0.00000000000000000000
chr14,106350495,106443239,92744,-1,0,,0,0.00000000000000000000
chr14,106224848,106300666,75818,-1,0,,0,0.00000000000000000000
chr14,106686394,106777815,91421,-1,0,,0,0.00000000000000000000
chr14,106121997,106218139,96142,-1,0,,0,0.00000000000000000000
chr14,106867967,106944138,76171,-1,0,,0,0.00000000000000000000
chr14,106786639,106862715,76076,-1,0,,0,0.00000000000000000000
chr14,106424144,106495967,71823,-1,0,,0,0.00000000000000000000
chr14,106082305,106161597,79292,-1,0,,0,0.00000000000000000000
chr14,107070371,107155322,84951,-1,0,,0,0.00000000000000000000
chr14,106499828,106586319,86491,-1,0,,0,0.00000000000000000000
chr14,107032302,107113939,81637,-1,0,,0,0.00000000000000000000
chr14,106252899,106325116,72217,-1,0,,0,0.00000000000000000000
chr14,106018990,106081793,62803,-1,0,,0,0.00000000000000000000
chr14,103533901,103602300,68399,-1,0,91828;7127;107984640,3,4.38602903551222000000
chr14,106176799,106239549,62750,-1,0,,0,0.00000000000000000000
chr14,106867716,106919461,51745,-1,0,,0,0.00000000000000000000
chr14,106581445,106630772,49327,-1,0,,0,0.00000000000000000000
chr14,106519459,106564117,44658,-1,0,,0,0.00000000000000000000
chr14,106667115,106728149,61034,-1,0,,0,0.00000000000000000000
chr14,106330067,106376154,46087,-1,0,,0,0.00000000000000000000
chr14,106445184,106495906,50722,-1,0,,0,0.00000000000000000000
chr14,106086442,106130041,43599,-1,0,,0,0.00000000000000000000
chr14,106728898,106783550,54652,-1,0,,0,0.00000000000000000000
chr14,106239777,106286546,46769,-1,0,,0,0.00000000000000000000
chr14,106891010,106929950,38940,-1,0,,0,0.00000000000000000000
chr14,106176216,106212056,35840,-1,0,,0,0.00000000000000000000
chr14,106783479,106826308,42829,-1,0,,0,0.00000000000000000000
chr14,107149090,107179196,30106,-1,0,,0,0.00000000000000000000
chr14,105310001,105355600,45599,-1,0,283638,1,2.19303054891555000000
chr14,106646029,106688193,42164,-1,0,,0,0.00000000000000000000
chr14,106154001,106192277,38276,-1,0,,0,0.00000000000000000000
chr14,107245651,107287489,41838,-1,0,,0,0.00000000000000000000
chr14,104546401,104587200,40799,-1,0,374569,1,2.45104046667810000000
chr14,106330376,106357294,26918,-1,0,,0,0.00000000000000000000
chr14,106530689,106568954,38265,-1,0,,0,0.00000000000000000000
chr14,103983333,104018873,35540,-1,0,115708;1152,2,5.62746201463140000000
chr14,106885126,106918819,33693,-1,0,,0,0.00000000000000000000
chr14,107102592,107128942,26350,-1,0,,0,0.00000000000000000000
chr14,107184271,107215112,30841,-1,0,,0,0.00000000000000000000
chr14,106362275,106385172,22897,-1,0,,0,0.00000000000000000000
chr14,106822445,106855292,32847,-1,0,,0,0.00000000000000000000
chr14,106752745,106783092,30347,-1,0,,0,0.00000000000000000000
chr14,107005018,107033738,28720,-1,0,,0,0.00000000000000000000
chr14,106198861,106228146,29285,-1,0,,0,0.00000000000000000000
chr14,106890850,106918453,27603,-1,0,,0,0.00000000000000000000
chr14,106352373,106377107,24734,-1,0,,0,0.00000000000000000000
chr14,106118172,106145752,27580,-1,0,,0,0.00000000000000000000
chr14,106079392,106099606,20214,-1,0,,0,0.00000000000000000000
chr14,106781979,106806719,24740,-1,0,,0,0.00000000000000000000
chr14,106799880,106824648,24768,-1,0,,0,0.00000000000000000000
chr14,106483725,106508484,24759,-1,0,,0,0.00000000000000000000
chr14,107157566,107177240,19674,-1,0,,0,0.00000000000000000000
chr14,106905478,106927019,21541,-1,0,,0,0.00000000000000000000
chr14,106889965,106909869,19904,-1,0,,0,0.00000000000000000000
chr14,106549766,106561624,11858,-1,0,,0,0.00000000000000000000
chr14,106084509,106105079,20570,-1,0,,0,0.00000000000000000000
chr14,106794107,106812316,18209,-1,0,,0,0.00000000000000000000
chr14,107148134,107165872,17738,-1,0,,0,0.00000000000000000000
chr14,106331600,106346915,15315,-1,0,,0,0.00000000000000000000
chr14,106096035,106114571,18536,-1,0,,0,0.00000000000000000000
chr14,106346079,106362230,16151,-1,0,,0,0.00000000000000000000
chr14,107166639,107181395,14756,-1,0,,0,0.00000000000000000000
chr14,104264316,104276615,12299,-1,0,23368,1,8.13074233677535000000
chr14,106810043,106826216,16173,-1,0,,0,0.00000000000000000000
chr14,106901897,106916307,14410,-1,0,,0,0.00000000000000000000
chr14,106362079,106375987,13908,-1,0,,0,0.00000000000000000000
chr14,106179957,106195131,15174,-1,0,,0,0.00000000000000000000
chr14,106395897,106410918,15021,-1,0,,0,0.00000000000000000000
chr14,106791561,106805215,13654,-1,0,,0,0.00000000000000000000
chr14,107085031,107095783,10752,-1,0,,0,0.00000000000000000000
chr14,103854874,103869018,14144,-1,0,4140,1,7.07013574660634000000
chr14,105011438,105025462,14024,-1,0,,0,0.00000000000000000000
chr14,106473078,106483448,10370,-1,0,,0,0.00000000000000000000
chr14,106801606,106811367,9761,-1,0,,0,0.00000000000000000000
chr14,106716201,106727912,11711,-1,0,,0,0.00000000000000000000
chr14,105407011,105420097,13086,-1,0,113146,1,7.64175454684395000000
chr14,105695660,105707556,11896,-1,0,2972,1,8.40618695359785000000
chr14,107125339,107137490,12151,-1,0,,0,0.00000000000000000000
chr14,107159276,107169882,10606,-1,0,,0,0.00000000000000000000
chr14,106867165,106875300,8135,-1,0,,0,0.00000000000000000000
chr14,107172848,107183396,10548,-1,0,,0,0.00000000000000000000
chr14,106372852,106382440,9588,-1,0,,0,0.00000000000000000000
chr14,106354567,106363794,9227,-1,0,,0,0.00000000000000000000
chr14,106360165,106369143,8978,-1,0,,0,0.00000000000000000000
chr14,106807876,106816694,8818,-1,0,,0,0.00000000000000000000
chr14,103728152,103736972,8820,-1,0,,0,0.00000000000000000000
chr14,107166462,107173910,7448,-1,0,,0,0.00000000000000000000
chr14,107152761,107160239,7478,-1,0,,0,0.00000000000000000000
chr14,105269778,105275090,5312,-1,0,100128927,1,18.82530120481930000000
chr14,105412735,105419049,6314,-1,0,113146,1,15.83782071586950000000
chr14,106722326,106728104,5778,-1,0,,0,0.00000000000000000000
chr14,103659306,103664606,5300,-1,0,,0,0.00000000000000000000
chr14,106801137,106806345,5208,-1,0,,0,0.00000000000000000000
chr14,106327696,106331938,4242,-1,0,,0,0.00000000000000000000
chr14,106180543,106184672,4129,-1,0,,0,0.00000000000000000000
chr14,106324309,106327635,3326,-1,0,,0,0.00000000000000000000
chr14,106370298,106373348,3050,-1,0,,0,0.00000000000000000000
chr14,103546583,103549944,3361,-1,0,,0,0.00000000000000000000
chr14,105576567,105579668,3101,-1,0,,0,0.00000000000000000000
chr14,105273886,105277062,3176,-1,0,,0,0.00000000000000000000
chr14,105092275,105095361,3086,-1,0,,0,0.00000000000000000000
chr14,105415189,105417968,2779,-1,0,113146,1,35.98416696653470000000
chr14,103648841,103651699,2858,-1,0,,0,0.00000000000000000000
chr14,104312355,104315015,2660,-1,0,23368,1,37.59398496240600000000
chr14,105371455,105373523,2068,-1,0,,0,0.00000000000000000000
chr14,106330693,106332795,2102,-1,0,,0,0.00000000000000000000
chr14,106449025,106450848,1823,-1,0,,0,0.00000000000000000000
chr14,105633519,105635789,2270,-1,0,3714,1,44.05286343612340000000
chr14,106211015,106212729,1714,-1,0,,0,0.00000000000000000000
chr14,104136739,104137888,1149,-1,0,3831,1,87.03220191470840000000
chr14,106204553,106206315,1762,-1,0,,0,0.00000000000000000000
chr14,103988029,103989824,1795,-1,0,1152,1,55.71030640668520000000
chr14,107173825,107175176,1351,-1,0,,0,0.00000000000000000000
chr14,104075999,104077522,1523,-1,0,,0,0.00000000000000000000
chr14,105273887,105274987,1100,-1,0,,0,0.00000000000000000000
chr14,104896095,104897845,1750,-1,0,,0,0.00000000000000000000
chr14,103575187,103576731,1544,-1,0,91828,1,64.76683937823830000000
chr14,104717134,104718386,1252,-1,0,,0,0.00000000000000000000
chr14,105350148,105351688,1540,-1,0,283638,1,64.93506493506490000000
chr14,106232600,106233965,1365,-1,0,,0,0.00000000000000000000
chr14,105415798,105417210,1412,-1,0,113146,1,70.82152974504250000000
chr14,105417022,105418384,1362,-1,0,113146,1,73.42143906020560000000
chr14,106325193,106326577,1384,-1,0,,0,0.00000000000000000000
chr14,105506301,105507053,752,-1,0,,0,0.00000000000000000000
chr14,107134529,107135786,1257,-1,0,,0,0.00000000000000000000
chr14,105331121,105332456,1335,-1,0,283638,1,74.90636704119850000000
chr14,105780623,105781644,1021,-1,0,2972;23241,2,195.88638589618000000000
chr14,105940481,105941616,1135,-1,0,1397,1,88.10572687224670000000
chr14,106789146,106790040,894,-1,0,,0,0.00000000000000000000
chr14,106204676,106205550,874,-1,0,,0,0.00000000000000000000
chr14,106184298,106185204,906,-1,0,,0,0.00000000000000000000
chr14,106094135,106094985,850,-1,0,,0,0.00000000000000000000
chr14,105273963,105274779,816,-1,0,,0,0.00000000000000000000
chr14,103575564,103576043,479,-1,0,91828,1,208.76826722338200000000
chr14,105987027,105987772,745,-1,0,,0,0.00000000000000000000
chr14,104717219,104717878,659,-1,0,,0,0.00000000000000000000
chr14,104938142,104938627,485,-1,0,,0,0.00000000000000000000
chr14,106880153,106880659,506,-1,0,,0,0.00000000000000000000
chr14,107174135,107174817,682,-1,0,,0,0.00000000000000000000
chr14,106083877,106084352,475,-1,0,,0,0.00000000000000000000
chr14,107088127,107088779,652,-1,0,,0,0.00000000000000000000
chr14,104765189,104765683,494,-1,0,,0,0.00000000000000000000
chr14,106330194,106330799,605,-1,0,,0,0.00000000000000000000
chr14,106479959,106480549,590,-1,0,,0,0.00000000000000000000
chr14,105416061,105416636,575,-1,0,113146,1,173.91304347826100000000
chr14,104791375,104791938,563,-1,0,,0,0.00000000000000000000
chr14,105738151,105738666,515,-1,0,2972,1,194.17475728155300000000
chr14,104841497,104842004,507,-1,0,,0,0.00000000000000000000
chr14,105371483,105371949,466,-1,0,,0,0.00000000000000000000
chr14,107174390,107174930,540,-1,0,,0,0.00000000000000000000
chr14,105742106,105742625,519,-1,0,2972,1,192.67822736030800000000
chr14,104674618,104674923,305,-1,0,,0,0.00000000000000000000
chr14,104631474,104631972,498,-1,0,26153,1,200.80321285140600000000
chr14,105292966,105293461,495,-1,0,,0,0.00000000000000000000
chr14,104691577,104691952,375,-1,0,,0,0.00000000000000000000
chr14,103598151,103598564,413,-1,0,7127,1,242.13075060532700000000
chr14,104541957,104542350,393,-1,0,,0,0.00000000000000000000
chr14,106055901,106056119,218,-1,0,,0,0.00000000000000000000
chr14,104691706,104692013,307,-1,0,,0,0.00000000000000000000
chr14,104755600,104755959,359,-1,0,,0,0.00000000000000000000
chr14,103583530,103583824,294,-1,0,,0,0.00000000000000000000
chr14,105293195,105293425,230,-1,0,,0,0.00000000000000000000
chr14,106047383,106047626,243,-1,0,,0,0.00000000000000000000
chr14,104896937,104897157,220,-1,0,,0,0.00000000000000000000
chr14,104992523,104992752,229,-1,0,,0,0.00000000000000000000
chr14,104841612,104841849,237,-1,0,,0,0.00000000000000000000
chr14,105186753,105186925,172,-1,0,,0,0.00000000000000000000
chr14,103838462,103838651,189,-1,0,,0,0.00000000000000000000
chr14,105293174,105293360,186,-1,0,,0,0.00000000000000000000
chr14,104465980,104466116,136,-1,0,122402,1,735.29411764705900000000
chr14,107023151,107023278,127,-1,0,,0,0.00000000000000000000
chr14,106415130,106415231,101,-1,0,,0,0.00000000000000000000
chr14,103764021,103764125,104,-1,0,,0,0.00000000000000000000
chr14,106102188,106102263,75,-1,0,,0,0.00000000000000000000
chr14,106323457,106323521,64,-1,0,,0,0.00000000000000000000
chr14,103598330,103598390,60,-1,0,7127,1,1666.66666666667000000000
chr14,106986869,106986929,60,-1,0,,0,0.00000000000000000000
chr15,20025573,20033598,8025,-1,0,,0,0.00000000000000000000
chr15,20031750,20039234,7484,-1,0,,0,0.00000000000000000000
chr15,20005892,20012540,6648,-1,0,,0,0.00000000000000000000
chr15,20021867,20024519,2652,-1,0,,0,0.00000000000000000000
chr15,20001309,20001868,559,-1,0,,0,0.00000000000000000000
chr15,20230244,22699752,2469508,-1,0,283694;727832;100287399;390538;100996331,5,0.20246947975062200000
chr15,20434992,22121718,1686726,-1,0,100996331;727832;100287399,3,0.17785935593570000000
chr15,21268690,22602911,1334221,-1,0,390538;283694;100996331,3,0.22485030590884100000
chr15,22556487,23520645,964158,-1,0,123606;114791;81614;23191;283767,5,0.51858720251245100000
chr15,21012347,21898584,886237,-1,0,100287399,1,0.11283663399293900000
chr15,22299434,23102295,802861,-1,0,123606;283694;114791;81614;390538;23191;283767,7,0.87188193223982700000
chr15,20217620,20959301,741681,-1,0,727832,1,0.13482885499291500000
chr15,20746938,21288809,541871,-1,0,727832;100287399,2,0.36909153654652100000
chr15,22758088,23148966,390878,-1,0,123606;23191;114791;81614,4,1.02333720495909000000
chr15,20243622,20580773,337151,-1,0,,0,0.00000000000000000000
chr15,20501583,20820459,318876,-1,0,727832,1,0.31360152535781900000
chr15,22301244,22655486,354242,-1,0,390538;283694,2,0.56458579163396800000
chr15,20587712,20854130,266418,-1,0,727832,1,0.37535001388795100000
chr15,20439228,20652624,213396,-1,0,,0,0.00000000000000000000
chr15,22310906,22526036,215130,-1,0,390538;283694,2,0.92967043183191600000
chr15,22403679,22594359,190680,-1,0,,0,0.00000000000000000000
chr15,20835037,21046693,211656,-1,0,100287399,1,0.47246475412934200000
chr15,20238167,20442549,204382,-1,0,,0,0.00000000000000000000
chr15,20555876,20733378,177502,-1,0,,0,0.00000000000000000000
chr15,20402412,20580139,177727,-1,0,,0,0.00000000000000000000
chr15,22284177,22449225,165048,-1,0,390538;283694,2,1.21176869759100000000
chr15,20134530,20270837,136307,-1,0,,0,0.00000000000000000000
chr15,21937176,22115280,178104,-1,0,100996331,1,0.56146970309482100000
chr15,21146899,21297218,150319,-1,0,,0,0.00000000000000000000
chr15,20412769,20527832,115063,-1,0,,0,0.00000000000000000000
chr15,20516226,20629733,113507,-1,0,,0,0.00000000000000000000
chr15,22434345,22556732,122387,-1,0,,0,0.00000000000000000000
chr15,21076846,21199763,122917,-1,0,,0,0.00000000000000000000
chr15,21999569,22112047,112478,-1,0,100996331,1,0.88906275004889800000
chr15,22290332,22372828,82496,-1,0,390538,1,1.21217998448410000000
chr15,20211082,20311249,100167,-1,0,,0,0.00000000000000000000
chr15,22372307,22480520,108213,-1,0,283694,1,0.92410338868712600000
chr15,22494690,22571270,76580,-1,0,,0,0.00000000000000000000
chr15,20502974,20581942,78968,-1,0,,0,0.00000000000000000000
chr15,20120480,20210842,90362,-1,0,,0,0.00000000000000000000
chr15,22649686,22723998,74312,-1,0,,0,0.00000000000000000000
chr15,22979131,23066585,87454,-1,0,123606;23191;81614,3,3.43037482562261000000
chr15,20561529,20640875,79346,-1,0,,0,0.00000000000000000000
chr15,22063149,22117373,54224,-1,0,100996331,1,1.84420182944821000000
chr15,21159054,21241912,82858,-1,0,,0,0.00000000000000000000
chr15,22263917,22340776,76859,-1,0,,0,0.00000000000000000000
chr15,23301664,23379695,78031,-1,0,,0,0.00000000000000000000
chr15,20377920,20440361,62441,-1,0,,0,0.00000000000000000000
chr15,20818952,20882155,63203,-1,0,,0,0.00000000000000000000
chr15,22141159,22210584,69425,-1,0,,0,0.00000000000000000000
chr15,20586359,20645744,59385,-1,0,,0,0.00000000000000000000
chr15,23453902,23504037,50135,-1,0,,0,0.00000000000000000000
chr15,23619218,23679735,60517,-1,0,,0,0.00000000000000000000
chr15,22446739,22506103,59364,-1,0,,0,0.00000000000000000000
chr15,21260680,21315095,54415,-1,0,,0,0.00000000000000000000
chr15,20206941,20260123,53182,-1,0,,0,0.00000000000000000000
chr15,20541403,20586683,45280,-1,0,,0,0.00000000000000000000
chr15,20254594,20306620,52026,-1,0,,0,0.00000000000000000000
chr15,22297990,22343845,45855,-1,0,,0,0.00000000000000000000
chr15,21202286,21249037,46751,-1,0,,0,0.00000000000000000000
chr15,22383477,22434169,50692,-1,0,283694,1,1.97269786159552000000
chr15,21931182,21965277,34095,-1,0,,0,0.00000000000000000000
chr15,20785431,20832736,47305,-1,0,,0,0.00000000000000000000
chr15,22547733,22589443,41710,-1,0,,0,0.00000000000000000000
chr15,23213145,23252286,39141,-1,0,,0,0.00000000000000000000
chr15,20575860,20610499,34639,-1,0,,0,0.00000000000000000000
chr15,20599954,20635303,35349,-1,0,,0,0.00000000000000000000
chr15,23089822,23131301,41479,-1,0,,0,0.00000000000000000000
chr15,20168521,20206687,38166,-1,0,,0,0.00000000000000000000
chr15,22414497,22453754,39257,-1,0,,0,0.00000000000000000000
chr15,22262174,22296253,34079,-1,0,,0,0.00000000000000000000
chr15,22844800,22871836,27036,-1,0,114791,1,3.69877200769345000000
chr15,22298201,22336889,38688,-1,0,,0,0.00000000000000000000
chr15,20277100,20311013,33913,-1,0,,0,0.00000000000000000000
chr15,22340394,22370318,29924,-1,0,390538,1,3.34179922470258000000
chr15,20202246,20235708,33462,-1,0,,0,0.00000000000000000000
chr15,20588610,20617673,29063,-1,0,,0,0.00000000000000000000
chr15,23484471,23509921,25450,-1,0,,0,0.00000000000000000000
chr15,22568076,22592617,24541,-1,0,,0,0.00000000000000000000
chr15,20561986,20585524,23538,-1,0,,0,0.00000000000000000000
chr15,21288909,21313510,24601,-1,0,,0,0.00000000000000000000
chr15,20584992,20606205,21213,-1,0,,0,0.00000000000000000000
chr15,22535611,22557517,21906,-1,0,,0,0.00000000000000000000
chr15,20572754,20590160,17406,-1,0,,0,0.00000000000000000000
chr15,21378771,21398778,20007,-1,0,,0,0.00000000000000000000
chr15,22820527,22833265,12738,-1,0,,0,0.00000000000000000000
chr15,21153621,21170901,17280,-1,0,,0,0.00000000000000000000
chr15,22294202,22309898,15696,-1,0,,0,0.00000000000000000000
chr15,23497776,23510950,13174,-1,0,,0,0.00000000000000000000
chr15,22378391,22394059,15668,-1,0,283694,1,6.38243553740107000000
chr15,20789370,20804996,15626,-1,0,,0,0.00000000000000000000
chr15,20561180,20574994,13814,-1,0,,0,0.00000000000000000000
chr15,22372858,22383638,10780,-1,0,283694,1,9.27643784786642000000
chr15,20201794,20215229,13435,-1,0,,0,0.00000000000000000000
chr15,20581169,20591447,10278,-1,0,,0,0.00000000000000000000
chr15,22569675,22579973,10298,-1,0,,0,0.00000000000000000000
chr15,20573074,20584393,11319,-1,0,,0,0.00000000000000000000
chr15,22586965,22595486,8521,-1,0,,0,0.00000000000000000000
chr15,20580749,20588519,7770,-1,0,,0,0.00000000000000000000
chr15,20304627,20311659,7032,-1,0,,0,0.00000000000000000000
chr15,22336249,22344219,7970,-1,0,,0,0.00000000000000000000
chr15,22676439,22682855,6416,-1,0,,0,0.00000000000000000000
chr15,23369799,23376612,6813,-1,0,,0,0.00000000000000000000
chr15,22823997,22830521,6524,-1,0,,0,0.00000000000000000000
chr15,23508040,23514813,6773,-1,0,,0,0.00000000000000000000
chr15,22374519,22381139,6620,-1,0,,0,0.00000000000000000000
chr15,22678324,22683109,4785,-1,0,,0,0.00000000000000000000
chr15,23177654,23183043,5389,-1,0,,0,0.00000000000000000000
chr15,21076354,21080854,4500,-1,0,,0,0.00000000000000000000
chr15,20585703,20589521,3818,-1,0,,0,0.00000000000000000000
chr15,21202193,21205336,3143,-1,0,,0,0.00000000000000000000
chr15,23671405,23675319,3914,-1,0,,0,0.00000000000000000000
chr15,21163125,21166378,3253,-1,0,,0,0.00000000000000000000
chr15,22882344,22884980,2636,-1,0,,0,0.00000000000000000000
chr15,21933495,21934686,1191,-1,0,,0,0.00000000000000000000
chr15,23040923,23042298,1375,-1,0,,0,0.00000000000000000000
chr15,23772850,23774014,1164,-1,0,,0,0.00000000000000000000
chr15,21199922,21200993,1071,-1,0,,0,0.00000000000000000000
chr15,23029650,23030479,829,-1,0,81614,1,120.62726176115800000000
chr15,23782366,23782970,604,-1,0,,0,0.00000000000000000000
chr15,22545758,22546371,613,-1,0,,0,0.00000000000000000000
chr15,23066241,23066669,428,-1,0,123606,1,233.64485981308400000000
chr15,20945596,20946013,417,-1,0,,0,0.00000000000000000000
chr15,23066394,23066528,134,-1,0,123606,1,746.26865671641800000000
chr15,23973472,23975299,1827,-1,0,,0,0.00000000000000000000
chr15,23992043,23995984,3941,-1,0,,0,0.00000000000000000000
chr15,24055015,24073115,18100,-1,0,,0,0.00000000000000000000
chr15,24054882,24067284,12402,-1,0,,0,0.00000000000000000000
chr15,24049614,24059307,9693,-1,0,,0,0.00000000000000000000
chr15,24055130,24065309,10179,-1,0,,0,0.00000000000000000000
chr15,24055355,24061641,6286,-1,0,,0,0.00000000000000000000
chr15,24055594,24059213,3619,-1,0,,0,0.00000000000000000000
chr15,24107695,24107884,189,-1,0,,0,0.00000000000000000000
chr15,24334530,24801502,466972,-1,0,,0,0.00000000000000000000
chr15,24380281,24711560,331279,-1,0,,0,0.00000000000000000000
chr15,24389401,24590473,201072,-1,0,,0,0.00000000000000000000
chr15,24546649,24759653,213004,-1,0,,0,0.00000000000000000000
chr15,24673128,24763535,90407,-1,0,,0,0.00000000000000000000
chr15,24509357,24651280,141923,-1,0,,0,0.00000000000000000000
chr15,24350783,24508558,157775,-1,0,,0,0.00000000000000000000
chr15,24604260,24707339,103079,-1,0,,0,0.00000000000000000000
chr15,24461076,24562893,101817,-1,0,,0,0.00000000000000000000
chr15,24651186,24747983,96797,-1,0,,0,0.00000000000000000000
chr15,24429349,24511678,82329,-1,0,,0,0.00000000000000000000
chr15,24665058,24722743,57685,-1,0,,0,0.00000000000000000000
chr15,24521698,24600300,78602,-1,0,,0,0.00000000000000000000
chr15,24409775,24485111,75336,-1,0,,0,0.00000000000000000000
chr15,24381235,24439976,58741,-1,0,,0,0.00000000000000000000
chr15,24461931,24516774,54843,-1,0,,0,0.00000000000000000000
chr15,24718680,24771352,52672,-1,0,,0,0.00000000000000000000
chr15,24600445,24654700,54255,-1,0,,0,0.00000000000000000000
chr15,24300341,24351317,50976,-1,0,,0,0.00000000000000000000
chr15,24331809,24379850,48041,-1,0,,0,0.00000000000000000000
chr15,24678917,24723464,44547,-1,0,,0,0.00000000000000000000
chr15,24662200,24701305,39105,-1,0,,0,0.00000000000000000000
chr15,25090349,25125353,35004,-1,0,6638,1,2.85681636384413000000
chr15,24508886,24546084,37198,-1,0,,0,0.00000000000000000000
chr15,24409214,24439297,30083,-1,0,,0,0.00000000000000000000
chr15,24681312,24704621,23309,-1,0,,0,0.00000000000000000000
chr15,25065668,25087274,21606,-1,0,6638,1,4.62834397852448000000
chr15,24488943,24517406,28463,-1,0,,0,0.00000000000000000000
chr15,24799345,24825289,25944,-1,0,,0,0.00000000000000000000
chr15,24721626,24740558,18932,-1,0,,0,0.00000000000000000000
chr15,24257863,24273305,15442,-1,0,,0,0.00000000000000000000
chr15,25069613,25084258,14645,-1,0,6638,1,6.82826903379993000000
chr15,24667161,24680906,13745,-1,0,,0,0.00000000000000000000
chr15,24255471,24263941,8470,-1,0,,0,0.00000000000000000000
chr15,24720370,24731213,10843,-1,0,,0,0.00000000000000000000
chr15,25108556,25118534,9978,-1,0,6638,1,10.02204850671480000000
chr15,24494872,24502538,7666,-1,0,,0,0.00000000000000000000
chr15,24447039,24454985,7946,-1,0,,0,0.00000000000000000000
chr15,24257753,24263980,6227,-1,0,,0,0.00000000000000000000
chr15,24538452,24543810,5358,-1,0,,0,0.00000000000000000000
chr15,24396553,24401790,5237,-1,0,,0,0.00000000000000000000
chr15,25116986,25118735,1749,-1,0,6638,1,57.17552887364210000000
chr15,25107076,25109298,2222,-1,0,6638,1,45.00450045004500000000
chr15,25115696,25117505,1809,-1,0,6638,1,55.27915975677170000000
chr15,24525977,24527795,1818,-1,0,,0,0.00000000000000000000
chr15,25037841,25039354,1513,-1,0,,0,0.00000000000000000000
chr15,24206931,24207511,580,-1,0,,0,0.00000000000000000000
chr15,24839284,24839699,415,-1,0,,0,0.00000000000000000000
chr15,24207045,24207385,340,-1,0,,0,0.00000000000000000000
chr15,25302445,25304124,1679,-1,0,,0,0.00000000000000000000
chr15,25332900,25334048,1148,-1,0,,0,0.00000000000000000000
chr15,25333093,25334276,1183,-1,0,,0,0.00000000000000000000
chr15,25332846,25333678,832,-1,0,,0,0.00000000000000000000
chr15,25414801,25498600,83799,-1,0,,0,0.00000000000000000000
chr15,25418988,25465238,46250,-1,0,,0,0.00000000000000000000
chr15,25420787,25436610,15823,-1,0,,0,0.00000000000000000000
chr15,25438735,25460195,21460,-1,0,,0,0.00000000000000000000
chr15,25419802,25430773,10971,-1,0,,0,0.00000000000000000000
chr15,25472213,25477659,5446,-1,0,,0,0.00000000000000000000
chr15,25464361,25466714,2353,-1,0,,0,0.00000000000000000000
chr15,25436602,25438542,1940,-1,0,,0,0.00000000000000000000
chr15,25931318,25932463,1145,-1,0,57194,1,87.33624454148470000000
chr15,25931396,25932132,736,-1,0,57194,1,135.86956521739100000000
chr15,26124066,26126044,1978,-1,0,,0,0.00000000000000000000
chr15,26322714,26324169,1455,-1,0,,0,0.00000000000000000000
chr15,26399035,26401869,2834,-1,0,,0,0.00000000000000000000
chr15,26745269,26766594,21325,-1,0,,0,0.00000000000000000000
chr15,26749090,26752356,3266,-1,0,,0,0.00000000000000000000
chr15,26899423,26901549,2126,-1,0,2562,1,47.03668861712140000000
chr15,26961953,26962344,391,-1,0,2562,1,255.75447570332500000000
chr15,27021397,27021899,502,-1,0,,0,0.00000000000000000000
chr15,27021498,27021807,309,-1,0,,0,0.00000000000000000000
chr15,27028687,27030128,1441,-1,0,,0,0.00000000000000000000
chr15,27918484,27927880,9396,-1,0,,0,0.00000000000000000000
chr15,27919234,27928345,9111,-1,0,,0,0.00000000000000000000
chr15,27403015,27409798,6783,-1,0,2567,1,14.74273920094350000000
chr15,27389573,27394501,4928,-1,0,2567,1,20.29220779220780000000
chr15,27469994,27471787,1793,-1,0,2567,1,55.77244841048520000000
chr15,27112235,27113345,1110,-1,0,2558,1,90.09009009009010000000
chr15,27913425,27913833,408,-1,0,,0,0.00000000000000000000
chr15,27633274,27633543,269,-1,0,2567,1,371.74721189591100000000
chr15,27483242,27483346,104,-1,0,2567,1,961.53846153846200000000
chr15,28262853,28265823,2970,-1,0,4948,1,33.67003367003370000000
chr15,30445047,31086337,641290,-1,0,728498;89832;101059918;89839,4,0.62374276848227800000
chr15,28419353,28924423,505070,-1,0,8924,1,0.19799235749500100000
chr15,30371370,30840547,469177,-1,0,89832;101059918;653073,3,0.63941753325504000000
chr15,30700744,30971031,270287,-1,0,728498;101059918;89839,3,1.10993129525282000000
chr15,30450020,30701459,251439,-1,0,89832;101059918,2,0.79542155353783600000
chr15,30786266,31029949,243683,-1,0,728498;89839,2,0.82073841835499400000
chr15,30621555,30849204,227649,-1,0,89832;101059918,2,0.87854548010314100000
chr15,28740353,28934783,194430,-1,0,,0,0.00000000000000000000
chr15,30397974,30587353,189379,-1,0,,0,0.00000000000000000000
chr15,30598112,30766099,167987,-1,0,89832;101059918,2,1.19056831778650000000
chr15,30902621,31088362,185741,-1,0,728498;89839,2,1.07676818796065000000
chr15,30507388,30640356,132968,-1,0,,0,0.00000000000000000000
chr15,30665112,30785543,120431,-1,0,89832;101059918,2,1.66070197872641000000
chr15,30496275,30601956,105681,-1,0,,0,0.00000000000000000000
chr15,30598028,30672812,74784,-1,0,89832,1,1.33718442447582000000
chr15,30915709,30990442,74733,-1,0,89839,1,1.33809695850561000000
chr15,28829215,28910698,81483,-1,0,,0,0.00000000000000000000
chr15,30926123,30966824,40701,-1,0,89839,1,2.45694208987494000000
chr15,30497871,30546373,48502,-1,0,,0,0.00000000000000000000
chr15,30943512,30975198,31686,-1,0,,0,0.00000000000000000000
chr15,30394442,30425809,31367,-1,0,,0,0.00000000000000000000
chr15,30864344,30894987,30643,-1,0,,0,0.00000000000000000000
chr15,28638339,28658981,20642,-1,0,,0,0.00000000000000000000
chr15,30670044,30687156,17112,-1,0,89832,1,5.84385226741468000000
chr15,30489545,30505717,16172,-1,0,,0,0.00000000000000000000
chr15,28658445,28669824,11379,-1,0,,0,0.00000000000000000000
chr15,28734288,28744601,10313,-1,0,,0,0.00000000000000000000
chr15,30820425,30831236,10811,-1,0,,0,0.00000000000000000000
chr15,28647236,28658737,11501,-1,0,,0,0.00000000000000000000
chr15,30137501,30148000,10499,-1,0,7082,1,9.52471663967997000000
chr15,28901560,28911002,9442,-1,0,,0,0.00000000000000000000
chr15,28837455,28843833,6378,-1,0,,0,0.00000000000000000000
chr15,29410828,29416883,6055,-1,0,23359,1,16.51527663088360000000
chr15,28737785,28743297,5512,-1,0,,0,0.00000000000000000000
chr15,31013176,31019855,6679,-1,0,,0,0.00000000000000000000
chr15,29663434,29667702,4268,-1,0,23359,1,23.43017806935330000000
chr15,30965916,30969628,3712,-1,0,,0,0.00000000000000000000
chr15,30971250,30974807,3557,-1,0,,0,0.00000000000000000000
chr15,29066351,29069744,3393,-1,0,,0,0.00000000000000000000
chr15,29900953,29903436,2483,-1,0,,0,0.00000000000000000000
chr15,29752967,29755631,2664,-1,0,23359,1,37.53753753753750000000
chr15,28840758,28842493,1735,-1,0,,0,0.00000000000000000000
chr15,29911446,29913621,2175,-1,0,,0,0.00000000000000000000
chr15,29900245,29902392,2147,-1,0,,0,0.00000000000000000000
chr15,30199525,30201371,1846,-1,0,7082,1,54.17118093174430000000
chr15,28938000,28939393,1393,-1,0,,0,0.00000000000000000000
chr15,30083241,30084254,1013,-1,0,7082,1,98.71668311944720000000
chr15,29411428,29411982,554,-1,0,,0,0.00000000000000000000
chr15,31254721,31256313,1592,-1,0,54893,1,62.81407035175880000000
chr15,31296565,31300135,3570,-1,0,4308,1,28.01120448179270000000
chr15,31359564,31393190,33626,-1,0,4308,1,2.97388925236424000000
chr15,31362087,31367223,5136,-1,0,4308,1,19.47040498442370000000
chr15,31447324,31451212,3888,-1,0,4308,1,25.72016460905350000000
chr15,31569999,31570578,579,-1,0,,0,0.00000000000000000000
chr15,31617901,31620649,2748,-1,0,51621,1,36.39010189228530000000
chr15,31618314,31620471,2157,-1,0,51621,1,46.36068613815480000000
chr15,31723818,31726032,2214,-1,0,51621,1,45.16711833785000000000
chr15,31775453,31776533,1080,-1,0,161725,1,92.59259259259260000000
chr15,32291172,32291599,427,-1,0,,0,0.00000000000000000000
chr15,32456466,32879476,423010,-1,0,653125;728047;1139,3,0.70920309212548200000
chr15,32585624,32815247,229623,-1,0,653125;728047,2,0.87099288834306700000
chr15,32445666,32631887,186221,-1,0,1139,1,0.53699636453461200000
chr15,32539407,32655256,115849,-1,0,,0,0.00000000000000000000
chr15,32536961,32614379,77418,-1,0,,0,0.00000000000000000000
chr15,32444700,32509105,64405,-1,0,1139,1,1.55267448179489000000
chr15,32499153,32556885,57732,-1,0,,0,0.00000000000000000000
chr15,32499000,32536449,37449,-1,0,,0,0.00000000000000000000
chr15,32697672,32729115,31443,-1,0,,0,0.00000000000000000000
chr15,32492250,32515827,23577,-1,0,,0,0.00000000000000000000
chr15,32900308,32925084,24776,-1,0,9824,1,4.03616402970617000000
chr15,32504287,32519739,15452,-1,0,,0,0.00000000000000000000
chr15,32504264,32512220,7956,-1,0,,0,0.00000000000000000000
chr15,32508945,32516542,7597,-1,0,,0,0.00000000000000000000
chr15,33906457,33910821,4364,-1,0,6263,1,22.91475710357470000000
chr15,34274910,34279065,4155,-1,0,1133;57099,2,48.13477737665460000000
chr15,34200446,34200714,268,-1,0,57099,1,373.13432835820900000000
chr15,34406257,34409368,3111,-1,0,,0,0.00000000000000000000
chr15,34531141,34535160,4019,-1,0,9990,1,24.88181139586960000000
chr15,34562147,34562533,386,-1,0,9990,1,259.06735751295300000000
chr15,34718090,34885323,167233,-1,0,440270,1,0.59796810438131200000
chr15,34717212,34839412,122200,-1,0,440270,1,0.81833060556464800000
chr15,34727014,34818344,91330,-1,0,440270,1,1.09493047191503000000
chr15,34709554,34800404,90850,-1,0,,0,0.00000000000000000000
chr15,34702008,34763194,61186,-1,0,,0,0.00000000000000000000
chr15,34733121,34803306,70185,-1,0,,0,0.00000000000000000000
chr15,34929720,34984079,54359,-1,0,,0,0.00000000000000000000
chr15,34729417,34771048,41631,-1,0,,0,0.00000000000000000000
chr15,34769802,34812303,42501,-1,0,,0,0.00000000000000000000
chr15,34703715,34739886,36171,-1,0,,0,0.00000000000000000000
chr15,34742067,34778366,36299,-1,0,,0,0.00000000000000000000
chr15,34724127,34753144,29017,-1,0,,0,0.00000000000000000000
chr15,34829318,34854102,24784,-1,0,,0,0.00000000000000000000
chr15,34706563,34721903,15340,-1,0,,0,0.00000000000000000000
chr15,34802469,34810923,8454,-1,0,,0,0.00000000000000000000
chr15,34848103,34853499,5396,-1,0,,0,0.00000000000000000000
chr15,34701293,34707017,5724,-1,0,,0,0.00000000000000000000
chr15,35008925,35009469,544,-1,0,,0,0.00000000000000000000
chr15,34930622,34931217,595,-1,0,,0,0.00000000000000000000
chr15,34741632,34742130,498,-1,0,,0,0.00000000000000000000
chr15,34746890,34747415,525,-1,0,,0,0.00000000000000000000
chr15,35009022,35009360,338,-1,0,,0,0.00000000000000000000
chr15,34930744,34931081,337,-1,0,,0,0.00000000000000000000
chr15,34741747,34742028,281,-1,0,,0,0.00000000000000000000
chr15,35196794,35197893,1099,-1,0,9716,1,90.99181073703370000000
chr15,35530624,35535934,5310,-1,0,,0,0.00000000000000000000
chr15,35683958,35721577,37619,-1,0,89978,1,2.65823121295090000000
chr15,35761204,35762325,1121,-1,0,89978,1,89.20606601248880000000
chr15,35588989,35589148,159,-1,0,,0,0.00000000000000000000
chr15,36087608,36088571,963,-1,0,,0,0.00000000000000000000
chr15,36160570,36164756,4186,-1,0,,0,0.00000000000000000000
chr15,36160128,36162495,2367,-1,0,,0,0.00000000000000000000
chr15,36699373,36700942,1569,-1,0,,0,0.00000000000000000000
chr15,36954477,36954927,450,-1,0,84529,1,222.22222222222200000000
chr15,36954641,36954693,52,-1,0,84529,1,1923.07692307692000000000
chr15,37389421,37394989,5568,-1,0,4212,1,17.95977011494250000000
chr15,38104481,38105072,591,-1,0,,0,0.00000000000000000000
chr15,38142223,38143522,1299,-1,0,,0,0.00000000000000000000
chr15,38267562,38268313,751,-1,0,,0,0.00000000000000000000
chr15,38299404,38324844,25440,-1,0,,0,0.00000000000000000000
chr15,38655569,38688596,33027,-1,0,,0,0.00000000000000000000
chr15,39266916,39267485,569,-1,0,,0,0.00000000000000000000
chr15,39267007,39267362,355,-1,0,,0,0.00000000000000000000
chr15,39281497,39281891,394,-1,0,,0,0.00000000000000000000
chr15,39372369,39373488,1119,-1,0,,0,0.00000000000000000000
chr15,39372403,39373464,1061,-1,0,,0,0.00000000000000000000
chr15,39372385,39373410,1025,-1,0,,0,0.00000000000000000000
chr15,39520000,39520591,591,-1,0,,0,0.00000000000000000000
chr15,39520102,39520442,340,-1,0,,0,0.00000000000000000000
chr15,39525851,39526504,653,-1,0,,0,0.00000000000000000000
chr15,39583275,39598498,15223,-1,0,,0,0.00000000000000000000
chr15,39744412,39748167,3755,-1,0,,0,0.00000000000000000000
chr15,39744389,39744859,470,-1,0,,0,0.00000000000000000000
chr15,39837743,39839304,1561,-1,0,,0,0.00000000000000000000
chr15,40329813,40329882,69,-1,0,6727,1,1449.27536231884000000000
chr15,40739409,40743381,3972,-1,0,22893,1,25.17623363544810000000
chr15,40821896,40823565,1669,-1,0,90416,1,59.91611743559020000000
chr15,41465040,41465789,749,-1,0,,0,0.00000000000000000000
chr15,41604019,41604430,411,-1,0,11339,1,243.30900243309000000000
chr15,41865306,41870188,4882,-1,0,7301,1,20.48340843916430000000
chr15,42017707,42018103,396,-1,0,23269,1,252.52525252525300000000
chr15,42389090,42392372,3282,-1,0,,0,0.00000000000000000000
chr15,42403445,42409169,5724,-1,0,,0,0.00000000000000000000
chr15,42421452,42433846,12394,-1,0,255189,1,8.06842020332419000000
chr15,42617413,42621082,3669,-1,0,2595,1,27.25538293813030000000
chr15,42585723,42587209,1486,-1,0,2595,1,67.29475100942130000000
chr15,42721018,42723635,2617,-1,0,64397,1,38.21169277799010000000
chr15,42782363,42782787,424,-1,0,64397,1,235.84905660377400000000
chr15,42845311,42846843,1532,-1,0,55142,1,65.27415143603130000000
chr15,42988934,42995217,6283,-1,0,57519,1,15.91596371160270000000
chr15,43093359,43093516,157,-1,0,146057,1,636.94267515923600000000
chr15,43468850,43470373,1523,-1,0,80021,1,65.65988181221270000000
chr15,43660302,43660885,583,-1,0,146050,1,171.52658662092600000000
chr15,43660436,43660765,329,-1,0,146050,1,303.95136778115500000000
chr15,43847654,43989398,141744,-1,0,117155;161497;548596;1159;9677,5,3.52748617225420000000
chr15,43924849,44022235,97386,-1,0,548596;117155,2,2.05368328096441000000
chr15,43900674,43960574,59900,-1,0,117155;161497,2,3.33889816360601000000
chr15,43885403,43938697,53294,-1,0,117155;1159;161497,3,5.62915149923068000000
chr15,43893009,43896447,3438,-1,0,161497,1,29.08667830133800000000
chr15,43993607,43995607,2000,-1,0,,0,0.00000000000000000000
chr15,44137065,44139015,1950,-1,0,79968,1,51.28205128205130000000
chr15,44137459,44138845,1386,-1,0,79968,1,72.15007215007210000000
chr15,44122455,44123558,1103,-1,0,79968,1,90.66183136899370000000
chr15,44137724,44138411,687,-1,0,79968,1,145.56040756914100000000
chr15,44343892,44353275,9383,-1,0,84978,1,10.65757220505170000000
chr15,44578496,44578814,318,-1,0,,0,0.00000000000000000000
chr15,44757183,44758424,1241,-1,0,51496,1,80.58017727639000000000
chr15,44993159,44996464,3305,-1,0,,0,0.00000000000000000000
chr15,45068684,45069150,466,-1,0,,0,0.00000000000000000000
chr15,45068778,45069086,308,-1,0,,0,0.00000000000000000000
chr15,45224107,45236237,12130,-1,0,,0,0.00000000000000000000
chr15,45129907,45146587,16680,-1,0,,0,0.00000000000000000000
chr15,45226129,45236612,10483,-1,0,,0,0.00000000000000000000
chr15,45154116,45160117,6001,-1,0,,0,0.00000000000000000000
chr15,45134586,45137329,2743,-1,0,,0,0.00000000000000000000
chr15,45120154,45120636,482,-1,0,,0,0.00000000000000000000
chr15,45327014,45363760,36746,-1,0,6652,1,2.72138464050509000000
chr15,45519773,45521400,1627,-1,0,,0,0.00000000000000000000
chr15,45570010,45570364,354,-1,0,,0,0.00000000000000000000
chr15,45570059,45570260,201,-1,0,,0,0.00000000000000000000
chr15,46097912,46263177,165265,-1,0,,0,0.00000000000000000000
chr15,46254938,46257687,2749,-1,0,,0,0.00000000000000000000
chr15,46067888,46068391,503,-1,0,,0,0.00000000000000000000
chr15,46067964,46068314,350,-1,0,,0,0.00000000000000000000
chr15,46438530,46454097,15567,-1,0,,0,0.00000000000000000000
chr15,46429280,46435407,6127,-1,0,,0,0.00000000000000000000
chr15,46860705,46861165,460,-1,0,,0,0.00000000000000000000
chr15,47058449,47063570,5121,-1,0,,0,0.00000000000000000000
chr15,47235761,47235850,89,-1,0,,0,0.00000000000000000000
chr15,47242775,47243856,1081,-1,0,,0,0.00000000000000000000
chr15,47483312,47487784,4472,-1,0,80031,1,22.36135957066190000000
chr15,47511455,47525661,14206,-1,0,80031,1,7.03927917781219000000
chr15,47515172,47521840,6668,-1,0,80031,1,14.99700059988000000000
chr15,47520087,47520336,249,-1,0,80031,1,401.60642570281100000000
chr15,47720471,47720999,528,-1,0,80031,1,189.39393939393900000000
chr15,47720633,47720809,176,-1,0,80031,1,568.18181818181800000000
chr15,47924608,47924722,114,-1,0,80031,1,877.19298245614000000000
chr15,47972903,47974112,1209,-1,0,80031,1,82.71298593879240000000
chr15,48102771,48104364,1593,-1,0,,0,0.00000000000000000000
chr15,48207005,48215254,8249,-1,0,,0,0.00000000000000000000
chr15,48260683,48266496,5813,-1,0,,0,0.00000000000000000000
chr15,48340509,48343248,2739,-1,0,,0,0.00000000000000000000
chr15,48550203,48550609,406,-1,0,6557,1,246.30541871921200000000
chr15,48640312,48648228,7916,-1,0,,0,0.00000000000000000000
chr15,48683924,48683980,56,-1,0,,0,0.00000000000000000000
chr15,48737315,48737405,90,-1,0,2200,1,1111.11111111111000000000
chr15,49184292,49187843,3551,-1,0,399694,1,28.16108138552520000000
chr15,49544981,49547814,2833,-1,0,2585,1,35.29827038475110000000
chr15,49649189,49695536,46347,-1,0,196951,1,2.15763695600578000000
chr15,49811364,49817889,6525,-1,0,196951,1,15.32567049808430000000
chr15,50079943,50125102,45159,-1,0,,0,0.00000000000000000000
chr15,50153084,50153498,414,-1,0,79895,1,241.54589371980700000000
chr15,50448245,50448345,100,-1,0,,0,0.00000000000000000000
chr15,50632889,50633351,462,-1,0,2553,1,216.45021645021600000000
chr15,50633061,50633181,120,-1,0,2553,1,833.33333333333300000000
chr15,50747053,50747686,633,-1,0,9101,1,157.97788309636600000000
chr15,50787258,50787705,447,-1,0,9101,1,223.71364653243800000000
chr15,50798987,50800109,1122,-1,0,373509,1,89.12655971479500000000
chr15,50921352,50921795,443,-1,0,54822,1,225.73363431151200000000
chr15,50946444,50947444,1000,-1,0,54822,1,100.00000000000000000000
chr15,51119918,51125422,5504,-1,0,,0,0.00000000000000000000
chr15,51518881,51519945,1064,-1,0,1588,1,93.98496240601500000000
chr15,51820206,51820988,782,-1,0,23312,1,127.87723785166200000000
chr15,51897715,51898058,343,-1,0,23312,1,291.54518950437300000000
chr15,52261565,52273251,11686,-1,0,123169,1,8.55724798904672000000
chr15,52265740,52273308,7568,-1,0,,0,0.00000000000000000000
chr15,52303754,52307718,3964,-1,0,,0,0.00000000000000000000
chr15,52355581,52356093,512,-1,0,5597,1,195.31250000000000000000
chr15,52375812,52378355,2543,-1,0,,0,0.00000000000000000000
chr15,52388281,52389658,1377,-1,0,,0,0.00000000000000000000
chr15,52525060,52525635,575,-1,0,55930,1,173.91304347826100000000
chr15,52525186,52525524,338,-1,0,55930,1,295.85798816568000000000
chr15,52889215,52889590,375,-1,0,56204,1,266.66666666666700000000
chr15,53121370,53123005,1635,-1,0,,0,0.00000000000000000000
chr15,53231272,53231681,409,-1,0,,0,0.00000000000000000000
chr15,53251295,53286677,35382,-1,0,,0,0.00000000000000000000
chr15,53536168,53537620,1452,-1,0,,0,0.00000000000000000000
chr15,53545654,53546478,824,-1,0,,0,0.00000000000000000000
chr15,53997995,54021191,23196,-1,0,256764,1,4.31108811864114000000
chr15,53760877,53788027,27150,-1,0,,0,0.00000000000000000000
chr15,53974429,53976915,2486,-1,0,256764,1,40.22526146419950000000
chr15,53880887,53881821,934,-1,0,256764,1,107.06638115631700000000
chr15,53779500,53780505,1005,-1,0,,0,0.00000000000000000000
chr15,53765708,53766088,380,-1,0,,0,0.00000000000000000000
chr15,54196993,54202262,5269,-1,0,,0,0.00000000000000000000
chr15,54199232,54203148,3916,-1,0,,0,0.00000000000000000000
chr15,54199909,54202537,2628,-1,0,,0,0.00000000000000000000
chr15,54386005,54386413,408,-1,0,440279,1,245.09803921568600000000
chr15,54443590,54444808,1218,-1,0,440279,1,82.10180623973730000000
chr15,54540580,54540990,410,-1,0,440279,1,243.90243902439000000000
chr15,54908477,55007338,98861,-1,0,440279,1,1.01152122677294000000
chr15,54890760,54907400,16640,-1,0,440279,1,6.00961538461539000000
chr15,54890817,54893268,2451,-1,0,440279,1,40.79967360261120000000
chr15,55129167,55139007,9840,-1,0,,0,0.00000000000000000000
chr15,55218147,55224601,6454,-1,0,,0,0.00000000000000000000
chr15,55429855,55430296,441,-1,0,,0,0.00000000000000000000
chr15,55501930,55607678,105748,-1,0,5873,1,0.94564436206831300000
chr15,55655373,55658458,3085,-1,0,9236,1,32.41491085899510000000
chr15,55655543,55657055,1512,-1,0,9236,1,66.13756613756610000000
chr15,56060172,56062872,2700,-1,0,,0,0.00000000000000000000
chr15,56082566,56089514,6948,-1,0,,0,0.00000000000000000000
chr15,56447942,56448913,971,-1,0,64864,1,102.98661174047400000000
chr15,56486821,56492762,5941,-1,0,64864,1,16.83218313415250000000
chr15,56515795,56531681,15886,-1,0,64864,1,6.29485081203576000000
chr15,56529093,56532380,3287,-1,0,64864,1,30.42287800425920000000
chr15,56542084,56552781,10697,-1,0,,0,0.00000000000000000000
chr15,56662152,56896388,234236,-1,0,55329;374618,2,0.85383971720828600000
chr15,56835814,56893033,57219,-1,0,,0,0.00000000000000000000
chr15,56794150,56827210,33060,-1,0,,0,0.00000000000000000000
chr15,56764090,56790498,26408,-1,0,,0,0.00000000000000000000
chr15,56790241,56811397,21156,-1,0,,0,0.00000000000000000000
chr15,56804000,56826631,22631,-1,0,,0,0.00000000000000000000
chr15,56789722,56800996,11274,-1,0,,0,0.00000000000000000000
chr15,56782139,56792916,10777,-1,0,,0,0.00000000000000000000
chr15,56790066,56799781,9715,-1,0,,0,0.00000000000000000000
chr15,56705743,56715022,9279,-1,0,374618,1,10.77702338614070000000
chr15,56677807,56684304,6497,-1,0,374618,1,15.39171925504080000000
chr15,56790080,56794930,4850,-1,0,,0,0.00000000000000000000
chr15,56789804,56792669,2865,-1,0,,0,0.00000000000000000000
chr15,56966886,56968279,1393,-1,0,54816,1,71.78750897343860000000
chr15,57462837,57463027,190,-1,0,6938,1,526.31578947368400000000
chr15,57587089,57587846,757,-1,0,,0,0.00000000000000000000
chr15,57980516,57980590,74,-1,0,145781,1,1351.35135135135000000000
chr15,58231560,58235284,3724,-1,0,,0,0.00000000000000000000
chr15,58281325,58282423,1098,-1,0,8854,1,91.07468123861570000000
chr15,58281932,58282466,534,-1,0,8854,1,187.26591760299600000000
chr15,58282114,58282225,111,-1,0,8854,1,900.90090090090100000000
chr15,58458707,58465700,6993,-1,0,366,1,14.30001430001430000000
chr15,58506021,58577330,71309,-1,0,,0,0.00000000000000000000
chr15,58724524,58756571,32047,-1,0,3990,1,3.12041688769620000000
chr15,58721509,58730976,9467,-1,0,3990,1,10.56300834477660000000
chr15,58596395,58596945,550,-1,0,,0,0.00000000000000000000
chr15,58596495,58596816,321,-1,0,,0,0.00000000000000000000
chr15,58912726,58913307,581,-1,0,102,1,172.11703958691900000000
chr15,58912847,58913166,319,-1,0,102,1,313.47962382445100000000
chr15,59088866,59090539,1673,-1,0,54629,1,59.77286312014340000000
chr15,59100932,59102121,1189,-1,0,54629,1,84.10428931875520000000
chr15,59712802,59713329,527,-1,0,,0,0.00000000000000000000
chr15,59712898,59713229,331,-1,0,,0,0.00000000000000000000
chr15,60072478,60103946,31468,-1,0,,0,0.00000000000000000000
chr15,60206281,60207329,1048,-1,0,,0,0.00000000000000000000
chr15,60316984,60352552,35568,-1,0,,0,0.00000000000000000000
chr15,60591475,60593157,1682,-1,0,,0,0.00000000000000000000
chr15,60909757,60910020,263,-1,0,6095,1,380.22813688212900000000
chr15,61002968,61008388,5420,-1,0,6095,1,18.45018450184500000000
chr15,61108571,61108870,299,-1,0,6095,1,334.44816053511700000000
chr15,61686566,61698818,12252,-1,0,,0,0.00000000000000000000
chr15,61688851,61696696,7845,-1,0,,0,0.00000000000000000000
chr15,61685036,61688369,3333,-1,0,,0,0.00000000000000000000
chr15,62392916,62394145,1229,-1,0,,0,0.00000000000000000000
chr15,62460675,62466967,6292,-1,0,,0,0.00000000000000000000
chr15,62538337,62538691,354,-1,0,,0,0.00000000000000000000
chr15,62706122,62708800,2678,-1,0,,0,0.00000000000000000000
chr15,62706090,62707792,1702,-1,0,,0,0.00000000000000000000
chr15,62842617,62895952,53335,-1,0,,0,0.00000000000000000000
chr15,62955511,62957156,1645,-1,0,83660,1,60.79027355623100000000
chr15,62947556,62948115,559,-1,0,83660,1,178.89087656529500000000
chr15,63201800,63210976,9176,-1,0,,0,0.00000000000000000000
chr15,63267334,63269175,1841,-1,0,,0,0.00000000000000000000
chr15,63441723,63441811,88,-1,0,,0,0.00000000000000000000
chr15,63481888,63482999,1111,-1,0,51762,1,90.00900090009000000000
chr15,63612938,63613276,338,-1,0,,0,0.00000000000000000000
chr15,63763245,63764767,1522,-1,0,,0,0.00000000000000000000
chr15,64196407,64197567,1160,-1,0,,0,0.00000000000000000000
chr15,64440057,64441550,1493,-1,0,,0,0.00000000000000000000
chr15,64633142,64633565,423,-1,0,53944,1,236.40661938534300000000
chr15,64663868,64664438,570,-1,0,9768,1,175.43859649122800000000
chr15,64664066,64664364,298,-1,0,9768,1,335.57046979865800000000
chr15,64664106,64664226,120,-1,0,9768,1,833.33333333333300000000
chr15,64843786,64844213,427,-1,0,23060,1,234.19203747072600000000
chr15,64901729,64904569,2840,-1,0,23060,1,35.21126760563380000000
chr15,64906393,64907598,1205,-1,0,23060,1,82.98755186721990000000
chr15,64997602,65007759,10157,-1,0,,0,0.00000000000000000000
chr15,65026063,65027825,1762,-1,0,,0,0.00000000000000000000
chr15,65461980,65463711,1731,-1,0,10845,1,57.77007510109760000000
chr15,65589789,65591862,2073,-1,0,,0,0.00000000000000000000
chr15,65598047,65601530,3483,-1,0,,0,0.00000000000000000000
chr15,65618407,65618806,399,-1,0,,0,0.00000000000000000000
chr15,65784248,65788550,4302,-1,0,54878,1,23.24500232450020000000
chr15,65812137,65822014,9877,-1,0,,0,0.00000000000000000000
chr15,65816751,65819135,2384,-1,0,,0,0.00000000000000000000
chr15,65817114,65818901,1787,-1,0,,0,0.00000000000000000000
chr15,65817669,65819122,1453,-1,0,,0,0.00000000000000000000
chr15,65873611,65873779,168,-1,0,81556,1,595.23809523809500000000
chr15,66097785,66102829,5044,-1,0,,0,0.00000000000000000000
chr15,66331968,66332500,532,-1,0,84465,1,187.96992481203000000000
chr15,66332111,66332299,188,-1,0,84465,1,531.91489361702100000000
chr15,66633697,66634129,432,-1,0,54962,1,231.48148148148100000000
chr15,66633790,66634117,327,-1,0,54962,1,305.81039755351700000000
chr15,66706536,66706683,147,-1,0,5604,1,680.27210884353700000000
chr15,66866256,66891088,24832,-1,0,,0,0.00000000000000000000
chr15,66877618,66878467,849,-1,0,,0,0.00000000000000000000
chr15,67083655,67084185,530,-1,0,,0,0.00000000000000000000
chr15,67083770,67084069,299,-1,0,,0,0.00000000000000000000
chr15,67290645,67291173,528,-1,0,,0,0.00000000000000000000
chr15,67290797,67290907,110,-1,0,,0,0.00000000000000000000
chr15,67404640,67405633,993,-1,0,4088,1,100.70493454179300000000
chr15,67534450,67534874,424,-1,0,79719,1,235.84905660377400000000
chr15,67579866,67583089,3223,-1,0,64799,1,31.02699348433140000000
chr15,67868290,67869391,1101,-1,0,5607,1,90.82652134423250000000
chr15,67901842,67901949,107,-1,0,5607,1,934.57943925233600000000
chr15,68063290,68063730,440,-1,0,5607,1,227.27272727272700000000
chr15,68063435,68063508,73,-1,0,5607,1,1369.86301369863000000000
chr15,68063496,68063567,71,-1,0,5607,1,1408.45070422535000000000
chr15,68137955,68155345,17390,-1,0,,0,0.00000000000000000000
chr15,68197433,68197631,198,-1,0,,0,0.00000000000000000000
chr15,68262345,68264913,2568,-1,0,,0,0.00000000000000000000
chr15,68351866,68352810,944,-1,0,8554,1,105.93220338983100000000
chr15,68425938,68429312,3374,-1,0,8554,1,29.63841138115000000000
chr15,68418310,68419192,882,-1,0,8554,1,113.37868480725600000000
chr15,68713230,68713701,471,-1,0,22801,1,212.31422505307900000000
chr15,68713322,68713558,236,-1,0,22801,1,423.72881355932200000000
chr15,68750741,68757264,6523,-1,0,,0,0.00000000000000000000
chr15,68983190,68984588,1398,-1,0,10391,1,71.53075822603720000000
chr15,68983477,68983914,437,-1,0,10391,1,228.83295194508000000000
chr15,69049435,69050035,600,-1,0,,0,0.00000000000000000000
chr15,69049574,69049895,321,-1,0,,0,0.00000000000000000000
chr15,69316040,69317695,1655,-1,0,79400,1,60.42296072507550000000
chr15,69369692,69370565,873,-1,0,,0,0.00000000000000000000
chr15,69532427,69532766,339,-1,0,26035,1,294.98525073746300000000
chr15,69592928,69593279,351,-1,0,54852,1,284.90028490028500000000
chr15,69592989,69593282,293,-1,0,54852,1,341.29692832764500000000
chr15,69614424,69615450,1026,-1,0,54852,1,97.46588693957110000000
chr15,70254094,70258238,4144,-1,0,,0,0.00000000000000000000
chr15,70298239,70298410,171,-1,0,,0,0.00000000000000000000
chr15,70387745,70394753,7008,-1,0,7090,1,14.26940639269410000000
chr15,70486328,70488594,2266,-1,0,,0,0.00000000000000000000
chr15,70599559,70603702,4143,-1,0,,0,0.00000000000000000000
chr15,70677134,70677206,72,-1,0,,0,0.00000000000000000000
chr15,70748544,70749371,827,-1,0,,0,0.00000000000000000000
chr15,70771925,70772045,120,-1,0,,0,0.00000000000000000000
chr15,71021657,71027554,5897,-1,0,55075,1,16.95777513990160000000
chr15,71615057,71639449,24392,-1,0,79875,1,4.09970482125287000000
chr15,71615575,71631357,15782,-1,0,79875,1,6.33633253073121000000
chr15,71708360,71714117,5757,-1,0,79875,1,17.37015806843840000000
chr15,71474172,71478075,3903,-1,0,79875,1,25.62131693569050000000
chr15,71879956,71883233,3277,-1,0,79875,1,30.51571559353070000000
chr15,71881334,71883753,2419,-1,0,79875,1,41.33939644481190000000
chr15,71671468,71673161,1693,-1,0,79875,1,59.06674542232720000000
chr15,71881569,71882967,1398,-1,0,79875,1,71.53075822603720000000
chr15,71856796,71857379,583,-1,0,79875,1,171.52658662092600000000
chr15,71885414,71885834,420,-1,0,79875,1,238.09523809523800000000
chr15,71452489,71452829,340,-1,0,79875,1,294.11764705882400000000
chr15,71991440,71991916,476,-1,0,79875,1,210.08403361344500000000
chr15,71991544,71991777,233,-1,0,79875,1,429.18454935622300000000
chr15,72016125,72017866,1741,-1,0,79875,1,57.43825387708210000000
chr15,72017090,72017695,605,-1,0,79875,1,165.28925619834700000000
chr15,72017124,72017484,360,-1,0,79875,1,277.77777777777800000000
chr15,72217335,72217782,447,-1,0,4649,1,223.71364653243800000000
chr15,72223387,72225180,1793,-1,0,4649,1,55.77244841048520000000
chr15,72288925,72291675,2750,-1,0,4649,1,36.36363636363640000000
chr15,72385964,72388158,2194,-1,0,4649,1,45.57885141294440000000
chr15,72568155,72568503,348,-1,0,,0,0.00000000000000000000
chr15,72568248,72568450,202,-1,0,,0,0.00000000000000000000
chr15,72568265,72568357,92,-1,0,,0,0.00000000000000000000
chr15,72572146,72575628,3482,-1,0,,0,0.00000000000000000000
chr15,72719320,72723571,4251,-1,0,,0,0.00000000000000000000
chr15,73152595,73155369,2774,-1,0,,0,0.00000000000000000000
chr15,73483608,73483972,364,-1,0,4756,1,274.72527472527500000000
chr15,73483750,73483911,161,-1,0,4756,1,621.11801242236000000000
chr15,73660021,73661346,1325,-1,0,10021,1,75.47169811320750000000
chr15,73724138,73725007,869,-1,0,,0,0.00000000000000000000
chr15,73808435,73811198,2763,-1,0,283677,1,36.19254433586680000000
chr15,73924279,73925101,822,-1,0,27020,1,121.65450121654500000000
chr15,74017294,74026319,9025,-1,0,,0,0.00000000000000000000
chr15,74037231,74037403,172,-1,0,388135,1,581.39534883720900000000
chr15,74163952,74164620,668,-1,0,,0,0.00000000000000000000
chr15,74164204,74164387,183,-1,0,,0,0.00000000000000000000
chr15,74545925,74547629,1704,-1,0,80125,1,58.68544600938970000000
chr15,74892992,74896662,3670,-1,0,,0,0.00000000000000000000
chr15,75013879,75037537,23658,-1,0,1543,1,4.22689999154620000000
chr15,75283152,75283603,451,-1,0,,0,0.00000000000000000000
chr15,75283321,75283452,131,-1,0,,0,0.00000000000000000000
chr15,75493915,75536155,42240,-1,0,105376731;56905,2,4.73484848484848000000
chr15,75547276,75580276,33000,-1,0,653643;653641,2,6.06060606060606000000
chr15,77502165,77604150,101985,-1,0,79834,1,0.98053635338530200000
chr15,77567142,77673459,106317,-1,0,79834,1,0.94058334979354200000
chr15,76876253,76895772,19519,-1,0,49855,1,5.12321327936882000000
chr15,76883667,76897463,13796,-1,0,49855,1,7.24847781965787000000
chr15,77660793,77673914,13121,-1,0,79834,1,7.62137032238396000000
chr15,76891305,76902829,11524,-1,0,49855,1,8.67754251995835000000
chr15,76336210,76347170,10960,-1,0,,0,0.00000000000000000000
chr15,76087704,76098650,10946,-1,0,,0,0.00000000000000000000
chr15,77635675,77646434,10759,-1,0,79834,1,9.29454410261177000000
chr15,76383514,76391200,7686,-1,0,123591,1,13.01066874837370000000
chr15,76891659,76895737,4078,-1,0,49855,1,24.52182442373710000000
chr15,76340932,76346345,5413,-1,0,,0,0.00000000000000000000
chr15,78008467,78012715,4248,-1,0,84894,1,23.54048964218460000000
chr15,76366273,76370816,4543,-1,0,123591,1,22.01188641866610000000
chr15,77330370,77333211,2841,-1,0,,0,0.00000000000000000000
chr15,77772017,77775168,3151,-1,0,10363,1,31.73595683909870000000
chr15,76674318,76677107,2789,-1,0,49855,1,35.85514521333810000000
chr15,78008718,78011171,2453,-1,0,84894,1,40.76640847941300000000
chr15,77330748,77332718,1970,-1,0,,0,0.00000000000000000000
chr15,78111213,78113061,1848,-1,0,84894,1,54.11255411255410000000
chr15,76891313,76893497,2184,-1,0,49855,1,45.78754578754580000000
chr15,78066075,78068130,2055,-1,0,84894,1,48.66180048661800000000
chr15,77588406,77590439,2033,-1,0,79834,1,49.18839153959670000000
chr15,77910349,77912070,1721,-1,0,84894,1,58.10575246949450000000
chr15,76010543,76012003,1460,-1,0,,0,0.00000000000000000000
chr15,77851950,77853173,1223,-1,0,,0,0.00000000000000000000
chr15,77331279,77332551,1272,-1,0,,0,0.00000000000000000000
chr15,77877951,77879186,1235,-1,0,,0,0.00000000000000000000
chr15,77199679,77200770,1091,-1,0,,0,0.00000000000000000000
chr15,77910769,77911339,570,-1,0,84894,1,175.43859649122800000000
chr15,77991528,77992131,603,-1,0,84894,1,165.83747927031500000000
chr15,75867283,75867664,381,-1,0,5780,1,262.46719160105000000000
chr15,78208074,78208469,395,-1,0,,0,0.00000000000000000000
chr15,77910855,77911230,375,-1,0,84894,1,266.66666666666700000000
chr15,77844600,77844647,47,-1,0,,0,0.00000000000000000000
chr15,78849081,78850690,1609,-1,0,,0,0.00000000000000000000
chr15,78924352,78924847,495,-1,0,1143,1,202.02020202020200000000
chr15,79084263,79084355,92,-1,0,11173,1,1086.95652173913000000000
chr15,79262759,79263233,474,-1,0,5923,1,210.97046413502100000000
chr15,79474959,79475130,171,-1,0,,0,0.00000000000000000000
chr15,79475011,79475101,90,-1,0,,0,0.00000000000000000000
chr15,79545426,79554330,8904,-1,0,,0,0.00000000000000000000
chr15,79548355,79554661,6306,-1,0,,0,0.00000000000000000000
chr15,79728752,79731472,2720,-1,0,23251,1,36.76470588235290000000
chr15,79730205,79731758,1553,-1,0,23251,1,64.39150032195750000000
chr15,79730991,79731456,465,-1,0,23251,1,215.05376344086000000000
chr15,79804628,79805573,945,-1,0,,0,0.00000000000000000000
chr15,79804653,79805428,775,-1,0,,0,0.00000000000000000000
chr15,79804633,79804992,359,-1,0,,0,0.00000000000000000000
chr15,79844756,79845173,417,-1,0,,0,0.00000000000000000000
chr15,79844899,79845038,139,-1,0,,0,0.00000000000000000000
chr15,79964794,79972279,7485,-1,0,,0,0.00000000000000000000
chr15,79911524,79911990,466,-1,0,,0,0.00000000000000000000
chr15,79891790,79892270,480,-1,0,,0,0.00000000000000000000
chr15,79969689,79970126,437,-1,0,,0,0.00000000000000000000
chr15,79911592,79911915,323,-1,0,,0,0.00000000000000000000
chr15,80110679,80110969,290,-1,0,,0,0.00000000000000000000
chr15,80166498,80171375,4877,-1,0,10588;100528021,2,41.00881689563260000000
chr15,80190555,80252713,62158,-1,0,100528021;400410,2,3.21760674410374000000
chr15,80199889,80201106,1217,-1,0,100528021;400410,2,164.33853738701700000000
chr15,80520945,80526913,5968,-1,0,,0,0.00000000000000000000
chr15,80859434,80859862,428,-1,0,9915,1,233.64485981308400000000
chr15,81204479,81205960,1481,-1,0,57214,1,67.52194463200540000000
chr15,81351024,81351477,453,-1,0,,0,0.00000000000000000000
chr15,81405644,81406523,879,-1,0,,0,0.00000000000000000000
chr15,81421991,81422482,491,-1,0,,0,0.00000000000000000000
chr15,81677581,81678026,445,-1,0,,0,0.00000000000000000000
chr15,81773679,81781599,7920,-1,0,,0,0.00000000000000000000
chr15,81885633,81886023,390,-1,0,,0,0.00000000000000000000
chr15,81885790,81885875,85,-1,0,,0,0.00000000000000000000
chr15,82092727,82115751,23024,-1,0,,0,0.00000000000000000000
chr15,82237117,82238218,1101,-1,0,,0,0.00000000000000000000
chr15,82396639,82401747,5108,-1,0,,0,0.00000000000000000000
chr15,82565809,82567855,2046,-1,0,283726,1,48.87585532746820000000
chr15,82652953,82663812,10859,-1,0,,0,0.00000000000000000000
chr15,83029242,83040195,10953,-1,0,,0,0.00000000000000000000
chr15,82786423,82792752,6329,-1,0,,0,0.00000000000000000000
chr15,83166248,83177424,11176,-1,0,,0,0.00000000000000000000
chr15,83275212,83275664,452,-1,0,64506,1,221.23893805309700000000
chr15,83275235,83275584,349,-1,0,64506,1,286.53295128939800000000
chr15,83290136,83292204,2068,-1,0,64506,1,48.35589941972920000000
chr15,83414281,83415917,1636,-1,0,,0,0.00000000000000000000
chr15,83551622,83557673,6051,-1,0,9455,1,16.52619401751780000000
chr15,83773752,83774331,579,-1,0,,0,0.00000000000000000000
chr15,83773925,83774201,276,-1,0,,0,0.00000000000000000000
chr15,84071157,84072262,1105,-1,0,,0,0.00000000000000000000
chr15,84086182,84089387,3205,-1,0,,0,0.00000000000000000000
chr15,84087119,84088507,1388,-1,0,,0,0.00000000000000000000
chr15,84280618,84280828,210,-1,0,6457,1,476.19047619047600000000
chr15,84541104,84544378,3274,-1,0,57188,1,30.54367745876600000000
chr15,84542980,84543732,752,-1,0,57188,1,132.97872340425500000000
chr15,84578468,84579553,1085,-1,0,57188,1,92.16589861751150000000
chr15,84604921,84606921,2000,-1,0,57188,1,50.00000000000000000000
chr15,84699238,84707951,8713,-1,0,57188,1,11.47710317915760000000
chr15,84821368,84947937,126569,-1,0,100505679;643707,2,1.58016575938816000000
chr15,84924998,85044270,119272,-1,0,,0,0.00000000000000000000
chr15,85061009,85089935,28926,-1,0,,0,0.00000000000000000000
chr15,84815149,84846202,31053,-1,0,100505679,1,3.22030077609249000000
chr15,85062433,85087047,24614,-1,0,,0,0.00000000000000000000
chr15,85790957,85813712,22755,-1,0,,0,0.00000000000000000000
chr15,85055269,85075365,20096,-1,0,,0,0.00000000000000000000
chr15,85489042,85496788,7746,-1,0,9154,1,12.90988897495480000000
chr15,85242965,85243768,803,-1,0,23478,1,124.53300124533000000000
chr15,85462050,85462194,144,-1,0,9154,1,694.44444444444400000000
chr15,85712881,85712964,83,-1,0,,0,0.00000000000000000000
chr15,85884424,85892822,8398,-1,0,,0,0.00000000000000000000
chr15,85949607,85954241,4634,-1,0,11214,1,21.57962883038410000000
chr15,86056995,86059184,2189,-1,0,11214,1,45.68296025582460000000
chr15,86102802,86102995,193,-1,0,11214,1,518.13471502590700000000
chr15,86102892,86102988,96,-1,0,11214,1,1041.66666666667000000000
chr15,86300559,86301130,571,-1,0,,0,0.00000000000000000000
chr15,86340044,86350642,10598,-1,0,,0,0.00000000000000000000
chr15,86341281,86350039,8758,-1,0,,0,0.00000000000000000000
chr15,86357104,86364236,7132,-1,0,,0,0.00000000000000000000
chr15,86396669,86397224,555,-1,0,,0,0.00000000000000000000
chr15,86511207,86521233,10026,-1,0,,0,0.00000000000000000000
chr15,86538267,86548737,10470,-1,0,,0,0.00000000000000000000
chr15,86628836,86632914,4078,-1,0,123624,1,24.52182442373710000000
chr15,86762674,86770473,7799,-1,0,123624,1,12.82215668675470000000
chr15,86940457,86941736,1279,-1,0,123624,1,78.18608287724790000000
chr15,87827175,87881859,54684,-1,0,,0,0.00000000000000000000
chr15,87819665,87856492,36827,-1,0,,0,0.00000000000000000000
chr15,87899731,87912709,12978,-1,0,,0,0.00000000000000000000
chr15,87905894,87914599,8705,-1,0,,0,0.00000000000000000000
chr15,87904903,87910457,5554,-1,0,,0,0.00000000000000000000
chr15,87577879,87579107,1228,-1,0,,0,0.00000000000000000000
chr15,87529010,87529831,821,-1,0,123624,1,121.80267965895200000000
chr15,87700029,87700474,445,-1,0,,0,0.00000000000000000000
chr15,87890815,87891238,423,-1,0,,0,0.00000000000000000000
chr15,87370559,87370721,162,-1,0,123624,1,617.28395061728400000000
chr15,87890976,87891049,73,-1,0,,0,0.00000000000000000000
chr15,88881305,88881698,393,-1,0,,0,0.00000000000000000000
chr15,88960181,88963133,2952,-1,0,,0,0.00000000000000000000
chr15,89182888,89195778,12890,-1,0,3669,1,7.75795190069821000000
chr15,89254062,89256219,2157,-1,0,,0,0.00000000000000000000
chr15,89269393,89277309,7916,-1,0,,0,0.00000000000000000000
chr15,89398738,89400363,1625,-1,0,176,1,61.53846153846150000000
chr15,89459657,89465704,6047,-1,0,,0,0.00000000000000000000
chr15,89483958,89486566,2608,-1,0,,0,0.00000000000000000000
chr15,89565722,89683294,117572,-1,0,11057,1,0.85054264620828100000
chr15,89582075,89596505,14430,-1,0,,0,0.00000000000000000000
chr15,89602030,89610414,8384,-1,0,,0,0.00000000000000000000
chr15,89548935,89551547,2612,-1,0,,0,0.00000000000000000000
chr15,89554344,89555674,1330,-1,0,,0,0.00000000000000000000
chr15,89868207,89868575,368,-1,0,5428,1,271.73913043478300000000
chr15,89868307,89868505,198,-1,0,5428,1,505.05050505050500000000
chr15,89959493,89961664,2171,-1,0,,0,0.00000000000000000000
chr15,90064846,90117601,52755,-1,0,,0,0.00000000000000000000
chr15,90059240,90061829,2589,-1,0,,0,0.00000000000000000000
chr15,90221890,90237589,15699,-1,0,8800;5346;56964,3,19.10949742021780000000
chr15,90288938,90289430,492,-1,0,,0,0.00000000000000000000
chr15,90505515,90510919,5404,-1,0,,0,0.00000000000000000000
chr15,90535042,90537733,2691,-1,0,,0,0.00000000000000000000
chr15,90790398,90794026,3628,-1,0,,0,0.00000000000000000000
chr15,90799812,90799875,63,-1,0,,0,0.00000000000000000000
chr15,90826757,90858166,31409,-1,0,,0,0.00000000000000000000
chr15,91173885,91174403,518,-1,0,64784,1,193.05019305019300000000
chr15,91173993,91174340,347,-1,0,64784,1,288.18443804034600000000
chr15,91219179,91222795,3616,-1,0,,0,0.00000000000000000000
chr15,91335622,91336624,1002,-1,0,641,1,99.80039920159680000000
chr15,91362340,91362792,452,-1,0,,0,0.00000000000000000000
chr15,91401897,91402416,519,-1,0,,0,0.00000000000000000000
chr15,91402091,91402412,321,-1,0,,0,0.00000000000000000000
chr15,91414323,91415618,1295,-1,0,5045,1,77.22007722007720000000
chr15,91591186,91591673,487,-1,0,,0,0.00000000000000000000
chr15,91813860,91814359,499,-1,0,9899,1,200.40080160320600000000
chr15,91839671,91840376,705,-1,0,9899,1,141.84397163120600000000
chr15,91981522,91989394,7872,-1,0,,0,0.00000000000000000000
chr15,91981832,91983419,1587,-1,0,,0,0.00000000000000000000
chr15,91981567,91982188,621,-1,0,,0,0.00000000000000000000
chr15,92292223,92294203,1980,-1,0,,0,0.00000000000000000000
chr15,92293828,92294237,409,-1,0,,0,0.00000000000000000000
chr15,92354988,92355973,985,-1,0,,0,0.00000000000000000000
chr15,92577240,92579306,2066,-1,0,28232,1,48.40271055179090000000
chr15,92673730,92678135,4405,-1,0,28232,1,22.70147559591370000000
chr15,92674574,92677071,2497,-1,0,28232,1,40.04805766920300000000
chr15,92674937,92676045,1108,-1,0,28232,1,90.25270758122740000000
chr15,93314480,93316000,1520,-1,0,,0,0.00000000000000000000
chr15,93314961,93315498,537,-1,0,,0,0.00000000000000000000
chr15,93400433,93407060,6627,-1,0,,0,0.00000000000000000000
chr15,93515695,93516195,500,-1,0,1106,1,200.00000000000000000000
chr15,93515793,93516109,316,-1,0,1106,1,316.45569620253200000000
chr15,93661930,93663092,1162,-1,0,,0,0.00000000000000000000
chr15,93710935,93711213,278,-1,0,,0,0.00000000000000000000
chr15,93747485,93747550,65,-1,0,,0,0.00000000000000000000
chr15,93809591,93809994,403,-1,0,,0,0.00000000000000000000
chr15,93803680,93804071,391,-1,0,,0,0.00000000000000000000
chr15,93856893,93866136,9243,-1,0,,0,0.00000000000000000000
chr15,93876542,93877247,705,-1,0,,0,0.00000000000000000000
chr15,94149636,94245995,96359,-1,0,,0,0.00000000000000000000
chr15,94136627,94166763,30136,-1,0,,0,0.00000000000000000000
chr15,93888880,93890977,2097,-1,0,,0,0.00000000000000000000
chr15,93897045,93897579,534,-1,0,,0,0.00000000000000000000
chr15,93897034,93897397,363,-1,0,,0,0.00000000000000000000
chr15,94773151,94829155,56004,-1,0,,0,0.00000000000000000000
chr15,94884501,94888447,3946,-1,0,55784,1,25.34211860111510000000
chr15,94886285,94888534,2249,-1,0,55784,1,44.46420631391730000000
chr15,94933285,94933353,68,-1,0,55784,1,1470.58823529412000000000
chr15,95024096,95037565,13469,-1,0,55784,1,7.42445615858638000000
chr15,95116011,95117054,1043,-1,0,,0,0.00000000000000000000
chr15,95227315,95227961,646,-1,0,,0,0.00000000000000000000
chr15,95691770,95692329,559,-1,0,,0,0.00000000000000000000
chr15,95838199,95839079,880,-1,0,,0,0.00000000000000000000
chr15,95989978,95994833,4855,-1,0,,0,0.00000000000000000000
chr15,96043370,96046227,2857,-1,0,,0,0.00000000000000000000
chr15,96581161,96583558,2397,-1,0,,0,0.00000000000000000000
chr15,96581629,96582983,1354,-1,0,,0,0.00000000000000000000
chr15,96655387,96656061,674,-1,0,,0,0.00000000000000000000
chr15,96662195,96662247,52,-1,0,,0,0.00000000000000000000
chr15,96734995,96739820,4825,-1,0,,0,0.00000000000000000000
chr15,96771724,96771775,51,-1,0,,0,0.00000000000000000000
chr15,96813410,96814862,1452,-1,0,,0,0.00000000000000000000
chr15,96873503,96874703,1200,-1,0,7026,1,83.33333333333330000000
chr15,97082435,97090011,7576,-1,0,,0,0.00000000000000000000
chr15,97261231,97269171,7940,-1,0,,0,0.00000000000000000000
chr15,97262968,97263042,74,-1,0,,0,0.00000000000000000000
chr15,97842445,97912014,69569,-1,0,,0,0.00000000000000000000
chr15,97884559,97929683,45124,-1,0,,0,0.00000000000000000000
chr15,97806431,97849797,43366,-1,0,,0,0.00000000000000000000
chr15,97809557,97833310,23753,-1,0,,0,0.00000000000000000000
chr15,97804553,97821662,17109,-1,0,,0,0.00000000000000000000
chr15,97822612,97834370,11758,-1,0,,0,0.00000000000000000000
chr15,97808069,97815360,7291,-1,0,,0,0.00000000000000000000
chr15,98002555,98003408,853,-1,0,,0,0.00000000000000000000
chr15,98226778,98227062,284,-1,0,,0,0.00000000000000000000
chr15,98226901,98227142,241,-1,0,,0,0.00000000000000000000
chr15,98532521,98536491,3970,-1,0,,0,0.00000000000000000000
chr15,98641935,98642588,653,-1,0,,0,0.00000000000000000000
chr15,98598628,98599074,446,-1,0,,0,0.00000000000000000000
chr15,98705998,98706417,419,-1,0,,0,0.00000000000000000000
chr15,98760501,98762233,1732,-1,0,,0,0.00000000000000000000
chr15,98780745,98784505,3760,-1,0,,0,0.00000000000000000000
chr15,98817014,98817425,411,-1,0,,0,0.00000000000000000000
chr15,98842314,98843809,1495,-1,0,,0,0.00000000000000000000
chr15,98842381,98843744,1363,-1,0,,0,0.00000000000000000000
chr15,98899175,98901135,1960,-1,0,,0,0.00000000000000000000
chr15,98900057,98900634,577,-1,0,,0,0.00000000000000000000
chr15,98901380,98901442,62,-1,0,,0,0.00000000000000000000
chr15,99065794,99066130,336,-1,0,,0,0.00000000000000000000
chr15,99065838,99066051,213,-1,0,,0,0.00000000000000000000
chr15,99125300,99125733,433,-1,0,,0,0.00000000000000000000
chr15,99190762,99193816,3054,-1,0,3480,1,32.74394237066140000000
chr15,99191180,99192335,1155,-1,0,3480,1,86.58008658008660000000
chr15,99551813,99556731,4918,-1,0,,0,0.00000000000000000000
chr15,99561083,99562765,1682,-1,0,,0,0.00000000000000000000
chr15,99574393,99575810,1417,-1,0,,0,0.00000000000000000000
chr15,99574507,99575634,1127,-1,0,,0,0.00000000000000000000
chr15,99656392,99657808,1416,-1,0,23336,1,70.62146892655370000000
chr15,99656561,99657404,843,-1,0,23336,1,118.62396204033200000000
chr15,99727060,99734014,6954,-1,0,64927,1,14.38021282714980000000
chr15,100051043,100057687,6644,-1,0,,0,0.00000000000000000000
chr15,100264017,100264546,529,-1,0,,0,0.00000000000000000000
chr15,100339970,100340457,487,-1,0,,0,0.00000000000000000000
chr15,100338287,100338914,627,-1,0,,0,0.00000000000000000000
chr15,100290681,100291064,383,-1,0,,0,0.00000000000000000000
chr15,100340122,100340316,194,-1,0,,0,0.00000000000000000000
chr15,100349143,100349232,89,-1,0,,0,0.00000000000000000000
chr15,100380534,100499975,119441,-1,0,,0,0.00000000000000000000
chr15,100414666,100423723,9057,-1,0,,0,0.00000000000000000000
chr15,100416955,100421995,5040,-1,0,,0,0.00000000000000000000
chr15,100514033,100517018,2985,-1,0,170691,1,33.50083752093800000000
chr15,100466639,100468764,2125,-1,0,,0,0.00000000000000000000
chr15,100542015,100544152,2137,-1,0,170691,1,46.79457182966780000000
chr15,100466875,100468040,1165,-1,0,,0,0.00000000000000000000
chr15,100432614,100433876,1262,-1,0,,0,0.00000000000000000000
chr15,100606429,100607655,1226,-1,0,170691,1,81.56606851549760000000
chr15,100606850,100607365,515,-1,0,170691,1,194.17475728155300000000
chr15,100606996,100607240,244,-1,0,170691,1,409.83606557377000000000
chr15,100609945,100612583,2638,-1,0,170691,1,37.90750568612590000000
chr15,100642522,100642793,271,-1,0,170691,1,369.00369003690000000000
chr15,101043817,101044517,700,-1,0,204219,1,142.85714285714300000000
chr15,101050486,101052544,2058,-1,0,204219,1,48.59086491739550000000
chr15,101051760,101052354,594,-1,0,204219,1,168.35016835016800000000
chr15,101051684,101052108,424,-1,0,204219,1,235.84905660377400000000
chr15,101051833,101052206,373,-1,0,204219,1,268.09651474530800000000
chr15,101094464,101098817,4353,-1,0,,0,0.00000000000000000000
chr15,101122357,101122847,490,-1,0,55180,1,204.08163265306100000000
chr15,101194833,101202184,7351,-1,0,,0,0.00000000000000000000
chr15,101259230,101260513,1283,-1,0,,0,0.00000000000000000000
chr15,101318871,101319100,229,-1,0,,0,0.00000000000000000000
chr15,101341319,101342617,1298,-1,0,,0,0.00000000000000000000
chr15,101341488,101342372,884,-1,0,,0,0.00000000000000000000
chr15,101419325,101420645,1320,-1,0,220,1,75.75757575757580000000
chr15,101449173,101449940,767,-1,0,220,1,130.37809647979100000000
chr15,101452976,101453501,525,-1,0,220,1,190.47619047619000000000
chr15,101453073,101453384,311,-1,0,220,1,321.54340836012900000000
chr15,101592416,101592838,422,-1,0,79705,1,236.96682464455000000000
chr15,101670755,101671294,539,-1,0,,0,0.00000000000000000000
chr15,101694832,101696260,1428,-1,0,,0,0.00000000000000000000
chr15,101706714,101716112,9398,-1,0,22856,1,10.64056182166420000000
chr15,101752689,101757982,5293,-1,0,22856,1,18.89287738522580000000
chr15,101753501,101756415,2914,-1,0,22856,1,34.31708991077560000000
chr15,101754633,101755112,479,-1,0,22856,1,208.76826722338200000000
chr15,101790833,101793744,2911,-1,0,22856,1,34.35245620061830000000
chr15,101791288,101792675,1387,-1,0,22856,1,72.09805335255950000000
chr15,101797279,101798089,810,-1,0,,0,0.00000000000000000000
chr15,102265713,102444178,178465,-1,0,100128108;390648;390649,3,1.68100187711876000000
chr15,102394461,102455168,60707,-1,0,,0,0.00000000000000000000
chr15,102151469,102224601,73132,-1,0,80213;123283,2,2.73478094404638000000
chr15,102430057,102482809,52752,-1,0,26682,1,1.89566272368820000000
chr15,102331823,102395530,63707,-1,0,390648;390649,2,3.13937243944935000000
chr15,102384784,102432054,47270,-1,0,,0,0.00000000000000000000
chr15,102081177,102105540,24363,-1,0,,0,0.00000000000000000000
chr15,102289874,102305952,16078,-1,0,,0,0.00000000000000000000
chr15,102004013,102011479,7466,-1,0,5046,1,13.39405304045000000000
chr15,102110645,102112876,2231,-1,0,,0,0.00000000000000000000
chr15,102227718,102229759,2041,-1,0,123283,1,48.99559039686430000000
chr15,102028912,102030796,1884,-1,0,5046,1,53.07855626326960000000
chr15,101900554,101901060,506,-1,0,5046,1,197.62845849802400000000
chr15,101901386,101901757,371,-1,0,5046,1,269.54177897574100000000
chr16,67112,83172,16060,-1,0,,0,0.00000000000000000000
chr16,215393,234721,19328,-1,0,3049;3042;3039;3040,4,20.69536423841060000000
chr16,196434,209073,12639,-1,0,3050,1,7.91201835588259000000
chr16,86952,94313,7361,-1,0,,0,0.00000000000000000000
chr16,220628,227792,7164,-1,0,3039;3040,2,27.91736460078170000000
chr16,222864,225952,3088,-1,0,3040,1,32.38341968911920000000
chr16,235329,237343,2014,-1,0,,0,0.00000000000000000000
chr16,236140,237950,1810,-1,0,,0,0.00000000000000000000
chr16,209818,210865,1047,-1,0,,0,0.00000000000000000000
chr16,236058,237245,1187,-1,0,,0,0.00000000000000000000
chr16,131689,132151,462,-1,0,4350,1,216.45021645021600000000
chr16,213339,213830,491,-1,0,,0,0.00000000000000000000
chr16,243166,243827,661,-1,0,55692,1,151.28593040847200000000
chr16,273158,274712,1554,-1,0,55692,1,64.35006435006430000000
chr16,296402,300164,3762,-1,0,83986,1,26.58160552897400000000
chr16,294827,296952,2125,-1,0,83986,1,47.05882352941180000000
chr16,380447,429974,49527,-1,0,8312;58986;10573,3,6.05730207765461000000
chr16,462623,464204,1581,-1,0,,0,0.00000000000000000000
chr16,469410,472908,3498,-1,0,,0,0.00000000000000000000
chr16,477823,480884,3061,-1,0,9727,1,32.66906239790920000000
chr16,485695,487890,2195,-1,0,9727,1,45.55808656036450000000
chr16,502807,503155,348,-1,0,9727,1,287.35632183908000000000
chr16,530775,531086,311,-1,0,9727,1,321.54340836012900000000
chr16,543783,544094,311,-1,0,9727,1,321.54340836012900000000
chr16,859186,967355,108169,-1,0,64788;388199,2,1.84895857408315000000
chr16,1156012,1189957,33945,-1,0,,0,0.00000000000000000000
chr16,875427,893248,17821,-1,0,,0,0.00000000000000000000
chr16,866627,873099,6472,-1,0,,0,0.00000000000000000000
chr16,907458,910239,2781,-1,0,64788,1,35.95828838547280000000
chr16,661459,663433,1974,-1,0,57799,1,50.65856129685920000000
chr16,1002945,1004985,2040,-1,0,64788,1,49.01960784313730000000
chr16,907894,909765,1871,-1,0,64788,1,53.44735435595940000000
chr16,998830,1000717,1887,-1,0,64788,1,52.99417064122950000000
chr16,608619,610657,2038,-1,0,146325,1,49.06771344455350000000
chr16,1010291,1012250,1959,-1,0,64788,1,51.04645227156710000000
chr16,1030735,1032634,1899,-1,0,30812,1,52.65929436545550000000
chr16,1002721,1004138,1417,-1,0,64788,1,70.57163020465770000000
chr16,1004373,1005694,1321,-1,0,64788,1,75.70022710068130000000
chr16,866663,868073,1410,-1,0,,0,0.00000000000000000000
chr16,553946,554874,928,-1,0,9727,1,107.75862068965500000000
chr16,1003033,1003931,898,-1,0,64788,1,111.35857461024500000000
chr16,826456,827367,911,-1,0,,0,0.00000000000000000000
chr16,796039,796759,720,-1,0,,0,0.00000000000000000000
chr16,1090953,1091703,750,-1,0,,0,0.00000000000000000000
chr16,972542,973145,603,-1,0,64788,1,165.83747927031500000000
chr16,817387,818027,640,-1,0,10232,1,156.25000000000000000000
chr16,896579,897294,715,-1,0,,0,0.00000000000000000000
chr16,876581,877075,494,-1,0,,0,0.00000000000000000000
chr16,1003428,1004070,642,-1,0,64788,1,155.76323987538900000000
chr16,1010086,1010560,474,-1,0,64788,1,210.97046413502100000000
chr16,799491,799808,317,-1,0,,0,0.00000000000000000000
chr16,943964,944329,365,-1,0,64788,1,273.97260273972600000000
chr16,581449,581861,412,-1,0,6650,1,242.71844660194200000000
chr16,796268,796604,336,-1,0,,0,0.00000000000000000000
chr16,876627,876958,331,-1,0,,0,0.00000000000000000000
chr16,967249,967533,284,-1,0,64788,1,352.11267605633800000000
chr16,1186804,1187034,230,-1,0,,0,0.00000000000000000000
chr16,934670,934897,227,-1,0,64788,1,440.52863436123400000000
chr16,1186738,1186878,140,-1,0,,0,0.00000000000000000000
chr16,967358,967485,127,-1,0,64788,1,787.40157480315000000000
chr16,1010315,1010430,115,-1,0,64788,1,869.56521739130400000000
chr16,953867,954003,136,-1,0,64788,1,735.29411764705900000000
chr16,953681,953773,92,-1,0,64788,1,1086.95652173913000000000
chr16,1310609,1356378,45769,-1,0,,0,0.00000000000000000000
chr16,1276262,1301825,25563,-1,0,7177;64499,2,7.82380784727927000000
chr16,1292979,1305779,12800,-1,0,,0,0.00000000000000000000
chr16,1289937,1295280,5343,-1,0,7177,1,18.71607711023770000000
chr16,1784799,1790515,5716,-1,0,23162,1,17.49475157452760000000
chr16,1354504,1358942,4438,-1,0,,0,0.00000000000000000000
chr16,1786049,1788404,2355,-1,0,23162,1,42.46284501061570000000
chr16,1422870,1424127,1257,-1,0,64718,1,79.55449482895780000000
chr16,1407697,1409043,1346,-1,0,84572,1,74.29420505200590000000
chr16,1359005,1360242,1237,-1,0,7329,1,80.84074373484240000000
chr16,1422899,1423919,1020,-1,0,64718,1,98.03921568627450000000
chr16,1241019,1241871,852,-1,0,8912,1,117.37089201877900000000
chr16,1235638,1236165,527,-1,0,8912,1,189.75332068311200000000
chr16,1241357,1241784,427,-1,0,8912,1,234.19203747072600000000
chr16,1357798,1358212,414,-1,0,,0,0.00000000000000000000
chr16,1358281,1358675,394,-1,0,,0,0.00000000000000000000
chr16,1447359,1447760,401,-1,0,64718,1,249.37655860349100000000
chr16,1298059,1298367,308,-1,0,,0,0.00000000000000000000
chr16,1314569,1314903,334,-1,0,,0,0.00000000000000000000
chr16,1886488,1886800,312,-1,0,254528;81889,2,641.02564102564100000000
chr16,1509456,1509793,337,-1,0,1186,1,296.73590504451000000000
chr16,1778549,1778839,290,-1,0,23162,1,344.82758620689700000000
chr16,1500693,1500940,247,-1,0,1186,1,404.85829959514200000000
chr16,1339821,1339965,144,-1,0,,0,0.00000000000000000000
chr16,2147455,2171925,24470,-1,0,5310,1,4.08663669799755000000
chr16,2179152,2188476,9324,-1,0,5310,1,10.72501072501070000000
chr16,2265877,2292800,26923,-1,0,1775;1632;1877,3,11.14288897968280000000
chr16,2214310,2216085,1775,-1,0,84231,1,56.33802816901410000000
chr16,2212211,2213032,821,-1,0,84231,1,121.80267965895200000000
chr16,2347804,2348434,630,-1,0,21,1,158.73015873015900000000
chr16,2347995,2348156,161,-1,0,21,1,621.11801242236000000000
chr16,2521157,2525956,4799,-1,0,4917;57465,2,41.67534903104810000000
chr16,2651714,2730160,78446,-1,0,5170,1,1.27476225683910000000
chr16,2658361,2670452,12091,-1,0,,0,0.00000000000000000000
chr16,2699044,2705416,6372,-1,0,,0,0.00000000000000000000
chr16,2697932,2700600,2668,-1,0,,0,0.00000000000000000000
chr16,2698573,2699847,1274,-1,0,,0,0.00000000000000000000
chr16,2971715,2986761,15046,-1,0,84256,1,6.64628472683770000000
chr16,2936333,2939359,3026,-1,0,114984,1,33.04692663582290000000
chr16,2969217,2971069,1852,-1,0,84256,1,53.99568034557240000000
chr16,2998188,2998741,553,-1,0,84256,1,180.83182640144700000000
chr16,3061542,3061660,118,-1,0,,0,0.00000000000000000000
chr16,3104507,3123011,18504,-1,0,9235;64386,2,10.80847384349330000000
chr16,3119780,3132831,13051,-1,0,9235,1,7.66224810359359000000
chr16,3116800,3117225,425,-1,0,9235,1,235.29411764705900000000
chr16,3116916,3117096,180,-1,0,9235,1,555.55555555555600000000
chr16,3249243,3254617,5374,-1,0,4992,1,18.60811313732790000000
chr16,3420447,3425030,4583,-1,0,100463285,1,21.81976871045170000000
chr16,3261002,3263391,2389,-1,0,,0,0.00000000000000000000
chr16,3394536,3395347,811,-1,0,,0,0.00000000000000000000
chr16,3263276,3263572,296,-1,0,,0,0.00000000000000000000
chr16,3247579,3247669,90,-1,0,,0,0.00000000000000000000
chr16,3495269,3496737,1468,-1,0,79903,1,68.11989100817440000000
chr16,3519441,3519632,191,-1,0,79903,1,523.56020942408400000000
chr16,3703196,3719649,16453,-1,0,1773;10131,2,12.15583784112320000000
chr16,3752098,3753998,1900,-1,0,10131,1,52.63157894736840000000
chr16,3918272,3918501,229,-1,0,1387,1,436.68122270742400000000
chr16,3929935,3932568,2633,-1,0,1387,1,37.97949107481960000000
chr16,3930106,3931145,1039,-1,0,1387,1,96.24639076034650000000
chr16,3979364,3990363,10999,-1,0,,0,0.00000000000000000000
chr16,3972906,3981152,8246,-1,0,,0,0.00000000000000000000
chr16,3994386,3994814,428,-1,0,,0,0.00000000000000000000
chr16,4067048,4067529,481,-1,0,115,1,207.90020790020800000000
chr16,4134230,4141231,7001,-1,0,115,1,14.28367376089130000000
chr16,4165666,4166856,1190,-1,0,115,1,84.03361344537820000000
chr16,4181471,4181873,402,-1,0,,0,0.00000000000000000000
chr16,4221087,4244756,23669,-1,0,6345,1,4.22493556973256000000
chr16,4251466,4251846,380,-1,0,6345,1,263.15789473684200000000
chr16,4278952,4283951,4999,-1,0,6345,1,20.00400080016000000000
chr16,4300517,4301633,1116,-1,0,,0,0.00000000000000000000
chr16,4365208,4367021,1813,-1,0,84662,1,55.15719801434090000000
chr16,4672101,4672414,313,-1,0,,0,0.00000000000000000000
chr16,4769925,4772356,2431,-1,0,124401,1,41.13533525298230000000
chr16,4762145,4763032,887,-1,0,124401,1,112.73957158962800000000
chr16,4698301,4698566,265,-1,0,23295,1,377.35849056603800000000
chr16,4878155,4879753,1598,-1,0,84656,1,62.57822277847310000000
chr16,5332651,5423999,91348,-1,0,,0,0.00000000000000000000
chr16,5185118,5214480,29362,-1,0,,0,0.00000000000000000000
chr16,5126013,5144525,18512,-1,0,196483;56052,2,10.80380293863440000000
chr16,5607954,5615945,7991,-1,0,,0,0.00000000000000000000
chr16,5195693,5201162,5469,-1,0,,0,0.00000000000000000000
chr16,5107141,5111446,4305,-1,0,146556,1,23.22880371660860000000
chr16,5426553,5429618,3065,-1,0,,0,0.00000000000000000000
chr16,5180173,5180666,493,-1,0,,0,0.00000000000000000000
chr16,5537971,5538464,493,-1,0,,0,0.00000000000000000000
chr16,5177614,5177990,376,-1,0,,0,0.00000000000000000000
chr16,5709256,5710348,1092,-1,0,,0,0.00000000000000000000
chr16,6118787,7010453,891666,-1,0,54715,1,0.11214961656046100000
chr16,6834998,7085275,250277,-1,0,54715,1,0.39955729052210200000
chr16,6506896,6737966,231070,-1,0,54715,1,0.43276929069113300000
chr16,6939023,7194105,255082,-1,0,54715,1,0.39203079793948600000
chr16,6829648,6953712,124064,-1,0,54715,1,0.80603559453185500000
chr16,6678974,6852555,173581,-1,0,54715,1,0.57609991876991200000
chr16,6978388,7094907,116519,-1,0,54715,1,0.85822913001313100000
chr16,6895898,7015031,119133,-1,0,54715,1,0.83939798376604300000
chr16,7037927,7119534,81607,-1,0,54715,1,1.22538507726053000000
chr16,6296157,6394020,97863,-1,0,54715,1,1.02183664919326000000
chr16,6763793,6851869,88076,-1,0,54715,1,1.13538307825060000000
chr16,6875510,6953004,77494,-1,0,54715,1,1.29042248432137000000
chr16,6946408,6999850,53442,-1,0,54715,1,1.87118745555930000000
chr16,6621149,6677967,56818,-1,0,54715,1,1.76000563201802000000
chr16,6838920,6895552,56632,-1,0,54715,1,1.76578612798418000000
chr16,6974971,7036206,61235,-1,0,54715,1,1.63305299256961000000
chr16,6904896,6956637,51741,-1,0,54715,1,1.93270327206664000000
chr16,6873405,6915404,41999,-1,0,54715,1,2.38100907164456000000
chr16,6811406,6844341,32935,-1,0,54715,1,3.03628358888720000000
chr16,7221863,7260330,38467,-1,0,54715,1,2.59963085241896000000
chr16,6949378,6983544,34166,-1,0,54715,1,2.92688637827080000000
chr16,7061892,7088083,26191,-1,0,54715,1,3.81810545607270000000
chr16,6829917,6856884,26967,-1,0,54715,1,3.70823599213854000000
chr16,6442767,6475578,32811,-1,0,54715,1,3.04775837371613000000
chr16,7093181,7124671,31490,-1,0,54715,1,3.17561130517625000000
chr16,6775358,6805033,29675,-1,0,54715,1,3.36983993260320000000
chr16,6931485,6954017,22532,-1,0,54715,1,4.43813243387183000000
chr16,6637292,6661476,24184,-1,0,54715,1,4.13496526629176000000
chr16,6516370,6530840,14470,-1,0,54715,1,6.91085003455425000000
chr16,6663587,6676676,13089,-1,0,54715,1,7.64000305600122000000
chr16,7044867,7056248,11381,-1,0,54715,1,8.78657411475266000000
chr16,7086614,7092318,5704,-1,0,54715,1,17.53155680224400000000
chr16,6951759,6959026,7267,-1,0,54715,1,13.76083665886890000000
chr16,7138676,7144973,6297,-1,0,54715,1,15.88057805304110000000
chr16,6321359,6325247,3888,-1,0,54715,1,25.72016460905350000000
chr16,6274433,6277210,2777,-1,0,54715,1,36.01008282319050000000
chr16,6776990,6779339,2349,-1,0,54715,1,42.57130693912300000000
chr16,6695947,6697829,1882,-1,0,54715,1,53.13496280552600000000
chr16,5773100,5773732,632,-1,0,,0,0.00000000000000000000
chr16,6957717,6958470,753,-1,0,54715,1,132.80212483399700000000
chr16,5773181,5773630,449,-1,0,,0,0.00000000000000000000
chr16,5773326,5773426,100,-1,0,,0,0.00000000000000000000
chr16,6909125,6909193,68,-1,0,54715,1,1470.58823529412000000000
chr16,7421858,7423714,1856,-1,0,54715,1,53.87931034482760000000
chr16,7912730,7979544,66814,-1,0,,0,0.00000000000000000000
chr16,8592907,8606519,13612,-1,0,283953,1,7.34645900675874000000
chr16,8106901,8112100,5199,-1,0,,0,0.00000000000000000000
chr16,8121613,8124917,3304,-1,0,,0,0.00000000000000000000
chr16,8076998,8080163,3165,-1,0,,0,0.00000000000000000000
chr16,8228504,8230513,2009,-1,0,,0,0.00000000000000000000
chr16,8483141,8484145,1004,-1,0,,0,0.00000000000000000000
chr16,8206579,8207527,948,-1,0,,0,0.00000000000000000000
chr16,8159010,8159806,796,-1,0,,0,0.00000000000000000000
chr16,8066525,8067040,515,-1,0,,0,0.00000000000000000000
chr16,8066596,8066933,337,-1,0,,0,0.00000000000000000000
chr16,8614207,8614922,715,-1,0,283953,1,139.86013986014000000000
chr16,8614245,8614630,385,-1,0,283953,1,259.74025974026000000000
chr16,8614849,8614915,66,-1,0,283953,1,1515.15151515152000000000
chr16,8688168,8689563,1395,-1,0,,0,0.00000000000000000000
chr16,8755311,8756842,1531,-1,0,,0,0.00000000000000000000
chr16,8755916,8756617,701,-1,0,,0,0.00000000000000000000
chr16,8756200,8756734,534,-1,0,,0,0.00000000000000000000
chr16,8775104,8775756,652,-1,0,18,1,153.37423312883400000000
chr16,8826043,8827721,1678,-1,0,18,1,59.59475566150180000000
chr16,8926797,8939700,12903,-1,0,5373,1,7.75013562737348000000
chr16,8972112,8977450,5338,-1,0,,0,0.00000000000000000000
chr16,9007189,9008297,1108,-1,0,7874,1,90.25270758122740000000
chr16,9078503,9081200,2697,-1,0,,0,0.00000000000000000000
chr16,9125961,9126605,644,-1,0,,0,0.00000000000000000000
chr16,9386730,9411962,25232,-1,0,,0,0.00000000000000000000
chr16,9406817,9407253,436,-1,0,,0,0.00000000000000000000
chr16,9754931,9801990,47059,-1,0,,0,0.00000000000000000000
chr16,9780915,9825049,44134,-1,0,,0,0.00000000000000000000
chr16,10350581,10356052,5471,-1,0,,0,0.00000000000000000000
chr16,10362032,10362591,559,-1,0,,0,0.00000000000000000000
chr16,10362263,10362419,156,-1,0,,0,0.00000000000000000000
chr16,10367899,10392893,24994,-1,0,,0,0.00000000000000000000
chr16,10383396,10404597,21201,-1,0,,0,0.00000000000000000000
chr16,10414480,10423391,8911,-1,0,,0,0.00000000000000000000
chr16,10428072,10434282,6210,-1,0,,0,0.00000000000000000000
chr16,10621415,10626355,4940,-1,0,2013,1,20.24291497975710000000
chr16,10484374,10487677,3303,-1,0,80063,1,30.27550711474420000000
chr16,10678501,10686450,7949,-1,0,,0,0.00000000000000000000
chr16,10726844,10730026,3182,-1,0,146279,1,31.42677561282210000000
chr16,10771057,10771584,527,-1,0,146279,1,189.75332068311200000000
chr16,10791045,10791276,231,-1,0,,0,0.00000000000000000000
chr16,10880365,10880786,421,-1,0,780776,1,237.52969121140100000000
chr16,10925012,10925630,618,-1,0,,0,0.00000000000000000000
chr16,11299557,11302469,2912,-1,0,,0,0.00000000000000000000
chr16,11389020,11389151,131,-1,0,,0,0.00000000000000000000
chr16,11435562,11436640,1078,-1,0,,0,0.00000000000000000000
chr16,11468965,11469430,465,-1,0,,0,0.00000000000000000000
chr16,11603744,11605028,1284,-1,0,,0,0.00000000000000000000
chr16,11683731,11685292,1561,-1,0,,0,0.00000000000000000000
chr16,11759754,11761469,1715,-1,0,,0,0.00000000000000000000
chr16,11866094,11867932,1838,-1,0,29066,1,54.40696409140370000000
chr16,12002277,12002709,432,-1,0,2935,1,231.48148148148100000000
chr16,12002356,12002683,327,-1,0,2935,1,305.81039755351700000000
chr16,12106360,12107618,1258,-1,0,92017,1,79.49125596184420000000
chr16,12178336,12209264,30928,-1,0,92017,1,3.23331608898086000000
chr16,12412467,12430090,17623,-1,0,92017,1,5.67440276910855000000
chr16,12650782,12671326,20544,-1,0,92017,1,4.86760124610592000000
chr16,12640348,12651351,11003,-1,0,92017,1,9.08843042806507000000
chr16,12656667,12659421,2754,-1,0,92017,1,36.31082062454610000000
chr16,12817539,12880961,63422,-1,0,55313,1,1.57673993251553000000
chr16,12682137,12712958,30821,-1,0,,0,0.00000000000000000000
chr16,12725451,12745658,20207,-1,0,,0,0.00000000000000000000
chr16,12792415,12809893,17478,-1,0,55313,1,5.72147843002632000000
chr16,12688918,12706469,17551,-1,0,,0,0.00000000000000000000
chr16,12721875,12736420,14545,-1,0,,0,0.00000000000000000000
chr16,12900343,12903158,2815,-1,0,,0,0.00000000000000000000
chr16,13293929,13298301,4372,-1,0,729993,1,22.87282708142730000000
chr16,13294450,13296484,2034,-1,0,729993,1,49.16420845624390000000
chr16,13479364,13479571,207,-1,0,,0,0.00000000000000000000
chr16,13623743,13624696,953,-1,0,,0,0.00000000000000000000
chr16,13505777,13506657,880,-1,0,,0,0.00000000000000000000
chr16,13835703,13841009,5306,-1,0,,0,0.00000000000000000000
chr16,13944335,13944439,104,-1,0,,0,0.00000000000000000000
chr16,14075376,14075818,442,-1,0,,0,0.00000000000000000000
chr16,14075621,14075741,120,-1,0,,0,0.00000000000000000000
chr16,14152597,14153892,1295,-1,0,,0,0.00000000000000000000
chr16,14469488,14471602,2114,-1,0,,0,0.00000000000000000000
chr16,14453181,14453599,418,-1,0,,0,0.00000000000000000000
chr16,14470499,14470811,312,-1,0,,0,0.00000000000000000000
chr16,14499798,14505289,5491,-1,0,,0,0.00000000000000000000
chr16,14549468,14550607,1139,-1,0,5073,1,87.79631255487270000000
chr16,15385949,18341768,2955819,-1,0,4629;100288332;123811;64131;89927;4363;54820;408050;255027;101059938;368;9665,12,0.40597885053178200000
chr16,18238276,18792698,554422,-1,0,283820;101059953,2,0.36073604582790700000
chr16,16346849,16755894,409045,-1,0,408050;101059938,2,0.48894375924409300000
chr16,15069651,15416501,346850,-1,0,23042;54700;123803,3,0.86492720196050200000
chr16,16608004,16818569,210565,-1,0,,0,0.00000000000000000000
chr16,16519038,16692527,173489,-1,0,,0,0.00000000000000000000
chr16,18568369,18753579,185210,-1,0,283820,1,0.53992764969494100000
chr16,14982728,15106557,123829,-1,0,23042;23420;9284,3,2.42269581438920000000
chr16,16629826,16763836,134010,-1,0,,0,0.00000000000000000000
chr16,18585837,18678111,92274,-1,0,,0,0.00000000000000000000
chr16,14929482,15053870,124388,-1,0,23420;9284,2,1.60787214200727000000
chr16,15035460,15124440,88980,-1,0,23042;9284,2,2.24769611148573000000
chr16,16626586,16691420,64834,-1,0,,0,0.00000000000000000000
chr16,14777401,14865091,87690,-1,0,642799;642778;8399,3,3.42114266164899000000
chr16,15126231,15186299,60068,-1,0,23042;54700;123803,3,4.99433974828528000000
chr16,15052001,15105835,53834,-1,0,23042,1,1.85756213545343000000
chr16,15049291,15086431,37140,-1,0,23042,1,2.69251480883145000000
chr16,16445591,16471902,26311,-1,0,,0,0.00000000000000000000
chr16,18491265,18514972,23707,-1,0,283820,1,4.21816341165057000000
chr16,15220347,15243687,23340,-1,0,23042,1,4.28449014567266000000
chr16,14813001,14839100,26099,-1,0,642778,1,3.83156442775585000000
chr16,14782636,14802363,19727,-1,0,8399,1,5.06919450499316000000
chr16,14988647,15007312,18665,-1,0,23420,1,5.35762121618002000000
chr16,16387627,16407543,19916,-1,0,408050,1,5.02108857200241000000
chr16,16246225,16260621,14396,-1,0,368,1,6.94637399277577000000
chr16,16631704,16651111,19407,-1,0,,0,0.00000000000000000000
chr16,15048931,15061372,12441,-1,0,,0,0.00000000000000000000
chr16,15242959,15254556,11597,-1,0,,0,0.00000000000000000000
chr16,14788236,14797219,8983,-1,0,8399,1,11.13213848380270000000
chr16,17804927,17813770,8843,-1,0,,0,0.00000000000000000000
chr16,17475712,17479784,4072,-1,0,64131,1,24.55795677799610000000
chr16,16934087,16940675,6588,-1,0,,0,0.00000000000000000000
chr16,18069786,18076179,6393,-1,0,,0,0.00000000000000000000
chr16,16071328,16077429,6101,-1,0,4363,1,16.39075561383380000000
chr16,16000774,16006144,5370,-1,0,,0,0.00000000000000000000
chr16,16457766,16462977,5211,-1,0,,0,0.00000000000000000000
chr16,15669951,15674467,4516,-1,0,89927,1,22.14348981399470000000
chr16,15559845,15564227,4382,-1,0,89927,1,22.82062984938380000000
chr16,16726671,16730779,4108,-1,0,,0,0.00000000000000000000
chr16,17166614,17170685,4071,-1,0,,0,0.00000000000000000000
chr16,18099814,18103056,3242,-1,0,,0,0.00000000000000000000
chr16,17655115,17656243,1128,-1,0,,0,0.00000000000000000000
chr16,16013935,16016027,2092,-1,0,,0,0.00000000000000000000
chr16,15745817,15747698,1881,-1,0,54820,1,53.16321105794790000000
chr16,16715125,16716872,1747,-1,0,,0,0.00000000000000000000
chr16,15501737,15502999,1262,-1,0,255027,1,79.23930269413630000000
chr16,17172689,17173939,1250,-1,0,,0,0.00000000000000000000
chr16,17655142,17656228,1086,-1,0,,0,0.00000000000000000000
chr16,15869052,15869524,472,-1,0,4629,1,211.86440677966100000000
chr16,16127510,16128195,685,-1,0,4363,1,145.98540145985400000000
chr16,17664255,17664876,621,-1,0,,0,0.00000000000000000000
chr16,16097223,16097737,514,-1,0,4363,1,194.55252918287900000000
chr16,17864602,17865095,493,-1,0,,0,0.00000000000000000000
chr16,16096992,16097355,363,-1,0,4363,1,275.48209366391200000000
chr16,15198233,15198493,260,-1,0,23042,1,384.61538461538500000000
chr16,17126194,17126292,98,-1,0,,0,0.00000000000000000000
chr16,15869266,15869316,50,-1,0,4629,1,2000.00000000000000000000
chr16,18832365,18838792,6427,-1,0,23049,1,15.55935895441110000000
chr16,18922859,18929052,6193,-1,0,23049,1,16.14726303891490000000
chr16,18967329,18967914,585,-1,0,,0,0.00000000000000000000
chr16,19230349,19230912,563,-1,0,51760,1,177.61989342806400000000
chr16,19230442,19230802,360,-1,0,51760,1,277.77777777777800000000
chr16,19460452,19463011,2559,-1,0,79838,1,39.07776475185620000000
chr16,19476290,19476395,105,-1,0,79838,1,952.38095238095300000000
chr16,19506221,19506742,521,-1,0,79838,1,191.93857965451100000000
chr16,19506316,19506635,319,-1,0,79838,1,313.47962382445100000000
chr16,19718698,19719354,656,-1,0,400506,1,152.43902439024400000000
chr16,19945488,19970642,25154,-1,0,,0,0.00000000000000000000
chr16,19946207,19960647,14440,-1,0,,0,0.00000000000000000000
chr16,19961561,19972670,11109,-1,0,,0,0.00000000000000000000
chr16,19959365,19966090,6725,-1,0,,0,0.00000000000000000000
chr16,19988417,19992937,4520,-1,0,,0,0.00000000000000000000
chr16,20177322,20180087,2765,-1,0,,0,0.00000000000000000000
chr16,20481022,20546709,65687,-1,0,123876,1,1.52237124545192000000
chr16,20545828,20579930,34102,-1,0,348158,1,2.93237933259046000000
chr16,20509848,20542977,33129,-1,0,,0,0.00000000000000000000
chr16,20515757,20531531,15774,-1,0,,0,0.00000000000000000000
chr16,20553074,20568333,15259,-1,0,348158,1,6.55350940428600000000
chr16,20545319,20554567,9248,-1,0,348158,1,10.81314878892730000000
chr16,20541999,20550237,8238,-1,0,348158,1,12.13886865744110000000
chr16,20451145,20451976,831,-1,0,54988,1,120.33694344163700000000
chr16,20778459,20779035,576,-1,0,6296,1,173.61111111111100000000
chr16,20778541,20778861,320,-1,0,6296,1,312.50000000000000000000
chr16,21791339,22608600,817261,-1,0,730094;440345;100132247;29904;7385;1039;146177;55718;255762,9,1.10123938374644000000
chr16,21560936,21830892,269956,-1,0,51108;10261;146183,3,1.11129221058247000000
chr16,22541620,22713376,171756,-1,0,100132247,1,0.58222129066815700000
chr16,21413036,21594109,181073,-1,0,23117,1,0.55226345175702600000
chr16,21603978,21743001,139023,-1,0,51108;10261;146183,3,2.15791631600527000000
chr16,22622554,22713596,91042,-1,0,,0,0.00000000000000000000
chr16,21515144,21591325,76181,-1,0,,0,0.00000000000000000000
chr16,22625636,22674933,49297,-1,0,,0,0.00000000000000000000
chr16,22655473,22698520,43047,-1,0,,0,0.00000000000000000000
chr16,21565053,21593811,28758,-1,0,,0,0.00000000000000000000
chr16,22676219,22703073,26854,-1,0,,0,0.00000000000000000000
chr16,22190989,22199285,8296,-1,0,,0,0.00000000000000000000
chr16,22086976,22092200,5224,-1,0,730094,1,19.14241960183770000000
chr16,22707199,22707379,180,-1,0,,0,0.00000000000000000000
chr16,22707259,22707404,145,-1,0,,0,0.00000000000000000000
chr16,22908906,22909355,449,-1,0,9956,1,222.71714922049000000000
chr16,22908972,22909251,279,-1,0,9956,1,358.42293906810000000000
chr16,22988532,22996520,7988,-1,0,,0,0.00000000000000000000
chr16,23046501,23051078,4577,-1,0,,0,0.00000000000000000000
chr16,23047726,23049533,1807,-1,0,,0,0.00000000000000000000
chr16,23159867,23160834,967,-1,0,57478,1,103.41261633919300000000
chr16,23283423,23283961,538,-1,0,,0,0.00000000000000000000
chr16,23473513,23475088,1575,-1,0,23062,1,63.49206349206350000000
chr16,23474072,23474453,381,-1,0,,0,0.00000000000000000000
chr16,23528431,23528965,534,-1,0,,0,0.00000000000000000000
chr16,23528500,23528833,333,-1,0,,0,0.00000000000000000000
chr16,23588733,23589004,271,-1,0,,0,0.00000000000000000000
chr16,23654480,23656564,2084,-1,0,84516,1,47.98464491362760000000
chr16,23760372,23762235,1863,-1,0,,0,0.00000000000000000000
chr16,23803490,23805227,1737,-1,0,,0,0.00000000000000000000
chr16,23910199,23911430,1231,-1,0,5579,1,81.23476848090980000000
chr16,23910837,23911261,424,-1,0,5579,1,235.84905660377400000000
chr16,23910887,23911192,305,-1,0,5579,1,327.86885245901600000000
chr16,23934068,23943071,9003,-1,0,5579,1,11.10740864156390000000
chr16,24126532,24126821,289,-1,0,5579,1,346.02076124567500000000
chr16,24136201,24136677,476,-1,0,5579,1,210.08403361344500000000
chr16,24328948,24329039,91,-1,0,10368,1,1098.90109890110000000000
chr16,24396426,24398388,1962,-1,0,,0,0.00000000000000000000
chr16,24538822,24546295,7473,-1,0,,0,0.00000000000000000000
chr16,24541581,24546370,4789,-1,0,,0,0.00000000000000000000
chr16,24592933,24598731,5798,-1,0,,0,0.00000000000000000000
chr16,24606886,24608273,1387,-1,0,,0,0.00000000000000000000
chr16,24864017,24864413,396,-1,0,115584,1,252.52525252525300000000
chr16,24916574,24917852,1278,-1,0,115584,1,78.24726134585290000000
chr16,25066146,25137378,71232,-1,0,51451,1,1.40386343216532000000
chr16,25115651,25116907,1256,-1,0,,0,0.00000000000000000000
chr16,25204941,25207929,2988,-1,0,,0,0.00000000000000000000
chr16,25229997,25231163,1166,-1,0,343,1,85.76329331046310000000
chr16,25339870,25343416,3546,-1,0,,0,0.00000000000000000000
chr16,25340968,25343048,2080,-1,0,,0,0.00000000000000000000
chr16,25543302,25544280,978,-1,0,,0,0.00000000000000000000
chr16,25623553,25623861,308,-1,0,,0,0.00000000000000000000
chr16,25639116,25640521,1405,-1,0,,0,0.00000000000000000000
chr16,25639368,25640145,777,-1,0,,0,0.00000000000000000000
chr16,25721773,25721835,62,-1,0,9951,1,1612.90322580645000000000
chr16,25825637,25836193,10556,-1,0,9951,1,9.47328533535430000000
chr16,25946749,26023518,76769,-1,0,9951,1,1.30260912607954000000
chr16,26376643,26377057,414,-1,0,,0,0.00000000000000000000
chr16,26383485,26388385,4900,-1,0,,0,0.00000000000000000000
chr16,26383372,26383758,386,-1,0,,0,0.00000000000000000000
chr16,26607949,26608355,406,-1,0,,0,0.00000000000000000000
chr16,26608031,26608339,308,-1,0,,0,0.00000000000000000000
chr16,26822964,26825650,2686,-1,0,,0,0.00000000000000000000
chr16,26824401,26826000,1599,-1,0,,0,0.00000000000000000000
chr16,26822960,26823714,754,-1,0,,0,0.00000000000000000000
chr16,26916921,26919500,2579,-1,0,,0,0.00000000000000000000
chr16,26963253,26963386,133,-1,0,,0,0.00000000000000000000
chr16,26980087,26980132,45,-1,0,,0,0.00000000000000000000
chr16,27050095,27050259,164,-1,0,,0,0.00000000000000000000
chr16,27077621,27103704,26083,-1,0,162083,1,3.83391481041291000000
chr16,27306342,27307449,1107,-1,0,,0,0.00000000000000000000
chr16,27306864,27307544,680,-1,0,,0,0.00000000000000000000
chr16,27317475,27317740,265,-1,0,,0,0.00000000000000000000
chr16,27335891,27351221,15330,-1,0,3566,1,6.52315720808872000000
chr16,27340746,27350820,10074,-1,0,3566,1,9.92654357752630000000
chr16,27445859,27447410,1551,-1,0,50615,1,64.47453255963890000000
chr16,27853422,27853526,104,-1,0,146395,1,961.53846153846200000000
chr16,27853359,27853436,77,-1,0,146395,1,1298.70129870130000000000
chr16,27880225,27882474,2249,-1,0,146395,1,44.46420631391730000000
chr16,27881081,27881702,621,-1,0,146395,1,161.03059581320500000000
chr16,27899783,27899875,92,-1,0,146395,1,1086.95652173913000000000
chr16,28133258,28134779,1521,-1,0,23214,1,65.74621959237340000000
chr16,28364001,28468926,104925,-1,0,728689;728741,2,1.90612342149154000000
chr16,28376276,28418578,42302,-1,0,728689,1,2.36395442295873000000
chr16,28416713,28426990,10277,-1,0,,0,0.00000000000000000000
chr16,28419899,28426320,6421,-1,0,,0,0.00000000000000000000
chr16,28497261,28498282,1021,-1,0,1201,1,97.94319294809010000000
chr16,28669919,28835288,165369,-1,0,8663;11273;100507607;728734,4,2.41883303400275000000
chr16,28700869,28762991,62122,-1,0,8663,1,1.60973568140111000000
chr16,28717453,28758317,40864,-1,0,8663,1,2.44714173844949000000
chr16,28609159,28626645,17486,-1,0,6817,1,5.71886080292806000000
chr16,28607324,28620288,12964,-1,0,6817;6799,2,15.42733724159210000000
chr16,28710304,28721175,10871,-1,0,8663,1,9.19878576027964000000
chr16,28614549,28626915,12366,-1,0,6817,1,8.08668930939673000000
chr16,28614099,28620710,6611,-1,0,6817,1,15.12630464377550000000
chr16,28711878,28718874,6996,-1,0,8663,1,14.29388221841050000000
chr16,28614803,28618240,3437,-1,0,6817,1,29.09514111143440000000
chr16,29005315,29009599,4284,-1,0,,0,0.00000000000000000000
chr16,28896339,28898087,1748,-1,0,487,1,57.20823798627000000000
chr16,28834139,28835740,1601,-1,0,11273,1,62.46096189881320000000
chr16,29005314,29005757,443,-1,0,,0,0.00000000000000000000
chr16,29088128,29088193,65,-1,0,,0,0.00000000000000000000
chr16,29131635,29134046,2411,-1,0,,0,0.00000000000000000000
chr16,29132881,29133995,1114,-1,0,,0,0.00000000000000000000
chr16,29208507,29208642,135,-1,0,,0,0.00000000000000000000
chr16,29235571,29237541,1970,-1,0,,0,0.00000000000000000000
chr16,29301551,29304349,2798,-1,0,,0,0.00000000000000000000
chr16,29309900,29310347,447,-1,0,,0,0.00000000000000000000
chr16,29583834,30200124,616290,-1,0,653808;5531;26470;283897;253980;146378;8479;83719;23475;283899;124446;9344;3835;4150;226;253982;83723;5595;6911;11151;8448;79447;112476;9961;10423;6693;79153,27,4.38105437375262000000
chr16,29450226,29556530,106304,-1,0,552900;107282092;79008;445329,4,3.76279349789284000000
chr16,29719557,29741524,21967,-1,0,,0,0.00000000000000000000
chr16,29718106,29722777,4671,-1,0,,0,0.00000000000000000000
chr16,30083202,30085396,2194,-1,0,,0,0.00000000000000000000
chr16,29558759,29559162,403,-1,0,,0,0.00000000000000000000
chr16,30339425,30345083,5658,-1,0,,0,0.00000000000000000000
chr16,30983722,30989411,5689,-1,0,9739,1,17.57778168395150000000
chr16,31327266,31327650,384,-1,0,3684,1,260.41666666666700000000
chr16,31327317,31327548,231,-1,0,3684,1,432.90043290043300000000
chr16,31526846,31821487,294641,-1,0,51327;124411,2,0.67879215723541500000
chr16,31566463,31566515,52,-1,0,,0,0.00000000000000000000
chr16,31921458,31924291,2833,-1,0,10308,1,35.29827038475110000000
chr16,32290812,33399673,1108861,-1,0,653550;24150;729355,3,0.27054788652500200000
chr16,32097585,33055496,957911,-1,0,729264;24150,2,0.20878766398966100000
chr16,32846900,33694121,847221,-1,0,653550;729355,2,0.23606591432459800000
chr16,32591494,33167760,576266,-1,0,24150,1,0.17353097354346800000
chr16,33087189,33719983,632794,-1,0,653550;729355,2,0.31605862255331100000
chr16,32054579,32640710,586131,-1,0,729264,1,0.17061032431316500000
chr16,32427742,32858366,430624,-1,0,24150,1,0.23222114884446800000
chr16,33346194,33787862,441668,-1,0,,0,0.00000000000000000000
chr16,32354698,32654321,299623,-1,0,,0,0.00000000000000000000
chr16,32109624,32473817,364193,-1,0,729264,1,0.27457968714390400000
chr16,32742872,33075133,332261,-1,0,,0,0.00000000000000000000
chr16,33340924,33629021,288097,-1,0,,0,0.00000000000000000000
chr16,32555952,32856129,300177,-1,0,24150,1,0.33313678263158100000
chr16,32254559,32514485,259926,-1,0,729264,1,0.38472488323599800000
chr16,33804014,34009293,205279,-1,0,,0,0.00000000000000000000
chr16,32588832,32861382,272550,-1,0,24150,1,0.36690515501742800000
chr16,32825000,33076605,251605,-1,0,,0,0.00000000000000000000
chr16,33430920,33619200,188280,-1,0,,0,0.00000000000000000000
chr16,33594665,33827317,232652,-1,0,,0,0.00000000000000000000
chr16,32427468,32648586,221118,-1,0,,0,0.00000000000000000000
chr16,32107587,32293816,186229,-1,0,729264,1,0.53697329631797400000
chr16,33491393,33623828,132435,-1,0,,0,0.00000000000000000000
chr16,32559992,32660947,100955,-1,0,,0,0.00000000000000000000
chr16,32609905,32728699,118794,-1,0,24150,1,0.84179335656683000000
chr16,33184931,33293938,109007,-1,0,653550;729355,2,1.83474455768896000000
chr16,32502787,32621982,119195,-1,0,,0,0.00000000000000000000
chr16,33414461,33496312,81851,-1,0,,0,0.00000000000000000000
chr16,33827056,33926621,99565,-1,0,,0,0.00000000000000000000
chr16,32479780,32555821,76041,-1,0,,0,0.00000000000000000000
chr16,32558569,32628925,70356,-1,0,,0,0.00000000000000000000
chr16,33371243,33462907,91664,-1,0,,0,0.00000000000000000000
chr16,33528552,33611636,83084,-1,0,,0,0.00000000000000000000
chr16,32243614,32297546,53932,-1,0,729264,1,1.85418675368983000000
chr16,32366548,32413142,46594,-1,0,,0,0.00000000000000000000
chr16,33571781,33643122,71341,-1,0,,0,0.00000000000000000000
chr16,33883953,33956617,72664,-1,0,,0,0.00000000000000000000
chr16,33595415,33642955,47540,-1,0,,0,0.00000000000000000000
chr16,32587888,32650139,62251,-1,0,,0,0.00000000000000000000
chr16,33562634,33614007,51373,-1,0,,0,0.00000000000000000000
chr16,32327925,32370916,42991,-1,0,,0,0.00000000000000000000
chr16,33238722,33293958,55236,-1,0,729355,1,1.81041349844304000000
chr16,32659801,32708143,48342,-1,0,24150,1,2.06859459683091000000
chr16,33864021,33902261,38240,-1,0,,0,0.00000000000000000000
chr16,32550212,32597066,46854,-1,0,,0,0.00000000000000000000
chr16,33819771,33868342,48571,-1,0,,0,0.00000000000000000000
chr16,32609345,32655316,45971,-1,0,,0,0.00000000000000000000
chr16,33524565,33570784,46219,-1,0,,0,0.00000000000000000000
chr16,32524765,32570932,46167,-1,0,,0,0.00000000000000000000
chr16,32571196,32616295,45099,-1,0,,0,0.00000000000000000000
chr16,33588532,33626594,38062,-1,0,,0,0.00000000000000000000
chr16,32611029,32642738,31709,-1,0,,0,0.00000000000000000000
chr16,32903406,32927776,24370,-1,0,,0,0.00000000000000000000
chr16,32252845,32275709,22864,-1,0,729264,1,4.37368789363191000000
chr16,33470755,33495606,24851,-1,0,,0,0.00000000000000000000
chr16,33551132,33573062,21930,-1,0,,0,0.00000000000000000000
chr16,33591078,33612937,21859,-1,0,,0,0.00000000000000000000
chr16,32526171,32545089,18918,-1,0,,0,0.00000000000000000000
chr16,33618516,33630464,11948,-1,0,,0,0.00000000000000000000
chr16,32501051,32511838,10787,-1,0,,0,0.00000000000000000000
chr16,33589115,33599697,10582,-1,0,,0,0.00000000000000000000
chr16,32699226,32707411,8185,-1,0,,0,0.00000000000000000000
chr16,33997005,34004591,7586,-1,0,,0,0.00000000000000000000
chr16,33926705,33933443,6738,-1,0,,0,0.00000000000000000000
chr16,33484806,33490626,5820,-1,0,,0,0.00000000000000000000
chr16,33754988,33761186,6198,-1,0,,0,0.00000000000000000000
chr16,33373776,33379501,5725,-1,0,,0,0.00000000000000000000
chr16,32596835,32601517,4682,-1,0,,0,0.00000000000000000000
chr16,33937492,33942015,4523,-1,0,,0,0.00000000000000000000
chr16,32598581,32602963,4382,-1,0,,0,0.00000000000000000000
chr16,32495186,32498091,2905,-1,0,,0,0.00000000000000000000
chr16,33538368,33541352,2984,-1,0,,0,0.00000000000000000000
chr16,33972333,33974234,1901,-1,0,,0,0.00000000000000000000
chr16,32588179,32590787,2608,-1,0,,0,0.00000000000000000000
chr16,33537362,33539700,2338,-1,0,,0,0.00000000000000000000
chr16,32523771,32526006,2235,-1,0,,0,0.00000000000000000000
chr16,33545170,33547149,1979,-1,0,,0,0.00000000000000000000
chr16,33543681,33545481,1800,-1,0,,0,0.00000000000000000000
chr16,33977613,33979489,1876,-1,0,,0,0.00000000000000000000
chr16,32532144,32533724,1580,-1,0,,0,0.00000000000000000000
chr16,32600304,32601868,1564,-1,0,,0,0.00000000000000000000
chr16,33043591,33045112,1521,-1,0,,0,0.00000000000000000000
chr16,33985156,33986597,1441,-1,0,,0,0.00000000000000000000
chr16,33987017,33988238,1221,-1,0,,0,0.00000000000000000000
chr16,33916110,33917493,1383,-1,0,,0,0.00000000000000000000
chr16,33996840,33998096,1256,-1,0,,0,0.00000000000000000000
chr16,33864980,33865967,987,-1,0,,0,0.00000000000000000000
chr16,33997350,33998105,755,-1,0,,0,0.00000000000000000000
chr16,32817695,32818616,921,-1,0,,0,0.00000000000000000000
chr16,32371319,32371932,613,-1,0,,0,0.00000000000000000000
chr16,32524643,32525224,581,-1,0,,0,0.00000000000000000000
chr16,33485903,33486368,465,-1,0,,0,0.00000000000000000000
chr16,32518878,32519502,624,-1,0,,0,0.00000000000000000000
chr16,33944904,33945400,496,-1,0,,0,0.00000000000000000000
chr16,31971531,31972077,546,-1,0,,0,0.00000000000000000000
chr16,33949703,33950082,379,-1,0,,0,0.00000000000000000000
chr16,33559082,33559460,378,-1,0,,0,0.00000000000000000000
chr16,33997310,33997705,395,-1,0,,0,0.00000000000000000000
chr16,33485950,33486265,315,-1,0,,0,0.00000000000000000000
chr16,33864542,33864747,205,-1,0,,0,0.00000000000000000000
chr16,33954921,33955141,220,-1,0,,0,0.00000000000000000000
chr16,34009903,34010070,167,-1,0,,0,0.00000000000000000000
chr16,34022361,34022545,184,-1,0,,0,0.00000000000000000000
chr16,33968802,33968960,158,-1,0,,0,0.00000000000000000000
chr16,33626695,33626757,62,-1,0,,0,0.00000000000000000000
chr16,34178943,34196418,17475,-1,0,,0,0.00000000000000000000
chr16,34181721,34192524,10803,-1,0,,0,0.00000000000000000000
chr16,34241255,34249429,8174,-1,0,,0,0.00000000000000000000
chr16,34182739,34189733,6994,-1,0,,0,0.00000000000000000000
chr16,34296899,34299498,2599,-1,0,,0,0.00000000000000000000
chr16,34193293,34194139,846,-1,0,,0,0.00000000000000000000
chr16,34336816,34337360,544,-1,0,,0,0.00000000000000000000
chr16,34185543,34185596,53,-1,0,,0,0.00000000000000000000
chr16,34465776,34757748,291972,-1,0,,0,0.00000000000000000000
chr16,34455603,34489220,33617,-1,0,,0,0.00000000000000000000
chr16,34707461,34714130,6669,-1,0,,0,0.00000000000000000000
chr16,34539633,34540315,682,-1,0,,0,0.00000000000000000000
chr16,34684704,34685235,531,-1,0,,0,0.00000000000000000000
chr16,34925186,34927596,2410,-1,0,,0,0.00000000000000000000
chr16,35183776,35276651,92875,-1,0,,0,0.00000000000000000000
chr16,35128739,35210370,81631,-1,0,,0,0.00000000000000000000
chr16,35178627,35227805,49178,-1,0,,0,0.00000000000000000000
chr16,35228865,35280591,51726,-1,0,,0,0.00000000000000000000
chr16,35184246,35206222,21976,-1,0,,0,0.00000000000000000000
chr16,35182950,35198019,15069,-1,0,,0,0.00000000000000000000
chr16,35244509,35255125,10616,-1,0,,0,0.00000000000000000000
chr16,35119258,35124879,5621,-1,0,,0,0.00000000000000000000
chr16,35227121,35230785,3664,-1,0,,0,0.00000000000000000000
chr16,35184314,35186868,2554,-1,0,,0,0.00000000000000000000
chr16,35280706,35284175,3469,-1,0,,0,0.00000000000000000000
chr16,46422304,46499403,77099,-1,0,,0,0.00000000000000000000
chr16,46404880,46452831,47951,-1,0,,0,0.00000000000000000000
chr16,46456684,46497552,40868,-1,0,,0,0.00000000000000000000
chr16,46419196,46447657,28461,-1,0,,0,0.00000000000000000000
chr16,46393165,46407030,13865,-1,0,,0,0.00000000000000000000
chr16,46435758,46456368,20610,-1,0,,0,0.00000000000000000000
chr16,46420116,46432245,12129,-1,0,,0,0.00000000000000000000
chr16,46390598,46402094,11496,-1,0,,0,0.00000000000000000000
chr16,46442132,46453504,11372,-1,0,,0,0.00000000000000000000
chr16,46387371,46397250,9879,-1,0,,0,0.00000000000000000000
chr16,46394068,46400840,6772,-1,0,,0,0.00000000000000000000
chr16,46417555,46426568,9013,-1,0,,0,0.00000000000000000000
chr16,46427812,46436045,8233,-1,0,,0,0.00000000000000000000
chr16,46482116,46489831,7715,-1,0,,0,0.00000000000000000000
chr16,46387536,46393924,6388,-1,0,,0,0.00000000000000000000
chr16,46448539,46453600,5061,-1,0,,0,0.00000000000000000000
chr16,46398807,46404751,5944,-1,0,,0,0.00000000000000000000
chr16,46406970,46412917,5947,-1,0,,0,0.00000000000000000000
chr16,46386707,46391496,4789,-1,0,,0,0.00000000000000000000
chr16,46390282,46393929,3647,-1,0,,0,0.00000000000000000000
chr16,46450647,46454761,4114,-1,0,,0,0.00000000000000000000
chr16,46410476,46414601,4125,-1,0,,0,0.00000000000000000000
chr16,46391579,46394695,3116,-1,0,,0,0.00000000000000000000
chr16,46401121,46403460,2339,-1,0,,0,0.00000000000000000000
chr16,46388766,46391306,2540,-1,0,,0,0.00000000000000000000
chr16,46393514,46395445,1931,-1,0,,0,0.00000000000000000000
chr16,46388659,46390529,1870,-1,0,,0,0.00000000000000000000
chr16,46392597,46394019,1422,-1,0,,0,0.00000000000000000000
chr16,46386900,46388273,1373,-1,0,,0,0.00000000000000000000
chr16,46499217,46500477,1260,-1,0,,0,0.00000000000000000000
chr16,46390674,46391842,1168,-1,0,,0,0.00000000000000000000
chr16,46424568,46425242,674,-1,0,,0,0.00000000000000000000
chr16,46403979,46404405,426,-1,0,,0,0.00000000000000000000
chr16,46392230,46392568,338,-1,0,,0,0.00000000000000000000
chr16,46428355,46428667,312,-1,0,,0,0.00000000000000000000
chr16,46426736,46426865,129,-1,0,,0,0.00000000000000000000
chr16,46497910,46498001,91,-1,0,,0,0.00000000000000000000
chr16,46395082,46395156,74,-1,0,,0,0.00000000000000000000
chr16,46979464,46979901,437,-1,0,,0,0.00000000000000000000
chr16,47524712,47586341,61629,-1,0,5257,1,1.62261273101949000000
chr16,47352957,47355780,2823,-1,0,81533,1,35.42330853701740000000
chr16,47784455,47786022,1567,-1,0,,0,0.00000000000000000000
chr16,47834524,47852130,17606,-1,0,,0,0.00000000000000000000
chr16,47864796,47873413,8617,-1,0,,0,0.00000000000000000000
chr16,47935879,47937502,1623,-1,0,,0,0.00000000000000000000
chr16,48005596,48007206,1610,-1,0,,0,0.00000000000000000000
chr16,48418477,48419724,1247,-1,0,6477,1,80.19246190858060000000
chr16,48508920,48511389,2469,-1,0,,0,0.00000000000000000000
chr16,48509288,48510957,1669,-1,0,,0,0.00000000000000000000
chr16,48549867,48554370,4503,-1,0,,0,0.00000000000000000000
chr16,48673240,48675070,1830,-1,0,,0,0.00000000000000000000
chr16,48816764,48817309,545,-1,0,,0,0.00000000000000000000
chr16,48816892,48817193,301,-1,0,,0,0.00000000000000000000
chr16,48905299,48905860,561,-1,0,,0,0.00000000000000000000
chr16,49036071,49036226,155,-1,0,,0,0.00000000000000000000
chr16,49288297,49289114,817,-1,0,,0,0.00000000000000000000
chr16,49330579,49334458,3879,-1,0,,0,0.00000000000000000000
chr16,49335852,49336301,449,-1,0,,0,0.00000000000000000000
chr16,49540386,49540533,147,-1,0,23090,1,680.27210884353700000000
chr16,49848029,49848746,717,-1,0,23090,1,139.47001394700100000000
chr16,49888760,49892970,4210,-1,0,23090,1,23.75296912114010000000
chr16,49979353,49979765,412,-1,0,,0,0.00000000000000000000
chr16,50207833,50210729,2896,-1,0,64282,1,34.53038674033150000000
chr16,50223551,50225123,1572,-1,0,64282,1,63.61323155216290000000
chr16,50509518,50510001,483,-1,0,,0,0.00000000000000000000
chr16,50509658,50509826,168,-1,0,,0,0.00000000000000000000
chr16,50962363,50962672,309,-1,0,,0,0.00000000000000000000
chr16,51047635,51049663,2028,-1,0,,0,0.00000000000000000000
chr16,51048029,51049147,1118,-1,0,,0,0.00000000000000000000
chr16,51184640,51190500,5860,-1,0,6299,1,17.06484641638230000000
chr16,51800279,51801452,1173,-1,0,,0,0.00000000000000000000
chr16,52004397,52004737,340,-1,0,,0,0.00000000000000000000
chr16,52011488,52011932,444,-1,0,,0,0.00000000000000000000
chr16,52032418,52033574,1156,-1,0,,0,0.00000000000000000000
chr16,52149346,52149779,433,-1,0,,0,0.00000000000000000000
chr16,52149589,52149642,53,-1,0,,0,0.00000000000000000000
chr16,52283298,52283485,187,-1,0,,0,0.00000000000000000000
chr16,52293544,52294384,840,-1,0,,0,0.00000000000000000000
chr16,52412202,52416395,4193,-1,0,,0,0.00000000000000000000
chr16,52412391,52414906,2515,-1,0,,0,0.00000000000000000000
chr16,52604486,52605740,1254,-1,0,,0,0.00000000000000000000
chr16,52904157,52904389,232,-1,0,,0,0.00000000000000000000
chr16,52904247,52904373,126,-1,0,,0,0.00000000000000000000
chr16,53713447,53713558,111,-1,0,23322,1,900.90090090090100000000
chr16,54315947,54325970,10023,-1,0,79191,1,9.97705277860920000000
chr16,54407747,54419745,11998,-1,0,,0,0.00000000000000000000
chr16,54412363,54418921,6558,-1,0,,0,0.00000000000000000000
chr16,54472781,54499349,26568,-1,0,,0,0.00000000000000000000
chr16,54566008,54567711,1703,-1,0,,0,0.00000000000000000000
chr16,54660270,54660771,501,-1,0,,0,0.00000000000000000000
chr16,54660310,54660649,339,-1,0,,0,0.00000000000000000000
chr16,54996284,54996343,59,-1,0,,0,0.00000000000000000000
chr16,55226924,55231404,4480,-1,0,,0,0.00000000000000000000
chr16,55451037,55451760,723,-1,0,,0,0.00000000000000000000
chr16,55785920,55823888,37968,-1,0,,0,0.00000000000000000000
chr16,55832207,55864521,32314,-1,0,1066,1,3.09463390480906000000
chr16,55801791,55821300,19509,-1,0,,0,0.00000000000000000000
chr16,55796595,55815945,19350,-1,0,,0,0.00000000000000000000
chr16,55807220,55822887,15667,-1,0,,0,0.00000000000000000000
chr16,55795671,55805648,9977,-1,0,,0,0.00000000000000000000
chr16,55805396,55816009,10613,-1,0,,0,0.00000000000000000000
chr16,55812689,55821689,9000,-1,0,,0,0.00000000000000000000
chr16,56431729,56432056,327,-1,0,267,1,305.81039755351700000000
chr16,56574532,56574859,327,-1,0,,0,0.00000000000000000000
chr16,56574583,56574756,173,-1,0,,0,0.00000000000000000000
chr16,56615303,56617152,1849,-1,0,,0,0.00000000000000000000
chr16,56617024,56617359,335,-1,0,,0,0.00000000000000000000
chr16,56654819,56655805,986,-1,0,,0,0.00000000000000000000
chr16,56699385,56700408,1023,-1,0,,0,0.00000000000000000000
chr16,57126111,57127112,1001,-1,0,221184,1,99.90009990009990000000
chr16,57104678,57105186,508,-1,0,84166,1,196.85039370078700000000
chr16,57252659,57253009,350,-1,0,89970,1,285.71428571428600000000
chr16,57326365,57328170,1805,-1,0,,0,0.00000000000000000000
chr16,57332372,57334223,1851,-1,0,,0,0.00000000000000000000
chr16,57362018,57362795,777,-1,0,,0,0.00000000000000000000
chr16,57366281,57367124,843,-1,0,,0,0.00000000000000000000
chr16,57725869,57729099,3230,-1,0,84229,1,30.95975232198140000000
chr16,57725351,57727831,2480,-1,0,,0,0.00000000000000000000
chr16,57727475,57727951,476,-1,0,,0,0.00000000000000000000
chr16,57727646,57727710,64,-1,0,,0,0.00000000000000000000
chr16,57739620,57739932,312,-1,0,84229,1,320.51282051282000000000
chr16,57740575,57740737,162,-1,0,84229,1,617.28395061728400000000
chr16,57779257,57779307,50,-1,0,10300,1,2000.00000000000000000000
chr16,58054272,58054507,235,-1,0,79650,1,425.53191489361700000000
chr16,58203718,58205919,2201,-1,0,1459,1,45.43389368468880000000
chr16,58290901,58291220,319,-1,0,29070,1,313.47962382445100000000
chr16,58614559,58615594,1035,-1,0,23019,1,96.61835748792270000000
chr16,58614723,58615203,480,-1,0,23019,1,208.33333333333300000000
chr16,58614895,58614985,90,-1,0,23019,1,1111.11111111111000000000
chr16,58647189,58650306,3117,-1,0,23019,1,32.08213025344880000000
chr16,58673828,58677349,3521,-1,0,,0,0.00000000000000000000
chr16,58673595,58676333,2738,-1,0,,0,0.00000000000000000000
chr16,58674422,58676363,1941,-1,0,,0,0.00000000000000000000
chr16,58744628,58744722,94,-1,0,2806,1,1063.82978723404000000000
chr16,58800910,58800966,56,-1,0,,0,0.00000000000000000000
chr16,58977817,59040701,62884,-1,0,,0,0.00000000000000000000
chr16,58945822,58954213,8391,-1,0,,0,0.00000000000000000000
chr16,58967769,58975270,7501,-1,0,,0,0.00000000000000000000
chr16,58945797,58948582,2785,-1,0,,0,0.00000000000000000000
chr16,59037452,59038553,1101,-1,0,,0,0.00000000000000000000
chr16,59037640,59038226,586,-1,0,,0,0.00000000000000000000
chr16,59027671,59028216,545,-1,0,,0,0.00000000000000000000
chr16,59037875,59038057,182,-1,0,,0,0.00000000000000000000
chr16,59088261,59088597,336,-1,0,,0,0.00000000000000000000
chr16,59088377,59088433,56,-1,0,,0,0.00000000000000000000
chr16,59308305,59309094,789,-1,0,,0,0.00000000000000000000
chr16,59430426,59430798,372,-1,0,,0,0.00000000000000000000
chr16,59468865,59471450,2585,-1,0,,0,0.00000000000000000000
chr16,59549362,59556404,7042,-1,0,,0,0.00000000000000000000
chr16,59836733,59848115,11382,-1,0,,0,0.00000000000000000000
chr16,59987105,59994126,7021,-1,0,,0,0.00000000000000000000
chr16,60032026,60032477,451,-1,0,,0,0.00000000000000000000
chr16,59808332,59808855,523,-1,0,,0,0.00000000000000000000
chr16,60032086,60032414,328,-1,0,,0,0.00000000000000000000
chr16,59784234,59784360,126,-1,0,,0,0.00000000000000000000
chr16,60081047,60098562,17515,-1,0,,0,0.00000000000000000000
chr16,60062629,60062910,281,-1,0,,0,0.00000000000000000000
chr16,60466713,60467416,703,-1,0,,0,0.00000000000000000000
chr16,60541609,60576502,34893,-1,0,,0,0.00000000000000000000
chr16,60554402,60573068,18666,-1,0,,0,0.00000000000000000000
chr16,60611857,60613434,1577,-1,0,,0,0.00000000000000000000
chr16,60704435,60704900,465,-1,0,,0,0.00000000000000000000
chr16,60881163,60881509,346,-1,0,,0,0.00000000000000000000
chr16,60881262,60881371,109,-1,0,,0,0.00000000000000000000
chr16,60910033,60913925,3892,-1,0,,0,0.00000000000000000000
chr16,60918743,60919139,396,-1,0,,0,0.00000000000000000000
chr16,60918851,60919104,253,-1,0,,0,0.00000000000000000000
chr16,60918161,60918293,132,-1,0,,0,0.00000000000000000000
chr16,61101451,61111685,10234,-1,0,,0,0.00000000000000000000
chr16,61269163,61485938,216775,-1,0,,0,0.00000000000000000000
chr16,61452740,61453019,279,-1,0,,0,0.00000000000000000000
chr16,61459657,61459941,284,-1,0,,0,0.00000000000000000000
chr16,61694115,61697755,3640,-1,0,1006,1,27.47252747252750000000
chr16,61910969,61912490,1521,-1,0,1006,1,65.74621959237340000000
chr16,61979591,61995250,15659,-1,0,1006,1,6.38610383804841000000
chr16,62046767,62047326,559,-1,0,1006,1,178.89087656529500000000
chr16,62046861,62047194,333,-1,0,1006,1,300.30030030030000000000
chr16,62419371,62419736,365,-1,0,,0,0.00000000000000000000
chr16,62544314,62552540,8226,-1,0,,0,0.00000000000000000000
chr16,63159846,63186201,26355,-1,0,,0,0.00000000000000000000
chr16,63442336,63442865,529,-1,0,,0,0.00000000000000000000
chr16,63442426,63442760,334,-1,0,,0,0.00000000000000000000
chr16,63524227,63638884,114657,-1,0,,0,0.00000000000000000000
chr16,63583652,63615989,32337,-1,0,,0,0.00000000000000000000
chr16,63557063,63557422,359,-1,0,,0,0.00000000000000000000
chr16,63756300,63756410,110,-1,0,,0,0.00000000000000000000
chr16,63905478,63907930,2452,-1,0,,0,0.00000000000000000000
chr16,64075354,64115782,40428,-1,0,,0,0.00000000000000000000
chr16,64326748,64328263,1515,-1,0,,0,0.00000000000000000000
chr16,64475506,64475621,115,-1,0,,0,0.00000000000000000000
chr16,64589056,64591195,2139,-1,0,,0,0.00000000000000000000
chr16,64682963,64685241,2278,-1,0,,0,0.00000000000000000000
chr16,64696372,64696602,230,-1,0,,0,0.00000000000000000000
chr16,64955571,64955865,294,-1,0,,0,0.00000000000000000000
chr16,65282955,65283702,747,-1,0,,0,0.00000000000000000000
chr16,65286415,65287527,1112,-1,0,,0,0.00000000000000000000
chr16,65499321,65499651,330,-1,0,,0,0.00000000000000000000
chr16,65570970,65571035,65,-1,0,,0,0.00000000000000000000
chr16,65578854,65582735,3881,-1,0,,0,0.00000000000000000000
chr16,66058963,66071099,12136,-1,0,,0,0.00000000000000000000
chr16,66413779,66414229,450,-1,0,1003,1,222.22222222222200000000
chr16,66520355,66526153,5798,-1,0,146227,1,17.24732666436700000000
chr16,66521143,66522661,1518,-1,0,146227,1,65.87615283267460000000
chr16,66735919,66738951,3032,-1,0,,0,0.00000000000000000000
chr16,66823140,66823625,485,-1,0,283847,1,206.18556701030900000000
chr16,66823181,66823518,337,-1,0,283847,1,296.73590504451000000000
chr16,67087175,67088714,1539,-1,0,865,1,64.97725795971410000000
chr16,67178679,67300749,122070,-1,0,26231;55336;653319;6553;8717;80262;29100;283849;8996;84752;29109;79767;3299;1874,14,11.46882936020320000000
chr16,67253561,67254100,539,-1,0,26231,1,185.52875695732800000000
chr16,67296974,67297392,418,-1,0,6553,1,239.23444976076600000000
chr16,67253665,67253981,316,-1,0,26231,1,316.45569620253200000000
chr16,67513705,67514249,544,-1,0,9114,1,183.82352941176500000000
chr16,67513805,67514123,318,-1,0,9114,1,314.46540880503100000000
chr16,67536926,67537414,488,-1,0,,0,0.00000000000000000000
chr16,67822242,67825019,2777,-1,0,57610,1,36.01008282319050000000
chr16,67933501,67939016,5515,-1,0,5681,1,18.13236627379870000000
chr16,68061654,68063158,1504,-1,0,54920,1,66.48936170212770000000
chr16,68637404,68643761,6357,-1,0,,0,0.00000000000000000000
chr16,68864009,68866315,2306,-1,0,999,1,43.36513443191670000000
chr16,69063806,69066530,2724,-1,0,79613,1,36.71071953010280000000
chr16,69854331,69858805,4474,-1,0,11060,1,22.35136343316940000000
chr16,70010881,70246105,235224,-1,0,55066;283971,2,0.85025337550590100000
chr16,70029799,70139363,109564,-1,0,,0,0.00000000000000000000
chr16,70036633,70109470,72837,-1,0,,0,0.00000000000000000000
chr16,70148776,70242510,93734,-1,0,55066;283971,2,2.13369748437067000000
chr16,70141645,70205191,63546,-1,0,55066,1,1.57366317313442000000
chr16,70049278,70122536,73258,-1,0,,0,0.00000000000000000000
chr16,70061025,70087607,26582,-1,0,,0,0.00000000000000000000
chr16,70177525,70199554,22029,-1,0,55066,1,4.53947069771665000000
chr16,69976872,70007950,31078,-1,0,348174,1,3.21771027736663000000
chr16,70184194,70202462,18268,-1,0,55066,1,5.47405298883293000000
chr16,70179778,70195277,15499,-1,0,55066,1,6.45202916317182000000
chr16,69977132,69977529,397,-1,0,,0,0.00000000000000000000
chr16,70552982,70553420,438,-1,0,25839,1,228.31050228310500000000
chr16,70553009,70553330,321,-1,0,25839,1,311.52647975077900000000
chr16,70847248,71202529,355281,-1,0,54768,1,0.28146734556590400000
chr16,71144772,71186944,42172,-1,0,54768,1,2.37124158209238000000
chr16,70977719,70979972,2253,-1,0,54768,1,44.38526409232130000000
chr16,71164039,71165168,1129,-1,0,54768,1,88.57395925597870000000
chr16,71164366,71164683,317,-1,0,54768,1,315.45741324921100000000
chr16,71355924,71360569,4645,-1,0,,0,0.00000000000000000000
chr16,71675522,71677687,2165,-1,0,91862,1,46.18937644341800000000
chr16,71753574,71755877,2303,-1,0,23035,1,43.42162396873640000000
chr16,71865575,71869885,4310,-1,0,,0,0.00000000000000000000
chr16,72082132,72104085,21953,-1,0,3250;3240,2,9.11037215870268000000
chr16,72088749,72097492,8743,-1,0,3250;3240,2,22.87544321171220000000
chr16,71996388,72002552,6164,-1,0,342372,1,16.22323166774820000000
chr16,72090316,72093698,3382,-1,0,3240,1,29.56830277942050000000
chr16,71999603,72002835,3232,-1,0,342372,1,30.94059405940590000000
chr16,72074289,72074593,304,-1,0,,0,0.00000000000000000000
chr16,72318786,72320839,2053,-1,0,,0,0.00000000000000000000
chr16,72318979,72319969,990,-1,0,,0,0.00000000000000000000
chr16,72388153,72389029,876,-1,0,,0,0.00000000000000000000
chr16,72671840,72765262,93422,-1,0,,0,0.00000000000000000000
chr16,72570930,72649657,78727,-1,0,,0,0.00000000000000000000
chr16,72571437,72590192,18755,-1,0,,0,0.00000000000000000000
chr16,72676937,72680325,3388,-1,0,,0,0.00000000000000000000
chr16,72737135,72738051,916,-1,0,,0,0.00000000000000000000
chr16,72753193,72753701,508,-1,0,,0,0.00000000000000000000
chr16,72753286,72753599,313,-1,0,,0,0.00000000000000000000
chr16,73091650,73093207,1557,-1,0,463,1,64.22607578676940000000
chr16,73330893,73332205,1312,-1,0,,0,0.00000000000000000000
chr16,73390155,73391349,1194,-1,0,,0,0.00000000000000000000
chr16,73423070,73425321,2251,-1,0,,0,0.00000000000000000000
chr16,73450661,73451881,1220,-1,0,,0,0.00000000000000000000
chr16,73613727,73616980,3253,-1,0,,0,0.00000000000000000000
chr16,73699247,73701015,1768,-1,0,,0,0.00000000000000000000
chr16,74125589,74148166,22577,-1,0,,0,0.00000000000000000000
chr16,74113621,74114296,675,-1,0,,0,0.00000000000000000000
chr16,74203081,74204246,1165,-1,0,,0,0.00000000000000000000
chr16,74224410,74225888,1478,-1,0,,0,0.00000000000000000000
chr16,74298215,74300280,2065,-1,0,,0,0.00000000000000000000
chr16,74368645,74457084,88439,-1,0,440348;497190,2,2.26144574226303000000
chr16,74359223,74406101,46878,-1,0,,0,0.00000000000000000000
chr16,74381095,74416761,35666,-1,0,440348,1,2.80379072506028000000
chr16,74430340,74463566,33226,-1,0,497190,1,3.00969120568230000000
chr16,74371280,74388307,17027,-1,0,,0,0.00000000000000000000
chr16,74430264,74431237,973,-1,0,,0,0.00000000000000000000
chr16,74470933,74471733,800,-1,0,,0,0.00000000000000000000
chr16,74521495,74524244,2749,-1,0,2734,1,36.37686431429610000000
chr16,74809767,74809849,82,-1,0,,0,0.00000000000000000000
chr16,74870232,74989660,119428,-1,0,79726,1,0.83732458050038500000
chr16,75023920,75027552,3632,-1,0,,0,0.00000000000000000000
chr16,75095261,75095611,350,-1,0,84937,1,285.71428571428600000000
chr16,75164003,75167916,3913,-1,0,,0,0.00000000000000000000
chr16,75516461,75566286,49825,-1,0,4166;23563,2,4.01404917210236000000
chr16,75532031,75573468,41437,-1,0,23563;79583,2,4.82660424258513000000
chr16,75428824,75431708,2884,-1,0,10428,1,34.67406380027740000000
chr16,75429389,75430990,1601,-1,0,10428,1,62.46096189881320000000
chr16,75522750,75524284,1534,-1,0,4166,1,65.18904823989570000000
chr16,75429830,75430673,843,-1,0,10428,1,118.62396204033200000000
chr16,75633078,75656568,23490,-1,0,23536,1,4.25713069391230000000
chr16,75705426,75706292,866,-1,0,,0,0.00000000000000000000
chr16,75938511,76055776,117265,-1,0,,0,0.00000000000000000000
chr16,75964679,76012203,47524,-1,0,,0,0.00000000000000000000
chr16,76021047,76056505,35458,-1,0,,0,0.00000000000000000000
chr16,76000293,76021718,21425,-1,0,,0,0.00000000000000000000
chr16,76002055,76018867,16812,-1,0,,0,0.00000000000000000000
chr16,75920832,75925943,5111,-1,0,,0,0.00000000000000000000
chr16,76160811,76198740,37929,-1,0,,0,0.00000000000000000000
chr16,76168568,76168905,337,-1,0,,0,0.00000000000000000000
chr16,76168648,76168753,105,-1,0,,0,0.00000000000000000000
chr16,76250287,76251108,821,-1,0,,0,0.00000000000000000000
chr16,76449921,76451278,1357,-1,0,85445,1,73.69196757553430000000
chr16,76294917,76295086,169,-1,0,,0,0.00000000000000000000
chr16,76505921,76506481,560,-1,0,85445,1,178.57142857142900000000
chr16,76745516,76866466,120950,-1,0,,0,0.00000000000000000000
chr16,76687126,76786702,99576,-1,0,,0,0.00000000000000000000
chr16,76611440,76701351,89911,-1,0,,0,0.00000000000000000000
chr16,76888325,76943192,54867,-1,0,,0,0.00000000000000000000
chr16,76670579,76708160,37581,-1,0,,0,0.00000000000000000000
chr16,76661549,76671182,9633,-1,0,,0,0.00000000000000000000
chr16,76538917,76544483,5566,-1,0,85445,1,17.96622349982030000000
chr16,76539207,76543818,4611,-1,0,85445,1,21.68726957276080000000
chr16,76598904,76601570,2666,-1,0,,0,0.00000000000000000000
chr16,76716393,76719158,2765,-1,0,,0,0.00000000000000000000
chr16,76548548,76548647,99,-1,0,85445,1,1010.10101010101000000000
chr16,77077655,77079000,1345,-1,0,,0,0.00000000000000000000
chr16,77081660,77092636,10976,-1,0,,0,0.00000000000000000000
chr16,77090218,77093860,3642,-1,0,,0,0.00000000000000000000
chr16,77090641,77092862,2221,-1,0,,0,0.00000000000000000000
chr16,78031410,78147319,115909,-1,0,51741;10143,2,1.72549154940514000000
chr16,78051307,78088584,37277,-1,0,10143,1,2.68261930949379000000
chr16,78052262,78076501,24239,-1,0,10143,1,4.12558273856182000000
chr16,78079471,78098176,18705,-1,0,,0,0.00000000000000000000
chr16,77169097,77193949,24852,-1,0,,0,0.00000000000000000000
chr16,78211294,78231233,19939,-1,0,51741,1,5.01529665479713000000
chr16,78080330,78091426,11096,-1,0,,0,0.00000000000000000000
chr16,78223599,78227989,4390,-1,0,51741,1,22.77904328018220000000
chr16,77885714,77889482,3768,-1,0,57687,1,26.53927813163480000000
chr16,78038284,78041216,2932,-1,0,,0,0.00000000000000000000
chr16,77906597,77908507,1910,-1,0,57687,1,52.35602094240840000000
chr16,78171651,78172356,705,-1,0,51741,1,141.84397163120600000000
chr16,77148412,77149286,874,-1,0,,0,0.00000000000000000000
chr16,77372995,77373808,813,-1,0,170692,1,123.00123001230000000000
chr16,78068275,78068485,210,-1,0,,0,0.00000000000000000000
chr16,78379752,78506352,126600,-1,0,51741,1,0.78988941548183300000
chr16,78502761,78635427,132666,-1,0,51741,1,0.75377263202327600000
chr16,78293392,78369643,76251,-1,0,51741,1,1.31145821038413000000
chr16,78650907,78737295,86388,-1,0,51741,1,1.15756818076585000000
chr16,78381024,78436307,55283,-1,0,51741,1,1.80887433749977000000
chr16,78486827,78508485,21658,-1,0,51741,1,4.61723150798781000000
chr16,78371592,78384911,13319,-1,0,51741,1,7.50807117651475000000
chr16,78761931,78772520,10589,-1,0,51741,1,9.44376239493814000000
chr16,78375356,78382729,7373,-1,0,51741,1,13.56300013563000000000
chr16,78764914,78770506,5592,-1,0,51741,1,17.88268955650930000000
chr16,78373436,78377464,4028,-1,0,51741,1,24.82621648460770000000
chr16,78369817,78373485,3668,-1,0,51741,1,27.26281352235550000000
chr16,78306574,78309887,3313,-1,0,51741,1,30.18412315122250000000
chr16,78293217,78295739,2522,-1,0,51741,1,39.65107057890560000000
chr16,78373657,78375071,1414,-1,0,51741,1,70.72135785007070000000
chr16,78394515,78394606,91,-1,0,51741,1,1098.90109890110000000000
chr16,78835262,78894176,58914,-1,0,51741,1,1.69738941507961000000
chr16,78876646,78877569,923,-1,0,51741,1,108.34236186348900000000
chr16,78876959,78877709,750,-1,0,51741,1,133.33333333333300000000
chr16,78958477,79148865,190388,-1,0,51741,1,0.52524318759585700000
chr16,78944123,78948692,4569,-1,0,51741,1,21.88662727073760000000
chr16,79060041,79063319,3278,-1,0,51741,1,30.50640634533250000000
chr16,79203190,79268284,65094,-1,0,51741,1,1.53623989922266000000
chr16,79257762,79281873,24111,-1,0,,0,0.00000000000000000000
chr16,79260511,79275302,14791,-1,0,,0,0.00000000000000000000
chr16,79224086,79225189,1103,-1,0,51741,1,90.66183136899370000000
chr16,79590843,79592066,1223,-1,0,,0,0.00000000000000000000
chr16,79739051,79745014,5963,-1,0,,0,0.00000000000000000000
chr16,79886663,79931444,44781,-1,0,,0,0.00000000000000000000
chr16,79975981,79977067,1086,-1,0,,0,0.00000000000000000000
chr16,80196900,80197002,102,-1,0,,0,0.00000000000000000000
chr16,80239446,80350789,111343,-1,0,,0,0.00000000000000000000
chr16,80489550,80507088,17538,-1,0,,0,0.00000000000000000000
chr16,80366393,80373092,6699,-1,0,,0,0.00000000000000000000
chr16,80468610,80469023,413,-1,0,,0,0.00000000000000000000
chr16,80468651,80468983,332,-1,0,,0,0.00000000000000000000
chr16,80678741,80680417,1676,-1,0,124359,1,59.66587112171840000000
chr16,80992819,81033146,40327,-1,0,56942,1,2.47972822178689000000
chr16,80954491,81000120,45629,-1,0,,0,0.00000000000000000000
chr16,80938249,80954524,16275,-1,0,,0,0.00000000000000000000
chr16,80973764,80983045,9281,-1,0,,0,0.00000000000000000000
chr16,80902995,80913694,10699,-1,0,,0,0.00000000000000000000
chr16,80976509,80983310,6801,-1,0,,0,0.00000000000000000000
chr16,80978714,80983234,4520,-1,0,,0,0.00000000000000000000
chr16,81069171,81070144,973,-1,0,23300,1,102.77492291880800000000
chr16,81119383,81119884,501,-1,0,2653,1,199.60079840319400000000
chr16,81119479,81119832,353,-1,0,2653,1,283.28611898017000000000
chr16,81170952,81271182,100230,-1,0,114780,1,0.99770527786092000000
chr16,81233095,81297195,64100,-1,0,114780;53630,2,3.12012480499220000000
chr16,81213025,81241568,28543,-1,0,114780,1,3.50348596853870000000
chr16,81182202,81218603,36401,-1,0,114780,1,2.74717727534958000000
chr16,81247654,81273805,26151,-1,0,114780;53630,2,7.64789109403082000000
chr16,81175827,81188714,12887,-1,0,114780,1,7.75975789555366000000
chr16,81172786,81181375,8589,-1,0,114780,1,11.64279892886250000000
chr16,81170927,81177380,6453,-1,0,114780,1,15.49666821633350000000
chr16,81159211,81164840,5629,-1,0,114780,1,17.76514478593000000000
chr16,81179441,81183678,4237,-1,0,114780,1,23.60160490913380000000
chr16,81154583,81157280,2697,-1,0,114780,1,37.07823507601040000000
chr16,81219540,81221238,1698,-1,0,114780,1,58.89281507656070000000
chr16,81148708,81149621,913,-1,0,114780,1,109.52902519167600000000
chr16,81173807,81174324,517,-1,0,114780,1,193.42359767891700000000
chr16,81451851,81461264,9413,-1,0,,0,0.00000000000000000000
chr16,81618996,81619516,520,-1,0,80790,1,192.30769230769200000000
chr16,81851742,81901297,49555,-1,0,5336,1,2.01795984259913000000
chr16,81831252,81835109,3857,-1,0,5336,1,25.92688618096970000000
chr16,81879301,81882333,3032,-1,0,5336,1,32.98153034300790000000
chr16,81756637,81759553,2916,-1,0,,0,0.00000000000000000000
chr16,81751714,81753845,2131,-1,0,,0,0.00000000000000000000
chr16,81899984,81900330,346,-1,0,5336,1,289.01734104046200000000
chr16,81899769,81900057,288,-1,0,5336,1,347.22222222222200000000
chr16,82043711,82049608,5897,-1,0,93517,1,16.95777513990160000000
chr16,82076892,82077415,523,-1,0,3294,1,191.20458891013400000000
chr16,82164143,82164496,353,-1,0,,0,0.00000000000000000000
chr16,82164201,82164452,251,-1,0,,0,0.00000000000000000000
chr16,82987923,83055657,67734,-1,0,1012,1,1.47636342161987000000
chr16,82175716,82232162,56446,-1,0,10200,1,1.77160471955497000000
chr16,84013567,84062207,48640,-1,0,146167;54550,2,4.11184210526316000000
chr16,84603954,84636958,33004,-1,0,23406,1,3.02993576536177000000
chr16,84438591,84469920,31329,-1,0,9914,1,3.19193079894028000000
chr16,83339054,83369816,30762,-1,0,1012,1,3.25076392952344000000
chr16,82784691,82806018,21327,-1,0,1012,1,4.68889201481690000000
chr16,83195747,83209351,13604,-1,0,1012,1,7.35077918259335000000
chr16,83685079,83692591,7512,-1,0,1012,1,13.31203407880720000000
chr16,83670613,83677150,6537,-1,0,1012,1,15.29753709652750000000
chr16,84248502,84255062,6560,-1,0,93107,1,15.24390243902440000000
chr16,83890580,83895240,4660,-1,0,,0,0.00000000000000000000
chr16,84501386,84504079,2693,-1,0,,0,0.00000000000000000000
chr16,83738862,83742434,3572,-1,0,1012,1,27.99552071668530000000
chr16,83889679,83891774,2095,-1,0,,0,0.00000000000000000000
chr16,83914899,83917256,2357,-1,0,,0,0.00000000000000000000
chr16,84084206,84085839,1633,-1,0,,0,0.00000000000000000000
chr16,84274702,84276875,2173,-1,0,,0,0.00000000000000000000
chr16,84427514,84429464,1950,-1,0,9914,1,51.28205128205130000000
chr16,84429918,84431783,1865,-1,0,9914,1,53.61930294906170000000
chr16,82309244,82310190,946,-1,0,,0,0.00000000000000000000
chr16,83243648,83244717,1069,-1,0,1012,1,93.54536950420950000000
chr16,84057214,84058203,989,-1,0,146167,1,101.11223458038400000000
chr16,84582933,84583670,737,-1,0,,0,0.00000000000000000000
chr16,83808507,83809078,571,-1,0,1012,1,175.13134851138400000000
chr16,84546389,84546915,526,-1,0,,0,0.00000000000000000000
chr16,83477380,83477773,393,-1,0,1012,1,254.45292620865100000000
chr16,83984289,83984697,408,-1,0,,0,0.00000000000000000000
chr16,82634726,82635120,394,-1,0,,0,0.00000000000000000000
chr16,83003971,83004270,299,-1,0,1012,1,334.44816053511700000000
chr16,82482520,82482852,332,-1,0,,0,0.00000000000000000000
chr16,83798351,83798421,70,-1,0,1012,1,1428.57142857143000000000
chr16,84651916,84670936,19020,-1,0,,0,0.00000000000000000000
chr16,84711858,84718479,6621,-1,0,,0,0.00000000000000000000
chr16,84831180,84835452,4272,-1,0,,0,0.00000000000000000000
chr16,85040441,85043171,2730,-1,0,55625,1,36.63003663003660000000
chr16,85063060,85086401,23341,-1,0,9764,1,4.28430658497922000000
chr16,85150851,85154564,3713,-1,0,,0,0.00000000000000000000
chr16,85149484,85150074,590,-1,0,,0,0.00000000000000000000
chr16,85242396,85242530,134,-1,0,,0,0.00000000000000000000
chr16,85294771,85306154,11383,-1,0,,0,0.00000000000000000000
chr16,85437527,85446685,9158,-1,0,,0,0.00000000000000000000
chr16,85302218,85304625,2407,-1,0,,0,0.00000000000000000000
chr16,85444125,85446239,2114,-1,0,,0,0.00000000000000000000
chr16,85416688,85417754,1066,-1,0,,0,0.00000000000000000000
chr16,85585866,85586184,318,-1,0,,0,0.00000000000000000000
chr16,85800466,85800534,68,-1,0,,0,0.00000000000000000000
chr16,85916931,85917500,569,-1,0,,0,0.00000000000000000000
chr16,85917116,85917267,151,-1,0,,0,0.00000000000000000000
chr16,85996940,85997565,625,-1,0,,0,0.00000000000000000000
chr16,86006475,86007700,1225,-1,0,,0,0.00000000000000000000
chr16,86006881,86007642,761,-1,0,,0,0.00000000000000000000
chr16,86008494,86014370,5876,-1,0,,0,0.00000000000000000000
chr16,86073591,86074210,619,-1,0,,0,0.00000000000000000000
chr16,86073787,86074046,259,-1,0,,0,0.00000000000000000000
chr16,86109225,86119637,10412,-1,0,,0,0.00000000000000000000
chr16,86155841,86156886,1045,-1,0,,0,0.00000000000000000000
chr16,86273648,86292293,18645,-1,0,,0,0.00000000000000000000
chr16,86284249,86284713,464,-1,0,,0,0.00000000000000000000
chr16,86284297,86284613,316,-1,0,,0,0.00000000000000000000
chr16,86464633,86465014,381,-1,0,,0,0.00000000000000000000
chr16,86483097,86483779,682,-1,0,,0,0.00000000000000000000
chr16,86637015,86637406,391,-1,0,,0,0.00000000000000000000
chr16,86878984,86879858,874,-1,0,,0,0.00000000000000000000
chr16,86915799,86920424,4625,-1,0,,0,0.00000000000000000000
chr16,86922791,86923158,367,-1,0,,0,0.00000000000000000000
chr16,86948144,86949492,1348,-1,0,,0,0.00000000000000000000
chr16,87047297,87047816,519,-1,0,,0,0.00000000000000000000
chr16,87196114,87196825,711,-1,0,,0,0.00000000000000000000
chr16,87220775,87220856,81,-1,0,,0,0.00000000000000000000
chr16,87221240,87221303,63,-1,0,,0,0.00000000000000000000
chr16,87252185,87323182,70997,-1,0,,0,0.00000000000000000000
chr16,87251222,87252338,1116,-1,0,,0,0.00000000000000000000
chr16,87418926,87421282,2356,-1,0,79791,1,42.44482173174870000000
chr16,87597430,87598003,573,-1,0,,0,0.00000000000000000000
chr16,87597541,87597836,295,-1,0,,0,0.00000000000000000000
chr16,87606506,87607381,875,-1,0,,0,0.00000000000000000000
chr16,87719600,87720335,735,-1,0,57338,1,136.05442176870700000000
chr16,87648207,87648649,442,-1,0,57338,1,226.24434389140300000000
chr16,87719945,87720221,276,-1,0,57338,1,362.31884057971000000000
chr16,87738026,87738137,111,-1,0,,0,0.00000000000000000000
chr16,87705191,87705243,52,-1,0,57338,1,1923.07692307692000000000
chr16,87788764,87807525,18761,-1,0,54758,1,5.33020627898300000000
chr16,87787185,87797002,9817,-1,0,54758,1,10.18641132728940000000
chr16,87828111,87832919,4808,-1,0,,0,0.00000000000000000000
chr16,87828686,87831534,2848,-1,0,,0,0.00000000000000000000
chr16,87876257,87878155,1898,-1,0,8140,1,52.68703898840890000000
chr16,87772264,87773094,830,-1,0,54758,1,120.48192771084300000000
chr16,87912967,87913205,238,-1,0,,0,0.00000000000000000000
chr16,87968171,87979959,11788,-1,0,763,1,8.48320325755005000000
chr16,88032047,88035307,3260,-1,0,54971,1,30.67484662576690000000
chr16,88033801,88034771,970,-1,0,54971,1,103.09278350515500000000
chr16,87981640,87982008,368,-1,0,,0,0.00000000000000000000
chr16,88023282,88023522,240,-1,0,54971,1,416.66666666666700000000
chr16,87981798,87981853,55,-1,0,,0,0.00000000000000000000
chr16,88112106,88116046,3940,-1,0,,0,0.00000000000000000000
chr16,88112710,88115079,2369,-1,0,,0,0.00000000000000000000
chr16,88113664,88115417,1753,-1,0,,0,0.00000000000000000000
chr16,88155541,88156062,521,-1,0,,0,0.00000000000000000000
chr16,88164794,88165240,446,-1,0,,0,0.00000000000000000000
chr16,88155679,88155894,215,-1,0,,0,0.00000000000000000000
chr16,88179837,88182587,2750,-1,0,,0,0.00000000000000000000
chr16,88240400,88241035,635,-1,0,,0,0.00000000000000000000
chr16,88196671,88196942,271,-1,0,,0,0.00000000000000000000
chr16,88218693,88218775,82,-1,0,,0,0.00000000000000000000
chr16,88263924,88264406,482,-1,0,,0,0.00000000000000000000
chr16,88270705,88271038,333,-1,0,,0,0.00000000000000000000
chr16,88861859,88869061,7202,-1,0,,0,0.00000000000000000000
chr16,88310866,88315752,4886,-1,0,,0,0.00000000000000000000
chr16,88638746,88642325,3579,-1,0,124245,1,27.94076557697680000000
chr16,88610884,88614188,3304,-1,0,,0,0.00000000000000000000
chr16,88562148,88564878,2730,-1,0,161882,1,36.63003663003660000000
chr16,89019870,89022826,2956,-1,0,863,1,33.82949932341000000000
chr16,88311318,88312924,1606,-1,0,,0,0.00000000000000000000
chr16,88861923,88863481,1558,-1,0,,0,0.00000000000000000000
chr16,88599849,88601132,1283,-1,0,161882,1,77.94232268121590000000
chr16,89074435,89075745,1310,-1,0,,0,0.00000000000000000000
chr16,88897567,88898357,790,-1,0,2588,1,126.58227848101300000000
chr16,88446745,88447808,1063,-1,0,,0,0.00000000000000000000
chr16,88807804,88808487,683,-1,0,9780,1,146.41288433382100000000
chr16,88862616,88863416,800,-1,0,,0,0.00000000000000000000
chr16,88317323,88317862,539,-1,0,,0,0.00000000000000000000
chr16,88917449,88918214,765,-1,0,2588,1,130.71895424836600000000
chr16,88999672,89000262,590,-1,0,863,1,169.49152542372900000000
chr16,88559253,88559783,530,-1,0,161882,1,188.67924528301900000000
chr16,88891440,88892048,608,-1,0,2588,1,164.47368421052600000000
chr16,88613852,88614284,432,-1,0,,0,0.00000000000000000000
chr16,89078332,89078712,380,-1,0,,0,0.00000000000000000000
chr16,88897682,88898197,515,-1,0,2588,1,194.17475728155300000000
chr16,89017426,89017738,312,-1,0,100129697;863,2,641.02564102564100000000
chr16,88567424,88567789,365,-1,0,161882,1,273.97260273972600000000
chr16,88794841,88795155,314,-1,0,9780,1,318.47133757961800000000
chr16,88838189,88838458,269,-1,0,9780,1,371.74721189591100000000
chr16,88808170,88808321,151,-1,0,9780,1,662.25165562913900000000
chr16,88314698,88314916,218,-1,0,,0,0.00000000000000000000
chr16,88900865,88901033,168,-1,0,2588,1,595.23809523809500000000
chr16,89190664,89197834,7170,-1,0,197322,1,13.94700139470010000000
chr16,89258911,89259851,940,-1,0,1013,1,106.38297872340400000000
chr16,89149840,89150793,953,-1,0,,0,0.00000000000000000000
chr16,89188212,89188759,547,-1,0,197322,1,182.81535648994500000000
chr16,89258838,89259323,485,-1,0,1013,1,206.18556701030900000000
chr16,89224116,89224528,412,-1,0,,0,0.00000000000000000000
chr16,89184207,89184504,297,-1,0,197322,1,336.70033670033700000000
chr16,89133291,89133428,137,-1,0,,0,0.00000000000000000000
chr16,89226781,89226873,92,-1,0,,0,0.00000000000000000000
chr16,89190470,89190513,43,-1,0,197322,1,2325.58139534884000000000
chr16,89418227,89419705,1478,-1,0,29123,1,67.65899864682000000000
chr16,89464482,89464941,459,-1,0,29123,1,217.86492374727700000000
chr16,89466944,89467163,219,-1,0,29123,1,456.62100456621000000000
chr16,89487594,89487826,232,-1,0,29123,1,431.03448275862100000000
chr16,89495161,89497745,2584,-1,0,29123,1,38.69969040247680000000
chr16,89536219,89537354,1135,-1,0,29123,1,88.10572687224670000000
chr16,89548151,89548647,496,-1,0,29123,1,201.61290322580600000000
chr16,89569612,89570196,584,-1,0,,0,0.00000000000000000000
chr16,89654024,89654780,756,-1,0,27132,1,132.27513227513200000000
chr16,89646154,89646669,515,-1,0,27132,1,194.17475728155300000000
chr16,89653934,89654412,478,-1,0,27132,1,209.20502092050200000000
chr16,89828406,89877972,49566,-1,0,2175,1,2.01751200419642000000
chr16,89896060,89898398,2338,-1,0,84501,1,42.77159965782720000000
chr16,89798793,89799576,783,-1,0,92822,1,127.71392081736900000000
chr16,89847990,89848852,862,-1,0,2175,1,116.00928074245900000000
chr16,89713975,89714845,870,-1,0,5119,1,114.94252873563200000000
chr16,89900509,89901247,738,-1,0,84501,1,135.50135501355000000000
chr16,89811677,89812301,624,-1,0,2175,1,160.25641025641000000000
chr16,89798972,89799447,475,-1,0,92822,1,210.52631578947400000000
chr16,89811852,89812138,286,-1,0,2175,1,349.65034965035000000000
chr16,89799105,89799291,186,-1,0,92822,1,537.63440860215100000000
chr16,89923906,90103659,179753,-1,0,79007;84501;22980;92806;2622;10381;4157;54849,8,4.45055159023771000000
chr16,90282416,90290986,8570,-1,0,,0,0.00000000000000000000
chr16,90131655,90136922,5267,-1,0,11105,1,18.98614011771410000000
chr16,90183003,90185532,2529,-1,0,,0,0.00000000000000000000
chr16,89967766,89969142,1376,-1,0,22980,1,72.67441860465120000000
chr16,90069368,90071048,1680,-1,0,,0,0.00000000000000000000
chr16,90284232,90285943,1711,-1,0,,0,0.00000000000000000000
chr16,89918457,89919432,975,-1,0,84501,1,102.56410256410300000000
chr16,90070138,90071012,874,-1,0,,0,0.00000000000000000000
chr16,89918457,89918982,525,-1,0,84501,1,190.47619047619000000000
chr16,90048756,90049082,326,-1,0,,0,0.00000000000000000000
chr16,90089998,90090367,369,-1,0,2622,1,271.00271002710000000000
chr17,40650,43137,2487,-1,0,,0,0.00000000000000000000
chr17,16362,18652,2290,-1,0,8447,1,43.66812227074240000000
chr17,30270,31653,1383,-1,0,8447,1,72.30657989877080000000
chr17,41425,42458,1033,-1,0,,0,0.00000000000000000000
chr17,20633,21714,1081,-1,0,8447,1,92.50693802035150000000
chr17,51241,51602,361,-1,0,,0,0.00000000000000000000
chr17,70067,71800,1733,-1,0,9501,1,57.70340450086550000000
chr17,71030,71773,743,-1,0,9501,1,134.58950201884300000000
chr17,83708,84132,424,-1,0,9501,1,235.84905660377400000000
chr17,84863,85925,1062,-1,0,9501,1,94.16195856873820000000
chr17,91934,94016,2082,-1,0,9501,1,48.03073967339100000000
chr17,103454,107780,4326,-1,0,9501,1,23.11604253351830000000
chr17,113943,114427,484,-1,0,9501,1,206.61157024793400000000
chr17,122652,123648,996,-1,0,9501,1,100.40160642570300000000
chr17,122899,123341,442,-1,0,9501,1,226.24434389140300000000
chr17,123237,123367,130,-1,0,9501,1,769.23076923076900000000
chr17,194802,197862,3060,-1,0,9501,1,32.67973856209150000000
chr17,193858,197139,3281,-1,0,9501,1,30.47851264858270000000
chr17,136483,139728,3245,-1,0,9501,1,30.81664098613250000000
chr17,194464,195945,1481,-1,0,9501,1,67.52194463200540000000
chr17,144381,145050,669,-1,0,9501,1,149.47683109118100000000
chr17,205474,206409,935,-1,0,,0,0.00000000000000000000
chr17,184134,184846,712,-1,0,9501,1,140.44943820224700000000
chr17,193452,194022,570,-1,0,9501,1,175.43859649122800000000
chr17,195205,195741,536,-1,0,9501,1,186.56716417910400000000
chr17,153153,153719,566,-1,0,9501,1,176.67844522968200000000
chr17,217214,217734,520,-1,0,,0,0.00000000000000000000
chr17,153700,154084,384,-1,0,9501,1,260.41666666666700000000
chr17,210454,210895,441,-1,0,,0,0.00000000000000000000
chr17,205541,206013,472,-1,0,,0,0.00000000000000000000
chr17,149679,150004,325,-1,0,9501,1,307.69230769230800000000
chr17,213255,213669,414,-1,0,,0,0.00000000000000000000
chr17,184175,184454,279,-1,0,9501,1,358.42293906810000000000
chr17,144328,144617,289,-1,0,9501,1,346.02076124567500000000
chr17,184474,184752,278,-1,0,9501,1,359.71223021582700000000
chr17,184362,184611,249,-1,0,9501,1,401.60642570281100000000
chr17,182928,182990,62,-1,0,100506388;9501,2,3225.80645161290000000000
chr17,185812,185874,62,-1,0,9501,1,1612.90322580645000000000
chr17,230084,230499,415,-1,0,,0,0.00000000000000000000
chr17,245634,262021,16387,-1,0,400566,1,6.10239824250931000000
chr17,252675,254458,1783,-1,0,,0,0.00000000000000000000
chr17,247618,248020,402,-1,0,,0,0.00000000000000000000
chr17,573513,586890,13377,-1,0,55275,1,7.47551767959931000000
chr17,407783,410491,2708,-1,0,,0,0.00000000000000000000
chr17,514797,517211,2414,-1,0,55275,1,41.42502071251040000000
chr17,548982,550033,1051,-1,0,55275,1,95.14747859181730000000
chr17,416884,417929,1045,-1,0,55275,1,95.69377990430620000000
chr17,498146,498928,782,-1,0,55275,1,127.87723785166200000000
chr17,485319,485999,680,-1,0,55275,1,147.05882352941200000000
chr17,412461,413142,681,-1,0,55275,1,146.84287812041100000000
chr17,563676,564143,467,-1,0,55275,1,214.13276231263400000000
chr17,549596,550070,474,-1,0,55275,1,210.97046413502100000000
chr17,456132,456591,459,-1,0,55275,1,217.86492374727700000000
chr17,455410,455781,371,-1,0,55275,1,269.54177897574100000000
chr17,456247,456441,194,-1,0,55275,1,515.46391752577300000000
chr17,451743,451841,98,-1,0,55275,1,1020.40816326531000000000
chr17,407342,407412,70,-1,0,,0,0.00000000000000000000
chr17,412688,412755,67,-1,0,55275,1,1492.53731343284000000000
chr17,658578,659014,436,-1,0,,0,0.00000000000000000000
chr17,691230,731359,40129,-1,0,64359;55178,2,4.98392683595405000000
chr17,699954,704844,4890,-1,0,64359,1,20.44989775051120000000
chr17,965217,968822,3605,-1,0,29,1,27.73925104022190000000
chr17,1019616,1023321,3705,-1,0,29,1,26.99055330634280000000
chr17,1097203,1100223,3020,-1,0,29,1,33.11258278145700000000
chr17,800595,802984,2389,-1,0,64359,1,41.85851820845540000000
chr17,844005,846286,2281,-1,0,64359,1,43.84042086804030000000
chr17,1032848,1035238,2390,-1,0,29,1,41.84100418410040000000
chr17,723418,725269,1851,-1,0,64359,1,54.02485143165860000000
chr17,919608,921351,1743,-1,0,29,1,57.37234652897300000000
chr17,966745,968367,1622,-1,0,29,1,61.65228113440200000000
chr17,894421,895852,1431,-1,0,,0,0.00000000000000000000
chr17,723719,724861,1142,-1,0,64359,1,87.56567425569180000000
chr17,693632,694463,831,-1,0,55178,1,120.33694344163700000000
chr17,855392,856158,766,-1,0,64359,1,130.54830287206300000000
chr17,852101,853021,920,-1,0,64359,1,108.69565217391300000000
chr17,801623,802237,614,-1,0,64359,1,162.86644951140100000000
chr17,896627,897295,668,-1,0,,0,0.00000000000000000000
chr17,667996,668791,795,-1,0,51031,1,125.78616352201300000000
chr17,957561,958149,588,-1,0,29,1,170.06802721088400000000
chr17,738893,739393,500,-1,0,64359,1,200.00000000000000000000
chr17,1056547,1057162,615,-1,0,29,1,162.60162601626000000000
chr17,1097737,1098193,456,-1,0,29,1,219.29824561403500000000
chr17,744498,745002,504,-1,0,64359,1,198.41269841269800000000
chr17,1046166,1046721,555,-1,0,29,1,180.18018018018000000000
chr17,1062525,1063040,515,-1,0,29,1,194.17475728155300000000
chr17,817364,817636,272,-1,0,64359,1,367.64705882352900000000
chr17,887297,887729,432,-1,0,,0,0.00000000000000000000
chr17,724212,724662,450,-1,0,64359,1,222.22222222222200000000
chr17,1034541,1034987,446,-1,0,29,1,224.21524663677100000000
chr17,738961,739329,368,-1,0,64359,1,271.73913043478300000000
chr17,935686,935973,287,-1,0,29,1,348.43205574912900000000
chr17,744725,744963,238,-1,0,64359,1,420.16806722689100000000
chr17,817382,817597,215,-1,0,64359,1,465.11627906976700000000
chr17,1055014,1055162,148,-1,0,29,1,675.67567567567600000000
chr17,777820,778018,198,-1,0,64359,1,505.05050505050500000000
chr17,693864,694058,194,-1,0,55178,1,515.46391752577300000000
chr17,887459,887633,174,-1,0,,0,0.00000000000000000000
chr17,817498,817643,145,-1,0,64359,1,689.65517241379300000000
chr17,957791,957941,150,-1,0,29,1,666.66666666666700000000
chr17,949480,949612,132,-1,0,29,1,757.57575757575800000000
chr17,948687,948738,51,-1,0,29,1,1960.78431372549000000000
chr17,1146029,1148093,2064,-1,0,,0,0.00000000000000000000
chr17,1146328,1147678,1350,-1,0,,0,0.00000000000000000000
chr17,1153348,1153658,310,-1,0,,0,0.00000000000000000000
chr17,1153277,1153528,251,-1,0,,0,0.00000000000000000000
chr17,1163193,1218920,55727,-1,0,727857;286753,2,3.58892457874998000000
chr17,1211126,1215164,4038,-1,0,,0,0.00000000000000000000
chr17,1209636,1210086,450,-1,0,,0,0.00000000000000000000
chr17,1253990,1254820,830,-1,0,7531,1,120.48192771084300000000
chr17,1287705,1297208,9503,-1,0,7531,1,10.52299273913500000000
chr17,1452775,1453136,361,-1,0,5306,1,277.00831024930700000000
chr17,1475837,1491086,15249,-1,0,124935,1,6.55780706931602000000
chr17,1502496,1506852,4356,-1,0,124935,1,22.95684113865930000000
chr17,1594830,1603252,8422,-1,0,,0,0.00000000000000000000
chr17,1642161,1645209,3048,-1,0,,0,0.00000000000000000000
chr17,1654683,1655417,734,-1,0,5345,1,136.23978201634900000000
chr17,1602163,1602938,775,-1,0,,0,0.00000000000000000000
chr17,1912480,1913800,1320,-1,0,146760,1,75.75757575757580000000
chr17,1912675,1913542,867,-1,0,146760,1,115.34025374855800000000
chr17,1916811,1917167,356,-1,0,146760,1,280.89887640449400000000
chr17,1916936,1917063,127,-1,0,146760,1,787.40157480315000000000
chr17,1953101,1959900,6799,-1,0,3090,1,14.70804530077950000000
chr17,1955680,1956380,700,-1,0,,0,0.00000000000000000000
chr17,1966105,1967000,895,-1,0,23293,1,111.73184357541900000000
chr17,2125663,2126193,530,-1,0,23293,1,188.67924528301900000000
chr17,2194711,2195391,680,-1,0,23293,1,147.05882352941200000000
chr17,2194922,2195095,173,-1,0,23293,1,578.03468208092500000000
chr17,2241201,2302800,61599,-1,0,4335;9905,2,3.24680595464212000000
chr17,2246415,2263887,17472,-1,0,9905,1,5.72344322344322000000
chr17,2258055,2260393,2338,-1,0,9905,1,42.77159965782720000000
chr17,2312933,2316564,3631,-1,0,,0,0.00000000000000000000
chr17,2395292,2398213,2921,-1,0,79066,1,34.23485107839780000000
chr17,2398886,2402745,3859,-1,0,79066,1,25.91344908007260000000
chr17,2570592,2571635,1043,-1,0,5048,1,95.87727708533080000000
chr17,3500559,3560495,59936,-1,0,23729;1497;7442,3,5.00533902829685000000
chr17,3492425,3511009,18584,-1,0,7442,1,5.38097287989669000000
chr17,3465010,3474269,9259,-1,0,7442,1,10.80030240846740000000
chr17,3257453,3266974,9521,-1,0,,0,0.00000000000000000000
chr17,2713989,2721352,7363,-1,0,23108,1,13.58142061659650000000
chr17,2640997,2644740,3743,-1,0,,0,0.00000000000000000000
chr17,2690449,2693625,3176,-1,0,23108,1,31.48614609571790000000
chr17,2719695,2721623,1928,-1,0,23108,1,51.86721991701240000000
chr17,3589033,3591351,2318,-1,0,5026,1,43.14063848144950000000
chr17,2903464,2904987,1523,-1,0,23108,1,65.65988181221270000000
chr17,2719918,2721217,1299,-1,0,23108,1,76.98229407236330000000
chr17,3209848,3210302,454,-1,0,,0,0.00000000000000000000
chr17,3287060,3287476,416,-1,0,,0,0.00000000000000000000
chr17,2903786,2904152,366,-1,0,23108,1,273.22404371584700000000
chr17,2904774,2904913,139,-1,0,23108,1,719.42446043165500000000
chr17,3734095,3736492,2397,-1,0,55421,1,41.71881518564870000000
chr17,3734773,3735836,1063,-1,0,55421,1,94.07337723424270000000
chr17,3770876,3771837,961,-1,0,84254,1,104.05827263267400000000
chr17,3771246,3771599,353,-1,0,84254,1,283.28611898017000000000
chr17,3835964,3837452,1488,-1,0,489,1,67.20430107526880000000
chr17,3833309,3833708,399,-1,0,489,1,250.62656641604000000000
chr17,3833499,3833591,92,-1,0,489,1,1086.95652173913000000000
chr17,3989413,3989869,456,-1,0,23140,1,219.29824561403500000000
chr17,4028312,4028854,542,-1,0,23140,1,184.50184501845000000000
chr17,4042152,4042573,421,-1,0,23140,1,237.52969121140100000000
chr17,4094576,4095945,1369,-1,0,51479,1,73.04601899196490000000
chr17,4232183,4233907,1724,-1,0,7326,1,58.00464037122970000000
chr17,4296394,4359045,62651,-1,0,201305,1,1.59614371678026000000
chr17,4365455,4365946,491,-1,0,201305,1,203.66598778004100000000
chr17,4433800,4465872,32072,-1,0,10514;124976;124975,3,9.35395360439012000000
chr17,4564534,4566163,1629,-1,0,,0,0.00000000000000000000
chr17,4640606,4641351,745,-1,0,58191,1,134.22818791946300000000
chr17,4757954,4762364,4410,-1,0,50488,1,22.67573696145120000000
chr17,4825976,4828826,2850,-1,0,,0,0.00000000000000000000
chr17,4836938,4837422,484,-1,0,2811,1,206.61157024793400000000
chr17,4960805,4964408,3603,-1,0,,0,0.00000000000000000000
chr17,5085192,5085754,562,-1,0,84622,1,177.93594306049800000000
chr17,5143358,5156614,13256,-1,0,,0,0.00000000000000000000
chr17,5147179,5148397,1218,-1,0,,0,0.00000000000000000000
chr17,5144290,5144666,376,-1,0,,0,0.00000000000000000000
chr17,5270831,5271332,501,-1,0,9135,1,199.60079840319400000000
chr17,5339111,5340107,996,-1,0,708,1,100.40160642570300000000
chr17,5464668,5465065,397,-1,0,22861,1,251.88916876574300000000
chr17,5587685,5588655,970,-1,0,,0,0.00000000000000000000
chr17,5595707,5597499,1792,-1,0,,0,0.00000000000000000000
chr17,5596232,5596895,663,-1,0,,0,0.00000000000000000000
chr17,5653677,5655544,1867,-1,0,,0,0.00000000000000000000
chr17,5760843,5761901,1058,-1,0,,0,0.00000000000000000000
chr17,5933505,5934022,517,-1,0,,0,0.00000000000000000000
chr17,5933607,5933937,330,-1,0,,0,0.00000000000000000000
chr17,5960061,5962748,2687,-1,0,,0,0.00000000000000000000
chr17,6036465,6036744,279,-1,0,,0,0.00000000000000000000
chr17,6036575,6036713,138,-1,0,,0,0.00000000000000000000
chr17,6101398,6131905,30507,-1,0,,0,0.00000000000000000000
chr17,6107769,6124088,16319,-1,0,,0,0.00000000000000000000
chr17,6129065,6132783,3718,-1,0,,0,0.00000000000000000000
chr17,6292622,6295587,2965,-1,0,,0,0.00000000000000000000
chr17,6204217,6205299,1082,-1,0,,0,0.00000000000000000000
chr17,6422448,6422719,271,-1,0,83394,1,369.00369003690000000000
chr17,6464076,6465001,925,-1,0,,0,0.00000000000000000000
chr17,6749336,6865997,116661,-1,0,,0,0.00000000000000000000
chr17,6865245,6867271,2026,-1,0,,0,0.00000000000000000000
chr17,6855184,6856586,1402,-1,0,,0,0.00000000000000000000
chr17,6649927,6650991,1064,-1,0,,0,0.00000000000000000000
chr17,6871550,6877187,5637,-1,0,,0,0.00000000000000000000
chr17,6874595,6875133,538,-1,0,,0,0.00000000000000000000
chr17,6874731,6875034,303,-1,0,,0,0.00000000000000000000
chr17,6882397,6883803,1406,-1,0,,0,0.00000000000000000000
chr17,6940523,6940914,391,-1,0,201232,1,255.75447570332500000000
chr17,6988722,6989961,1239,-1,0,,0,0.00000000000000000000
chr17,7022723,7277687,254964,-1,0,1742;6517;1856;37;147040;51087;432;2874;339168;11337;84461;1984;23399;23587;1366;79142;9744,17,6.66760797602799000000
chr17,6996420,7002958,6538,-1,0,,0,0.00000000000000000000
chr17,7241093,7243560,2467,-1,0,9744,1,40.53506282934740000000
chr17,7264576,7265993,1417,-1,0,,0,0.00000000000000000000
chr17,7336423,7337723,1300,-1,0,,0,0.00000000000000000000
chr17,7337030,7337666,636,-1,0,,0,0.00000000000000000000
chr17,7524413,7524918,505,-1,0,6462,1,198.01980198019800000000
chr17,7564556,7566153,1597,-1,0,,0,0.00000000000000000000
chr17,7729806,7732379,2573,-1,0,146754,1,38.86513797123980000000
chr17,7882779,7884139,1360,-1,0,,0,0.00000000000000000000
chr17,8246618,8247966,1348,-1,0,146852,1,74.18397626112760000000
chr17,8289402,8289728,326,-1,0,,0,0.00000000000000000000
chr17,8384267,8384674,407,-1,0,4628,1,245.70024570024600000000
chr17,8384442,8384514,72,-1,0,4628,1,1388.88888888889000000000
chr17,8384400,8384469,69,-1,0,4628,1,1449.27536231884000000000
chr17,8595994,8596195,201,-1,0,,0,0.00000000000000000000
chr17,8711645,8713995,2350,-1,0,146850,1,42.55319148936170000000
chr17,8713425,8715287,1862,-1,0,146850,1,53.70569280343720000000
chr17,9065214,9065332,118,-1,0,9423,1,847.45762711864400000000
chr17,9135540,9137168,1628,-1,0,9423,1,61.42506142506140000000
chr17,9178943,9181499,2556,-1,0,9482,1,39.12363067292640000000
chr17,9341991,9344559,2568,-1,0,9482,1,38.94080996884740000000
chr17,10006447,10006963,516,-1,0,8522,1,193.79844961240300000000
chr17,10201490,10201998,508,-1,0,,0,0.00000000000000000000
chr17,10203325,10203880,555,-1,0,,0,0.00000000000000000000
chr17,10203423,10203778,355,-1,0,,0,0.00000000000000000000
chr17,10236855,10286756,49901,-1,0,8735,1,2.00396785635558000000
chr17,10347172,10357347,10175,-1,0,4622,1,9.82800982800983000000
chr17,10226054,10232155,6101,-1,0,8735,1,16.39075561383380000000
chr17,10761932,10767032,5100,-1,0,,0,0.00000000000000000000
chr17,10749821,10750361,540,-1,0,,0,0.00000000000000000000
chr17,10749943,10750231,288,-1,0,,0,0.00000000000000000000
chr17,10886860,10895883,9023,-1,0,,0,0.00000000000000000000
chr17,11028164,11036449,8285,-1,0,,0,0.00000000000000000000
chr17,11194552,11196254,1702,-1,0,388336,1,58.75440658049350000000
chr17,11249958,11263386,13428,-1,0,388336,1,7.44712540959190000000
chr17,11355693,11356247,554,-1,0,388336,1,180.50541516245500000000
chr17,11411657,11413186,1529,-1,0,388336,1,65.40222367560500000000
chr17,11411662,11412339,677,-1,0,388336,1,147.71048744460900000000
chr17,11429987,11430438,451,-1,0,388336,1,221.72949002217300000000
chr17,11430186,11430241,55,-1,0,388336,1,1818.18181818182000000000
chr17,11479838,11485016,5178,-1,0,,0,0.00000000000000000000
chr17,11557369,11557691,322,-1,0,1770,1,310.55900621118000000000
chr17,11570962,11571857,895,-1,0,1770,1,111.73184357541900000000
chr17,11597956,11598266,310,-1,0,1770,1,322.58064516129000000000
chr17,11598001,11598191,190,-1,0,1770,1,526.31578947368400000000
chr17,12118476,12119622,1146,-1,0,,0,0.00000000000000000000
chr17,12196480,12197033,553,-1,0,,0,0.00000000000000000000
chr17,12196580,12196904,324,-1,0,,0,0.00000000000000000000
chr17,12279619,12281811,2192,-1,0,,0,0.00000000000000000000
chr17,12345648,12347221,1573,-1,0,,0,0.00000000000000000000
chr17,12346725,12346911,186,-1,0,,0,0.00000000000000000000
chr17,12352940,12359501,6561,-1,0,,0,0.00000000000000000000
chr17,12379911,12387887,7976,-1,0,,0,0.00000000000000000000
chr17,12922823,12923253,430,-1,0,,0,0.00000000000000000000
chr17,13089294,13098604,9310,-1,0,,0,0.00000000000000000000
chr17,13161065,13161485,420,-1,0,,0,0.00000000000000000000
chr17,13220396,13220924,528,-1,0,,0,0.00000000000000000000
chr17,13220497,13220800,303,-1,0,,0,0.00000000000000000000
chr17,13531669,13533168,1499,-1,0,,0,0.00000000000000000000
chr17,13531999,13532626,627,-1,0,,0,0.00000000000000000000
chr17,13686827,13687387,560,-1,0,,0,0.00000000000000000000
chr17,13704469,13704954,485,-1,0,,0,0.00000000000000000000
chr17,13704553,13704841,288,-1,0,,0,0.00000000000000000000
chr17,14078264,15479940,1401676,-1,0,1352;64518;9953;201158;284040;100533496;5376;374286;146822,9,0.64208847123015600000
chr17,14676699,14996268,319569,-1,0,,0,0.00000000000000000000
chr17,15507961,15559384,51423,-1,0,374286;10626,2,3.88931023083056000000
chr17,14300914,14367997,67083,-1,0,,0,0.00000000000000000000
chr17,14010746,14044523,33777,-1,0,1352,1,2.96059448737306000000
chr17,15043741,15058726,14985,-1,0,,0,0.00000000000000000000
chr17,14190576,14196829,6253,-1,0,,0,0.00000000000000000000
chr17,15541001,15546800,5799,-1,0,10626,1,17.24435247456460000000
chr17,15183455,15185721,2266,-1,0,,0,0.00000000000000000000
chr17,14188236,14191556,3320,-1,0,,0,0.00000000000000000000
chr17,15268921,15272022,3101,-1,0,,0,0.00000000000000000000
chr17,15046090,15048181,2091,-1,0,,0,0.00000000000000000000
chr17,14939346,14940799,1453,-1,0,,0,0.00000000000000000000
chr17,15183449,15185084,1635,-1,0,,0,0.00000000000000000000
chr17,14189909,14191556,1647,-1,0,,0,0.00000000000000000000
chr17,14240920,14242030,1110,-1,0,9953,1,90.09009009009010000000
chr17,14939000,14940030,1030,-1,0,,0,0.00000000000000000000
chr17,14190882,14191686,804,-1,0,,0,0.00000000000000000000
chr17,15368299,15368776,477,-1,0,100533496;284040,2,419.28721174004200000000
chr17,14050931,14051489,558,-1,0,1352,1,179.21146953405000000000
chr17,14685515,14685927,412,-1,0,,0,0.00000000000000000000
chr17,15505918,15506244,326,-1,0,374286,1,306.74846625766900000000
chr17,15591107,15597226,6119,-1,0,,0,0.00000000000000000000
chr17,15635311,15678213,42902,-1,0,353149,1,2.33089366463102000000
chr17,15676815,15694773,17958,-1,0,,0,0.00000000000000000000
chr17,16573488,16589231,15743,-1,0,,0,0.00000000000000000000
chr17,16711606,16724681,13075,-1,0,,0,0.00000000000000000000
chr17,15696480,15703058,6578,-1,0,,0,0.00000000000000000000
chr17,15789360,15793666,4306,-1,0,,0,0.00000000000000000000
chr17,16719362,16724158,4796,-1,0,,0,0.00000000000000000000
chr17,15789862,15793847,3985,-1,0,,0,0.00000000000000000000
chr17,16716993,16719843,2850,-1,0,,0,0.00000000000000000000
chr17,16721901,16725183,3282,-1,0,,0,0.00000000000000000000
chr17,16402048,16404512,2464,-1,0,,0,0.00000000000000000000
chr17,16204668,16206942,2274,-1,0,9487,1,43.97537379067720000000
chr17,16505267,16506668,1401,-1,0,,0,0.00000000000000000000
chr17,16505450,16506298,848,-1,0,,0,0.00000000000000000000
chr17,16394909,16395705,796,-1,0,388341,1,125.62814070351800000000
chr17,15863515,15863933,418,-1,0,136,1,239.23444976076600000000
chr17,16095147,16095627,480,-1,0,9611,1,208.33333333333300000000
chr17,16860390,16863411,3021,-1,0,23495,1,33.10162197947700000000
chr17,17024202,17025392,1190,-1,0,23164,1,84.03361344537820000000
chr17,17210787,17210903,116,-1,0,56953,1,862.06896551724100000000
chr17,17231284,17235583,4299,-1,0,56953,1,23.26122354035820000000
chr17,17234124,17235288,1164,-1,0,56953,1,85.91065292096220000000
chr17,17230369,17231247,878,-1,0,56953,1,113.89521640091100000000
chr17,17308837,17348469,39632,-1,0,,0,0.00000000000000000000
chr17,17523197,17523909,712,-1,0,,0,0.00000000000000000000
chr17,17553924,17558243,4319,-1,0,,0,0.00000000000000000000
chr17,18182766,18182899,133,-1,0,7156,1,751.87969924812000000000
chr17,18270137,18271646,1509,-1,0,,0,0.00000000000000000000
chr17,18939314,19142391,203077,-1,0,79999;22905;388436;400581;10750,5,2.46212027949989000000
chr17,18345823,18481599,135776,-1,0,654346;80039,2,1.47301437662032000000
chr17,18322349,18445526,123177,-1,0,654346;80039,2,1.62367974540702000000
chr17,18418589,18465114,46525,-1,0,80039,1,2.14938205265986000000
chr17,18360987,18423115,62128,-1,0,654346,1,1.60958022147824000000
chr17,18357623,18396412,38789,-1,0,654346,1,2.57805047822836000000
chr17,18359790,18376723,16933,-1,0,,0,0.00000000000000000000
chr17,18605964,18611527,5563,-1,0,,0,0.00000000000000000000
chr17,19397268,19399840,2572,-1,0,,0,0.00000000000000000000
chr17,18790721,18792420,1699,-1,0,5636,1,58.85815185403180000000
chr17,19331354,19332723,1369,-1,0,,0,0.00000000000000000000
chr17,18791138,18792163,1025,-1,0,5636,1,97.56097560975610000000
chr17,18784692,18785299,607,-1,0,5636,1,164.74464579901200000000
chr17,18593032,18593450,418,-1,0,,0,0.00000000000000000000
chr17,19410134,19410441,307,-1,0,,0,0.00000000000000000000
chr17,18637477,18637798,321,-1,0,147166,1,311.52647975077900000000
chr17,19498412,19538741,40329,-1,0,,0,0.00000000000000000000
chr17,19498349,19519896,21547,-1,0,,0,0.00000000000000000000
chr17,19543328,19543846,518,-1,0,,0,0.00000000000000000000
chr17,19571909,19572320,411,-1,0,224,1,243.30900243309000000000
chr17,19780874,19791073,10199,-1,0,,0,0.00000000000000000000
chr17,19902303,19902707,404,-1,0,,0,0.00000000000000000000
chr17,19983284,20000080,16796,-1,0,92521,1,5.95379852345797000000
chr17,19976455,19984355,7900,-1,0,92521,1,12.65822784810130000000
chr17,20445741,20603495,157754,-1,0,256223,1,0.63389834806090500000
chr17,20152031,20240205,88174,-1,0,92521,1,1.13412116950575000000
chr17,20345577,20395931,50354,-1,0,284194,1,1.98593954800016000000
chr17,20334434,20377615,43181,-1,0,284194,1,2.31583335263194000000
chr17,20239506,20248523,9017,-1,0,,0,0.00000000000000000000
chr17,20459970,20460460,490,-1,0,,0,0.00000000000000000000
chr17,20611057,20614592,3535,-1,0,,0,0.00000000000000000000
chr17,20678739,20680295,1556,-1,0,,0,0.00000000000000000000
chr17,20662619,20663096,477,-1,0,,0,0.00000000000000000000
chr17,20715273,20792980,77707,-1,0,339184,1,1.28688535138405000000
chr17,20796165,20800881,4716,-1,0,339184,1,21.20441051738760000000
chr17,20823204,20825743,2539,-1,0,,0,0.00000000000000000000
chr17,21107046,21111606,4560,-1,0,8834,1,21.92982456140350000000
chr17,21212574,21221757,9183,-1,0,5606,1,10.88968746596970000000
chr17,21328517,21521738,193221,-1,0,339263,1,0.51754208911039700000
chr17,22163316,22204314,40998,-1,0,,0,0.00000000000000000000
chr17,21530251,21558099,27848,-1,0,,0,0.00000000000000000000
chr17,21836380,21858925,22545,-1,0,,0,0.00000000000000000000
chr17,22244693,22262910,18217,-1,0,,0,0.00000000000000000000
chr17,22017293,22031979,14686,-1,0,100462977,1,6.80920604657497000000
chr17,21840176,21848661,8485,-1,0,,0,0.00000000000000000000
chr17,21901878,21910099,8221,-1,0,,0,0.00000000000000000000
chr17,21792066,21797126,5060,-1,0,,0,0.00000000000000000000
chr17,22060462,22066737,6275,-1,0,,0,0.00000000000000000000
chr17,21369854,21374377,4523,-1,0,,0,0.00000000000000000000
chr17,25263046,25268055,5009,-1,0,,0,0.00000000000000000000
chr17,21321030,21324929,3899,-1,0,3768,1,25.64760194921770000000
chr17,21884579,21889320,4741,-1,0,,0,0.00000000000000000000
chr17,21792174,21795905,3731,-1,0,,0,0.00000000000000000000
chr17,21877874,21882115,4241,-1,0,,0,0.00000000000000000000
chr17,21370319,21372142,1823,-1,0,,0,0.00000000000000000000
chr17,25263774,25266127,2353,-1,0,,0,0.00000000000000000000
chr17,22069377,22071288,1911,-1,0,,0,0.00000000000000000000
chr17,21849412,21851167,1755,-1,0,,0,0.00000000000000000000
chr17,21321197,21322959,1762,-1,0,3768,1,56.75368898978430000000
chr17,21556657,21558095,1438,-1,0,,0,0.00000000000000000000
chr17,21482905,21483820,915,-1,0,,0,0.00000000000000000000
chr17,21736664,21737289,625,-1,0,,0,0.00000000000000000000
chr17,25386048,25455557,69509,-1,0,,0,0.00000000000000000000
chr17,25462402,25501158,38756,-1,0,,0,0.00000000000000000000
chr17,25744177,25757069,12892,-1,0,,0,0.00000000000000000000
chr17,25480982,25485759,4777,-1,0,,0,0.00000000000000000000
chr17,25536538,25540383,3845,-1,0,,0,0.00000000000000000000
chr17,25464253,25467308,3055,-1,0,,0,0.00000000000000000000
chr17,25536609,25538254,1645,-1,0,,0,0.00000000000000000000
chr17,25568219,25569344,1125,-1,0,,0,0.00000000000000000000
chr17,25979897,26085825,105928,-1,0,4843,1,0.94403745940638900000
chr17,26030245,26030708,463,-1,0,,0,0.00000000000000000000
chr17,26030427,26030499,72,-1,0,,0,0.00000000000000000000
chr17,26576904,26590178,13274,-1,0,,0,0.00000000000000000000
chr17,26780359,26783483,3124,-1,0,,0,0.00000000000000000000
chr17,26780482,26782173,1691,-1,0,,0,0.00000000000000000000
chr17,26780485,26781662,1177,-1,0,,0,0.00000000000000000000
chr17,26782397,26783495,1098,-1,0,,0,0.00000000000000000000
chr17,26843060,26844640,1580,-1,0,,0,0.00000000000000000000
chr17,26843766,26844173,407,-1,0,,0,0.00000000000000000000
chr17,27019324,27020010,686,-1,0,6830,1,145.77259475218700000000
chr17,27128338,27131864,3526,-1,0,55731,1,28.36074872376630000000
chr17,27173638,27179645,6007,-1,0,,0,0.00000000000000000000
chr17,27593167,27594170,1003,-1,0,57532,1,99.70089730807580000000
chr17,27715196,27716000,804,-1,0,,0,0.00000000000000000000
chr17,27782139,27784324,2185,-1,0,57551,1,45.76659038901600000000
chr17,28179093,28181760,2667,-1,0,85464,1,37.49531308586430000000
chr17,28209545,28209626,81,-1,0,85464,1,1234.56790123457000000000
chr17,28345516,28353389,7873,-1,0,374786,1,12.70163851136800000000
chr17,28686461,28686667,206,-1,0,,0,0.00000000000000000000
chr17,28712359,28712607,248,-1,0,1362,1,403.22580645161300000000
chr17,29015368,29025404,10036,-1,0,,0,0.00000000000000000000
chr17,29200990,29203018,2028,-1,0,79915,1,49.30966469428010000000
chr17,29186701,29187068,367,-1,0,79915,1,272.47956403269800000000
chr17,28988474,28989133,659,-1,0,,0,0.00000000000000000000
chr17,29232848,29233362,514,-1,0,79736,1,194.55252918287900000000
chr17,29557885,29559660,1775,-1,0,4763,1,56.33802816901410000000
chr17,29659590,29659941,351,-1,0,4763,1,284.90028490028500000000
chr17,29743488,29744805,1317,-1,0,84440,1,75.93014426727410000000
chr17,29830229,29831505,1276,-1,0,84440,1,78.36990595611280000000
chr17,29830189,29831287,1098,-1,0,84440,1,91.07468123861570000000
chr17,29986273,29986378,105,-1,0,,0,0.00000000000000000000
chr17,29989529,29991455,1926,-1,0,,0,0.00000000000000000000
chr17,30098748,30098852,104,-1,0,,0,0.00000000000000000000
chr17,30106608,30107555,947,-1,0,,0,0.00000000000000000000
chr17,30106743,30107649,906,-1,0,,0,0.00000000000000000000
chr17,30106632,30107449,817,-1,0,,0,0.00000000000000000000
chr17,30293356,30295368,2012,-1,0,23512,1,49.70178926441350000000
chr17,30436623,30437168,545,-1,0,,0,0.00000000000000000000
chr17,30436736,30437055,319,-1,0,,0,0.00000000000000000000
chr17,30603717,30603964,247,-1,0,162494,1,404.85829959514200000000
chr17,30813048,30814615,1567,-1,0,8851,1,63.81620931716660000000
chr17,31477673,31477962,289,-1,0,40,1,346.02076124567500000000
chr17,31477691,31477940,249,-1,0,40,1,401.60642570281100000000
chr17,31596498,31596919,421,-1,0,40,1,237.52969121140100000000
chr17,31797855,31798027,172,-1,0,40,1,581.39534883720900000000
chr17,32050007,32055666,5659,-1,0,40,1,17.67096660187310000000
chr17,32426151,32426206,55,-1,0,40,1,1818.18181818182000000000
chr17,32430680,32435814,5134,-1,0,40,1,19.47798987144530000000
chr17,32484853,32485010,157,-1,0,,0,0.00000000000000000000
chr17,32601646,32602120,474,-1,0,,0,0.00000000000000000000
chr17,32872776,32874502,1726,-1,0,,0,0.00000000000000000000
chr17,32982071,32983439,1368,-1,0,,0,0.00000000000000000000
chr17,33115847,33122203,6356,-1,0,,0,0.00000000000000000000
chr17,33237196,33238256,1060,-1,0,,0,0.00000000000000000000
chr17,33679018,33766844,87826,-1,0,91607;146857;55106,3,3.41584496618314000000
chr17,33888820,33889126,306,-1,0,,0,0.00000000000000000000
chr17,34211128,34212040,912,-1,0,,0,0.00000000000000000000
chr17,34376178,34376661,483,-1,0,,0,0.00000000000000000000
chr17,34376270,34376606,336,-1,0,,0,0.00000000000000000000
chr17,34456075,34652750,196675,-1,0,6349;414062;9560;414060;414059,5,2.54226515825601000000
chr17,34533835,34660318,126483,-1,0,6349;9560;414060,3,2.37186024999407000000
chr17,34425090,34532313,107223,-1,0,414062;6351;414059,3,2.79790716544025000000
chr17,34731665,34812660,80995,-1,0,729877;101060321,2,2.46928822766837000000
chr17,34593529,34669295,75766,-1,0,6349,1,1.31985323232057000000
chr17,34436830,34483425,46595,-1,0,,0,0.00000000000000000000
chr17,34509779,34551554,41775,-1,0,9560;414062,2,4.78755236385398000000
chr17,34553542,34590398,36856,-1,0,414060,1,2.71326242674191000000
chr17,34761100,34793664,32564,-1,0,,0,0.00000000000000000000
chr17,34600303,34636409,36106,-1,0,6349,1,2.76962277737772000000
chr17,34529177,34565438,36261,-1,0,9560,1,2.75778384490224000000
chr17,34408126,34436810,28684,-1,0,6348;6351,2,6.97252823873937000000
chr17,34616319,34645039,28720,-1,0,6349,1,3.48189415041783000000
chr17,34486687,34506344,19657,-1,0,414059,1,5.08724627359210000000
chr17,34790817,34808921,18104,-1,0,101060321,1,5.52364118426867000000
chr17,34600150,34610946,10796,-1,0,,0,0.00000000000000000000
chr17,34596582,34602749,6167,-1,0,,0,0.00000000000000000000
chr17,35093779,35094478,699,-1,0,,0,0.00000000000000000000
chr17,35138360,35146810,8450,-1,0,,0,0.00000000000000000000
chr17,35143333,35143864,531,-1,0,,0,0.00000000000000000000
chr17,35143464,35143795,331,-1,0,,0,0.00000000000000000000
chr17,35250482,35250933,451,-1,0,,0,0.00000000000000000000
chr17,35378842,35379205,363,-1,0,26574,1,275.48209366391200000000
chr17,35437554,35438266,712,-1,0,,0,0.00000000000000000000
chr17,35514542,35516279,1737,-1,0,31,1,57.57052389176740000000
chr17,35689166,35694701,5535,-1,0,31,1,18.06684733514000000000
chr17,35737739,35738856,1117,-1,0,284099;31,2,179.05102954342000000000
chr17,35746882,35762334,15452,-1,0,284099;31,2,12.94330830960390000000
chr17,35754275,35759211,4936,-1,0,31,1,20.25931928687200000000
chr17,35755661,35759181,3520,-1,0,31,1,28.40909090909090000000
chr17,35756094,35758390,2296,-1,0,31,1,43.55400696864110000000
chr17,35757355,35758600,1245,-1,0,31,1,80.32128514056230000000
chr17,35778796,35782492,3696,-1,0,6871,1,27.05627705627710000000
chr17,35796588,35797660,1072,-1,0,6871,1,93.28358208955220000000
chr17,35937799,35940398,2599,-1,0,11276,1,38.47633705271260000000
chr17,36038357,36038422,65,-1,0,,0,0.00000000000000000000
chr17,36167608,36169267,1659,-1,0,,0,0.00000000000000000000
chr17,36331658,36405784,74126,-1,0,729873,1,1.34905431292664000000
chr17,36249783,36280752,30969,-1,0,,0,0.00000000000000000000
chr17,36296988,36324503,27515,-1,0,,0,0.00000000000000000000
chr17,36387317,36405330,18013,-1,0,,0,0.00000000000000000000
chr17,36406166,36419076,12910,-1,0,,0,0.00000000000000000000
chr17,36400792,36405498,4706,-1,0,,0,0.00000000000000000000
chr17,36402195,36405078,2883,-1,0,,0,0.00000000000000000000
chr17,36542936,36543090,154,-1,0,30837,1,649.35064935064900000000
chr17,36543560,36543829,269,-1,0,30837,1,371.74721189591100000000
chr17,36682220,36683550,1330,-1,0,,0,0.00000000000000000000
chr17,36963473,36964969,1496,-1,0,54883,1,66.84491978609630000000
chr17,37095377,37097517,2140,-1,0,494188,1,46.72897196261680000000
chr17,37191862,37194306,2444,-1,0,,0,0.00000000000000000000
chr17,37287609,37290071,2462,-1,0,57125,1,40.61738424045490000000
chr17,37448147,37448752,605,-1,0,84961,1,165.28925619834700000000
chr17,37655133,37655532,399,-1,0,51755,1,250.62656641604000000000
chr17,37655203,37655484,281,-1,0,51755,1,355.87188612099600000000
chr17,37748967,37750784,1817,-1,0,,0,0.00000000000000000000
chr17,38058905,38059304,399,-1,0,,0,0.00000000000000000000
chr17,38300055,38303042,2987,-1,0,22794,1,33.47840642785400000000
chr17,38378944,38380544,1600,-1,0,147179,1,62.50000000000000000000
chr17,38377859,38378472,613,-1,0,147179,1,163.13213703099500000000
chr17,38582262,38589489,7227,-1,0,,0,0.00000000000000000000
chr17,38688335,38689380,1045,-1,0,,0,0.00000000000000000000
chr17,39195641,39217762,22121,-1,0,730755;81872;81851;728279,4,18.08236517336470000000
chr17,39211933,39232862,20929,-1,0,730755;85294,2,9.55611830474461000000
chr17,39252794,39276767,23973,-1,0,653240;728224;100132386,3,12.51407833813040000000
chr17,39244269,39264331,20062,-1,0,728224;100132386,2,9.96909580301067000000
chr17,39254470,39275500,21030,-1,0,653240;100132386,2,9.51022349025202000000
chr17,39210765,39221852,11087,-1,0,730755;85294;728279,3,27.05871741679440000000
chr17,39212325,39220355,8030,-1,0,730755,1,12.45330012453300000000
chr17,39203278,39211468,8190,-1,0,81872;728279,2,24.42002442002440000000
chr17,39190036,39195883,5847,-1,0,81850,1,17.10278775440400000000
chr17,39150230,39156005,5775,-1,0,83897;85293,2,34.63203463203460000000
chr17,39134107,39139975,5868,-1,0,125115,1,17.04158145875940000000
chr17,39237631,39239236,1605,-1,0,,0,0.00000000000000000000
chr17,39197007,39198079,1072,-1,0,81851,1,93.28358208955220000000
chr17,39197272,39197806,534,-1,0,81851,1,187.26591760299600000000
chr17,39340803,39340860,57,-1,0,85285,1,1754.38596491228000000000
chr17,39382241,39432514,50273,-1,0,81870;85280;83900;83901;83899;100507608;100505724,7,13.92397509597600000000
chr17,39382644,39407193,24549,-1,0,83899;85280;83901;83900,4,16.29394272679130000000
chr17,39416178,39430551,14373,-1,0,100507608,1,6.95748973770264000000
chr17,39383317,39396444,13127,-1,0,83899;83901;83900,3,22.85366039460650000000
chr17,39421684,39433812,12128,-1,0,100507608;100505724,2,16.49076517150400000000
chr17,39384291,39392558,8267,-1,0,83900,1,12.09628644006290000000
chr17,39422988,39430527,7539,-1,0,,0,0.00000000000000000000
chr17,39390296,39395560,5264,-1,0,83901,1,18.99696048632220000000
chr17,39429150,39433594,4444,-1,0,100505724,1,22.50225022502250000000
chr17,39392100,39392154,54,-1,0,,0,0.00000000000000000000
chr17,39444992,39445106,114,-1,0,,0,0.00000000000000000000
chr17,39506604,39525797,19193,-1,0,3883;3884,2,10.42046579482100000000
chr17,39582294,39584306,2012,-1,0,,0,0.00000000000000000000
chr17,39738094,39741953,3859,-1,0,3861,1,25.91344908007260000000
chr17,39787057,39787213,156,-1,0,,0,0.00000000000000000000
chr17,39964902,39965860,958,-1,0,10609,1,104.38413361169100000000
chr17,40166353,40167164,811,-1,0,7266,1,123.30456226880400000000
chr17,40218842,40221897,3055,-1,0,,0,0.00000000000000000000
chr17,40427345,40428983,1638,-1,0,6777,1,61.05006105006110000000
chr17,40489726,40491051,1325,-1,0,6774,1,75.47169811320750000000
chr17,40489925,40490541,616,-1,0,6774,1,162.33766233766200000000
chr17,40701877,40708476,6599,-1,0,3292,1,15.15381118351270000000
chr17,40909164,40910136,972,-1,0,,0,0.00000000000000000000
chr17,41094511,41097124,2613,-1,0,,0,0.00000000000000000000
chr17,41383440,41465913,82473,-1,0,,0,0.00000000000000000000
chr17,41382324,41400212,17888,-1,0,,0,0.00000000000000000000
chr17,41432074,41440371,8297,-1,0,,0,0.00000000000000000000
chr17,41438738,41445350,6612,-1,0,,0,0.00000000000000000000
chr17,41438042,41442165,4123,-1,0,,0,0.00000000000000000000
chr17,41437890,41440399,2509,-1,0,,0,0.00000000000000000000
chr17,41438612,41440387,1775,-1,0,,0,0.00000000000000000000
chr17,41333882,41335563,1681,-1,0,4077,1,59.48839976204640000000
chr17,41163348,41164541,1193,-1,0,3430,1,83.82229673093040000000
chr17,41153410,41154283,873,-1,0,6155,1,114.54753722795000000000
chr17,41401877,41402577,700,-1,0,,0,0.00000000000000000000
chr17,41119211,41119420,209,-1,0,100885850,1,478.46889952153100000000
chr17,41517016,41518244,1228,-1,0,,0,0.00000000000000000000
chr17,41517440,41518137,697,-1,0,,0,0.00000000000000000000
chr17,41667338,41668459,1121,-1,0,,0,0.00000000000000000000
chr17,41671547,41672586,1039,-1,0,,0,0.00000000000000000000
chr17,41847850,41849205,1355,-1,0,1845,1,73.80073800738010000000
chr17,41912820,41913962,1142,-1,0,,0,0.00000000000000000000
chr17,42122439,42124712,2273,-1,0,124801,1,43.99472063352400000000
chr17,42295884,42298849,2965,-1,0,7343,1,33.72681281618890000000
chr17,42372838,42374471,1633,-1,0,,0,0.00000000000000000000
chr17,42430542,42432495,1953,-1,0,284069,1,51.20327700972860000000
chr17,42651497,42652145,648,-1,0,,0,0.00000000000000000000
chr17,42668165,42668516,351,-1,0,,0,0.00000000000000000000
chr17,42791254,42796435,5181,-1,0,80174,1,19.30129318664350000000
chr17,42888512,42891796,3284,-1,0,10052,1,30.45066991473810000000
chr17,43001245,43002528,1283,-1,0,146909,1,77.94232268121590000000
chr17,43123863,43128210,4347,-1,0,79877,1,23.00437083045780000000
chr17,43256768,43258940,2172,-1,0,,0,0.00000000000000000000
chr17,44281452,45168501,887049,-1,0,474170;100506084;284058;9570;7484;388394;51326;7473;9884;4905,10,1.12733343930268000000
chr17,44385867,44752364,366497,-1,0,474170;51326;4905;9884;100506084,5,1.36426764748415000000
chr17,44510409,44754695,244286,-1,0,4905;474170;51326,3,1.22806873910089000000
chr17,44415959,44583682,167723,-1,0,100506084,1,0.59622115034908800000
chr17,44249512,44458174,208662,-1,0,100506084;9884;284058,3,1.43773183425827000000
chr17,44192776,44349579,156803,-1,0,284058,1,0.63774290032716200000
chr17,44643087,44784481,141394,-1,0,4905;51326,2,1.41448717767373000000
chr17,44208418,44284322,75904,-1,0,284058,1,1.31745362563238000000
chr17,43579322,43660249,80927,-1,0,,0,0.00000000000000000000
chr17,44265488,44350849,85361,-1,0,284058,1,1.17149517929734000000
chr17,44217768,44276313,58545,-1,0,284058,1,1.70808779571270000000
chr17,44228894,44288442,59548,-1,0,284058,1,1.67931752535769000000
chr17,44307534,44362619,55085,-1,0,,0,0.00000000000000000000
chr17,44210022,44249288,39266,-1,0,284058,1,2.54673254214842000000
chr17,43627184,43660691,33507,-1,0,,0,0.00000000000000000000
chr17,44259897,44286186,26289,-1,0,284058,1,3.80387234204420000000
chr17,44224116,44249152,25036,-1,0,284058,1,3.99424828247324000000
chr17,43753209,43773077,19868,-1,0,104909134,1,5.03321924703040000000
chr17,43649017,43662465,13448,-1,0,,0,0.00000000000000000000
chr17,45117152,45133586,16434,-1,0,,0,0.00000000000000000000
chr17,43638621,43653206,14585,-1,0,,0,0.00000000000000000000
chr17,45142849,45153796,10947,-1,0,,0,0.00000000000000000000
chr17,43647872,43656644,8772,-1,0,,0,0.00000000000000000000
chr17,43651245,43659295,8050,-1,0,,0,0.00000000000000000000
chr17,43591053,43598456,7403,-1,0,,0,0.00000000000000000000
chr17,43620601,43628300,7699,-1,0,,0,0.00000000000000000000
chr17,43925039,43929324,4285,-1,0,,0,0.00000000000000000000
chr17,44848454,44849701,1247,-1,0,7473,1,80.19246190858060000000
chr17,44314867,44315591,724,-1,0,,0,0.00000000000000000000
chr17,44270310,44271101,791,-1,0,284058,1,126.42225031605600000000
chr17,44223906,44224221,315,-1,0,284058,1,317.46031746031700000000
chr17,44176393,44176717,324,-1,0,284058,1,308.64197530864200000000
chr17,44086722,44086961,239,-1,0,4137,1,418.41004184100400000000
chr17,44888487,44888655,168,-1,0,7473,1,595.23809523809500000000
chr17,45213238,45213541,303,-1,0,996,1,330.03300330033000000000
chr17,45214754,45219197,4443,-1,0,996,1,22.50731487733510000000
chr17,45214805,45216045,1240,-1,0,996,1,80.64516129032260000000
chr17,45221254,45232025,10771,-1,0,996,1,9.28418902608857000000
chr17,45219546,45221204,1658,-1,0,996,1,60.31363088057900000000
chr17,45219361,45219640,279,-1,0,996,1,358.42293906810000000000
chr17,45249401,45266371,16970,-1,0,996,1,5.89275191514437000000
chr17,45235368,45248428,13060,-1,0,996,1,7.65696784073507000000
chr17,45234548,45235504,956,-1,0,996,1,104.60251046025100000000
chr17,45426457,45510143,83686,-1,0,124989,1,1.19494300121884000000
chr17,45474274,45493972,19698,-1,0,124989,1,5.07665752868312000000
chr17,45615617,45672004,56387,-1,0,9520,1,1.77345842126731000000
chr17,45615829,45634020,18191,-1,0,9520,1,5.49722390192953000000
chr17,45615401,45621620,6219,-1,0,9520,1,16.07975558771510000000
chr17,45616285,45619782,3497,-1,0,9520,1,28.59593937660850000000
chr17,45634781,45635291,510,-1,0,9520,1,196.07843137254900000000
chr17,46159821,46162257,2436,-1,0,10951,1,41.05090311986860000000
chr17,46400260,46402406,2146,-1,0,8631,1,46.59832246039140000000
chr17,46615794,46617259,1465,-1,0,,0,0.00000000000000000000
chr17,46746184,46748955,2771,-1,0,,0,0.00000000000000000000
chr17,46904768,46907439,2671,-1,0,,0,0.00000000000000000000
chr17,46906163,46907184,1021,-1,0,,0,0.00000000000000000000
chr17,46944269,46949832,5563,-1,0,,0,0.00000000000000000000
chr17,47037140,47037876,736,-1,0,2695,1,135.86956521739100000000
chr17,47037349,47037868,519,-1,0,2695,1,192.67822736030800000000
chr17,47037181,47037573,392,-1,0,2695,1,255.10204081632700000000
chr17,47166554,47171638,5084,-1,0,,0,0.00000000000000000000
chr17,47228393,47228879,486,-1,0,124872,1,205.76131687242800000000
chr17,47228473,47228774,301,-1,0,124872,1,332.22591362126200000000
chr17,47346384,47355213,8829,-1,0,,0,0.00000000000000000000
chr17,47351621,47353518,1897,-1,0,,0,0.00000000000000000000
chr17,47351765,47353071,1306,-1,0,,0,0.00000000000000000000
chr17,47826963,47828872,1909,-1,0,81558,1,52.38344683080150000000
chr17,47826802,47827875,1073,-1,0,81558,1,93.19664492078280000000
chr17,47827016,47827815,799,-1,0,81558,1,125.15644555694600000000
chr17,47923542,47925095,1553,-1,0,255061;729220,2,128.78300064391500000000
chr17,48102032,48102344,312,-1,0,,0,0.00000000000000000000
chr17,48102471,48102646,175,-1,0,,0,0.00000000000000000000
chr17,48308981,48318789,9808,-1,0,,0,0.00000000000000000000
chr17,48378229,48378315,86,-1,0,,0,0.00000000000000000000
chr17,48427323,48427940,617,-1,0,64132,1,162.07455429497600000000
chr17,48427521,48427921,400,-1,0,64132,1,250.00000000000000000000
chr17,48778114,48778719,605,-1,0,91369,1,165.28925619834700000000
chr17,48844117,48844499,382,-1,0,,0,0.00000000000000000000
chr17,48991471,48997723,6252,-1,0,,0,0.00000000000000000000
chr17,49154099,49154588,489,-1,0,9043,1,204.49897750511200000000
chr17,49154354,49154427,73,-1,0,9043,1,1369.86301369863000000000
chr17,49623971,49627054,3083,-1,0,,0,0.00000000000000000000
chr17,49623914,49625862,1948,-1,0,,0,0.00000000000000000000
chr17,49897968,49899371,1403,-1,0,56934,1,71.27583749109050000000
chr17,50116402,50126225,9823,-1,0,56934,1,10.18018935152190000000
chr17,50122164,50122643,479,-1,0,56934,1,208.76826722338200000000
chr17,50564274,50817434,253160,-1,0,,0,0.00000000000000000000
chr17,50711904,50836141,124237,-1,0,,0,0.00000000000000000000
chr17,50653817,50664247,10430,-1,0,,0,0.00000000000000000000
chr17,50929608,50934652,5044,-1,0,,0,0.00000000000000000000
chr17,51442981,51447479,4498,-1,0,,0,0.00000000000000000000
chr17,51602764,51605093,2329,-1,0,,0,0.00000000000000000000
chr17,51848087,51859267,11180,-1,0,,0,0.00000000000000000000
chr17,51852809,51860908,8099,-1,0,,0,0.00000000000000000000
chr17,51852962,51857046,4084,-1,0,,0,0.00000000000000000000
chr17,51853992,51857151,3159,-1,0,,0,0.00000000000000000000
chr17,52158242,52168107,9865,-1,0,,0,0.00000000000000000000
chr17,52159302,52163010,3708,-1,0,,0,0.00000000000000000000
chr17,52160226,52162300,2074,-1,0,,0,0.00000000000000000000
chr17,52783574,52784942,1368,-1,0,,0,0.00000000000000000000
chr17,52783846,52784531,685,-1,0,,0,0.00000000000000000000
chr17,52704986,52705432,446,-1,0,,0,0.00000000000000000000
chr17,52705176,52705226,50,-1,0,,0,0.00000000000000000000
chr17,53463395,53465414,2019,-1,0,,0,0.00000000000000000000
chr17,53474046,53474598,552,-1,0,23531,1,181.15942028985500000000
chr17,53544677,53554005,9328,-1,0,,0,0.00000000000000000000
chr17,54089594,54090025,431,-1,0,,0,0.00000000000000000000
chr17,54160178,54173206,13028,-1,0,,0,0.00000000000000000000
chr17,54162325,54171936,9611,-1,0,,0,0.00000000000000000000
chr17,54161662,54167629,5967,-1,0,,0,0.00000000000000000000
chr17,54297985,54298435,450,-1,0,162282,1,222.22222222222200000000
chr17,54599430,54602802,3372,-1,0,,0,0.00000000000000000000
chr17,54669947,54675690,5743,-1,0,9241,1,17.41250217656280000000
chr17,54705065,54706231,1166,-1,0,,0,0.00000000000000000000
chr17,54900889,54904832,3943,-1,0,339210,1,25.36139994927720000000
chr17,54950434,54953593,3159,-1,0,,0,0.00000000000000000000
chr17,55080077,55081614,1537,-1,0,59342,1,65.06180871828240000000
chr17,55088993,55093154,4161,-1,0,,0,0.00000000000000000000
chr17,55089719,55092848,3129,-1,0,,0,0.00000000000000000000
chr17,55091040,55092140,1100,-1,0,,0,0.00000000000000000000
chr17,55130852,55131017,165,-1,0,,0,0.00000000000000000000
chr17,55208557,55210090,1533,-1,0,,0,0.00000000000000000000
chr17,55208654,55209551,897,-1,0,,0,0.00000000000000000000
chr17,55231566,55231657,91,-1,0,,0,0.00000000000000000000
chr17,55490625,55491521,896,-1,0,124540,1,111.60714285714300000000
chr17,55586900,55587921,1021,-1,0,124540,1,97.94319294809010000000
chr17,55687804,55696370,8566,-1,0,124540,1,11.67406023815080000000
chr17,55686513,55691374,4861,-1,0,124540,1,20.57189878625800000000
chr17,55685981,55689047,3066,-1,0,124540,1,32.61578604044360000000
chr17,55687808,55689916,2108,-1,0,124540,1,47.43833017077800000000
chr17,56187849,56190423,2574,-1,0,,0,0.00000000000000000000
chr17,56200487,56217480,16993,-1,0,,0,0.00000000000000000000
chr17,56207117,56213540,6423,-1,0,,0,0.00000000000000000000
chr17,56211679,56217726,6047,-1,0,,0,0.00000000000000000000
chr17,56212499,56214097,1598,-1,0,,0,0.00000000000000000000
chr17,56677640,56678778,1138,-1,0,56155,1,87.87346221441120000000
chr17,56807788,56808931,1143,-1,0,5889,1,87.48906386701660000000
chr17,56904621,56908514,3893,-1,0,22843,1,25.68713074749550000000
chr17,56979375,56990642,11267,-1,0,22843,1,8.87547705689181000000
chr17,57109562,57118744,9182,-1,0,4591,1,10.89087344805050000000
chr17,57110074,57117978,7904,-1,0,4591,1,12.65182186234820000000
chr17,57257419,57259531,2112,-1,0,55771,1,47.34848484848490000000
chr17,57363922,57365720,1798,-1,0,,0,0.00000000000000000000
chr17,57869664,57873701,4037,-1,0,81671,1,24.77086945751800000000
chr17,57870149,57871315,1166,-1,0,81671,1,85.76329331046310000000
chr17,57870487,57871036,549,-1,0,81671,1,182.14936247723100000000
chr17,57920230,57920708,478,-1,0,,0,0.00000000000000000000
chr17,58079753,58099036,19283,-1,0,,0,0.00000000000000000000
chr17,58062122,58080391,18269,-1,0,,0,0.00000000000000000000
chr17,58119486,58120658,1172,-1,0,63897,1,85.32423208191130000000
chr17,58119692,58120210,518,-1,0,,0,0.00000000000000000000
chr17,58327218,58327296,78,-1,0,84669,1,1282.05128205128000000000
chr17,58411853,58414026,2173,-1,0,84669,1,46.01932811780950000000
chr17,58412303,58413741,1438,-1,0,84669,1,69.54102920723230000000
chr17,58579352,58581831,2479,-1,0,10513,1,40.33884630899560000000
chr17,58653402,58656995,3593,-1,0,,0,0.00000000000000000000
chr17,58654055,58655765,1710,-1,0,,0,0.00000000000000000000
chr17,58655635,58656193,558,-1,0,,0,0.00000000000000000000
chr17,58857829,58868390,10561,-1,0,54828,1,9.46880030300161000000
chr17,58968343,58973045,4702,-1,0,54828,1,21.26754572522330000000
chr17,59118570,59128822,10252,-1,0,54828,1,9.75419430355053000000
chr17,59318977,59322175,3198,-1,0,54828,1,31.26954346466540000000
chr17,59350997,59356324,5327,-1,0,54828,1,18.77229209686500000000
chr17,60190376,60192033,1657,-1,0,,0,0.00000000000000000000
chr17,60326737,60354588,27851,-1,0,,0,0.00000000000000000000
chr17,60300762,60312805,12043,-1,0,,0,0.00000000000000000000
chr17,60934360,60934485,125,-1,0,,0,0.00000000000000000000
chr17,61182126,61188000,5874,-1,0,26115,1,17.02417432754510000000
chr17,61542167,61546829,4662,-1,0,,0,0.00000000000000000000
chr17,61578442,61579069,627,-1,0,,0,0.00000000000000000000
chr17,61578617,61578873,256,-1,0,,0,0.00000000000000000000
chr17,61673661,61676931,3270,-1,0,,0,0.00000000000000000000
chr17,61749366,61751796,2430,-1,0,4215,1,41.15226337448560000000
chr17,61865829,61867110,1281,-1,0,11325,1,78.06401249024200000000
chr17,61926054,61927164,1110,-1,0,,0,0.00000000000000000000
chr17,61945676,61987479,41803,-1,0,1444;1443;2689;1442,4,9.56869124225534000000
chr17,61961154,61979473,18319,-1,0,1442,1,5.45881325399858000000
chr17,61943638,61967223,23585,-1,0,1443;2689,2,8.47996608013568000000
chr17,61972067,61985779,13712,-1,0,1442,1,7.29288214702450000000
chr17,61951881,61963143,11262,-1,0,2689,1,8.87941751021133000000
chr17,61991911,61998245,6334,-1,0,2688,1,15.78781180928320000000
chr17,61969922,61977280,7358,-1,0,1442,1,13.59064963305250000000
chr17,62212827,62214440,1613,-1,0,,0,0.00000000000000000000
chr17,62213200,62214190,990,-1,0,,0,0.00000000000000000000
chr17,62302366,62304318,1952,-1,0,55852,1,51.22950819672130000000
chr17,62571074,62572709,1635,-1,0,64750,1,61.16207951070340000000
chr17,62913873,62918766,4893,-1,0,374819,1,20.43735949315350000000
chr17,63123045,63129224,6179,-1,0,,0,0.00000000000000000000
chr17,63272052,63272372,320,-1,0,,0,0.00000000000000000000
chr17,63463807,63464582,775,-1,0,,0,0.00000000000000000000
chr17,63496000,63496419,419,-1,0,,0,0.00000000000000000000
chr17,63699428,63707800,8372,-1,0,201134,1,11.94457716196850000000
chr17,64004403,64014514,10111,-1,0,201134,1,9.89021857383048000000
chr17,64021169,64022996,1827,-1,0,201134,1,54.73453749315820000000
chr17,64264811,64266491,1680,-1,0,,0,0.00000000000000000000
chr17,64287103,64289194,2091,-1,0,,0,0.00000000000000000000
chr17,64410583,64485422,74839,-1,0,5578,1,1.33620171301060000000
chr17,64930468,64930926,458,-1,0,,0,0.00000000000000000000
chr17,64940048,64941088,1040,-1,0,,0,0.00000000000000000000
chr17,64985007,64986050,1043,-1,0,27092,1,95.87727708533080000000
chr17,65270527,65312965,42438,-1,0,,0,0.00000000000000000000
chr17,65294411,65295267,856,-1,0,,0,0.00000000000000000000
chr17,65291301,65291461,160,-1,0,,0,0.00000000000000000000
chr17,65388196,65401678,13482,-1,0,26207,1,7.41729713692331000000
chr17,65431187,65444917,13730,-1,0,26207,1,7.28332119446468000000
chr17,65438315,65443855,5540,-1,0,26207,1,18.05054151624550000000
chr17,65447910,65448770,860,-1,0,26207,1,116.27906976744200000000
chr17,65514573,65514637,64,-1,0,26207,1,1562.50000000000000000000
chr17,65520829,65521221,392,-1,0,26207,1,255.10204081632700000000
chr17,65727248,65727770,522,-1,0,25926,1,191.57088122605400000000
chr17,65727356,65727652,296,-1,0,25926,1,337.83783783783800000000
chr17,65772462,65774924,2462,-1,0,,0,0.00000000000000000000
chr17,66079045,66177709,98664,-1,0,,0,0.00000000000000000000
chr17,65963835,65965750,1915,-1,0,2186,1,52.21932114882510000000
chr17,65945080,65946940,1860,-1,0,2186,1,53.76344086021510000000
chr17,65989557,65990690,1133,-1,0,284018,1,88.26125330979700000000
chr17,65866810,65866925,115,-1,0,2186,1,869.56521739130400000000
chr17,66227467,66227887,420,-1,0,51321,1,238.09523809523800000000
chr17,66227555,66227777,222,-1,0,51321,1,450.45045045045000000000
chr17,66548790,66549121,331,-1,0,54757,1,302.11480362537800000000
chr17,66563151,66565239,2088,-1,0,54757,1,47.89272030651340000000
chr17,66817815,66822225,4410,-1,0,,0,0.00000000000000000000
chr17,66960848,66961335,487,-1,0,,0,0.00000000000000000000
chr17,66960925,66961259,334,-1,0,,0,0.00000000000000000000
chr17,67087546,67088082,536,-1,0,23460,1,186.56716417910400000000
chr17,67087656,67087976,320,-1,0,23460,1,312.50000000000000000000
chr17,67268117,67321879,53762,-1,0,23461,1,1.86004984933596000000
chr17,67344393,67348829,4436,-1,0,,0,0.00000000000000000000
chr17,68091703,68097399,5696,-1,0,3773,1,17.55617977528090000000
chr17,68102790,68104425,1635,-1,0,3773,1,61.16207951070340000000
chr17,68219173,68220370,1197,-1,0,,0,0.00000000000000000000
chr17,68150124,68150669,545,-1,0,,0,0.00000000000000000000
chr17,68159931,68160355,424,-1,0,,0,0.00000000000000000000
chr17,68150228,68150548,320,-1,0,,0,0.00000000000000000000
chr17,68454700,68461435,6735,-1,0,,0,0.00000000000000000000
chr17,68573432,68575845,2413,-1,0,,0,0.00000000000000000000
chr17,68615016,68615377,361,-1,0,,0,0.00000000000000000000
chr17,68825970,68853772,27802,-1,0,,0,0.00000000000000000000
chr17,68888097,68888495,398,-1,0,,0,0.00000000000000000000
chr17,68888260,68888313,53,-1,0,,0,0.00000000000000000000
chr17,68920029,68920514,485,-1,0,,0,0.00000000000000000000
chr17,69334990,69335050,60,-1,0,,0,0.00000000000000000000
chr17,69852123,69852523,400,-1,0,,0,0.00000000000000000000
chr17,70300791,70301146,355,-1,0,,0,0.00000000000000000000
chr17,70316493,70316556,63,-1,0,,0,0.00000000000000000000
chr17,70561210,70566210,5000,-1,0,,0,0.00000000000000000000
chr17,70772683,70823145,50462,-1,0,201266,1,1.98168919186715000000
chr17,70815206,70824471,9265,-1,0,201266,1,10.79330814894770000000
chr17,70815227,70821347,6120,-1,0,201266,1,16.33986928104580000000
chr17,70789988,70795212,5224,-1,0,201266,1,19.14241960183770000000
chr17,70979648,70980596,948,-1,0,201266,1,105.48523206751100000000
chr17,71144076,71144385,309,-1,0,,0,0.00000000000000000000
chr17,71188762,71189289,527,-1,0,9382,1,189.75332068311200000000
chr17,71188979,71189109,130,-1,0,,0,0.00000000000000000000
chr17,71216636,71217686,1050,-1,0,84923,1,95.23809523809520000000
chr17,71369839,71371345,1506,-1,0,54549,1,66.40106241699870000000
chr17,71369996,71370827,831,-1,0,54549,1,120.33694344163700000000
chr17,71667719,71669241,1522,-1,0,,0,0.00000000000000000000
chr17,71721711,71723616,1905,-1,0,,0,0.00000000000000000000
chr17,71722435,71723032,597,-1,0,,0,0.00000000000000000000
chr17,71745126,71764358,19232,-1,0,100134391,1,5.19966722129784000000
chr17,71739924,71748898,8974,-1,0,100134391,1,11.14330287497210000000
chr17,71745646,71747957,2311,-1,0,100134391,1,43.27131112072700000000
chr17,71745934,71748069,2135,-1,0,100134391,1,46.83840749414520000000
chr17,71745287,71745849,562,-1,0,100134391,1,177.93594306049800000000
chr17,72173574,72174037,463,-1,0,,0,0.00000000000000000000
chr17,72173807,72173902,95,-1,0,,0,0.00000000000000000000
chr17,72297985,72298286,301,-1,0,64446,1,332.22591362126200000000
chr17,72298058,72298294,236,-1,0,64446,1,423.72881355932200000000
chr17,72297976,72298184,208,-1,0,64446,1,480.76923076923100000000
chr17,72316064,72316767,703,-1,0,,0,0.00000000000000000000
chr17,72334441,72335818,1377,-1,0,124602,1,72.62164124909220000000
chr17,72378382,72379825,1443,-1,0,,0,0.00000000000000000000
chr17,72392978,72393318,340,-1,0,,0,0.00000000000000000000
chr17,72393048,72393206,158,-1,0,,0,0.00000000000000000000
chr17,72393118,72393252,134,-1,0,,0,0.00000000000000000000
chr17,72498648,72511816,13168,-1,0,,0,0.00000000000000000000
chr17,72544457,72555779,11322,-1,0,,0,0.00000000000000000000
chr17,72630918,72634541,3623,-1,0,,0,0.00000000000000000000
chr17,72639086,72639233,147,-1,0,,0,0.00000000000000000000
chr17,72729004,72729573,569,-1,0,326624,1,175.74692442882200000000
chr17,72873381,72877823,4442,-1,0,283985,1,22.51238180999550000000
chr17,72880513,72883377,2864,-1,0,283985,1,34.91620111731840000000
chr17,73040242,73040652,410,-1,0,10476,1,243.90243902439000000000
chr17,73091840,73092955,1115,-1,0,9121,1,89.68609865470850000000
chr17,73107715,73108268,553,-1,0,79637,1,180.83182640144700000000
chr17,73272678,73273086,408,-1,0,60386,1,245.09803921568600000000
chr17,73309540,73310752,1212,-1,0,,0,0.00000000000000000000
chr17,73513262,73538365,25103,-1,0,3993;283989,2,7.96717523801936000000
chr17,73542646,73543190,544,-1,0,3993,1,183.82352941176500000000
chr17,73554752,73555202,450,-1,0,3993,1,222.22222222222200000000
chr17,73542651,73542929,278,-1,0,3993,1,359.71223021582700000000
chr17,73717401,73737100,19699,-1,0,3691,1,5.07639981724961000000
chr17,73875239,73879292,4053,-1,0,,0,0.00000000000000000000
chr17,74279707,74280652,945,-1,0,84074,1,105.82010582010600000000
chr17,74280675,74282136,1461,-1,0,84074,1,68.44626967830250000000
chr17,74294838,74297965,3127,-1,0,84074,1,31.97953309881680000000
chr17,74306194,74306533,339,-1,0,,0,0.00000000000000000000
chr17,74306238,74306411,173,-1,0,,0,0.00000000000000000000
chr17,74335164,74336812,1648,-1,0,5635,1,60.67961165048540000000
chr17,74360074,74366091,6017,-1,0,,0,0.00000000000000000000
chr17,74362044,74365075,3031,-1,0,,0,0.00000000000000000000
chr17,74363252,74365571,2319,-1,0,,0,0.00000000000000000000
chr17,74380201,74382231,2030,-1,0,8877,1,49.26108374384240000000
chr17,74602218,74607744,5526,-1,0,,0,0.00000000000000000000
chr17,74624092,74629410,5318,-1,0,55808,1,18.80406167732230000000
chr17,74702173,74702664,491,-1,0,439921,1,203.66598778004100000000
chr17,74783325,74788309,4984,-1,0,,0,0.00000000000000000000
chr17,74786461,74790951,4490,-1,0,,0,0.00000000000000000000
chr17,74849916,74850869,953,-1,0,,0,0.00000000000000000000
chr17,74986068,74988366,2298,-1,0,,0,0.00000000000000000000
chr17,74987427,74987955,528,-1,0,,0,0.00000000000000000000
chr17,74987513,74987839,326,-1,0,,0,0.00000000000000000000
chr17,75065069,75067484,2415,-1,0,,0,0.00000000000000000000
chr17,75211865,75212327,462,-1,0,6397,1,216.45021645021600000000
chr17,75227213,75228522,1309,-1,0,,0,0.00000000000000000000
chr17,75235877,75236390,513,-1,0,,0,0.00000000000000000000
chr17,75235958,75236305,347,-1,0,,0,0.00000000000000000000
chr17,75241883,75242369,486,-1,0,,0,0.00000000000000000000
chr17,75242054,75242256,202,-1,0,,0,0.00000000000000000000
chr17,75245847,75245931,84,-1,0,,0,0.00000000000000000000
chr17,75264067,75273656,9589,-1,0,,0,0.00000000000000000000
chr17,75265488,75272606,7118,-1,0,,0,0.00000000000000000000
chr17,75376887,75382490,5603,-1,0,10801,1,17.84758165268610000000
chr17,75483541,75484043,502,-1,0,10801,1,199.20318725099600000000
chr17,75483558,75483912,354,-1,0,10801,1,282.48587570621500000000
chr17,75483718,75483887,169,-1,0,10801,1,591.71597633136100000000
chr17,75557314,75558557,1243,-1,0,,0,0.00000000000000000000
chr17,75558672,75559041,369,-1,0,,0,0.00000000000000000000
chr17,75641417,75651292,9875,-1,0,,0,0.00000000000000000000
chr17,75755291,75756735,1444,-1,0,,0,0.00000000000000000000
chr17,75824958,75825242,284,-1,0,,0,0.00000000000000000000
chr17,75828394,75828587,193,-1,0,,0,0.00000000000000000000
chr17,75988199,75988719,520,-1,0,,0,0.00000000000000000000
chr17,75988291,75988609,318,-1,0,,0,0.00000000000000000000
chr17,76282196,76283453,1257,-1,0,,0,0.00000000000000000000
chr17,76240964,76242228,1264,-1,0,,0,0.00000000000000000000
chr17,76282282,76283308,1026,-1,0,,0,0.00000000000000000000
chr17,76282527,76282977,450,-1,0,,0,0.00000000000000000000
chr17,76470812,76471371,559,-1,0,8632,1,178.89087656529500000000
chr17,76505008,76505341,333,-1,0,8632,1,300.30030030030000000000
chr17,76505128,76505311,183,-1,0,8632,1,546.44808743169400000000
chr17,76583033,76583381,348,-1,0,,0,0.00000000000000000000
chr17,76657463,76659993,2530,-1,0,,0,0.00000000000000000000
chr17,77178995,77232472,53477,-1,0,146713,1,1.86996278774052000000
chr17,77048787,77055971,7184,-1,0,,0,0.00000000000000000000
chr17,77060909,77062831,1922,-1,0,,0,0.00000000000000000000
chr17,77228533,77230152,1619,-1,0,146713,1,61.76652254478070000000
chr17,77167612,77168028,416,-1,0,146713,1,240.38461538461500000000
chr17,77315896,77316075,179,-1,0,146713,1,558.65921787709500000000
chr17,77315881,77316021,140,-1,0,146713,1,714.28571428571400000000
chr17,77125448,77125603,155,-1,0,146713,1,645.16129032258100000000
chr17,77363126,77365491,2365,-1,0,146713,1,42.28329809725160000000
chr17,77608970,77610772,1802,-1,0,,0,0.00000000000000000000
chr17,77507543,77509386,1843,-1,0,146713,1,54.25935973955510000000
chr17,77480379,77480872,493,-1,0,146713,1,202.83975659229200000000
chr17,77438304,77438418,114,-1,0,146713,1,877.19298245614000000000
chr17,77673299,77673383,84,-1,0,,0,0.00000000000000000000
chr17,77944478,77944801,323,-1,0,125058,1,309.59752321981400000000
chr17,77990177,78001933,11756,-1,0,125058,1,8.50629465804695000000
chr17,77995706,77999169,3463,-1,0,125058,1,28.87669650591970000000
chr17,78025220,78028586,3366,-1,0,55036,1,29.70885323826500000000
chr17,78064210,78064299,89,-1,0,55036,1,1123.59550561798000000000
chr17,78231228,78231720,492,-1,0,,0,0.00000000000000000000
chr17,78231456,78231529,73,-1,0,,0,0.00000000000000000000
chr17,78286981,78290110,3129,-1,0,57674,1,31.95909236177690000000
chr17,78287807,78289442,1635,-1,0,57674,1,61.16207951070340000000
chr17,78287099,78287502,403,-1,0,57674,1,248.13895781637700000000
chr17,78329066,78329698,632,-1,0,57674,1,158.22784810126600000000
chr17,78329163,78329594,431,-1,0,57674,1,232.01856148491900000000
chr17,78428116,78473151,45035,-1,0,4884,1,2.22049517042300000000
chr17,78461469,78463829,2360,-1,0,,0,0.00000000000000000000
chr17,78575036,78576649,1613,-1,0,57521,1,61.99628022318660000000
chr17,78575283,78576397,1114,-1,0,57521,1,89.76660682226210000000
chr17,78977797,78994548,16751,-1,0,,0,0.00000000000000000000
chr17,78717455,78723244,5789,-1,0,57521,1,17.27414061150460000000
chr17,79022079,79025508,3429,-1,0,10458,1,29.16302128900550000000
chr17,78883415,78887526,4111,-1,0,57521,1,24.32498175626370000000
chr17,78694576,78698335,3759,-1,0,57521,1,26.60281989890930000000
chr17,79689852,79692860,3008,-1,0,,0,0.00000000000000000000
chr17,78717544,78718825,1281,-1,0,57521,1,78.06401249024200000000
chr17,78721752,78723317,1565,-1,0,57521,1,63.89776357827480000000
chr17,79691945,79692944,999,-1,0,,0,0.00000000000000000000
chr17,78945287,78946834,1547,-1,0,,0,0.00000000000000000000
chr17,79470464,79471472,1008,-1,0,,0,0.00000000000000000000
chr17,79285329,79286625,1296,-1,0,284186,1,77.16049382716050000000
chr17,78717555,78718517,962,-1,0,57521,1,103.95010395010400000000
chr17,79051671,79052611,940,-1,0,10458,1,106.38297872340400000000
chr17,78834684,78835348,664,-1,0,57521,1,150.60240963855400000000
chr17,79610284,79610701,417,-1,0,83882,1,239.80815347721800000000
chr17,79204200,79204810,610,-1,0,146705,1,163.93442622950800000000
chr17,79128318,79128661,343,-1,0,9625,1,291.54518950437300000000
chr17,79389875,79390394,519,-1,0,57597,1,192.67822736030800000000
chr17,79129812,79130140,328,-1,0,9625,1,304.87804878048800000000
chr17,79577680,79578003,323,-1,0,55666,1,309.59752321981400000000
chr17,79334830,79335181,351,-1,0,,0,0.00000000000000000000
chr17,79610350,79610666,316,-1,0,83882,1,316.45569620253200000000
chr17,78717531,78717780,249,-1,0,57521,1,401.60642570281100000000
chr17,78814743,78814986,243,-1,0,57521,1,411.52263374485600000000
chr17,78655431,78655613,182,-1,0,57521,1,549.45054945054900000000
chr17,79183722,79183897,175,-1,0,22994,1,571.42857142857100000000
chr17,79227538,79227619,81,-1,0,124565,1,1234.56790123457000000000
chr17,79455459,79455514,55,-1,0,,0,0.00000000000000000000
chr17,79840074,79841499,1425,-1,0,,0,0.00000000000000000000
chr17,79998600,79999888,1288,-1,0,,0,0.00000000000000000000
chr17,79903189,79904328,1139,-1,0,255275,1,87.79631255487270000000
chr17,79905036,79905466,430,-1,0,255275,1,232.55813953488400000000
chr17,79887563,79888038,475,-1,0,,0,0.00000000000000000000
chr17,80034101,80139700,105599,-1,0,2194;284001,2,1.89395732914137000000
chr17,80044188,80053415,9227,-1,0,2194,1,10.83775875149020000000
chr17,80107609,80109389,1780,-1,0,284001,1,56.17977528089890000000
chr17,80106071,80107045,974,-1,0,284001,1,102.66940451745400000000
chr17,80120511,80120718,207,-1,0,284001,1,483.09178743961300000000
chr17,80185484,80185563,79,-1,0,,0,0.00000000000000000000
chr17,80317173,80319521,2348,-1,0,400629,1,42.58943781942080000000
chr17,80344014,80344277,263,-1,0,,0,0.00000000000000000000
chr17,80369874,80369983,109,-1,0,79701,1,917.43119266055100000000
chr17,80466927,80468088,1161,-1,0,,0,0.00000000000000000000
chr17,80634953,80727325,92372,-1,0,64122;79672;6904;10966,4,4.33031654613952000000
chr17,81007201,81077400,70199,-1,0,146712;284207,2,2.84904343366715000000
chr17,80970674,80976445,5771,-1,0,146712,1,17.32801940738170000000
chr17,80592318,80597801,5483,-1,0,56270,1,18.23819077147550000000
chr17,80932896,80934862,1966,-1,0,146712,1,50.86469989827060000000
chr17,80722387,80723875,1488,-1,0,6904,1,67.20430107526880000000
chr17,80629091,80630337,1246,-1,0,10966,1,80.25682182985550000000
chr17,80651809,80653411,1602,-1,0,10966,1,62.42197253433210000000
chr17,81025706,81026991,1285,-1,0,,0,0.00000000000000000000
chr17,80929500,80930568,1068,-1,0,146712,1,93.63295880149810000000
chr17,80980173,80981278,1105,-1,0,146712,1,90.49773755656110000000
chr17,80941794,80942488,694,-1,0,146712,1,144.09221902017300000000
chr17,80722630,80723380,750,-1,0,6904,1,133.33333333333300000000
chr17,80883581,80884243,662,-1,0,6904,1,151.05740181268900000000
chr17,81013248,81013853,605,-1,0,,0,0.00000000000000000000
chr17,80983033,80983528,495,-1,0,146712,1,202.02020202020200000000
chr17,80571908,80572376,468,-1,0,,0,0.00000000000000000000
chr17,80969815,80970199,384,-1,0,146712,1,260.41666666666700000000
chr17,80722683,80722975,292,-1,0,6904,1,342.46575342465800000000
chr17,80997178,80997482,304,-1,0,146712,1,328.94736842105300000000
chr17,81010563,81010843,280,-1,0,,0,0.00000000000000000000
chr17,80883761,80883994,233,-1,0,6904,1,429.18454935622300000000
chr17,80941968,80942234,266,-1,0,146712,1,375.93984962406000000000
chr17,80969865,80970109,244,-1,0,146712,1,409.83606557377000000000
chr17,80778649,80778862,213,-1,0,6904,1,469.48356807511700000000
chr17,81010672,81010880,208,-1,0,,0,0.00000000000000000000
chr17,80630200,80630374,174,-1,0,10966,1,574.71264367816100000000
chr17,80883833,80884007,174,-1,0,6904,1,574.71264367816100000000
chr17,80572120,80572264,144,-1,0,,0,0.00000000000000000000
chr17,80996729,80996870,141,-1,0,146712,1,709.21985815602800000000
chr17,81025596,81025682,86,-1,0,,0,0.00000000000000000000
chr17,81105005,81106778,1773,-1,0,,0,0.00000000000000000000
chr18,39520,83659,44139,-1,0,,0,0.00000000000000000000
chr18,108490,110926,2436,-1,0,,0,0.00000000000000000000
chr18,93711,94869,1158,-1,0,,0,0.00000000000000000000
chr18,120141,144176,24035,-1,0,,0,0.00000000000000000000
chr18,293069,304994,11925,-1,0,,0,0.00000000000000000000
chr18,168446,177668,9222,-1,0,9097,1,10.84363478638040000000
chr18,144348,151980,7632,-1,0,,0,0.00000000000000000000
chr18,136230,143567,7337,-1,0,,0,0.00000000000000000000
chr18,299273,300796,1523,-1,0,,0,0.00000000000000000000
chr18,207028,207706,678,-1,0,9097,1,147.49262536873200000000
chr18,633649,638806,5157,-1,0,27098,1,19.39111886755870000000
chr18,879912,886020,6108,-1,0,,0,0.00000000000000000000
chr18,654168,655922,1754,-1,0,494514,1,57.01254275940710000000
chr18,836704,837667,963,-1,0,,0,0.00000000000000000000
chr18,666681,667928,1247,-1,0,7298,1,80.19246190858060000000
chr18,666714,667312,598,-1,0,7298,1,167.22408026755900000000
chr18,689822,690338,516,-1,0,55556,1,193.79844961240300000000
chr18,591811,592194,383,-1,0,,0,0.00000000000000000000
chr18,666941,667200,259,-1,0,7298,1,386.10038610038600000000
chr18,667293,667587,294,-1,0,7298,1,340.13605442176900000000
chr18,667086,667250,164,-1,0,7298,1,609.75609756097600000000
chr18,633821,633881,60,-1,0,27098,1,1666.66666666667000000000
chr18,988039,1049259,61220,-1,0,,0,0.00000000000000000000
chr18,1116841,1117225,384,-1,0,,0,0.00000000000000000000
chr18,1785705,1924635,138930,-1,0,,0,0.00000000000000000000
chr18,1737165,1840791,103626,-1,0,,0,0.00000000000000000000
chr18,1904557,1989380,84823,-1,0,,0,0.00000000000000000000
chr18,1609029,1620877,11848,-1,0,,0,0.00000000000000000000
chr18,1199561,1200305,744,-1,0,,0,0.00000000000000000000
chr18,1219226,1219663,437,-1,0,,0,0.00000000000000000000
chr18,1851905,1852427,522,-1,0,,0,0.00000000000000000000
chr18,1854559,1854981,422,-1,0,,0,0.00000000000000000000
chr18,1962720,1963079,359,-1,0,,0,0.00000000000000000000
chr18,1852007,1852319,312,-1,0,,0,0.00000000000000000000
chr18,1854688,1854921,233,-1,0,,0,0.00000000000000000000
chr18,1219331,1219480,149,-1,0,,0,0.00000000000000000000
chr18,1854776,1854898,122,-1,0,,0,0.00000000000000000000
chr18,1219447,1219509,62,-1,0,,0,0.00000000000000000000
chr18,2262213,2265381,3168,-1,0,,0,0.00000000000000000000
chr18,2189517,2190798,1281,-1,0,,0,0.00000000000000000000
chr18,2337535,2338114,579,-1,0,,0,0.00000000000000000000
chr18,2372269,2377011,4742,-1,0,,0,0.00000000000000000000
chr18,2472722,2472837,115,-1,0,,0,0.00000000000000000000
chr18,2614443,2614640,197,-1,0,10403,1,507.61421319796900000000
chr18,2667978,2671096,3118,-1,0,23347,1,32.07184092366900000000
chr18,2830240,2834956,4716,-1,0,,0,0.00000000000000000000
chr18,2876464,2876740,276,-1,0,84034,1,362.31884057971000000000
chr18,2876498,2876671,173,-1,0,84034,1,578.03468208092500000000
chr18,2963313,2964366,1053,-1,0,9663,1,94.96676163342830000000
chr18,2997370,2997468,98,-1,0,9663,1,1020.40816326531000000000
chr18,3367801,3373690,5889,-1,0,,0,0.00000000000000000000
chr18,3349098,3351101,2003,-1,0,,0,0.00000000000000000000
chr18,3335190,3336633,1443,-1,0,,0,0.00000000000000000000
chr18,3322461,3323335,874,-1,0,,0,0.00000000000000000000
chr18,3317797,3318250,453,-1,0,,0,0.00000000000000000000
chr18,3349559,3349963,404,-1,0,,0,0.00000000000000000000
chr18,3318055,3318128,73,-1,0,,0,0.00000000000000000000
chr18,3479011,3482716,3705,-1,0,,0,0.00000000000000000000
chr18,3502644,3508567,5923,-1,0,9229,1,16.88333614722270000000
chr18,3560286,3562097,1811,-1,0,9229,1,55.21811154058530000000
chr18,3568883,3571730,2847,-1,0,9229,1,35.12469265893920000000
chr18,3630096,3631712,1616,-1,0,9229,1,61.88118811881190000000
chr18,3635432,3638243,2811,-1,0,9229,1,35.57452863749560000000
chr18,3635312,3636554,1242,-1,0,9229,1,80.51529790660230000000
chr18,3765967,3770709,4742,-1,0,9229,1,21.08814846056520000000
chr18,3832962,3833358,396,-1,0,9229,1,252.52525252525300000000
chr18,3833185,3833250,65,-1,0,9229,1,1538.46153846154000000000
chr18,3995745,3997842,2097,-1,0,9229,1,47.68717215069150000000
chr18,3997013,3997471,458,-1,0,9229,1,218.34061135371200000000
chr18,4022701,4023110,409,-1,0,9229,1,244.49877750611200000000
chr18,4258223,4258835,612,-1,0,9229,1,163.39869281045800000000
chr18,4306250,4314495,8245,-1,0,9229,1,12.12856276531230000000
chr18,4330272,4335674,5402,-1,0,9229,1,18.51166234727880000000
chr18,4324547,4324933,386,-1,0,9229,1,259.06735751295300000000
chr18,4324697,4324774,77,-1,0,9229,1,1298.70129870130000000000
chr18,4437647,4437894,247,-1,0,9229,1,404.85829959514200000000
chr18,4457952,4495650,37698,-1,0,,0,0.00000000000000000000
chr18,4506390,4511119,4729,-1,0,,0,0.00000000000000000000
chr18,4513869,4515734,1865,-1,0,,0,0.00000000000000000000
chr18,4535387,4536753,1366,-1,0,,0,0.00000000000000000000
chr18,4571541,4575463,3922,-1,0,,0,0.00000000000000000000
chr18,4705314,4707627,2313,-1,0,,0,0.00000000000000000000
chr18,4813611,4814506,895,-1,0,,0,0.00000000000000000000
chr18,4813795,4814478,683,-1,0,,0,0.00000000000000000000
chr18,4881144,4895036,13892,-1,0,,0,0.00000000000000000000
chr18,4955590,4955987,397,-1,0,,0,0.00000000000000000000
chr18,5180366,5183648,3282,-1,0,642597,1,30.46922608165750000000
chr18,5209696,5212062,2366,-1,0,,0,0.00000000000000000000
chr18,5209094,5210861,1767,-1,0,,0,0.00000000000000000000
chr18,5209758,5210674,916,-1,0,,0,0.00000000000000000000
chr18,5322837,5326541,3704,-1,0,,0,0.00000000000000000000
chr18,5324642,5326242,1600,-1,0,,0,0.00000000000000000000
chr18,5294874,5296604,1730,-1,0,7541,1,57.80346820809250000000
chr18,5324691,5326208,1517,-1,0,,0,0.00000000000000000000
chr18,5306597,5307760,1163,-1,0,,0,0.00000000000000000000
chr18,5300842,5302079,1237,-1,0,,0,0.00000000000000000000
chr18,5306850,5307389,539,-1,0,,0,0.00000000000000000000
chr18,5456976,5457328,352,-1,0,23136,1,284.09090909090900000000
chr18,5457105,5457205,100,-1,0,23136,1,1000.00000000000000000000
chr18,5492280,5492519,239,-1,0,23136,1,418.41004184100400000000
chr18,5927628,5934107,6479,-1,0,,0,0.00000000000000000000
chr18,6107629,6110132,2503,-1,0,91133,1,39.95205753096280000000
chr18,6272408,6273585,1177,-1,0,91133,1,84.96176720475790000000
chr18,6272656,6273481,825,-1,0,91133,1,121.21212121212100000000
chr18,6497049,6499331,2282,-1,0,,0,0.00000000000000000000
chr18,6541202,6541689,487,-1,0,,0,0.00000000000000000000
chr18,6541319,6541528,209,-1,0,,0,0.00000000000000000000
chr18,7073837,7073890,53,-1,0,284217,1,1886.79245283019000000000
chr18,7194389,7196073,1684,-1,0,,0,0.00000000000000000000
chr18,7216097,7217015,918,-1,0,,0,0.00000000000000000000
chr18,7522155,7522677,522,-1,0,,0,0.00000000000000000000
chr18,7566147,7569197,3050,-1,0,5797,1,32.78688524590160000000
chr18,7566928,7568663,1735,-1,0,5797,1,57.63688760806920000000
chr18,7728691,7763021,34330,-1,0,5797,1,2.91290416545296000000
chr18,7909699,7909756,57,-1,0,5797,1,1754.38596491228000000000
chr18,8206696,8210765,4069,-1,0,5797,1,24.57606291472110000000
chr18,8371941,8372489,548,-1,0,5797,1,182.48175182481800000000
chr18,8529045,8529632,587,-1,0,,0,0.00000000000000000000
chr18,8535091,8535635,544,-1,0,,0,0.00000000000000000000
chr18,8569840,8572560,2720,-1,0,,0,0.00000000000000000000
chr18,8634164,8634281,117,-1,0,201475,1,854.70085470085500000000
chr18,8705031,8706788,1757,-1,0,,0,0.00000000000000000000
chr18,8890793,8890921,128,-1,0,,0,0.00000000000000000000
chr18,9036060,9036511,451,-1,0,,0,0.00000000000000000000
chr18,9036096,9036401,305,-1,0,,0,0.00000000000000000000
chr18,9111524,9112118,594,-1,0,4729,1,168.35016835016800000000
chr18,9205193,9206961,1768,-1,0,23253,1,56.56108597285070000000
chr18,9225121,9225458,337,-1,0,23253,1,296.73590504451000000000
chr18,9284959,9286179,1220,-1,0,23253,1,81.96721311475410000000
chr18,9297079,9297834,755,-1,0,,0,0.00000000000000000000
chr18,9324170,9327287,3117,-1,0,,0,0.00000000000000000000
chr18,9385358,9385727,369,-1,0,57045,1,271.00271002710000000000
chr18,9539158,9540560,1402,-1,0,,0,0.00000000000000000000
chr18,9621929,9622241,312,-1,0,,0,0.00000000000000000000
chr18,9621959,9622233,274,-1,0,,0,0.00000000000000000000
chr18,9784172,9793224,9052,-1,0,11031,1,11.04728236853730000000
chr18,9814953,9816288,1335,-1,0,11031,1,74.90636704119850000000
chr18,9815323,9816040,717,-1,0,11031,1,139.47001394700100000000
chr18,9877529,9877912,383,-1,0,,0,0.00000000000000000000
chr18,9913523,9914930,1407,-1,0,9218,1,71.07320540156360000000
chr18,9923068,9923603,535,-1,0,9218,1,186.91588785046700000000
chr18,9923161,9923514,353,-1,0,9218,1,283.28611898017000000000
chr18,9923337,9923432,95,-1,0,9218,1,1052.63157894737000000000
chr18,10134666,10145472,10806,-1,0,,0,0.00000000000000000000
chr18,10150565,10151046,481,-1,0,,0,0.00000000000000000000
chr18,10218783,10224864,6081,-1,0,,0,0.00000000000000000000
chr18,10222278,10223605,1327,-1,0,,0,0.00000000000000000000
chr18,10286507,10292786,6279,-1,0,,0,0.00000000000000000000
chr18,10325969,10346497,20528,-1,0,,0,0.00000000000000000000
chr18,10324628,10335499,10871,-1,0,,0,0.00000000000000000000
chr18,10331018,10331158,140,-1,0,,0,0.00000000000000000000
chr18,10356902,10357375,473,-1,0,,0,0.00000000000000000000
chr18,10431299,10431485,186,-1,0,,0,0.00000000000000000000
chr18,10462080,10462974,894,-1,0,147495,1,111.85682326621900000000
chr18,10462257,10462832,575,-1,0,147495,1,173.91304347826100000000
chr18,10462394,10462658,264,-1,0,147495,1,378.78787878787900000000
chr18,10757249,10757707,458,-1,0,63895,1,218.34061135371200000000
chr18,10911286,10924443,13157,-1,0,63895,1,7.60051683514479000000
chr18,11335067,11343681,8614,-1,0,,0,0.00000000000000000000
chr18,11505060,11514806,9746,-1,0,,0,0.00000000000000000000
chr18,11509701,11511474,1773,-1,0,,0,0.00000000000000000000
chr18,11510008,11511223,1215,-1,0,,0,0.00000000000000000000
chr18,11510054,11510715,661,-1,0,,0,0.00000000000000000000
chr18,11521328,11521566,238,-1,0,,0,0.00000000000000000000
chr18,11559092,11565420,6328,-1,0,,0,0.00000000000000000000
chr18,11613395,11645384,31989,-1,0,,0,0.00000000000000000000
chr18,11676950,11679162,2212,-1,0,,0,0.00000000000000000000
chr18,11681612,11686419,4807,-1,0,,0,0.00000000000000000000
chr18,11826085,11826549,464,-1,0,2774,1,215.51724137931000000000
chr18,11826268,11826367,99,-1,0,2774,1,1010.10101010101000000000
chr18,11855840,11856683,843,-1,0,2774,1,118.62396204033200000000
chr18,11864957,11866873,1916,-1,0,2774,1,52.19206680584550000000
chr18,11880078,11880395,317,-1,0,2774,1,315.45741324921100000000
chr18,11896374,11898332,1958,-1,0,65258,1,51.07252298263530000000
chr18,11953051,11954074,1023,-1,0,,0,0.00000000000000000000
chr18,11971916,11972237,321,-1,0,,0,0.00000000000000000000
chr18,12201779,12261159,59380,-1,0,1149,1,1.68406871000337000000
chr18,12600457,12605064,4607,-1,0,56907,1,21.70609941393530000000
chr18,12657165,12658579,1414,-1,0,56907,1,70.72135785007070000000
chr18,12503588,12504466,878,-1,0,56907,1,113.89521640091100000000
chr18,12851153,12851606,453,-1,0,5771,1,220.75055187638000000000
chr18,12177793,12178048,255,-1,0,,0,0.00000000000000000000
chr18,13106414,13106641,227,-1,0,55125,1,440.52863436123400000000
chr18,13143138,13144147,1009,-1,0,,0,0.00000000000000000000
chr18,13143278,13144121,843,-1,0,,0,0.00000000000000000000
chr18,13143653,13144152,499,-1,0,,0,0.00000000000000000000
chr18,13261951,13263286,1335,-1,0,753,1,74.90636704119850000000
chr18,13647101,13647593,492,-1,0,753,1,203.25203252032500000000
chr18,13672956,13676466,3510,-1,0,125228,1,28.49002849002850000000
chr18,13778413,13782471,4058,-1,0,,0,0.00000000000000000000
chr18,14092784,14306131,213347,-1,0,162655,1,0.46871997262675400000
chr18,14071268,14236104,164836,-1,0,162655,1,0.60666359290446300000
chr18,14259641,14307166,47525,-1,0,,0,0.00000000000000000000
chr18,14271432,14294925,23493,-1,0,,0,0.00000000000000000000
chr18,14293100,14329085,35985,-1,0,,0,0.00000000000000000000
chr18,14280235,14300456,20221,-1,0,,0,0.00000000000000000000
chr18,14263362,14282003,18641,-1,0,,0,0.00000000000000000000
chr18,14311170,14330346,19176,-1,0,,0,0.00000000000000000000
chr18,14301193,14314943,13750,-1,0,,0,0.00000000000000000000
chr18,13794527,13805318,10791,-1,0,,0,0.00000000000000000000
chr18,14145950,14151081,5131,-1,0,,0,0.00000000000000000000
chr18,14280477,14283668,3191,-1,0,,0,0.00000000000000000000
chr18,14260793,14264015,3222,-1,0,,0,0.00000000000000000000
chr18,13886932,13887597,665,-1,0,4158,1,150.37593984962400000000
chr18,14050861,14051522,661,-1,0,,0,0.00000000000000000000
chr18,13886944,13887252,308,-1,0,4158,1,324.67532467532500000000
chr18,13887178,13887387,209,-1,0,4158,1,478.46889952153100000000
chr18,14551702,14568679,16977,-1,0,,0,0.00000000000000000000
chr18,14592792,14608990,16198,-1,0,,0,0.00000000000000000000
chr18,14450566,14460594,10028,-1,0,,0,0.00000000000000000000
chr18,14612932,14617720,4788,-1,0,,0,0.00000000000000000000
chr18,14482726,14485589,2863,-1,0,,0,0.00000000000000000000
chr18,14530296,14531821,1525,-1,0,388468,1,65.57377049180330000000
chr18,14549286,14550452,1166,-1,0,,0,0.00000000000000000000
chr18,14689048,14689194,146,-1,0,,0,0.00000000000000000000
chr18,14767685,14827219,59534,-1,0,374860,1,1.67971243323143000000
chr18,14799664,14814026,14362,-1,0,374860,1,6.96281854894861000000
chr18,14838013,14849542,11529,-1,0,374860,1,8.67377916558244000000
chr18,14822898,14823394,496,-1,0,374860,1,201.61290322580600000000
chr18,14822949,14823313,364,-1,0,374860,1,274.72527472527500000000
chr18,15242561,15243291,730,-1,0,,0,0.00000000000000000000
chr18,15394876,15405406,10530,-1,0,,0,0.00000000000000000000
chr18,15405411,15409543,4132,-1,0,,0,0.00000000000000000000
chr18,18512304,18517145,4841,-1,0,,0,0.00000000000000000000
chr18,18516180,18517129,949,-1,0,,0,0.00000000000000000000
chr18,18515364,18516048,684,-1,0,,0,0.00000000000000000000
chr18,18780645,18781178,533,-1,0,,0,0.00000000000000000000
chr18,19562263,19563055,792,-1,0,,0,0.00000000000000000000
chr18,20054187,20067385,13198,-1,0,,0,0.00000000000000000000
chr18,20025204,20027042,1838,-1,0,,0,0.00000000000000000000
chr18,20154817,20160676,5859,-1,0,,0,0.00000000000000000000
chr18,20172054,20172107,53,-1,0,,0,0.00000000000000000000
chr18,20519797,20523188,3391,-1,0,5932,1,29.48982601002650000000
chr18,21289353,21289934,581,-1,0,3909,1,172.11703958691900000000
chr18,21322356,21324966,2610,-1,0,3909,1,38.31417624521070000000
chr18,21490977,21491121,144,-1,0,3909,1,694.44444444444400000000
chr18,21626202,21627319,1117,-1,0,125488,1,89.52551477170990000000
chr18,21903181,21904858,1677,-1,0,114876,1,59.63029218843170000000
chr18,21990663,21992068,1405,-1,0,,0,0.00000000000000000000
chr18,22518749,22518801,52,-1,0,,0,0.00000000000000000000
chr18,22664116,22664599,483,-1,0,25925,1,207.03933747412000000000
chr18,22892473,22892804,331,-1,0,25925,1,302.11480362537800000000
chr18,22915179,22920202,5023,-1,0,25925,1,19.90842126219390000000
chr18,23347118,23350774,3656,-1,0,,0,0.00000000000000000000
chr18,23436030,23437021,991,-1,0,,0,0.00000000000000000000
chr18,23471377,23472046,669,-1,0,,0,0.00000000000000000000
chr18,23473584,23473654,70,-1,0,,0,0.00000000000000000000
chr18,23479206,23506190,26984,-1,0,,0,0.00000000000000000000
chr18,23747759,23751695,3936,-1,0,143471,1,25.40650406504070000000
chr18,23762913,23766165,3252,-1,0,143471,1,30.75030750307500000000
chr18,23827236,23829418,2182,-1,0,6875,1,45.82951420714940000000
chr18,24030476,24032538,2062,-1,0,,0,0.00000000000000000000
chr18,24045810,24046240,430,-1,0,284252,1,232.55813953488400000000
chr18,24134021,24134443,422,-1,0,284252,1,236.96682464455000000000
chr18,24330209,24341028,10819,-1,0,,0,0.00000000000000000000
chr18,24307540,24311152,3612,-1,0,,0,0.00000000000000000000
chr18,24555582,24557055,1473,-1,0,83539,1,67.88866259334690000000
chr18,24571616,24572339,723,-1,0,83539,1,138.31258644536700000000
chr18,24571670,24572246,576,-1,0,83539,1,173.61111111111100000000
chr18,24791451,24792013,562,-1,0,,0,0.00000000000000000000
chr18,24791587,24791873,286,-1,0,,0,0.00000000000000000000
chr18,25360013,25381637,21624,-1,0,,0,0.00000000000000000000
chr18,24967213,24981985,14772,-1,0,,0,0.00000000000000000000
chr18,25974067,25981478,7411,-1,0,,0,0.00000000000000000000
chr18,25973385,25976138,2753,-1,0,,0,0.00000000000000000000
chr18,25070858,25072162,1304,-1,0,,0,0.00000000000000000000
chr18,25827747,25828339,592,-1,0,,0,0.00000000000000000000
chr18,25827890,25828227,337,-1,0,,0,0.00000000000000000000
chr18,26101420,26101563,143,-1,0,,0,0.00000000000000000000
chr18,26273003,26278467,5464,-1,0,,0,0.00000000000000000000
chr18,26286153,26287825,1672,-1,0,,0,0.00000000000000000000
chr18,26363642,26364168,526,-1,0,,0,0.00000000000000000000
chr18,26363767,26364102,335,-1,0,,0,0.00000000000000000000
chr18,27209694,27226260,16566,-1,0,,0,0.00000000000000000000
chr18,27215552,27222322,6770,-1,0,,0,0.00000000000000000000
chr18,27238766,27241477,2711,-1,0,,0,0.00000000000000000000
chr18,27170192,27172201,2009,-1,0,,0,0.00000000000000000000
chr18,27489009,27490864,1855,-1,0,,0,0.00000000000000000000
chr18,27814777,27816402,1625,-1,0,,0,0.00000000000000000000
chr18,27695057,27695485,428,-1,0,,0,0.00000000000000000000
chr18,27810708,27811095,387,-1,0,,0,0.00000000000000000000
chr18,27629669,27630021,352,-1,0,,0,0.00000000000000000000
chr18,27364230,27364553,323,-1,0,,0,0.00000000000000000000
chr18,27363992,27364159,167,-1,0,,0,0.00000000000000000000
chr18,27363964,27364086,122,-1,0,,0,0.00000000000000000000
chr18,27810839,27810955,116,-1,0,,0,0.00000000000000000000
chr18,27364002,27364049,47,-1,0,,0,0.00000000000000000000
chr18,27872448,27873008,560,-1,0,,0,0.00000000000000000000
chr18,27872558,27872893,335,-1,0,,0,0.00000000000000000000
chr18,27950874,27953286,2412,-1,0,,0,0.00000000000000000000
chr18,27988918,28051503,62585,-1,0,,0,0.00000000000000000000
chr18,28230653,28231349,696,-1,0,,0,0.00000000000000000000
chr18,28279458,28283741,4283,-1,0,,0,0.00000000000000000000
chr18,28677254,28677892,638,-1,0,1824,1,156.73981191222600000000
chr18,28717886,28718793,907,-1,0,1823,1,110.25358324145500000000
chr18,28771329,28775923,4594,-1,0,,0,0.00000000000000000000
chr18,29003300,29004316,1016,-1,0,,0,0.00000000000000000000
chr18,29032458,29033997,1539,-1,0,1830,1,64.97725795971410000000
chr18,29230831,29231841,1010,-1,0,9331,1,99.00990099009900000000
chr18,29710829,29711192,363,-1,0,51444,1,275.48209366391200000000
chr18,29725460,29725844,384,-1,0,,0,0.00000000000000000000
chr18,29886640,29889577,2937,-1,0,64762,1,34.04834865509020000000
chr18,29888255,29890866,2611,-1,0,64762,1,38.29950210647260000000
chr18,29888159,29889489,1330,-1,0,64762,1,75.18796992481200000000
chr18,30132503,30139678,7175,-1,0,,0,0.00000000000000000000
chr18,30226164,30229293,3129,-1,0,,0,0.00000000000000000000
chr18,30497278,30503415,6137,-1,0,,0,0.00000000000000000000
chr18,30724835,30737309,12474,-1,0,374864,1,8.01667468334135000000
chr18,30862723,30931622,68899,-1,0,374864,1,1.45139987517961000000
chr18,31131770,31132804,1034,-1,0,,0,0.00000000000000000000
chr18,31143911,31144231,320,-1,0,,0,0.00000000000000000000
chr18,31547260,31552088,4828,-1,0,8715,1,20.71251035625520000000
chr18,31746603,31747187,584,-1,0,8715,1,171.23287671232900000000
chr18,31746715,31747055,340,-1,0,8715,1,294.11764705882400000000
chr18,31813837,31815291,1454,-1,0,,0,0.00000000000000000000
chr18,32333296,32333645,349,-1,0,1837,1,286.53295128939800000000
chr18,32370305,32370546,241,-1,0,1837,1,414.93775933610000000000
chr18,32530872,32531335,463,-1,0,,0,0.00000000000000000000
chr18,32530964,32531233,269,-1,0,,0,0.00000000000000000000
chr18,32661832,32662403,571,-1,0,10982,1,175.13134851138400000000
chr18,32661967,32662266,299,-1,0,10982,1,334.44816053511700000000
chr18,32759746,32767794,8048,-1,0,,0,0.00000000000000000000
chr18,32925345,32927952,2607,-1,0,,0,0.00000000000000000000
chr18,33348323,33357790,9467,-1,0,,0,0.00000000000000000000
chr18,33106099,33110434,4335,-1,0,,0,0.00000000000000000000
chr18,33201090,33201613,523,-1,0,,0,0.00000000000000000000
chr18,33390124,33390664,540,-1,0,,0,0.00000000000000000000
chr18,33201198,33201524,326,-1,0,,0,0.00000000000000000000
chr18,33791302,33791825,523,-1,0,55034,1,191.20458891013400000000
chr18,34253118,34259855,6737,-1,0,80206,1,14.84340210776310000000
chr18,34509288,34511990,2702,-1,0,57536,1,37.00962250185050000000
chr18,34035480,34037584,2104,-1,0,80206,1,47.52851711026620000000
chr18,34580421,34580849,428,-1,0,57536,1,233.64485981308400000000
chr18,34917927,34918497,570,-1,0,56853,1,175.43859649122800000000
chr18,34918048,34918382,334,-1,0,56853,1,299.40119760479000000000
chr18,35306046,35306637,591,-1,0,,0,0.00000000000000000000
chr18,35315610,35315996,386,-1,0,,0,0.00000000000000000000
chr18,35360434,35361117,683,-1,0,,0,0.00000000000000000000
chr18,35533670,35544309,10639,-1,0,,0,0.00000000000000000000
chr18,35531068,35537681,6613,-1,0,,0,0.00000000000000000000
chr18,35533645,35537063,3418,-1,0,,0,0.00000000000000000000
chr18,35550017,35551950,1933,-1,0,,0,0.00000000000000000000
chr18,35825939,35856495,30556,-1,0,,0,0.00000000000000000000
chr18,35825525,35838197,12672,-1,0,,0,0.00000000000000000000
chr18,35963696,35967810,4114,-1,0,,0,0.00000000000000000000
chr18,36144547,36145497,950,-1,0,,0,0.00000000000000000000
chr18,36216598,36218950,2352,-1,0,,0,0.00000000000000000000
chr18,36577332,36585863,8531,-1,0,,0,0.00000000000000000000
chr18,36656782,36666774,9992,-1,0,,0,0.00000000000000000000
chr18,36654858,36657208,2350,-1,0,,0,0.00000000000000000000
chr18,36816047,36816335,288,-1,0,,0,0.00000000000000000000
chr18,36816155,36816264,109,-1,0,,0,0.00000000000000000000
chr18,36903655,36904070,415,-1,0,,0,0.00000000000000000000
chr18,36903851,36903925,74,-1,0,,0,0.00000000000000000000
chr18,36903780,36903854,74,-1,0,,0,0.00000000000000000000
chr18,37061536,37062065,529,-1,0,,0,0.00000000000000000000
chr18,37061632,37061962,330,-1,0,,0,0.00000000000000000000
chr18,37213355,37264625,51270,-1,0,,0,0.00000000000000000000
chr18,37566542,37567164,622,-1,0,,0,0.00000000000000000000
chr18,37747245,37747308,63,-1,0,,0,0.00000000000000000000
chr18,38258723,38271122,12399,-1,0,,0,0.00000000000000000000
chr18,37876826,37891111,14285,-1,0,,0,0.00000000000000000000
chr18,38203624,38213096,9472,-1,0,,0,0.00000000000000000000
chr18,38259787,38266764,6977,-1,0,,0,0.00000000000000000000
chr18,38116284,38120363,4079,-1,0,,0,0.00000000000000000000
chr18,37811796,37812609,813,-1,0,,0,0.00000000000000000000
chr18,38006380,38006996,616,-1,0,,0,0.00000000000000000000
chr18,38486164,38487118,954,-1,0,,0,0.00000000000000000000
chr18,38862821,38879832,17011,-1,0,,0,0.00000000000000000000
chr18,38864884,38868159,3275,-1,0,,0,0.00000000000000000000
chr18,38866271,38868193,1922,-1,0,,0,0.00000000000000000000
chr18,39010243,39012270,2027,-1,0,,0,0.00000000000000000000
chr18,39133480,39135077,1597,-1,0,,0,0.00000000000000000000
chr18,39143402,39143481,79,-1,0,,0,0.00000000000000000000
chr18,39585695,39586316,621,-1,0,5289,1,161.03059581320500000000
chr18,39589464,39589857,393,-1,0,5289,1,254.45292620865100000000
chr18,39589679,39589738,59,-1,0,5289,1,1694.91525423729000000000
chr18,40040693,40058087,17394,-1,0,,0,0.00000000000000000000
chr18,40049706,40057646,7940,-1,0,,0,0.00000000000000000000
chr18,40054104,40059621,5517,-1,0,,0,0.00000000000000000000
chr18,40054077,40057688,3611,-1,0,,0,0.00000000000000000000
chr18,40055533,40057481,1948,-1,0,,0,0.00000000000000000000
chr18,40056464,40057957,1493,-1,0,,0,0.00000000000000000000
chr18,40056569,40057471,902,-1,0,,0,0.00000000000000000000
chr18,40252776,40257802,5026,-1,0,,0,0.00000000000000000000
chr18,40304196,40304847,651,-1,0,,0,0.00000000000000000000
chr18,40749717,40749886,169,-1,0,,0,0.00000000000000000000
chr18,40880117,40904270,24153,-1,0,,0,0.00000000000000000000
chr18,40920575,40924214,3639,-1,0,,0,0.00000000000000000000
chr18,41030296,41033089,2793,-1,0,,0,0.00000000000000000000
chr18,41031442,41032613,1171,-1,0,,0,0.00000000000000000000
chr18,41229871,41231459,1588,-1,0,,0,0.00000000000000000000
chr18,41381571,41381621,50,-1,0,,0,0.00000000000000000000
chr18,41453501,41453936,435,-1,0,,0,0.00000000000000000000
chr18,41764430,41778256,13826,-1,0,,0,0.00000000000000000000
chr18,41765714,41776114,10400,-1,0,,0,0.00000000000000000000
chr18,41886619,41886875,256,-1,0,,0,0.00000000000000000000
chr18,41886763,41886923,160,-1,0,,0,0.00000000000000000000
chr18,41922271,42064156,141885,-1,0,,0,0.00000000000000000000
chr18,41976707,41982107,5400,-1,0,,0,0.00000000000000000000
chr18,41976956,41981283,4327,-1,0,,0,0.00000000000000000000
chr18,41976908,41978580,1672,-1,0,,0,0.00000000000000000000
chr18,42145625,42152671,7046,-1,0,,0,0.00000000000000000000
chr18,42625416,42626099,683,-1,0,26040,1,146.41288433382100000000
chr18,42815495,42816729,1234,-1,0,8170,1,81.03727714748780000000
chr18,42838107,42838810,703,-1,0,8170,1,142.24751066856300000000
chr18,42863193,42863422,229,-1,0,8170,1,436.68122270742400000000
chr18,43260974,43261367,393,-1,0,8170,1,254.45292620865100000000
chr18,43345201,43345281,80,-1,0,,0,0.00000000000000000000
chr18,43567456,43567511,55,-1,0,9050,1,1818.18181818182000000000
chr18,43676714,43677704,990,-1,0,498,1,101.01010101010100000000
chr18,43695306,43697797,2491,-1,0,115106,1,40.14452027298270000000
chr18,43706006,43707438,1432,-1,0,115106,1,69.83240223463690000000
chr18,43773336,43775635,2299,-1,0,147339,1,43.49717268377560000000
chr18,43895574,43896460,886,-1,0,,0,0.00000000000000000000
chr18,43941639,43946322,4683,-1,0,494470,1,21.35383301302580000000
chr18,44481531,44535937,54406,-1,0,83473;9063,2,3.67606513987428000000
chr18,44540977,44560143,19166,-1,0,100506888;83473;162699;728929;51224,5,26.08786392570180000000
chr18,44542335,44553901,11566,-1,0,100506888;728929;83473,3,25.93809441466370000000
chr18,44550123,44556864,6741,-1,0,728929;83473;162699,3,44.50378282153980000000
chr18,44527377,44529844,2467,-1,0,83473,1,40.53506282934740000000
chr18,44429410,44431075,1665,-1,0,9063,1,60.06006006006010000000
chr18,44714964,44715458,494,-1,0,,0,0.00000000000000000000
chr18,44338334,44338866,532,-1,0,,0,0.00000000000000000000
chr18,44382659,44383110,451,-1,0,,0,0.00000000000000000000
chr18,44338429,44338771,342,-1,0,,0,0.00000000000000000000
chr18,44715166,44715243,77,-1,0,,0,0.00000000000000000000
chr18,44774050,44775630,1580,-1,0,652991,1,63.29113924050630000000
chr18,44926685,44929279,2594,-1,0,,0,0.00000000000000000000
chr18,44927168,44929258,2090,-1,0,,0,0.00000000000000000000
chr18,45095005,45096066,1061,-1,0,,0,0.00000000000000000000
chr18,45099893,45100206,313,-1,0,,0,0.00000000000000000000
chr18,45379609,45379807,198,-1,0,4087,1,505.05050505050500000000
chr18,45715379,45733654,18275,-1,0,201501,1,5.47195622435020000000
chr18,45736977,45739507,2530,-1,0,201501,1,39.52569169960470000000
chr18,45747561,45748040,479,-1,0,201501,1,208.76826722338200000000
chr18,45785629,45785896,267,-1,0,201501,1,374.53183520599300000000
chr18,45815759,45816162,403,-1,0,201501,1,248.13895781637700000000
chr18,45989333,45995040,5707,-1,0,,0,0.00000000000000000000
chr18,45996053,45996577,524,-1,0,,0,0.00000000000000000000
chr18,45996151,45996471,320,-1,0,,0,0.00000000000000000000
chr18,46036396,46043111,6715,-1,0,,0,0.00000000000000000000
chr18,46159130,46159654,524,-1,0,9811,1,190.83969465648900000000
chr18,46159351,46159429,78,-1,0,9811,1,1282.05128205128000000000
chr18,46333864,46333970,106,-1,0,9811,1,943.39622641509400000000
chr18,46396188,46396846,658,-1,0,,0,0.00000000000000000000
chr18,46396484,46396901,417,-1,0,,0,0.00000000000000000000
chr18,46396369,46396451,82,-1,0,,0,0.00000000000000000000
chr18,46492259,46493447,1188,-1,0,,0,0.00000000000000000000
chr18,46521920,46523177,1257,-1,0,,0,0.00000000000000000000
chr18,46539049,46545676,6627,-1,0,,0,0.00000000000000000000
chr18,46833998,46836044,2046,-1,0,54808,1,48.87585532746820000000
chr18,46979011,46979602,591,-1,0,54808,1,169.20473773265600000000
chr18,46997684,47005315,7631,-1,0,,0,0.00000000000000000000
chr18,47019546,47020446,900,-1,0,,0,0.00000000000000000000
chr18,47019847,47020219,372,-1,0,,0,0.00000000000000000000
chr18,47160294,47163601,3307,-1,0,,0,0.00000000000000000000
chr18,47656082,47661891,5809,-1,0,4645,1,17.21466689619560000000
chr18,47694948,47698504,3556,-1,0,4645,1,28.12148481439820000000
chr18,47824596,47829047,4451,-1,0,,0,0.00000000000000000000
chr18,47850753,47852081,1328,-1,0,,0,0.00000000000000000000
chr18,47870301,47876417,6116,-1,0,,0,0.00000000000000000000
chr18,47893848,47898732,4884,-1,0,,0,0.00000000000000000000
chr18,48537028,48539104,2076,-1,0,,0,0.00000000000000000000
chr18,49140683,49140731,48,-1,0,,0,0.00000000000000000000
chr18,49184337,49210537,26200,-1,0,,0,0.00000000000000000000
chr18,49187943,49190655,2712,-1,0,,0,0.00000000000000000000
chr18,49196485,49198943,2458,-1,0,,0,0.00000000000000000000
chr18,49197010,49198401,1391,-1,0,,0,0.00000000000000000000
chr18,49444326,49445344,1018,-1,0,,0,0.00000000000000000000
chr18,49444570,49445077,507,-1,0,,0,0.00000000000000000000
chr18,49444746,49444902,156,-1,0,,0,0.00000000000000000000
chr18,49911695,49914757,3062,-1,0,1630,1,32.65839320705420000000
chr18,50007638,50007775,137,-1,0,1630,1,729.92700729927000000000
chr18,50355966,50360666,4700,-1,0,1630,1,21.27659574468090000000
chr18,50432282,50433390,1108,-1,0,1630,1,90.25270758122740000000
chr18,50462541,50463039,498,-1,0,1630,1,200.80321285140600000000
chr18,50488009,50489483,1474,-1,0,1630,1,67.84260515603800000000
chr18,50612382,50612968,586,-1,0,1630,1,170.64846416382300000000
chr18,50730051,50730691,640,-1,0,1630,1,156.25000000000000000000
chr18,50925889,50926394,505,-1,0,1630,1,198.01980198019800000000
chr18,50925992,50926315,323,-1,0,1630,1,309.59752321981400000000
chr18,51136400,51137797,1397,-1,0,,0,0.00000000000000000000
chr18,51136428,51137703,1275,-1,0,,0,0.00000000000000000000
chr18,51184727,51197738,13011,-1,0,,0,0.00000000000000000000
chr18,51205964,51210602,4638,-1,0,,0,0.00000000000000000000
chr18,51206690,51210550,3860,-1,0,,0,0.00000000000000000000
chr18,51436013,51436469,456,-1,0,,0,0.00000000000000000000
chr18,51831866,51832047,181,-1,0,,0,0.00000000000000000000
chr18,51850845,51857988,7143,-1,0,147323,1,13.99972000559990000000
chr18,51868776,51870969,2193,-1,0,147323,1,45.59963520291840000000
chr18,51952949,51956960,4011,-1,0,,0,0.00000000000000000000
chr18,52390272,52399291,9019,-1,0,,0,0.00000000000000000000
chr18,52391122,52394217,3095,-1,0,,0,0.00000000000000000000
chr18,52391161,52394161,3000,-1,0,,0,0.00000000000000000000
chr18,52447102,52447663,561,-1,0,,0,0.00000000000000000000
chr18,52501951,52504159,2208,-1,0,5874,1,45.28985507246380000000
chr18,52865004,52865084,80,-1,0,,0,0.00000000000000000000
chr18,53305961,53322461,16500,-1,0,,0,0.00000000000000000000
chr18,53312937,53322692,9755,-1,0,,0,0.00000000000000000000
chr18,53363728,53365640,1912,-1,0,,0,0.00000000000000000000
chr18,53757019,53757817,798,-1,0,,0,0.00000000000000000000
chr18,53765124,53766314,1190,-1,0,,0,0.00000000000000000000
chr18,53929080,53931153,2073,-1,0,,0,0.00000000000000000000
chr18,54021759,54026562,4803,-1,0,,0,0.00000000000000000000
chr18,54160501,54160864,363,-1,0,,0,0.00000000000000000000
chr18,54244953,54245639,686,-1,0,,0,0.00000000000000000000
chr18,54691692,54692171,479,-1,0,23335,1,208.76826722338200000000
chr18,54946734,54948718,1984,-1,0,,0,0.00000000000000000000
chr18,54960163,54960646,483,-1,0,,0,0.00000000000000000000
chr18,54960331,54960444,113,-1,0,,0,0.00000000000000000000
chr18,55018652,55021500,2848,-1,0,51046,1,35.11235955056180000000
chr18,55176835,55178803,1968,-1,0,,0,0.00000000000000000000
chr18,55177302,55177938,636,-1,0,,0,0.00000000000000000000
chr18,55177172,55177487,315,-1,0,,0,0.00000000000000000000
chr18,55345884,55346271,387,-1,0,5205,1,258.39793281653700000000
chr18,55669519,55671765,2246,-1,0,,0,0.00000000000000000000
chr18,55671030,55671557,527,-1,0,,0,0.00000000000000000000
chr18,55671129,55671436,307,-1,0,,0,0.00000000000000000000
chr18,55801546,55801976,430,-1,0,23327,1,232.55813953488400000000
chr18,55801593,55801918,325,-1,0,23327,1,307.69230769230800000000
chr18,55926265,55941517,15252,-1,0,23327,1,6.55651717807501000000
chr18,55931094,55944100,13006,-1,0,23327,1,7.68875903429187000000
chr18,55931027,55937148,6121,-1,0,23327,1,16.33719980395360000000
chr18,55908698,55909314,616,-1,0,23327,1,162.33766233766200000000
chr18,56036504,56036910,406,-1,0,23327,1,246.30541871921200000000
chr18,56770056,56771450,1394,-1,0,,0,0.00000000000000000000
chr18,56795016,56803342,8326,-1,0,,0,0.00000000000000000000
chr18,57063013,57064100,1087,-1,0,,0,0.00000000000000000000
chr18,57258077,57258634,557,-1,0,147372,1,179.53321364452400000000
chr18,57258178,57258516,338,-1,0,147372,1,295.85798816568000000000
chr18,57454186,57456074,1888,-1,0,,0,0.00000000000000000000
chr18,57546787,57547705,918,-1,0,,0,0.00000000000000000000
chr18,57914714,57925062,10348,-1,0,,0,0.00000000000000000000
chr18,57917964,57922132,4168,-1,0,,0,0.00000000000000000000
chr18,57670659,57672031,1372,-1,0,,0,0.00000000000000000000
chr18,58099047,58121340,22293,-1,0,,0,0.00000000000000000000
chr18,58116902,58122917,6015,-1,0,,0,0.00000000000000000000
chr18,58115236,58121101,5865,-1,0,,0,0.00000000000000000000
chr18,58138989,58162205,23216,-1,0,,0,0.00000000000000000000
chr18,58230500,58233427,2927,-1,0,,0,0.00000000000000000000
chr18,58486465,58487262,797,-1,0,,0,0.00000000000000000000
chr18,58672176,58672859,683,-1,0,,0,0.00000000000000000000
chr18,58929723,58934175,4452,-1,0,,0,0.00000000000000000000
chr18,59185549,59189072,3523,-1,0,28316,1,28.38489923360770000000
chr18,59283862,59284098,236,-1,0,,0,0.00000000000000000000
chr18,59394865,59395043,178,-1,0,,0,0.00000000000000000000
chr18,59394916,59395048,132,-1,0,,0,0.00000000000000000000
chr18,59448220,59451633,3413,-1,0,,0,0.00000000000000000000
chr18,59583893,59585689,1796,-1,0,,0,0.00000000000000000000
chr18,59591596,59591781,185,-1,0,,0,0.00000000000000000000
chr18,59672493,59674391,1898,-1,0,,0,0.00000000000000000000
chr18,59672748,59674192,1444,-1,0,,0,0.00000000000000000000
chr18,59706696,59707531,835,-1,0,,0,0.00000000000000000000
chr18,59728660,59728776,116,-1,0,23556,1,862.06896551724100000000
chr18,59861537,59865373,3836,-1,0,57614,1,26.06882168925960000000
chr18,60158202,60159528,1326,-1,0,,0,0.00000000000000000000
chr18,60189545,60195008,5463,-1,0,54877,1,18.30496064433460000000
chr18,60247560,60249328,1768,-1,0,,0,0.00000000000000000000
chr18,60730750,60731131,381,-1,0,,0,0.00000000000000000000
chr18,60770633,60770991,358,-1,0,,0,0.00000000000000000000
chr18,60812408,60812821,413,-1,0,596,1,242.13075060532700000000
chr18,60879316,60879871,555,-1,0,596,1,180.18018018018000000000
chr18,61172102,61174341,2239,-1,0,5268,1,44.66279589102280000000
chr18,61305847,61323356,17509,-1,0,6318;6317,2,11.42269689873780000000
chr18,61312733,61318185,5452,-1,0,,0,0.00000000000000000000
chr18,64082657,64337165,254508,-1,0,28513,1,0.39291495748660200000
chr18,63128648,63179529,50881,-1,0,,0,0.00000000000000000000
chr18,64188571,64220890,32319,-1,0,28513,1,3.09415514093877000000
chr18,62147480,62176352,28872,-1,0,,0,0.00000000000000000000
chr18,64300653,64317364,16711,-1,0,,0,0.00000000000000000000
chr18,63767294,63782060,14766,-1,0,,0,0.00000000000000000000
chr18,63723362,63732533,9171,-1,0,,0,0.00000000000000000000
chr18,63454934,63465521,10587,-1,0,1005,1,9.44554642486068000000
chr18,63907338,63914826,7488,-1,0,,0,0.00000000000000000000
chr18,63200429,63207458,7029,-1,0,,0,0.00000000000000000000
chr18,63829790,63835065,5275,-1,0,,0,0.00000000000000000000
chr18,63700201,63709065,8864,-1,0,,0,0.00000000000000000000
chr18,63724579,63730021,5442,-1,0,,0,0.00000000000000000000
chr18,64210047,64215420,5373,-1,0,28513,1,18.61157640052110000000
chr18,63726350,63731577,5227,-1,0,,0,0.00000000000000000000
chr18,63334304,63340229,5925,-1,0,,0,0.00000000000000000000
chr18,61865612,61871581,5969,-1,0,,0,0.00000000000000000000
chr18,63907099,63911863,4764,-1,0,,0,0.00000000000000000000
chr18,63635498,63640173,4675,-1,0,,0,0.00000000000000000000
chr18,62835412,62839841,4429,-1,0,,0,0.00000000000000000000
chr18,63201834,63206208,4374,-1,0,,0,0.00000000000000000000
chr18,63829883,63833954,4071,-1,0,,0,0.00000000000000000000
chr18,63766843,63769204,2361,-1,0,,0,0.00000000000000000000
chr18,63376036,63379539,3503,-1,0,,0,0.00000000000000000000
chr18,64130062,64133174,3112,-1,0,,0,0.00000000000000000000
chr18,63908521,63911116,2595,-1,0,,0,0.00000000000000000000
chr18,64219700,64221255,1555,-1,0,28513,1,64.30868167202570000000
chr18,63350790,63352849,2059,-1,0,,0,0.00000000000000000000
chr18,64006979,64008010,1031,-1,0,,0,0.00000000000000000000
chr18,62036123,62037243,1120,-1,0,,0,0.00000000000000000000
chr18,63767101,63768023,922,-1,0,,0,0.00000000000000000000
chr18,64007038,64007997,959,-1,0,,0,0.00000000000000000000
chr18,63304895,63305725,830,-1,0,,0,0.00000000000000000000
chr18,62041773,62042511,738,-1,0,,0,0.00000000000000000000
chr18,63533121,63533744,623,-1,0,1005,1,160.51364365971100000000
chr18,62385677,62386195,518,-1,0,,0,0.00000000000000000000
chr18,63208028,63208617,589,-1,0,,0,0.00000000000000000000
chr18,62432666,62433253,587,-1,0,,0,0.00000000000000000000
chr18,63533244,63533601,357,-1,0,1005,1,280.11204481792700000000
chr18,62385766,62386081,315,-1,0,,0,0.00000000000000000000
chr18,64339233,64339466,233,-1,0,,0,0.00000000000000000000
chr18,63208201,63208326,125,-1,0,,0,0.00000000000000000000
chr18,61810774,61810871,97,-1,0,,0,0.00000000000000000000
chr18,62996842,62996923,81,-1,0,,0,0.00000000000000000000
chr18,63911477,63911539,62,-1,0,,0,0.00000000000000000000
chr18,64534327,64576952,42625,-1,0,,0,0.00000000000000000000
chr18,64538567,64539114,547,-1,0,,0,0.00000000000000000000
chr18,64542828,64543366,538,-1,0,,0,0.00000000000000000000
chr18,64542932,64543259,327,-1,0,,0,0.00000000000000000000
chr18,64538773,64538854,81,-1,0,,0,0.00000000000000000000
chr18,64777208,64780001,2793,-1,0,,0,0.00000000000000000000
chr18,64777226,64779612,2386,-1,0,,0,0.00000000000000000000
chr18,64855581,64857317,1736,-1,0,,0,0.00000000000000000000
chr18,64889583,64894368,4785,-1,0,,0,0.00000000000000000000
chr18,64950860,64967003,16143,-1,0,,0,0.00000000000000000000
chr18,64958962,64968812,9850,-1,0,,0,0.00000000000000000000
chr18,64959333,64965171,5838,-1,0,,0,0.00000000000000000000
chr18,65295868,65318190,22322,-1,0,,0,0.00000000000000000000
chr18,65304091,65315347,11256,-1,0,,0,0.00000000000000000000
chr18,65347681,65353048,5367,-1,0,,0,0.00000000000000000000
chr18,65426154,65426841,687,-1,0,,0,0.00000000000000000000
chr18,65440638,65440912,274,-1,0,,0,0.00000000000000000000
chr18,65547062,65553593,6531,-1,0,,0,0.00000000000000000000
chr18,65611708,65775854,164146,-1,0,,0,0.00000000000000000000
chr18,65763392,65763913,521,-1,0,,0,0.00000000000000000000
chr18,65763649,65763743,94,-1,0,,0,0.00000000000000000000
chr18,65819230,65822472,3242,-1,0,,0,0.00000000000000000000
chr18,65846367,65896723,50356,-1,0,,0,0.00000000000000000000
chr18,65850290,65872311,22021,-1,0,,0,0.00000000000000000000
chr18,65947940,65949010,1070,-1,0,,0,0.00000000000000000000
chr18,65947312,65947469,157,-1,0,,0,0.00000000000000000000
chr18,66073258,66073326,68,-1,0,,0,0.00000000000000000000
chr18,66204743,66209059,4316,-1,0,,0,0.00000000000000000000
chr18,66219061,66221200,2139,-1,0,,0,0.00000000000000000000
chr18,66221318,66221641,323,-1,0,,0,0.00000000000000000000
chr18,66228959,66229340,381,-1,0,,0,0.00000000000000000000
chr18,66274832,66275910,1078,-1,0,,0,0.00000000000000000000
chr18,66430779,66431207,428,-1,0,79839,1,233.64485981308400000000
chr18,66602162,66647179,45017,-1,0,79839,1,2.22138303307639000000
chr18,66741249,66756426,15177,-1,0,,0,0.00000000000000000000
chr18,66745608,66757179,11571,-1,0,,0,0.00000000000000000000
chr18,66750104,66755924,5820,-1,0,,0,0.00000000000000000000
chr18,66746106,66753326,7220,-1,0,,0,0.00000000000000000000
chr18,66752921,66757132,4211,-1,0,,0,0.00000000000000000000
chr18,66992592,66994354,1762,-1,0,,0,0.00000000000000000000
chr18,66992797,66994078,1281,-1,0,,0,0.00000000000000000000
chr18,67033294,67048246,14952,-1,0,,0,0.00000000000000000000
chr18,67079631,67095977,16346,-1,0,220164,1,6.11770463722011000000
chr18,67440523,67453330,12807,-1,0,220164,1,7.80822987428750000000
chr18,67208330,67217500,9170,-1,0,220164,1,10.90512540894220000000
chr18,67410600,67414890,4290,-1,0,220164,1,23.31002331002330000000
chr18,67149542,67151592,2050,-1,0,220164,1,48.78048780487800000000
chr18,67172917,67174450,1533,-1,0,220164,1,65.23157208088710000000
chr18,67283511,67283926,415,-1,0,220164,1,240.96385542168700000000
chr18,67101743,67101876,133,-1,0,220164,1,751.87969924812000000000
chr18,67543333,67557955,14622,-1,0,10666,1,6.83900971139379000000
chr18,67670524,67874814,204290,-1,0,25914,1,0.48950022027509900000
chr18,67951964,67955180,3216,-1,0,,0,0.00000000000000000000
chr18,67953618,67955383,1765,-1,0,,0,0.00000000000000000000
chr18,67949488,67950053,565,-1,0,,0,0.00000000000000000000
chr18,67949601,67949927,326,-1,0,,0,0.00000000000000000000
chr18,68166567,68231023,64456,-1,0,,0,0.00000000000000000000
chr18,68431082,68480787,49705,-1,0,,0,0.00000000000000000000
chr18,68383987,68387115,3128,-1,0,,0,0.00000000000000000000
chr18,68724272,68724789,517,-1,0,,0,0.00000000000000000000
chr18,68724367,68724677,310,-1,0,,0,0.00000000000000000000
chr18,69164769,69449833,285064,-1,0,,0,0.00000000000000000000
chr18,68986074,69049144,63070,-1,0,,0,0.00000000000000000000
chr18,69146962,69174710,27748,-1,0,,0,0.00000000000000000000
chr18,68959561,68987551,27990,-1,0,,0,0.00000000000000000000
chr18,69426377,69441535,15158,-1,0,,0,0.00000000000000000000
chr18,69348558,69353979,5421,-1,0,,0,0.00000000000000000000
chr18,69376235,69378558,2323,-1,0,,0,0.00000000000000000000
chr18,69077558,69079515,1957,-1,0,,0,0.00000000000000000000
chr18,69232723,69234491,1768,-1,0,,0,0.00000000000000000000
chr18,68914214,68915825,1611,-1,0,,0,0.00000000000000000000
chr18,69484401,69485767,1366,-1,0,,0,0.00000000000000000000
chr18,69078361,69079062,701,-1,0,,0,0.00000000000000000000
chr18,68846644,68847153,509,-1,0,,0,0.00000000000000000000
chr18,68904093,68904782,689,-1,0,,0,0.00000000000000000000
chr18,68846741,68847075,334,-1,0,,0,0.00000000000000000000
chr18,69859576,69935537,75961,-1,0,,0,0.00000000000000000000
chr18,69829022,69851096,22074,-1,0,,0,0.00000000000000000000
chr18,69591079,69607666,16587,-1,0,,0,0.00000000000000000000
chr18,69762999,69764073,1074,-1,0,,0,0.00000000000000000000
chr18,69712018,69712776,758,-1,0,,0,0.00000000000000000000
chr18,69838956,69839541,585,-1,0,,0,0.00000000000000000000
chr18,69896761,69897106,345,-1,0,,0,0.00000000000000000000
chr18,69993326,70049969,56643,-1,0,,0,0.00000000000000000000
chr18,70123312,70129414,6102,-1,0,,0,0.00000000000000000000
chr18,70000515,70003166,2651,-1,0,,0,0.00000000000000000000
chr18,70126652,70127016,364,-1,0,,0,0.00000000000000000000
chr18,70323411,70323517,106,-1,0,,0,0.00000000000000000000
chr18,70353218,70353421,203,-1,0,,0,0.00000000000000000000
chr18,70439208,70439773,565,-1,0,81832,1,176.99115044247800000000
chr18,70721970,70726809,4839,-1,0,,0,0.00000000000000000000
chr18,70766642,70769278,2636,-1,0,,0,0.00000000000000000000
chr18,70873903,70875127,1224,-1,0,,0,0.00000000000000000000
chr18,70879097,71102019,222922,-1,0,,0,0.00000000000000000000
chr18,71127991,71160542,32551,-1,0,,0,0.00000000000000000000
chr18,71074085,71077607,3522,-1,0,,0,0.00000000000000000000
chr18,71002488,71004074,1586,-1,0,,0,0.00000000000000000000
chr18,71057780,71058715,935,-1,0,,0,0.00000000000000000000
chr18,70978837,70979191,354,-1,0,,0,0.00000000000000000000
chr18,71245305,71247450,2145,-1,0,,0,0.00000000000000000000
chr18,71273308,71273834,526,-1,0,,0,0.00000000000000000000
chr18,71273397,71273728,331,-1,0,,0,0.00000000000000000000
chr18,71426692,71433058,6366,-1,0,,0,0.00000000000000000000
chr18,71444191,71444587,396,-1,0,,0,0.00000000000000000000
chr18,71614781,71652083,37302,-1,0,,0,0.00000000000000000000
chr18,71876798,71883514,6716,-1,0,,0,0.00000000000000000000
chr18,72017248,72019951,2703,-1,0,644041,1,36.99593044765080000000
chr18,72092334,72092410,76,-1,0,,0,0.00000000000000000000
chr18,72152323,72152889,566,-1,0,,0,0.00000000000000000000
chr18,72152427,72152778,351,-1,0,,0,0.00000000000000000000
chr18,72620898,72632012,11114,-1,0,55628,1,8.99766060824186000000
chr18,72529600,72539833,10233,-1,0,55628,1,9.77230528681716000000
chr18,72723987,72724571,584,-1,0,55628,1,171.23287671232900000000
chr18,72485259,72485431,172,-1,0,55628,1,581.39534883720900000000
chr18,72879939,72887846,7907,-1,0,,0,0.00000000000000000000
chr18,73575015,73583457,8442,-1,0,,0,0.00000000000000000000
chr18,73394016,73402045,8029,-1,0,,0,0.00000000000000000000
chr18,73074043,73080570,6527,-1,0,,0,0.00000000000000000000
chr18,72779202,72779784,582,-1,0,,0,0.00000000000000000000
chr18,73271690,73272198,508,-1,0,,0,0.00000000000000000000
chr18,73570008,73570360,352,-1,0,,0,0.00000000000000000000
chr18,73302994,73303344,350,-1,0,,0,0.00000000000000000000
chr18,72779488,72779574,86,-1,0,,0,0.00000000000000000000
chr18,72817188,72817264,76,-1,0,,0,0.00000000000000000000
chr18,72779988,72780039,51,-1,0,,0,0.00000000000000000000
chr18,73777047,73786409,9362,-1,0,,0,0.00000000000000000000
chr18,73913340,73922663,9323,-1,0,,0,0.00000000000000000000
chr18,73901646,73902035,389,-1,0,,0,0.00000000000000000000
chr18,74404312,74475643,71331,-1,0,,0,0.00000000000000000000
chr18,74439708,74471433,31725,-1,0,,0,0.00000000000000000000
chr18,76277211,76297282,20071,-1,0,,0,0.00000000000000000000
chr18,76663287,76672708,9421,-1,0,,0,0.00000000000000000000
chr18,76288888,76298329,9441,-1,0,,0,0.00000000000000000000
chr18,76412862,76421257,8395,-1,0,,0,0.00000000000000000000
chr18,74176791,74183494,6703,-1,0,9658,1,14.91869312248250000000
chr18,76793051,76797251,4200,-1,0,,0,0.00000000000000000000
chr18,76129781,76133230,3449,-1,0,,0,0.00000000000000000000
chr18,75262516,75268230,5714,-1,0,,0,0.00000000000000000000
chr18,76290532,76294693,4161,-1,0,,0,0.00000000000000000000
chr18,77307834,77312544,4710,-1,0,,0,0.00000000000000000000
chr18,76042995,76048291,5296,-1,0,,0,0.00000000000000000000
chr18,76893116,76898383,5267,-1,0,374868,1,18.98614011771410000000
chr18,76193466,76198627,5161,-1,0,,0,0.00000000000000000000
chr18,76271684,76275647,3963,-1,0,,0,0.00000000000000000000
chr18,76662414,76666357,3943,-1,0,,0,0.00000000000000000000
chr18,76291723,76295987,4264,-1,0,,0,0.00000000000000000000
chr18,76412640,76415485,2845,-1,0,,0,0.00000000000000000000
chr18,74103945,74106965,3020,-1,0,9658,1,33.11258278145700000000
chr18,76737945,76741392,3447,-1,0,27164,1,29.01073397156950000000
chr18,76774339,76777209,2870,-1,0,,0,0.00000000000000000000
chr18,76157353,76160427,3074,-1,0,,0,0.00000000000000000000
chr18,76130080,76133129,3049,-1,0,,0,0.00000000000000000000
chr18,75639348,75642308,2960,-1,0,,0,0.00000000000000000000
chr18,77378458,77380854,2396,-1,0,,0,0.00000000000000000000
chr18,74459145,74460580,1435,-1,0,,0,0.00000000000000000000
chr18,76201998,76203726,1728,-1,0,,0,0.00000000000000000000
chr18,75295710,75298205,2495,-1,0,,0,0.00000000000000000000
chr18,77309946,77312089,2143,-1,0,,0,0.00000000000000000000
chr18,76598659,76601193,2534,-1,0,,0,0.00000000000000000000
chr18,76662856,76665159,2303,-1,0,,0,0.00000000000000000000
chr18,76372906,76375158,2252,-1,0,,0,0.00000000000000000000
chr18,76196881,76198470,1589,-1,0,,0,0.00000000000000000000
chr18,77116776,77118938,2162,-1,0,374868,1,46.25346901017580000000
chr18,76169400,76171413,2013,-1,0,,0,0.00000000000000000000
chr18,76413125,76415044,1919,-1,0,,0,0.00000000000000000000
chr18,76905037,76906644,1607,-1,0,374868,1,62.22775357809580000000
chr18,74104842,74106715,1873,-1,0,9658,1,53.39028296849970000000
chr18,74346942,74348241,1299,-1,0,,0,0.00000000000000000000
chr18,75381700,75383226,1526,-1,0,,0,0.00000000000000000000
chr18,76594943,76596066,1123,-1,0,,0,0.00000000000000000000
chr18,76412586,76414202,1616,-1,0,,0,0.00000000000000000000
chr18,76739427,76741039,1612,-1,0,27164,1,62.03473945409430000000
chr18,74293887,74295469,1582,-1,0,,0,0.00000000000000000000
chr18,74747977,74749262,1285,-1,0,4155,1,77.82101167315180000000
chr18,75266982,75268167,1185,-1,0,,0,0.00000000000000000000
chr18,77168302,77169596,1294,-1,0,4772,1,77.27975270479130000000
chr18,76774405,76775857,1452,-1,0,,0,0.00000000000000000000
chr18,77057735,77059035,1300,-1,0,374868,1,76.92307692307690000000
chr18,75833003,75834360,1357,-1,0,,0,0.00000000000000000000
chr18,77264754,77266022,1268,-1,0,4772,1,78.86435331230280000000
chr18,76295448,76296724,1276,-1,0,,0,0.00000000000000000000
chr18,75241798,75243002,1204,-1,0,,0,0.00000000000000000000
chr18,76202115,76203357,1242,-1,0,,0,0.00000000000000000000
chr18,76197171,76198324,1153,-1,0,,0,0.00000000000000000000
chr18,77068642,77069646,1004,-1,0,374868,1,99.60159362549800000000
chr18,76373622,76374477,855,-1,0,,0,0.00000000000000000000
chr18,74730205,74730880,675,-1,0,4155,1,148.14814814814800000000
chr18,76541939,76542813,874,-1,0,,0,0.00000000000000000000
chr18,74337015,74337917,902,-1,0,,0,0.00000000000000000000
chr18,74970531,74971439,908,-1,0,2587,1,110.13215859030800000000
chr18,74347196,74348005,809,-1,0,,0,0.00000000000000000000
chr18,75084720,75085464,744,-1,0,,0,0.00000000000000000000
chr18,77168756,77169357,601,-1,0,4772,1,166.38935108153100000000
chr18,76344412,76344916,504,-1,0,,0,0.00000000000000000000
chr18,74407972,74408545,573,-1,0,,0,0.00000000000000000000
chr18,75997183,75997731,548,-1,0,,0,0.00000000000000000000
chr18,77006003,77006451,448,-1,0,374868,1,223.21428571428600000000
chr18,74323421,74324113,692,-1,0,,0,0.00000000000000000000
chr18,75681127,75681827,700,-1,0,,0,0.00000000000000000000
chr18,74297291,74297959,668,-1,0,,0,0.00000000000000000000
chr18,76595233,76595760,527,-1,0,,0,0.00000000000000000000
chr18,74769663,74770163,500,-1,0,4155,1,200.00000000000000000000
chr18,76392690,76393179,489,-1,0,,0,0.00000000000000000000
chr18,75261104,75261500,396,-1,0,,0,0.00000000000000000000
chr18,76381297,76381797,500,-1,0,,0,0.00000000000000000000
chr18,77233415,77233921,506,-1,0,4772,1,197.62845849802400000000
chr18,77365792,77366188,396,-1,0,,0,0.00000000000000000000
chr18,76932230,76932561,331,-1,0,374868,1,302.11480362537800000000
chr18,76793224,76793815,591,-1,0,,0,0.00000000000000000000
chr18,76160552,76160978,426,-1,0,,0,0.00000000000000000000
chr18,75085065,75085618,553,-1,0,,0,0.00000000000000000000
chr18,76373704,76374216,512,-1,0,,0,0.00000000000000000000
chr18,76658505,76658886,381,-1,0,,0,0.00000000000000000000
chr18,74104341,74104748,407,-1,0,9658,1,245.70024570024600000000
chr18,74069139,74069603,464,-1,0,,0,0.00000000000000000000
chr18,76614257,76614799,542,-1,0,,0,0.00000000000000000000
chr18,75424525,75425003,478,-1,0,,0,0.00000000000000000000
chr18,76169454,76169924,470,-1,0,,0,0.00000000000000000000
chr18,75267029,75267561,532,-1,0,,0,0.00000000000000000000
chr18,75669394,75669892,498,-1,0,,0,0.00000000000000000000
chr18,74347123,74347627,504,-1,0,,0,0.00000000000000000000
chr18,75325841,75326200,359,-1,0,,0,0.00000000000000000000
chr18,75084690,75085120,430,-1,0,,0,0.00000000000000000000
chr18,77382604,77383037,433,-1,0,,0,0.00000000000000000000
chr18,76132985,76133345,360,-1,0,,0,0.00000000000000000000
chr18,75681681,75681984,303,-1,0,,0,0.00000000000000000000
chr18,76268296,76268738,442,-1,0,,0,0.00000000000000000000
chr18,74504533,74504945,412,-1,0,,0,0.00000000000000000000
chr18,74365363,74365670,307,-1,0,,0,0.00000000000000000000
chr18,74964794,74965078,284,-1,0,2587,1,352.11267605633800000000
chr18,75997272,75997620,348,-1,0,,0,0.00000000000000000000
chr18,75085326,75085598,272,-1,0,,0,0.00000000000000000000
chr18,76338436,76338764,328,-1,0,,0,0.00000000000000000000
chr18,74769767,74770076,309,-1,0,4155,1,323.62459546925600000000
chr18,77168953,77169218,265,-1,0,4772,1,377.35849056603800000000
chr18,74104465,74104712,247,-1,0,9658,1,404.85829959514200000000
chr18,76658559,76658815,256,-1,0,,0,0.00000000000000000000
chr18,76169585,76169825,240,-1,0,,0,0.00000000000000000000
chr18,75005988,75006179,191,-1,0,,0,0.00000000000000000000
chr18,77184780,77184944,164,-1,0,4772,1,609.75609756097600000000
chr18,74827849,74828021,172,-1,0,4155,1,581.39534883720900000000
chr18,74179154,74179333,179,-1,0,9658,1,558.65921787709500000000
chr18,76614397,76614587,190,-1,0,,0,0.00000000000000000000
chr18,76626569,76626724,155,-1,0,,0,0.00000000000000000000
chr18,77106488,77106633,145,-1,0,374868,1,689.65517241379300000000
chr18,75084846,75085014,168,-1,0,,0,0.00000000000000000000
chr18,74179041,74179202,161,-1,0,9658,1,621.11801242236000000000
chr18,77106581,77106720,139,-1,0,374868,1,719.42446043165500000000
chr18,77169022,77169155,133,-1,0,4772,1,751.87969924812000000000
chr18,75992378,75992484,106,-1,0,,0,0.00000000000000000000
chr18,74730314,74730400,86,-1,0,4155,1,1162.79069767442000000000
chr18,74853364,74853458,94,-1,0,,0,0.00000000000000000000
chr18,76160713,76160782,69,-1,0,,0,0.00000000000000000000
chr18,76381477,76381563,86,-1,0,,0,0.00000000000000000000
chr18,74069345,74069424,79,-1,0,,0,0.00000000000000000000
chr18,74964936,74965010,74,-1,0,2587,1,1351.35135135135000000000
chr18,77215735,77215791,56,-1,0,4772,1,1785.71428571429000000000
chr18,75085010,75085062,52,-1,0,,0,0.00000000000000000000
chr18,77408550,77408735,185,-1,0,,0,0.00000000000000000000
chr18,77408680,77408837,157,-1,0,,0,0.00000000000000000000
chr18,77454159,77454551,392,-1,0,9150,1,255.10204081632700000000
chr18,77454318,77454602,284,-1,0,9150,1,352.11267605633800000000
chr18,77499536,77500420,884,-1,0,9150,1,113.12217194570100000000
chr18,77499656,77500323,667,-1,0,9150,1,149.92503748125900000000
chr18,77499861,77500130,269,-1,0,9150,1,371.74721189591100000000
chr18,77504854,77506918,2064,-1,0,9150,1,48.44961240310080000000
chr18,77518548,77548788,30240,-1,0,,0,0.00000000000000000000
chr18,77524337,77525881,1544,-1,0,,0,0.00000000000000000000
chr18,77524569,77525531,962,-1,0,,0,0.00000000000000000000
chr18,77530874,77531672,798,-1,0,,0,0.00000000000000000000
chr18,77540146,77540627,481,-1,0,,0,0.00000000000000000000
chr18,77540223,77540341,118,-1,0,,0,0.00000000000000000000
chr18,77623001,77649200,26199,-1,0,26251,1,3.81693957784648000000
chr18,77983239,77999485,16246,-1,0,84552,1,6.15536131970947000000
chr18,77929962,77934164,4202,-1,0,84552,1,23.79819133745840000000
chr18,77567650,77569988,2338,-1,0,,0,0.00000000000000000000
chr18,77679416,77681939,2523,-1,0,80148,1,39.63535473642490000000
chr18,77924026,77926729,2703,-1,0,84552,1,36.99593044765080000000
chr18,77908785,77910904,2119,-1,0,,0,0.00000000000000000000
chr18,77653790,77655553,1763,-1,0,26251,1,56.72149744753260000000
chr18,77645086,77647089,2003,-1,0,26251,1,49.92511233150280000000
chr18,77652934,77654493,1559,-1,0,26251,1,64.14368184733800000000
chr18,77645860,77647132,1272,-1,0,26251,1,78.61635220125790000000
chr18,77568131,77569331,1200,-1,0,,0,0.00000000000000000000
chr18,77654201,77654993,792,-1,0,26251,1,126.26262626262600000000
chr18,77831197,77831853,656,-1,0,,0,0.00000000000000000000
chr18,77567610,77568108,498,-1,0,,0,0.00000000000000000000
chr18,77568401,77568883,482,-1,0,,0,0.00000000000000000000
chr18,77625570,77626042,472,-1,0,26251,1,211.86440677966100000000
chr18,77588965,77589200,235,-1,0,,0,0.00000000000000000000
chr19,122574,174731,52157,-1,0,,0,0.00000000000000000000
chr19,198380,200873,2493,-1,0,,0,0.00000000000000000000
chr19,284356,306015,21659,-1,0,8612;54531,2,9.23403665912554000000
chr19,296154,301471,5317,-1,0,,0,0.00000000000000000000
chr19,294001,298391,4390,-1,0,,0,0.00000000000000000000
chr19,298303,301307,3004,-1,0,,0,0.00000000000000000000
chr19,324136,324688,552,-1,0,54531,1,181.15942028985500000000
chr19,323100,323453,353,-1,0,54531,1,283.28611898017000000000
chr19,402336,498356,96020,-1,0,25759;8174;284451;126567,4,4.16579879191835000000
chr19,428811,434721,5910,-1,0,25759,1,16.92047377326570000000
chr19,565849,569774,3925,-1,0,,0,0.00000000000000000000
chr19,1194658,1198713,4055,-1,0,,0,0.00000000000000000000
chr19,359460,361944,2484,-1,0,,0,0.00000000000000000000
chr19,605292,608432,3140,-1,0,610,1,31.84713375796180000000
chr19,566036,569211,3175,-1,0,,0,0.00000000000000000000
chr19,393125,395679,2554,-1,0,,0,0.00000000000000000000
chr19,1248495,1250976,2481,-1,0,90007,1,40.30632809351070000000
chr19,921465,923262,1797,-1,0,,0,0.00000000000000000000
chr19,563941,566106,2165,-1,0,,0,0.00000000000000000000
chr19,393936,395926,1990,-1,0,,0,0.00000000000000000000
chr19,1033677,1035223,1546,-1,0,1265,1,64.68305304010350000000
chr19,360102,361586,1484,-1,0,,0,0.00000000000000000000
chr19,878756,879717,961,-1,0,10025,1,104.05827263267400000000
chr19,698695,699864,1169,-1,0,,0,0.00000000000000000000
chr19,404016,405088,1072,-1,0,,0,0.00000000000000000000
chr19,376638,377616,978,-1,0,,0,0.00000000000000000000
chr19,394075,395000,925,-1,0,,0,0.00000000000000000000
chr19,540025,540783,758,-1,0,997,1,131.92612137203200000000
chr19,1029015,1029544,529,-1,0,1265,1,189.03591682419700000000
chr19,1182640,1183159,519,-1,0,,0,0.00000000000000000000
chr19,423103,423679,576,-1,0,25759,1,173.61111111111100000000
chr19,559939,560568,629,-1,0,,0,0.00000000000000000000
chr19,828885,829286,401,-1,0,566,1,249.37655860349100000000
chr19,988845,989398,553,-1,0,57418,1,180.83182640144700000000
chr19,456734,457374,640,-1,0,25759,1,156.25000000000000000000
chr19,376694,377269,575,-1,0,,0,0.00000000000000000000
chr19,451057,451544,487,-1,0,25759,1,205.33880903490800000000
chr19,523153,523615,462,-1,0,,0,0.00000000000000000000
chr19,443238,443502,264,-1,0,25759,1,378.78787878787900000000
chr19,872903,873306,403,-1,0,10025,1,248.13895781637700000000
chr19,837852,838174,322,-1,0,,0,0.00000000000000000000
chr19,981265,981602,337,-1,0,,0,0.00000000000000000000
chr19,818937,819256,319,-1,0,79948,1,313.47962382445100000000
chr19,1247060,1247367,307,-1,0,,0,0.00000000000000000000
chr19,786571,786849,278,-1,0,,0,0.00000000000000000000
chr19,879410,879714,304,-1,0,10025,1,328.94736842105300000000
chr19,667256,667424,168,-1,0,,0,0.00000000000000000000
chr19,376760,376929,169,-1,0,,0,0.00000000000000000000
chr19,866657,866810,153,-1,0,,0,0.00000000000000000000
chr19,786550,786695,145,-1,0,,0,0.00000000000000000000
chr19,398551,398623,72,-1,0,,0,0.00000000000000000000
chr19,841459,841543,84,-1,0,5657,1,1190.47619047619000000000
chr19,765236,765312,76,-1,0,,0,0.00000000000000000000
chr19,1325844,1326065,221,-1,0,,0,0.00000000000000000000
chr19,1489527,1510103,20576,-1,0,92840;54760;339366,3,14.58009331259720000000
chr19,1852528,1866688,14160,-1,0,83855,1,7.06214689265537000000
chr19,1465058,1470715,5657,-1,0,10297,1,17.67721407106240000000
chr19,1950131,1951907,1776,-1,0,1455,1,56.30630630630630000000
chr19,1862845,1865249,2404,-1,0,83855,1,41.59733777038270000000
chr19,1566424,1568402,1978,-1,0,399664,1,50.55611729019210000000
chr19,1950502,1951547,1045,-1,0,1455,1,95.69377990430620000000
chr19,1967646,1968329,683,-1,0,1455,1,146.41288433382100000000
chr19,1967765,1967916,151,-1,0,1455,1,662.25165562913900000000
chr19,2033039,2033181,142,-1,0,,0,0.00000000000000000000
chr19,1959739,1959854,115,-1,0,1455,1,869.56521739130400000000
chr19,1992044,1992134,90,-1,0,55643,1,1111.11111111111000000000
chr19,2090749,2093247,2498,-1,0,126308,1,40.03202562049640000000
chr19,2104274,2104444,170,-1,0,8943,1,588.23529411764700000000
chr19,2128479,2129063,584,-1,0,8943,1,171.23287671232900000000
chr19,2131366,2131791,425,-1,0,8943,1,235.29411764705900000000
chr19,2153878,2153985,107,-1,0,,0,0.00000000000000000000
chr19,2409668,2417115,7447,-1,0,360200,1,13.42822613132810000000
chr19,2347376,2348814,1438,-1,0,56928,1,69.54102920723230000000
chr19,2469768,2470893,1125,-1,0,,0,0.00000000000000000000
chr19,2432885,2433730,845,-1,0,84823,1,118.34319526627200000000
chr19,2347342,2347905,563,-1,0,56928,1,177.61989342806400000000
chr19,2483708,2484305,597,-1,0,,0,0.00000000000000000000
chr19,2347899,2348307,408,-1,0,56928,1,245.09803921568600000000
chr19,2692117,2695570,3453,-1,0,2788,1,28.96032435563280000000
chr19,2701510,2702402,892,-1,0,2788,1,112.10762331838600000000
chr19,2713151,2714305,1154,-1,0,,0,0.00000000000000000000
chr19,2713043,2713466,423,-1,0,,0,0.00000000000000000000
chr19,2730825,2731016,191,-1,0,,0,0.00000000000000000000
chr19,2772776,2774033,1257,-1,0,6449,1,79.55449482895780000000
chr19,2773125,2773827,702,-1,0,6449,1,142.45014245014200000000
chr19,2817614,2819018,1404,-1,0,,0,0.00000000000000000000
chr19,2820748,2821737,989,-1,0,115196,1,101.11223458038400000000
chr19,2835899,2836407,508,-1,0,115196,1,196.85039370078700000000
chr19,2841218,2842149,931,-1,0,148254,1,107.41138560687400000000
chr19,2901685,2914440,12755,-1,0,126295,1,7.84006272050176000000
chr19,2898959,2904690,5731,-1,0,126295,1,17.44896178677370000000
chr19,2945694,2948741,3047,-1,0,,0,0.00000000000000000000
chr19,2909164,2910884,1720,-1,0,126295,1,58.13953488372090000000
chr19,2909353,2910623,1270,-1,0,126295,1,78.74015748031500000000
chr19,2972518,2973839,1321,-1,0,,0,0.00000000000000000000
chr19,3089379,3091461,2082,-1,0,,0,0.00000000000000000000
chr19,3119341,3120994,1653,-1,0,2767,1,60.49606775559590000000
chr19,3172585,3175823,3238,-1,0,,0,0.00000000000000000000
chr19,3334364,3336972,2608,-1,0,,0,0.00000000000000000000
chr19,3174308,3175765,1457,-1,0,,0,0.00000000000000000000
chr19,3529765,3530546,781,-1,0,51343,1,128.04097311139600000000
chr19,3309852,3310360,508,-1,0,,0,0.00000000000000000000
chr19,3310690,3311085,395,-1,0,,0,0.00000000000000000000
chr19,3581046,3581377,331,-1,0,,0,0.00000000000000000000
chr19,3406297,3406435,138,-1,0,4782,1,724.63768115942000000000
chr19,3528686,3528854,168,-1,0,51343,1,595.23809523809500000000
chr19,3311160,3311288,128,-1,0,,0,0.00000000000000000000
chr19,3310025,3310088,63,-1,0,,0,0.00000000000000000000
chr19,3715902,3717228,1326,-1,0,27134,1,75.41478129713420000000
chr19,3711012,3711335,323,-1,0,27134,1,309.59752321981400000000
chr19,3725608,3728162,2554,-1,0,27134,1,39.15426781519190000000
chr19,3789978,3791442,1464,-1,0,4145,1,68.30601092896180000000
chr19,3820701,3821169,468,-1,0,23217,1,213.67521367521400000000
chr19,3820831,3820971,140,-1,0,23217,1,714.28571428571400000000
chr19,3820905,3820981,76,-1,0,23217,1,1315.78947368421000000000
chr19,3866227,3866661,434,-1,0,23217,1,230.41474654377900000000
chr19,3866386,3866447,61,-1,0,23217,1,1639.34426229508000000000
chr19,3937031,3938551,1520,-1,0,27231,1,65.78947368421050000000
chr19,3939269,3940010,741,-1,0,27231,1,134.95276653171400000000
chr19,3946999,3949199,2200,-1,0,,0,0.00000000000000000000
chr19,3982552,4124470,141918,-1,0,51588;51341;1938;5605,4,2.81852900970983000000
chr19,4042845,4049792,6947,-1,0,51341,1,14.39470274938820000000
chr19,4065246,4068591,3345,-1,0,51341,1,29.89536621823620000000
chr19,3972981,3975293,2312,-1,0,,0,0.00000000000000000000
chr19,4036091,4036557,466,-1,0,51588,1,214.59227467811200000000
chr19,4041595,4042001,406,-1,0,,0,0.00000000000000000000
chr19,4036268,4036578,310,-1,0,51588,1,322.58064516129000000000
chr19,3994543,3994871,328,-1,0,,0,0.00000000000000000000
chr19,4125886,4126090,204,-1,0,,0,0.00000000000000000000
chr19,4210570,4210627,57,-1,0,170961,1,1754.38596491228000000000
chr19,4269672,4270077,405,-1,0,,0,0.00000000000000000000
chr19,4293109,4294221,1112,-1,0,126259,1,89.92805755395680000000
chr19,4325337,4327306,1969,-1,0,55620,1,50.78720162519040000000
chr19,4511055,4513142,2087,-1,0,729359,1,47.91566842357450000000
chr19,4511155,4512036,881,-1,0,729359,1,113.50737797956900000000
chr19,4512649,4513195,546,-1,0,729359,1,183.15018315018300000000
chr19,4512866,4513259,393,-1,0,729359,1,254.45292620865100000000
chr19,4511526,4511749,223,-1,0,729359,1,448.43049327354300000000
chr19,4513038,4513235,197,-1,0,729359,1,507.61421319796900000000
chr19,4525877,4525994,117,-1,0,440503,1,854.70085470085500000000
chr19,4616563,4621497,4934,-1,0,,0,0.00000000000000000000
chr19,4808071,4814121,6050,-1,0,,0,0.00000000000000000000
chr19,4880107,4884144,4037,-1,0,,0,0.00000000000000000000
chr19,4691771,4694134,2363,-1,0,91039,1,42.31908590774440000000
chr19,4560555,4562818,2263,-1,0,,0,0.00000000000000000000
chr19,4618452,4619686,1234,-1,0,,0,0.00000000000000000000
chr19,4835498,4836386,888,-1,0,,0,0.00000000000000000000
chr19,4662908,4663619,711,-1,0,56005,1,140.64697609001400000000
chr19,4618574,4619078,504,-1,0,,0,0.00000000000000000000
chr19,4671786,4672230,444,-1,0,,0,0.00000000000000000000
chr19,4874702,4875105,403,-1,0,,0,0.00000000000000000000
chr19,4786495,4786673,178,-1,0,,0,0.00000000000000000000
chr19,4974085,4976257,2172,-1,0,23030,1,46.04051565377530000000
chr19,5076047,5076675,628,-1,0,23030,1,159.23566878980900000000
chr19,5509800,5510769,969,-1,0,,0,0.00000000000000000000
chr19,5510049,5510543,494,-1,0,,0,0.00000000000000000000
chr19,5633615,5637152,3537,-1,0,6294,1,28.27254735651680000000
chr19,5796147,5796398,251,-1,0,,0,0.00000000000000000000
chr19,5810073,5810790,717,-1,0,,0,0.00000000000000000000
chr19,5882016,5883832,1816,-1,0,,0,0.00000000000000000000
chr19,6152131,6152722,591,-1,0,81616,1,169.20473773265600000000
chr19,6152271,6152558,287,-1,0,81616,1,348.43205574912900000000
chr19,6163159,6163489,330,-1,0,81616,1,303.03030303030300000000
chr19,6256041,6257675,1634,-1,0,4298,1,61.19951040391680000000
chr19,6266551,6267203,652,-1,0,4298,1,153.37423312883400000000
chr19,6330111,6331517,1406,-1,0,125981,1,71.12375533428170000000
chr19,6387620,6388180,560,-1,0,2962,1,178.57142857142900000000
chr19,6441585,6442052,467,-1,0,79085,1,214.13276231263400000000
chr19,6485643,6486964,1321,-1,0,,0,0.00000000000000000000
chr19,6508419,6508910,491,-1,0,,0,0.00000000000000000000
chr19,6635177,6636681,1504,-1,0,,0,0.00000000000000000000
chr19,6693927,6694309,382,-1,0,718,1,261.78010471204200000000
chr19,6710038,6710436,398,-1,0,718,1,251.25628140703500000000
chr19,6710192,6710365,173,-1,0,718,1,578.03468208092500000000
chr19,6779066,6780908,1842,-1,0,7409,1,54.28881650380020000000
chr19,6858620,6861177,2557,-1,0,,0,0.00000000000000000000
chr19,6954340,7029805,75465,-1,0,,0,0.00000000000000000000
chr19,7019260,7061637,42377,-1,0,653656;653657;125997;284428,4,9.43908252117894000000
chr19,6987458,6987792,334,-1,0,,0,0.00000000000000000000
chr19,7246614,7247310,696,-1,0,3643,1,143.67816091954000000000
chr19,7246860,7247037,177,-1,0,3643,1,564.97175141242900000000
chr19,7250840,7252853,2013,-1,0,3643,1,49.67709885742670000000
chr19,7258360,7259291,931,-1,0,3643,1,107.41138560687400000000
chr19,7426815,7427066,251,-1,0,,0,0.00000000000000000000
chr19,7426860,7427033,173,-1,0,,0,0.00000000000000000000
chr19,7426944,7427107,163,-1,0,,0,0.00000000000000000000
chr19,7451042,7454106,3064,-1,0,,0,0.00000000000000000000
chr19,7648384,7652655,4271,-1,0,,0,0.00000000000000000000
chr19,7756816,7757281,465,-1,0,2208,1,215.05376344086000000000
chr19,7753627,7754028,401,-1,0,2208,1,249.37655860349100000000
chr19,7780543,7784060,3517,-1,0,,0,0.00000000000000000000
chr19,7818620,7819893,1273,-1,0,,0,0.00000000000000000000
chr19,7935608,7936302,694,-1,0,80164,1,144.09221902017300000000
chr19,7935863,7935939,76,-1,0,80164,1,1315.78947368421000000000
chr19,7943035,7943096,61,-1,0,,0,0.00000000000000000000
chr19,8009846,8010324,478,-1,0,,0,0.00000000000000000000
chr19,8074179,8079287,5108,-1,0,,0,0.00000000000000000000
chr19,8156939,8158388,1449,-1,0,84467,1,69.01311249137340000000
chr19,8163405,8163471,66,-1,0,84467,1,1515.15151515152000000000
chr19,8191310,8194047,2737,-1,0,84467,1,36.53635367190350000000
chr19,8222535,8230906,8371,-1,0,,0,0.00000000000000000000
chr19,8229391,8230408,1017,-1,0,,0,0.00000000000000000000
chr19,8245746,8252811,7065,-1,0,,0,0.00000000000000000000
chr19,8242774,8247043,4269,-1,0,,0,0.00000000000000000000
chr19,8243029,8244959,1930,-1,0,,0,0.00000000000000000000
chr19,8262163,8264294,2131,-1,0,,0,0.00000000000000000000
chr19,8334668,8359495,24827,-1,0,,0,0.00000000000000000000
chr19,8351599,8366564,14965,-1,0,,0,0.00000000000000000000
chr19,8334800,8336901,2101,-1,0,,0,0.00000000000000000000
chr19,8375510,8379627,4117,-1,0,4701,1,24.28953121204760000000
chr19,8411629,8417947,6318,-1,0,,0,0.00000000000000000000
chr19,8411694,8414583,2889,-1,0,,0,0.00000000000000000000
chr19,8412084,8413600,1516,-1,0,,0,0.00000000000000000000
chr19,8470673,8474900,4227,-1,0,,0,0.00000000000000000000
chr19,8514338,8514845,507,-1,0,4670,1,197.23865877712000000000
chr19,8514425,8514732,307,-1,0,4670,1,325.73289902280100000000
chr19,8663706,8664609,903,-1,0,81794,1,110.74197120708700000000
chr19,8765865,8766083,218,-1,0,,0,0.00000000000000000000
chr19,8765775,8765933,158,-1,0,,0,0.00000000000000000000
chr19,8772987,8773303,316,-1,0,,0,0.00000000000000000000
chr19,8847442,8900397,52955,-1,0,,0,0.00000000000000000000
chr19,8888168,8901155,12987,-1,0,,0,0.00000000000000000000
chr19,8878472,8885114,6642,-1,0,,0,0.00000000000000000000
chr19,8885192,8890509,5317,-1,0,,0,0.00000000000000000000
chr19,8937769,8937861,92,-1,0,148156,1,1086.95652173913000000000
chr19,8994867,8995355,488,-1,0,94025,1,204.91803278688500000000
chr19,8995049,8995196,147,-1,0,94025,1,680.27210884353700000000
chr19,9015181,9017992,2811,-1,0,94025,1,35.57452863749560000000
chr19,9008454,9008943,489,-1,0,94025,1,204.49897750511200000000
chr19,9222940,9225122,2182,-1,0,,0,0.00000000000000000000
chr19,9245106,9246371,1265,-1,0,,0,0.00000000000000000000
chr19,9274123,9284937,10814,-1,0,,0,0.00000000000000000000
chr19,9278574,9284800,6226,-1,0,,0,0.00000000000000000000
chr19,9275739,9279552,3813,-1,0,,0,0.00000000000000000000
chr19,9519454,9519859,405,-1,0,,0,0.00000000000000000000
chr19,9659680,9659934,254,-1,0,,0,0.00000000000000000000
chr19,9863484,9872017,8533,-1,0,162993,1,11.71920778155400000000
chr19,9926241,9928506,2265,-1,0,54850,1,44.15011037527590000000
chr19,9930092,9931345,1253,-1,0,,0,0.00000000000000000000
chr19,9931085,9931295,210,-1,0,,0,0.00000000000000000000
chr19,10034522,10040032,5510,-1,0,93145,1,18.14882032667880000000
chr19,10048688,10049633,945,-1,0,,0,0.00000000000000000000
chr19,10082315,10082833,518,-1,0,50509,1,193.05019305019300000000
chr19,10212322,10214616,2294,-1,0,83854,1,43.59197907585000000000
chr19,10592217,10596320,4103,-1,0,,0,0.00000000000000000000
chr19,10839723,10839865,142,-1,0,1785,1,704.22535211267600000000
chr19,10871521,10875637,4116,-1,0,1785,1,24.29543245869780000000
chr19,11158161,11158980,819,-1,0,6597,1,122.10012210012200000000
chr19,11268968,11270132,1164,-1,0,,0,0.00000000000000000000
chr19,11294843,11296507,1664,-1,0,25959,1,60.09615384615380000000
chr19,11413564,11415445,1881,-1,0,26526,1,53.16321105794790000000
chr19,11517441,11518625,1184,-1,0,57139,1,84.45945945945950000000
chr19,11779830,11782099,2269,-1,0,,0,0.00000000000000000000
chr19,11922501,11923017,516,-1,0,,0,0.00000000000000000000
chr19,11922704,11922790,86,-1,0,,0,0.00000000000000000000
chr19,12033326,12073639,40313,-1,0,90592,1,2.48058938803860000000
chr19,12005192,12030148,24956,-1,0,7620,1,4.00705241224555000000
chr19,12039123,12046499,7376,-1,0,90592,1,13.55748373101950000000
chr19,11969054,11971068,2014,-1,0,,0,0.00000000000000000000
chr19,12042472,12043205,733,-1,0,90592,1,136.42564802182800000000
chr19,12164653,12177728,13075,-1,0,284391,1,7.64818355640535000000
chr19,12403115,12404862,1747,-1,0,51710,1,57.24098454493420000000
chr19,12499183,12544624,45441,-1,0,90576;10224,2,4.40131159085407000000
chr19,12424226,12426284,2058,-1,0,,0,0.00000000000000000000
chr19,12556656,12558239,1583,-1,0,,0,0.00000000000000000000
chr19,12557695,12557985,290,-1,0,,0,0.00000000000000000000
chr19,12606760,12611120,4360,-1,0,,0,0.00000000000000000000
chr19,12649184,12651416,2232,-1,0,163050,1,44.80286738351250000000
chr19,12694532,12699076,4544,-1,0,57474,1,22.00704225352110000000
chr19,12695297,12697441,2144,-1,0,57474,1,46.64179104477610000000
chr19,12671402,12672729,1327,-1,0,,0,0.00000000000000000000
chr19,12695130,12695903,773,-1,0,57474,1,129.36610608020700000000
chr19,12753335,12754501,1166,-1,0,,0,0.00000000000000000000
chr19,13016357,13023111,6754,-1,0,256126,1,14.80604086467280000000
chr19,13022837,13023257,420,-1,0,256126,1,238.09523809523800000000
chr19,13208116,13209652,1536,-1,0,4784,1,65.10416666666670000000
chr19,13301195,13301531,336,-1,0,,0,0.00000000000000000000
chr19,13307833,13311401,3568,-1,0,,0,0.00000000000000000000
chr19,13306592,13307358,766,-1,0,,0,0.00000000000000000000
chr19,13479549,13479870,321,-1,0,773,1,311.52647975077900000000
chr19,13698447,13702791,4344,-1,0,,0,0.00000000000000000000
chr19,13738883,13739390,507,-1,0,,0,0.00000000000000000000
chr19,13739099,13739227,128,-1,0,,0,0.00000000000000000000
chr19,13775215,13777774,2559,-1,0,,0,0.00000000000000000000
chr19,13775668,13776835,1167,-1,0,,0,0.00000000000000000000
chr19,13776042,13776661,619,-1,0,,0,0.00000000000000000000
chr19,14193401,14321100,127699,-1,0,5566;55723;90378;22859;646457,5,3.91545744289305000000
chr19,14199908,14204086,4178,-1,0,5566;90378,2,47.86979415988510000000
chr19,14200616,14202374,1758,-1,0,90378,1,56.88282138794080000000
chr19,14472324,14473840,1516,-1,0,,0,0.00000000000000000000
chr19,14511526,14513223,1697,-1,0,976,1,58.92751915144370000000
chr19,14599541,14601777,2236,-1,0,10755,1,44.72271914132380000000
chr19,14649823,14653339,3516,-1,0,9524,1,28.44141069397040000000
chr19,14679296,14679802,506,-1,0,4713,1,197.62845849802400000000
chr19,14695453,14704392,8939,-1,0,388512,1,11.18693366148340000000
chr19,14731896,14734154,2258,-1,0,84658,1,44.28697962798940000000
chr19,14732476,14733942,1466,-1,0,84658,1,68.21282401091400000000
chr19,14908456,14921734,13278,-1,0,26664,1,7.53125470703419000000
chr19,14915312,14922954,7642,-1,0,,0,0.00000000000000000000
chr19,14963795,15013715,49920,-1,0,26333,1,2.00320512820513000000
chr19,14991812,15003277,11465,-1,0,26333,1,8.72219799389446000000
chr19,15046476,15049634,3158,-1,0,,0,0.00000000000000000000
chr19,15045600,15047835,2235,-1,0,,0,0.00000000000000000000
chr19,15047287,15049377,2090,-1,0,,0,0.00000000000000000000
chr19,15323054,15324204,1150,-1,0,,0,0.00000000000000000000
chr19,15678590,15697156,18566,-1,0,,0,0.00000000000000000000
chr19,15727731,15787718,59987,-1,0,66002;4051;11283,3,5.00108356810642000000
chr19,15757623,15777145,19522,-1,0,4051,1,5.12242598094458000000
chr19,15783708,15793234,9526,-1,0,66002,1,10.49758555532230000000
chr19,15761837,15763217,1380,-1,0,4051,1,72.46376811594200000000
chr19,15761931,15762409,478,-1,0,4051,1,209.20502092050200000000
chr19,15787193,15787690,497,-1,0,66002,1,201.20724346076500000000
chr19,15784760,15785303,543,-1,0,66002,1,184.16206261510100000000
chr19,15787445,15787724,279,-1,0,66002,1,358.42293906810000000000
chr19,15784107,15784356,249,-1,0,66002,1,401.60642570281100000000
chr19,15787983,15788229,246,-1,0,66002,1,406.50406504065000000000
chr19,15870045,16046299,176254,-1,0,8529;284433;26539;102724279;57834,5,2.83681505100593000000
chr19,15985081,16017406,32325,-1,0,8529,1,3.09358081979892000000
chr19,16026438,16030509,4071,-1,0,57834,1,24.56398919184480000000
chr19,16042229,16045026,2797,-1,0,57834,1,35.75259206292460000000
chr19,15893246,15896267,3021,-1,0,,0,0.00000000000000000000
chr19,15993140,15993707,567,-1,0,8529,1,176.36684303351000000000
chr19,16103205,16106225,3020,-1,0,,0,0.00000000000000000000
chr19,16144075,16144416,341,-1,0,,0,0.00000000000000000000
chr19,16144256,16144499,243,-1,0,,0,0.00000000000000000000
chr19,16234954,16235570,616,-1,0,4218,1,162.33766233766200000000
chr19,16414309,16420907,6598,-1,0,,0,0.00000000000000000000
chr19,16658541,16660181,1640,-1,0,,0,0.00000000000000000000
chr19,16786899,16787108,209,-1,0,79041,1,478.46889952153100000000
chr19,16814756,16816541,1785,-1,0,,0,0.00000000000000000000
chr19,16985026,16986792,1766,-1,0,23309,1,56.62514156285390000000
chr19,17087112,17087693,581,-1,0,27151,1,172.11703958691900000000
chr19,17100842,17102476,1634,-1,0,27151,1,61.19951040391680000000
chr19,17141631,17145525,3894,-1,0,,0,0.00000000000000000000
chr19,17153829,17157869,4040,-1,0,,0,0.00000000000000000000
chr19,17261345,17261802,457,-1,0,4650,1,218.81838074398200000000
chr19,17398165,17400106,1941,-1,0,126549,1,51.51983513652760000000
chr19,17459966,17460095,129,-1,0,,0,0.00000000000000000000
chr19,17577233,17581002,3769,-1,0,,0,0.00000000000000000000
chr19,17605049,17606387,1338,-1,0,376497,1,74.73841554559040000000
chr19,17660833,17662222,1389,-1,0,199786,1,71.99424046076310000000
chr19,17703905,17704292,387,-1,0,,0,0.00000000000000000000
chr19,17776786,17776844,58,-1,0,23025,1,1724.13793103448000000000
chr19,17856112,17856803,691,-1,0,,0,0.00000000000000000000
chr19,17995112,17995822,710,-1,0,6528,1,140.84507042253500000000
chr19,18044806,18045200,394,-1,0,115098,1,253.80710659898500000000
chr19,18390837,18393021,2184,-1,0,3727,1,45.78754578754580000000
chr19,18387481,18388664,1183,-1,0,,0,0.00000000000000000000
chr19,18566046,18566657,611,-1,0,8178,1,163.66612111293000000000
chr19,18242157,18242478,321,-1,0,23031,1,311.52647975077900000000
chr19,18661345,18661809,464,-1,0,,0,0.00000000000000000000
chr19,18746535,18747892,1357,-1,0,55295,1,73.69196757553430000000
chr19,18847080,18847616,536,-1,0,23373,1,186.56716417910400000000
chr19,18926117,18926292,175,-1,0,,0,0.00000000000000000000
chr19,19046629,19047248,619,-1,0,9454,1,161.55088852988700000000
chr19,19258013,19258291,278,-1,0,4207;100271849,2,719.42446043165500000000
chr19,19410404,19411256,852,-1,0,57794,1,117.37089201877900000000
chr19,19801634,19802300,666,-1,0,,0,0.00000000000000000000
chr19,19802242,19802623,381,-1,0,,0,0.00000000000000000000
chr19,19833907,19839913,6006,-1,0,7561,1,16.65001665001660000000
chr19,19837729,19839629,1900,-1,0,7561,1,52.63157894736840000000
chr19,19838263,19839599,1336,-1,0,7561,1,74.85029940119760000000
chr19,20067174,20821061,753887,-1,0,90649;91120;100129842;199777;7643,5,0.66322936991883400000
chr19,20254638,20389164,134526,-1,0,90649,1,0.74335072774036200000
chr19,20594811,20725405,130594,-1,0,100129842,1,0.76573196318360700000
chr19,20321646,20404791,83145,-1,0,,0,0.00000000000000000000
chr19,20603924,20670029,66105,-1,0,,0,0.00000000000000000000
chr19,20266494,20293834,27340,-1,0,90649,1,3.65764447695684000000
chr19,20749451,20778369,28918,-1,0,,0,0.00000000000000000000
chr19,20717224,20733585,16361,-1,0,100129842,1,6.11209583766273000000
chr19,20752480,20761336,8856,-1,0,,0,0.00000000000000000000
chr19,20145557,20153711,8154,-1,0,91120,1,12.26391954868780000000
chr19,20711508,20717775,6267,-1,0,,0,0.00000000000000000000
chr19,20794352,20800939,6587,-1,0,,0,0.00000000000000000000
chr19,20262994,20267857,4863,-1,0,,0,0.00000000000000000000
chr19,20375789,20380358,4569,-1,0,,0,0.00000000000000000000
chr19,20887460,20889918,2458,-1,0,,0,0.00000000000000000000
chr19,20298340,20300041,1701,-1,0,90649,1,58.78894767783660000000
chr19,19927444,19928907,1463,-1,0,440515,1,68.35269993164730000000
chr19,20947820,20949067,1247,-1,0,,0,0.00000000000000000000
chr19,20801314,20802093,779,-1,0,,0,0.00000000000000000000
chr19,20441751,20442433,682,-1,0,,0,0.00000000000000000000
chr19,20176608,20177148,540,-1,0,,0,0.00000000000000000000
chr19,20044868,20045288,420,-1,0,81931,1,238.09523809523800000000
chr19,20174680,20175004,324,-1,0,,0,0.00000000000000000000
chr19,20176715,20177026,311,-1,0,,0,0.00000000000000000000
chr19,20807161,20807428,267,-1,0,199777,1,374.53183520599300000000
chr19,20807159,20807306,147,-1,0,199777,1,680.27210884353700000000
chr19,21003382,21003541,159,-1,0,,0,0.00000000000000000000
chr19,21050071,21050488,417,-1,0,,0,0.00000000000000000000
chr19,21058341,21104825,46484,-1,0,,0,0.00000000000000000000
chr19,21156801,21166163,9362,-1,0,,0,0.00000000000000000000
chr19,21087784,21089733,1949,-1,0,,0,0.00000000000000000000
chr19,21063059,21064269,1210,-1,0,,0,0.00000000000000000000
chr19,22087099,23141940,1054841,-1,0,7652;7757;100287226;57615;148198;113835;163223,7,0.66360712183163200000
chr19,21297350,21807068,509718,-1,0,148206;170959;7562;284443;353088,5,0.98093455597016400000
chr19,22225934,22451140,225206,-1,0,163223;113835,2,0.88807580615081300000
chr19,22241058,22354748,113690,-1,0,113835,1,0.87958483595742800000
chr19,21281932,21351343,69411,-1,0,148206;170959,2,2.88138767630491000000
chr19,22029285,22109428,80143,-1,0,7594,1,1.24776961181887000000
chr19,21525088,21598833,73745,-1,0,284443,1,1.35602413722964000000
chr19,21268462,21327967,59505,-1,0,148206;170959,2,3.36106209562222000000
chr19,22782927,22822736,39809,-1,0,57615,1,2.51199477505087000000
chr19,23133503,23174956,41453,-1,0,388523,1,2.41237063662461000000
chr19,22532059,22571479,39420,-1,0,,0,0.00000000000000000000
chr19,22710897,22748531,37634,-1,0,,0,0.00000000000000000000
chr19,21390313,21400957,10644,-1,0,,0,0.00000000000000000000
chr19,21643972,21658122,14150,-1,0,,0,0.00000000000000000000
chr19,23217325,23225576,8251,-1,0,,0,0.00000000000000000000
chr19,21463753,21474969,11216,-1,0,7562,1,8.91583452211127000000
chr19,21903057,21908480,5423,-1,0,163227,1,18.43997787202660000000
chr19,23218139,23223390,5251,-1,0,,0,0.00000000000000000000
chr19,22838668,22843365,4697,-1,0,57615,1,21.29018522461150000000
chr19,21752335,21755345,3010,-1,0,,0,0.00000000000000000000
chr19,22423021,22426523,3502,-1,0,,0,0.00000000000000000000
chr19,23140877,23142941,2064,-1,0,,0,0.00000000000000000000
chr19,21981192,21984471,3279,-1,0,,0,0.00000000000000000000
chr19,21903049,21905565,2516,-1,0,,0,0.00000000000000000000
chr19,21635903,21638151,2248,-1,0,,0,0.00000000000000000000
chr19,22312063,22314232,2169,-1,0,,0,0.00000000000000000000
chr19,22767371,22769169,1798,-1,0,,0,0.00000000000000000000
chr19,22448276,22450151,1875,-1,0,,0,0.00000000000000000000
chr19,21445516,21447228,1712,-1,0,,0,0.00000000000000000000
chr19,23389878,23391455,1577,-1,0,,0,0.00000000000000000000
chr19,22779106,22780479,1373,-1,0,,0,0.00000000000000000000
chr19,21750736,21751715,979,-1,0,,0,0.00000000000000000000
chr19,22982443,22983616,1173,-1,0,,0,0.00000000000000000000
chr19,23264331,23265379,1048,-1,0,,0,0.00000000000000000000
chr19,22226118,22227142,1024,-1,0,,0,0.00000000000000000000
chr19,22544641,22545508,867,-1,0,,0,0.00000000000000000000
chr19,22938994,22939551,557,-1,0,7652,1,179.53321364452400000000
chr19,21801718,21802434,716,-1,0,,0,0.00000000000000000000
chr19,23320699,23321230,531,-1,0,100129543,1,188.32391713747600000000
chr19,22768067,22768546,479,-1,0,,0,0.00000000000000000000
chr19,23046887,23047417,530,-1,0,,0,0.00000000000000000000
chr19,21758588,21759001,413,-1,0,,0,0.00000000000000000000
chr19,22508990,22509397,407,-1,0,,0,0.00000000000000000000
chr19,21909809,21910319,510,-1,0,163227,1,196.07843137254900000000
chr19,22834957,22835253,296,-1,0,57615,1,337.83783783783800000000
chr19,21513914,21514199,285,-1,0,,0,0.00000000000000000000
chr19,22156697,22157111,414,-1,0,7757,1,241.54589371980700000000
chr19,22768146,22768470,324,-1,0,,0,0.00000000000000000000
chr19,23320802,23321125,323,-1,0,100129543,1,309.59752321981400000000
chr19,21717094,21717341,247,-1,0,353088,1,404.85829959514200000000
chr19,22509119,22509302,183,-1,0,,0,0.00000000000000000000
chr19,22834996,22835198,202,-1,0,57615,1,495.04950495049500000000
chr19,22618522,22618701,179,-1,0,,0,0.00000000000000000000
chr19,21513950,21514148,198,-1,0,,0,0.00000000000000000000
chr19,21319499,21319621,122,-1,0,,0,0.00000000000000000000
chr19,21566172,21566261,89,-1,0,,0,0.00000000000000000000
chr19,23620965,24071154,450189,-1,0,148213;171392,2,0.44425785614486400000
chr19,24378109,24475270,97161,-1,0,,0,0.00000000000000000000
chr19,24468847,24560874,92027,-1,0,,0,0.00000000000000000000
chr19,23871448,23968276,96828,-1,0,148213,1,1.03275911926302000000
chr19,24055603,24150581,94978,-1,0,730087,1,1.05287540272484000000
chr19,23716455,23781246,64791,-1,0,,0,0.00000000000000000000
chr19,24460965,24513298,52333,-1,0,,0,0.00000000000000000000
chr19,24285074,24331433,46359,-1,0,9534,1,2.15707845294333000000
chr19,24457188,24488990,31802,-1,0,,0,0.00000000000000000000
chr19,24603100,24631644,28544,-1,0,,0,0.00000000000000000000
chr19,24378816,24392841,14025,-1,0,,0,0.00000000000000000000
chr19,24458809,24465335,6526,-1,0,,0,0.00000000000000000000
chr19,23856746,23866615,9869,-1,0,171392,1,10.13273887931910000000
chr19,24484943,24491933,6990,-1,0,,0,0.00000000000000000000
chr19,23908131,23914584,6453,-1,0,,0,0.00000000000000000000
chr19,23996015,24000443,4428,-1,0,,0,0.00000000000000000000
chr19,24458116,24463415,5299,-1,0,,0,0.00000000000000000000
chr19,24298856,24303940,5084,-1,0,9534,1,19.66955153422500000000
chr19,23805682,23808601,2919,-1,0,,0,0.00000000000000000000
chr19,24460856,24464791,3935,-1,0,,0,0.00000000000000000000
chr19,23608174,23612005,3831,-1,0,,0,0.00000000000000000000
chr19,24593901,24596593,2692,-1,0,,0,0.00000000000000000000
chr19,24316801,24319873,3072,-1,0,,0,0.00000000000000000000
chr19,23893456,23895588,2132,-1,0,,0,0.00000000000000000000
chr19,23805877,23808031,2154,-1,0,,0,0.00000000000000000000
chr19,23465132,23466784,1652,-1,0,,0,0.00000000000000000000
chr19,24595003,24596072,1069,-1,0,,0,0.00000000000000000000
chr19,24573553,24574272,719,-1,0,,0,0.00000000000000000000
chr19,23986293,23986803,510,-1,0,,0,0.00000000000000000000
chr19,23649361,23650070,709,-1,0,,0,0.00000000000000000000
chr19,23649097,23649546,449,-1,0,,0,0.00000000000000000000
chr19,23986387,23986714,327,-1,0,,0,0.00000000000000000000
chr19,23675428,23675766,338,-1,0,,0,0.00000000000000000000
chr19,24599786,24599963,177,-1,0,,0,0.00000000000000000000
chr19,24594387,24594526,139,-1,0,,0,0.00000000000000000000
chr19,24541759,24541917,158,-1,0,,0,0.00000000000000000000
chr19,23655182,23655239,57,-1,0,,0,0.00000000000000000000
chr19,27736063,28172667,436604,-1,0,,0,0.00000000000000000000
chr19,27733647,27961912,228265,-1,0,,0,0.00000000000000000000
chr19,27760598,27908024,147426,-1,0,,0,0.00000000000000000000
chr19,28137704,28226127,88423,-1,0,,0,0.00000000000000000000
chr19,27823269,27883082,59813,-1,0,,0,0.00000000000000000000
chr19,27925171,27982851,57680,-1,0,,0,0.00000000000000000000
chr19,28291521,28318220,26699,-1,0,,0,0.00000000000000000000
chr19,27763636,27771113,7477,-1,0,,0,0.00000000000000000000
chr19,27731835,27740122,8287,-1,0,,0,0.00000000000000000000
chr19,27831336,27837219,5883,-1,0,,0,0.00000000000000000000
chr19,28323057,28329189,6132,-1,0,,0,0.00000000000000000000
chr19,28360911,28367038,6127,-1,0,,0,0.00000000000000000000
chr19,27956872,27960396,3524,-1,0,,0,0.00000000000000000000
chr19,27996008,27999145,3137,-1,0,,0,0.00000000000000000000
chr19,27733590,27736286,2696,-1,0,,0,0.00000000000000000000
chr19,27976031,27979459,3428,-1,0,,0,0.00000000000000000000
chr19,28250329,28253747,3418,-1,0,,0,0.00000000000000000000
chr19,28140001,28143153,3152,-1,0,,0,0.00000000000000000000
chr19,27736477,27738758,2281,-1,0,,0,0.00000000000000000000
chr19,28317865,28320185,2320,-1,0,,0,0.00000000000000000000
chr19,27961357,27963241,1884,-1,0,,0,0.00000000000000000000
chr19,27961548,27962595,1047,-1,0,,0,0.00000000000000000000
chr19,27881610,27882419,809,-1,0,,0,0.00000000000000000000
chr19,28125880,28126449,569,-1,0,,0,0.00000000000000000000
chr19,27736066,27736554,488,-1,0,,0,0.00000000000000000000
chr19,27880056,27880648,592,-1,0,,0,0.00000000000000000000
chr19,27737049,27737479,430,-1,0,,0,0.00000000000000000000
chr19,28405185,28411953,6768,-1,0,,0,0.00000000000000000000
chr19,28518073,29447731,929658,-1,0,,0,0.00000000000000000000
chr19,28492811,28707872,215061,-1,0,,0,0.00000000000000000000
chr19,29949947,29956374,6427,-1,0,,0,0.00000000000000000000
chr19,28771050,28776539,5489,-1,0,,0,0.00000000000000000000
chr19,28583801,28590100,6299,-1,0,,0,0.00000000000000000000
chr19,30167880,30173881,6001,-1,0,,0,0.00000000000000000000
chr19,30001350,30005613,4263,-1,0,,0,0.00000000000000000000
chr19,28772845,28776078,3233,-1,0,,0,0.00000000000000000000
chr19,29827171,29830278,3107,-1,0,,0,0.00000000000000000000
chr19,29336964,29339937,2973,-1,0,,0,0.00000000000000000000
chr19,30003166,30003835,669,-1,0,,0,0.00000000000000000000
chr19,30057819,30058621,802,-1,0,,0,0.00000000000000000000
chr19,28780414,28781143,729,-1,0,,0,0.00000000000000000000
chr19,30002735,30003160,425,-1,0,,0,0.00000000000000000000
chr19,30004840,30005397,557,-1,0,,0,0.00000000000000000000
chr19,30003109,30003535,426,-1,0,,0,0.00000000000000000000
chr19,29295717,29296071,354,-1,0,,0,0.00000000000000000000
chr19,29211288,29211497,209,-1,0,,0,0.00000000000000000000
chr19,30289450,30289556,106,-1,0,,0,0.00000000000000000000
chr19,30316735,30317229,494,-1,0,,0,0.00000000000000000000
chr19,30374870,30375016,146,-1,0,,0,0.00000000000000000000
chr19,30386442,30386914,472,-1,0,,0,0.00000000000000000000
chr19,30386508,30386765,257,-1,0,,0,0.00000000000000000000
chr19,30388609,30393250,4641,-1,0,,0,0.00000000000000000000
chr19,30421822,30423770,1948,-1,0,8725,1,51.33470225872690000000
chr19,30440164,30484737,44573,-1,0,8725,1,2.24351064545801000000
chr19,30638943,30639270,327,-1,0,,0,0.00000000000000000000
chr19,30953699,30953866,167,-1,0,9745,1,598.80239520958100000000
chr19,31287129,31289780,2651,-1,0,,0,0.00000000000000000000
chr19,31287591,31289317,1726,-1,0,,0,0.00000000000000000000
chr19,31316682,31318675,1993,-1,0,,0,0.00000000000000000000
chr19,31495369,31495823,454,-1,0,,0,0.00000000000000000000
chr19,31733438,31733933,495,-1,0,,0,0.00000000000000000000
chr19,31733641,31733762,121,-1,0,,0,0.00000000000000000000
chr19,31967397,31967727,330,-1,0,,0,0.00000000000000000000
chr19,32189051,32192985,3934,-1,0,,0,0.00000000000000000000
chr19,32703585,32704537,952,-1,0,,0,0.00000000000000000000
chr19,33030148,33030574,426,-1,0,,0,0.00000000000000000000
chr19,33208868,33223900,15032,-1,0,91646,1,6.65247472059606000000
chr19,33210801,33212000,1199,-1,0,91646,1,83.40283569641370000000
chr19,33572779,33573043,264,-1,0,55094,1,378.78787878787900000000
chr19,33650123,33655320,5197,-1,0,126248,1,19.24187030979410000000
chr19,33651840,33652661,821,-1,0,126248,1,121.80267965895200000000
chr19,33819228,33819985,757,-1,0,,0,0.00000000000000000000
chr19,33996703,33996815,112,-1,0,5184,1,892.85714285714300000000
chr19,34112483,34113320,837,-1,0,64377,1,119.47431302270000000000
chr19,34316286,34316600,314,-1,0,,0,0.00000000000000000000
chr19,34431599,34432633,1034,-1,0,,0,0.00000000000000000000
chr19,34727580,34730629,3049,-1,0,,0,0.00000000000000000000
chr19,34972272,34973707,1435,-1,0,126374,1,69.68641114982580000000
chr19,35140569,35150877,10308,-1,0,,0,0.00000000000000000000
chr19,35119146,35121634,2488,-1,0,,0,0.00000000000000000000
chr19,35247996,35248513,517,-1,0,,0,0.00000000000000000000
chr19,35308976,35309710,734,-1,0,,0,0.00000000000000000000
chr19,35315906,35363056,47150,-1,0,,0,0.00000000000000000000
chr19,35339998,35342569,2571,-1,0,,0,0.00000000000000000000
chr19,35360462,35361362,900,-1,0,,0,0.00000000000000000000
chr19,35660084,35666391,6307,-1,0,53827,1,15.85539876327890000000
chr19,35662135,35665225,3090,-1,0,,0,0.00000000000000000000
chr19,35663843,35666034,2191,-1,0,,0,0.00000000000000000000
chr19,35721472,35724570,3098,-1,0,,0,0.00000000000000000000
chr19,35743984,35753963,9979,-1,0,51599,1,10.02104419280490000000
chr19,35758040,35761056,3016,-1,0,51599;7392,2,66.31299734748010000000
chr19,35758933,35760371,1438,-1,0,7392,1,69.54102920723230000000
chr19,35849489,35866415,16926,-1,0,2865,1,5.90807042419946000000
chr19,35855429,35867014,11585,-1,0,,0,0.00000000000000000000
chr19,35852720,35861883,9163,-1,0,,0,0.00000000000000000000
chr19,35851533,35853295,1762,-1,0,,0,0.00000000000000000000
chr19,35861507,35863175,1668,-1,0,,0,0.00000000000000000000
chr19,36002371,36002421,50,-1,0,93099,1,2000.00000000000000000000
chr19,36152157,36160269,8112,-1,0,11045,1,12.32741617357000000000
chr19,36653814,36654153,339,-1,0,,0,0.00000000000000000000
chr19,36662672,36662971,299,-1,0,,0,0.00000000000000000000
chr19,36662693,36662964,271,-1,0,,0,0.00000000000000000000
chr19,36749133,36841460,92327,-1,0,57677,1,1.08310678349778000000
chr19,36759046,36801846,42800,-1,0,,0,0.00000000000000000000
chr19,36806489,36849488,42999,-1,0,57677,1,2.32563547989488000000
chr19,36830398,36846911,16513,-1,0,57677,1,6.05583479682674000000
chr19,36840250,36851177,10927,-1,0,57677,1,9.15164271986822000000
chr19,36839827,36847083,7256,-1,0,57677,1,13.78169790518190000000
chr19,36845796,36847373,1577,-1,0,57677,1,63.41154090044390000000
chr19,37025505,37054365,28860,-1,0,57711,1,3.46500346500346000000
chr19,36957830,36960300,2470,-1,0,84924,1,40.48582995951420000000
chr19,37219385,37220034,649,-1,0,,0,0.00000000000000000000
chr19,37046069,37046623,554,-1,0,57711,1,180.50541516245500000000
chr19,37284237,37284715,478,-1,0,,0,0.00000000000000000000
chr19,37463239,37463700,461,-1,0,374900,1,216.91973969631200000000
chr19,37460715,37461279,564,-1,0,374900,1,177.30496453900700000000
chr19,37284307,37284632,325,-1,0,,0,0.00000000000000000000
chr19,37046181,37046497,316,-1,0,57711,1,316.45569620253200000000
chr19,37463427,37463508,81,-1,0,374900,1,1234.56790123457000000000
chr19,37741355,37808953,67598,-1,0,284459,1,1.47933370809787000000
chr19,37735944,37737478,1534,-1,0,,0,0.00000000000000000000
chr19,37856489,37859808,3319,-1,0,,0,0.00000000000000000000
chr19,38007108,38017750,10642,-1,0,390927,1,9.39672993798158000000
chr19,37969406,37970101,695,-1,0,148268,1,143.88489208633100000000
chr19,38054592,38054639,47,-1,0,163255,1,2127.65957446808000000000
chr19,38259770,38312751,52981,-1,0,126231,1,1.88746909269361000000
chr19,38341180,38345773,4593,-1,0,,0,0.00000000000000000000
chr19,38341552,38345358,3806,-1,0,,0,0.00000000000000000000
chr19,38274458,38277850,3392,-1,0,,0,0.00000000000000000000
chr19,38343838,38344871,1033,-1,0,,0,0.00000000000000000000
chr19,38677384,38679340,1956,-1,0,23094,1,51.12474437627810000000
chr19,38926600,38929903,3303,-1,0,6261,1,30.27550711474420000000
chr19,38990064,38990131,67,-1,0,6261,1,1492.53731343284000000000
chr19,39234019,39234238,219,-1,0,147968,1,456.62100456621000000000
chr19,39393079,39393379,300,-1,0,4793,1,333.33333333333300000000
chr19,39458761,39505939,47178,-1,0,115290,1,2.11963203187927000000
chr19,39465849,39485572,19723,-1,0,115290,1,5.07022258277138000000
chr19,39470645,39471936,1291,-1,0,,0,0.00000000000000000000
chr19,39533285,39541768,8483,-1,0,,0,0.00000000000000000000
chr19,39610381,39611191,810,-1,0,,0,0.00000000000000000000
chr19,39616495,39617340,845,-1,0,10298,1,118.34319526627200000000
chr19,39637516,39637935,419,-1,0,10298,1,238.66348448687400000000
chr19,39688253,39690221,1968,-1,0,342897,1,50.81300813008130000000
chr19,39676277,39677743,1466,-1,0,,0,0.00000000000000000000
chr19,39718775,39719579,804,-1,0,,0,0.00000000000000000000
chr19,40019489,40027856,8367,-1,0,126272,1,11.95171507111270000000
chr19,40127289,40184184,56895,-1,0,148003,1,1.75762369276738000000
chr19,40263693,40265065,1372,-1,0,,0,0.00000000000000000000
chr19,40257544,40257851,307,-1,0,,0,0.00000000000000000000
chr19,40369266,40398911,29645,-1,0,8857,1,3.37325012649688000000
chr19,40368971,40385636,16665,-1,0,8857,1,6.00060006000600000000
chr19,40389017,40405083,16066,-1,0,8857,1,6.22432466077431000000
chr19,40385410,40386050,640,-1,0,8857,1,156.25000000000000000000
chr19,40464308,40464881,573,-1,0,,0,0.00000000000000000000
chr19,40612903,40616066,3163,-1,0,,0,0.00000000000000000000
chr19,40623079,40625311,2232,-1,0,,0,0.00000000000000000000
chr19,40665317,40666336,1019,-1,0,,0,0.00000000000000000000
chr19,40861281,40864235,2954,-1,0,23646,1,33.85240352065000000000
chr19,40982574,40983930,1356,-1,0,57731,1,73.74631268436580000000
chr19,40987571,40991012,3441,-1,0,57731,1,29.06131938390000000000
chr19,41153257,41156004,2747,-1,0,,0,0.00000000000000000000
chr19,41388799,41534441,145642,-1,0,1555,1,0.68661512475796800000
chr19,41449254,41508939,59685,-1,0,1555,1,1.67546284661138000000
chr19,41339430,41394961,55531,-1,0,1548;1549,2,3.60159190362140000000
chr19,41360605,41392420,31815,-1,0,1549,1,3.14317146000314000000
chr19,41338507,41370564,32057,-1,0,1548,1,3.11944349128116000000
chr19,41353917,41373728,19811,-1,0,1548,1,5.04770077229822000000
chr19,41363305,41380724,17419,-1,0,,0,0.00000000000000000000
chr19,41353738,41365220,11482,-1,0,1548,1,8.70928409684724000000
chr19,41360170,41370924,10754,-1,0,,0,0.00000000000000000000
chr19,41379148,41384099,4951,-1,0,1549,1,20.19793981013940000000
chr19,41608705,41610196,1491,-1,0,,0,0.00000000000000000000
chr19,41680257,41680997,740,-1,0,,0,0.00000000000000000000
chr19,41691901,41697468,5567,-1,0,,0,0.00000000000000000000
chr19,41745318,41748314,2996,-1,0,558,1,33.37783711615490000000
chr19,41971030,42029465,58435,-1,0,,0,0.00000000000000000000
chr19,41961990,42007691,45701,-1,0,,0,0.00000000000000000000
chr19,41982121,42007150,25029,-1,0,,0,0.00000000000000000000
chr19,42008279,42030545,22266,-1,0,,0,0.00000000000000000000
chr19,42059245,42062148,2903,-1,0,90273,1,34.44712366517400000000
chr19,42060717,42063371,2654,-1,0,90273,1,37.67897513187640000000
chr19,42117113,42119243,2130,-1,0,,0,0.00000000000000000000
chr19,42168540,42169010,470,-1,0,,0,0.00000000000000000000
chr19,42129052,42129382,330,-1,0,1089,1,303.03030303030300000000
chr19,42308799,42320078,11279,-1,0,1084,1,8.86603422289210000000
chr19,42400536,42401319,783,-1,0,9138,1,127.71392081736900000000
chr19,42398621,42399291,670,-1,0,9138,1,149.25373134328400000000
chr19,42418514,42419140,626,-1,0,,0,0.00000000000000000000
chr19,42400705,42401137,432,-1,0,9138,1,231.48148148148100000000
chr19,42398826,42399283,457,-1,0,9138,1,218.81838074398200000000
chr19,42418714,42419088,374,-1,0,,0,0.00000000000000000000
chr19,42400705,42401023,318,-1,0,9138,1,314.46540880503100000000
chr19,42418674,42418967,293,-1,0,,0,0.00000000000000000000
chr19,42398805,42398982,177,-1,0,9138,1,564.97175141242900000000
chr19,42547737,42554172,6435,-1,0,2901,1,15.54001554001550000000
chr19,43034588,43038068,3480,-1,0,,0,0.00000000000000000000
chr19,43288263,43787404,499141,-1,0,5670;5676;5678;5680;5669;5672;5673;5675,8,1.60275353056551000000
chr19,43283990,43557197,273207,-1,0,5676;5680;5669;5675,4,1.46409133001717000000
chr19,43489481,43745512,256031,-1,0,5672;5670;5673;5680,4,1.56231081392488000000
chr19,43441373,43629951,188578,-1,0,5670;5680,2,1.06056910137980000000
chr19,43600139,43807334,207195,-1,0,5672;5678;5673,3,1.44791138782307000000
chr19,43575509,43724492,148983,-1,0,5672;5670;5673,3,2.01365256438654000000
chr19,43329885,43506863,176978,-1,0,5676;5669;5675,3,1.69512594785793000000
chr19,43283626,43448116,164490,-1,0,5676;5669;5675,3,1.82381907714755000000
chr19,43496940,43644129,147189,-1,0,5670;5680,2,1.35879719272500000000
chr19,43446594,43544377,97783,-1,0,5680,1,1.02267265271059000000
chr19,43748178,43854897,106719,-1,0,5678,1,0.93704026462017100000
chr19,43644231,43744190,99959,-1,0,5672;5673,2,2.00082033633790000000
chr19,43563888,43667496,103608,-1,0,5670,1,0.96517643425218100000
chr19,43280535,43360372,79837,-1,0,,0,0.00000000000000000000
chr19,43356216,43422852,66636,-1,0,5669;5675,2,3.00138063509214000000
chr19,43455594,43546557,90963,-1,0,5680,1,1.09934808658466000000
chr19,43700746,43765066,64320,-1,0,5672;5678,2,3.10945273631841000000
chr19,43800595,43845040,44445,-1,0,,0,0.00000000000000000000
chr19,43543962,43602789,58827,-1,0,5670,1,1.69989970591735000000
chr19,43604102,43661978,57876,-1,0,,0,0.00000000000000000000
chr19,43726856,43789259,62403,-1,0,5678,1,1.60248705991699000000
chr19,43646591,43696083,49492,-1,0,5673,1,2.02052857027398000000
chr19,43699744,43738916,39172,-1,0,5672,1,2.55284386806903000000
chr19,43360871,43402844,41973,-1,0,5669,1,2.38248397779525000000
chr19,43505313,43547211,41898,-1,0,5680,1,2.38674877082438000000
chr19,43714962,43754406,39444,-1,0,,0,0.00000000000000000000
chr19,43823153,43844375,21222,-1,0,,0,0.00000000000000000000
chr19,43423637,43447093,23456,-1,0,5676,1,4.26330150068213000000
chr19,43239579,43265183,25604,-1,0,440533;5671,2,7.81127948758007000000
chr19,43689483,43710472,20989,-1,0,5672;5673,2,9.52880080041927000000
chr19,43414627,43433590,18963,-1,0,5676;5675,2,10.54685440067500000000
chr19,43702545,43712084,9539,-1,0,5672,1,10.48327916972430000000
chr19,43709211,43715794,6583,-1,0,5672,1,15.19064256418050000000
chr19,43488189,43492306,4117,-1,0,,0,0.00000000000000000000
chr19,43440060,43441585,1525,-1,0,5676,1,65.57377049180330000000
chr19,43167352,43167931,579,-1,0,,0,0.00000000000000000000
chr19,43916978,43953434,36456,-1,0,83639,1,2.74303269694975000000
chr19,43981375,43981983,608,-1,0,653583,1,164.47368421052600000000
chr19,44502010,44502414,404,-1,0,7711,1,247.52475247524800000000
chr19,44645562,44645616,54,-1,0,,0,0.00000000000000000000
chr19,44890279,44938973,48694,-1,0,7772;26974,2,4.10728221136074000000
chr19,44892380,44913200,20820,-1,0,26974,1,4.80307396733910000000
chr19,44957859,44964253,6394,-1,0,,0,0.00000000000000000000
chr19,44881951,44882510,559,-1,0,,0,0.00000000000000000000
chr19,45062479,45062583,104,-1,0,,0,0.00000000000000000000
chr19,45110038,45113535,3497,-1,0,,0,0.00000000000000000000
chr19,45473124,45474247,1123,-1,0,1209,1,89.04719501335710000000
chr19,45675270,45676634,1364,-1,0,79090,1,73.31378299120230000000
chr19,45728550,45730078,1528,-1,0,90332,1,65.44502617801050000000
chr19,45902386,45904275,1889,-1,0,10848,1,52.93806246691370000000
chr19,45904011,45904407,396,-1,0,10848,1,252.52525252525300000000
chr19,45960752,45961678,926,-1,0,,0,0.00000000000000000000
chr19,46036285,46038060,1775,-1,0,80207,1,56.33802816901410000000
chr19,46097789,46098295,506,-1,0,2828,1,197.62845849802400000000
chr19,46097990,46098127,137,-1,0,2828,1,729.92700729927000000000
chr19,46273463,46273516,53,-1,0,1760,1,1886.79245283019000000000
chr19,46278276,46280099,1823,-1,0,1760,1,54.85463521667580000000
chr19,46278622,46279603,981,-1,0,1760,1,101.93679918450600000000
chr19,46314912,46316827,1915,-1,0,81492,1,52.21932114882510000000
chr19,46555769,46567907,12138,-1,0,,0,0.00000000000000000000
chr19,46622342,46628475,6133,-1,0,388555,1,16.30523398010760000000
chr19,46764010,46785557,21547,-1,0,,0,0.00000000000000000000
chr19,46794651,46795450,799,-1,0,,0,0.00000000000000000000
chr19,46796801,46797133,332,-1,0,,0,0.00000000000000000000
chr19,46817358,46818734,1376,-1,0,64344,1,72.67441860465120000000
chr19,46941692,46944770,3078,-1,0,,0,0.00000000000000000000
chr19,46957030,46963124,6094,-1,0,,0,0.00000000000000000000
chr19,46956069,46956493,424,-1,0,,0,0.00000000000000000000
chr19,47169991,47174794,4803,-1,0,,0,0.00000000000000000000
chr19,47265378,47269123,3745,-1,0,,0,0.00000000000000000000
chr19,47338687,47340516,1829,-1,0,,0,0.00000000000000000000
chr19,47377130,47379890,2760,-1,0,,0,0.00000000000000000000
chr19,47528253,47528722,469,-1,0,4861,1,213.21961620469100000000
chr19,47650561,47652118,1557,-1,0,10055,1,64.22607578676940000000
chr19,47732595,47735722,3127,-1,0,27113,1,31.97953309881680000000
chr19,47798306,47803274,4968,-1,0,,0,0.00000000000000000000
chr19,47993540,47993941,401,-1,0,8775,1,249.37655860349100000000
chr19,48098781,48104514,5733,-1,0,,0,0.00000000000000000000
chr19,48104411,48106644,2233,-1,0,,0,0.00000000000000000000
chr19,48189896,48193388,3492,-1,0,29998,1,28.63688430698740000000
chr19,48271004,48278220,7216,-1,0,,0,0.00000000000000000000
chr19,48406603,48463684,57081,-1,0,,0,0.00000000000000000000
chr19,50593024,50641908,48884,-1,0,,0,0.00000000000000000000
chr19,49532734,49556592,23858,-1,0,114335;94115;93659;114336,4,16.76586469947190000000
chr19,49183571,49206532,22961,-1,0,2524,1,4.35521100997343000000
chr19,48382885,48402331,19446,-1,0,6822,1,5.14244574719737000000
chr19,50448685,50458591,9906,-1,0,114132,1,10.09489198465580000000
chr19,49202152,49211853,9701,-1,0,2524,1,10.30821564787140000000
chr19,48304160,48313789,9629,-1,0,284355,1,10.38529442309690000000
chr19,48558756,48566540,7784,-1,0,8605,1,12.84686536485100000000
chr19,50554478,50561364,6886,-1,0,,0,0.00000000000000000000
chr19,49203500,49207841,4341,-1,0,2524,1,23.03616678184750000000
chr19,49552604,49559326,6722,-1,0,94027,1,14.87652484379650000000
chr19,48752407,48758402,5995,-1,0,22900,1,16.68056713928270000000
chr19,50555528,50559680,4152,-1,0,,0,0.00000000000000000000
chr19,49051514,49054294,2780,-1,0,,0,0.00000000000000000000
chr19,49729675,49731913,2238,-1,0,,0,0.00000000000000000000
chr19,50445608,50447323,1715,-1,0,,0,0.00000000000000000000
chr19,49337525,49338903,1378,-1,0,51171,1,72.56894049346880000000
chr19,48372721,48374261,1540,-1,0,6822,1,64.93506493506490000000
chr19,49264543,49265845,1302,-1,0,,0,0.00000000000000000000
chr19,48826487,48827751,1264,-1,0,,0,0.00000000000000000000
chr19,50007091,50008296,1205,-1,0,,0,0.00000000000000000000
chr19,48856503,48857293,790,-1,0,55260,1,126.58227848101300000000
chr19,49460172,49460778,606,-1,0,581,1,165.01650165016500000000
chr19,50368836,50369535,699,-1,0,11284,1,143.06151645207400000000
chr19,49966108,49966833,725,-1,0,126133,1,137.93103448275900000000
chr19,49717417,49717875,458,-1,0,,0,0.00000000000000000000
chr19,49514954,49515262,308,-1,0,10856,1,324.67532467532500000000
chr19,49172523,49172872,349,-1,0,126147,1,286.53295128939800000000
chr19,49581921,49582294,373,-1,0,,0,0.00000000000000000000
chr19,49889474,49889799,325,-1,0,,0,0.00000000000000000000
chr19,49529793,49530099,306,-1,0,,0,0.00000000000000000000
chr19,48494861,48495081,220,-1,0,100131137,1,454.54545454545500000000
chr19,49947423,49947596,173,-1,0,,0,0.00000000000000000000
chr19,49947386,49947531,145,-1,0,,0,0.00000000000000000000
chr19,48983056,48983182,126,-1,0,9266,1,793.65079365079400000000
chr19,48845603,48845662,59,-1,0,55260,1,1694.91525423729000000000
chr19,51112896,51120748,7852,-1,0,,0,0.00000000000000000000
chr19,51077978,51084761,6783,-1,0,,0,0.00000000000000000000
chr19,51106142,51110419,4277,-1,0,,0,0.00000000000000000000
chr19,51077886,51082505,4619,-1,0,,0,0.00000000000000000000
chr19,51078063,51081110,3047,-1,0,,0,0.00000000000000000000
chr19,51086592,51088805,2213,-1,0,,0,0.00000000000000000000
chr19,51128850,51129258,408,-1,0,84258,1,245.09803921568600000000
chr19,51262537,51274635,12098,-1,0,2854,1,8.26582906265498000000
chr19,51255913,51266933,11020,-1,0,,0,0.00000000000000000000
chr19,51330397,51333916,3519,-1,0,55554,1,28.41716396703610000000
chr19,51342235,51342357,122,-1,0,,0,0.00000000000000000000
chr19,51406745,51408334,1589,-1,0,,0,0.00000000000000000000
chr19,51416813,51417948,1135,-1,0,,0,0.00000000000000000000
chr19,51457398,51457902,504,-1,0,,0,0.00000000000000000000
chr19,51508745,51511048,2303,-1,0,284366,1,43.42162396873640000000
chr19,51545348,51547416,2068,-1,0,,0,0.00000000000000000000
chr19,51548197,51548732,535,-1,0,,0,0.00000000000000000000
chr19,51682524,51682967,443,-1,0,,0,0.00000000000000000000
chr19,51776406,51776719,313,-1,0,,0,0.00000000000000000000
chr19,52131840,52154411,22571,-1,0,8778;100049587,2,8.86092773913429000000
chr19,52142607,52155878,13271,-1,0,100049587,1,7.53522718709969000000
chr19,52133990,52147697,13707,-1,0,100049587,1,7.29554242357919000000
chr19,52141849,52150046,8197,-1,0,100049587,1,12.19958521410270000000
chr19,52175764,52177683,1919,-1,0,,0,0.00000000000000000000
chr19,52190856,52210470,19614,-1,0,147650,1,5.09839910268176000000
chr19,52479187,52479596,409,-1,0,59348,1,244.49877750611200000000
chr19,52762681,52771537,8856,-1,0,,0,0.00000000000000000000
chr19,53215240,53334170,118930,-1,0,7576;81856;162966,3,2.52249222231565000000
chr19,52894448,52984431,89983,-1,0,84436;147658;147660,3,3.33396308191547000000
chr19,54726934,54824039,97105,-1,0,11025;10990;10288,3,3.08943926677308000000
chr19,53281731,53373971,92240,-1,0,7576;90333;162966,3,3.25238508239376000000
chr19,53072732,53160325,87593,-1,0,55769;55762,2,2.28328747730983000000
chr19,53932444,54005774,73330,-1,0,126017;388561,2,2.72739669984999000000
chr19,53879233,53950027,70794,-1,0,170958;388561;91661,3,4.23764725824222000000
chr19,53201631,53263474,61843,-1,0,81856,1,1.61699788173277000000
chr19,53277450,53334601,57151,-1,0,7576;162966,2,3.49950132106175000000
chr19,52893418,52933461,40043,-1,0,84436,1,2.49731538596009000000
chr19,53321671,53356686,35015,-1,0,7576;90333,2,5.71183778380694000000
chr19,53915915,53962206,46291,-1,0,388561,1,2.16024713227193000000
chr19,54726264,54760214,33950,-1,0,11025;10990,2,5.89101620029455000000
chr19,53517256,53553889,36633,-1,0,100271846;147664,2,5.45955832173177000000
chr19,53939389,53976651,37262,-1,0,126017;388561,2,5.36739842198486000000
chr19,53339026,53368392,29366,-1,0,90333,1,3.40529864469114000000
chr19,54847017,54879626,32609,-1,0,3903;23547,2,6.13327608942317000000
chr19,54229892,54255335,25443,-1,0,,0,0.00000000000000000000
chr19,53602352,53632172,29820,-1,0,90338;55786,2,6.70690811535882000000
chr19,54723568,54746499,22931,-1,0,11025,1,4.36090881339671000000
chr19,54759332,54782729,23397,-1,0,10288;10990,2,8.54810445783647000000
chr19,53732590,53756120,23530,-1,0,342926,1,4.24989375265618000000
chr19,54744564,54764752,20188,-1,0,11025;10990,2,9.90687537150783000000
chr19,54730124,54751615,21491,-1,0,11025,1,4.65311060443907000000
chr19,54782935,54801895,18960,-1,0,10288,1,5.27426160337553000000
chr19,53142837,53160012,17175,-1,0,55769,1,5.82241630276565000000
chr19,54797935,54809008,11073,-1,0,,0,0.00000000000000000000
chr19,53537411,53553720,16309,-1,0,100271846,1,6.13158378809246000000
chr19,54481401,54497300,15899,-1,0,59283;59285,2,12.57940750990630000000
chr19,54355989,54369595,13606,-1,0,91663,1,7.34969866235484000000
chr19,54800465,54807635,7170,-1,0,,0,0.00000000000000000000
chr19,54421164,54429157,7993,-1,0,59284,1,12.51094707869390000000
chr19,53313368,53320777,7409,-1,0,7576,1,13.49709812390340000000
chr19,54555031,54562006,6975,-1,0,284415,1,14.33691756272400000000
chr19,52889123,52895525,6402,-1,0,,0,0.00000000000000000000
chr19,53799475,53805425,5950,-1,0,,0,0.00000000000000000000
chr19,54461155,54466879,5724,-1,0,59283,1,17.47030048916840000000
chr19,53688142,53693152,5010,-1,0,79788,1,19.96007984031940000000
chr19,54800638,54805580,4942,-1,0,,0,0.00000000000000000000
chr19,53316502,53320241,3739,-1,0,7576,1,26.74511901577960000000
chr19,53734257,53738543,4286,-1,0,,0,0.00000000000000000000
chr19,52888652,52891773,3121,-1,0,400713,1,32.04101249599490000000
chr19,54737188,54739707,2519,-1,0,11025,1,39.69829297340210000000
chr19,53081843,53083690,1847,-1,0,55762,1,54.14185165132650000000
chr19,53095967,53097721,1754,-1,0,,0,0.00000000000000000000
chr19,54815188,54817631,2443,-1,0,,0,0.00000000000000000000
chr19,53422194,53424196,2002,-1,0,,0,0.00000000000000000000
chr19,54810486,54811699,1213,-1,0,,0,0.00000000000000000000
chr19,53504795,53506478,1683,-1,0,,0,0.00000000000000000000
chr19,54110921,54112556,1635,-1,0,,0,0.00000000000000000000
chr19,54736796,54738390,1594,-1,0,11025,1,62.73525721455460000000
chr19,53180737,53182285,1548,-1,0,55769,1,64.59948320413440000000
chr19,54180170,54181632,1462,-1,0,,0,0.00000000000000000000
chr19,53082248,53083450,1202,-1,0,55762,1,83.19467554076540000000
chr19,54295870,54297034,1164,-1,0,91662,1,85.91065292096220000000
chr19,53558135,53558990,855,-1,0,,0,0.00000000000000000000
chr19,53083872,53084486,614,-1,0,55762,1,162.86644951140100000000
chr19,54810732,54811514,782,-1,0,,0,0.00000000000000000000
chr19,54860941,54861597,656,-1,0,,0,0.00000000000000000000
chr19,52896546,52897323,777,-1,0,,0,0.00000000000000000000
chr19,54737176,54737863,687,-1,0,11025,1,145.56040756914100000000
chr19,53116745,53117222,477,-1,0,55769,1,209.64360587002100000000
chr19,54855959,54856679,720,-1,0,,0,0.00000000000000000000
chr19,53820693,53821204,511,-1,0,,0,0.00000000000000000000
chr19,53477142,53477710,568,-1,0,,0,0.00000000000000000000
chr19,52948795,52949343,548,-1,0,147658,1,182.48175182481800000000
chr19,53616472,53616904,432,-1,0,55786,1,231.48148148148100000000
chr19,53872634,53873137,503,-1,0,170958,1,198.80715705765400000000
chr19,53323245,53323699,454,-1,0,7576,1,220.26431718061700000000
chr19,53820789,53821104,315,-1,0,,0,0.00000000000000000000
chr19,53616464,53616782,318,-1,0,55786,1,314.46540880503100000000
chr19,54245984,54246192,208,-1,0,,0,0.00000000000000000000
chr19,54383493,54383728,235,-1,0,,0,0.00000000000000000000
chr19,53084110,53084246,136,-1,0,55762,1,735.29411764705900000000
chr19,54675994,54676170,176,-1,0,147798,1,568.18181818181800000000
chr19,52948968,52949075,107,-1,0,147658,1,934.57943925233600000000
chr19,53084148,53084268,120,-1,0,55762,1,833.33333333333300000000
chr19,53116909,53117008,99,-1,0,55769,1,1010.10101010101000000000
chr19,54887338,54888354,1016,-1,0,,0,0.00000000000000000000
chr19,54896067,54897541,1474,-1,0,,0,0.00000000000000000000
chr19,54896004,54896400,396,-1,0,,0,0.00000000000000000000
chr19,54925215,54925384,169,-1,0,,0,0.00000000000000000000
chr19,54983688,55605648,621960,-1,0,2204;3811;3805;3812;9437;3802;55655;11024;51206;3809;11006;54869;115653;10859;54776;148170;11027;112724;3904;199713;3804,21,3.37642292108817000000
chr19,55250151,55361432,111281,-1,0,3811;3805;3809;3802;3804,5,4.49313000422354000000
chr19,55253132,55327366,74234,-1,0,3805;3802;3804,3,4.04127488751785000000
chr19,55291193,55356362,65169,-1,0,3809;3811;3802;3805,4,6.13788764596664000000
chr19,55486915,55539037,52122,-1,0,51206;55655,2,3.83715129887571000000
chr19,55249328,55290329,41001,-1,0,3802;3804,2,4.87792980659008000000
chr19,55287942,55340014,52072,-1,0,3811;3802;3805,3,5.76125364879398000000
chr19,55322214,55371897,49683,-1,0,3809;3811;3805;3812,4,8.05104361652879000000
chr19,55304879,55338419,33540,-1,0,3811;3805,2,5.96302921884317000000
chr19,55342389,55378806,36417,-1,0,3809;3812,2,5.49194057720295000000
chr19,55146386,55175107,28721,-1,0,11006;10859,2,6.96354583754048000000
chr19,55250228,55270954,20726,-1,0,3804,1,4.82485766669883000000
chr19,55302798,55327387,24589,-1,0,3805,1,4.06685916466713000000
chr19,55266311,55280805,14494,-1,0,,0,0.00000000000000000000
chr19,55327027,55343670,16643,-1,0,3811,1,6.00853211560416000000
chr19,55358669,55377182,18513,-1,0,3809;3812,2,10.80321935936910000000
chr19,55544218,55561455,17237,-1,0,112724;51206,2,11.60294714857570000000
chr19,55338840,55355314,16474,-1,0,3809;3811,2,12.14034235765450000000
chr19,55283801,55298725,14924,-1,0,3802,1,6.70061645671402000000
chr19,55272050,55286717,14667,-1,0,3802,1,6.81802686302584000000
chr19,55347701,55356300,8599,-1,0,3809,1,11.62925921618790000000
chr19,55577274,55584629,7355,-1,0,112724,1,13.59619306594150000000
chr19,55472109,55474298,2189,-1,0,,0,0.00000000000000000000
chr19,55470568,55472049,1481,-1,0,,0,0.00000000000000000000
chr19,55476234,55477885,1651,-1,0,55655,1,60.56935190793460000000
chr19,55344415,55345835,1420,-1,0,3809,1,70.42253521126760000000
chr19,55576035,55577280,1245,-1,0,112724,1,80.32128514056230000000
chr19,55544204,55544925,721,-1,0,51206,1,138.69625520111000000000
chr19,55344978,55345919,941,-1,0,3809,1,106.26992561105200000000
chr19,55203988,55204683,695,-1,0,,0,0.00000000000000000000
chr19,55589613,55590258,645,-1,0,54869,1,155.03875968992200000000
chr19,55203860,55204315,455,-1,0,,0,0.00000000000000000000
chr19,55001564,55002049,485,-1,0,,0,0.00000000000000000000
chr19,55465260,55465832,572,-1,0,,0,0.00000000000000000000
chr19,55194104,55194485,381,-1,0,,0,0.00000000000000000000
chr19,55486615,55487000,385,-1,0,55655,1,259.74025974026000000000
chr19,55001746,55002059,313,-1,0,,0,0.00000000000000000000
chr19,55345827,55346068,241,-1,0,3809,1,414.93775933610000000000
chr19,55192029,55192107,78,-1,0,,0,0.00000000000000000000
chr19,55607935,55609443,1508,-1,0,54776,1,66.31299734748010000000
chr19,55608114,55608498,384,-1,0,54776,1,260.41666666666700000000
chr19,55608883,55609019,136,-1,0,54776,1,735.29411764705900000000
chr19,55636993,55637597,604,-1,0,,0,0.00000000000000000000
chr19,55714235,55717429,3194,-1,0,5794,1,31.30870381966190000000
chr19,55908795,55910590,1795,-1,0,,0,0.00000000000000000000
chr19,56016339,56017747,1408,-1,0,284297,1,71.02272727272730000000
chr19,56077042,56077888,846,-1,0,,0,0.00000000000000000000
chr19,56038825,56039426,601,-1,0,,0,0.00000000000000000000
chr19,55961443,55961896,453,-1,0,,0,0.00000000000000000000
chr19,56041805,56042201,396,-1,0,646643,1,252.52525252525300000000
chr19,56019911,56020319,408,-1,0,284297,1,245.09803921568600000000
chr19,55872861,55873151,290,-1,0,284418,1,344.82758620689700000000
chr19,56020054,56020324,270,-1,0,284297,1,370.37037037037000000000
chr19,55872982,55873203,221,-1,0,284418,1,452.48868778280500000000
chr19,56029174,56029354,180,-1,0,284297,1,555.55555555555600000000
chr19,56020022,56020170,148,-1,0,284297,1,675.67567567567600000000
chr19,56267454,56286745,19291,-1,0,342931;729974,2,10.36752889948680000000
chr19,56268271,56284530,16259,-1,0,342931;729974,2,12.30087951288520000000
chr19,56260289,56262153,1864,-1,0,,0,0.00000000000000000000
chr19,56308083,56309417,1334,-1,0,204801,1,74.96251874062970000000
chr19,56361216,56363225,2009,-1,0,147945,1,49.77600796416130000000
chr19,56495750,56496067,317,-1,0,126205,1,315.45741324921100000000
chr19,56518162,56519604,1442,-1,0,126206,1,69.34812760055480000000
chr19,56577137,56592830,15693,-1,0,,0,0.00000000000000000000
chr19,56591214,56592013,799,-1,0,,0,0.00000000000000000000
chr19,56580772,56581206,434,-1,0,,0,0.00000000000000000000
chr19,56591353,56591557,204,-1,0,,0,0.00000000000000000000
chr19,56580944,56580994,50,-1,0,,0,0.00000000000000000000
chr19,56609755,56610320,565,-1,0,126208,1,176.99115044247800000000
chr19,56711354,56746581,35227,-1,0,79149,1,2.83873165469668000000
chr19,56697501,56729117,31616,-1,0,342933,1,3.16295546558704000000
chr19,56713379,56722057,8678,-1,0,,0,0.00000000000000000000
chr19,56864679,56871684,7005,-1,0,79149,1,14.27551748750890000000
chr19,56855951,56865077,9126,-1,0,79149,1,10.95770326539560000000
chr19,56866454,56869924,3470,-1,0,79149,1,28.81844380403460000000
chr19,56867414,56869928,2514,-1,0,79149,1,39.77724741447890000000
chr19,56850426,56851429,1003,-1,0,79149,1,99.70089730807580000000
chr19,56850717,56851241,524,-1,0,79149,1,190.83969465648900000000
chr19,56850602,56850873,271,-1,0,79149,1,369.00369003690000000000
chr19,57111515,57111889,374,-1,0,58491,1,267.37967914438500000000
chr19,57160845,57170121,9276,-1,0,147670,1,10.78050884001720000000
chr19,57180911,57181459,548,-1,0,90485,1,182.48175182481800000000
chr19,57202751,57212221,9470,-1,0,,0,0.00000000000000000000
chr19,57284023,57284225,202,-1,0,,0,0.00000000000000000000
chr19,57471897,57480548,8651,-1,0,,0,0.00000000000000000000
chr19,57473775,57478794,5019,-1,0,,0,0.00000000000000000000
chr19,57474507,57476163,1656,-1,0,,0,0.00000000000000000000
chr19,57479666,57480736,1070,-1,0,,0,0.00000000000000000000
chr19,57474871,57475609,738,-1,0,,0,0.00000000000000000000
chr19,57615740,57619015,3275,-1,0,,0,0.00000000000000000000
chr19,57649185,57649513,328,-1,0,114026,1,304.87804878048800000000
chr19,57706876,57714288,7412,-1,0,9422,1,13.49163518618460000000
chr19,57737308,57738864,1556,-1,0,,0,0.00000000000000000000
chr19,57752785,57753229,444,-1,0,390980,1,225.22522522522500000000
chr19,57777621,57779783,2162,-1,0,,0,0.00000000000000000000
chr19,57835666,57836488,822,-1,0,125919,1,121.65450121654500000000
chr19,58002160,58013638,11478,-1,0,374928;79744,2,17.42463843875240000000
chr19,58010786,58011016,230,-1,0,,0,0.00000000000000000000
chr19,58010837,58010963,126,-1,0,,0,0.00000000000000000000
chr19,58010916,58011002,86,-1,0,,0,0.00000000000000000000
chr19,58034306,58035179,873,-1,0,,0,0.00000000000000000000
chr19,58034592,58034820,228,-1,0,,0,0.00000000000000000000
chr19,58157938,58157985,47,-1,0,,0,0.00000000000000000000
chr19,58281503,58298147,16644,-1,0,54807,1,6.00817111271329000000
chr19,58385732,58386124,392,-1,0,730051,1,255.10204081632700000000
chr19,58537859,58543287,5428,-1,0,,0,0.00000000000000000000
chr19,58567935,58568059,124,-1,0,,0,0.00000000000000000000
chr19,58617737,58618205,468,-1,0,65982,1,213.67521367521400000000
chr19,58769728,58769969,241,-1,0,27300,1,414.93775933610000000000
chr19,58769842,58769947,105,-1,0,27300,1,952.38095238095300000000
chr19,58921907,58922149,242,-1,0,201514,1,413.22314049586800000000
chr19,59035053,59042266,7213,-1,0,84878,1,13.86385692499650000000
chr19,59050134,59054259,4125,-1,0,84878,1,24.24242424242420000000
chr19,59015771,59017727,1956,-1,0,10998,1,51.12474437627810000000
chr19,59096464,59096620,156,-1,0,,0,0.00000000000000000000
chr2,65385,245608,180223,-1,0,26751,1,0.55486813558757800000
chr2,112731,182675,69944,-1,0,,0,0.00000000000000000000
chr2,31520,34465,2945,-1,0,,0,0.00000000000000000000
chr2,168238,172498,4260,-1,0,,0,0.00000000000000000000
chr2,32150,34839,2689,-1,0,,0,0.00000000000000000000
chr2,33237,34461,1224,-1,0,,0,0.00000000000000000000
chr2,306387,309060,2673,-1,0,,0,0.00000000000000000000
chr2,306607,307599,992,-1,0,,0,0.00000000000000000000
chr2,388690,390417,1727,-1,0,,0,0.00000000000000000000
chr2,397857,401605,3748,-1,0,,0,0.00000000000000000000
chr2,398532,400814,2282,-1,0,,0,0.00000000000000000000
chr2,426524,427589,1065,-1,0,,0,0.00000000000000000000
chr2,449456,450838,1382,-1,0,,0,0.00000000000000000000
chr2,494882,495927,1045,-1,0,,0,0.00000000000000000000
chr2,495174,495813,639,-1,0,,0,0.00000000000000000000
chr2,547056,547589,533,-1,0,,0,0.00000000000000000000
chr2,671306,671863,557,-1,0,129787,1,179.53321364452400000000
chr2,731347,733689,2342,-1,0,,0,0.00000000000000000000
chr2,863794,865236,1442,-1,0,,0,0.00000000000000000000
chr2,739893,740907,1014,-1,0,,0,0.00000000000000000000
chr2,845190,846008,818,-1,0,,0,0.00000000000000000000
chr2,856585,857607,1022,-1,0,,0,0.00000000000000000000
chr2,732126,732937,811,-1,0,,0,0.00000000000000000000
chr2,859571,860099,528,-1,0,,0,0.00000000000000000000
chr2,740264,740699,435,-1,0,,0,0.00000000000000000000
chr2,856481,857057,576,-1,0,,0,0.00000000000000000000
chr2,725398,725801,403,-1,0,,0,0.00000000000000000000
chr2,859643,859914,271,-1,0,,0,0.00000000000000000000
chr2,725539,725623,84,-1,0,,0,0.00000000000000000000
chr2,905383,905919,536,-1,0,,0,0.00000000000000000000
chr2,908011,909620,1609,-1,0,,0,0.00000000000000000000
chr2,908543,909464,921,-1,0,,0,0.00000000000000000000
chr2,960758,961108,350,-1,0,54221,1,285.71428571428600000000
chr2,1008120,1010687,2567,-1,0,54221,1,38.95597974289050000000
chr2,1023296,1023523,227,-1,0,54221,1,440.52863436123400000000
chr2,1051801,1052600,799,-1,0,54221,1,125.15644555694600000000
chr2,1052412,1052576,164,-1,0,54221,1,609.75609756097600000000
chr2,1089593,1090756,1163,-1,0,54221,1,85.98452278589850000000
chr2,1089649,1090625,976,-1,0,54221,1,102.45901639344300000000
chr2,1089372,1089841,469,-1,0,54221,1,213.21961620469100000000
chr2,1101810,1104924,3114,-1,0,54221,1,32.11303789338470000000
chr2,1101573,1102249,676,-1,0,54221,1,147.92899408284000000000
chr2,1101699,1101986,287,-1,0,54221,1,348.43205574912900000000
chr2,1109232,1110070,838,-1,0,54221,1,119.33174224343700000000
chr2,1218633,1227160,8527,-1,0,54221,1,11.72745396974320000000
chr2,1217372,1218469,1097,-1,0,54221,1,91.15770282588880000000
chr2,1217306,1217944,638,-1,0,54221,1,156.73981191222600000000
chr2,1320197,1321856,1659,-1,0,54221,1,60.27727546714890000000
chr2,1320493,1321671,1178,-1,0,54221,1,84.88964346349740000000
chr2,1327081,1327571,490,-1,0,54221,1,204.08163265306100000000
chr2,1346119,1349828,3709,-1,0,54221,1,26.96144513345920000000
chr2,1357401,1359114,1713,-1,0,54221,1,58.37711617046120000000
chr2,1357939,1358540,601,-1,0,54221,1,166.38935108153100000000
chr2,1365251,1366831,1580,-1,0,54221,1,63.29113924050630000000
chr2,1428440,1429061,621,-1,0,7173,1,161.03059581320500000000
chr2,1428585,1428980,395,-1,0,7173,1,253.16455696202500000000
chr2,1436433,1436555,122,-1,0,7173,1,819.67213114754100000000
chr2,1460083,1461710,1627,-1,0,7173,1,61.46281499692690000000
chr2,1460425,1460984,559,-1,0,7173,1,178.89087656529500000000
chr2,1525738,1542403,16665,-1,0,7173,1,6.00060006000600000000
chr2,1534564,1541394,6830,-1,0,7173,1,14.64128843338210000000
chr2,1527888,1533368,5480,-1,0,7173,1,18.24817518248180000000
chr2,1533641,1538010,4369,-1,0,7173,1,22.88853284504460000000
chr2,1530948,1534506,3558,-1,0,7173,1,28.10567734682410000000
chr2,1537053,1540094,3041,-1,0,7173,1,32.88391976323580000000
chr2,1525543,1528420,2877,-1,0,7173,1,34.75842891901290000000
chr2,1533856,1536548,2692,-1,0,7173,1,37.14710252600300000000
chr2,1537961,1539903,1942,-1,0,7173,1,51.49330587023690000000
chr2,1536463,1538911,2448,-1,0,7173,1,40.84967320261440000000
chr2,1531164,1532668,1504,-1,0,7173,1,66.48936170212770000000
chr2,1534456,1535869,1413,-1,0,7173,1,70.77140835102620000000
chr2,1537854,1539293,1439,-1,0,7173,1,69.49270326615710000000
chr2,1535199,1536117,918,-1,0,7173,1,108.93246187363800000000
chr2,1526786,1527812,1026,-1,0,7173,1,97.46588693957110000000
chr2,1528294,1529096,802,-1,0,7173,1,124.68827930174600000000
chr2,1535163,1535817,654,-1,0,7173,1,152.90519877675800000000
chr2,1541638,1542080,442,-1,0,7173,1,226.24434389140300000000
chr2,1535168,1535583,415,-1,0,7173,1,240.96385542168700000000
chr2,1526017,1526201,184,-1,0,7173,1,543.47826086956500000000
chr2,1584433,1585780,1347,-1,0,,0,0.00000000000000000000
chr2,1584633,1585223,590,-1,0,,0,0.00000000000000000000
chr2,1599644,1601714,2070,-1,0,,0,0.00000000000000000000
chr2,1614286,1615887,1601,-1,0,,0,0.00000000000000000000
chr2,1604534,1605139,605,-1,0,,0,0.00000000000000000000
chr2,1614646,1615109,463,-1,0,,0,0.00000000000000000000
chr2,1622780,1623660,880,-1,0,,0,0.00000000000000000000
chr2,1622885,1623316,431,-1,0,,0,0.00000000000000000000
chr2,1623112,1623447,335,-1,0,,0,0.00000000000000000000
chr2,1623082,1623297,215,-1,0,,0,0.00000000000000000000
chr2,1625666,1626093,427,-1,0,,0,0.00000000000000000000
chr2,1625909,1626096,187,-1,0,,0,0.00000000000000000000
chr2,1641458,1641916,458,-1,0,7837,1,218.34061135371200000000
chr2,1642853,1642905,52,-1,0,7837,1,1923.07692307692000000000
chr2,1704901,1708900,3999,-1,0,7837,1,25.00625156289070000000
chr2,1706758,1708518,1760,-1,0,7837,1,56.81818181818180000000
chr2,1706558,1707451,893,-1,0,7837,1,111.98208286674100000000
chr2,1707279,1707926,647,-1,0,7837,1,154.55950540958300000000
chr2,1710228,1711205,977,-1,0,7837,1,102.35414534288600000000
chr2,1723674,1724102,428,-1,0,7837,1,233.64485981308400000000
chr2,1760604,1760999,395,-1,0,,0,0.00000000000000000000
chr2,1801653,1802002,349,-1,0,23040,1,286.53295128939800000000
chr2,1826530,1826587,57,-1,0,23040,1,1754.38596491228000000000
chr2,1968942,1969169,227,-1,0,23040,1,440.52863436123400000000
chr2,2038013,2040273,2260,-1,0,23040,1,44.24778761061950000000
chr2,2178326,2179485,1159,-1,0,23040,1,86.28127696289910000000
chr2,2189267,2189930,663,-1,0,23040,1,150.82956259426800000000
chr2,2189614,2190020,406,-1,0,23040,1,246.30541871921200000000
chr2,2496703,2497802,1099,-1,0,,0,0.00000000000000000000
chr2,2497028,2497543,515,-1,0,,0,0.00000000000000000000
chr2,2497207,2497367,160,-1,0,,0,0.00000000000000000000
chr2,2532305,2533593,1288,-1,0,,0,0.00000000000000000000
chr2,2583963,2584496,533,-1,0,,0,0.00000000000000000000
chr2,2584113,2584162,49,-1,0,,0,0.00000000000000000000
chr2,2627241,2628773,1532,-1,0,,0,0.00000000000000000000
chr2,2720324,2720679,355,-1,0,,0,0.00000000000000000000
chr2,2726048,2726803,755,-1,0,,0,0.00000000000000000000
chr2,2726295,2726531,236,-1,0,,0,0.00000000000000000000
chr2,2724966,2725063,97,-1,0,,0,0.00000000000000000000
chr2,2796311,2796980,669,-1,0,,0,0.00000000000000000000
chr2,2798692,2799274,582,-1,0,,0,0.00000000000000000000
chr2,2910356,2911079,723,-1,0,,0,0.00000000000000000000
chr2,2910346,2910492,146,-1,0,,0,0.00000000000000000000
chr2,3061331,3061762,431,-1,0,,0,0.00000000000000000000
chr2,3244068,3244849,781,-1,0,7260,1,128.04097311139600000000
chr2,3245849,3246284,435,-1,0,7260,1,229.88505747126400000000
chr2,3245912,3246135,223,-1,0,7260,1,448.43049327354300000000
chr2,3308245,3308435,190,-1,0,7260,1,526.31578947368400000000
chr2,3332558,3333124,566,-1,0,7260,1,176.67844522968200000000
chr2,3383922,3387065,3143,-1,0,51112,1,31.81673560292710000000
chr2,3440454,3442228,1774,-1,0,51112,1,56.36978579481400000000
chr2,3440653,3441413,760,-1,0,51112,1,131.57894736842100000000
chr2,3490348,3490780,432,-1,0,,0,0.00000000000000000000
chr2,3445723,3446098,375,-1,0,51112,1,266.66666666666700000000
chr2,3612669,3612826,157,-1,0,,0,0.00000000000000000000
chr2,3717509,3720327,2818,-1,0,55821,1,35.48616039744500000000
chr2,3719092,3720327,1235,-1,0,55821,1,80.97165991902830000000
chr2,3731811,3740279,8468,-1,0,55821,1,11.80916391119510000000
chr2,3732784,3738047,5263,-1,0,55821,1,19.00057001710050000000
chr2,3772838,3773449,611,-1,0,728597,1,163.66612111293000000000
chr2,3822776,3823523,747,-1,0,728597,1,133.86880856760400000000
chr2,3822766,3823144,378,-1,0,728597,1,264.55026455026500000000
chr2,3823396,3823501,105,-1,0,728597,1,952.38095238095300000000
chr2,3825382,3825961,579,-1,0,728597,1,172.71157167530200000000
chr2,3825559,3825683,124,-1,0,728597,1,806.45161290322600000000
chr2,3833906,3834273,367,-1,0,728597,1,272.47956403269800000000
chr2,3848150,3848537,387,-1,0,728597,1,258.39793281653700000000
chr2,3848195,3848453,258,-1,0,728597,1,387.59689922480600000000
chr2,3884895,3885527,632,-1,0,728597,1,158.22784810126600000000
chr2,4116621,4128740,12119,-1,0,,0,0.00000000000000000000
chr2,4183877,4188361,4484,-1,0,,0,0.00000000000000000000
chr2,4208559,4234925,26366,-1,0,,0,0.00000000000000000000
chr2,4203107,4222987,19880,-1,0,,0,0.00000000000000000000
chr2,4213831,4229994,16163,-1,0,,0,0.00000000000000000000
chr2,4211862,4223513,11651,-1,0,,0,0.00000000000000000000
chr2,4280134,4281417,1283,-1,0,,0,0.00000000000000000000
chr2,4647100,4657149,10049,-1,0,,0,0.00000000000000000000
chr2,4650448,4655331,4883,-1,0,,0,0.00000000000000000000
chr2,4651685,4654014,2329,-1,0,,0,0.00000000000000000000
chr2,4714299,4737073,22774,-1,0,,0,0.00000000000000000000
chr2,4779820,4787311,7491,-1,0,,0,0.00000000000000000000
chr2,4881882,4887892,6010,-1,0,,0,0.00000000000000000000
chr2,4973898,4976342,2444,-1,0,,0,0.00000000000000000000
chr2,5137418,5139639,2221,-1,0,,0,0.00000000000000000000
chr2,5250427,5252705,2278,-1,0,,0,0.00000000000000000000
chr2,5209082,5209624,542,-1,0,,0,0.00000000000000000000
chr2,5209176,5209511,335,-1,0,,0,0.00000000000000000000
chr2,5449506,5450060,554,-1,0,,0,0.00000000000000000000
chr2,5486699,5488247,1548,-1,0,,0,0.00000000000000000000
chr2,5487604,5488232,628,-1,0,,0,0.00000000000000000000
chr2,5487762,5488048,286,-1,0,,0,0.00000000000000000000
chr2,5736041,5737327,1286,-1,0,,0,0.00000000000000000000
chr2,5830249,5835072,4823,-1,0,6664,1,20.73398299813390000000
chr2,5845340,5846546,1206,-1,0,,0,0.00000000000000000000
chr2,5845980,5846585,605,-1,0,,0,0.00000000000000000000
chr2,5888017,5889037,1020,-1,0,,0,0.00000000000000000000
chr2,5888315,5888832,517,-1,0,,0,0.00000000000000000000
chr2,6298236,6308805,10569,-1,0,,0,0.00000000000000000000
chr2,6324323,6324758,435,-1,0,,0,0.00000000000000000000
chr2,6378121,6379227,1106,-1,0,,0,0.00000000000000000000
chr2,6378789,6379044,255,-1,0,,0,0.00000000000000000000
chr2,6393409,6393669,260,-1,0,,0,0.00000000000000000000
chr2,6400193,6411223,11030,-1,0,,0,0.00000000000000000000
chr2,6400504,6402195,1691,-1,0,,0,0.00000000000000000000
chr2,6400740,6400981,241,-1,0,,0,0.00000000000000000000
chr2,6400893,6401017,124,-1,0,,0,0.00000000000000000000
chr2,6432923,6445289,12366,-1,0,,0,0.00000000000000000000
chr2,6559960,6560377,417,-1,0,,0,0.00000000000000000000
chr2,6654226,6655246,1020,-1,0,,0,0.00000000000000000000
chr2,6660345,6660779,434,-1,0,,0,0.00000000000000000000
chr2,6693409,6707854,14445,-1,0,,0,0.00000000000000000000
chr2,6973041,6986256,13215,-1,0,129607,1,7.56715853197124000000
chr2,7229959,7235776,5817,-1,0,,0,0.00000000000000000000
chr2,7628715,7629132,417,-1,0,,0,0.00000000000000000000
chr2,7660194,7660395,201,-1,0,,0,0.00000000000000000000
chr2,8043465,8043762,297,-1,0,,0,0.00000000000000000000
chr2,8129664,8138527,8863,-1,0,,0,0.00000000000000000000
chr2,8391682,8393675,1993,-1,0,,0,0.00000000000000000000
chr2,8566547,8568077,1530,-1,0,,0,0.00000000000000000000
chr2,8568362,8583833,15471,-1,0,,0,0.00000000000000000000
chr2,8616707,8617210,503,-1,0,,0,0.00000000000000000000
chr2,8616803,8617110,307,-1,0,,0,0.00000000000000000000
chr2,9535125,9538002,2877,-1,0,8853,1,34.75842891901290000000
chr2,9546199,9546712,513,-1,0,9270,1,194.93177387914200000000
chr2,9546389,9546661,272,-1,0,9270,1,367.64705882352900000000
chr2,9925474,9929059,3585,-1,0,,0,0.00000000000000000000
chr2,9925541,9928015,2474,-1,0,,0,0.00000000000000000000
chr2,9959192,9959623,431,-1,0,,0,0.00000000000000000000
chr2,10076619,10077796,1177,-1,0,,0,0.00000000000000000000
chr2,10150102,10156495,6393,-1,0,,0,0.00000000000000000000
chr2,10340501,10340884,383,-1,0,348738,1,261.09660574412500000000
chr2,10340601,10340755,154,-1,0,348738,1,649.35064935064900000000
chr2,10373814,10374285,471,-1,0,,0,0.00000000000000000000
chr2,10374008,10374158,150,-1,0,,0,0.00000000000000000000
chr2,10431484,10431625,141,-1,0,,0,0.00000000000000000000
chr2,10433505,10439183,5678,-1,0,,0,0.00000000000000000000
chr2,10587852,10589007,1155,-1,0,4953,1,86.58008658008660000000
chr2,10627912,10628328,416,-1,0,,0,0.00000000000000000000
chr2,10702501,10706492,3991,-1,0,,0,0.00000000000000000000
chr2,10842090,10843524,1434,-1,0,,0,0.00000000000000000000
chr2,10865763,10867431,1668,-1,0,245973,1,59.95203836930460000000
chr2,11081838,11082195,357,-1,0,,0,0.00000000000000000000
chr2,11246301,11247474,1173,-1,0,,0,0.00000000000000000000
chr2,11248605,11248971,366,-1,0,,0,0.00000000000000000000
chr2,11253516,11253935,419,-1,0,,0,0.00000000000000000000
chr2,11395049,11400625,5576,-1,0,9475,1,17.93400286944050000000
chr2,11474751,11475105,354,-1,0,9475,1,282.48587570621500000000
chr2,11503643,11504560,917,-1,0,,0,0.00000000000000000000
chr2,11520489,11520945,456,-1,0,,0,0.00000000000000000000
chr2,11520553,11520851,298,-1,0,,0,0.00000000000000000000
chr2,11993541,11995933,2392,-1,0,,0,0.00000000000000000000
chr2,11994005,11995300,1295,-1,0,,0,0.00000000000000000000
chr2,11994617,11995175,558,-1,0,,0,0.00000000000000000000
chr2,12018937,12022895,3958,-1,0,,0,0.00000000000000000000
chr2,12572947,12591538,18591,-1,0,,0,0.00000000000000000000
chr2,12596199,12596303,104,-1,0,,0,0.00000000000000000000
chr2,12926770,12926827,57,-1,0,,0,0.00000000000000000000
chr2,13087238,13093241,6003,-1,0,,0,0.00000000000000000000
chr2,13171157,13171437,280,-1,0,,0,0.00000000000000000000
chr2,13503333,13572148,68815,-1,0,,0,0.00000000000000000000
chr2,13516205,13561646,45441,-1,0,,0,0.00000000000000000000
chr2,13532773,13549982,17209,-1,0,,0,0.00000000000000000000
chr2,13581184,13597763,16579,-1,0,,0,0.00000000000000000000
chr2,13555202,13561869,6667,-1,0,,0,0.00000000000000000000
chr2,13674304,13698327,24023,-1,0,,0,0.00000000000000000000
chr2,13708300,13719871,11571,-1,0,,0,0.00000000000000000000
chr2,13851163,13963266,112103,-1,0,,0,0.00000000000000000000
chr2,14521903,14567090,45187,-1,0,,0,0.00000000000000000000
chr2,14704081,14710211,6130,-1,0,,0,0.00000000000000000000
chr2,14189994,14199667,9673,-1,0,,0,0.00000000000000000000
chr2,14704608,14710425,5817,-1,0,,0,0.00000000000000000000
chr2,14344456,14349060,4604,-1,0,,0,0.00000000000000000000
chr2,14452359,14455268,2909,-1,0,,0,0.00000000000000000000
chr2,14469278,14470809,1531,-1,0,,0,0.00000000000000000000
chr2,14236154,14236795,641,-1,0,,0,0.00000000000000000000
chr2,14574288,14574877,589,-1,0,,0,0.00000000000000000000
chr2,14065768,14066174,406,-1,0,,0,0.00000000000000000000
chr2,14075546,14075955,409,-1,0,,0,0.00000000000000000000
chr2,14531290,14531618,328,-1,0,,0,0.00000000000000000000
chr2,14504852,14504997,145,-1,0,,0,0.00000000000000000000
chr2,14269409,14269480,71,-1,0,,0,0.00000000000000000000
chr2,14852880,14855237,2357,-1,0,,0,0.00000000000000000000
chr2,15013004,15066272,53268,-1,0,,0,0.00000000000000000000
chr2,14922409,14936927,14518,-1,0,,0,0.00000000000000000000
chr2,15156443,15197787,41344,-1,0,,0,0.00000000000000000000
chr2,15285007,15288043,3036,-1,0,,0,0.00000000000000000000
chr2,15166250,15166672,422,-1,0,,0,0.00000000000000000000
chr2,15166275,15166620,345,-1,0,,0,0.00000000000000000000
chr2,15723157,15723858,701,-1,0,,0,0.00000000000000000000
chr2,15819121,15819336,215,-1,0,,0,0.00000000000000000000
chr2,15927707,15928155,448,-1,0,,0,0.00000000000000000000
chr2,16230122,16230529,407,-1,0,,0,0.00000000000000000000
chr2,16250975,16251580,605,-1,0,,0,0.00000000000000000000
chr2,16251118,16251444,326,-1,0,,0,0.00000000000000000000
chr2,16271526,16273888,2362,-1,0,,0,0.00000000000000000000
chr2,16560514,16561532,1018,-1,0,,0,0.00000000000000000000
chr2,16580865,16581643,778,-1,0,,0,0.00000000000000000000
chr2,17220163,17244912,24749,-1,0,,0,0.00000000000000000000
chr2,17222263,17236809,14546,-1,0,,0,0.00000000000000000000
chr2,17585459,17590720,5261,-1,0,,0,0.00000000000000000000
chr2,17587377,17590527,3150,-1,0,,0,0.00000000000000000000
chr2,17959474,17959728,254,-1,0,348654,1,393.70078740157500000000
chr2,17969499,17979543,10044,-1,0,,0,0.00000000000000000000
chr2,18117934,18121048,3114,-1,0,,0,0.00000000000000000000
chr2,18118226,18119922,1696,-1,0,,0,0.00000000000000000000
chr2,18118903,18120078,1175,-1,0,,0,0.00000000000000000000
chr2,18118939,18119715,776,-1,0,,0,0.00000000000000000000
chr2,18118892,18119565,673,-1,0,,0,0.00000000000000000000
chr2,18177499,18246703,69204,-1,0,,0,0.00000000000000000000
chr2,18173654,18202351,28697,-1,0,,0,0.00000000000000000000
chr2,18173025,18193249,20224,-1,0,,0,0.00000000000000000000
chr2,18183209,18185414,2205,-1,0,,0,0.00000000000000000000
chr2,18435707,18438996,3289,-1,0,,0,0.00000000000000000000
chr2,18476794,18476994,200,-1,0,,0,0.00000000000000000000
chr2,18574229,18574524,295,-1,0,,0,0.00000000000000000000
chr2,18784760,18786421,1661,-1,0,,0,0.00000000000000000000
chr2,18817172,18817289,117,-1,0,,0,0.00000000000000000000
chr2,18906056,18907359,1303,-1,0,,0,0.00000000000000000000
chr2,19002866,19003369,503,-1,0,,0,0.00000000000000000000
chr2,19185691,19225290,39599,-1,0,,0,0.00000000000000000000
chr2,19407409,19409993,2584,-1,0,,0,0.00000000000000000000
chr2,19460666,19528615,67949,-1,0,,0,0.00000000000000000000
chr2,19576128,19585493,9365,-1,0,,0,0.00000000000000000000
chr2,19765028,19774396,9368,-1,0,,0,0.00000000000000000000
chr2,19767763,19772367,4604,-1,0,,0,0.00000000000000000000
chr2,19767564,19770555,2991,-1,0,,0,0.00000000000000000000
chr2,19987244,19987829,585,-1,0,,0,0.00000000000000000000
chr2,19992416,19992531,115,-1,0,,0,0.00000000000000000000
chr2,20423227,20425210,1983,-1,0,6382,1,50.42864346949070000000
chr2,20645657,20645927,270,-1,0,,0,0.00000000000000000000
chr2,20666575,20667088,513,-1,0,,0,0.00000000000000000000
chr2,20666672,20666987,315,-1,0,,0,0.00000000000000000000
chr2,20915444,20916658,1214,-1,0,60526,1,82.37232289950580000000
chr2,20971373,20971771,398,-1,0,60526,1,251.25628140703500000000
chr2,21107620,21131837,24217,-1,0,,0,0.00000000000000000000
chr2,21383793,21386065,2272,-1,0,,0,0.00000000000000000000
chr2,21407745,21408182,437,-1,0,,0,0.00000000000000000000
chr2,21407939,21407985,46,-1,0,,0,0.00000000000000000000
chr2,21572786,21573111,325,-1,0,,0,0.00000000000000000000
chr2,21821776,21857881,36105,-1,0,,0,0.00000000000000000000
chr2,21859201,21861410,2209,-1,0,,0,0.00000000000000000000
chr2,22062410,22064790,2380,-1,0,,0,0.00000000000000000000
chr2,22328246,22331972,3726,-1,0,,0,0.00000000000000000000
chr2,22307050,22308451,1401,-1,0,,0,0.00000000000000000000
chr2,22406947,22407880,933,-1,0,,0,0.00000000000000000000
chr2,22498593,22498970,377,-1,0,,0,0.00000000000000000000
chr2,22512708,22605492,92784,-1,0,,0,0.00000000000000000000
chr2,22673344,22673420,76,-1,0,,0,0.00000000000000000000
chr2,22688410,22690088,1678,-1,0,,0,0.00000000000000000000
chr2,22811246,22811760,514,-1,0,,0,0.00000000000000000000
chr2,22864118,22864667,549,-1,0,,0,0.00000000000000000000
chr2,23466334,23475546,9212,-1,0,,0,0.00000000000000000000
chr2,23607746,23609935,2189,-1,0,114818,1,45.68296025582460000000
chr2,24151213,24156138,4925,-1,0,,0,0.00000000000000000000
chr2,24439571,24439994,423,-1,0,50618,1,236.40661938534300000000
chr2,24451767,24452098,331,-1,0,50618,1,302.11480362537800000000
chr2,24451905,24451960,55,-1,0,50618,1,1818.18181818182000000000
chr2,24474340,24474472,132,-1,0,50618,1,757.57575757575800000000
chr2,24547082,24548447,1365,-1,0,50618,1,73.26007326007330000000
chr2,24554814,24559168,4354,-1,0,50618,1,22.96738631143780000000
chr2,24599219,24614879,15660,-1,0,,0,0.00000000000000000000
chr2,24607721,24619686,11965,-1,0,,0,0.00000000000000000000
chr2,24600329,24610683,10354,-1,0,,0,0.00000000000000000000
chr2,24876026,24879822,3796,-1,0,8648,1,26.34351949420440000000
chr2,24607933,24611256,3323,-1,0,,0,0.00000000000000000000
chr2,25563406,25565566,2160,-1,0,1788,1,46.29629629629630000000
chr2,24608976,24611262,2286,-1,0,,0,0.00000000000000000000
chr2,25445069,25446873,1804,-1,0,,0,0.00000000000000000000
chr2,25103430,25105032,1602,-1,0,109,1,62.42197253433210000000
chr2,24713787,24715004,1217,-1,0,,0,0.00000000000000000000
chr2,25142500,25143608,1108,-1,0,109,1,90.25270758122740000000
chr2,25117058,25117992,934,-1,0,109,1,107.06638115631700000000
chr2,24687212,24687795,583,-1,0,,0,0.00000000000000000000
chr2,25227562,25227995,433,-1,0,,0,0.00000000000000000000
chr2,25052407,25053025,618,-1,0,109,1,161.81229773462800000000
chr2,25227629,25227944,315,-1,0,,0,0.00000000000000000000
chr2,25148416,25148565,149,-1,0,,0,0.00000000000000000000
chr2,25680854,25683960,3106,-1,0,1838,1,32.19575016097870000000
chr2,25682508,25683977,1469,-1,0,1838,1,68.07351940095300000000
chr2,25896052,25896955,903,-1,0,1838,1,110.74197120708700000000
chr2,26183210,26183387,177,-1,0,3797,1,564.97175141242900000000
chr2,26376087,26378870,2783,-1,0,,0,0.00000000000000000000
chr2,26822757,26823090,333,-1,0,130106,1,300.30030030030000000000
chr2,26878028,26878199,171,-1,0,,0,0.00000000000000000000
chr2,27314677,27324118,9441,-1,0,3795;10669,2,21.18419658934430000000
chr2,27324325,27324389,64,-1,0,10669,1,1562.50000000000000000000
chr2,27523627,27527018,3391,-1,0,57159,1,29.48982601002650000000
chr2,27765313,27779199,13886,-1,0,,0,0.00000000000000000000
chr2,27810740,27811757,1017,-1,0,84450,1,98.32841691248770000000
chr2,27898980,27899823,843,-1,0,22950,1,118.62396204033200000000
chr2,28059773,28060218,445,-1,0,64080,1,224.71910112359600000000
chr2,28353829,28354271,442,-1,0,9577,1,226.24434389140300000000
chr2,28680573,28682643,2070,-1,0,,0,0.00000000000000000000
chr2,28688931,28688988,57,-1,0,,0,0.00000000000000000000
chr2,28720760,28721306,546,-1,0,151056,1,183.15018315018300000000
chr2,28856354,28882000,25646,-1,0,151056,1,3.89924354675193000000
chr2,29085123,29087323,2200,-1,0,55006,1,45.45454545454550000000
chr2,29097415,29105578,8163,-1,0,,0,0.00000000000000000000
chr2,29106634,29117280,10646,-1,0,,0,0.00000000000000000000
chr2,29097278,29101206,3928,-1,0,,0,0.00000000000000000000
chr2,29208062,29212762,4700,-1,0,165186,1,21.27659574468090000000
chr2,29227940,29228862,922,-1,0,165186,1,108.45986984815600000000
chr2,29228196,29228916,720,-1,0,165186,1,138.88888888888900000000
chr2,29228568,29228637,69,-1,0,165186,1,1449.27536231884000000000
chr2,29275834,29277256,1422,-1,0,,0,0.00000000000000000000
chr2,29337958,29338845,887,-1,0,79745,1,112.73957158962800000000
chr2,29641650,29645381,3731,-1,0,238,1,26.80246582685610000000
chr2,29535145,29539497,4352,-1,0,238,1,22.97794117647060000000
chr2,29642213,29644210,1997,-1,0,238,1,50.07511266900350000000
chr2,29731176,29737183,6007,-1,0,238,1,16.64724488097220000000
chr2,29817613,29824940,7327,-1,0,238,1,13.64815067558350000000
chr2,29957925,29963362,5437,-1,0,238,1,18.39249586168840000000
chr2,29999051,29999424,373,-1,0,238,1,268.09651474530800000000
chr2,29999221,29999306,85,-1,0,238,1,1176.47058823529000000000
chr2,30303125,30303271,146,-1,0,,0,0.00000000000000000000
chr2,30370102,30370907,805,-1,0,51646,1,124.22360248447200000000
chr2,30531941,30536228,4287,-1,0,,0,0.00000000000000000000
chr2,30546103,30546801,698,-1,0,,0,0.00000000000000000000
chr2,30607642,30608495,853,-1,0,,0,0.00000000000000000000
chr2,30615374,30627773,12399,-1,0,,0,0.00000000000000000000
chr2,30732395,30733092,697,-1,0,253558,1,143.47202295552400000000
chr2,30812774,30850271,37497,-1,0,253558,1,2.66688001706803000000
chr2,30828709,30832219,3510,-1,0,253558,1,28.49002849002850000000
chr2,30864649,30875933,11284,-1,0,253558,1,8.86210563629919000000
chr2,31124761,31132475,7714,-1,0,,0,0.00000000000000000000
chr2,31342719,31343043,324,-1,0,79623,1,308.64197530864200000000
chr2,31423394,31469604,46210,-1,0,30845;440854,2,4.32806751785328000000
chr2,31455030,31455836,806,-1,0,440854,1,124.06947890818900000000
chr2,31506513,31506568,55,-1,0,,0,0.00000000000000000000
chr2,31709904,31710916,1012,-1,0,,0,0.00000000000000000000
chr2,31725301,31727895,2594,-1,0,,0,0.00000000000000000000
chr2,31888775,32026012,137237,-1,0,,0,0.00000000000000000000
chr2,31942922,31958424,15502,-1,0,,0,0.00000000000000000000
chr2,32074134,32075449,1315,-1,0,,0,0.00000000000000000000
chr2,32293087,32295247,2160,-1,0,6683,1,46.29629629629630000000
chr2,32331885,32335340,3455,-1,0,6683,1,28.94356005788710000000
chr2,32478643,32480258,1615,-1,0,58484,1,61.91950464396290000000
chr2,33091367,33095867,4500,-1,0,,0,0.00000000000000000000
chr2,33092179,33095431,3252,-1,0,,0,0.00000000000000000000
chr2,33051607,33052652,1045,-1,0,,0,0.00000000000000000000
chr2,33140055,33143889,3834,-1,0,,0,0.00000000000000000000
chr2,33221655,33227331,5676,-1,0,4052,1,17.61804087385480000000
chr2,33224461,33227296,2835,-1,0,4052,1,35.27336860670190000000
chr2,33225641,33227571,1930,-1,0,4052,1,51.81347150259070000000
chr2,33224571,33226324,1753,-1,0,4052,1,57.04506560182540000000
chr2,33226104,33227245,1141,-1,0,4052,1,87.64241893076250000000
chr2,33282142,33282341,199,-1,0,4052,1,502.51256281407000000000
chr2,33481798,33481846,48,-1,0,4052,1,2083.33333333333000000000
chr2,33512890,33516813,3923,-1,0,4052,1,25.49069589599800000000
chr2,33763990,33767610,3620,-1,0,25780,1,27.62430939226520000000
chr2,33781177,33781713,536,-1,0,25780,1,186.56716417910400000000
chr2,33781270,33781610,340,-1,0,25780,1,294.11764705882400000000
chr2,33992335,33992827,492,-1,0,,0,0.00000000000000000000
chr2,33992538,33992587,49,-1,0,,0,0.00000000000000000000
chr2,34236606,34318929,82323,-1,0,,0,0.00000000000000000000
chr2,34293322,34352039,58717,-1,0,,0,0.00000000000000000000
chr2,34303765,34313027,9262,-1,0,,0,0.00000000000000000000
chr2,34229672,34234369,4697,-1,0,,0,0.00000000000000000000
chr2,34151388,34152192,804,-1,0,,0,0.00000000000000000000
chr2,34523575,34525669,2094,-1,0,,0,0.00000000000000000000
chr2,34523897,34525308,1411,-1,0,,0,0.00000000000000000000
chr2,34523896,34524806,910,-1,0,,0,0.00000000000000000000
chr2,34545341,34545984,643,-1,0,,0,0.00000000000000000000
chr2,34643552,34644053,501,-1,0,,0,0.00000000000000000000
chr2,34643641,34643960,319,-1,0,,0,0.00000000000000000000
chr2,34805209,34925996,120787,-1,0,,0,0.00000000000000000000
chr2,34919394,35045708,126314,-1,0,,0,0.00000000000000000000
chr2,34960640,35015754,55114,-1,0,,0,0.00000000000000000000
chr2,34690117,34735610,45493,-1,0,,0,0.00000000000000000000
chr2,34701643,34730732,29089,-1,0,,0,0.00000000000000000000
chr2,34699119,34722917,23798,-1,0,,0,0.00000000000000000000
chr2,34715445,34736248,20803,-1,0,,0,0.00000000000000000000
chr2,34697981,34709629,11648,-1,0,,0,0.00000000000000000000
chr2,34717010,34727824,10814,-1,0,,0,0.00000000000000000000
chr2,34797533,34801614,4081,-1,0,,0,0.00000000000000000000
chr2,34826808,34829334,2526,-1,0,,0,0.00000000000000000000
chr2,34965702,34967240,1538,-1,0,,0,0.00000000000000000000
chr2,35006896,35008316,1420,-1,0,,0,0.00000000000000000000
chr2,34965756,34966569,813,-1,0,,0,0.00000000000000000000
chr2,35007244,35007825,581,-1,0,,0,0.00000000000000000000
chr2,34828917,34829256,339,-1,0,,0,0.00000000000000000000
chr2,35034389,35034787,398,-1,0,,0,0.00000000000000000000
chr2,34828977,34829256,279,-1,0,,0,0.00000000000000000000
chr2,35034437,35034682,245,-1,0,,0,0.00000000000000000000
chr2,35060103,35068522,8419,-1,0,,0,0.00000000000000000000
chr2,35078492,35093131,14639,-1,0,,0,0.00000000000000000000
chr2,35818631,36090090,271459,-1,0,,0,0.00000000000000000000
chr2,35289330,35558345,269015,-1,0,,0,0.00000000000000000000
chr2,35513775,35641094,127319,-1,0,,0,0.00000000000000000000
chr2,35817244,35945112,127868,-1,0,,0,0.00000000000000000000
chr2,35578057,35620040,41983,-1,0,,0,0.00000000000000000000
chr2,35967532,35998653,31121,-1,0,,0,0.00000000000000000000
chr2,35257015,35289796,32781,-1,0,,0,0.00000000000000000000
chr2,35582002,35608717,26715,-1,0,,0,0.00000000000000000000
chr2,35974967,35991448,16481,-1,0,,0,0.00000000000000000000
chr2,35387990,35404940,16950,-1,0,,0,0.00000000000000000000
chr2,35932283,35944599,12316,-1,0,,0,0.00000000000000000000
chr2,35980173,35991181,11008,-1,0,,0,0.00000000000000000000
chr2,36075870,36086052,10182,-1,0,,0,0.00000000000000000000
chr2,35635045,35645074,10029,-1,0,,0,0.00000000000000000000
chr2,35987387,35991474,4087,-1,0,,0,0.00000000000000000000
chr2,35827761,35831909,4148,-1,0,,0,0.00000000000000000000
chr2,35257428,35259923,2495,-1,0,,0,0.00000000000000000000
chr2,35872573,35873897,1324,-1,0,,0,0.00000000000000000000
chr2,36057921,36058776,855,-1,0,,0,0.00000000000000000000
chr2,36090444,36090902,458,-1,0,,0,0.00000000000000000000
chr2,36008834,36009224,390,-1,0,,0,0.00000000000000000000
chr2,35772265,35772328,63,-1,0,,0,0.00000000000000000000
chr2,36097870,36132602,34732,-1,0,,0,0.00000000000000000000
chr2,36159523,36159959,436,-1,0,,0,0.00000000000000000000
chr2,36167065,36167550,485,-1,0,,0,0.00000000000000000000
chr2,36216235,36219178,2943,-1,0,,0,0.00000000000000000000
chr2,36352549,36569068,216519,-1,0,,0,0.00000000000000000000
chr2,36398759,36472999,74240,-1,0,,0,0.00000000000000000000
chr2,36332556,36342953,10397,-1,0,,0,0.00000000000000000000
chr2,36332589,36339555,6966,-1,0,,0,0.00000000000000000000
chr2,36336136,36339564,3428,-1,0,,0,0.00000000000000000000
chr2,36394686,36395242,556,-1,0,,0,0.00000000000000000000
chr2,36732540,36732868,328,-1,0,51232,1,304.87804878048800000000
chr2,36732707,36732961,254,-1,0,51232,1,393.70078740157500000000
chr2,36820330,36821585,1255,-1,0,9637,1,79.68127490039840000000
chr2,36836163,36840705,4542,-1,0,,0,0.00000000000000000000
chr2,36955653,36956027,374,-1,0,5212,1,267.37967914438500000000
chr2,36986221,36991103,4882,-1,0,5212,1,20.48340843916430000000
chr2,36998504,36999525,1021,-1,0,5212,1,97.94319294809010000000
chr2,37259032,37259092,60,-1,0,54497,1,1666.66666666667000000000
chr2,37347650,37348408,758,-1,0,5610,1,131.92612137203200000000
chr2,37958428,38003151,44723,-1,0,,0,0.00000000000000000000
chr2,38040911,38040967,56,-1,0,,0,0.00000000000000000000
chr2,38185474,38187123,1649,-1,0,151393,1,60.64281382656160000000
chr2,38956062,38972486,16424,-1,0,6432;130589,2,12.17730150998540000000
chr2,38872874,38884428,11554,-1,0,,0,0.00000000000000000000
chr2,38308140,38313431,5291,-1,0,,0,0.00000000000000000000
chr2,38944838,38947070,2232,-1,0,130589,1,44.80286738351250000000
chr2,38464208,38465748,1540,-1,0,,0,0.00000000000000000000
chr2,38851309,38851841,532,-1,0,,0,0.00000000000000000000
chr2,39071421,39071880,459,-1,0,90957,1,217.86492374727700000000
chr2,38552624,38553039,415,-1,0,64225,1,240.96385542168700000000
chr2,38851419,38851728,309,-1,0,,0,0.00000000000000000000
chr2,38706833,38707031,198,-1,0,,0,0.00000000000000000000
chr2,39316505,39317758,1253,-1,0,6654,1,79.80845969672790000000
chr2,39712310,39712948,638,-1,0,,0,0.00000000000000000000
chr2,39754649,39755439,790,-1,0,,0,0.00000000000000000000
chr2,40091586,40232326,140740,-1,0,,0,0.00000000000000000000
chr2,40203029,40253638,50609,-1,0,,0,0.00000000000000000000
chr2,40416667,40432795,16128,-1,0,6546,1,6.20039682539683000000
chr2,40481377,40481978,601,-1,0,6546,1,166.38935108153100000000
chr2,40446790,40447225,435,-1,0,6546,1,229.88505747126400000000
chr2,40446938,40447080,142,-1,0,6546,1,704.22535211267600000000
chr2,40614823,40626542,11719,-1,0,6546,1,8.53315129277242000000
chr2,40612234,40614942,2708,-1,0,6546,1,36.92762186115210000000
chr2,40764796,40772039,7243,-1,0,,0,0.00000000000000000000
chr2,40861338,40862828,1490,-1,0,,0,0.00000000000000000000
chr2,40882317,40882788,471,-1,0,,0,0.00000000000000000000
chr2,40882482,40882559,77,-1,0,,0,0.00000000000000000000
chr2,40926121,40953911,27790,-1,0,,0,0.00000000000000000000
chr2,40978056,40978618,562,-1,0,,0,0.00000000000000000000
chr2,40978152,40978487,335,-1,0,,0,0.00000000000000000000
chr2,41147549,41251711,104162,-1,0,,0,0.00000000000000000000
chr2,41243151,41274149,30998,-1,0,,0,0.00000000000000000000
chr2,41238331,41252708,14377,-1,0,,0,0.00000000000000000000
chr2,41238344,41250296,11952,-1,0,,0,0.00000000000000000000
chr2,41238845,41246188,7343,-1,0,,0,0.00000000000000000000
chr2,41147122,41150716,3594,-1,0,,0,0.00000000000000000000
chr2,41118125,41118536,411,-1,0,,0,0.00000000000000000000
chr2,41199079,41199196,117,-1,0,,0,0.00000000000000000000
chr2,41607424,41616718,9294,-1,0,,0,0.00000000000000000000
chr2,41638896,41639622,726,-1,0,,0,0.00000000000000000000
chr2,41660716,41660939,223,-1,0,,0,0.00000000000000000000
chr2,41818631,41910435,91804,-1,0,,0,0.00000000000000000000
chr2,41933213,41965434,32221,-1,0,,0,0.00000000000000000000
chr2,41775943,41781289,5346,-1,0,,0,0.00000000000000000000
chr2,41775951,41777258,1307,-1,0,,0,0.00000000000000000000
chr2,41921738,41923048,1310,-1,0,,0,0.00000000000000000000
chr2,41973026,41976041,3015,-1,0,,0,0.00000000000000000000
chr2,42005984,42009534,3550,-1,0,,0,0.00000000000000000000
chr2,42274580,42275846,1266,-1,0,91461,1,78.98894154818320000000
chr2,42346263,42347320,1057,-1,0,,0,0.00000000000000000000
chr2,42346229,42347096,867,-1,0,,0,0.00000000000000000000
chr2,42346180,42346858,678,-1,0,,0,0.00000000000000000000
chr2,42446736,42453736,7000,-1,0,27436,1,14.28571428571430000000
chr2,42852282,42853558,1276,-1,0,57504,1,78.36990595611280000000
chr2,42986809,42988380,1571,-1,0,,0,0.00000000000000000000
chr2,43129256,43129588,332,-1,0,,0,0.00000000000000000000
chr2,43205575,43205968,393,-1,0,,0,0.00000000000000000000
chr2,43230837,43231535,698,-1,0,,0,0.00000000000000000000
chr2,43450781,43454557,3776,-1,0,678,1,26.48305084745760000000
chr2,43486114,43557170,71056,-1,0,63892,1,1.40734068903400000000
chr2,43547768,43569380,21612,-1,0,63892,1,4.62705904127337000000
chr2,43523293,43534635,11342,-1,0,63892,1,8.81678716275789000000
chr2,43656294,43657101,807,-1,0,63892,1,123.91573729863700000000
chr2,43658767,43659294,527,-1,0,63892,1,189.75332068311200000000
chr2,43854260,43854480,220,-1,0,,0,0.00000000000000000000
chr2,43884994,43894066,9072,-1,0,130271,1,11.02292768959440000000
chr2,44083081,44098610,15529,-1,0,64241,1,6.43956468542727000000
chr2,44096078,44098278,2200,-1,0,64241,1,45.45454545454550000000
chr2,44098411,44098566,155,-1,0,64241,1,645.16129032258100000000
chr2,44709744,44796809,87065,-1,0,79823,1,1.14856716246483000000
chr2,44580431,44654333,73902,-1,0,79823;9581,2,2.70628670401342000000
chr2,44505469,44562121,56652,-1,0,9581;6519,2,3.53032549601073000000
chr2,44643667,44670880,27213,-1,0,79823,1,3.67471429096388000000
chr2,44742721,44767673,24952,-1,0,79823,1,4.00769477396601000000
chr2,44817133,44826624,9491,-1,0,79823,1,10.53629754504270000000
chr2,44282002,44291133,9131,-1,0,,0,0.00000000000000000000
chr2,44465076,44469309,4233,-1,0,,0,0.00000000000000000000
chr2,44484262,44491402,7140,-1,0,,0,0.00000000000000000000
chr2,44825042,44830297,5255,-1,0,79823,1,19.02949571836350000000
chr2,44467102,44468838,1736,-1,0,,0,0.00000000000000000000
chr2,44318561,44321202,2641,-1,0,,0,0.00000000000000000000
chr2,44783047,44784877,1830,-1,0,79823,1,54.64480874316940000000
chr2,44612634,44614531,1897,-1,0,79823,1,52.71481286241430000000
chr2,44826885,44828730,1845,-1,0,79823,1,54.20054200542010000000
chr2,44467226,44468549,1323,-1,0,,0,0.00000000000000000000
chr2,44783576,44783936,360,-1,0,79823,1,277.77777777777800000000
chr2,44790249,44790711,462,-1,0,79823,1,216.45021645021600000000
chr2,44636107,44636488,381,-1,0,79823,1,262.46719160105000000000
chr2,44308491,44308817,326,-1,0,,0,0.00000000000000000000
chr2,44636236,44636324,88,-1,0,79823,1,1136.36363636364000000000
chr2,45274546,45349823,75277,-1,0,,0,0.00000000000000000000
chr2,45306978,45335637,28659,-1,0,,0,0.00000000000000000000
chr2,45300412,45311075,10663,-1,0,,0,0.00000000000000000000
chr2,45481028,45530632,49604,-1,0,,0,0.00000000000000000000
chr2,45641741,45642711,970,-1,0,55133,1,103.09278350515500000000
chr2,45642246,45642480,234,-1,0,55133,1,427.35042735042700000000
chr2,45725262,45736476,11214,-1,0,55133,1,8.91742464776173000000
chr2,45758005,45760012,2007,-1,0,55133,1,49.82561036372700000000
chr2,46253989,46258408,4419,-1,0,5581,1,22.62955419778230000000
chr2,46312695,46312947,252,-1,0,5581,1,396.82539682539700000000
chr2,46416220,46422131,5911,-1,0,,0,0.00000000000000000000
chr2,46433675,46434097,422,-1,0,,0,0.00000000000000000000
chr2,46433775,46433961,186,-1,0,,0,0.00000000000000000000
chr2,46669071,46744828,75757,-1,0,388946;90423,2,2.64002006415249000000
chr2,46694186,46697710,3524,-1,0,,0,0.00000000000000000000
chr2,46910038,46910574,536,-1,0,,0,0.00000000000000000000
chr2,46910146,46910454,308,-1,0,,0,0.00000000000000000000
chr2,46967780,46978973,11193,-1,0,9655,1,8.93415527561869000000
chr2,47026154,47026624,470,-1,0,,0,0.00000000000000000000
chr2,47138770,47140759,1989,-1,0,90411,1,50.27652086475620000000
chr2,47152594,47158884,6290,-1,0,57217;90411,2,31.79650238473770000000
chr2,47327078,47334766,7688,-1,0,285051,1,13.00728407908430000000
chr2,47555289,47598306,43017,-1,0,4072,1,2.32466234279471000000
chr2,47653884,47654376,492,-1,0,4436,1,203.25203252032500000000
chr2,47653963,47654292,329,-1,0,4436,1,303.95136778115500000000
chr2,47653996,47654127,131,-1,0,4436,1,763.35877862595400000000
chr2,47880393,47881674,1281,-1,0,,0,0.00000000000000000000
chr2,47797003,47798103,1100,-1,0,56660,1,90.90909090909090000000
chr2,48413140,48493182,80042,-1,0,,0,0.00000000000000000000
chr2,48852860,48869771,16911,-1,0,11036;286749,2,11.82662172550410000000
chr2,48851164,48857940,6776,-1,0,11036;286749,2,29.51593860684770000000
chr2,48781833,48784869,3036,-1,0,286749;11037,2,65.87615283267460000000
chr2,48851209,48854801,3592,-1,0,11036;286749,2,55.67928730512250000000
chr2,48744102,48747464,3362,-1,0,,0,0.00000000000000000000
chr2,48791563,48791730,167,-1,0,286749;11037,2,1197.60479041916000000000
chr2,48990525,48991165,640,-1,0,286749,1,156.25000000000000000000
chr2,49014284,49015522,1238,-1,0,,0,0.00000000000000000000
chr2,49179714,49248222,68508,-1,0,2492,1,1.45968354060840000000
chr2,49087802,49139844,52042,-1,0,,0,0.00000000000000000000
chr2,49041170,49065607,24437,-1,0,,0,0.00000000000000000000
chr2,49037138,49055202,18064,-1,0,,0,0.00000000000000000000
chr2,49377205,49378044,839,-1,0,2492,1,119.18951132300400000000
chr2,49527545,49692557,165012,-1,0,,0,0.00000000000000000000
chr2,49646146,49737159,91013,-1,0,,0,0.00000000000000000000
chr2,49620741,49660770,40029,-1,0,,0,0.00000000000000000000
chr2,49493962,49525613,31651,-1,0,,0,0.00000000000000000000
chr2,49518379,49540211,21832,-1,0,,0,0.00000000000000000000
chr2,49713802,49728423,14621,-1,0,,0,0.00000000000000000000
chr2,49532584,49542657,10073,-1,0,,0,0.00000000000000000000
chr2,49533535,49539292,5757,-1,0,,0,0.00000000000000000000
chr2,49536125,49539181,3056,-1,0,,0,0.00000000000000000000
chr2,49612806,49613302,496,-1,0,,0,0.00000000000000000000
chr2,49561216,49561828,612,-1,0,,0,0.00000000000000000000
chr2,49612875,49613209,334,-1,0,,0,0.00000000000000000000
chr2,49561481,49561626,145,-1,0,,0,0.00000000000000000000
chr2,50134703,50135562,859,-1,0,,0,0.00000000000000000000
chr2,50182531,50192463,9932,-1,0,9378,1,10.06846556584780000000
chr2,50473383,50481016,7633,-1,0,9378,1,13.10100877767590000000
chr2,50480983,50481764,781,-1,0,9378,1,128.04097311139600000000
chr2,50505283,50569455,64172,-1,0,9378,1,1.55831203640217000000
chr2,50497042,50516033,18991,-1,0,9378,1,5.26565215101890000000
chr2,50489529,50505534,16005,-1,0,9378,1,6.24804748516089000000
chr2,50787566,50835254,47688,-1,0,9378,1,2.09696359671196000000
chr2,50874827,51379223,504396,-1,0,9378,1,0.19825692511439400000
chr2,51077163,51350527,273364,-1,0,9378,1,0.36581261614550600000
chr2,50878133,51113953,235820,-1,0,9378,1,0.42405224323636700000
chr2,51308075,51479170,171095,-1,0,,0,0.00000000000000000000
chr2,51019799,51142683,122884,-1,0,9378,1,0.81377559324240800000
chr2,51344552,51432606,88054,-1,0,,0,0.00000000000000000000
chr2,50877708,50948416,70708,-1,0,9378,1,1.41426712677491000000
chr2,50948552,51000226,51674,-1,0,9378,1,1.93520919611410000000
chr2,51382049,51432439,50390,-1,0,,0,0.00000000000000000000
chr2,51030155,51081718,51563,-1,0,9378,1,1.93937513333204000000
chr2,50976338,51020736,44398,-1,0,9378,1,2.25235370962656000000
chr2,51299791,51336190,36399,-1,0,,0,0.00000000000000000000
chr2,50919025,50953861,34836,-1,0,9378,1,2.87059363876450000000
chr2,51096051,51110737,14686,-1,0,9378,1,6.80920604657497000000
chr2,51009186,51016044,6858,-1,0,9378,1,14.58151064450280000000
chr2,51433344,51435654,2310,-1,0,,0,0.00000000000000000000
chr2,51183189,51185705,2516,-1,0,9378,1,39.74562798092210000000
chr2,51224544,51225541,997,-1,0,9378,1,100.30090270812400000000
chr2,51224958,51225586,628,-1,0,9378,1,159.23566878980900000000
chr2,51504564,51507673,3109,-1,0,,0,0.00000000000000000000
chr2,51588021,51591645,3624,-1,0,,0,0.00000000000000000000
chr2,51735494,51862691,127197,-1,0,,0,0.00000000000000000000
chr2,51768440,51776021,7581,-1,0,,0,0.00000000000000000000
chr2,51837628,51845499,7871,-1,0,,0,0.00000000000000000000
chr2,51922282,51927723,5441,-1,0,,0,0.00000000000000000000
chr2,51926591,51927804,1213,-1,0,,0,0.00000000000000000000
chr2,51943441,51943589,148,-1,0,,0,0.00000000000000000000
chr2,51943531,51943613,82,-1,0,,0,0.00000000000000000000
chr2,51973821,51974238,417,-1,0,,0,0.00000000000000000000
chr2,52930310,53182754,252444,-1,0,,0,0.00000000000000000000
chr2,52392345,52577760,185415,-1,0,,0,0.00000000000000000000
chr2,52294488,52440652,146164,-1,0,,0,0.00000000000000000000
chr2,52599360,52749714,150354,-1,0,,0,0.00000000000000000000
chr2,53172215,53289714,117499,-1,0,,0,0.00000000000000000000
chr2,52942275,53058567,116292,-1,0,,0,0.00000000000000000000
chr2,52834083,52882235,48152,-1,0,,0,0.00000000000000000000
chr2,52257509,52317396,59887,-1,0,,0,0.00000000000000000000
chr2,52747469,52786002,38533,-1,0,,0,0.00000000000000000000
chr2,53018572,53057370,38798,-1,0,,0,0.00000000000000000000
chr2,53073598,53112639,39041,-1,0,,0,0.00000000000000000000
chr2,53002002,53033537,31535,-1,0,,0,0.00000000000000000000
chr2,53143660,53173441,29781,-1,0,,0,0.00000000000000000000
chr2,52977338,53000517,23179,-1,0,,0,0.00000000000000000000
chr2,52755134,52781224,26090,-1,0,,0,0.00000000000000000000
chr2,52764407,52786994,22587,-1,0,,0,0.00000000000000000000
chr2,52750948,52771430,20482,-1,0,,0,0.00000000000000000000
chr2,52734227,52755904,21677,-1,0,,0,0.00000000000000000000
chr2,52378299,52398952,20653,-1,0,,0,0.00000000000000000000
chr2,53123843,53142759,18916,-1,0,,0,0.00000000000000000000
chr2,53166720,53182209,15489,-1,0,,0,0.00000000000000000000
chr2,53277363,53289591,12228,-1,0,,0,0.00000000000000000000
chr2,52587715,52595020,7305,-1,0,,0,0.00000000000000000000
chr2,53249391,53252615,3224,-1,0,,0,0.00000000000000000000
chr2,52635575,52636537,962,-1,0,,0,0.00000000000000000000
chr2,53292225,53293091,866,-1,0,,0,0.00000000000000000000
chr2,53429400,53444256,14856,-1,0,,0,0.00000000000000000000
chr2,53527445,53559509,32064,-1,0,,0,0.00000000000000000000
chr2,53512600,53536405,23805,-1,0,,0,0.00000000000000000000
chr2,53557757,53560644,2887,-1,0,,0,0.00000000000000000000
chr2,53489814,53491870,2056,-1,0,,0,0.00000000000000000000
chr2,53558085,53559785,1700,-1,0,,0,0.00000000000000000000
chr2,53625759,53628001,2242,-1,0,,0,0.00000000000000000000
chr2,53843803,53846635,2832,-1,0,,0,0.00000000000000000000
chr2,53898828,53899030,202,-1,0,51130;100302652,2,990.09900990099000000000
chr2,54972648,55134875,162227,-1,0,400954,1,0.61642020132283800000
chr2,54346085,54384510,38425,-1,0,98,1,2.60247234873129000000
chr2,55323879,55338081,14202,-1,0,57142,1,7.04126179411350000000
chr2,54513083,54517805,4722,-1,0,98,1,21.17746717492590000000
chr2,54565489,54567478,1989,-1,0,129852,1,50.27652086475620000000
chr2,54593807,54595506,1699,-1,0,,0,0.00000000000000000000
chr2,54565768,54567147,1379,-1,0,129852,1,72.51631617113850000000
chr2,54693389,54693849,460,-1,0,6711,1,217.39130434782600000000
chr2,55135004,55135480,476,-1,0,400954,1,210.08403361344500000000
chr2,55183236,55183599,363,-1,0,400954,1,275.48209366391200000000
chr2,54693484,54693757,273,-1,0,6711,1,366.30036630036600000000
chr2,54954309,54954544,235,-1,0,400954,1,425.53191489361700000000
chr2,55634246,55636188,1942,-1,0,55704,1,51.49330587023690000000
chr2,56064623,56066164,1541,-1,0,,0,0.00000000000000000000
chr2,56083410,56084012,602,-1,0,,0,0.00000000000000000000
chr2,56071106,56071397,291,-1,0,,0,0.00000000000000000000
chr2,56083521,56083856,335,-1,0,,0,0.00000000000000000000
chr2,56320841,56328599,7758,-1,0,,0,0.00000000000000000000
chr2,56338450,56341124,2674,-1,0,,0,0.00000000000000000000
chr2,56492362,56492807,445,-1,0,114800,1,224.71910112359600000000
chr2,57137586,57453805,316219,-1,0,,0,0.00000000000000000000
chr2,56892585,57175087,282502,-1,0,,0,0.00000000000000000000
chr2,57524955,57665581,140626,-1,0,,0,0.00000000000000000000
chr2,56738591,56819648,81057,-1,0,,0,0.00000000000000000000
chr2,57358986,57402258,43272,-1,0,,0,0.00000000000000000000
chr2,56719633,56753335,33702,-1,0,,0,0.00000000000000000000
chr2,57202112,57213384,11272,-1,0,,0,0.00000000000000000000
chr2,56847470,56853254,5784,-1,0,,0,0.00000000000000000000
chr2,57548937,57553598,4661,-1,0,,0,0.00000000000000000000
chr2,57007316,57012681,5365,-1,0,,0,0.00000000000000000000
chr2,56652178,56655876,3698,-1,0,,0,0.00000000000000000000
chr2,56537482,56541185,3703,-1,0,114800,1,27.00513097488520000000
chr2,57242150,57245235,3085,-1,0,,0,0.00000000000000000000
chr2,56828019,56829913,1894,-1,0,,0,0.00000000000000000000
chr2,57579799,57581978,2179,-1,0,,0,0.00000000000000000000
chr2,56654101,56655572,1471,-1,0,,0,0.00000000000000000000
chr2,57519748,57520495,747,-1,0,,0,0.00000000000000000000
chr2,57343542,57344212,670,-1,0,,0,0.00000000000000000000
chr2,57342639,57343158,519,-1,0,,0,0.00000000000000000000
chr2,56850005,56850540,535,-1,0,,0,0.00000000000000000000
chr2,57342730,57343063,333,-1,0,,0,0.00000000000000000000
chr2,56850142,56850449,307,-1,0,,0,0.00000000000000000000
chr2,57662385,57662483,98,-1,0,,0,0.00000000000000000000
chr2,57781776,57812586,30810,-1,0,,0,0.00000000000000000000
chr2,57799307,57828789,29482,-1,0,,0,0.00000000000000000000
chr2,58204643,58206771,2128,-1,0,7444,1,46.99248120300750000000
chr2,58444219,58447300,3081,-1,0,55120,1,32.45699448231090000000
chr2,59095436,59100028,4592,-1,0,,0,0.00000000000000000000
chr2,59096115,59096755,640,-1,0,,0,0.00000000000000000000
chr2,59623254,59631070,7816,-1,0,,0,0.00000000000000000000
chr2,59623588,59626793,3205,-1,0,,0,0.00000000000000000000
chr2,59623223,59624499,1276,-1,0,,0,0.00000000000000000000
chr2,59644945,59644995,50,-1,0,,0,0.00000000000000000000
chr2,59948373,59953484,5111,-1,0,,0,0.00000000000000000000
chr2,60197890,60198223,333,-1,0,,0,0.00000000000000000000
chr2,60283522,60288302,4780,-1,0,,0,0.00000000000000000000
chr2,61281810,61285743,3933,-1,0,,0,0.00000000000000000000
chr2,61390913,61395284,4371,-1,0,339804,1,22.87805994051700000000
chr2,61880172,61881103,931,-1,0,,0,0.00000000000000000000
chr2,62108513,62109327,814,-1,0,10575,1,122.85012285012300000000
chr2,62119684,62120678,994,-1,0,150684,1,100.60362173038200000000
chr2,62195589,62231861,36272,-1,0,150684,1,2.75694750771945000000
chr2,62253764,62281757,27993,-1,0,150684,1,3.57232165184153000000
chr2,62350434,62351237,803,-1,0,150684,1,124.53300124533000000000
chr2,62457098,62457426,328,-1,0,,0,0.00000000000000000000
chr2,62483218,62483685,467,-1,0,,0,0.00000000000000000000
chr2,62735625,62761236,25611,-1,0,,0,0.00000000000000000000
chr2,63540657,63565182,24525,-1,0,51057,1,4.07747196738022000000
chr2,63740965,63744106,3141,-1,0,51057,1,31.83699458771090000000
chr2,63913852,63914220,368,-1,0,,0,0.00000000000000000000
chr2,63936190,63936442,252,-1,0,,0,0.00000000000000000000
chr2,63936219,63936299,80,-1,0,,0,0.00000000000000000000
chr2,64046409,64053522,7113,-1,0,,0,0.00000000000000000000
chr2,64088316,64090026,1710,-1,0,7360,1,58.47953216374270000000
chr2,64479637,64484509,4872,-1,0,,0,0.00000000000000000000
chr2,64315568,64316369,801,-1,0,,0,0.00000000000000000000
chr2,64504829,64505224,395,-1,0,,0,0.00000000000000000000
chr2,64504926,64505087,161,-1,0,,0,0.00000000000000000000
chr2,65285629,65287169,1540,-1,0,23177,1,64.93506493506490000000
chr2,65421309,65424077,2768,-1,0,,0,0.00000000000000000000
chr2,65512706,65517508,4802,-1,0,,0,0.00000000000000000000
chr2,65596638,65597010,372,-1,0,200734,1,268.81720430107500000000
chr2,65676037,65676400,363,-1,0,,0,0.00000000000000000000
chr2,65807379,65807930,551,-1,0,,0,0.00000000000000000000
chr2,65807511,65807824,313,-1,0,,0,0.00000000000000000000
chr2,66008573,66009737,1164,-1,0,,0,0.00000000000000000000
chr2,66031537,66036242,4705,-1,0,,0,0.00000000000000000000
chr2,66157603,66160420,2817,-1,0,,0,0.00000000000000000000
chr2,66182883,66198545,15662,-1,0,,0,0.00000000000000000000
chr2,66216513,66216603,90,-1,0,,0,0.00000000000000000000
chr2,66296795,66297669,874,-1,0,,0,0.00000000000000000000
chr2,66504872,66509494,4622,-1,0,,0,0.00000000000000000000
chr2,66505611,66507517,1906,-1,0,,0,0.00000000000000000000
chr2,66978344,66983484,5140,-1,0,,0,0.00000000000000000000
chr2,67000538,67000984,446,-1,0,,0,0.00000000000000000000
chr2,67319137,67334482,15345,-1,0,,0,0.00000000000000000000
chr2,67324348,67329184,4836,-1,0,,0,0.00000000000000000000
chr2,67612191,67613282,1091,-1,0,,0,0.00000000000000000000
chr2,67679085,67679234,149,-1,0,,0,0.00000000000000000000
chr2,67758965,67766226,7261,-1,0,,0,0.00000000000000000000
chr2,67811085,67812826,1741,-1,0,,0,0.00000000000000000000
chr2,67974874,67975068,194,-1,0,,0,0.00000000000000000000
chr2,68133562,68133964,402,-1,0,,0,0.00000000000000000000
chr2,68133710,68133850,140,-1,0,,0,0.00000000000000000000
chr2,68709996,68716285,6289,-1,0,200558,1,15.90077913817780000000
chr2,69215850,69217515,1665,-1,0,,0,0.00000000000000000000
chr2,69706301,69707944,1643,-1,0,22848,1,60.86427267194160000000
chr2,69712546,69724503,11957,-1,0,22848,1,8.36330183156310000000
chr2,70017301,70026660,9359,-1,0,307,1,10.68490223314460000000
chr2,70131874,70136763,4889,-1,0,11017,1,20.45408058907750000000
chr2,70124708,70126812,2104,-1,0,11017,1,47.52851711026620000000
chr2,70125023,70125563,540,-1,0,11017,1,185.18518518518500000000
chr2,70125100,70125542,442,-1,0,11017,1,226.24434389140300000000
chr2,70308480,70309804,1324,-1,0,,0,0.00000000000000000000
chr2,70491602,70496619,5017,-1,0,51449,1,19.93223041658360000000
chr2,70552553,70552755,202,-1,0,,0,0.00000000000000000000
chr2,70661297,70662437,1140,-1,0,,0,0.00000000000000000000
chr2,70988633,70992378,3745,-1,0,119,1,26.70226969292390000000
chr2,71272622,71273081,459,-1,0,,0,0.00000000000000000000
chr2,71306420,71406793,100373,-1,0,10199;84693,2,1.99256772239546000000
chr2,71342188,71348368,6180,-1,0,84693,1,16.18122977346280000000
chr2,71392933,71396982,4049,-1,0,,0,0.00000000000000000000
chr2,71318586,71321816,3230,-1,0,,0,0.00000000000000000000
chr2,71477608,71494226,16618,-1,0,,0,0.00000000000000000000
chr2,71487393,71487887,494,-1,0,,0,0.00000000000000000000
chr2,71918468,71918923,455,-1,0,,0,0.00000000000000000000
chr2,72248920,72276837,27917,-1,0,,0,0.00000000000000000000
chr2,72906291,72914758,8467,-1,0,23233,1,11.81055863942360000000
chr2,73081487,73082528,1041,-1,0,,0,0.00000000000000000000
chr2,73106168,73108614,2446,-1,0,,0,0.00000000000000000000
chr2,73286663,73287159,496,-1,0,94097,1,201.61290322580600000000
chr2,73430828,73431356,528,-1,0,344022,1,189.39393939393900000000
chr2,73430931,73431243,312,-1,0,344022,1,320.51282051282000000000
chr2,73502970,73504022,1052,-1,0,,0,0.00000000000000000000
chr2,73718702,73719458,756,-1,0,7840,1,132.27513227513200000000
chr2,73852683,73912610,59927,-1,0,9027,1,1.66869691457940000000
chr2,73875436,73913790,38354,-1,0,,0,0.00000000000000000000
chr2,74010870,74037139,26269,-1,0,388960,1,3.80676843427614000000
chr2,74102156,74102877,721,-1,0,,0,0.00000000000000000000
chr2,74511112,74511707,595,-1,0,57835,1,168.06722689075600000000
chr2,74529478,74531291,1813,-1,0,57835,1,55.15719801434090000000
chr2,74677135,74679261,2126,-1,0,,0,0.00000000000000000000
chr2,75092068,75094418,2350,-1,0,3099,1,42.55319148936170000000
chr2,75439907,75501999,62092,-1,0,,0,0.00000000000000000000
chr2,75469985,75473210,3225,-1,0,,0,0.00000000000000000000
chr2,75908441,75910645,2204,-1,0,6936,1,45.37205081669690000000
chr2,75899429,75899499,70,-1,0,6936,1,1428.57142857143000000000
chr2,76410413,76414056,3643,-1,0,,0,0.00000000000000000000
chr2,76336925,76338100,1175,-1,0,,0,0.00000000000000000000
chr2,76543488,76593051,49563,-1,0,,0,0.00000000000000000000
chr2,76526329,76529114,2785,-1,0,,0,0.00000000000000000000
chr2,76557055,76557290,235,-1,0,,0,0.00000000000000000000
chr2,76706628,76707386,758,-1,0,,0,0.00000000000000000000
chr2,76773558,76775450,1892,-1,0,,0,0.00000000000000000000
chr2,76854211,76974469,120258,-1,0,,0,0.00000000000000000000
chr2,76930638,76953289,22651,-1,0,,0,0.00000000000000000000
chr2,76936110,76952035,15925,-1,0,,0,0.00000000000000000000
chr2,76844764,76845507,743,-1,0,,0,0.00000000000000000000
chr2,77031428,77120851,89423,-1,0,80059,1,1.11828053185422000000
chr2,77022690,77036707,14017,-1,0,80059,1,7.13419419276593000000
chr2,77100662,77102026,1364,-1,0,80059,1,73.31378299120230000000
chr2,77206763,77210742,3979,-1,0,80059,1,25.13194269917060000000
chr2,77357417,77368648,11231,-1,0,80059,1,8.90392663164456000000
chr2,77363854,77364655,801,-1,0,80059,1,124.84394506866400000000
chr2,77580168,77590060,9892,-1,0,80059,1,10.10917913465430000000
chr2,77657683,77659031,1348,-1,0,80059,1,74.18397626112760000000
chr2,77794459,77830171,35712,-1,0,,0,0.00000000000000000000
chr2,77976716,77994364,17648,-1,0,,0,0.00000000000000000000
chr2,77976758,77977091,333,-1,0,,0,0.00000000000000000000
chr2,78117887,78118360,473,-1,0,,0,0.00000000000000000000
chr2,78263800,78635554,371754,-1,0,,0,0.00000000000000000000
chr2,78701773,78732029,30256,-1,0,,0,0.00000000000000000000
chr2,78700852,78723028,22176,-1,0,,0,0.00000000000000000000
chr2,78650793,78677618,26825,-1,0,,0,0.00000000000000000000
chr2,78707539,78720834,13295,-1,0,,0,0.00000000000000000000
chr2,79331275,79340044,8769,-1,0,,0,0.00000000000000000000
chr2,79361960,79375867,13907,-1,0,,0,0.00000000000000000000
chr2,79075758,79083088,7330,-1,0,,0,0.00000000000000000000
chr2,78474689,78481207,6518,-1,0,,0,0.00000000000000000000
chr2,78707767,78712674,4907,-1,0,,0,0.00000000000000000000
chr2,78566386,78571817,5431,-1,0,,0,0.00000000000000000000
chr2,79076572,79081207,4635,-1,0,,0,0.00000000000000000000
chr2,78689668,78694005,4337,-1,0,,0,0.00000000000000000000
chr2,79077531,79081128,3597,-1,0,,0,0.00000000000000000000
chr2,78598382,78601177,2795,-1,0,,0,0.00000000000000000000
chr2,78976647,78978909,2262,-1,0,,0,0.00000000000000000000
chr2,78426995,78427963,968,-1,0,,0,0.00000000000000000000
chr2,78820045,78820722,677,-1,0,,0,0.00000000000000000000
chr2,78785748,78786358,610,-1,0,,0,0.00000000000000000000
chr2,79407949,79408345,396,-1,0,,0,0.00000000000000000000
chr2,78456141,78456585,444,-1,0,,0,0.00000000000000000000
chr2,79057629,79058008,379,-1,0,,0,0.00000000000000000000
chr2,79408041,79408284,243,-1,0,,0,0.00000000000000000000
chr2,78785959,78786161,202,-1,0,,0,0.00000000000000000000
chr2,78748474,78748668,194,-1,0,,0,0.00000000000000000000
chr2,79763388,79811631,48243,-1,0,1496,1,2.07283958294468000000
chr2,80060283,80285936,225653,-1,0,1496,1,0.44315830057654900000
chr2,80235151,80253011,17860,-1,0,1496,1,5.59910414333707000000
chr2,80427841,80428687,846,-1,0,1496,1,118.20330969267100000000
chr2,80679285,80680053,768,-1,0,1496,1,130.20833333333300000000
chr2,81073399,81074060,661,-1,0,,0,0.00000000000000000000
chr2,81522047,81559208,37161,-1,0,,0,0.00000000000000000000
chr2,81584263,81584985,722,-1,0,,0,0.00000000000000000000
chr2,81753591,81753932,341,-1,0,,0,0.00000000000000000000
chr2,81771353,81771778,425,-1,0,,0,0.00000000000000000000
chr2,81810878,81817508,6630,-1,0,,0,0.00000000000000000000
chr2,81812170,81816221,4051,-1,0,,0,0.00000000000000000000
chr2,82339682,82341903,2221,-1,0,,0,0.00000000000000000000
chr2,82362011,82362923,912,-1,0,,0,0.00000000000000000000
chr2,82340348,82340883,535,-1,0,,0,0.00000000000000000000
chr2,82362135,82362622,487,-1,0,,0,0.00000000000000000000
chr2,82340446,82340771,325,-1,0,,0,0.00000000000000000000
chr2,82362293,82362489,196,-1,0,,0,0.00000000000000000000
chr2,82541104,82547670,6566,-1,0,,0,0.00000000000000000000
chr2,82681046,82700587,19541,-1,0,,0,0.00000000000000000000
chr2,82757055,82757534,479,-1,0,,0,0.00000000000000000000
chr2,82757144,82757444,300,-1,0,,0,0.00000000000000000000
chr2,82877067,82879082,2015,-1,0,,0,0.00000000000000000000
chr2,83235809,83864013,628204,-1,0,,0,0.00000000000000000000
chr2,82992717,83310399,317682,-1,0,,0,0.00000000000000000000
chr2,83035449,83036664,1215,-1,0,,0,0.00000000000000000000
chr2,83066835,83068235,1400,-1,0,,0,0.00000000000000000000
chr2,83035649,83036420,771,-1,0,,0,0.00000000000000000000
chr2,83061237,83061674,437,-1,0,,0,0.00000000000000000000
chr2,84007107,84122344,115237,-1,0,,0,0.00000000000000000000
chr2,84100763,84106373,5610,-1,0,,0,0.00000000000000000000
chr2,84193824,84194261,437,-1,0,,0,0.00000000000000000000
chr2,84215891,84261681,45790,-1,0,,0,0.00000000000000000000
chr2,84298252,84299356,1104,-1,0,,0,0.00000000000000000000
chr2,84432452,84432774,322,-1,0,,0,0.00000000000000000000
chr2,84424389,84424536,147,-1,0,,0,0.00000000000000000000
chr2,84489992,84494819,4827,-1,0,,0,0.00000000000000000000
chr2,84679582,84683651,4069,-1,0,8802,1,24.57606291472110000000
chr2,84758340,84758857,517,-1,0,1768,1,193.42359767891700000000
chr2,84758425,84758725,300,-1,0,1768,1,333.33333333333300000000
chr2,84816748,84817530,782,-1,0,1768,1,127.87723785166200000000
chr2,85096299,85102497,6198,-1,0,129293,1,16.13423685059700000000
chr2,85174414,85175807,1393,-1,0,,0,0.00000000000000000000
chr2,85189235,85194504,5269,-1,0,,0,0.00000000000000000000
chr2,85235292,85235664,372,-1,0,56888,1,268.81720430107500000000
chr2,85326973,85327412,439,-1,0,,0,0.00000000000000000000
chr2,85326968,85327281,313,-1,0,,0,0.00000000000000000000
chr2,85335243,85335815,572,-1,0,,0,0.00000000000000000000
chr2,85335357,85335675,318,-1,0,,0,0.00000000000000000000
chr2,85518998,85519544,546,-1,0,83439,1,183.15018315018300000000
chr2,85519128,85519469,341,-1,0,83439,1,293.25513196480900000000
chr2,85893338,85893566,228,-1,0,6439,1,438.59649122807000000000
chr2,85934771,85935131,360,-1,0,,0,0.00000000000000000000
chr2,85939064,85939545,481,-1,0,,0,0.00000000000000000000
chr2,85939180,85939430,250,-1,0,,0,0.00000000000000000000
chr2,85941274,85944941,3667,-1,0,,0,0.00000000000000000000
chr2,86209202,86214486,5284,-1,0,,0,0.00000000000000000000
chr2,86570481,86570720,239,-1,0,,0,0.00000000000000000000
chr2,87428194,87986736,558542,-1,0,,0,0.00000000000000000000
chr2,87661938,87955275,293337,-1,0,,0,0.00000000000000000000
chr2,87833415,87993117,159702,-1,0,,0,0.00000000000000000000
chr2,87365744,87455172,89428,-1,0,,0,0.00000000000000000000
chr2,87635571,87755639,120068,-1,0,,0,0.00000000000000000000
chr2,87884158,87972621,88463,-1,0,,0,0.00000000000000000000
chr2,87373286,87417509,44223,-1,0,,0,0.00000000000000000000
chr2,87623175,87658903,35728,-1,0,,0,0.00000000000000000000
chr2,87819901,87830900,10999,-1,0,,0,0.00000000000000000000
chr2,87510505,87519915,9410,-1,0,,0,0.00000000000000000000
chr2,87560963,87567398,6435,-1,0,,0,0.00000000000000000000
chr2,87629019,87630959,1940,-1,0,,0,0.00000000000000000000
chr2,87627357,87627981,624,-1,0,,0,0.00000000000000000000
chr2,88206523,88206990,467,-1,0,,0,0.00000000000000000000
chr2,88317648,88319381,1733,-1,0,,0,0.00000000000000000000
chr2,88320929,88321277,348,-1,0,,0,0.00000000000000000000
chr2,89866396,91694418,1828022,-1,0,,0,0.00000000000000000000
chr2,89289201,90282686,993485,-1,0,,0,0.00000000000000000000
chr2,91631091,92257189,626098,-1,0,,0,0.00000000000000000000
chr2,89593751,90120360,526609,-1,0,,0,0.00000000000000000000
chr2,89155523,89579341,423818,-1,0,,0,0.00000000000000000000
chr2,89939302,90319590,380288,-1,0,,0,0.00000000000000000000
chr2,89146340,89392024,245684,-1,0,,0,0.00000000000000000000
chr2,89945082,90156392,211310,-1,0,,0,0.00000000000000000000
chr2,89286789,89471436,184647,-1,0,,0,0.00000000000000000000
chr2,89142208,89306951,164743,-1,0,,0,0.00000000000000000000
chr2,90133399,90300424,167025,-1,0,,0,0.00000000000000000000
chr2,90063712,90200730,137018,-1,0,,0,0.00000000000000000000
chr2,89355307,89492479,137172,-1,0,,0,0.00000000000000000000
chr2,89213589,89333765,120176,-1,0,,0,0.00000000000000000000
chr2,92062488,92143325,80837,-1,0,,0,0.00000000000000000000
chr2,89467220,89544795,77575,-1,0,,0,0.00000000000000000000
chr2,90165548,90256332,90784,-1,0,,0,0.00000000000000000000
chr2,89157354,89245437,88083,-1,0,,0,0.00000000000000000000
chr2,89340602,89441794,101192,-1,0,,0,0.00000000000000000000
chr2,89291917,89384671,92754,-1,0,,0,0.00000000000000000000
chr2,92117378,92201432,84054,-1,0,,0,0.00000000000000000000
chr2,89151247,89210313,59066,-1,0,,0,0.00000000000000000000
chr2,89245910,89300019,54109,-1,0,,0,0.00000000000000000000
chr2,90005834,90052218,46384,-1,0,,0,0.00000000000000000000
chr2,90044551,90102805,58254,-1,0,,0,0.00000000000000000000
chr2,92267942,92326018,58076,-1,0,,0,0.00000000000000000000
chr2,90211836,90249075,37239,-1,0,,0,0.00000000000000000000
chr2,89459244,89512939,53695,-1,0,,0,0.00000000000000000000
chr2,89131604,89161827,30223,-1,0,,0,0.00000000000000000000
chr2,89586092,89615315,29223,-1,0,,0,0.00000000000000000000
chr2,90093984,90118710,24726,-1,0,,0,0.00000000000000000000
chr2,89544807,89575814,31007,-1,0,,0,0.00000000000000000000
chr2,91926220,91956356,30136,-1,0,,0,0.00000000000000000000
chr2,91766750,91791889,25139,-1,0,,0,0.00000000000000000000
chr2,89275690,89293428,17738,-1,0,,0,0.00000000000000000000
chr2,90249376,90275932,26556,-1,0,,0,0.00000000000000000000
chr2,92282788,92305997,23209,-1,0,,0,0.00000000000000000000
chr2,91595321,91615828,20507,-1,0,,0,0.00000000000000000000
chr2,89239815,89259944,20129,-1,0,,0,0.00000000000000000000
chr2,90230050,90240746,10696,-1,0,,0,0.00000000000000000000
chr2,90102398,90121436,19038,-1,0,,0,0.00000000000000000000
chr2,91690328,91708371,18043,-1,0,,0,0.00000000000000000000
chr2,90044437,90061011,16574,-1,0,,0,0.00000000000000000000
chr2,89295860,89304877,9017,-1,0,,0,0.00000000000000000000
chr2,91602597,91611795,9198,-1,0,,0,0.00000000000000000000
chr2,91596635,91605932,9297,-1,0,,0,0.00000000000000000000
chr2,92291683,92300442,8759,-1,0,,0,0.00000000000000000000
chr2,91751015,91759893,8878,-1,0,,0,0.00000000000000000000
chr2,90240074,90248877,8803,-1,0,,0,0.00000000000000000000
chr2,91679836,91685504,5668,-1,0,,0,0.00000000000000000000
chr2,90459209,90464811,5602,-1,0,,0,0.00000000000000000000
chr2,89861766,89866350,4584,-1,0,,0,0.00000000000000000000
chr2,92276065,92280811,4746,-1,0,,0,0.00000000000000000000
chr2,92267769,92272409,4640,-1,0,,0,0.00000000000000000000
chr2,89028982,89032467,3485,-1,0,22934,1,28.69440459110470000000
chr2,89850418,89853975,3557,-1,0,,0,0.00000000000000000000
chr2,90160287,90163570,3283,-1,0,,0,0.00000000000000000000
chr2,92260345,92263394,3049,-1,0,,0,0.00000000000000000000
chr2,89854094,89856571,2477,-1,0,,0,0.00000000000000000000
chr2,92071674,92073865,2191,-1,0,,0,0.00000000000000000000
chr2,89159171,89161064,1893,-1,0,,0,0.00000000000000000000
chr2,91784168,91785201,1033,-1,0,,0,0.00000000000000000000
chr2,89831989,89833329,1340,-1,0,,0,0.00000000000000000000
chr2,92261461,92262703,1242,-1,0,,0,0.00000000000000000000
chr2,89840873,89841596,723,-1,0,,0,0.00000000000000000000
chr2,88821916,88822495,579,-1,0,,0,0.00000000000000000000
chr2,89160402,89160892,490,-1,0,,0,0.00000000000000000000
chr2,88600815,88601142,327,-1,0,,0,0.00000000000000000000
chr2,89075716,89075891,175,-1,0,,0,0.00000000000000000000
chr2,89853390,89853565,175,-1,0,,0,0.00000000000000000000
chr2,88429845,88429942,97,-1,0,,0,0.00000000000000000000
chr2,88352017,88352094,77,-1,0,51315,1,1298.70129870130000000000
chr2,95430229,95438514,8285,-1,0,,0,0.00000000000000000000
chr2,95474278,95475624,1346,-1,0,,0,0.00000000000000000000
chr2,95527771,95548889,21118,-1,0,150483,1,4.73529690311583000000
chr2,95604719,95607813,3094,-1,0,,0,0.00000000000000000000
chr2,95730625,95737260,6635,-1,0,,0,0.00000000000000000000
chr2,95730974,95735466,4492,-1,0,,0,0.00000000000000000000
chr2,95734183,95736609,2426,-1,0,,0,0.00000000000000000000
chr2,95936361,95938303,1942,-1,0,,0,0.00000000000000000000
chr2,96159520,96206158,46638,-1,0,,0,0.00000000000000000000
chr2,96399691,96405504,5813,-1,0,,0,0.00000000000000000000
chr2,97743587,98091847,348260,-1,0,151313;375248,2,0.57428358123241300000
chr2,98034281,98162108,127827,-1,0,57730,1,0.78230733726051600000
chr2,97740372,97821451,81079,-1,0,151313;375248,2,2.46672997940280000000
chr2,98143502,98203463,59961,-1,0,57730,1,1.66775070462467000000
chr2,97861913,97912014,50101,-1,0,375248,1,1.99596814434842000000
chr2,96534368,96583735,49367,-1,0,400986,1,2.02564466141349000000
chr2,98117996,98162143,44147,-1,0,57730,1,2.26515958049245000000
chr2,97857383,97877233,19850,-1,0,375248,1,5.03778337531486000000
chr2,98136953,98157310,20357,-1,0,57730,1,4.91231517414157000000
chr2,97876040,97899552,23512,-1,0,375248,1,4.25314732902348000000
chr2,96556623,96579733,23110,-1,0,400986,1,4.32713111207270000000
chr2,97865383,97883023,17640,-1,0,375248,1,5.66893424036281000000
chr2,97760949,97774811,13862,-1,0,,0,0.00000000000000000000
chr2,97856618,97870506,13888,-1,0,375248,1,7.20046082949309000000
chr2,97812644,97825464,12820,-1,0,375248,1,7.80031201248050000000
chr2,97850376,97858367,7991,-1,0,375248,1,12.51407833813040000000
chr2,97812087,97818346,6259,-1,0,375248,1,15.97699312989300000000
chr2,97853292,97859015,5723,-1,0,375248,1,17.47335313646690000000
chr2,97817805,97822219,4414,-1,0,375248,1,22.65518803806070000000
chr2,98168282,98172015,3733,-1,0,57730,1,26.78810608090010000000
chr2,97873210,97875928,2718,-1,0,375248,1,36.79175864606330000000
chr2,97705323,97708451,3128,-1,0,,0,0.00000000000000000000
chr2,96584391,96586825,2434,-1,0,400986,1,41.08463434675430000000
chr2,97854280,97856137,1857,-1,0,375248,1,53.85029617662900000000
chr2,97248674,97250142,1468,-1,0,,0,0.00000000000000000000
chr2,96750832,96751207,375,-1,0,,0,0.00000000000000000000
chr2,96750931,96751067,136,-1,0,,0,0.00000000000000000000
chr2,98385292,98385700,408,-1,0,23505,1,245.09803921568600000000
chr2,98544774,98547874,3100,-1,0,23505,1,32.25806451612900000000
chr2,98769100,98772378,3278,-1,0,200403,1,30.50640634533250000000
chr2,98767934,98770484,2550,-1,0,200403,1,39.21568627450980000000
chr2,98856383,98886911,30528,-1,0,200403,1,3.27568134171908000000
chr2,99752894,99753305,411,-1,0,80705,1,243.30900243309000000000
chr2,99868429,99868755,326,-1,0,254773,1,306.74846625766900000000
chr2,100103292,100105335,2043,-1,0,51455,1,48.94762604013710000000
chr2,100103689,100105020,1331,-1,0,51455,1,75.13148009015780000000
chr2,100518230,100524870,6640,-1,0,3899,1,15.06024096385540000000
chr2,100762064,100762896,832,-1,0,,0,0.00000000000000000000
chr2,101569485,101569669,184,-1,0,4862,1,543.47826086956500000000
chr2,101974831,101976480,1649,-1,0,200407,1,60.64281382656160000000
chr2,101975108,101975678,570,-1,0,200407,1,175.43859649122800000000
chr2,101975199,101975543,344,-1,0,200407,1,290.69767441860500000000
chr2,102097739,102098276,537,-1,0,,0,0.00000000000000000000
chr2,102097836,102098167,331,-1,0,,0,0.00000000000000000000
chr2,102125571,102128880,3309,-1,0,,0,0.00000000000000000000
chr2,102232549,102233569,1020,-1,0,,0,0.00000000000000000000
chr2,102302303,102306991,4688,-1,0,,0,0.00000000000000000000
chr2,102356491,102357037,546,-1,0,9448,1,183.15018315018300000000
chr2,102356600,102356915,315,-1,0,9448,1,317.46031746031700000000
chr2,102401984,102402424,440,-1,0,9448,1,227.27272727272700000000
chr2,102402139,102402294,155,-1,0,9448,1,645.16129032258100000000
chr2,102619439,102619686,247,-1,0,7850,1,404.85829959514200000000
chr2,102812039,102812104,65,-1,0,8808,1,1538.46153846154000000000
chr2,102931353,102936967,5614,-1,0,9173,1,17.81261132882080000000
chr2,102967165,102970122,2957,-1,0,9173,1,33.81805884342240000000
chr2,103109644,103110899,1255,-1,0,389015,1,79.68127490039840000000
chr2,103322494,103322958,464,-1,0,6549,1,215.51724137931000000000
chr2,103322484,103322818,334,-1,0,6549,1,299.40119760479000000000
chr2,104187012,104187257,245,-1,0,,0,0.00000000000000000000
chr2,104560474,104560592,118,-1,0,,0,0.00000000000000000000
chr2,105207929,105208698,769,-1,0,,0,0.00000000000000000000
chr2,105333667,105334494,827,-1,0,,0,0.00000000000000000000
chr2,105545529,105550075,4546,-1,0,,0,0.00000000000000000000
chr2,105662102,105665630,3528,-1,0,64965,1,28.34467120181410000000
chr2,105825911,105828661,2750,-1,0,,0,0.00000000000000000000
chr2,105791475,105794201,2726,-1,0,,0,0.00000000000000000000
chr2,106105712,106105776,64,-1,0,,0,0.00000000000000000000
chr2,106272602,106272910,308,-1,0,,0,0.00000000000000000000
chr2,106338821,106359045,20224,-1,0,,0,0.00000000000000000000
chr2,106347677,106353434,5757,-1,0,,0,0.00000000000000000000
chr2,106348632,106351288,2656,-1,0,,0,0.00000000000000000000
chr2,106388298,106391516,3218,-1,0,8440,1,31.07520198881290000000
chr2,106438736,106440734,1998,-1,0,8440,1,50.05005005005000000000
chr2,106479377,106483014,3637,-1,0,8440,1,27.49518834204010000000
chr2,106694927,106695963,1036,-1,0,,0,0.00000000000000000000
chr2,106695029,106695626,597,-1,0,,0,0.00000000000000000000
chr2,106861893,108529484,1667591,-1,0,285190;84620;653489,3,0.17990022733392100000
chr2,108499095,109170476,671381,-1,0,6819;9648;27233;285190;3987;442038;60482,7,1.04262706272593000000
chr2,106873090,106886303,13213,-1,0,,0,0.00000000000000000000
chr2,106880263,106885868,5605,-1,0,,0,0.00000000000000000000
chr2,108275309,108279108,3799,-1,0,,0,0.00000000000000000000
chr2,107899179,107903895,4716,-1,0,,0,0.00000000000000000000
chr2,108443464,108446265,2801,-1,0,285190,1,35.70153516601210000000
chr2,106882116,106885519,3403,-1,0,,0,0.00000000000000000000
chr2,108016155,108019385,3230,-1,0,,0,0.00000000000000000000
chr2,109307886,109311156,3270,-1,0,,0,0.00000000000000000000
chr2,108275313,108278207,2894,-1,0,,0,0.00000000000000000000
chr2,107418297,107420750,2453,-1,0,84620,1,40.76640847941300000000
chr2,108443922,108445724,1802,-1,0,285190,1,55.49389567147610000000
chr2,108855390,108857363,1973,-1,0,442038,1,50.68423720223010000000
chr2,108335851,108337891,2040,-1,0,,0,0.00000000000000000000
chr2,109310325,109312258,1933,-1,0,,0,0.00000000000000000000
chr2,108183226,108184700,1474,-1,0,,0,0.00000000000000000000
chr2,108855422,108856273,851,-1,0,,0,0.00000000000000000000
chr2,108054720,108055635,915,-1,0,,0,0.00000000000000000000
chr2,106938368,106938843,475,-1,0,,0,0.00000000000000000000
chr2,106930442,106930880,438,-1,0,,0,0.00000000000000000000
chr2,107926380,107926722,342,-1,0,,0,0.00000000000000000000
chr2,107408203,107408465,262,-1,0,,0,0.00000000000000000000
chr2,106890486,106890589,103,-1,0,,0,0.00000000000000000000
chr2,109064553,109064607,54,-1,0,,0,0.00000000000000000000
chr2,109541369,109541795,426,-1,0,10913,1,234.74178403755900000000
chr2,109577925,109587701,9776,-1,0,10913,1,10.22913256955810000000
chr2,109652497,109689287,36790,-1,0,,0,0.00000000000000000000
chr2,109689959,109695306,5347,-1,0,,0,0.00000000000000000000
chr2,109803451,109803611,160,-1,0,344558,1,625.00000000000000000000
chr2,110278130,110278575,445,-1,0,,0,0.00000000000000000000
chr2,110503289,111302233,798944,-1,0,84220;100288695;4867;96626;729540;7851,6,0.75099130852725600000
chr2,110717357,111073600,356243,-1,0,7851;4867,2,0.56141454007517300000
chr2,110849304,111051761,202457,-1,0,7851;4867,2,0.98786408965854500000
chr2,111619643,111771883,152240,-1,0,55289,1,0.65685759327377800000
chr2,112692499,112804609,112110,-1,0,10461,1,0.89198109000089200000
chr2,110854998,110958189,103191,-1,0,7851;4867,2,1.93815352114041000000
chr2,112649472,112740597,91125,-1,0,10461,1,1.09739368998628000000
chr2,110687667,110733386,45719,-1,0,,0,0.00000000000000000000
chr2,111154116,111197849,43733,-1,0,,0,0.00000000000000000000
chr2,110864030,110887000,22970,-1,0,7851;4867,2,8.70700914235960000000
chr2,110984449,110991311,6862,-1,0,,0,0.00000000000000000000
chr2,110986957,110991311,4354,-1,0,,0,0.00000000000000000000
chr2,111980605,111983133,2528,-1,0,,0,0.00000000000000000000
chr2,111883195,111886119,2924,-1,0,10018,1,34.19972640218880000000
chr2,112896120,112897990,1870,-1,0,129804,1,53.47593582887700000000
chr2,112871291,112873124,1833,-1,0,84910,1,54.55537370430990000000
chr2,111860371,111862181,1810,-1,0,55289,1,55.24861878453040000000
chr2,113045329,113047054,1725,-1,0,376940,1,57.97101449275360000000
chr2,112763765,112765357,1592,-1,0,10461,1,62.81407035175880000000
chr2,112872603,112873289,686,-1,0,84910,1,145.77259475218700000000
chr2,110945223,110945914,691,-1,0,4867,1,144.71780028943600000000
chr2,111576332,111576746,414,-1,0,55289,1,241.54589371980700000000
chr2,111576391,111576633,242,-1,0,55289,1,413.22314049586800000000
chr2,113461707,113485000,23293,-1,0,,0,0.00000000000000000000
chr2,113533840,113534743,903,-1,0,3552,1,110.74197120708700000000
chr2,113843603,113843908,305,-1,0,,0,0.00000000000000000000
chr2,114034314,114078615,44301,-1,0,7849,1,2.25728538859168000000
chr2,114151315,114153613,2298,-1,0,,0,0.00000000000000000000
chr2,114407875,114411323,3448,-1,0,,0,0.00000000000000000000
chr2,114444753,114445666,913,-1,0,,0,0.00000000000000000000
chr2,114526817,114531702,4885,-1,0,,0,0.00000000000000000000
chr2,114570363,114572843,2480,-1,0,,0,0.00000000000000000000
chr2,114789311,114789392,81,-1,0,,0,0.00000000000000000000
chr2,115390921,115402823,11902,-1,0,57628,1,8.40194925222652000000
chr2,115415437,115420198,4761,-1,0,57628,1,21.00399075824410000000
chr2,115397023,115400801,3778,-1,0,57628,1,26.46903123345690000000
chr2,114841794,114842800,1006,-1,0,,0,0.00000000000000000000
chr2,115254666,115255094,428,-1,0,57628,1,233.64485981308400000000
chr2,115236525,115236639,114,-1,0,57628,1,877.19298245614000000000
chr2,115254863,115254925,62,-1,0,57628,1,1612.90322580645000000000
chr2,115518802,115536588,17786,-1,0,57628,1,5.62239964016642000000
chr2,115534371,115542472,8101,-1,0,57628,1,12.34415504258730000000
chr2,115536384,115542033,5649,-1,0,57628,1,17.70224818551960000000
chr2,115627908,115639417,11509,-1,0,57628,1,8.68885220262403000000
chr2,115627790,115629606,1816,-1,0,57628,1,55.06607929515420000000
chr2,115627938,115628906,968,-1,0,57628,1,103.30578512396700000000
chr2,115628257,115628834,577,-1,0,57628,1,173.31022530329300000000
chr2,116422415,116422531,116,-1,0,57628,1,862.06896551724100000000
chr2,116501211,116503403,2192,-1,0,57628,1,45.62043795620440000000
chr2,116662062,116662653,591,-1,0,,0,0.00000000000000000000
chr2,116669550,116674096,4546,-1,0,,0,0.00000000000000000000
chr2,116974634,116978301,3667,-1,0,,0,0.00000000000000000000
chr2,116865295,116866309,1014,-1,0,,0,0.00000000000000000000
chr2,117239559,117240173,614,-1,0,,0,0.00000000000000000000
chr2,117401838,117402280,442,-1,0,,0,0.00000000000000000000
chr2,117072871,117073134,263,-1,0,,0,0.00000000000000000000
chr2,117059337,117059662,325,-1,0,,0,0.00000000000000000000
chr2,117334923,117335240,317,-1,0,,0,0.00000000000000000000
chr2,117239741,117239882,141,-1,0,,0,0.00000000000000000000
chr2,117496429,117742014,245585,-1,0,,0,0.00000000000000000000
chr2,117594347,117635101,40754,-1,0,,0,0.00000000000000000000
chr2,117728340,117736474,8134,-1,0,,0,0.00000000000000000000
chr2,117594810,117595149,339,-1,0,,0,0.00000000000000000000
chr2,117799334,117801900,2566,-1,0,,0,0.00000000000000000000
chr2,117893025,117893420,395,-1,0,,0,0.00000000000000000000
chr2,118018352,118033645,15293,-1,0,,0,0.00000000000000000000
chr2,118223801,118227165,3364,-1,0,,0,0.00000000000000000000
chr2,118384475,118410408,25933,-1,0,,0,0.00000000000000000000
chr2,118277328,118277839,511,-1,0,,0,0.00000000000000000000
chr2,118367444,118367794,350,-1,0,,0,0.00000000000000000000
chr2,118658956,118667537,8581,-1,0,,0,0.00000000000000000000
chr2,118790466,118790831,365,-1,0,,0,0.00000000000000000000
chr2,118850327,118852149,1822,-1,0,51141,1,54.88474204171240000000
chr2,118850395,118851126,731,-1,0,51141,1,136.79890560875500000000
chr2,118881382,118882284,902,-1,0,,0,0.00000000000000000000
chr2,118906139,118906294,155,-1,0,,0,0.00000000000000000000
chr2,119046646,119046935,289,-1,0,,0,0.00000000000000000000
chr2,119060214,119062855,2641,-1,0,,0,0.00000000000000000000
chr2,119223608,119233938,10330,-1,0,,0,0.00000000000000000000
chr2,119434294,119440567,6273,-1,0,,0,0.00000000000000000000
chr2,119432957,119436464,3507,-1,0,,0,0.00000000000000000000
chr2,119653319,119659374,6055,-1,0,,0,0.00000000000000000000
chr2,119713986,119714123,137,-1,0,8685,1,729.92700729927000000000
chr2,119894061,119894623,562,-1,0,,0,0.00000000000000000000
chr2,120045604,120050556,4952,-1,0,,0,0.00000000000000000000
chr2,120155186,120155621,435,-1,0,,0,0.00000000000000000000
chr2,120309458,120310761,1303,-1,0,200373,1,76.74597083653110000000
chr2,120417197,120418796,1599,-1,0,,0,0.00000000000000000000
chr2,121058440,121067671,9231,-1,0,,0,0.00000000000000000000
chr2,121078563,121078971,408,-1,0,,0,0.00000000000000000000
chr2,121091426,121142040,50614,-1,0,3625,1,1.97573793811989000000
chr2,121137319,121140830,3511,-1,0,,0,0.00000000000000000000
chr2,121427314,121428105,791,-1,0,,0,0.00000000000000000000
chr2,121590533,121592559,2026,-1,0,2736,1,49.35834155972360000000
chr2,121821022,121823882,2860,-1,0,,0,0.00000000000000000000
chr2,121797565,121799219,1654,-1,0,,0,0.00000000000000000000
chr2,121826449,121828171,1722,-1,0,,0,0.00000000000000000000
chr2,121797968,121798787,819,-1,0,,0,0.00000000000000000000
chr2,121797694,121798292,598,-1,0,,0,0.00000000000000000000
chr2,121873490,121873885,395,-1,0,,0,0.00000000000000000000
chr2,122056633,122058284,1651,-1,0,,0,0.00000000000000000000
chr2,122056856,122058005,1149,-1,0,,0,0.00000000000000000000
chr2,122057229,122057736,507,-1,0,,0,0.00000000000000000000
chr2,122058776,122059163,387,-1,0,,0,0.00000000000000000000
chr2,122058931,122059025,94,-1,0,,0,0.00000000000000000000
chr2,122092159,122093706,1547,-1,0,,0,0.00000000000000000000
chr2,122266138,122271905,5767,-1,0,23332,1,17.34003814808390000000
chr2,122314945,122315617,672,-1,0,23332,1,148.80952380952400000000
chr2,122478079,122478475,396,-1,0,,0,0.00000000000000000000
chr2,122623578,122623994,416,-1,0,,0,0.00000000000000000000
chr2,122564384,122564701,317,-1,0,,0,0.00000000000000000000
chr2,122623755,122623809,54,-1,0,,0,0.00000000000000000000
chr2,123050807,123057420,6613,-1,0,,0,0.00000000000000000000
chr2,123221825,123227654,5829,-1,0,,0,0.00000000000000000000
chr2,123369945,123370390,445,-1,0,,0,0.00000000000000000000
chr2,123364882,123365369,487,-1,0,,0,0.00000000000000000000
chr2,123477208,123482578,5370,-1,0,,0,0.00000000000000000000
chr2,123480515,123484391,3876,-1,0,,0,0.00000000000000000000
chr2,123479207,123481906,2699,-1,0,,0,0.00000000000000000000
chr2,123481320,123482407,1087,-1,0,,0,0.00000000000000000000
chr2,123481735,123482414,679,-1,0,,0,0.00000000000000000000
chr2,123616906,123616977,71,-1,0,,0,0.00000000000000000000
chr2,123676199,123765635,89436,-1,0,,0,0.00000000000000000000
chr2,124243026,124310361,67335,-1,0,,0,0.00000000000000000000
chr2,124113823,124171386,57563,-1,0,,0,0.00000000000000000000
chr2,123916006,123928995,12989,-1,0,,0,0.00000000000000000000
chr2,124157382,124160948,3566,-1,0,,0,0.00000000000000000000
chr2,124166535,124168065,1530,-1,0,,0,0.00000000000000000000
chr2,124538272,124539704,1432,-1,0,,0,0.00000000000000000000
chr2,124170173,124170633,460,-1,0,,0,0.00000000000000000000
chr2,124093018,124093466,448,-1,0,,0,0.00000000000000000000
chr2,123989133,123989464,331,-1,0,,0,0.00000000000000000000
chr2,124170255,124170585,330,-1,0,,0,0.00000000000000000000
chr2,123783288,123783518,230,-1,0,,0,0.00000000000000000000
chr2,124843519,124845746,2227,-1,0,129684,1,44.90345756623260000000
chr2,125036639,125037229,590,-1,0,129684,1,169.49152542372900000000
chr2,125428010,125428424,414,-1,0,129684,1,241.54589371980700000000
chr2,125428141,125428217,76,-1,0,129684,1,1315.78947368421000000000
chr2,125428228,125428288,60,-1,0,129684,1,1666.66666666667000000000
chr2,125435189,125438800,3611,-1,0,129684,1,27.69315978953200000000
chr2,125639400,125644866,5466,-1,0,129684,1,18.29491401390410000000
chr2,125653155,125658781,5626,-1,0,129684,1,17.77461784571630000000
chr2,125766537,125768269,1732,-1,0,,0,0.00000000000000000000
chr2,125766565,125768241,1676,-1,0,,0,0.00000000000000000000
chr2,125793122,125800796,7674,-1,0,,0,0.00000000000000000000
chr2,125863763,125864260,497,-1,0,,0,0.00000000000000000000
chr2,126443019,126452024,9005,-1,0,,0,0.00000000000000000000
chr2,126363083,126371918,8835,-1,0,,0,0.00000000000000000000
chr2,126378565,126385345,6780,-1,0,,0,0.00000000000000000000
chr2,126648387,126654042,5655,-1,0,,0,0.00000000000000000000
chr2,126814780,126820071,5291,-1,0,,0,0.00000000000000000000
chr2,126482085,126486923,4838,-1,0,,0,0.00000000000000000000
chr2,126487168,126491945,4777,-1,0,,0,0.00000000000000000000
chr2,126678195,126682044,3849,-1,0,,0,0.00000000000000000000
chr2,126368564,126371333,2769,-1,0,,0,0.00000000000000000000
chr2,126108166,126111003,2837,-1,0,,0,0.00000000000000000000
chr2,126368238,126370233,1995,-1,0,,0,0.00000000000000000000
chr2,126549710,126552150,2440,-1,0,,0,0.00000000000000000000
chr2,127044992,127047142,2150,-1,0,,0,0.00000000000000000000
chr2,126509710,126510598,888,-1,0,,0,0.00000000000000000000
chr2,127448583,127452265,3682,-1,0,2995,1,27.15915263443780000000
chr2,127674477,127678119,3642,-1,0,,0,0.00000000000000000000
chr2,127674710,127677292,2582,-1,0,,0,0.00000000000000000000
chr2,127717449,127723542,6093,-1,0,,0,0.00000000000000000000
chr2,127718886,127722341,3455,-1,0,,0,0.00000000000000000000
chr2,127926139,127929631,3492,-1,0,,0,0.00000000000000000000
chr2,128103648,128114046,10398,-1,0,,0,0.00000000000000000000
chr2,128220311,128222542,2231,-1,0,,0,0.00000000000000000000
chr2,128223693,128225835,2142,-1,0,,0,0.00000000000000000000
chr2,128551827,128554814,2987,-1,0,55339,1,33.47840642785400000000
chr2,128555677,128557236,1559,-1,0,55339,1,64.14368184733800000000
chr2,128737033,128737262,229,-1,0,79595,1,436.68122270742400000000
chr2,128737064,128737158,94,-1,0,79595,1,1063.82978723404000000000
chr2,128804235,128805248,1013,-1,0,,0,0.00000000000000000000
chr2,128812134,128813779,1645,-1,0,,0,0.00000000000000000000
chr2,128821466,128827204,5738,-1,0,,0,0.00000000000000000000
chr2,128871163,128871678,515,-1,0,56886,1,194.17475728155300000000
chr2,128871235,128871567,332,-1,0,56886,1,301.20481927710800000000
chr2,128899894,128900299,405,-1,0,56886,1,246.91358024691400000000
chr2,129098031,129098920,889,-1,0,,0,0.00000000000000000000
chr2,129239998,129242220,2222,-1,0,,0,0.00000000000000000000
chr2,129363775,129364347,572,-1,0,,0,0.00000000000000000000
chr2,129355877,129356198,321,-1,0,,0,0.00000000000000000000
chr2,129356065,129356325,260,-1,0,,0,0.00000000000000000000
chr2,129456047,129463632,7585,-1,0,,0,0.00000000000000000000
chr2,129524436,129524524,88,-1,0,,0,0.00000000000000000000
chr2,129546108,129546546,438,-1,0,,0,0.00000000000000000000
chr2,129636140,129646202,10062,-1,0,,0,0.00000000000000000000
chr2,129638530,129641896,3366,-1,0,,0,0.00000000000000000000
chr2,129638439,129640309,1870,-1,0,,0,0.00000000000000000000
chr2,129711711,129712112,401,-1,0,,0,0.00000000000000000000
chr2,129779920,129787480,7560,-1,0,,0,0.00000000000000000000
chr2,129784570,129787193,2623,-1,0,,0,0.00000000000000000000
chr2,130037097,130037407,310,-1,0,,0,0.00000000000000000000
chr2,130063760,130068055,4295,-1,0,,0,0.00000000000000000000
chr2,130373356,130386120,12764,-1,0,,0,0.00000000000000000000
chr2,130232003,130243136,11133,-1,0,,0,0.00000000000000000000
chr2,130242161,130251507,9346,-1,0,,0,0.00000000000000000000
chr2,130437985,130445392,7407,-1,0,,0,0.00000000000000000000
chr2,130249192,130255005,5813,-1,0,,0,0.00000000000000000000
chr2,130195992,130200673,4681,-1,0,,0,0.00000000000000000000
chr2,130242502,130246833,4331,-1,0,,0,0.00000000000000000000
chr2,130380436,130381555,1119,-1,0,,0,0.00000000000000000000
chr2,130355839,130356213,374,-1,0,,0,0.00000000000000000000
chr2,130492682,130493689,1007,-1,0,,0,0.00000000000000000000
chr2,130492955,130493599,644,-1,0,,0,0.00000000000000000000
chr2,130548181,130558537,10356,-1,0,,0,0.00000000000000000000
chr2,130554156,130558784,4628,-1,0,,0,0.00000000000000000000
chr2,130549382,130553557,4175,-1,0,,0,0.00000000000000000000
chr2,131413156,132206498,793342,-1,0,130074;445582;344561;150786;205147;653781;55041;50649,8,1.00839234529371000000
chr2,130804103,131157859,353756,-1,0,91409;84317;728378;26469;92856;55627;112714;80097,8,2.26144574226303000000
chr2,132028062,132290072,262010,-1,0,150786;90557;113457;653784,4,1.52665928781344000000
chr2,132353537,132505831,152294,-1,0,29798,1,0.65662468646171200000
chr2,131915726,132120621,204895,-1,0,445582;150786,2,0.97610971473193600000
chr2,131019850,131165054,145204,-1,0,92856;84317;26469,3,2.06605878625933000000
chr2,130768914,130889093,120179,-1,0,728378,1,0.83209212924055000000
chr2,132015266,132112974,97708,-1,0,445582,1,1.02345764932247000000
chr2,132429728,132493331,63603,-1,0,29798,1,1.57225288115340000000
chr2,130756826,130824718,67892,-1,0,,0,0.00000000000000000000
chr2,130692106,130767319,75213,-1,0,84084,1,1.32955739034475000000
chr2,130816499,130874650,58151,-1,0,728378,1,1.71966088287390000000
chr2,130901514,130954497,52983,-1,0,91409;112714;80097;55627,4,7.54959137836665000000
chr2,132088768,132135063,46295,-1,0,150786,1,2.16006048169349000000
chr2,132313813,132345628,31815,-1,0,,0,0.00000000000000000000
chr2,131919279,131952350,33071,-1,0,,0,0.00000000000000000000
chr2,132765384,132806315,40931,-1,0,,0,0.00000000000000000000
chr2,132437023,132471735,34712,-1,0,,0,0.00000000000000000000
chr2,130764321,130790379,26058,-1,0,,0,0.00000000000000000000
chr2,130793882,130823249,29367,-1,0,,0,0.00000000000000000000
chr2,130817330,130849250,31920,-1,0,728378,1,3.13283208020050000000
chr2,132085607,132111110,25503,-1,0,,0,0.00000000000000000000
chr2,131969202,131993658,24456,-1,0,445582,1,4.08897612037946000000
chr2,132321828,132342512,20684,-1,0,,0,0.00000000000000000000
chr2,132496530,132511956,15426,-1,0,29798,1,6.48256190846623000000
chr2,130788813,130805393,16580,-1,0,,0,0.00000000000000000000
chr2,131169076,131181069,11993,-1,0,,0,0.00000000000000000000
chr2,132063390,132073732,10342,-1,0,,0,0.00000000000000000000
chr2,131455220,131467416,12196,-1,0,,0,0.00000000000000000000
chr2,130777611,130789037,11426,-1,0,,0,0.00000000000000000000
chr2,132086850,132096586,9736,-1,0,,0,0.00000000000000000000
chr2,131639034,131647363,8329,-1,0,,0,0.00000000000000000000
chr2,130816826,130824100,7274,-1,0,,0,0.00000000000000000000
chr2,131313961,131321726,7765,-1,0,,0,0.00000000000000000000
chr2,131615149,131621491,6342,-1,0,,0,0.00000000000000000000
chr2,131424925,131428361,3436,-1,0,,0,0.00000000000000000000
chr2,132093032,132096566,3534,-1,0,,0,0.00000000000000000000
chr2,132221766,132225586,3820,-1,0,,0,0.00000000000000000000
chr2,130963334,130967323,3989,-1,0,,0,0.00000000000000000000
chr2,130954878,130957523,2645,-1,0,112714,1,37.80718336483930000000
chr2,131641440,131644966,3526,-1,0,,0,0.00000000000000000000
chr2,131425031,131428201,3170,-1,0,,0,0.00000000000000000000
chr2,130732769,130734944,2175,-1,0,,0,0.00000000000000000000
chr2,132221719,132223866,2147,-1,0,,0,0.00000000000000000000
chr2,130966471,130968219,1748,-1,0,,0,0.00000000000000000000
chr2,131893723,131894796,1073,-1,0,55041,1,93.19664492078280000000
chr2,132429590,132430501,911,-1,0,,0,0.00000000000000000000
chr2,130822743,130823387,644,-1,0,,0,0.00000000000000000000
chr2,131844254,131844749,495,-1,0,130074,1,202.02020202020200000000
chr2,132534392,132534881,489,-1,0,,0,0.00000000000000000000
chr2,132335066,132335542,476,-1,0,,0,0.00000000000000000000
chr2,131844355,131844673,318,-1,0,130074,1,314.46540880503100000000
chr2,132335227,132335335,108,-1,0,,0,0.00000000000000000000
chr2,132827401,132827674,273,-1,0,,0,0.00000000000000000000
chr2,132827428,132827593,165,-1,0,,0,0.00000000000000000000
chr2,132977803,132980492,2689,-1,0,,0,0.00000000000000000000
chr2,132995194,133001487,6293,-1,0,,0,0.00000000000000000000
chr2,132999433,133003695,4262,-1,0,,0,0.00000000000000000000
chr2,133006493,133007315,822,-1,0,,0,0.00000000000000000000
chr2,133017476,133018636,1160,-1,0,,0,0.00000000000000000000
chr2,133027369,133038887,11518,-1,0,,0,0.00000000000000000000
chr2,133039820,133045755,5935,-1,0,,0,0.00000000000000000000
chr2,133024590,133028031,3441,-1,0,,0,0.00000000000000000000
chr2,133028660,133029123,463,-1,0,,0,0.00000000000000000000
chr2,133027956,133028390,434,-1,0,,0,0.00000000000000000000
chr2,133024507,133024926,419,-1,0,,0,0.00000000000000000000
chr2,133028619,133028830,211,-1,0,,0,0.00000000000000000000
chr2,133063167,133063443,276,-1,0,,0,0.00000000000000000000
chr2,133085440,133088159,2719,-1,0,,0,0.00000000000000000000
chr2,133115531,133115804,273,-1,0,,0,0.00000000000000000000
chr2,133116377,133117077,700,-1,0,,0,0.00000000000000000000
chr2,133151347,133152306,959,-1,0,,0,0.00000000000000000000
chr2,133152407,133153373,966,-1,0,,0,0.00000000000000000000
chr2,133179977,133180922,945,-1,0,2863,1,105.82010582010600000000
chr2,133179998,133180897,899,-1,0,2863,1,111.23470522803100000000
chr2,133246370,133248433,2063,-1,0,2863,1,48.47309743092580000000
chr2,133325429,133327394,1965,-1,0,2863,1,50.89058524173030000000
chr2,133473442,133477188,3746,-1,0,344148,1,26.69514148424990000000
chr2,133657700,133736207,78507,-1,0,344148,1,1.27377176557504000000
chr2,133671170,133674401,3231,-1,0,344148,1,30.95017022593620000000
chr2,133672188,133674783,2595,-1,0,344148,1,38.53564547206170000000
chr2,133870036,134008904,138868,-1,0,344148,1,0.72010830428896500000
chr2,134091285,134120452,29167,-1,0,344148,1,3.42853224534577000000
chr2,134745641,134754097,8456,-1,0,,0,0.00000000000000000000
chr2,134966363,134970419,4056,-1,0,,0,0.00000000000000000000
chr2,134423453,134426296,2843,-1,0,,0,0.00000000000000000000
chr2,134611913,134613587,1674,-1,0,,0,0.00000000000000000000
chr2,134592038,134593369,1331,-1,0,,0,0.00000000000000000000
chr2,134544164,134544752,588,-1,0,,0,0.00000000000000000000
chr2,133873674,133874199,525,-1,0,344148,1,190.47619047619000000000
chr2,134460166,134460695,529,-1,0,,0,0.00000000000000000000
chr2,134555399,134555968,569,-1,0,,0,0.00000000000000000000
chr2,134383860,134384223,363,-1,0,,0,0.00000000000000000000
chr2,134868759,134869190,431,-1,0,,0,0.00000000000000000000
chr2,134544273,134544606,333,-1,0,,0,0.00000000000000000000
chr2,134460258,134460580,322,-1,0,,0,0.00000000000000000000
chr2,133873774,133874077,303,-1,0,344148,1,330.03300330033000000000
chr2,134995235,134995379,144,-1,0,,0,0.00000000000000000000
chr2,134383981,134384116,135,-1,0,,0,0.00000000000000000000
chr2,134765600,134765669,69,-1,0,,0,0.00000000000000000000
chr2,135260718,135262216,1498,-1,0,81615,1,66.75567423230970000000
chr2,135281899,135282599,700,-1,0,81615,1,142.85714285714300000000
chr2,135364671,135367311,2640,-1,0,81615,1,37.87878787878790000000
chr2,135487120,135491331,4211,-1,0,,0,0.00000000000000000000
chr2,135550560,135550931,371,-1,0,,0,0.00000000000000000000
chr2,135595248,135596296,1048,-1,0,130013,1,95.41984732824430000000
chr2,136098334,136101577,3243,-1,0,84083,1,30.83564600678380000000
chr2,136222606,136223102,496,-1,0,84083,1,201.61290322580600000000
chr2,136222803,136223000,197,-1,0,84083,1,507.61421319796900000000
chr2,136402687,136402773,86,-1,0,23518,1,1162.79069767442000000000
chr2,136485140,136487244,2104,-1,0,,0,0.00000000000000000000
chr2,136619665,136620071,406,-1,0,4175,1,246.30541871921200000000
chr2,136653678,136654220,542,-1,0,,0,0.00000000000000000000
chr2,136795591,136800624,5033,-1,0,,0,0.00000000000000000000
chr2,136970902,136972539,1637,-1,0,,0,0.00000000000000000000
chr2,137081940,137083043,1103,-1,0,,0,0.00000000000000000000
chr2,137266913,137273441,6528,-1,0,,0,0.00000000000000000000
chr2,137285504,137287728,2224,-1,0,,0,0.00000000000000000000
chr2,137935229,138238442,303213,-1,0,80731,1,0.32980116287890000000
chr2,138038823,138073810,34987,-1,0,80731,1,2.85820447594821000000
chr2,137983299,137984461,1162,-1,0,80731,1,86.05851979345960000000
chr2,138245293,138245657,364,-1,0,80731,1,274.72527472527500000000
chr2,137947084,137947141,57,-1,0,80731,1,1754.38596491228000000000
chr2,138275152,138278930,3778,-1,0,80731,1,26.46903123345690000000
chr2,138509195,138512350,3155,-1,0,,0,0.00000000000000000000
chr2,138489970,138490646,676,-1,0,,0,0.00000000000000000000
chr2,138469148,138469611,463,-1,0,,0,0.00000000000000000000
chr2,138490121,138490495,374,-1,0,,0,0.00000000000000000000
chr2,138499950,138500124,174,-1,0,,0,0.00000000000000000000
chr2,138499954,138500053,99,-1,0,,0,0.00000000000000000000
chr2,138611856,138613241,1385,-1,0,,0,0.00000000000000000000
chr2,138637457,138639825,2368,-1,0,,0,0.00000000000000000000
chr2,139104470,139105583,1113,-1,0,,0,0.00000000000000000000
chr2,139683083,139684464,1381,-1,0,,0,0.00000000000000000000
chr2,140196173,140210367,14194,-1,0,,0,0.00000000000000000000
chr2,139937272,139939168,1896,-1,0,,0,0.00000000000000000000
chr2,139750564,139752296,1732,-1,0,,0,0.00000000000000000000
chr2,139986795,139988018,1223,-1,0,,0,0.00000000000000000000
chr2,140116886,140117512,626,-1,0,,0,0.00000000000000000000
chr2,139942165,139942634,469,-1,0,,0,0.00000000000000000000
chr2,139975641,139976125,484,-1,0,,0,0.00000000000000000000
chr2,139987534,139987739,205,-1,0,,0,0.00000000000000000000
chr2,139987560,139987705,145,-1,0,,0,0.00000000000000000000
chr2,139942342,139942392,50,-1,0,,0,0.00000000000000000000
chr2,140522652,140574128,51476,-1,0,,0,0.00000000000000000000
chr2,140565254,140566858,1604,-1,0,,0,0.00000000000000000000
chr2,140712337,140779939,67602,-1,0,,0,0.00000000000000000000
chr2,140716326,140718792,2466,-1,0,,0,0.00000000000000000000
chr2,141301695,141301784,89,-1,0,53353,1,1123.59550561798000000000
chr2,142104517,142113396,8879,-1,0,53353,1,11.26252956414010000000
chr2,142324996,142329044,4048,-1,0,53353,1,24.70355731225300000000
chr2,142255019,142259527,4508,-1,0,53353,1,22.18278615794140000000
chr2,142325310,142327532,2222,-1,0,53353,1,45.00450045004500000000
chr2,141800488,141802369,1881,-1,0,53353,1,53.16321105794790000000
chr2,142229808,142230652,844,-1,0,53353,1,118.48341232227500000000
chr2,142350904,142351454,550,-1,0,53353,1,181.81818181818200000000
chr2,142350999,142351330,331,-1,0,53353,1,302.11480362537800000000
chr2,142394924,142397561,2637,-1,0,53353,1,37.92188092529390000000
chr2,142395980,142396598,618,-1,0,53353,1,161.81229773462800000000
chr2,142684310,142750827,66517,-1,0,53353,1,1.50337507704797000000
chr2,142788886,142789116,230,-1,0,53353,1,434.78260869565200000000
chr2,143248646,143252388,3742,-1,0,,0,0.00000000000000000000
chr2,143404047,143414701,10654,-1,0,,0,0.00000000000000000000
chr2,143434514,143435068,554,-1,0,,0,0.00000000000000000000
chr2,143434620,143434947,327,-1,0,,0,0.00000000000000000000
chr2,143667796,143670009,2213,-1,0,8942,1,45.18752824220520000000
chr2,143926134,143927709,1575,-1,0,55843,1,63.49206349206350000000
chr2,143967762,143968483,721,-1,0,55843,1,138.69625520111000000000
chr2,144514387,144517385,2998,-1,0,55843,1,33.35557038025350000000
chr2,145293470,145293537,67,-1,0,,0,0.00000000000000000000
chr2,145370104,145379789,9685,-1,0,,0,0.00000000000000000000
chr2,145480760,145485355,4595,-1,0,,0,0.00000000000000000000
chr2,145602505,145607576,5071,-1,0,,0,0.00000000000000000000
chr2,145777705,145778080,375,-1,0,,0,0.00000000000000000000
chr2,146857915,146879450,21535,-1,0,,0,0.00000000000000000000
chr2,146868235,146876313,8078,-1,0,,0,0.00000000000000000000
chr2,146861527,146866934,5407,-1,0,,0,0.00000000000000000000
chr2,146884896,146889092,4196,-1,0,,0,0.00000000000000000000
chr2,146864686,146866941,2255,-1,0,,0,0.00000000000000000000
chr2,146887556,146889531,1975,-1,0,,0,0.00000000000000000000
chr2,146952421,146952478,57,-1,0,,0,0.00000000000000000000
chr2,147411648,147414496,2848,-1,0,,0,0.00000000000000000000
chr2,147606517,147678079,71562,-1,0,,0,0.00000000000000000000
chr2,147613790,147647091,33301,-1,0,,0,0.00000000000000000000
chr2,147941322,147946801,5479,-1,0,,0,0.00000000000000000000
chr2,148169800,148171245,1445,-1,0,,0,0.00000000000000000000
chr2,148372229,148375637,3408,-1,0,,0,0.00000000000000000000
chr2,148440410,148440878,468,-1,0,,0,0.00000000000000000000
chr2,148574383,148575561,1178,-1,0,,0,0.00000000000000000000
chr2,149091754,149170115,78361,-1,0,55777,1,1.27614502112020000000
chr2,149003750,149018530,14780,-1,0,55777,1,6.76589986468200000000
chr2,149199594,149203748,4154,-1,0,55777,1,24.07318247472320000000
chr2,149248674,149250644,1970,-1,0,55777,1,50.76142131979700000000
chr2,149917486,149918696,1210,-1,0,130576,1,82.64462809917350000000
chr2,150360783,150401180,40397,-1,0,,0,0.00000000000000000000
chr2,150393047,150394616,1569,-1,0,,0,0.00000000000000000000
chr2,151031096,151038289,7193,-1,0,,0,0.00000000000000000000
chr2,150751335,150757588,6253,-1,0,,0,0.00000000000000000000
chr2,150916697,150918192,1495,-1,0,,0,0.00000000000000000000
chr2,150759214,150759748,534,-1,0,,0,0.00000000000000000000
chr2,150626971,150627299,328,-1,0,,0,0.00000000000000000000
chr2,150759300,150759621,321,-1,0,,0,0.00000000000000000000
chr2,151106271,151106331,60,-1,0,,0,0.00000000000000000000
chr2,151286583,151292934,6351,-1,0,,0,0.00000000000000000000
chr2,151351927,151395626,43699,-1,0,,0,0.00000000000000000000
chr2,151393997,151394672,675,-1,0,,0,0.00000000000000000000
chr2,151507065,151515936,8871,-1,0,,0,0.00000000000000000000
chr2,151659819,151663006,3187,-1,0,,0,0.00000000000000000000
chr2,151686657,151687970,1313,-1,0,,0,0.00000000000000000000
chr2,151785211,151789237,4026,-1,0,,0,0.00000000000000000000
chr2,151817482,151817553,71,-1,0,,0,0.00000000000000000000
chr2,151902999,151903474,475,-1,0,,0,0.00000000000000000000
chr2,151903079,151903357,278,-1,0,,0,0.00000000000000000000
chr2,152041183,152041560,377,-1,0,,0,0.00000000000000000000
chr2,153666725,153798040,131315,-1,0,,0,0.00000000000000000000
chr2,154460258,154511683,51425,-1,0,,0,0.00000000000000000000
chr2,152669188,152675760,6572,-1,0,26225,1,15.21606816798540000000
chr2,154446074,154453070,6996,-1,0,,0,0.00000000000000000000
chr2,153816400,153821747,5347,-1,0,,0,0.00000000000000000000
chr2,153795612,153799981,4369,-1,0,,0,0.00000000000000000000
chr2,153968762,153971627,2865,-1,0,,0,0.00000000000000000000
chr2,153797311,153799602,2291,-1,0,,0,0.00000000000000000000
chr2,153459935,153461273,1338,-1,0,114793,1,74.73841554559040000000
chr2,153204984,153206151,1167,-1,0,114793,1,85.68980291345330000000
chr2,153798602,153799770,1168,-1,0,,0,0.00000000000000000000
chr2,154494686,154495482,796,-1,0,,0,0.00000000000000000000
chr2,154686204,154687123,919,-1,0,,0,0.00000000000000000000
chr2,153153135,153153782,647,-1,0,,0,0.00000000000000000000
chr2,154064352,154064884,532,-1,0,,0,0.00000000000000000000
chr2,152798541,152799199,658,-1,0,785,1,151.97568389057700000000
chr2,152617200,152617733,533,-1,0,,0,0.00000000000000000000
chr2,153205213,153205787,574,-1,0,114793,1,174.21602787456400000000
chr2,154411683,154412006,323,-1,0,,0,0.00000000000000000000
chr2,153205321,153205649,328,-1,0,114793,1,304.87804878048800000000
chr2,154494938,154495150,212,-1,0,,0,0.00000000000000000000
chr2,152617301,152617616,315,-1,0,,0,0.00000000000000000000
chr2,154064577,154064680,103,-1,0,,0,0.00000000000000000000
chr2,153153406,153153494,88,-1,0,,0,0.00000000000000000000
chr2,154688070,154693685,5615,-1,0,,0,0.00000000000000000000
chr2,154886281,154899032,12751,-1,0,114805,1,7.84252215512509000000
chr2,154889616,154900388,10772,-1,0,114805,1,9.28332714444857000000
chr2,154895762,154899318,3556,-1,0,114805,1,28.12148481439820000000
chr2,154896508,154899039,2531,-1,0,114805,1,39.51007506914260000000
chr2,154863793,154864584,791,-1,0,114805,1,126.42225031605600000000
chr2,155255405,155291182,35777,-1,0,114805,1,2.79509181876625000000
chr2,155373575,155374615,1040,-1,0,,0,0.00000000000000000000
chr2,155816250,155830487,14237,-1,0,,0,0.00000000000000000000
chr2,155891177,155891494,317,-1,0,,0,0.00000000000000000000
chr2,156167417,156178903,11486,-1,0,,0,0.00000000000000000000
chr2,156188034,156188343,309,-1,0,,0,0.00000000000000000000
chr2,156385141,156385579,438,-1,0,,0,0.00000000000000000000
chr2,156656757,156656860,103,-1,0,,0,0.00000000000000000000
chr2,156733446,156741100,7654,-1,0,,0,0.00000000000000000000
chr2,156750114,156750547,433,-1,0,,0,0.00000000000000000000
chr2,156833696,156836733,3037,-1,0,,0,0.00000000000000000000
chr2,157077108,157077360,252,-1,0,,0,0.00000000000000000000
chr2,157272309,157272563,254,-1,0,,0,0.00000000000000000000
chr2,157347487,157347546,59,-1,0,2820,1,1694.91525423729000000000
chr2,157400840,157401209,369,-1,0,2820,1,271.00271002710000000000
chr2,157881403,157884898,3495,-1,0,,0,0.00000000000000000000
chr2,158119001,158119791,790,-1,0,11227,1,126.58227848101300000000
chr2,158433244,158433760,516,-1,0,130399,1,193.79844961240300000000
chr2,158433334,158433667,333,-1,0,130399,1,300.30030030030000000000
chr2,158718990,158719480,490,-1,0,90,1,204.08163265306100000000
chr2,158719057,158719386,329,-1,0,90,1,303.95136778115500000000
chr2,158973362,158979282,5920,-1,0,151531,1,16.89189189189190000000
chr2,158985296,158986222,926,-1,0,151531,1,107.99136069114500000000
chr2,159002665,159011173,8508,-1,0,,0,0.00000000000000000000
chr2,159053715,159095185,41470,-1,0,130940,1,2.41138172172655000000
chr2,159159145,159162792,3647,-1,0,130940,1,27.41979709350150000000
chr2,159222561,159289888,67327,-1,0,130940,1,1.48528822017913000000
chr2,159622267,159623096,829,-1,0,,0,0.00000000000000000000
chr2,159661935,159662905,970,-1,0,92196,1,103.09278350515500000000
chr2,159661894,159662852,958,-1,0,92196,1,104.38413361169100000000
chr2,159708090,159728686,20596,-1,0,,0,0.00000000000000000000
chr2,159724643,159740700,16057,-1,0,,0,0.00000000000000000000
chr2,159753786,159754904,1118,-1,0,,0,0.00000000000000000000
chr2,159958009,159963317,5308,-1,0,85461,1,18.83948756593820000000
chr2,159958908,159961502,2594,-1,0,85461,1,38.55050115651500000000
chr2,159959794,159961032,1238,-1,0,85461,1,80.77544426494350000000
chr2,160090239,160090569,330,-1,0,,0,0.00000000000000000000
chr2,160096215,160100204,3989,-1,0,151525,1,25.06893958385560000000
chr2,160098098,160100152,2054,-1,0,151525,1,48.68549172346640000000
chr2,160140043,160140186,143,-1,0,151525,1,699.30069930069900000000
chr2,160148952,160151840,2888,-1,0,,0,0.00000000000000000000
chr2,160290707,160291887,1180,-1,0,29994,1,84.74576271186440000000
chr2,160855777,160856290,513,-1,0,22925,1,194.93177387914200000000
chr2,160855854,160856186,332,-1,0,22925,1,301.20481927710800000000
chr2,160946148,160946625,477,-1,0,,0,0.00000000000000000000
chr2,160976806,160977303,497,-1,0,3694,1,201.20724346076500000000
chr2,161288068,161289418,1350,-1,0,5937,1,74.07407407407410000000
chr2,161392185,161392337,152,-1,0,,0,0.00000000000000000000
chr2,161678086,161703815,25729,-1,0,,0,0.00000000000000000000
chr2,161648816,161649515,699,-1,0,,0,0.00000000000000000000
chr2,161795510,161796053,543,-1,0,,0,0.00000000000000000000
chr2,161795603,161795928,325,-1,0,,0,0.00000000000000000000
chr2,162001726,162002451,725,-1,0,10010,1,137.93103448275900000000
chr2,162332268,162334045,1777,-1,0,,0,0.00000000000000000000
chr2,162446483,162449377,2894,-1,0,,0,0.00000000000000000000
chr2,163178368,163180418,2050,-1,0,25801,1,48.78048780487800000000
chr2,163189222,163190444,1222,-1,0,25801,1,81.83306055646480000000
chr2,163666308,163666858,550,-1,0,90134,1,181.81818181818200000000
chr2,163666403,163666724,321,-1,0,90134,1,311.52647975077900000000
chr2,163934119,163935796,1677,-1,0,,0,0.00000000000000000000
chr2,164144217,164144357,140,-1,0,,0,0.00000000000000000000
chr2,164165006,164165434,428,-1,0,,0,0.00000000000000000000
chr2,164171602,164175398,3796,-1,0,,0,0.00000000000000000000
chr2,164438211,164443776,5565,-1,0,,0,0.00000000000000000000
chr2,164641090,164646442,5352,-1,0,,0,0.00000000000000000000
chr2,164642842,164648662,5820,-1,0,,0,0.00000000000000000000
chr2,164642657,164645399,2742,-1,0,,0,0.00000000000000000000
chr2,164887900,164890432,2532,-1,0,,0,0.00000000000000000000
chr2,164969821,164970920,1099,-1,0,,0,0.00000000000000000000
chr2,164993268,164996167,2899,-1,0,,0,0.00000000000000000000
chr2,165006492,165006967,475,-1,0,,0,0.00000000000000000000
chr2,165614215,165647570,33355,-1,0,22837,1,2.99805126667666000000
chr2,165721520,165722357,837,-1,0,,0,0.00000000000000000000
chr2,165850017,165868546,18529,-1,0,,0,0.00000000000000000000
chr2,165853650,165864539,10889,-1,0,,0,0.00000000000000000000
chr2,166012643,166016432,3789,-1,0,6328,1,26.39218791237790000000
chr2,166014682,166017399,2717,-1,0,6328,1,36.80529996319470000000
chr2,166014715,166016196,1481,-1,0,6328,1,67.52194463200540000000
chr2,166267360,166267979,619,-1,0,,0,0.00000000000000000000
chr2,166267517,166267848,331,-1,0,,0,0.00000000000000000000
chr2,166522829,166523418,589,-1,0,80034,1,169.77928692699500000000
chr2,166522938,166523166,228,-1,0,80034,1,438.59649122807000000000
chr2,166905637,166905740,103,-1,0,6323,1,970.87378640776700000000
chr2,166972814,166973365,551,-1,0,6323,1,181.48820326678800000000
chr2,167047969,167048496,527,-1,0,,0,0.00000000000000000000
chr2,167057783,167058320,537,-1,0,6335,1,186.21973929236500000000
chr2,167058051,167058167,116,-1,0,6335,1,862.06896551724100000000
chr2,167058020,167058077,57,-1,0,6335,1,1754.38596491228000000000
chr2,167155640,167158774,3134,-1,0,6335,1,31.90810465858330000000
chr2,167447839,167448159,320,-1,0,,0,0.00000000000000000000
chr2,167447957,167448044,87,-1,0,,0,0.00000000000000000000
chr2,167545973,167547063,1090,-1,0,,0,0.00000000000000000000
chr2,167550017,167550632,615,-1,0,,0,0.00000000000000000000
chr2,167550064,167550422,358,-1,0,,0,0.00000000000000000000
chr2,167550218,167550294,76,-1,0,,0,0.00000000000000000000
chr2,167701628,167703864,2236,-1,0,,0,0.00000000000000000000
chr2,167844789,167851489,6700,-1,0,129446,1,14.92537313432840000000
chr2,167944226,167950588,6362,-1,0,129446,1,15.71832756994660000000
chr2,168024328,168074725,50397,-1,0,129446,1,1.98424509395401000000
chr2,168163123,168188595,25472,-1,0,,0,0.00000000000000000000
chr2,168172822,168185293,12471,-1,0,,0,0.00000000000000000000
chr2,168174637,168176399,1762,-1,0,,0,0.00000000000000000000
chr2,168489804,168617595,127791,-1,0,,0,0.00000000000000000000
chr2,168401736,168452758,51022,-1,0,,0,0.00000000000000000000
chr2,168666481,168667317,836,-1,0,,0,0.00000000000000000000
chr2,168845267,168848834,3567,-1,0,27347,1,28.03476310625180000000
chr2,168895628,168896453,825,-1,0,27347,1,121.21212121212100000000
chr2,168895801,168896175,374,-1,0,27347,1,267.37967914438500000000
chr2,169135324,169146462,11138,-1,0,,0,0.00000000000000000000
chr2,169266498,169297906,31408,-1,0,,0,0.00000000000000000000
chr2,169332766,169335724,2958,-1,0,253782,1,33.80662609871530000000
chr2,169395341,169395888,547,-1,0,253782,1,182.81535648994500000000
chr2,169395462,169395779,317,-1,0,253782,1,315.45741324921100000000
chr2,169587010,169588192,1182,-1,0,253782,1,84.60236886632820000000
chr2,169605952,169606398,446,-1,0,253782,1,224.21524663677100000000
chr2,169606136,169606212,76,-1,0,253782,1,1315.78947368421000000000
chr2,169886202,169886591,389,-1,0,8647,1,257.06940874036000000000
chr2,170104942,170111323,6381,-1,0,4036,1,15.67152483936690000000
chr2,170155436,170155818,382,-1,0,4036,1,261.78010471204200000000
chr2,170419176,170962610,543434,-1,0,6741;79675;129881;130507;151230;29081;493911;100526832;9360,9,1.65613487562427000000
chr2,170641292,170644103,2811,-1,0,,0,0.00000000000000000000
chr2,170646278,170647888,1610,-1,0,,0,0.00000000000000000000
chr2,170816848,170817874,1026,-1,0,130507,1,97.46588693957110000000
chr2,170747046,170747586,540,-1,0,130507,1,185.18518518518500000000
chr2,170992004,170992342,338,-1,0,,0,0.00000000000000000000
chr2,170609558,170609694,136,-1,0,,0,0.00000000000000000000
chr2,171568947,171573607,4660,-1,0,389058,1,21.45922746781120000000
chr2,171929204,171932703,3499,-1,0,9874,1,28.57959416976280000000
chr2,172363551,172363693,142,-1,0,,0,0.00000000000000000000
chr2,172664711,172664831,120,-1,0,8604,1,833.33333333333300000000
chr2,172832508,172841060,8552,-1,0,8520,1,11.69317118802620000000
chr2,172905677,172911330,5653,-1,0,254042,1,17.68972227136030000000
chr2,172907551,172911245,3694,-1,0,254042,1,27.07092582566320000000
chr2,172906256,172910597,4341,-1,0,254042,1,23.03616678184750000000
chr2,173004245,173007477,3232,-1,0,,0,0.00000000000000000000
chr2,173147823,173148279,456,-1,0,,0,0.00000000000000000000
chr2,173148031,173148112,81,-1,0,,0,0.00000000000000000000
chr2,173179817,173186159,6342,-1,0,,0,0.00000000000000000000
chr2,173302483,173304467,1984,-1,0,3655,1,50.40322580645160000000
chr2,173391384,173392557,1173,-1,0,,0,0.00000000000000000000
chr2,173554463,173556239,1776,-1,0,,0,0.00000000000000000000
chr2,173702799,173704453,1654,-1,0,11069,1,60.45949214026600000000
chr2,173888919,173889247,328,-1,0,11069,1,304.87804878048800000000
chr2,174151784,174152103,319,-1,0,,0,0.00000000000000000000
chr2,174198555,174199027,472,-1,0,,0,0.00000000000000000000
chr2,174198600,174198909,309,-1,0,,0,0.00000000000000000000
chr2,174327525,174330824,3299,-1,0,,0,0.00000000000000000000
chr2,174540657,174549359,8702,-1,0,,0,0.00000000000000000000
chr2,174602717,174603086,369,-1,0,,0,0.00000000000000000000
chr2,174602620,174602933,313,-1,0,,0,0.00000000000000000000
chr2,174719200,174722262,3062,-1,0,,0,0.00000000000000000000
chr2,174797187,174801033,3846,-1,0,6670,1,26.00104004160170000000
chr2,175090582,175090994,412,-1,0,29789,1,242.71844660194200000000
chr2,175169137,175171521,2384,-1,0,,0,0.00000000000000000000
chr2,175459208,175459670,462,-1,0,7456,1,216.45021645021600000000
chr2,175459317,175459571,254,-1,0,7456,1,393.70078740157500000000
chr2,175507338,175508400,1062,-1,0,7456,1,94.16195856873820000000
chr2,175767678,175773758,6080,-1,0,1123,1,16.44736842105260000000
chr2,175839158,175841875,2717,-1,0,1123,1,36.80529996319470000000
chr2,175910707,175911105,398,-1,0,,0,0.00000000000000000000
chr2,176102037,176105741,3704,-1,0,,0,0.00000000000000000000
chr2,176102520,176102865,345,-1,0,,0,0.00000000000000000000
chr2,176189915,176190482,567,-1,0,,0,0.00000000000000000000
chr2,176190117,176190260,143,-1,0,,0,0.00000000000000000000
chr2,176190166,176190307,141,-1,0,,0,0.00000000000000000000
chr2,176203314,176211285,7971,-1,0,,0,0.00000000000000000000
chr2,176345585,176352993,7408,-1,0,,0,0.00000000000000000000
chr2,176637439,176637854,415,-1,0,,0,0.00000000000000000000
chr2,176709474,176709730,256,-1,0,,0,0.00000000000000000000
chr2,177265637,177272042,6405,-1,0,,0,0.00000000000000000000
chr2,177351997,177356248,4251,-1,0,,0,0.00000000000000000000
chr2,177402889,177403194,305,-1,0,,0,0.00000000000000000000
chr2,177591365,177591807,442,-1,0,,0,0.00000000000000000000
chr2,177799384,177802746,3362,-1,0,,0,0.00000000000000000000
chr2,178215917,178216496,579,-1,0,,0,0.00000000000000000000
chr2,178287640,178288054,414,-1,0,8540,1,241.54589371980700000000
chr2,178351796,178354183,2387,-1,0,8540,1,41.89359028068710000000
chr2,178547472,178547878,406,-1,0,50940,1,246.30541871921200000000
chr2,178740972,178742102,1130,-1,0,50940,1,88.49557522123890000000
chr2,178836849,178849057,12208,-1,0,50940,1,8.19134993446920000000
chr2,178839013,178843637,4624,-1,0,50940,1,21.62629757785470000000
chr2,178843326,178847606,4280,-1,0,50940,1,23.36448598130840000000
chr2,178844656,178847499,2843,-1,0,50940,1,35.17411185367570000000
chr2,178855454,178857215,1761,-1,0,50940,1,56.78591709256100000000
chr2,178857971,178859122,1151,-1,0,50940,1,86.88097306689830000000
chr2,178856393,178857199,806,-1,0,50940,1,124.06947890818900000000
chr2,179058529,179059941,1412,-1,0,114880,1,70.82152974504250000000
chr2,179117115,179117878,763,-1,0,114880,1,131.06159895150700000000
chr2,179300819,179307621,6802,-1,0,8575,1,14.70155836518670000000
chr2,179308168,179314564,6396,-1,0,8575,1,15.63477173233270000000
chr2,179296929,179300898,3969,-1,0,8575,1,25.19526329050140000000
chr2,179296223,179296972,749,-1,0,8575,1,133.51134846461900000000
chr2,179315159,179315679,520,-1,0,8575,1,192.30769230769200000000
chr2,179516754,179528734,11980,-1,0,7273,1,8.34724540901503000000
chr2,179684884,179833992,149108,-1,0,285025,1,0.67065482737344700000
chr2,179853356,179888071,34715,-1,0,285025,1,2.88059916462624000000
chr2,180065246,180082028,16782,-1,0,91404,1,5.95876534382076000000
chr2,180068960,180084395,15435,-1,0,91404,1,6.47878198898607000000
chr2,180067189,180079129,11940,-1,0,91404,1,8.37520938023451000000
chr2,180069250,180070882,1632,-1,0,91404,1,61.27450980392160000000
chr2,180226941,180227524,583,-1,0,,0,0.00000000000000000000
chr2,180287846,180301159,13313,-1,0,,0,0.00000000000000000000
chr2,180381520,180382298,778,-1,0,151126,1,128.53470437018000000000
chr2,180411379,180422286,10907,-1,0,151126,1,9.16842394792335000000
chr2,180412217,180421761,9544,-1,0,151126,1,10.47778709136630000000
chr2,180416653,180421961,5308,-1,0,151126,1,18.83948756593820000000
chr2,180419518,180421556,2038,-1,0,151126,1,49.06771344455350000000
chr2,180422116,180422514,398,-1,0,151126,1,251.25628140703500000000
chr2,180422226,180422317,91,-1,0,151126,1,1098.90109890110000000000
chr2,180680757,180683762,3005,-1,0,151126,1,33.27787021630620000000
chr2,181316554,181319283,2729,-1,0,,0,0.00000000000000000000
chr2,181320657,181323648,2991,-1,0,,0,0.00000000000000000000
chr2,181453905,181454632,727,-1,0,,0,0.00000000000000000000
chr2,181796943,181798957,2014,-1,0,,0,0.00000000000000000000
chr2,181925748,181926255,507,-1,0,10477,1,197.23865877712000000000
chr2,181925837,181926147,310,-1,0,10477,1,322.58064516129000000000
chr2,182355879,182356387,508,-1,0,3676,1,196.85039370078700000000
chr2,182355968,182356285,317,-1,0,3676,1,315.45741324921100000000
chr2,182443195,182445142,1947,-1,0,375298,1,51.36106831022090000000
chr2,182565120,182565695,575,-1,0,,0,0.00000000000000000000
chr2,182565255,182565583,328,-1,0,,0,0.00000000000000000000
chr2,182592433,182592777,344,-1,0,,0,0.00000000000000000000
chr2,182733509,182735834,2325,-1,0,,0,0.00000000000000000000
chr2,182856589,182857902,1313,-1,0,151242,1,76.16146230007620000000
chr2,182856879,182857578,699,-1,0,151242,1,143.06151645207400000000
chr2,183028668,183029793,1125,-1,0,5136,1,88.88888888888890000000
chr2,183055169,183061780,6611,-1,0,5136,1,15.12630464377550000000
chr2,183053633,183059013,5380,-1,0,5136,1,18.58736059479550000000
chr2,183090389,183091634,1245,-1,0,5136,1,80.32128514056230000000
chr2,183315713,183316219,506,-1,0,5136,1,197.62845849802400000000
chr2,183315805,183316137,332,-1,0,5136,1,301.20481927710800000000
chr2,183354499,183354972,473,-1,0,5136,1,211.41649048625800000000
chr2,183354699,183354801,102,-1,0,5136,1,980.39215686274500000000
chr2,183510389,183573563,63174,-1,0,,0,0.00000000000000000000
chr2,183931901,183932130,229,-1,0,,0,0.00000000000000000000
chr2,183989624,183990193,569,-1,0,129401,1,175.74692442882200000000
chr2,184074812,184111405,36593,-1,0,,0,0.00000000000000000000
chr2,184085768,184093989,8221,-1,0,,0,0.00000000000000000000
chr2,184084039,184089995,5956,-1,0,,0,0.00000000000000000000
chr2,184085514,184090985,5471,-1,0,,0,0.00000000000000000000
chr2,184085956,184088515,2559,-1,0,,0,0.00000000000000000000
chr2,184249960,184250353,393,-1,0,,0,0.00000000000000000000
chr2,184591857,184601558,9701,-1,0,,0,0.00000000000000000000
chr2,184498548,184502791,4243,-1,0,,0,0.00000000000000000000
chr2,184625004,184628486,3482,-1,0,,0,0.00000000000000000000
chr2,184601730,184604744,3014,-1,0,,0,0.00000000000000000000
chr2,184581836,184583584,1748,-1,0,,0,0.00000000000000000000
chr2,184602735,184604185,1450,-1,0,,0,0.00000000000000000000
chr2,184546900,184547514,614,-1,0,,0,0.00000000000000000000
chr2,184546947,184547086,139,-1,0,,0,0.00000000000000000000
chr2,184377624,184377689,65,-1,0,,0,0.00000000000000000000
chr2,184686659,184699375,12716,-1,0,,0,0.00000000000000000000
chr2,184796789,184810120,13331,-1,0,,0,0.00000000000000000000
chr2,184789551,184802433,12882,-1,0,,0,0.00000000000000000000
chr2,184794469,184804089,9620,-1,0,,0,0.00000000000000000000
chr2,184794355,184801710,7355,-1,0,,0,0.00000000000000000000
chr2,184976030,185316560,340530,-1,0,,0,0.00000000000000000000
chr2,185294086,185349040,54954,-1,0,,0,0.00000000000000000000
chr2,185015958,185061628,45670,-1,0,,0,0.00000000000000000000
chr2,185098153,185139088,40935,-1,0,,0,0.00000000000000000000
chr2,185246639,185264960,18321,-1,0,,0,0.00000000000000000000
chr2,184913226,184927833,14607,-1,0,,0,0.00000000000000000000
chr2,184921022,184931631,10609,-1,0,,0,0.00000000000000000000
chr2,185257044,185264698,7654,-1,0,,0,0.00000000000000000000
chr2,185117285,185121986,4701,-1,0,,0,0.00000000000000000000
chr2,184848764,184850438,1674,-1,0,,0,0.00000000000000000000
chr2,184958034,184958266,232,-1,0,,0,0.00000000000000000000
chr2,186442384,186865011,422627,-1,0,,0,0.00000000000000000000
chr2,186459490,186563985,104495,-1,0,,0,0.00000000000000000000
chr2,186848494,186955495,107001,-1,0,,0,0.00000000000000000000
chr2,186524963,186594400,69437,-1,0,,0,0.00000000000000000000
chr2,186184726,186218201,33475,-1,0,,0,0.00000000000000000000
chr2,186927714,186959347,31633,-1,0,,0,0.00000000000000000000
chr2,186740874,186748877,8003,-1,0,,0,0.00000000000000000000
chr2,187025307,187029285,3978,-1,0,,0,0.00000000000000000000
chr2,186808531,186811948,3417,-1,0,,0,0.00000000000000000000
chr2,186568001,186568238,237,-1,0,,0,0.00000000000000000000
chr2,187437091,187437302,211,-1,0,,0,0.00000000000000000000
chr2,187656558,187658040,1482,-1,0,,0,0.00000000000000000000
chr2,187674602,187676518,1916,-1,0,,0,0.00000000000000000000
chr2,188119627,188141961,22334,-1,0,,0,0.00000000000000000000
chr2,188096547,188105764,9217,-1,0,,0,0.00000000000000000000
chr2,188215630,188216153,523,-1,0,10203,1,191.20458891013400000000
chr2,188215734,188216042,308,-1,0,10203,1,324.67532467532500000000
chr2,188123062,188123125,63,-1,0,,0,0.00000000000000000000
chr2,188384252,188389770,5518,-1,0,7035,1,18.12250815512870000000
chr2,188505053,188505649,596,-1,0,,0,0.00000000000000000000
chr2,188505186,188505539,353,-1,0,,0,0.00000000000000000000
chr2,188638274,188642307,4033,-1,0,,0,0.00000000000000000000
chr2,188732861,188733106,245,-1,0,,0,0.00000000000000000000
chr2,188955325,188995921,40596,-1,0,,0,0.00000000000000000000
chr2,189030910,189038554,7644,-1,0,,0,0.00000000000000000000
chr2,189119617,189120984,1367,-1,0,,0,0.00000000000000000000
chr2,189119920,189120953,1033,-1,0,,0,0.00000000000000000000
chr2,189267177,189277267,10090,-1,0,51454,1,9.91080277502478000000
chr2,189567887,189581230,13343,-1,0,,0,0.00000000000000000000
chr2,189730544,189740089,9545,-1,0,,0,0.00000000000000000000
chr2,189844897,189845377,480,-1,0,1281,1,208.33333333333300000000
chr2,189845071,189845176,105,-1,0,1281,1,952.38095238095300000000
chr2,189845122,189845200,78,-1,0,1281,1,1282.05128205128000000000
chr2,189969626,189970389,763,-1,0,1290,1,131.06159895150700000000
chr2,190095838,190102914,7076,-1,0,,0,0.00000000000000000000
chr2,190989265,190994405,5140,-1,0,,0,0.00000000000000000000
chr2,191230475,191231051,576,-1,0,3628,1,173.61111111111100000000
chr2,191248508,191248810,302,-1,0,,0,0.00000000000000000000
chr2,191680600,191681077,477,-1,0,,0,0.00000000000000000000
chr2,191680786,191680881,95,-1,0,,0,0.00000000000000000000
chr2,191918870,191918961,91,-1,0,6775,1,1098.90109890110000000000
chr2,191995121,191998655,3534,-1,0,6775,1,28.29654782116580000000
chr2,192562081,192562639,558,-1,0,,0,0.00000000000000000000
chr2,192559350,192559876,526,-1,0,,0,0.00000000000000000000
chr2,192562212,192562559,347,-1,0,,0,0.00000000000000000000
chr2,192809386,192810317,931,-1,0,,0,0.00000000000000000000
chr2,193111683,193182237,70554,-1,0,,0,0.00000000000000000000
chr2,193376302,193441409,65107,-1,0,,0,0.00000000000000000000
chr2,193388798,193428663,39865,-1,0,,0,0.00000000000000000000
chr2,193554624,193559152,4528,-1,0,,0,0.00000000000000000000
chr2,193562994,193566788,3794,-1,0,,0,0.00000000000000000000
chr2,193393004,193394764,1760,-1,0,,0,0.00000000000000000000
chr2,193355315,193355775,460,-1,0,,0,0.00000000000000000000
chr2,193355408,193355719,311,-1,0,,0,0.00000000000000000000
chr2,194089306,194090173,867,-1,0,,0,0.00000000000000000000
chr2,194112803,194113588,785,-1,0,,0,0.00000000000000000000
chr2,194287569,194288809,1240,-1,0,,0,0.00000000000000000000
chr2,194367722,194505291,137569,-1,0,,0,0.00000000000000000000
chr2,194398400,194398944,544,-1,0,,0,0.00000000000000000000
chr2,194398504,194398843,339,-1,0,,0,0.00000000000000000000
chr2,194581353,194598372,17019,-1,0,,0,0.00000000000000000000
chr2,194655743,194715328,59585,-1,0,,0,0.00000000000000000000
chr2,194689486,194698819,9333,-1,0,,0,0.00000000000000000000
chr2,194690810,194693025,2215,-1,0,,0,0.00000000000000000000
chr2,194740986,194741383,397,-1,0,,0,0.00000000000000000000
chr2,194810980,194813532,2552,-1,0,,0,0.00000000000000000000
chr2,194833624,194838644,5020,-1,0,,0,0.00000000000000000000
chr2,194910598,194988202,77604,-1,0,,0,0.00000000000000000000
chr2,194923525,194961076,37551,-1,0,,0,0.00000000000000000000
chr2,194914300,194914716,416,-1,0,,0,0.00000000000000000000
chr2,194913532,194913651,119,-1,0,,0,0.00000000000000000000
chr2,195060325,195224144,163819,-1,0,,0,0.00000000000000000000
chr2,195122401,195122494,93,-1,0,,0,0.00000000000000000000
chr2,195271342,195318047,46705,-1,0,,0,0.00000000000000000000
chr2,195669488,195700264,30776,-1,0,,0,0.00000000000000000000
chr2,195312384,195326327,13943,-1,0,,0,0.00000000000000000000
chr2,195363037,195367724,4687,-1,0,,0,0.00000000000000000000
chr2,195689087,195691677,2590,-1,0,,0,0.00000000000000000000
chr2,195297140,195298450,1310,-1,0,,0,0.00000000000000000000
chr2,195477627,195477734,107,-1,0,,0,0.00000000000000000000
chr2,195946657,195948707,2050,-1,0,,0,0.00000000000000000000
chr2,195979432,195984620,5188,-1,0,,0,0.00000000000000000000
chr2,195979674,195983771,4097,-1,0,,0,0.00000000000000000000
chr2,195981145,195985842,4697,-1,0,,0,0.00000000000000000000
chr2,195979975,195982611,2636,-1,0,,0,0.00000000000000000000
chr2,196031217,196031736,519,-1,0,,0,0.00000000000000000000
chr2,196031300,196031620,320,-1,0,,0,0.00000000000000000000
chr2,196051737,196052223,486,-1,0,,0,0.00000000000000000000
chr2,196051816,196052076,260,-1,0,,0,0.00000000000000000000
chr2,196089206,196094884,5678,-1,0,,0,0.00000000000000000000
chr2,196162917,196164327,1410,-1,0,,0,0.00000000000000000000
chr2,196172289,196174029,1740,-1,0,,0,0.00000000000000000000
chr2,196214813,196215226,413,-1,0,,0,0.00000000000000000000
chr2,196428160,196428639,479,-1,0,,0,0.00000000000000000000
chr2,196984910,197022555,37645,-1,0,9262,1,2.65639527161642000000
chr2,196736270,196736857,587,-1,0,56171,1,170.35775127768300000000
chr2,196908267,196908931,664,-1,0,56171,1,150.60240963855400000000
chr2,196736410,196736690,280,-1,0,56171,1,357.14285714285700000000
chr2,197614616,197614948,332,-1,0,,0,0.00000000000000000000
chr2,198141651,198143228,1577,-1,0,91526,1,63.41154090044390000000
chr2,198758197,198761597,3400,-1,0,5334,1,29.41176470588240000000
chr2,198894511,198894648,137,-1,0,5334,1,729.92700729927000000000
chr2,199686246,199696233,9987,-1,0,,0,0.00000000000000000000
chr2,199793912,199794692,780,-1,0,,0,0.00000000000000000000
chr2,200178762,200183454,4692,-1,0,23314,1,21.31287297527710000000
chr2,200312013,200313191,1178,-1,0,23314,1,84.88964346349740000000
chr2,200312344,200312850,506,-1,0,23314,1,197.62845849802400000000
chr2,200312454,200312679,225,-1,0,23314,1,444.44444444444400000000
chr2,200530319,200530480,161,-1,0,,0,0.00000000000000000000
chr2,200530394,200530483,89,-1,0,,0,0.00000000000000000000
chr2,201071891,201072039,148,-1,0,,0,0.00000000000000000000
chr2,201071893,201071982,89,-1,0,,0,0.00000000000000000000
chr2,201691158,201691675,517,-1,0,,0,0.00000000000000000000
chr2,201691337,201691479,142,-1,0,,0,0.00000000000000000000
chr2,201691352,201691445,93,-1,0,,0,0.00000000000000000000
chr2,201697994,201705515,7521,-1,0,,0,0.00000000000000000000
chr2,201836474,201837354,880,-1,0,,0,0.00000000000000000000
chr2,202063525,202076935,13410,-1,0,843,1,7.45712155108128000000
chr2,202146512,202149742,3230,-1,0,841,1,30.95975232198140000000
chr2,202373679,202374998,1319,-1,0,151254,1,75.81501137225170000000
chr2,202489707,202530742,41035,-1,0,58538;65062,2,4.87388814426709000000
chr2,202549777,202550225,448,-1,0,58538,1,223.21428571428600000000
chr2,202603787,202604883,1096,-1,0,57679,1,91.24087591240880000000
chr2,202721549,202722104,555,-1,0,65061,1,180.18018018018000000000
chr2,202721648,202721970,322,-1,0,65061,1,310.55900621118000000000
chr2,202730670,202732464,1794,-1,0,65061,1,55.74136008918620000000
chr2,202730582,202731469,887,-1,0,65061,1,112.73957158962800000000
chr2,202768585,202768654,69,-1,0,,0,0.00000000000000000000
chr2,202779660,202780367,707,-1,0,,0,0.00000000000000000000
chr2,202897994,202900914,2920,-1,0,8324,1,34.24657534246580000000
chr2,203219375,203222586,3211,-1,0,,0,0.00000000000000000000
chr2,203240536,203286422,45886,-1,0,659,1,2.17931395196792000000
chr2,203284470,203319281,34811,-1,0,659,1,2.87265519519692000000
chr2,203294448,203313721,19273,-1,0,659,1,5.18860582161573000000
chr2,203344118,203344921,803,-1,0,659,1,124.53300124533000000000
chr2,203896087,203904092,8005,-1,0,65065,1,12.49219237976260000000
chr2,203899048,203904296,5248,-1,0,65065,1,19.05487804878050000000
chr2,203899785,203901985,2200,-1,0,65065,1,45.45454545454550000000
chr2,204181511,204191653,10142,-1,0,,0,0.00000000000000000000
chr2,205185024,205185556,532,-1,0,,0,0.00000000000000000000
chr2,205185254,205185318,64,-1,0,,0,0.00000000000000000000
chr2,205343841,205349173,5332,-1,0,,0,0.00000000000000000000
chr2,206113655,206121796,8141,-1,0,117583,1,12.28350325512840000000
chr2,205706118,205712049,5931,-1,0,117583,1,16.86056314280900000000
chr2,206128030,206129886,1856,-1,0,117583,1,53.87931034482760000000
chr2,205517452,205519248,1796,-1,0,117583,1,55.67928730512250000000
chr2,205999193,205999705,512,-1,0,117583,1,195.31250000000000000000
chr2,205922135,205922221,86,-1,0,117583,1,1162.79069767442000000000
chr2,206412730,206417533,4803,-1,0,117583,1,20.82032063293770000000
chr2,206730511,206732175,1664,-1,0,,0,0.00000000000000000000
chr2,206731080,206731612,532,-1,0,,0,0.00000000000000000000
chr2,206731194,206731516,322,-1,0,,0,0.00000000000000000000
chr2,206845198,206845314,116,-1,0,,0,0.00000000000000000000
chr2,206853436,206853714,278,-1,0,,0,0.00000000000000000000
chr2,206853472,206853630,158,-1,0,,0,0.00000000000000000000
chr2,206999220,207000267,1047,-1,0,4719,1,95.51098376313280000000
chr2,207239345,207239561,216,-1,0,,0,0.00000000000000000000
chr2,207706307,207708113,1806,-1,0,,0,0.00000000000000000000
chr2,207860699,207868122,7423,-1,0,,0,0.00000000000000000000
chr2,208037738,208041889,4151,-1,0,,0,0.00000000000000000000
chr2,208144304,208147088,2784,-1,0,,0,0.00000000000000000000
chr2,208227000,208231938,4938,-1,0,,0,0.00000000000000000000
chr2,208317086,208317834,748,-1,0,,0,0.00000000000000000000
chr2,208351032,208359578,8546,-1,0,,0,0.00000000000000000000
chr2,208355581,208359123,3542,-1,0,,0,0.00000000000000000000
chr2,208472418,208476810,4392,-1,0,151194,1,22.76867030965390000000
chr2,208534461,208534615,154,-1,0,,0,0.00000000000000000000
chr2,208567120,208567615,495,-1,0,,0,0.00000000000000000000
chr2,208567225,208567514,289,-1,0,,0,0.00000000000000000000
chr2,208664901,208667072,2171,-1,0,,0,0.00000000000000000000
chr2,208706922,208709326,2404,-1,0,389072,1,41.59733777038270000000
chr2,208910238,208910679,441,-1,0,,0,0.00000000000000000000
chr2,208910295,208910635,340,-1,0,,0,0.00000000000000000000
chr2,208934450,208941969,7519,-1,0,,0,0.00000000000000000000
chr2,208959060,208959536,476,-1,0,,0,0.00000000000000000000
chr2,208959122,208959408,286,-1,0,,0,0.00000000000000000000
chr2,208970009,208974010,4001,-1,0,,0,0.00000000000000000000
chr2,209030814,209056034,25220,-1,0,389073,1,3.96510705789056000000
chr2,209061041,209061617,576,-1,0,,0,0.00000000000000000000
chr2,209061168,209061491,323,-1,0,,0,0.00000000000000000000
chr2,209080701,209086780,6079,-1,0,,0,0.00000000000000000000
chr2,209090117,209097449,7332,-1,0,,0,0.00000000000000000000
chr2,209232919,209247881,14962,-1,0,5746,1,6.68359844940516000000
chr2,209451629,209452142,513,-1,0,,0,0.00000000000000000000
chr2,209451713,209452047,334,-1,0,,0,0.00000000000000000000
chr2,209492307,209496405,4098,-1,0,,0,0.00000000000000000000
chr2,209942506,209949628,7122,-1,0,,0,0.00000000000000000000
chr2,210405218,210406360,1142,-1,0,4133,1,87.56567425569180000000
chr2,210970756,210972028,1272,-1,0,151050,1,78.61635220125790000000
chr2,211360860,211368609,7749,-1,0,1373,1,12.90489095367140000000
chr2,211768322,211779827,11505,-1,0,,0,0.00000000000000000000
chr2,211770577,211770677,100,-1,0,,0,0.00000000000000000000
chr2,211915796,211918393,2597,-1,0,,0,0.00000000000000000000
chr2,211923687,211923783,96,-1,0,,0,0.00000000000000000000
chr2,211923740,211923820,80,-1,0,,0,0.00000000000000000000
chr2,212078740,212080498,1758,-1,0,,0,0.00000000000000000000
chr2,212161289,212161841,552,-1,0,,0,0.00000000000000000000
chr2,212161649,212162282,633,-1,0,,0,0.00000000000000000000
chr2,212161549,212161608,59,-1,0,,0,0.00000000000000000000
chr2,212182588,212182647,59,-1,0,,0,0.00000000000000000000
chr2,212351033,212415917,64884,-1,0,2066,1,1.54121200912398000000
chr2,212551148,212551675,527,-1,0,2066,1,189.75332068311200000000
chr2,212551235,212551553,318,-1,0,2066,1,314.46540880503100000000
chr2,212699860,212700300,440,-1,0,2066,1,227.27272727272700000000
chr2,212700016,212700115,99,-1,0,2066,1,1010.10101010101000000000
chr2,212771238,212775158,3920,-1,0,2066,1,25.51020408163270000000
chr2,212801884,212809327,7443,-1,0,2066,1,13.43544269783690000000
chr2,213155534,213209659,54125,-1,0,2066,1,1.84757505773672000000
chr2,213161044,213190817,29773,-1,0,2066,1,3.35874785879824000000
chr2,213353284,213380976,27692,-1,0,2066,1,3.61115123501372000000
chr2,213180156,213191590,11434,-1,0,2066,1,8.74584572328144000000
chr2,213184822,213200920,16098,-1,0,2066,1,6.21195179525407000000
chr2,213183948,213192015,8067,-1,0,2066,1,12.39618197595140000000
chr2,213329622,213333205,3583,-1,0,2066,1,27.90957298353340000000
chr2,213370142,213371163,1021,-1,0,2066,1,97.94319294809010000000
chr2,213415552,213422084,6532,-1,0,,0,0.00000000000000000000
chr2,213525898,213526368,470,-1,0,,0,0.00000000000000000000
chr2,213530298,213530617,319,-1,0,,0,0.00000000000000000000
chr2,213574568,213575121,553,-1,0,,0,0.00000000000000000000
chr2,213574671,213574980,309,-1,0,,0,0.00000000000000000000
chr2,213620974,213624781,3807,-1,0,,0,0.00000000000000000000
chr2,214062241,214069564,7323,-1,0,,0,0.00000000000000000000
chr2,214349755,214354593,4838,-1,0,79582,1,20.66969822240600000000
chr2,214353519,214353815,296,-1,0,79582,1,337.83783783783800000000
chr2,214507061,214507644,583,-1,0,79582,1,171.52658662092600000000
chr2,214507265,214507566,301,-1,0,79582,1,332.22591362126200000000
chr2,214582997,214586545,3548,-1,0,79582,1,28.18489289740700000000
chr2,214775076,214775630,554,-1,0,79582,1,180.50541516245500000000
chr2,214775197,214775523,326,-1,0,79582,1,306.74846625766900000000
chr2,214778070,214778630,560,-1,0,79582,1,178.57142857142900000000
chr2,214778312,214778378,66,-1,0,79582,1,1515.15151515152000000000
chr2,214844894,214845147,253,-1,0,79582,1,395.25691699604700000000
chr2,214874698,214876217,1519,-1,0,79582,1,65.83278472679390000000
chr2,214874781,214876013,1232,-1,0,79582,1,81.16883116883120000000
chr2,214874714,214875462,748,-1,0,79582,1,133.68983957219300000000
chr2,214983474,214983577,103,-1,0,79582,1,970.87378640776700000000
chr2,214988939,214993863,4924,-1,0,79582,1,20.30869212022750000000
chr2,215015410,215016552,1142,-1,0,79582,1,87.56567425569180000000
chr2,215338162,215338873,711,-1,0,402117,1,140.64697609001400000000
chr2,215505189,215556815,51626,-1,0,,0,0.00000000000000000000
chr2,215627220,215630338,3118,-1,0,580,1,32.07184092366900000000
chr2,215649747,215651008,1261,-1,0,580,1,79.30214115781130000000
chr2,215728761,215730832,2071,-1,0,,0,0.00000000000000000000
chr2,215729365,215730811,1446,-1,0,,0,0.00000000000000000000
chr2,215729926,215730788,862,-1,0,,0,0.00000000000000000000
chr2,215749410,215750065,655,-1,0,,0,0.00000000000000000000
chr2,215749621,215749832,211,-1,0,,0,0.00000000000000000000
chr2,216105953,216106892,939,-1,0,,0,0.00000000000000000000
chr2,216858678,216859452,774,-1,0,55686,1,129.19896640826900000000
chr2,216782105,216782545,440,-1,0,,0,0.00000000000000000000
chr2,216473072,216473210,138,-1,0,,0,0.00000000000000000000
chr2,216553785,216553919,134,-1,0,,0,0.00000000000000000000
chr2,216920214,216923455,3241,-1,0,55825,1,30.85467448318420000000
chr2,217089762,217092931,3169,-1,0,,0,0.00000000000000000000
chr2,217092662,217093230,568,-1,0,,0,0.00000000000000000000
chr2,217092788,217093127,339,-1,0,,0,0.00000000000000000000
chr2,217158345,217158727,382,-1,0,57574,1,261.78010471204200000000
chr2,217378248,217379877,1629,-1,0,,0,0.00000000000000000000
chr2,217955893,217957269,1376,-1,0,,0,0.00000000000000000000
chr2,218254695,218259374,4679,-1,0,,0,0.00000000000000000000
chr2,218257516,218259613,2097,-1,0,,0,0.00000000000000000000
chr2,218397956,218399494,1538,-1,0,,0,0.00000000000000000000
chr2,218321855,218322145,290,-1,0,,0,0.00000000000000000000
chr2,218673869,218674278,409,-1,0,7145,1,244.49877750611200000000
chr2,218963629,218968145,4516,-1,0,,0,0.00000000000000000000
chr2,219025752,219027249,1497,-1,0,,0,0.00000000000000000000
chr2,219282216,219297298,15082,-1,0,7429,1,6.63042036865137000000
chr2,219275007,219289676,14669,-1,0,7429,1,6.81709727997819000000
chr2,219521368,219523401,2033,-1,0,7701,1,49.18839153959670000000
chr2,219931777,219932062,285,-1,0,,0,0.00000000000000000000
chr2,220052724,220056271,3547,-1,0,,0,0.00000000000000000000
chr2,220053677,220055941,2264,-1,0,,0,0.00000000000000000000
chr2,220052314,220052928,614,-1,0,,0,0.00000000000000000000
chr2,220053862,220054293,431,-1,0,,0,0.00000000000000000000
chr2,220232631,220233144,513,-1,0,,0,0.00000000000000000000
chr2,220321604,220321679,75,-1,0,10290,1,1333.33333333333000000000
chr2,220748040,220748436,396,-1,0,,0,0.00000000000000000000
chr2,220753993,220760339,6346,-1,0,,0,0.00000000000000000000
chr2,220946253,220946714,461,-1,0,,0,0.00000000000000000000
chr2,220994454,220995414,960,-1,0,,0,0.00000000000000000000
chr2,221046078,221046202,124,-1,0,,0,0.00000000000000000000
chr2,221568793,221572220,3427,-1,0,,0,0.00000000000000000000
chr2,221394021,221396754,2733,-1,0,,0,0.00000000000000000000
chr2,221345920,221346273,353,-1,0,,0,0.00000000000000000000
chr2,221688327,221688654,327,-1,0,,0,0.00000000000000000000
chr2,221818443,221818937,494,-1,0,,0,0.00000000000000000000
chr2,221818628,221818705,77,-1,0,,0,0.00000000000000000000
chr2,221818709,221818774,65,-1,0,,0,0.00000000000000000000
chr2,221882973,221883170,197,-1,0,,0,0.00000000000000000000
chr2,222064681,222074454,9773,-1,0,,0,0.00000000000000000000
chr2,222065883,222067409,1526,-1,0,,0,0.00000000000000000000
chr2,222085745,222090611,4866,-1,0,,0,0.00000000000000000000
chr2,222230250,222233624,3374,-1,0,,0,0.00000000000000000000
chr2,222231403,222232891,1488,-1,0,,0,0.00000000000000000000
chr2,222232840,222233422,582,-1,0,,0,0.00000000000000000000
chr2,222370004,222402188,32184,-1,0,2043,1,3.10713397961720000000
chr2,222388274,222388580,306,-1,0,2043,1,326.79738562091500000000
chr2,222532315,222540219,7904,-1,0,,0,0.00000000000000000000
chr2,222678538,222681045,2507,-1,0,,0,0.00000000000000000000
chr2,222725415,222725798,383,-1,0,,0,0.00000000000000000000
chr2,222987807,222989651,1844,-1,0,,0,0.00000000000000000000
chr2,223481551,223482162,611,-1,0,10056,1,163.66612111293000000000
chr2,223481675,223481998,323,-1,0,10056,1,309.59752321981400000000
chr2,223759947,223762881,2934,-1,0,2181,1,34.08316291751870000000
chr2,223797345,223797711,366,-1,0,2181,1,273.22404371584700000000
chr2,223824809,223827930,3121,-1,0,,0,0.00000000000000000000
chr2,223865067,223869907,4840,-1,0,,0,0.00000000000000000000
chr2,223866445,223870092,3647,-1,0,,0,0.00000000000000000000
chr2,224031099,224031514,415,-1,0,,0,0.00000000000000000000
chr2,224142330,224144126,1796,-1,0,,0,0.00000000000000000000
chr2,224473100,224473334,234,-1,0,,0,0.00000000000000000000
chr2,224501070,224501490,420,-1,0,,0,0.00000000000000000000
chr2,224550923,224579919,28996,-1,0,,0,0.00000000000000000000
chr2,224619248,224619847,599,-1,0,,0,0.00000000000000000000
chr2,225094753,225097139,2386,-1,0,,0,0.00000000000000000000
chr2,225097544,225101048,3504,-1,0,,0,0.00000000000000000000
chr2,225161403,225166826,5423,-1,0,,0,0.00000000000000000000
chr2,225219888,225220548,660,-1,0,,0,0.00000000000000000000
chr2,225240822,225242859,2037,-1,0,,0,0.00000000000000000000
chr2,225292993,225293946,953,-1,0,,0,0.00000000000000000000
chr2,225468702,225470713,2011,-1,0,,0,0.00000000000000000000
chr2,225516571,225527837,11266,-1,0,,0,0.00000000000000000000
chr2,225520875,225523150,2275,-1,0,,0,0.00000000000000000000
chr2,225735957,225737632,1675,-1,0,55619,1,59.70149253731340000000
chr2,225883184,225883471,287,-1,0,55619,1,348.43205574912900000000
chr2,225883235,225883402,167,-1,0,55619,1,598.80239520958100000000
chr2,226039582,226040061,479,-1,0,,0,0.00000000000000000000
chr2,226191348,226195791,4443,-1,0,,0,0.00000000000000000000
chr2,226453495,226463227,9732,-1,0,57624,1,10.27538018906700000000
chr2,226954980,226962183,7203,-1,0,,0,0.00000000000000000000
chr2,226831974,226838391,6417,-1,0,,0,0.00000000000000000000
chr2,226829124,226831010,1886,-1,0,,0,0.00000000000000000000
chr2,226744283,226745248,965,-1,0,,0,0.00000000000000000000
chr2,227017546,227017816,270,-1,0,,0,0.00000000000000000000
chr2,227165070,227171523,6453,-1,0,,0,0.00000000000000000000
chr2,227332124,227347817,15693,-1,0,,0,0.00000000000000000000
chr2,227342429,227347474,5045,-1,0,,0,0.00000000000000000000
chr2,227333975,227335836,1861,-1,0,,0,0.00000000000000000000
chr2,227334260,227335389,1129,-1,0,,0,0.00000000000000000000
chr2,227447563,227448331,768,-1,0,,0,0.00000000000000000000
chr2,227515284,227515817,533,-1,0,,0,0.00000000000000000000
chr2,227562650,227563933,1283,-1,0,,0,0.00000000000000000000
chr2,227681548,227681718,170,-1,0,,0,0.00000000000000000000
chr2,227910985,227912262,1277,-1,0,1286,1,78.30853563038370000000
chr2,228058714,228058769,55,-1,0,1285,1,1818.18181818182000000000
chr2,228194474,228195292,818,-1,0,56947,1,122.24938875305600000000
chr2,228195498,228197130,1632,-1,0,56947,1,61.27450980392160000000
chr2,228230687,228234040,3353,-1,0,79853,1,29.82403817476890000000
chr2,228268917,228270066,1149,-1,0,,0,0.00000000000000000000
chr2,228473772,228482461,8689,-1,0,56918,1,11.50880423524000000000
chr2,228604225,228613391,9166,-1,0,,0,0.00000000000000000000
chr2,228652565,228658041,5476,-1,0,,0,0.00000000000000000000
chr2,228642291,228642754,463,-1,0,,0,0.00000000000000000000
chr2,229128827,229128964,137,-1,0,,0,0.00000000000000000000
chr2,229148266,229149280,1014,-1,0,,0,0.00000000000000000000
chr2,229264324,229268332,4008,-1,0,,0,0.00000000000000000000
chr2,229266525,229268307,1782,-1,0,,0,0.00000000000000000000
chr2,229303216,229307714,4498,-1,0,,0,0.00000000000000000000
chr2,229337669,229364036,26367,-1,0,,0,0.00000000000000000000
chr2,229410647,229423072,12425,-1,0,,0,0.00000000000000000000
chr2,229448465,229453244,4779,-1,0,,0,0.00000000000000000000
chr2,229449675,229453192,3517,-1,0,,0,0.00000000000000000000
chr2,229449486,229452006,2520,-1,0,,0,0.00000000000000000000
chr2,229758646,229760391,1745,-1,0,,0,0.00000000000000000000
chr2,229759105,229759896,791,-1,0,,0,0.00000000000000000000
chr2,229759532,229760241,709,-1,0,,0,0.00000000000000000000
chr2,229957742,229958239,497,-1,0,55022,1,201.20724346076500000000
chr2,229956768,229956954,186,-1,0,55022,1,537.63440860215100000000
chr2,229949563,229949659,96,-1,0,55022,1,1041.66666666667000000000
chr2,230003576,230004010,434,-1,0,55022,1,230.41474654377900000000
chr2,230003699,230003824,125,-1,0,55022,1,800.00000000000000000000
chr2,230049236,230049530,294,-1,0,55022,1,340.13605442176900000000
chr2,230256905,230259106,2201,-1,0,92737,1,45.43389368468880000000
chr2,230319246,230327986,8740,-1,0,92737,1,11.44164759725400000000
chr2,230800888,230815959,15071,-1,0,130888,1,6.63525977042001000000
chr2,230834264,230838325,4061,-1,0,130888,1,24.62447672986950000000
chr2,230877111,230879671,2560,-1,0,130888,1,39.06250000000000000000
chr2,231150792,231250658,99866,-1,0,11262;93349,2,2.00268359601866000000
chr2,231325189,231325745,556,-1,0,6672,1,179.85611510791400000000
chr2,231207809,231208377,568,-1,0,93349,1,176.05633802816900000000
chr2,231325294,231325637,343,-1,0,6672,1,291.54518950437300000000
chr2,231401453,231401513,60,-1,0,6672,1,1666.66666666667000000000
chr2,231564425,231567650,3225,-1,0,,0,0.00000000000000000000
chr2,231658920,231662256,3336,-1,0,51719,1,29.97601918465230000000
chr2,231670612,231673813,3201,-1,0,51719,1,31.24023742580440000000
chr2,231705935,231706912,977,-1,0,,0,0.00000000000000000000
chr2,231844774,231844864,90,-1,0,,0,0.00000000000000000000
chr2,231884082,231885260,1178,-1,0,,0,0.00000000000000000000
chr2,231918460,231920403,1943,-1,0,,0,0.00000000000000000000
chr2,231995169,231996948,1779,-1,0,5707,1,56.21135469364810000000
chr2,231996078,231996608,530,-1,0,5707,1,188.67924528301900000000
chr2,231996174,231996507,333,-1,0,5707,1,300.30030030030000000000
chr2,232114317,232114954,637,-1,0,80210,1,156.98587127158600000000
chr2,232397068,232400180,3112,-1,0,,0,0.00000000000000000000
chr2,232434338,232439548,5210,-1,0,,0,0.00000000000000000000
chr2,232617470,232622154,4684,-1,0,5147,1,21.34927412467980000000
chr2,232678303,232678450,147,-1,0,,0,0.00000000000000000000
chr2,232686858,232714631,27773,-1,0,,0,0.00000000000000000000
chr2,233197249,233309154,111905,-1,0,250;251;129563,3,2.68084535990349000000
chr2,233242373,233277635,35262,-1,0,250;251,2,5.67182803017413000000
chr2,233187928,233226636,38708,-1,0,129563,1,2.58344528262891000000
chr2,233249143,233272886,23743,-1,0,251,1,4.21176767889483000000
chr2,233224671,233233700,9029,-1,0,,0,0.00000000000000000000
chr2,233214123,233224329,10206,-1,0,,0,0.00000000000000000000
chr2,233292859,233296587,3728,-1,0,,0,0.00000000000000000000
chr2,233197618,233198211,593,-1,0,129563,1,168.63406408094400000000
chr2,233332722,233333475,753,-1,0,,0,0.00000000000000000000
chr2,233392920,233396243,3323,-1,0,1144,1,30.09328919650920000000
chr2,233364545,233364739,194,-1,0,,0,0.00000000000000000000
chr2,233668277,233668780,503,-1,0,26058,1,198.80715705765400000000
chr2,233668373,233668690,317,-1,0,26058,1,315.45741324921100000000
chr2,233764214,233765425,1211,-1,0,25791,1,82.57638315441780000000
chr2,233764717,233765112,395,-1,0,25791,1,253.16455696202500000000
chr2,233827012,233828293,1281,-1,0,25791,1,78.06401249024200000000
chr2,233859834,233860227,393,-1,0,25791,1,254.45292620865100000000
chr2,233909874,233911322,1448,-1,0,,0,0.00000000000000000000
chr2,233920612,233920661,49,-1,0,,0,0.00000000000000000000
chr2,233930281,233930357,76,-1,0,3635,1,1315.78947368421000000000
chr2,234089312,234089627,315,-1,0,3635,1,317.46031746031700000000
chr2,234089382,234089534,152,-1,0,3635,1,657.89473684210500000000
chr2,234140203,234141620,1417,-1,0,,0,0.00000000000000000000
chr2,234476188,234477690,1502,-1,0,,0,0.00000000000000000000
chr2,234533999,234586844,52845,-1,0,54575;54600;54576,3,5.67697984672154000000
chr2,234619050,234638133,19083,-1,0,54576;54575;54657;54659;54579;54578;54600;54577,8,41.92212964418590000000
chr2,234941985,234957010,15025,-1,0,,0,0.00000000000000000000
chr2,234932267,234945490,13223,-1,0,,0,0.00000000000000000000
chr2,234652907,234664718,11811,-1,0,54576;54575;54657;54659;54579;54578;54600;54577,8,67.73346880027090000000
chr2,234648378,234658485,10107,-1,0,54576;54575;54657;54659;414061;54579;54578;54600;54577,9,89.04719501335710000000
chr2,234991345,234994872,3527,-1,0,,0,0.00000000000000000000
chr2,234631476,234633986,2510,-1,0,54576;54575;54657;54579;54578;54600;54577,7,278.88446215139400000000
chr2,234543317,234544993,1676,-1,0,54576,1,59.66587112171840000000
chr2,235259876,235261494,1618,-1,0,,0,0.00000000000000000000
chr2,234699026,234699411,385,-1,0,339766,1,259.74025974026000000000
chr2,235554095,235558437,4342,-1,0,,0,0.00000000000000000000
chr2,235563442,235571877,8435,-1,0,,0,0.00000000000000000000
chr2,235714291,235716227,1936,-1,0,,0,0.00000000000000000000
chr2,235812173,235812674,501,-1,0,,0,0.00000000000000000000
chr2,235812266,235812577,311,-1,0,,0,0.00000000000000000000
chr2,235840989,235843319,2330,-1,0,,0,0.00000000000000000000
chr2,235919215,235919825,610,-1,0,23677,1,163.93442622950800000000
chr2,235919291,235919706,415,-1,0,23677,1,240.96385542168700000000
chr2,235946836,235947049,213,-1,0,23677,1,469.48356807511700000000
chr2,236010734,236011379,645,-1,0,,0,0.00000000000000000000
chr2,236010925,236011112,187,-1,0,,0,0.00000000000000000000
chr2,236094667,236094997,330,-1,0,,0,0.00000000000000000000
chr2,236433798,236435105,1307,-1,0,116987,1,76.51109410864580000000
chr2,236434580,236434879,299,-1,0,116987,1,334.44816053511700000000
chr2,236637556,236639243,1687,-1,0,116987,1,59.27682276229990000000
chr2,236643587,236643732,145,-1,0,116987,1,689.65517241379300000000
chr2,236742139,236742717,578,-1,0,116987,1,173.01038062283700000000
chr2,239004701,239076100,71399,-1,0,339768;151176;377007;51540,4,5.60231936021513000000
chr2,239026571,239050489,23918,-1,0,377007;339768,2,8.36190316916130000000
chr2,238553513,238559378,5865,-1,0,9208,1,17.05029838022170000000
chr2,238309953,238315392,5439,-1,0,1293,1,18.38573267144700000000
chr2,238450829,238453999,3170,-1,0,79083,1,31.54574132492110000000
chr2,239456817,239460234,3417,-1,0,,0,0.00000000000000000000
chr2,239500110,239503042,2932,-1,0,,0,0.00000000000000000000
chr2,239147272,239149789,2517,-1,0,55502,1,39.72983710766790000000
chr2,239626159,239627513,1354,-1,0,,0,0.00000000000000000000
chr2,238451903,238453939,2036,-1,0,79083,1,49.11591355599210000000
chr2,239482926,239484867,1941,-1,0,,0,0.00000000000000000000
chr2,237333266,237335186,1920,-1,0,79781,1,52.08333333333330000000
chr2,238451411,238453161,1750,-1,0,79083,1,57.14285714285710000000
chr2,239500369,239501722,1353,-1,0,,0,0.00000000000000000000
chr2,237899313,237900507,1194,-1,0,,0,0.00000000000000000000
chr2,238430496,238431221,725,-1,0,79083,1,137.93103448275900000000
chr2,237537272,237537978,706,-1,0,,0,0.00000000000000000000
chr2,238962369,238962938,569,-1,0,,0,0.00000000000000000000
chr2,239204647,239205337,690,-1,0,,0,0.00000000000000000000
chr2,237355510,237356219,709,-1,0,79781,1,141.04372355430200000000
chr2,239409275,239409836,561,-1,0,,0,0.00000000000000000000
chr2,237623269,237623832,563,-1,0,,0,0.00000000000000000000
chr2,238451221,238451715,494,-1,0,79083,1,202.42914979757100000000
chr2,238506574,238507069,495,-1,0,,0,0.00000000000000000000
chr2,238746300,238746695,395,-1,0,375316,1,253.16455696202500000000
chr2,237537480,237537814,334,-1,0,,0,0.00000000000000000000
chr2,239409370,239409696,326,-1,0,,0,0.00000000000000000000
chr2,237939410,237939667,257,-1,0,,0,0.00000000000000000000
chr2,238962658,238962840,182,-1,0,,0,0.00000000000000000000
chr2,238373409,238373616,207,-1,0,,0,0.00000000000000000000
chr2,237537514,237537709,195,-1,0,,0,0.00000000000000000000
chr2,238501643,238501832,189,-1,0,,0,0.00000000000000000000
chr2,238474174,238474286,112,-1,0,,0,0.00000000000000000000
chr2,238506728,238506847,119,-1,0,,0,0.00000000000000000000
chr2,237701896,237701969,73,-1,0,,0,0.00000000000000000000
chr2,239718209,239719156,947,-1,0,,0,0.00000000000000000000
chr2,239779609,239780265,656,-1,0,117581,1,152.43902439024400000000
chr2,239886765,239886920,155,-1,0,,0,0.00000000000000000000
chr2,239902389,239902563,174,-1,0,,0,0.00000000000000000000
chr2,239942791,239942849,58,-1,0,,0,0.00000000000000000000
chr2,240046228,240046723,495,-1,0,9759,1,202.02020202020200000000
chr2,240077814,240090796,12982,-1,0,9759,1,7.70297334771222000000
chr2,240153203,240153856,653,-1,0,9759,1,153.13935681470100000000
chr2,240153397,240153704,307,-1,0,9759,1,325.73289902280100000000
chr2,240201530,240204795,3265,-1,0,9759,1,30.62787136294030000000
chr2,240202946,240204516,1570,-1,0,9759,1,63.69426751592360000000
chr2,240202641,240203036,395,-1,0,9759,1,253.16455696202500000000
chr2,240321920,240323255,1335,-1,0,9759,1,74.90636704119850000000
chr2,240386289,240389913,3624,-1,0,,0,0.00000000000000000000
chr2,240389384,240389681,297,-1,0,,0,0.00000000000000000000
chr2,240398247,240398523,276,-1,0,,0,0.00000000000000000000
chr2,240564693,240565140,447,-1,0,,0,0.00000000000000000000
chr2,240511436,240511497,61,-1,0,,0,0.00000000000000000000
chr2,240641024,240641602,578,-1,0,,0,0.00000000000000000000
chr2,240640979,240641273,294,-1,0,,0,0.00000000000000000000
chr2,240739427,240739961,534,-1,0,,0,0.00000000000000000000
chr2,240838335,240838861,526,-1,0,,0,0.00000000000000000000
chr2,240853889,240854527,638,-1,0,,0,0.00000000000000000000
chr2,240854571,240854854,283,-1,0,,0,0.00000000000000000000
chr2,240958814,240959392,578,-1,0,4705,1,173.01038062283700000000
chr2,240958950,240959278,328,-1,0,4705,1,304.87804878048800000000
chr2,240979828,240982387,2559,-1,0,,0,0.00000000000000000000
chr2,240981367,240982202,835,-1,0,,0,0.00000000000000000000
chr2,241045437,241045826,389,-1,0,,0,0.00000000000000000000
chr2,241047613,241048254,641,-1,0,,0,0.00000000000000000000
chr2,241047928,241048327,399,-1,0,,0,0.00000000000000000000
chr2,241050042,241050451,409,-1,0,,0,0.00000000000000000000
chr2,241086797,241087687,890,-1,0,,0,0.00000000000000000000
chr2,241087075,241087520,445,-1,0,,0,0.00000000000000000000
chr2,241272505,241346677,74172,-1,0,,0,0.00000000000000000000
chr2,241206434,241210737,4303,-1,0,,0,0.00000000000000000000
chr2,241097004,241098576,1572,-1,0,,0,0.00000000000000000000
chr2,241133705,241134678,973,-1,0,,0,0.00000000000000000000
chr2,241097896,241098500,604,-1,0,,0,0.00000000000000000000
chr2,241200172,241200852,680,-1,0,,0,0.00000000000000000000
chr2,241241800,241242445,645,-1,0,,0,0.00000000000000000000
chr2,241120672,241121182,510,-1,0,,0,0.00000000000000000000
chr2,241156831,241157259,428,-1,0,,0,0.00000000000000000000
chr2,241124841,241125290,449,-1,0,,0,0.00000000000000000000
chr2,241125042,241125419,377,-1,0,,0,0.00000000000000000000
chr2,241120890,241121083,193,-1,0,,0,0.00000000000000000000
chr2,241120939,241121063,124,-1,0,,0,0.00000000000000000000
chr2,241120933,241120988,55,-1,0,,0,0.00000000000000000000
chr2,241504496,241505857,1361,-1,0,,0,0.00000000000000000000
chr2,241579470,241580427,957,-1,0,,0,0.00000000000000000000
chr2,241579444,241579847,403,-1,0,,0,0.00000000000000000000
chr2,241613457,241648340,34883,-1,0,375318;653437,2,5.73345182467104000000
chr2,241647129,241670792,23663,-1,0,547,1,4.22600684613109000000
chr2,241862567,241872680,10113,-1,0,,0,0.00000000000000000000
chr2,241781642,241783173,1531,-1,0,,0,0.00000000000000000000
chr2,241847018,241848801,1783,-1,0,,0,0.00000000000000000000
chr2,241862870,241864207,1337,-1,0,,0,0.00000000000000000000
chr2,241758533,241759899,1366,-1,0,547,1,73.20644216691070000000
chr2,241718416,241718973,557,-1,0,547,1,179.53321364452400000000
chr2,241787478,241787814,336,-1,0,,0,0.00000000000000000000
chr2,241911808,241922505,10697,-1,0,,0,0.00000000000000000000
chr2,241915648,241923136,7488,-1,0,,0,0.00000000000000000000
chr2,241892249,241892990,741,-1,0,,0,0.00000000000000000000
chr2,242000801,242017600,16799,-1,0,25992,1,5.95273528186202000000
chr2,242017582,242018346,764,-1,0,25992,1,130.89005235602100000000
chr2,242007539,242007939,400,-1,0,25992,1,250.00000000000000000000
chr2,242032715,242033193,478,-1,0,25992;130916,2,418.41004184100400000000
chr2,242048170,242048700,530,-1,0,23178,1,188.67924528301900000000
chr2,242055234,242055614,380,-1,0,23178,1,263.15789473684200000000
chr2,242144321,242146627,2306,-1,0,50636,1,43.36513443191670000000
chr2,242179786,242181097,1311,-1,0,3069,1,76.27765064836000000000
chr2,242265233,242266273,1040,-1,0,4735,1,96.15384615384620000000
chr2,242265781,242266212,431,-1,0,4735,1,232.01856148491900000000
chr2,242396689,242397250,561,-1,0,9855,1,178.25311942959000000000
chr2,242396816,242397140,324,-1,0,9855,1,308.64197530864200000000
chr2,242456114,242456843,729,-1,0,,0,0.00000000000000000000
chr2,242505627,242507535,1908,-1,0,666,1,52.41090146750520000000
chr2,242506075,242507330,1255,-1,0,666,1,79.68127490039840000000
chr2,242503213,242504023,810,-1,0,666,1,123.45679012345700000000
chr2,242509869,242510389,520,-1,0,666,1,192.30769230769200000000
chr2,242542708,242542909,201,-1,0,51078,1,497.51243781094500000000
chr2,242608419,242608479,60,-1,0,23192,1,1666.66666666667000000000
chr2,242672601,242718700,46099,-1,0,64090;728294,2,4.33848890431463000000
chr2,242702960,242707238,4278,-1,0,728294,1,23.37540906965870000000
chr2,242704898,242706962,2064,-1,0,728294,1,48.44961240310080000000
chr2,242836538,243034049,197511,-1,0,,0,0.00000000000000000000
chr2,242744983,242949107,204124,-1,0,129807;285093;5133,3,1.46969489134056000000
chr2,242872862,243012181,139319,-1,0,,0,0.00000000000000000000
chr2,242954790,243083571,128781,-1,0,,0,0.00000000000000000000
chr2,242869447,242985795,116348,-1,0,,0,0.00000000000000000000
chr2,242945537,243006671,61134,-1,0,,0,0.00000000000000000000
chr2,242889142,242926641,37499,-1,0,,0,0.00000000000000000000
chr2,242986486,243036276,49790,-1,0,,0,0.00000000000000000000
chr2,242929057,242985910,56853,-1,0,,0,0.00000000000000000000
chr2,242896064,242948545,52481,-1,0,,0,0.00000000000000000000
chr2,243025897,243068739,42842,-1,0,,0,0.00000000000000000000
chr2,242953729,242995241,41512,-1,0,,0,0.00000000000000000000
chr2,242928032,242956502,28470,-1,0,,0,0.00000000000000000000
chr2,243019401,243045036,25635,-1,0,,0,0.00000000000000000000
chr2,242920281,242943248,22967,-1,0,,0,0.00000000000000000000
chr2,242881803,242896360,14557,-1,0,,0,0.00000000000000000000
chr2,242744790,242749316,4526,-1,0,,0,0.00000000000000000000
chr2,242965501,242970776,5275,-1,0,,0,0.00000000000000000000
chr2,242948538,242953222,4684,-1,0,,0,0.00000000000000000000
chr2,242971225,242974454,3229,-1,0,,0,0.00000000000000000000
chr2,242788830,242791115,2285,-1,0,,0,0.00000000000000000000
chr2,242744967,242746944,1977,-1,0,,0,0.00000000000000000000
chr2,242760348,242762463,2115,-1,0,,0,0.00000000000000000000
chr2,242988674,242990127,1453,-1,0,,0,0.00000000000000000000
chr20,130319,182090,51771,-1,0,140850;245939,2,3.86316663769292000000
chr20,317101,319263,2162,-1,0,,0,0.00000000000000000000
chr20,348297,351080,2783,-1,0,,0,0.00000000000000000000
chr20,365916,379801,13885,-1,0,57761,1,7.20201656463810000000
chr20,433632,434931,1299,-1,0,128637,1,76.98229407236330000000
chr20,528582,537431,8849,-1,0,,0,0.00000000000000000000
chr20,565702,566272,570,-1,0,,0,0.00000000000000000000
chr20,594316,594655,339,-1,0,,0,0.00000000000000000000
chr20,594430,594484,54,-1,0,,0,0.00000000000000000000
chr20,622529,623049,520,-1,0,,0,0.00000000000000000000
chr20,700314,701427,1113,-1,0,,0,0.00000000000000000000
chr20,869499,889833,20334,-1,0,51378,1,4.91787154519524000000
chr20,930057,930489,432,-1,0,,0,0.00000000000000000000
chr20,959481,960627,1146,-1,0,343637,1,87.26003490401400000000
chr20,1043020,1044471,1451,-1,0,,0,0.00000000000000000000
chr20,1073268,1077311,4043,-1,0,,0,0.00000000000000000000
chr20,1095628,1096157,529,-1,0,9491,1,189.03591682419700000000
chr20,1095215,1095826,611,-1,0,9491,1,163.66612111293000000000
chr20,1095828,1096053,225,-1,0,9491,1,444.44444444444400000000
chr20,1129983,1131433,1450,-1,0,9491,1,68.96551724137930000000
chr20,1130547,1130755,208,-1,0,9491,1,480.76923076923100000000
chr20,1238821,1241053,2232,-1,0,,0,0.00000000000000000000
chr20,1282195,1283285,1090,-1,0,9751,1,91.74311926605500000000
chr20,1307704,1317986,10282,-1,0,27111,1,9.72573429293912000000
chr20,1388131,1390772,2641,-1,0,,0,0.00000000000000000000
chr20,1389095,1390815,1720,-1,0,,0,0.00000000000000000000
chr20,1554810,1595707,40897,-1,0,10326,1,2.44516712717314000000
chr20,1570029,1592687,22658,-1,0,10326,1,4.41345220231265000000
chr20,1543381,1563660,20279,-1,0,10326,1,4.93120962572119000000
chr20,1559400,1582659,23259,-1,0,10326,1,4.29941098069564000000
chr20,1584512,1596836,12324,-1,0,10326,1,8.11424862057773000000
chr20,1557151,1571849,14698,-1,0,10326,1,6.80364675466050000000
chr20,1569803,1582398,12595,-1,0,10326,1,7.93965859468043000000
chr20,1550749,1562532,11783,-1,0,10326,1,8.48680302130188000000
chr20,1590029,1596731,6702,-1,0,10326,1,14.92091912861830000000
chr20,1599361,1605179,5818,-1,0,10326,1,17.18803712616020000000
chr20,1670374,1674265,3891,-1,0,,0,0.00000000000000000000
chr20,1557189,1561606,4417,-1,0,10326,1,22.63980076975320000000
chr20,1820317,1820673,356,-1,0,,0,0.00000000000000000000
chr20,1894711,1895777,1066,-1,0,140885,1,93.80863039399630000000
chr20,1895116,1895796,680,-1,0,140885,1,147.05882352941200000000
chr20,1975946,1976044,98,-1,0,,0,0.00000000000000000000
chr20,1976011,1976079,68,-1,0,,0,0.00000000000000000000
chr20,1995487,1997547,2060,-1,0,,0,0.00000000000000000000
chr20,2077584,2079665,2081,-1,0,,0,0.00000000000000000000
chr20,2183230,2186591,3361,-1,0,,0,0.00000000000000000000
chr20,2208919,2212019,3100,-1,0,,0,0.00000000000000000000
chr20,2221598,2221801,203,-1,0,,0,0.00000000000000000000
chr20,2241050,2241646,596,-1,0,,0,0.00000000000000000000
chr20,2359902,2360608,706,-1,0,,0,0.00000000000000000000
chr20,2423408,2425027,1619,-1,0,,0,0.00000000000000000000
chr20,2423724,2424032,308,-1,0,,0,0.00000000000000000000
chr20,2514786,2515395,609,-1,0,,0,0.00000000000000000000
chr20,2514992,2515105,113,-1,0,,0,0.00000000000000000000
chr20,2673175,2674407,1232,-1,0,57593,1,81.16883116883120000000
chr20,2802981,2806593,3612,-1,0,,0,0.00000000000000000000
chr20,2847980,2848397,417,-1,0,5786,1,239.80815347721800000000
chr20,2863901,2864460,559,-1,0,5786,1,178.89087656529500000000
chr20,2864012,2864344,332,-1,0,5786,1,301.20481927710800000000
chr20,2904874,2906189,1315,-1,0,5786,1,76.04562737642590000000
chr20,2929299,2934582,5283,-1,0,5786,1,18.92863903085370000000
chr20,3013174,3014380,1206,-1,0,5786,1,82.91873963515760000000
chr20,3021754,3022052,298,-1,0,,0,0.00000000000000000000
chr20,3033068,3035312,2244,-1,0,,0,0.00000000000000000000
chr20,3037827,3038254,427,-1,0,,0,0.00000000000000000000
chr20,3080028,3082332,2304,-1,0,,0,0.00000000000000000000
chr20,3085004,3086065,1061,-1,0,,0,0.00000000000000000000
chr20,3084829,3085431,602,-1,0,,0,0.00000000000000000000
chr20,3238625,3238762,137,-1,0,25943,1,729.92700729927000000000
chr20,3359280,3359959,679,-1,0,25943,1,147.27540500736400000000
chr20,3375579,3375919,340,-1,0,25943,1,294.11764705882400000000
chr20,3476500,3485980,9480,-1,0,8455,1,10.54852320675110000000
chr20,3696788,3699124,2336,-1,0,,0,0.00000000000000000000
chr20,3794886,3799181,4295,-1,0,,0,0.00000000000000000000
chr20,3795027,3795454,427,-1,0,,0,0.00000000000000000000
chr20,3821196,3825127,3931,-1,0,,0,0.00000000000000000000
chr20,3822621,3824505,1884,-1,0,,0,0.00000000000000000000
chr20,3823196,3824463,1267,-1,0,,0,0.00000000000000000000
chr20,3878815,3885151,6336,-1,0,80025,1,15.78282828282830000000
chr20,3894710,3895632,922,-1,0,80025,1,108.45986984815600000000
chr20,4012441,4016545,4104,-1,0,,0,0.00000000000000000000
chr20,4037533,4039536,2003,-1,0,,0,0.00000000000000000000
chr20,4055506,4056759,1253,-1,0,,0,0.00000000000000000000
chr20,4205254,4205361,107,-1,0,146,1,934.57943925233600000000
chr20,4445508,4449812,4304,-1,0,,0,0.00000000000000000000
chr20,4807408,4808146,738,-1,0,,0,0.00000000000000000000
chr20,4931136,4967125,35989,-1,0,9962,1,2.77862680263414000000
chr20,4996189,4996648,459,-1,0,,0,0.00000000000000000000
chr20,5013081,5017842,4761,-1,0,,0,0.00000000000000000000
chr20,5160940,5161767,827,-1,0,8760,1,120.91898428053200000000
chr20,5485946,5487463,1517,-1,0,,0,0.00000000000000000000
chr20,5534514,5534951,437,-1,0,56261,1,228.83295194508000000000
chr20,5610255,5613017,2762,-1,0,,0,0.00000000000000000000
chr20,5629051,5630394,1343,-1,0,,0,0.00000000000000000000
chr20,5680051,5681468,1417,-1,0,,0,0.00000000000000000000
chr20,5702513,5704716,2203,-1,0,,0,0.00000000000000000000
chr20,5725228,5727185,1957,-1,0,,0,0.00000000000000000000
chr20,5789561,5791418,1857,-1,0,149840,1,53.85029617662900000000
chr20,5942871,5943433,562,-1,0,84515,1,177.93594306049800000000
chr20,5942994,5943322,328,-1,0,84515,1,304.87804878048800000000
chr20,6025540,6027502,1962,-1,0,164312,1,50.96839959225280000000
chr20,6150836,6151436,600,-1,0,,0,0.00000000000000000000
chr20,6150950,6151282,332,-1,0,,0,0.00000000000000000000
chr20,6974279,6976940,2661,-1,0,,0,0.00000000000000000000
chr20,7077731,7078997,1266,-1,0,,0,0.00000000000000000000
chr20,7096522,7102938,6416,-1,0,,0,0.00000000000000000000
chr20,7150747,7152760,2013,-1,0,,0,0.00000000000000000000
chr20,7274247,7274782,535,-1,0,,0,0.00000000000000000000
chr20,7274338,7274655,317,-1,0,,0,0.00000000000000000000
chr20,7391159,7406715,15556,-1,0,,0,0.00000000000000000000
chr20,7398469,7403548,5079,-1,0,,0,0.00000000000000000000
chr20,7462817,7464643,1826,-1,0,,0,0.00000000000000000000
chr20,7601033,7607663,6630,-1,0,,0,0.00000000000000000000
chr20,7605012,7607568,2556,-1,0,,0,0.00000000000000000000
chr20,7624099,7650308,26209,-1,0,,0,0.00000000000000000000
chr20,7699070,7702858,3788,-1,0,,0,0.00000000000000000000
chr20,7751848,7752539,691,-1,0,,0,0.00000000000000000000
chr20,7848208,7849687,1479,-1,0,,0,0.00000000000000000000
chr20,8001546,8003506,1960,-1,0,,0,0.00000000000000000000
chr20,8410043,8411156,1113,-1,0,23236,1,89.84725965858040000000
chr20,8288344,8289221,877,-1,0,23236,1,114.02508551881400000000
chr20,8187281,8187901,620,-1,0,23236,1,161.29032258064500000000
chr20,8551046,8551480,434,-1,0,23236,1,230.41474654377900000000
chr20,8414039,8414456,417,-1,0,23236,1,239.80815347721800000000
chr20,8187616,8187800,184,-1,0,23236,1,543.47826086956500000000
chr20,8551255,8551351,96,-1,0,23236,1,1041.66666666667000000000
chr20,9008773,9009567,794,-1,0,,0,0.00000000000000000000
chr20,9149570,9149623,53,-1,0,5332,1,1886.79245283019000000000
chr20,9169304,9170148,844,-1,0,5332,1,118.48341232227500000000
chr20,9647968,9648349,381,-1,0,57144,1,262.46719160105000000000
chr20,9647997,9648154,157,-1,0,57144,1,636.94267515923600000000
chr20,9696764,9696817,53,-1,0,57144,1,1886.79245283019000000000
chr20,9699058,9710226,11168,-1,0,57144,1,8.95415472779370000000
chr20,10130897,10130963,66,-1,0,,0,0.00000000000000000000
chr20,10197448,10200984,3536,-1,0,6616,1,28.28054298642530000000
chr20,11517178,11517708,530,-1,0,,0,0.00000000000000000000
chr20,11517265,11517588,323,-1,0,,0,0.00000000000000000000
chr20,11647441,11648748,1307,-1,0,,0,0.00000000000000000000
chr20,11725764,11732675,6911,-1,0,,0,0.00000000000000000000
chr20,12252406,12253152,746,-1,0,,0,0.00000000000000000000
chr20,12458294,12475425,17131,-1,0,,0,0.00000000000000000000
chr20,12741023,12797504,56481,-1,0,,0,0.00000000000000000000
chr20,12732954,12740315,7361,-1,0,,0,0.00000000000000000000
chr20,12757276,12762169,4893,-1,0,,0,0.00000000000000000000
chr20,12638115,12639255,1140,-1,0,,0,0.00000000000000000000
chr20,12641627,12642393,766,-1,0,,0,0.00000000000000000000
chr20,12710524,12711480,956,-1,0,,0,0.00000000000000000000
chr20,12641934,12642067,133,-1,0,,0,0.00000000000000000000
chr20,12664890,12665021,131,-1,0,,0,0.00000000000000000000
chr20,13685390,13686118,728,-1,0,,0,0.00000000000000000000
chr20,14272019,14279410,7391,-1,0,140733,1,13.52996888107160000000
chr20,14722579,15142764,420185,-1,0,140733,1,0.23799040898651800000
chr20,14646779,14968328,321549,-1,0,140733,1,0.31099459180404900000
chr20,14904254,15175425,271171,-1,0,140733,1,0.36877099689863600000
chr20,14743941,14940627,196686,-1,0,140733,1,0.50842459554823400000
chr20,14672650,14875718,203068,-1,0,140733,1,0.49244588019776600000
chr20,14586014,14726398,140384,-1,0,140733,1,0.71233188967403700000
chr20,15043781,15150798,107017,-1,0,140733,1,0.93443097825579100000
chr20,14913737,15019333,105596,-1,0,140733,1,0.94700556839274200000
chr20,14817575,14936880,119305,-1,0,140733,1,0.83818783789447200000
chr20,14765423,14832152,66729,-1,0,140733,1,1.49859881011254000000
chr20,14717700,14801573,83873,-1,0,140733,1,1.19227880247517000000
chr20,14737152,14792235,55083,-1,0,140733,1,1.81544215093586000000
chr20,14700626,14756663,56037,-1,0,140733,1,1.78453521780252000000
chr20,14800890,14860855,59965,-1,0,140733,1,1.66763945634954000000
chr20,14858231,14928819,70588,-1,0,140733,1,1.41667138890463000000
chr20,14647040,14690686,43646,-1,0,140733,1,2.29116070201164000000
chr20,14961081,15016930,55849,-1,0,140733,1,1.79054235527941000000
chr20,15159229,15227027,67798,-1,0,140733,1,1.47496976311986000000
chr20,15083626,15141959,58333,-1,0,140733,1,1.71429551026006000000
chr20,14672955,14724377,51422,-1,0,140733,1,1.94469293298588000000
chr20,14779730,14828135,48405,-1,0,140733,1,2.06590228282202000000
chr20,14849358,14898246,48888,-1,0,140733,1,2.04549173621339000000
chr20,14592499,14640859,48360,-1,0,140733,1,2.06782464846981000000
chr20,14819445,14855431,35986,-1,0,140733,1,2.77885844495081000000
chr20,14420048,14451722,31674,-1,0,140733,1,3.15716360421797000000
chr20,14763650,14803027,39377,-1,0,140733,1,2.53955354648653000000
chr20,14586252,14620459,34207,-1,0,140733,1,2.92337825591253000000
chr20,14883792,14915763,31971,-1,0,140733,1,3.12783460010635000000
chr20,14804459,14828828,24369,-1,0,140733,1,4.10357421313964000000
chr20,14871322,14896615,25293,-1,0,140733,1,3.95366306883327000000
chr20,14781448,14799976,18528,-1,0,140733,1,5.39723661485319000000
chr20,14422471,14439945,17474,-1,0,140733,1,5.72278814238297000000
chr20,14808117,14822283,14166,-1,0,140733,1,7.05915572497529000000
chr20,15306269,15318688,12419,-1,0,140733,1,8.05217811417988000000
chr20,15311155,15322454,11299,-1,0,140733,1,8.85034073811842000000
chr20,15128640,15134074,5434,-1,0,140733,1,18.40264998159730000000
chr20,15300856,15304153,3297,-1,0,140733,1,30.33060357901120000000
chr20,14926114,14928380,2266,-1,0,140733,1,44.13062665489850000000
chr20,15301756,15303984,2228,-1,0,140733,1,44.88330341113110000000
chr20,14571845,14573965,2120,-1,0,140733,1,47.16981132075470000000
chr20,14435474,14437432,1958,-1,0,140733,1,51.07252298263530000000
chr20,14445462,14447437,1975,-1,0,140733,1,50.63291139240510000000
chr20,14477289,14478955,1666,-1,0,140733,1,60.02400960384150000000
chr20,14529055,14529411,356,-1,0,140733,1,280.89887640449400000000
chr20,14980956,14981356,400,-1,0,140733,1,250.00000000000000000000
chr20,14683215,14683311,96,-1,0,140733,1,1041.66666666667000000000
chr20,14466306,14466370,64,-1,0,140733,1,1562.50000000000000000000
chr20,15435220,15435625,405,-1,0,140733,1,246.91358024691400000000
chr20,15435300,15435478,178,-1,0,140733,1,561.79775280898900000000
chr20,15451244,15454395,3151,-1,0,140733,1,31.73595683909870000000
chr20,15689262,15689455,193,-1,0,140733,1,518.13471502590700000000
chr20,15711189,15713752,2563,-1,0,140733,1,39.01677721420210000000
chr20,15711605,15712442,837,-1,0,140733,1,119.47431302270000000000
chr20,15750135,15766066,15931,-1,0,140733,1,6.27706986378758000000
chr20,15782130,15784284,2154,-1,0,140733,1,46.42525533890440000000
chr20,16040301,16040395,94,-1,0,,0,0.00000000000000000000
chr20,16078997,16085361,6364,-1,0,,0,0.00000000000000000000
chr20,16207179,16209078,1899,-1,0,,0,0.00000000000000000000
chr20,16221774,16222320,546,-1,0,,0,0.00000000000000000000
chr20,16238780,16239728,948,-1,0,,0,0.00000000000000000000
chr20,16240175,16240835,660,-1,0,,0,0.00000000000000000000
chr20,16251419,16251885,466,-1,0,,0,0.00000000000000000000
chr20,16481789,16482118,329,-1,0,55614,1,303.95136778115500000000
chr20,16481923,16482001,78,-1,0,55614,1,1282.05128205128000000000
chr20,16566056,16587970,21914,-1,0,,0,0.00000000000000000000
chr20,16575279,16586623,11344,-1,0,,0,0.00000000000000000000
chr20,16662636,16668588,5952,-1,0,,0,0.00000000000000000000
chr20,17061953,17062059,106,-1,0,,0,0.00000000000000000000
chr20,17061941,17062018,77,-1,0,,0,0.00000000000000000000
chr20,17103311,17103921,610,-1,0,,0,0.00000000000000000000
chr20,17103451,17103798,347,-1,0,,0,0.00000000000000000000
chr20,17448549,17449027,478,-1,0,5126,1,209.20502092050200000000
chr20,17824862,17825352,490,-1,0,,0,0.00000000000000000000
chr20,17826027,17826157,130,-1,0,,0,0.00000000000000000000
chr20,18027939,18028282,343,-1,0,58495,1,291.54518950437300000000
chr20,18177993,18179167,1174,-1,0,,0,0.00000000000000000000
chr20,18189149,18191404,2255,-1,0,,0,0.00000000000000000000
chr20,18190629,18191272,643,-1,0,,0,0.00000000000000000000
chr20,18241204,18243023,1819,-1,0,,0,0.00000000000000000000
chr20,18610194,18611287,1093,-1,0,92675,1,91.49130832570910000000
chr20,18757272,18757498,226,-1,0,,0,0.00000000000000000000
chr20,18978141,18978874,733,-1,0,,0,0.00000000000000000000
chr20,19061364,19061861,497,-1,0,,0,0.00000000000000000000
chr20,19061431,19061743,312,-1,0,,0,0.00000000000000000000
chr20,19070152,19098429,28277,-1,0,,0,0.00000000000000000000
chr20,19072643,19075737,3094,-1,0,,0,0.00000000000000000000
chr20,19104340,19104642,302,-1,0,,0,0.00000000000000000000
chr20,19134472,19137970,3498,-1,0,,0,0.00000000000000000000
chr20,20012574,20013017,443,-1,0,51126,1,225.73363431151200000000
chr20,20103361,20111956,8595,-1,0,26074,1,11.63467132053520000000
chr20,20161810,20163190,1380,-1,0,26074,1,72.46376811594200000000
chr20,20172266,20174207,1941,-1,0,26074,1,51.51983513652760000000
chr20,20259773,20261176,1403,-1,0,26074,1,71.27583749109050000000
chr20,20335337,20339089,3752,-1,0,26074,1,26.65245202558640000000
chr20,20657064,20657135,71,-1,0,57186,1,1408.45070422535000000000
chr20,20736916,20741180,4264,-1,0,,0,0.00000000000000000000
chr20,21002707,21003056,349,-1,0,,0,0.00000000000000000000
chr20,21122086,21123967,1881,-1,0,55857,1,53.16321105794790000000
chr20,21251152,21251814,662,-1,0,,0,0.00000000000000000000
chr20,21286087,21288772,2685,-1,0,22803,1,37.24394785847300000000
chr20,21486525,21496720,10195,-1,0,4821,1,9.80872976949485000000
chr20,22046713,22152153,105440,-1,0,,0,0.00000000000000000000
chr20,21808870,21809866,996,-1,0,,0,0.00000000000000000000
chr20,21849808,21850291,483,-1,0,,0,0.00000000000000000000
chr20,21849901,21850189,288,-1,0,,0,0.00000000000000000000
chr20,22097666,22097721,55,-1,0,,0,0.00000000000000000000
chr20,22325333,22330323,4990,-1,0,,0,0.00000000000000000000
chr20,22467037,22469436,2399,-1,0,,0,0.00000000000000000000
chr20,22519535,22519627,92,-1,0,,0,0.00000000000000000000
chr20,22655317,22655706,389,-1,0,,0,0.00000000000000000000
chr20,22953663,22957091,3428,-1,0,,0,0.00000000000000000000
chr20,23073500,23077255,3755,-1,0,,0,0.00000000000000000000
chr20,23103192,23103634,442,-1,0,,0,0.00000000000000000000
chr20,23103313,23103621,308,-1,0,,0,0.00000000000000000000
chr20,23168261,23176273,8012,-1,0,,0,0.00000000000000000000
chr20,23541627,23541721,94,-1,0,,0,0.00000000000000000000
chr20,23605492,23605566,74,-1,0,,0,0.00000000000000000000
chr20,23678339,23779520,101181,-1,0,1469,1,0.98832784811377600000
chr20,23753628,23836789,83161,-1,0,1470,1,1.20248674258366000000
chr20,23727362,23803569,76207,-1,0,1469,1,1.31221541328224000000
chr20,23684147,23746737,62590,-1,0,1469,1,1.59769931298930000000
chr20,23671898,23674233,2335,-1,0,,0,0.00000000000000000000
chr20,23755107,23755539,432,-1,0,,0,0.00000000000000000000
chr20,23939613,24123246,183633,-1,0,92086,1,0.54456443014055200000
chr20,23957671,23976405,18734,-1,0,92086,1,5.33788833137611000000
chr20,23964080,23966959,2879,-1,0,92086,1,34.73428273706150000000
chr20,24234007,24236664,2657,-1,0,,0,0.00000000000000000000
chr20,24411242,24413187,1945,-1,0,,0,0.00000000000000000000
chr20,24388726,24389563,837,-1,0,,0,0.00000000000000000000
chr20,24456798,24457645,847,-1,0,79953,1,118.06375442739100000000
chr20,24249446,24250283,837,-1,0,,0,0.00000000000000000000
chr20,24782710,24785828,3118,-1,0,,0,0.00000000000000000000
chr20,24873674,24873738,64,-1,0,,0,0.00000000000000000000
chr20,24885146,24906501,21355,-1,0,,0,0.00000000000000000000
chr20,24903696,24904414,718,-1,0,,0,0.00000000000000000000
chr20,24962711,24963154,443,-1,0,57136,1,225.73363431151200000000
chr20,25414154,25414812,658,-1,0,9837,1,151.97568389057700000000
chr20,25449188,25450031,843,-1,0,22981,1,118.62396204033200000000
chr20,25583058,25583729,671,-1,0,,0,0.00000000000000000000
chr20,25679756,25681886,2130,-1,0,,0,0.00000000000000000000
chr20,25767427,25831283,63856,-1,0,,0,0.00000000000000000000
chr20,25992104,26052202,60098,-1,0,,0,0.00000000000000000000
chr20,25782560,25802158,19598,-1,0,,0,0.00000000000000000000
chr20,25835730,25847007,11277,-1,0,,0,0.00000000000000000000
chr20,25837424,25845998,8574,-1,0,,0,0.00000000000000000000
chr20,26038378,26047977,9599,-1,0,,0,0.00000000000000000000
chr20,26108956,26113279,4323,-1,0,,0,0.00000000000000000000
chr20,26092753,26094315,1562,-1,0,,0,0.00000000000000000000
chr20,26149003,26149285,282,-1,0,,0,0.00000000000000000000
chr20,26219070,26306093,87023,-1,0,,0,0.00000000000000000000
chr20,26221797,26271948,50151,-1,0,,0,0.00000000000000000000
chr20,26263868,26311594,47726,-1,0,,0,0.00000000000000000000
chr20,26277571,26299832,22261,-1,0,,0,0.00000000000000000000
chr20,26199124,26216913,17789,-1,0,,0,0.00000000000000000000
chr20,26288324,26305501,17177,-1,0,,0,0.00000000000000000000
chr20,26213607,26220393,6786,-1,0,,0,0.00000000000000000000
chr20,26297586,26302709,5123,-1,0,,0,0.00000000000000000000
chr20,26243947,26247928,3981,-1,0,,0,0.00000000000000000000
chr20,26234163,26235762,1599,-1,0,,0,0.00000000000000000000
chr20,26260599,26261802,1203,-1,0,,0,0.00000000000000000000
chr20,26204670,26205460,790,-1,0,,0,0.00000000000000000000
chr20,29424646,29589325,164679,-1,0,,0,0.00000000000000000000
chr20,29420054,29509668,89614,-1,0,,0,0.00000000000000000000
chr20,29534163,29580700,46537,-1,0,,0,0.00000000000000000000
chr20,29453676,29496100,42424,-1,0,,0,0.00000000000000000000
chr20,29509040,29536079,27039,-1,0,,0,0.00000000000000000000
chr20,29593563,29599458,5895,-1,0,,0,0.00000000000000000000
chr20,29638788,29641425,2637,-1,0,,0,0.00000000000000000000
chr20,29472365,29473672,1307,-1,0,,0,0.00000000000000000000
chr20,29647534,29647656,122,-1,0,,0,0.00000000000000000000
chr20,29804472,29833437,28965,-1,0,,0,0.00000000000000000000
chr20,29810115,29829103,18988,-1,0,,0,0.00000000000000000000
chr20,29817109,29832573,15464,-1,0,,0,0.00000000000000000000
chr20,30040084,30051552,11468,-1,0,,0,0.00000000000000000000
chr20,30408750,30411161,2411,-1,0,85366,1,41.47656574035670000000
chr20,30893040,30894755,1715,-1,0,9371,1,58.30903790087460000000
chr20,30899140,30899603,463,-1,0,9371,1,215.98272138228900000000
chr20,30899212,30899531,319,-1,0,9371,1,313.47962382445100000000
chr20,31682012,31694816,12804,-1,0,149954,1,7.81005935645111000000
chr20,31525485,31529389,3904,-1,0,,0,0.00000000000000000000
chr20,31170544,31173327,2783,-1,0,140688,1,35.93244699964070000000
chr20,31310819,31313153,2334,-1,0,149951,1,42.84490145672670000000
chr20,31458917,31461989,3072,-1,0,,0,0.00000000000000000000
chr20,31327348,31328023,675,-1,0,149951,1,148.14814814814800000000
chr20,31399996,31400392,396,-1,0,,0,0.00000000000000000000
chr20,31613052,31613465,413,-1,0,,0,0.00000000000000000000
chr20,32043277,32045416,2139,-1,0,,0,0.00000000000000000000
chr20,32046336,32048077,1741,-1,0,,0,0.00000000000000000000
chr20,32174450,32185369,10919,-1,0,9139,1,9.15834783405074000000
chr20,32286706,32288986,2280,-1,0,,0,0.00000000000000000000
chr20,32241440,32242578,1138,-1,0,,0,0.00000000000000000000
chr20,32815862,32819746,3884,-1,0,,0,0.00000000000000000000
chr20,33115717,33116278,561,-1,0,83658,1,178.25311942959000000000
chr20,33115811,33116144,333,-1,0,83658,1,300.30030030030000000000
chr20,33241752,33244415,2663,-1,0,128869,1,37.55163349605710000000
chr20,33242327,33243723,1396,-1,0,128869,1,71.63323782234960000000
chr20,33365697,33369158,3461,-1,0,23054,1,28.89338341519790000000
chr20,33477172,33477305,133,-1,0,55902,1,751.87969924812000000000
chr20,33621543,33622082,539,-1,0,26133,1,185.52875695732800000000
chr20,33621619,33621947,328,-1,0,26133,1,304.87804878048800000000
chr20,33715660,33718008,2348,-1,0,55741,1,42.58943781942080000000
chr20,33716062,33716812,750,-1,0,55741,1,133.33333333333300000000
chr20,34169370,34173103,3733,-1,0,,0,0.00000000000000000000
chr20,34663769,34665267,1498,-1,0,,0,0.00000000000000000000
chr20,34489679,34490089,410,-1,0,51230,1,243.90243902439000000000
chr20,34548503,34548820,317,-1,0,,0,0.00000000000000000000
chr20,35020889,35020998,109,-1,0,22839,1,917.43119266055100000000
chr20,35043533,35055950,12417,-1,0,22839,1,8.05347507449464000000
chr20,35161625,35162675,1050,-1,0,,0,0.00000000000000000000
chr20,35522773,35524535,1762,-1,0,25939,1,56.75368898978430000000
chr20,35523201,35524289,1088,-1,0,25939,1,91.91176470588230000000
chr20,35535473,35539577,4104,-1,0,25939,1,24.36647173489280000000
chr20,35815504,35815988,484,-1,0,6185,1,206.61157024793400000000
chr20,35815608,35815920,312,-1,0,6185,1,320.51282051282000000000
chr20,35891601,35894271,2670,-1,0,,0,0.00000000000000000000
chr20,36115832,36116781,949,-1,0,,0,0.00000000000000000000
chr20,36177222,36177550,328,-1,0,,0,0.00000000000000000000
chr20,36474487,36477318,2831,-1,0,56259,1,35.32320734722710000000
chr20,36625822,36626894,1072,-1,0,9675,1,93.28358208955220000000
chr20,36892746,37020794,128048,-1,0,3929;671,2,1.56191428214420000000
chr20,37008368,37015202,6834,-1,0,,0,0.00000000000000000000
chr20,37009626,37014495,4869,-1,0,,0,0.00000000000000000000
chr20,37030244,37032361,2117,-1,0,,0,0.00000000000000000000
chr20,37068683,37070287,1604,-1,0,,0,0.00000000000000000000
chr20,37055090,37055824,734,-1,0,,0,0.00000000000000000000
chr20,37139247,37139594,347,-1,0,57148,1,288.18443804034600000000
chr20,38053024,38059858,6834,-1,0,,0,0.00000000000000000000
chr20,38727123,38732646,5523,-1,0,,0,0.00000000000000000000
chr20,38641862,38647027,5165,-1,0,,0,0.00000000000000000000
chr20,37902856,37905232,2376,-1,0,,0,0.00000000000000000000
chr20,38337293,38338313,1020,-1,0,,0,0.00000000000000000000
chr20,38337422,38337992,570,-1,0,,0,0.00000000000000000000
chr20,38337640,38337777,137,-1,0,,0,0.00000000000000000000
chr20,40313729,40407138,93409,-1,0,,0,0.00000000000000000000
chr20,39530644,39536794,6150,-1,0,,0,0.00000000000000000000
chr20,40337047,40340527,3480,-1,0,,0,0.00000000000000000000
chr20,39882467,39886754,4287,-1,0,23051,1,23.32633543270350000000
chr20,39906263,39907603,1340,-1,0,23051,1,74.62686567164180000000
chr20,39610672,39611981,1309,-1,0,,0,0.00000000000000000000
chr20,39906473,39907404,931,-1,0,23051,1,107.41138560687400000000
chr20,39886354,39886646,292,-1,0,23051,1,342.46575342465800000000
chr20,40906642,40907155,513,-1,0,11122,1,194.93177387914200000000
chr20,40906909,40906961,52,-1,0,11122,1,1923.07692307692000000000
chr20,40943721,40943896,175,-1,0,11122,1,571.42857142857100000000
chr20,40953173,40953538,365,-1,0,11122,1,273.97260273972600000000
chr20,40959693,40960700,1007,-1,0,11122,1,99.30486593843100000000
chr20,41067429,41068452,1023,-1,0,11122,1,97.75171065493650000000
chr20,41598250,41746465,148215,-1,0,11122,1,0.67469554363593400000
chr20,41200792,41289679,88887,-1,0,11122,1,1.12502390675802000000
chr20,41185946,41243379,57433,-1,0,11122,1,1.74115926383786000000
chr20,41230639,41291397,60758,-1,0,11122,1,1.64587379439745000000
chr20,41210919,41252648,41729,-1,0,11122,1,2.39641496321503000000
chr20,41257568,41284109,26541,-1,0,11122,1,3.76775554802004000000
chr20,41241717,41267567,25850,-1,0,11122,1,3.86847195357834000000
chr20,41208127,41233372,25245,-1,0,11122,1,3.96118043176867000000
chr20,41319386,41339865,20479,-1,0,11122,1,4.88305093022120000000
chr20,41169005,41186814,17809,-1,0,11122,1,5.61513841316188000000
chr20,42476631,42482019,5388,-1,0,,0,0.00000000000000000000
chr20,42268501,42274630,6129,-1,0,51098,1,16.31587534671240000000
chr20,42481450,42484558,3108,-1,0,,0,0.00000000000000000000
chr20,42107648,42110957,3309,-1,0,,0,0.00000000000000000000
chr20,42271825,42274631,2806,-1,0,51098,1,35.63791874554530000000
chr20,42481396,42483463,2067,-1,0,,0,0.00000000000000000000
chr20,42391099,42393587,2488,-1,0,,0,0.00000000000000000000
chr20,42024495,42026982,2487,-1,0,,0,0.00000000000000000000
chr20,42482421,42483768,1347,-1,0,,0,0.00000000000000000000
chr20,41353449,41354559,1110,-1,0,11122,1,90.09009009009010000000
chr20,42024593,42025792,1199,-1,0,,0,0.00000000000000000000
chr20,42362354,42363530,1176,-1,0,,0,0.00000000000000000000
chr20,42893404,42894522,1118,-1,0,78997,1,89.44543828264760000000
chr20,42924377,42925314,937,-1,0,,0,0.00000000000000000000
chr20,41729422,41730317,895,-1,0,11122,1,111.73184357541900000000
chr20,42676084,42676594,510,-1,0,84969,1,196.07843137254900000000
chr20,42564300,42564968,668,-1,0,84969,1,149.70059880239500000000
chr20,42790307,42790884,577,-1,0,57158,1,173.31022530329300000000
chr20,41272153,41272599,446,-1,0,11122,1,224.21524663677100000000
chr20,41169958,41170375,417,-1,0,11122,1,239.80815347721800000000
chr20,41791261,41791447,186,-1,0,11122,1,537.63440860215100000000
chr20,42762540,42762666,126,-1,0,57158,1,793.65079365079400000000
chr20,43275100,43278317,3217,-1,0,100,1,31.08486167236560000000
chr20,44347473,44380552,33079,-1,0,391253,1,3.02306599353064000000
chr20,44372821,44387485,14664,-1,0,,0,0.00000000000000000000
chr20,43296949,43309604,12655,-1,0,,0,0.00000000000000000000
chr20,43304997,43309879,4882,-1,0,,0,0.00000000000000000000
chr20,44204036,44207309,3273,-1,0,90199,1,30.55300947143290000000
chr20,43305888,43308881,2993,-1,0,,0,0.00000000000000000000
chr20,43327310,43329521,2211,-1,0,,0,0.00000000000000000000
chr20,43296501,43297909,1408,-1,0,,0,0.00000000000000000000
chr20,43307191,43308327,1136,-1,0,,0,0.00000000000000000000
chr20,44177342,44178062,720,-1,0,,0,0.00000000000000000000
chr20,43905838,43906524,686,-1,0,,0,0.00000000000000000000
chr20,44359233,44359735,502,-1,0,,0,0.00000000000000000000
chr20,43485325,43485748,423,-1,0,,0,0.00000000000000000000
chr20,43836817,43837001,184,-1,0,6406,1,543.47826086956500000000
chr20,44359381,44359553,172,-1,0,,0,0.00000000000000000000
chr20,44402455,44402787,332,-1,0,,0,0.00000000000000000000
chr20,44402564,44402685,121,-1,0,,0,0.00000000000000000000
chr20,44535346,44535783,437,-1,0,5360,1,228.83295194508000000000
chr20,44616892,44626926,10034,-1,0,,0,0.00000000000000000000
chr20,44725598,44726031,433,-1,0,,0,0.00000000000000000000
chr20,44792192,44793955,1763,-1,0,,0,0.00000000000000000000
chr20,45779055,45788702,9647,-1,0,2139,1,10.36591686534670000000
chr20,45776973,45784409,7436,-1,0,2139,1,13.44809037116730000000
chr20,46019047,46019433,386,-1,0,,0,0.00000000000000000000
chr20,46463882,47083712,619830,-1,0,,0,0.00000000000000000000
chr20,46754321,47131716,377395,-1,0,,0,0.00000000000000000000
chr20,46500288,46505793,5505,-1,0,,0,0.00000000000000000000
chr20,47375274,47377741,2467,-1,0,57580,1,40.53506282934740000000
chr20,46666578,46668992,2414,-1,0,,0,0.00000000000000000000
chr20,47102013,47103403,1390,-1,0,,0,0.00000000000000000000
chr20,46689681,46690943,1262,-1,0,,0,0.00000000000000000000
chr20,47201954,47202718,764,-1,0,,0,0.00000000000000000000
chr20,47131922,47132634,712,-1,0,,0,0.00000000000000000000
chr20,46338961,46339459,498,-1,0,55959,1,200.80321285140600000000
chr20,47014278,47014354,76,-1,0,,0,0.00000000000000000000
chr20,47486831,47488791,1960,-1,0,,0,0.00000000000000000000
chr20,48048642,48052963,4321,-1,0,3745,1,23.14279102059710000000
chr20,47742152,47744151,1999,-1,0,6780,1,50.02501250625310000000
chr20,47724698,47725090,392,-1,0,,0,0.00000000000000000000
chr20,48136691,48241343,104652,-1,0,5740,1,0.95554791117226600000
chr20,48150686,48186708,36022,-1,0,5740,1,2.77608128365999000000
chr20,48150871,48178886,28015,-1,0,5740,1,3.56951633053721000000
chr20,48356179,48357038,859,-1,0,,0,0.00000000000000000000
chr20,48403985,48404629,644,-1,0,,0,0.00000000000000000000
chr20,48543406,48543983,577,-1,0,,0,0.00000000000000000000
chr20,48543736,48543815,79,-1,0,,0,0.00000000000000000000
chr20,48692509,48695297,2788,-1,0,,0,0.00000000000000000000
chr20,48917426,48917996,570,-1,0,,0,0.00000000000000000000
chr20,48772820,48773222,402,-1,0,,0,0.00000000000000000000
chr20,48917667,48917793,126,-1,0,,0,0.00000000000000000000
chr20,49233483,49234622,1139,-1,0,140876,1,87.79631255487270000000
chr20,49658886,49660098,1212,-1,0,,0,0.00000000000000000000
chr20,49734194,49735574,1380,-1,0,,0,0.00000000000000000000
chr20,49749695,49758112,8417,-1,0,,0,0.00000000000000000000
chr20,50492106,50492469,363,-1,0,,0,0.00000000000000000000
chr20,50625323,50630262,4939,-1,0,,0,0.00000000000000000000
chr20,50651797,50654434,2637,-1,0,,0,0.00000000000000000000
chr20,50654666,50655505,839,-1,0,,0,0.00000000000000000000
chr20,50686248,50690172,3924,-1,0,,0,0.00000000000000000000
chr20,50759521,50766090,6569,-1,0,55734,1,15.22301720200940000000
chr20,50759186,50760930,1744,-1,0,55734,1,57.33944954128440000000
chr20,50759726,50760654,928,-1,0,55734,1,107.75862068965500000000
chr20,50783965,50784033,68,-1,0,55734,1,1470.58823529412000000000
chr20,50805004,50805961,957,-1,0,55734,1,104.49320794148400000000
chr20,50882351,50920041,37690,-1,0,,0,0.00000000000000000000
chr20,50897538,50901642,4104,-1,0,,0,0.00000000000000000000
chr20,52172152,52178676,6524,-1,0,,0,0.00000000000000000000
chr20,52265750,52268164,2414,-1,0,,0,0.00000000000000000000
chr20,52285332,52291791,6459,-1,0,,0,0.00000000000000000000
chr20,52287845,52293962,6117,-1,0,,0,0.00000000000000000000
chr20,52335957,52336530,573,-1,0,,0,0.00000000000000000000
chr20,52339271,52342226,2955,-1,0,,0,0.00000000000000000000
chr20,52475742,52484189,8447,-1,0,,0,0.00000000000000000000
chr20,52480323,52484076,3753,-1,0,,0,0.00000000000000000000
chr20,52480057,52480480,423,-1,0,,0,0.00000000000000000000
chr20,52453028,52453493,465,-1,0,,0,0.00000000000000000000
chr20,52458045,52458269,224,-1,0,,0,0.00000000000000000000
chr20,52480165,52480339,174,-1,0,,0,0.00000000000000000000
chr20,52646730,52666321,19591,-1,0,8537,1,5.10438466642846000000
chr20,52646684,52658086,11402,-1,0,8537,1,8.77039115944571000000
chr20,52651209,52662148,10939,-1,0,8537,1,9.14160343724289000000
chr20,52652526,52658708,6182,-1,0,8537,1,16.17599482368170000000
chr20,52647777,52656465,8688,-1,0,8537,1,11.51012891344380000000
chr20,52653853,52658020,4167,-1,0,8537,1,23.99808015358770000000
chr20,52652718,52654938,2220,-1,0,8537,1,45.04504504504500000000
chr20,52750414,52750818,404,-1,0,,0,0.00000000000000000000
chr20,52765331,52774803,9472,-1,0,1591,1,10.55743243243240000000
chr20,52866236,52867342,1106,-1,0,,0,0.00000000000000000000
chr20,53292650,53292965,315,-1,0,,0,0.00000000000000000000
chr20,53325270,53325795,525,-1,0,,0,0.00000000000000000000
chr20,53326007,53326639,632,-1,0,,0,0.00000000000000000000
chr20,53405486,53420142,14656,-1,0,,0,0.00000000000000000000
chr20,53520057,53523327,3270,-1,0,,0,0.00000000000000000000
chr20,53603487,53605103,1616,-1,0,,0,0.00000000000000000000
chr20,53694138,53697427,3289,-1,0,,0,0.00000000000000000000
chr20,53700439,53700834,395,-1,0,,0,0.00000000000000000000
chr20,53805994,54018701,212707,-1,0,,0,0.00000000000000000000
chr20,53745007,53782481,37474,-1,0,,0,0.00000000000000000000
chr20,53769993,53779902,9909,-1,0,,0,0.00000000000000000000
chr20,53963613,53964127,514,-1,0,,0,0.00000000000000000000
chr20,53970015,53970389,374,-1,0,,0,0.00000000000000000000
chr20,53963862,53963947,85,-1,0,,0,0.00000000000000000000
chr20,54114121,54114465,344,-1,0,,0,0.00000000000000000000
chr20,54116279,54118397,2118,-1,0,,0,0.00000000000000000000
chr20,54125396,54127869,2473,-1,0,,0,0.00000000000000000000
chr20,54128530,54129367,837,-1,0,,0,0.00000000000000000000
chr20,54213954,54214087,133,-1,0,,0,0.00000000000000000000
chr20,54237729,54238308,579,-1,0,,0,0.00000000000000000000
chr20,54434517,54440716,6199,-1,0,,0,0.00000000000000000000
chr20,54463109,54463671,562,-1,0,,0,0.00000000000000000000
chr20,54463227,54463551,324,-1,0,,0,0.00000000000000000000
chr20,54520384,54520629,245,-1,0,,0,0.00000000000000000000
chr20,54541985,54542230,245,-1,0,,0,0.00000000000000000000
chr20,54542423,54542654,231,-1,0,,0,0.00000000000000000000
chr20,54750461,54754913,4452,-1,0,,0,0.00000000000000000000
chr20,54854173,54860396,6223,-1,0,,0,0.00000000000000000000
chr20,55017020,55018624,1604,-1,0,57091,1,62.34413965087280000000
chr20,55147999,55148309,310,-1,0,,0,0.00000000000000000000
chr20,55148174,55148243,69,-1,0,,0,0.00000000000000000000
chr20,55288264,55289368,1104,-1,0,,0,0.00000000000000000000
chr20,55406467,55428884,22417,-1,0,,0,0.00000000000000000000
chr20,55587396,55587928,532,-1,0,,0,0.00000000000000000000
chr20,55605375,55605870,495,-1,0,,0,0.00000000000000000000
chr20,55605486,55605751,265,-1,0,,0,0.00000000000000000000
chr20,55606781,55607218,437,-1,0,,0,0.00000000000000000000
chr20,55606928,55607109,181,-1,0,,0,0.00000000000000000000
chr20,55644354,55672983,28629,-1,0,,0,0.00000000000000000000
chr20,55765420,55765503,83,-1,0,655,1,1204.81927710843000000000
chr20,56079190,56080558,1368,-1,0,140690,1,73.09941520467840000000
chr20,56099101,56102500,3399,-1,0,140690,1,29.42041776993230000000
chr20,56173380,56173756,376,-1,0,,0,0.00000000000000000000
chr20,56554354,56554850,496,-1,0,,0,0.00000000000000000000
chr20,56554551,56554643,92,-1,0,,0,0.00000000000000000000
chr20,56961121,56962797,1676,-1,0,,0,0.00000000000000000000
chr20,57160567,57161620,1053,-1,0,,0,0.00000000000000000000
chr20,57307956,57311991,4035,-1,0,,0,0.00000000000000000000
chr20,57465364,57467157,1793,-1,0,2778,1,55.77244841048520000000
chr20,57644135,57645330,1195,-1,0,,0,0.00000000000000000000
chr20,57723443,57723778,335,-1,0,,0,0.00000000000000000000
chr20,57785701,57786326,625,-1,0,128611,1,160.00000000000000000000
chr20,57785887,57786136,249,-1,0,128611,1,401.60642570281100000000
chr20,58249433,58249910,477,-1,0,116154,1,209.64360587002100000000
chr20,58249188,58249470,282,-1,0,116154,1,354.60992907801400000000
chr20,58296126,58315672,19546,-1,0,116154,1,5.11613629387087000000
chr20,58454124,58499606,45482,-1,0,10388,1,2.19867200211073000000
chr20,58662324,58662893,569,-1,0,,0,0.00000000000000000000
chr20,58662444,58662607,163,-1,0,,0,0.00000000000000000000
chr20,58669627,58674673,5046,-1,0,,0,0.00000000000000000000
chr20,58882201,58882371,170,-1,0,,0,0.00000000000000000000
chr20,58926714,58927036,322,-1,0,,0,0.00000000000000000000
chr20,59111709,59124987,13278,-1,0,,0,0.00000000000000000000
chr20,59114397,59122434,8037,-1,0,,0,0.00000000000000000000
chr20,59128084,59130615,2531,-1,0,,0,0.00000000000000000000
chr20,59396252,59409889,13637,-1,0,,0,0.00000000000000000000
chr20,59474540,59483443,8903,-1,0,,0,0.00000000000000000000
chr20,59589573,59612486,22913,-1,0,,0,0.00000000000000000000
chr20,59620843,59621400,557,-1,0,,0,0.00000000000000000000
chr20,59621020,59621169,149,-1,0,,0,0.00000000000000000000
chr20,59630996,59639907,8911,-1,0,,0,0.00000000000000000000
chr20,59643052,59644605,1553,-1,0,,0,0.00000000000000000000
chr20,59675898,59677832,1934,-1,0,,0,0.00000000000000000000
chr20,59676831,59677579,748,-1,0,,0,0.00000000000000000000
chr20,59766292,59766472,180,-1,0,,0,0.00000000000000000000
chr20,59776970,59778720,1750,-1,0,,0,0.00000000000000000000
chr20,59776733,59777495,762,-1,0,,0,0.00000000000000000000
chr20,59804666,59804720,54,-1,0,,0,0.00000000000000000000
chr20,59827152,59828515,1363,-1,0,1002,1,73.36757153338220000000
chr20,59848158,59848460,302,-1,0,1002,1,331.12582781457000000000
chr20,59884377,59884429,52,-1,0,1002,1,1923.07692307692000000000
chr20,59925210,59925712,502,-1,0,1002,1,199.20318725099600000000
chr20,59964903,59965823,920,-1,0,1002,1,108.69565217391300000000
chr20,60029292,60260957,231665,-1,0,1002,1,0.43165778171066000000
chr20,59974354,59996833,22479,-1,0,1002,1,4.44859646781440000000
chr20,60185955,60190371,4416,-1,0,1002,1,22.64492753623190000000
chr20,59973108,59976267,3159,-1,0,1002,1,31.65558721114280000000
chr20,59973782,59974997,1215,-1,0,1002,1,82.30452674897120000000
chr20,59974102,59974581,479,-1,0,1002,1,208.76826722338200000000
chr20,60216651,60217244,593,-1,0,1002,1,168.63406408094400000000
chr20,60160573,60160968,395,-1,0,1002,1,253.16455696202500000000
chr20,60080676,60081006,330,-1,0,1002,1,303.03030303030300000000
chr20,60109738,60110063,325,-1,0,1002,1,307.69230769230800000000
chr20,59985471,59985664,193,-1,0,1002,1,518.13471502590700000000
chr20,60160739,60160878,139,-1,0,1002,1,719.42446043165500000000
chr20,60264632,60265314,682,-1,0,1002,1,146.62756598240500000000
chr20,60289390,60313925,24535,-1,0,1002,1,4.07581006725087000000
chr20,60517996,60523656,5660,-1,0,,0,0.00000000000000000000
chr20,60520693,60523074,2381,-1,0,,0,0.00000000000000000000
chr20,60457179,60460213,3034,-1,0,1002,1,32.95978905735000000000
chr20,60520714,60522129,1415,-1,0,,0,0.00000000000000000000
chr20,60440095,60441606,1511,-1,0,1002,1,66.18133686300460000000
chr20,60358513,60359452,939,-1,0,1002,1,106.49627263045800000000
chr20,60570503,60571069,566,-1,0,6874,1,176.67844522968200000000
chr20,60298777,60299372,595,-1,0,1002,1,168.06722689075600000000
chr20,60526312,60526696,384,-1,0,,0,0.00000000000000000000
chr20,60465019,60465418,399,-1,0,1002,1,250.62656641604000000000
chr20,60464478,60464942,464,-1,0,1002,1,215.51724137931000000000
chr20,60495201,60495592,391,-1,0,1002,1,255.75447570332500000000
chr20,60570624,60570943,319,-1,0,6874,1,313.47962382445100000000
chr20,60319414,60319567,153,-1,0,1002,1,653.59477124183000000000
chr20,60319498,60319576,78,-1,0,1002,1,1282.05128205128000000000
chr20,60431648,60431699,51,-1,0,1002,1,1960.78431372549000000000
chr20,60632531,60634302,1771,-1,0,6874,1,56.46527385657820000000
chr20,60639470,60641722,2252,-1,0,6874,1,44.40497335701600000000
chr20,60718405,60719511,1106,-1,0,26039;5688,2,180.83182640144700000000
chr20,60853421,60853648,227,-1,0,9885,1,440.52863436123400000000
chr20,60869516,60870349,833,-1,0,9885,1,120.04801920768300000000
chr20,61372266,61375767,3501,-1,0,4923,1,28.56326763781780000000
chr20,61263541,61265863,2322,-1,0,,0,0.00000000000000000000
chr20,61191928,61193901,1973,-1,0,,0,0.00000000000000000000
chr20,61373093,61374702,1609,-1,0,4923,1,62.15040397762580000000
chr20,61304237,61305141,904,-1,0,,0,0.00000000000000000000
chr20,61304372,61305128,756,-1,0,,0,0.00000000000000000000
chr20,60948440,60948960,520,-1,0,,0,0.00000000000000000000
chr20,60948046,60948510,464,-1,0,,0,0.00000000000000000000
chr20,61329991,61330464,473,-1,0,,0,0.00000000000000000000
chr20,61378609,61378793,184,-1,0,4923,1,543.47826086956500000000
chr20,60951925,60952111,186,-1,0,,0,0.00000000000000000000
chr20,61470814,61471339,525,-1,0,1299,1,190.47619047619000000000
chr20,61480127,61480953,826,-1,0,10732,1,121.06537530266300000000
chr20,61597451,61597651,200,-1,0,63910,1,500.00000000000000000000
chr20,61602922,61603681,759,-1,0,,0,0.00000000000000000000
chr20,61607264,61607652,388,-1,0,,0,0.00000000000000000000
chr20,61623539,61625241,1702,-1,0,,0,0.00000000000000000000
chr20,61676392,61676856,464,-1,0,,0,0.00000000000000000000
chr20,61716057,61716461,404,-1,0,,0,0.00000000000000000000
chr20,61716871,61717041,170,-1,0,,0,0.00000000000000000000
chr20,61721569,61721668,99,-1,0,,0,0.00000000000000000000
chr20,61724537,61725820,1283,-1,0,,0,0.00000000000000000000
chr20,61724699,61725605,906,-1,0,,0,0.00000000000000000000
chr20,61762215,61766764,4549,-1,0,,0,0.00000000000000000000
chr20,61988329,61988799,470,-1,0,1137,1,212.76595744680900000000
chr20,62190809,62191134,325,-1,0,85441,1,307.69230769230800000000
chr20,61788210,61788596,386,-1,0,,0,0.00000000000000000000
chr20,61852840,61853147,307,-1,0,,0,0.00000000000000000000
chr20,62003627,62003898,271,-1,0,,0,0.00000000000000000000
chr20,61988484,61988681,197,-1,0,1137,1,507.61421319796900000000
chr20,61852983,61853108,125,-1,0,,0,0.00000000000000000000
chr20,61852914,61853014,100,-1,0,,0,0.00000000000000000000
chr20,62202808,62203352,544,-1,0,85441,1,183.82352941176500000000
chr20,62238265,62241400,3135,-1,0,26205,1,31.89792663476870000000
chr20,62239598,62241171,1573,-1,0,26205,1,63.57279084551810000000
chr20,62238709,62240063,1354,-1,0,26205,1,73.85524372230430000000
chr20,62267513,62268022,509,-1,0,,0,0.00000000000000000000
chr20,62281501,62463200,181699,-1,0,10139;51750;56731;8771;140685;50861;54923;84619,8,4.40288609183320000000
chr20,62368924,62372606,3682,-1,0,54923;56731,2,54.31830526887560000000
chr20,62461786,62463790,2004,-1,0,,0,0.00000000000000000000
chr20,62300885,62301843,958,-1,0,51750,1,104.38413361169100000000
chr20,62362611,62363180,569,-1,0,84619,1,175.74692442882200000000
chr20,62392047,62392592,545,-1,0,140685,1,183.48623853211000000000
chr20,62308998,62309459,461,-1,0,51750,1,216.91973969631200000000
chr20,62481149,62481477,328,-1,0,,0,0.00000000000000000000
chr20,62309129,62309290,161,-1,0,51750,1,621.11801242236000000000
chr20,62481178,62481280,102,-1,0,,0,0.00000000000000000000
chr20,62481269,62481326,57,-1,0,,0,0.00000000000000000000
chr20,62481178,62481229,51,-1,0,,0,0.00000000000000000000
chr20,62649001,62791500,142499,-1,0,54345;6919;24148;198437;10287;2832;4987;284739,8,5.61407448473323000000
chr20,62762905,62765725,2820,-1,0,,0,0.00000000000000000000
chr20,62748408,62750739,2331,-1,0,,0,0.00000000000000000000
chr20,62756668,62759189,2521,-1,0,,0,0.00000000000000000000
chr20,62595888,62597566,1678,-1,0,57473,1,59.59475566150180000000
chr20,62763397,62765069,1672,-1,0,,0,0.00000000000000000000
chr20,62679440,62681276,1836,-1,0,54345,1,54.46623093681920000000
chr20,62643105,62644502,1397,-1,0,24148,1,71.58196134574090000000
chr20,62763386,62764499,1113,-1,0,,0,0.00000000000000000000
chr20,62596408,62596866,458,-1,0,57473,1,218.34061135371200000000
chr20,62767014,62767370,356,-1,0,,0,0.00000000000000000000
chr20,62804947,62807857,2910,-1,0,4661,1,34.36426116838490000000
chr20,62909091,62909156,65,-1,0,,0,0.00000000000000000000
chr20,62936108,62961788,25680,-1,0,,0,0.00000000000000000000
chr20,62949697,62959247,9550,-1,0,,0,0.00000000000000000000
chr20,62948345,62956087,7742,-1,0,,0,0.00000000000000000000
chr20,62954695,62956153,1458,-1,0,,0,0.00000000000000000000
chr21,9448606,9449052,446,-1,0,,0,0.00000000000000000000
chr21,9901765,9921225,19460,-1,0,,0,0.00000000000000000000
chr21,9851191,9854044,2853,-1,0,,0,0.00000000000000000000
chr21,9834223,9835577,1354,-1,0,,0,0.00000000000000000000
chr21,9877005,9877916,911,-1,0,,0,0.00000000000000000000
chr21,9841747,9842126,379,-1,0,,0,0.00000000000000000000
chr21,10475184,10475654,470,-1,0,,0,0.00000000000000000000
chr21,10492887,10493010,123,-1,0,,0,0.00000000000000000000
chr21,10600238,10603681,3443,-1,0,,0,0.00000000000000000000
chr21,10699850,10700225,375,-1,0,,0,0.00000000000000000000
chr21,10737454,11018685,281231,-1,0,7179,1,0.35557957693141900000
chr21,10941514,11176539,235025,-1,0,7179;85319,2,0.85097330071269000000
chr21,10739082,10950878,211796,-1,0,7179,1,0.47215244858259800000
chr21,10878462,11035266,156804,-1,0,7179;85319,2,1.27547766638606000000
chr21,10771438,10863428,91990,-1,0,,0,0.00000000000000000000
chr21,11054004,11174123,120119,-1,0,85319,1,0.83250776313489100000
chr21,10878814,10979047,100233,-1,0,7179,1,0.99767541628006700000
chr21,11022735,11127557,104822,-1,0,85319,1,0.95399820648337200000
chr21,10950552,11008742,58190,-1,0,7179,1,1.71850833476542000000
chr21,10913441,10996929,83488,-1,0,7179,1,1.19777692602530000000
chr21,10790344,10851682,61338,-1,0,,0,0.00000000000000000000
chr21,10729723,10762066,32343,-1,0,,0,0.00000000000000000000
chr21,10772035,10805464,33429,-1,0,,0,0.00000000000000000000
chr21,11081443,11117907,36464,-1,0,85319,1,2.74243089074155000000
chr21,10813745,10842848,29103,-1,0,,0,0.00000000000000000000
chr21,10787114,10805791,18677,-1,0,,0,0.00000000000000000000
chr21,10741118,10756017,14899,-1,0,,0,0.00000000000000000000
chr21,11094626,11108968,14342,-1,0,85319,1,6.97252823873937000000
chr21,10712134,10719836,7702,-1,0,,0,0.00000000000000000000
chr21,10766137,10772796,6659,-1,0,,0,0.00000000000000000000
chr21,10783437,10788531,5094,-1,0,,0,0.00000000000000000000
chr21,10813486,10818240,4754,-1,0,,0,0.00000000000000000000
chr21,10789282,10794550,5268,-1,0,,0,0.00000000000000000000
chr21,10755712,10760728,5016,-1,0,,0,0.00000000000000000000
chr21,10780139,10784849,4710,-1,0,,0,0.00000000000000000000
chr21,11089959,11092744,2785,-1,0,85319,1,35.90664272890480000000
chr21,10719087,10721986,2899,-1,0,,0,0.00000000000000000000
chr21,10824977,10828078,3101,-1,0,,0,0.00000000000000000000
chr21,10749862,10752249,2387,-1,0,,0,0.00000000000000000000
chr21,11104809,11106820,2011,-1,0,,0,0.00000000000000000000
chr21,11186183,11188064,1881,-1,0,,0,0.00000000000000000000
chr21,10722213,10723694,1481,-1,0,,0,0.00000000000000000000
chr21,10719694,10721394,1700,-1,0,,0,0.00000000000000000000
chr21,10729294,10730559,1265,-1,0,,0,0.00000000000000000000
chr21,10778232,10779343,1111,-1,0,,0,0.00000000000000000000
chr21,10742281,10743272,991,-1,0,,0,0.00000000000000000000
chr21,10713039,10713842,803,-1,0,,0,0.00000000000000000000
chr21,11036110,11036733,623,-1,0,85319,1,160.51364365971100000000
chr21,10712096,10712761,665,-1,0,,0,0.00000000000000000000
chr21,10847548,10848206,658,-1,0,,0,0.00000000000000000000
chr21,10719417,10719904,487,-1,0,,0,0.00000000000000000000
chr21,10725216,10725811,595,-1,0,,0,0.00000000000000000000
chr21,10732529,10732973,444,-1,0,,0,0.00000000000000000000
chr21,10703711,10704222,511,-1,0,,0,0.00000000000000000000
chr21,10733897,10734404,507,-1,0,,0,0.00000000000000000000
chr21,10969139,10969438,299,-1,0,7179,1,334.44816053511700000000
chr21,10757527,10757858,331,-1,0,,0,0.00000000000000000000
chr21,11127553,11127788,235,-1,0,,0,0.00000000000000000000
chr21,10757109,10757303,194,-1,0,,0,0.00000000000000000000
chr21,10763309,10763523,214,-1,0,,0,0.00000000000000000000
chr21,11142684,11142886,202,-1,0,,0,0.00000000000000000000
chr21,10705543,10705662,119,-1,0,,0,0.00000000000000000000
chr21,11137702,11137792,90,-1,0,,0,0.00000000000000000000
chr21,14589909,15295930,706021,-1,0,317754,1,0.14163884643657900000
chr21,14572090,15118609,546519,-1,0,317754,1,0.18297625517136600000
chr21,14624075,14954305,330230,-1,0,,0,0.00000000000000000000
chr21,14957505,15202003,244498,-1,0,317754,1,0.40900130062413600000
chr21,14433488,14546240,112752,-1,0,,0,0.00000000000000000000
chr21,14452255,14550147,97892,-1,0,,0,0.00000000000000000000
chr21,14351402,14458632,107230,-1,0,,0,0.00000000000000000000
chr21,14983066,15085579,102513,-1,0,317754,1,0.97548603591739600000
chr21,15088939,15152177,63238,-1,0,,0,0.00000000000000000000
chr21,15230913,15271758,40845,-1,0,,0,0.00000000000000000000
chr21,14981793,15016799,35006,-1,0,317754,1,2.85665314517511000000
chr21,14816979,14870671,53692,-1,0,,0,0.00000000000000000000
chr21,14447045,14486392,39347,-1,0,,0,0.00000000000000000000
chr21,15240825,15262556,21731,-1,0,,0,0.00000000000000000000
chr21,15232958,15252744,19786,-1,0,,0,0.00000000000000000000
chr21,15251052,15270617,19565,-1,0,,0,0.00000000000000000000
chr21,14349726,14363199,13473,-1,0,,0,0.00000000000000000000
chr21,14340416,14349434,9018,-1,0,,0,0.00000000000000000000
chr21,14849085,14859456,10371,-1,0,,0,0.00000000000000000000
chr21,15264119,15272574,8455,-1,0,,0,0.00000000000000000000
chr21,14743017,14750453,7436,-1,0,,0,0.00000000000000000000
chr21,14841857,14848999,7142,-1,0,,0,0.00000000000000000000
chr21,15460406,15461873,1467,-1,0,,0,0.00000000000000000000
chr21,14816412,14818277,1865,-1,0,,0,0.00000000000000000000
chr21,15460778,15461862,1084,-1,0,,0,0.00000000000000000000
chr21,14816863,14817691,828,-1,0,,0,0.00000000000000000000
chr21,14365850,14366597,747,-1,0,,0,0.00000000000000000000
chr21,15307079,15307348,269,-1,0,,0,0.00000000000000000000
chr21,14650763,14650844,81,-1,0,,0,0.00000000000000000000
chr21,15705745,15708404,2659,-1,0,,0,0.00000000000000000000
chr21,15847468,15847539,71,-1,0,,0,0.00000000000000000000
chr21,16275035,16275545,510,-1,0,,0,0.00000000000000000000
chr21,16275283,16275361,78,-1,0,,0,0.00000000000000000000
chr21,16403191,16404403,1212,-1,0,8204,1,82.50825082508250000000
chr21,16588329,16591479,3150,-1,0,,0,0.00000000000000000000
chr21,16588453,16591097,2644,-1,0,,0,0.00000000000000000000
chr21,16624158,16628945,4787,-1,0,,0,0.00000000000000000000
chr21,17086696,17094002,7306,-1,0,,0,0.00000000000000000000
chr21,17378117,17378849,732,-1,0,,0,0.00000000000000000000
chr21,17669070,17670303,1233,-1,0,,0,0.00000000000000000000
chr21,17731937,17732123,186,-1,0,,0,0.00000000000000000000
chr21,18250515,18312104,61589,-1,0,,0,0.00000000000000000000
chr21,17776932,17789145,12213,-1,0,,0,0.00000000000000000000
chr21,19042756,19049516,6760,-1,0,,0,0.00000000000000000000
chr21,18719991,18726173,6182,-1,0,,0,0.00000000000000000000
chr21,17771023,17775356,4333,-1,0,,0,0.00000000000000000000
chr21,18612377,18613697,1320,-1,0,,0,0.00000000000000000000
chr21,18449650,18450874,1224,-1,0,,0,0.00000000000000000000
chr21,17943633,17944597,964,-1,0,,0,0.00000000000000000000
chr21,18738485,18739343,858,-1,0,,0,0.00000000000000000000
chr21,18457400,18457544,144,-1,0,,0,0.00000000000000000000
chr21,18457498,18457602,104,-1,0,,0,0.00000000000000000000
chr21,18825802,18825867,65,-1,0,,0,0.00000000000000000000
chr21,19326272,19329196,2924,-1,0,140578,1,34.19972640218880000000
chr21,19327015,19328511,1496,-1,0,140578,1,66.84491978609630000000
chr21,19587762,19588869,1107,-1,0,140578,1,90.33423667570010000000
chr21,19687762,19687992,230,-1,0,5651,1,434.78260869565200000000
chr21,19792681,19793270,589,-1,0,,0,0.00000000000000000000
chr21,19913899,19914360,461,-1,0,,0,0.00000000000000000000
chr21,19914052,19914393,341,-1,0,,0,0.00000000000000000000
chr21,19959384,19959796,412,-1,0,,0,0.00000000000000000000
chr21,19997018,20000488,3470,-1,0,,0,0.00000000000000000000
chr21,20123790,20124301,511,-1,0,,0,0.00000000000000000000
chr21,20231349,20231745,396,-1,0,,0,0.00000000000000000000
chr21,20366972,20399276,32304,-1,0,,0,0.00000000000000000000
chr21,20360235,20360435,200,-1,0,,0,0.00000000000000000000
chr21,20568012,20574141,6129,-1,0,,0,0.00000000000000000000
chr21,20839627,20847385,7758,-1,0,,0,0.00000000000000000000
chr21,20835838,20843525,7687,-1,0,,0,0.00000000000000000000
chr21,21289966,21441107,151141,-1,0,,0,0.00000000000000000000
chr21,21305650,21342196,36546,-1,0,,0,0.00000000000000000000
chr21,21574333,21596418,22085,-1,0,,0,0.00000000000000000000
chr21,21635703,21652994,17291,-1,0,,0,0.00000000000000000000
chr21,21300502,21314207,13705,-1,0,,0,0.00000000000000000000
chr21,21607936,21620794,12858,-1,0,,0,0.00000000000000000000
chr21,21263820,21268161,4341,-1,0,,0,0.00000000000000000000
chr21,21354158,21356970,2812,-1,0,,0,0.00000000000000000000
chr21,21621889,21624006,2117,-1,0,,0,0.00000000000000000000
chr21,21199253,21200922,1669,-1,0,,0,0.00000000000000000000
chr21,20989460,20990735,1275,-1,0,,0,0.00000000000000000000
chr21,21586165,21586367,202,-1,0,,0,0.00000000000000000000
chr21,21145507,21145584,77,-1,0,,0,0.00000000000000000000
chr21,21799274,21844856,45582,-1,0,,0,0.00000000000000000000
chr21,21902549,21906584,4035,-1,0,,0,0.00000000000000000000
chr21,22005627,22010676,5049,-1,0,,0,0.00000000000000000000
chr21,22000005,22004215,4210,-1,0,,0,0.00000000000000000000
chr21,21958447,21962191,3744,-1,0,,0,0.00000000000000000000
chr21,22051692,22052220,528,-1,0,,0,0.00000000000000000000
chr21,21896514,21896630,116,-1,0,,0,0.00000000000000000000
chr21,22051926,22051995,69,-1,0,,0,0.00000000000000000000
chr21,22418141,22456240,38099,-1,0,4685,1,2.62474080684532000000
chr21,22578472,22640468,61996,-1,0,4685,1,1.61300729079295000000
chr21,22660333,22660976,643,-1,0,4685,1,155.52099533437000000000
chr21,23188299,23202310,14011,-1,0,,0,0.00000000000000000000
chr21,23162177,23162435,258,-1,0,,0,0.00000000000000000000
chr21,23303746,23321547,17801,-1,0,,0,0.00000000000000000000
chr21,23618794,24083983,465189,-1,0,,0,0.00000000000000000000
chr21,23642860,23821734,178874,-1,0,,0,0.00000000000000000000
chr21,23812993,23945676,132683,-1,0,,0,0.00000000000000000000
chr21,24480138,24630377,150239,-1,0,,0,0.00000000000000000000
chr21,24292406,24418566,126160,-1,0,,0,0.00000000000000000000
chr21,24373347,24449282,75935,-1,0,,0,0.00000000000000000000
chr21,23991942,24057495,65553,-1,0,,0,0.00000000000000000000
chr21,24648905,24707985,59080,-1,0,,0,0.00000000000000000000
chr21,24175410,24211346,35936,-1,0,,0,0.00000000000000000000
chr21,24211863,24245751,33888,-1,0,,0,0.00000000000000000000
chr21,23632023,23665878,33855,-1,0,,0,0.00000000000000000000
chr21,24019605,24045237,25632,-1,0,,0,0.00000000000000000000
chr21,24680181,24706428,26247,-1,0,,0,0.00000000000000000000
chr21,24422847,24435740,12893,-1,0,,0,0.00000000000000000000
chr21,24816736,24832876,16140,-1,0,,0,0.00000000000000000000
chr21,23654309,23666528,12219,-1,0,,0,0.00000000000000000000
chr21,24429548,24433761,4213,-1,0,,0,0.00000000000000000000
chr21,24373728,24375487,1759,-1,0,,0,0.00000000000000000000
chr21,24391755,24393247,1492,-1,0,,0,0.00000000000000000000
chr21,23460403,23461425,1022,-1,0,,0,0.00000000000000000000
chr21,24374795,24375420,625,-1,0,,0,0.00000000000000000000
chr21,24506108,24506932,824,-1,0,,0,0.00000000000000000000
chr21,24742135,24742663,528,-1,0,,0,0.00000000000000000000
chr21,24829008,24829461,453,-1,0,,0,0.00000000000000000000
chr21,24542051,24542350,299,-1,0,,0,0.00000000000000000000
chr21,23795902,23796261,359,-1,0,,0,0.00000000000000000000
chr21,24742231,24742546,315,-1,0,,0,0.00000000000000000000
chr21,24444672,24444832,160,-1,0,,0,0.00000000000000000000
chr21,24542143,24542360,217,-1,0,,0,0.00000000000000000000
chr21,24542167,24542346,179,-1,0,,0,0.00000000000000000000
chr21,23636869,23636955,86,-1,0,,0,0.00000000000000000000
chr21,24444742,24444840,98,-1,0,,0,0.00000000000000000000
chr21,24576779,24576834,55,-1,0,,0,0.00000000000000000000
chr21,25218962,25310357,91395,-1,0,,0,0.00000000000000000000
chr21,24846415,24893280,46865,-1,0,,0,0.00000000000000000000
chr21,25280867,25310185,29318,-1,0,,0,0.00000000000000000000
chr21,25258224,25264874,6650,-1,0,,0,0.00000000000000000000
chr21,25295867,25299702,3835,-1,0,,0,0.00000000000000000000
chr21,25288274,25289681,1407,-1,0,,0,0.00000000000000000000
chr21,25388442,25388935,493,-1,0,,0,0.00000000000000000000
chr21,25388636,25388714,78,-1,0,,0,0.00000000000000000000
chr21,25451738,25452427,689,-1,0,,0,0.00000000000000000000
chr21,25498801,25501221,2420,-1,0,,0,0.00000000000000000000
chr21,25479625,25480594,969,-1,0,,0,0.00000000000000000000
chr21,25506886,25508028,1142,-1,0,,0,0.00000000000000000000
chr21,25507146,25507924,778,-1,0,,0,0.00000000000000000000
chr21,25552760,25553975,1215,-1,0,,0,0.00000000000000000000
chr21,25627327,25627542,215,-1,0,,0,0.00000000000000000000
chr21,25710165,25710603,438,-1,0,,0,0.00000000000000000000
chr21,25749276,25752380,3104,-1,0,,0,0.00000000000000000000
chr21,25764176,25764528,352,-1,0,,0,0.00000000000000000000
chr21,26059929,26066721,6792,-1,0,,0,0.00000000000000000000
chr21,26335279,26340515,5236,-1,0,,0,0.00000000000000000000
chr21,26359940,26364694,4754,-1,0,,0,0.00000000000000000000
chr21,26344476,26345770,1294,-1,0,,0,0.00000000000000000000
chr21,26341836,26342287,451,-1,0,,0,0.00000000000000000000
chr21,26825019,26825518,499,-1,0,,0,0.00000000000000000000
chr21,26825130,26825398,268,-1,0,,0,0.00000000000000000000
chr21,26862375,26865774,3399,-1,0,,0,0.00000000000000000000
chr21,26922267,26927166,4899,-1,0,,0,0.00000000000000000000
chr21,27180604,27247546,66942,-1,0,,0,0.00000000000000000000
chr21,27174813,27180023,5210,-1,0,,0,0.00000000000000000000
chr21,27274750,27274950,200,-1,0,351,1,500.00000000000000000000
chr21,27781243,27785221,3978,-1,0,,0,0.00000000000000000000
chr21,28023139,28026792,3653,-1,0,,0,0.00000000000000000000
chr21,28195097,28202085,6988,-1,0,,0,0.00000000000000000000
chr21,28196554,28201822,5268,-1,0,,0,0.00000000000000000000
chr21,28298945,28302475,3530,-1,0,11096,1,28.32861189801700000000
chr21,28375986,28407331,31345,-1,0,,0,0.00000000000000000000
chr21,28450816,28459852,9036,-1,0,,0,0.00000000000000000000
chr21,28449949,28456611,6662,-1,0,,0,0.00000000000000000000
chr21,28460635,28467223,6588,-1,0,,0,0.00000000000000000000
chr21,28476660,28477440,780,-1,0,,0,0.00000000000000000000
chr21,28985167,28994576,9409,-1,0,,0,0.00000000000000000000
chr21,29107314,29108573,1259,-1,0,,0,0.00000000000000000000
chr21,29213570,29359939,146369,-1,0,,0,0.00000000000000000000
chr21,29712677,29714404,1727,-1,0,,0,0.00000000000000000000
chr21,29712898,29714104,1206,-1,0,,0,0.00000000000000000000
chr21,29877992,29881250,3258,-1,0,,0,0.00000000000000000000
chr21,30045814,30046145,331,-1,0,,0,0.00000000000000000000
chr21,30152592,30152855,263,-1,0,,0,0.00000000000000000000
chr21,30263263,30264690,1427,-1,0,,0,0.00000000000000000000
chr21,30263596,30264244,648,-1,0,,0,0.00000000000000000000
chr21,30234666,30234979,313,-1,0,,0,0.00000000000000000000
chr21,30552048,30552733,685,-1,0,,0,0.00000000000000000000
chr21,30552223,30552585,362,-1,0,,0,0.00000000000000000000
chr21,30601735,30602274,539,-1,0,,0,0.00000000000000000000
chr21,30601807,30602153,346,-1,0,,0,0.00000000000000000000
chr21,30986827,30987707,880,-1,0,2897,1,113.63636363636400000000
chr21,31136196,31139191,2995,-1,0,2897,1,33.38898163606010000000
chr21,31292418,31293361,943,-1,0,2897,1,106.04453870625700000000
chr21,31638898,31646414,7516,-1,0,,0,0.00000000000000000000
chr21,31639106,31644613,5507,-1,0,,0,0.00000000000000000000
chr21,31640449,31642852,2403,-1,0,,0,0.00000000000000000000
chr21,31636708,31638613,1905,-1,0,,0,0.00000000000000000000
chr21,31736758,31826863,90105,-1,0,140258;254950;337959;284827;337960,5,5.54908162699073000000
chr21,31808329,31824210,15881,-1,0,254950,1,6.29683269315534000000
chr21,31734917,31738351,3434,-1,0,,0,0.00000000000000000000
chr21,31894325,31908733,14408,-1,0,,0,0.00000000000000000000
chr21,31930550,31933066,2516,-1,0,,0,0.00000000000000000000
chr21,32092748,32093260,512,-1,0,,0,0.00000000000000000000
chr21,32092861,32093141,280,-1,0,,0,0.00000000000000000000
chr21,32432178,32434438,2260,-1,0,,0,0.00000000000000000000
chr21,32667912,32670194,2282,-1,0,7074,1,43.82120946538120000000
chr21,32946190,32948774,2584,-1,0,,0,0.00000000000000000000
chr21,33156791,33157474,683,-1,0,,0,0.00000000000000000000
chr21,33174094,33175052,958,-1,0,,0,0.00000000000000000000
chr21,33291139,33291666,527,-1,0,30811,1,189.75332068311200000000
chr21,33843193,33843775,582,-1,0,59271,1,171.82130584192400000000
chr21,33850086,33850224,138,-1,0,59271,1,724.63768115942000000000
chr21,33943662,33947949,4287,-1,0,140290,1,23.32633543270350000000
chr21,34143998,34144463,465,-1,0,94104,1,215.05376344086000000000
chr21,34375349,34376075,726,-1,0,,0,0.00000000000000000000
chr21,34693797,34696426,2629,-1,0,,0,0.00000000000000000000
chr21,34693718,34694194,476,-1,0,,0,0.00000000000000000000
chr21,35026395,35060659,34264,-1,0,6453,1,2.91851505953771000000
chr21,35024339,35025405,1066,-1,0,6453,1,93.80863039399630000000
chr21,35248312,35248769,457,-1,0,6453,1,218.81838074398200000000
chr21,35398844,35399116,272,-1,0,,0,0.00000000000000000000
chr21,35445350,35446724,1374,-1,0,6526;64968,2,145.56040756914100000000
chr21,35530428,35533202,2774,-1,0,,0,0.00000000000000000000
chr21,35695873,35696829,956,-1,0,,0,0.00000000000000000000
chr21,36030181,36030610,429,-1,0,,0,0.00000000000000000000
chr21,36072578,36073482,904,-1,0,54102,1,110.61946902654900000000
chr21,36072995,36073464,469,-1,0,54102,1,213.21961620469100000000
chr21,36261096,36262805,1709,-1,0,861,1,58.51375073142190000000
chr21,36295754,36296396,642,-1,0,861,1,155.76323987538900000000
chr21,36295979,36296195,216,-1,0,861,1,462.96296296296300000000
chr21,36298785,36298861,76,-1,0,861,1,1315.78947368421000000000
chr21,36451020,36453399,2379,-1,0,,0,0.00000000000000000000
chr21,36560995,36565908,4913,-1,0,,0,0.00000000000000000000
chr21,36600598,36602480,1882,-1,0,,0,0.00000000000000000000
chr21,36767710,36768247,537,-1,0,,0,0.00000000000000000000
chr21,36893021,36896618,3597,-1,0,,0,0.00000000000000000000
chr21,37014800,37015371,571,-1,0,,0,0.00000000000000000000
chr21,37014962,37015169,207,-1,0,,0,0.00000000000000000000
chr21,37294842,37300500,5658,-1,0,,0,0.00000000000000000000
chr21,37365545,37366677,1132,-1,0,,0,0.00000000000000000000
chr21,37403780,37405474,1694,-1,0,,0,0.00000000000000000000
chr21,37642617,37644197,1580,-1,0,9980,1,63.29113924050630000000
chr21,37675906,37676556,650,-1,0,,0,0.00000000000000000000
chr21,37676109,37676344,235,-1,0,,0,0.00000000000000000000
chr21,37699617,37700145,528,-1,0,23515,1,189.39393939393900000000
chr21,37857282,37857633,351,-1,0,23562,1,284.90028490028500000000
chr21,37864434,37864768,334,-1,0,23562,1,299.40119760479000000000
chr21,37868158,37870361,2203,-1,0,23562,1,45.39264639128460000000
chr21,38151227,38157787,6560,-1,0,3141,1,15.24390243902440000000
chr21,38192772,38193651,879,-1,0,3141,1,113.76564277588200000000
chr21,38287892,38302869,14977,-1,0,3141,1,6.67690458703345000000
chr21,38707412,38711836,4424,-1,0,,0,0.00000000000000000000
chr21,38961495,38962191,696,-1,0,,0,0.00000000000000000000
chr21,38961711,38962035,324,-1,0,,0,0.00000000000000000000
chr21,39128621,39130075,1454,-1,0,3763,1,68.77579092159560000000
chr21,39233013,39233543,530,-1,0,3763,1,188.67924528301900000000
chr21,39233178,39233240,62,-1,0,3763,1,1612.90322580645000000000
chr21,39314946,39317263,2317,-1,0,,0,0.00000000000000000000
chr21,39481257,39481879,622,-1,0,10281,1,160.77170418006400000000
chr21,39590431,39590988,557,-1,0,,0,0.00000000000000000000
chr21,39590542,39590888,346,-1,0,,0,0.00000000000000000000
chr21,39651072,39655118,4046,-1,0,3772,1,24.71576866040530000000
chr21,39863887,39863992,105,-1,0,2078,1,952.38095238095300000000
chr21,39900245,39900795,550,-1,0,2078,1,181.81818181818200000000
chr21,39900346,39900669,323,-1,0,2078,1,309.59752321981400000000
chr21,39911590,39917081,5491,-1,0,2078,1,18.21161901293020000000
chr21,40135895,40143776,7881,-1,0,,0,0.00000000000000000000
chr21,40344304,40344747,443,-1,0,,0,0.00000000000000000000
chr21,40344306,40344628,322,-1,0,,0,0.00000000000000000000
chr21,40475523,40479636,4113,-1,0,,0,0.00000000000000000000
chr21,40507878,40508282,404,-1,0,,0,0.00000000000000000000
chr21,40734413,40737005,2592,-1,0,,0,0.00000000000000000000
chr21,40789933,40790670,737,-1,0,150082;106865373,2,271.37042062415200000000
chr21,40881843,40882207,364,-1,0,6450;106865373,2,549.45054945054900000000
chr21,40926853,40926941,88,-1,0,,0,0.00000000000000000000
chr21,41199930,41200075,145,-1,0,,0,0.00000000000000000000
chr21,41217041,41217229,188,-1,0,,0,0.00000000000000000000
chr21,41346366,41347056,690,-1,0,,0,0.00000000000000000000
chr21,41346397,41346606,209,-1,0,,0,0.00000000000000000000
chr21,41521148,41521878,730,-1,0,1826,1,136.98630136986300000000
chr21,41554457,41555065,608,-1,0,1826,1,164.47368421052600000000
chr21,41554614,41554992,378,-1,0,1826,1,264.55026455026500000000
chr21,41586768,41587318,550,-1,0,1826,1,181.81818181818200000000
chr21,41586881,41587211,330,-1,0,1826,1,303.03030303030300000000
chr21,41812344,41812687,343,-1,0,1826,1,291.54518950437300000000
chr21,41812367,41812669,302,-1,0,1826,1,331.12582781457000000000
chr21,41957021,41957616,595,-1,0,1826,1,168.06722689075600000000
chr21,41957262,41957413,151,-1,0,1826,1,662.25165562913900000000
chr21,41957254,41957357,103,-1,0,1826,1,970.87378640776700000000
chr21,42054406,42054909,503,-1,0,1826,1,198.80715705765400000000
chr21,42054522,42054749,227,-1,0,1826,1,440.52863436123400000000
chr21,42341707,42342099,392,-1,0,,0,0.00000000000000000000
chr21,42402797,42403309,512,-1,0,,0,0.00000000000000000000
chr21,42402883,42403211,328,-1,0,,0,0.00000000000000000000
chr21,42453469,42459566,6097,-1,0,,0,0.00000000000000000000
chr21,42458098,42458404,306,-1,0,,0,0.00000000000000000000
chr21,42458112,42458221,109,-1,0,,0,0.00000000000000000000
chr21,42616327,42616742,415,-1,0,25825,1,240.96385542168700000000
chr21,42761727,42766405,4678,-1,0,4600,1,21.37665669089350000000
chr21,42688702,42690363,1661,-1,0,54097,1,60.20469596628540000000
chr21,42845931,42848417,2486,-1,0,7113,1,40.22526146419950000000
chr21,42911936,42912388,452,-1,0,,0,0.00000000000000000000
chr21,42936184,42936658,474,-1,0,,0,0.00000000000000000000
chr21,43037531,43039285,1754,-1,0,,0,0.00000000000000000000
chr21,43037004,43038401,1397,-1,0,,0,0.00000000000000000000
chr21,43136906,43138699,1793,-1,0,,0,0.00000000000000000000
chr21,43226013,43227418,1405,-1,0,63977,1,71.17437722419930000000
chr21,43226793,43227378,585,-1,0,63977,1,170.94017094017100000000
chr21,43226211,43226564,353,-1,0,63977,1,283.28611898017000000000
chr21,43284687,43285507,820,-1,0,63977,1,121.95121951219500000000
chr21,43310999,43311513,514,-1,0,25966,1,194.55252918287900000000
chr21,43350052,43353469,3417,-1,0,25966,1,29.26543751829090000000
chr21,43351445,43354892,3447,-1,0,25966,1,29.01073397156950000000
chr21,43387242,43388257,1015,-1,0,,0,0.00000000000000000000
chr21,43557567,43558204,637,-1,0,89766,1,156.98587127158600000000
chr21,43498559,43498952,393,-1,0,89766,1,254.45292620865100000000
chr21,43582722,43583121,399,-1,0,,0,0.00000000000000000000
chr21,43678093,43678312,219,-1,0,9619,1,456.62100456621000000000
chr21,43703950,43704291,341,-1,0,9619,1,293.25513196480900000000
chr21,43745863,43751115,5252,-1,0,,0,0.00000000000000000000
chr21,43933622,43934715,1093,-1,0,54020,1,91.49130832570910000000
chr21,43989989,43990546,557,-1,0,54020,1,179.53321364452400000000
chr21,43990087,43990223,136,-1,0,54020,1,735.29411764705900000000
chr21,44007541,44011089,3548,-1,0,,0,0.00000000000000000000
chr21,44008059,44010150,2091,-1,0,,0,0.00000000000000000000
chr21,44823222,44838093,14871,-1,0,150094,1,6.72449734382355000000
chr21,44969018,44974013,4995,-1,0,11077,1,20.02002002002000000000
chr21,44135367,44139754,4387,-1,0,5152,1,22.79462046956920000000
chr21,44970402,44973398,2996,-1,0,11077,1,33.37783711615490000000
chr21,44284587,44288010,3423,-1,0,10785,1,29.21413964358750000000
chr21,44970333,44971747,1414,-1,0,11077,1,70.72135785007070000000
chr21,44756542,44757466,924,-1,0,,0,0.00000000000000000000
chr21,44501186,44502014,828,-1,0,,0,0.00000000000000000000
chr21,44705519,44706071,552,-1,0,,0,0.00000000000000000000
chr21,44792511,44792929,418,-1,0,,0,0.00000000000000000000
chr21,44209411,44210017,606,-1,0,,0,0.00000000000000000000
chr21,44808566,44809052,486,-1,0,,0,0.00000000000000000000
chr21,44339992,44340394,402,-1,0,90625,1,248.75621890547300000000
chr21,44891737,44892040,303,-1,0,,0,0.00000000000000000000
chr21,44805246,44805646,400,-1,0,,0,0.00000000000000000000
chr21,44134839,44135043,204,-1,0,5152,1,490.19607843137300000000
chr21,44035459,44035718,259,-1,0,,0,0.00000000000000000000
chr21,45051813,45052122,309,-1,0,11077,1,323.62459546925600000000
chr21,45232877,45241349,8472,-1,0,,0,0.00000000000000000000
chr21,45158406,45160758,2352,-1,0,8566,1,42.51700680272110000000
chr21,45238052,45240139,2087,-1,0,,0,0.00000000000000000000
chr21,45159263,45160912,1649,-1,0,8566,1,60.64281382656160000000
chr21,45206827,45207359,532,-1,0,,0,0.00000000000000000000
chr21,45207022,45207249,227,-1,0,,0,0.00000000000000000000
chr21,45254689,45264263,9574,-1,0,,0,0.00000000000000000000
chr21,45326189,45334055,7866,-1,0,56894,1,12.71294177472670000000
chr21,45672850,46004762,331912,-1,0,386679;755;386682;386677;5211;386672;386680;54084;81543;7226;29947;326,12,3.61541613439707000000
chr21,45994406,46021184,26778,-1,0,386674;386675;386672;386680;54084,5,18.67204421540070000000
chr21,45681352,45685322,3970,-1,0,29947,1,25.18891687657430000000
chr21,45618142,45621227,3085,-1,0,,0,0.00000000000000000000
chr21,45684214,45686530,2316,-1,0,,0,0.00000000000000000000
chr21,45942839,45945089,2250,-1,0,54084,1,44.44444444444440000000
chr21,45681760,45683490,1730,-1,0,29947,1,57.80346820809250000000
chr21,45619178,45620712,1534,-1,0,,0,0.00000000000000000000
chr21,45815517,45816867,1350,-1,0,7226,1,74.07407407407410000000
chr21,45922572,45923096,524,-1,0,54084,1,190.83969465648900000000
chr21,45829304,45829934,630,-1,0,7226,1,158.73015873015900000000
chr21,45850190,45850711,521,-1,0,7226,1,191.93857965451100000000
chr21,45789348,45789953,605,-1,0,7226,1,165.28925619834700000000
chr21,45901493,45901933,440,-1,0,,0,0.00000000000000000000
chr21,45942820,45943271,451,-1,0,54084,1,221.72949002217300000000
chr21,45723731,45724130,399,-1,0,5211,1,250.62656641604000000000
chr21,45830077,45830425,348,-1,0,7226,1,287.35632183908000000000
chr21,45850300,45850631,331,-1,0,7226,1,302.11480362537800000000
chr21,45584150,45584405,255,-1,0,,0,0.00000000000000000000
chr21,45604015,45604211,196,-1,0,,0,0.00000000000000000000
chr21,45816041,45816237,196,-1,0,7226,1,510.20408163265300000000
chr21,45922786,45922879,93,-1,0,54084,1,1075.26881720430000000000
chr21,45583190,45583262,72,-1,0,,0,0.00000000000000000000
chr21,46222495,46325108,102613,-1,0,754;6612;3689,3,2.92360617075809000000
chr21,46303201,46329500,26299,-1,0,3689,1,3.80242594775467000000
chr21,46153099,46153671,572,-1,0,,0,0.00000000000000000000
chr21,46078733,46079300,567,-1,0,54084,1,176.36684303351000000000
chr21,46153281,46153536,255,-1,0,,0,0.00000000000000000000
chr21,46170368,46170669,301,-1,0,,0,0.00000000000000000000
chr21,46184055,46184364,309,-1,0,,0,0.00000000000000000000
chr21,46153266,46153456,190,-1,0,,0,0.00000000000000000000
chr21,46184165,46184275,110,-1,0,,0,0.00000000000000000000
chr21,46153309,46153383,74,-1,0,,0,0.00000000000000000000
chr21,46370910,46371940,1030,-1,0,85395,1,97.08737864077670000000
chr21,46401374,46402705,1331,-1,0,,0,0.00000000000000000000
chr21,46401513,46402355,842,-1,0,,0,0.00000000000000000000
chr21,46401431,46401770,339,-1,0,,0,0.00000000000000000000
chr21,46447739,46449084,1345,-1,0,,0,0.00000000000000000000
chr21,46447982,46448762,780,-1,0,,0,0.00000000000000000000
chr21,46443179,46443234,55,-1,0,,0,0.00000000000000000000
chr21,46528463,46528918,455,-1,0,104,1,219.78021978022000000000
chr21,46528631,46528695,64,-1,0,104,1,1562.50000000000000000000
chr21,46565820,46566249,429,-1,0,104,1,233.10023310023300000000
chr21,46572184,46572238,54,-1,0,104,1,1851.85185185185000000000
chr21,46762906,46763099,193,-1,0,,0,0.00000000000000000000
chr21,46765108,46766097,989,-1,0,,0,0.00000000000000000000
chr21,46775990,46779688,3698,-1,0,,0,0.00000000000000000000
chr21,46800105,46800677,572,-1,0,,0,0.00000000000000000000
chr21,46856598,46858323,1725,-1,0,80781,1,57.97101449275360000000
chr21,46857372,46858198,826,-1,0,80781,1,121.06537530266300000000
chr21,46921566,46921998,432,-1,0,80781,1,231.48148148148100000000
chr21,46906164,46906373,209,-1,0,80781,1,478.46889952153100000000
chr21,46947545,46947664,119,-1,0,6573,1,840.33613445378100000000
chr21,47026033,47026302,269,-1,0,,0,0.00000000000000000000
chr21,47050877,47067209,16332,-1,0,,0,0.00000000000000000000
chr21,47053034,47054451,1417,-1,0,,0,0.00000000000000000000
chr21,47090909,47161568,70659,-1,0,,0,0.00000000000000000000
chr21,47279037,47279430,393,-1,0,54039,1,254.45292620865100000000
chr21,47315671,47354451,38780,-1,0,54039,1,2.57864878803507000000
chr21,47343730,47345124,1394,-1,0,54039,1,71.73601147776180000000
chr21,47318050,47318921,871,-1,0,54039,1,114.81056257175700000000
chr21,47321969,47322455,486,-1,0,54039,1,205.76131687242800000000
chr21,47343639,47344233,594,-1,0,54039,1,168.35016835016800000000
chr21,47343766,47343977,211,-1,0,54039,1,473.93364928910000000000
chr21,47387501,47431500,43999,-1,0,1291,1,2.27277892679379000000
chr21,47388019,47389728,1709,-1,0,,0,0.00000000000000000000
chr21,47388130,47389461,1331,-1,0,,0,0.00000000000000000000
chr21,47388168,47388810,642,-1,0,,0,0.00000000000000000000
chr21,47454149,47455570,1421,-1,0,,0,0.00000000000000000000
chr21,47454308,47454754,446,-1,0,,0,0.00000000000000000000
chr21,47467487,47467801,314,-1,0,,0,0.00000000000000000000
chr21,47530701,47581100,50399,-1,0,1292;84221;10841,3,5.95249905752098000000
chr21,47589167,47591160,1993,-1,0,84221,1,50.17561465127950000000
chr21,47609721,47611005,1284,-1,0,4047,1,77.88161993769470000000
chr21,47609743,47610874,1131,-1,0,4047,1,88.41732979664010000000
chr21,47603399,47604082,683,-1,0,84221,1,146.41288433382100000000
chr21,47553455,47553883,428,-1,0,,0,0.00000000000000000000
chr21,47603490,47603821,331,-1,0,84221,1,302.11480362537800000000
chr21,47488509,47488772,263,-1,0,,0,0.00000000000000000000
chr21,47555264,47555389,125,-1,0,,0,0.00000000000000000000
chr21,47656976,47658894,1918,-1,0,8888,1,52.13764337851930000000
chr21,47657351,47658672,1321,-1,0,8888,1,75.70022710068130000000
chr21,47712385,47714783,2398,-1,0,54059,1,41.70141784820680000000
chr21,47779117,47779654,537,-1,0,5116,1,186.21973929236500000000
chr21,47801903,47804594,2691,-1,0,5116,1,37.16090672612410000000
chr21,48012792,48070297,57505,-1,0,6285;3275,2,3.47795843839666000000
chr22,16089360,16476630,387270,-1,0,81061;23784,2,0.51643556175278200000
chr22,16458227,16649982,191755,-1,0,,0,0.00000000000000000000
chr22,16161593,16341204,179611,-1,0,23784,1,0.55675877312636800000
chr22,16087012,16223770,136758,-1,0,,0,0.00000000000000000000
chr22,16079737,16152710,72973,-1,0,,0,0.00000000000000000000
chr22,16374835,16455693,80858,-1,0,81061,1,1.23673600633209000000
chr22,16578015,16613284,35269,-1,0,,0,0.00000000000000000000
chr22,17379738,17397823,18085,-1,0,,0,0.00000000000000000000
chr22,16589911,16605658,15747,-1,0,,0,0.00000000000000000000
chr22,17039098,17052089,12991,-1,0,,0,0.00000000000000000000
chr22,16848204,16861013,12809,-1,0,,0,0.00000000000000000000
chr22,16050035,16061970,11935,-1,0,,0,0.00000000000000000000
chr22,17770384,17779691,9307,-1,0,,0,0.00000000000000000000
chr22,16101306,16110186,8880,-1,0,,0,0.00000000000000000000
chr22,16364977,16370665,5688,-1,0,,0,0.00000000000000000000
chr22,17770363,17774196,3833,-1,0,,0,0.00000000000000000000
chr22,17332911,17336748,3837,-1,0,,0,0.00000000000000000000
chr22,16942588,16945869,3281,-1,0,,0,0.00000000000000000000
chr22,16533232,16536196,2964,-1,0,,0,0.00000000000000000000
chr22,17825717,17827347,1630,-1,0,,0,0.00000000000000000000
chr22,17026361,17027753,1392,-1,0,,0,0.00000000000000000000
chr22,17107195,17108414,1219,-1,0,,0,0.00000000000000000000
chr22,17362795,17363537,742,-1,0,,0,0.00000000000000000000
chr22,17333035,17333645,610,-1,0,,0,0.00000000000000000000
chr22,17617130,17617520,390,-1,0,,0,0.00000000000000000000
chr22,17654551,17654891,340,-1,0,,0,0.00000000000000000000
chr22,17718964,17719274,310,-1,0,,0,0.00000000000000000000
chr22,16858656,16858926,270,-1,0,,0,0.00000000000000000000
chr22,16858419,16858649,230,-1,0,,0,0.00000000000000000000
chr22,17665783,17665839,56,-1,0,51816,1,1785.71428571429000000000
chr22,17884157,17884628,471,-1,0,27443,1,212.31422505307900000000
chr22,18003596,18004263,667,-1,0,27443,1,149.92503748125900000000
chr22,18056401,18064300,7899,-1,0,83733;101929372,2,25.31966071654640000000
chr22,18140419,18144805,4386,-1,0,23786,1,22.79981760145920000000
chr22,18057539,18060489,2950,-1,0,83733,1,33.89830508474580000000
chr22,18126438,18129642,3204,-1,0,23786,1,31.21098626716600000000
chr22,18066790,18069337,2547,-1,0,83733;101929372,2,78.52375343541420000000
chr22,18142548,18144762,2214,-1,0,23786,1,45.16711833785000000000
chr22,18079169,18080612,1443,-1,0,529,1,69.30006930006930000000
chr22,18047287,18047807,520,-1,0,83733,1,192.30769230769200000000
chr22,18099469,18099910,441,-1,0,529,1,226.75736961451200000000
chr22,18047375,18047733,358,-1,0,83733,1,279.32960893854700000000
chr22,18196319,18198118,1799,-1,0,23786,1,55.58643690939410000000
chr22,18218409,18219242,833,-1,0,637,1,120.04801920768300000000
chr22,18283769,18284328,559,-1,0,57553,1,178.89087656529500000000
chr22,18283886,18284197,311,-1,0,57553,1,321.54340836012900000000
chr22,18317734,18318246,512,-1,0,57553,1,195.31250000000000000000
chr22,18359239,18360411,1172,-1,0,57553,1,85.32423208191130000000
chr22,18359578,18360282,704,-1,0,57553,1,142.04545454545500000000
chr22,18359885,18360312,427,-1,0,57553,1,234.19203747072600000000
chr22,18359484,18359875,391,-1,0,57553,1,255.75447570332500000000
chr22,18535754,18535914,160,-1,0,,0,0.00000000000000000000
chr22,18589546,18589787,241,-1,0,,0,0.00000000000000000000
chr22,18620344,18629822,9478,-1,0,,0,0.00000000000000000000
chr22,18625171,18629334,4163,-1,0,,0,0.00000000000000000000
chr22,18760679,19008945,248266,-1,0,5625;8214,2,0.80558755528344600000
chr22,18886546,19006736,120190,-1,0,5625;8214,2,1.66403194941343000000
chr22,18887501,18926300,38799,-1,0,5625;8214,2,5.15477203020696000000
chr22,18849842,18883127,33285,-1,0,,0,0.00000000000000000000
chr22,18688193,18709258,21065,-1,0,,0,0.00000000000000000000
chr22,18997195,19009723,12528,-1,0,,0,0.00000000000000000000
chr22,18877972,18884333,6361,-1,0,,0,0.00000000000000000000
chr22,18703239,18712753,9514,-1,0,,0,0.00000000000000000000
chr22,18684441,18688881,4440,-1,0,,0,0.00000000000000000000
chr22,18878622,18881345,2723,-1,0,,0,0.00000000000000000000
chr22,18876225,18878252,2027,-1,0,,0,0.00000000000000000000
chr22,18876907,18878612,1705,-1,0,,0,0.00000000000000000000
chr22,18957776,18958708,932,-1,0,,0,0.00000000000000000000
chr22,18977571,18977649,78,-1,0,,0,0.00000000000000000000
chr22,19099910,19100610,700,-1,0,9993,1,142.85714285714300000000
chr22,19123752,19123831,79,-1,0,8220,1,1265.82278481013000000000
chr22,19123832,19123911,79,-1,0,8220,1,1265.82278481013000000000
chr22,19143617,19144360,743,-1,0,,0,0.00000000000000000000
chr22,19538800,19538880,80,-1,0,,0,0.00000000000000000000
chr22,19564549,19574758,10209,-1,0,,0,0.00000000000000000000
chr22,19571615,19573103,1488,-1,0,,0,0.00000000000000000000
chr22,19571810,19572907,1097,-1,0,,0,0.00000000000000000000
chr22,19706337,19771786,65449,-1,0,5413;2812;6899,3,4.58372167641981000000
chr22,20030190,20061688,31498,-1,0,128989,1,3.17480474950791000000
chr22,20031054,20032710,1656,-1,0,128989,1,60.38647342995170000000
chr22,19912540,19913436,896,-1,0,10587,1,111.60714285714300000000
chr22,19748054,19748970,916,-1,0,6899,1,109.17030567685600000000
chr22,20149699,20150539,840,-1,0,,0,0.00000000000000000000
chr22,19947331,19947398,67,-1,0,1312,1,1492.53731343284000000000
chr22,20360055,20495631,135576,-1,0,85376;728229,2,1.47518734879330000000
chr22,21256865,21435776,178911,-1,0,400891;1399;80764;6545;150209;8216;9127,7,3.91255987613953000000
chr22,20428070,20499197,71127,-1,0,85376,1,1.40593586120601000000
chr22,20661985,20698889,36904,-1,0,,0,0.00000000000000000000
chr22,20369597,20397722,28125,-1,0,728229,1,3.55555555555556000000
chr22,20658961,20676027,17066,-1,0,,0,0.00000000000000000000
chr22,20947119,20962447,15328,-1,0,,0,0.00000000000000000000
chr22,20950621,20953846,3225,-1,0,,0,0.00000000000000000000
chr22,20973242,20974970,1728,-1,0,,0,0.00000000000000000000
chr22,21812558,21916568,104010,-1,0,645426;150221;7332,3,2.88433804441881000000
chr22,21714267,21798353,84086,-1,0,440804;23119,2,2.37851723235735000000
chr22,21711480,21742055,30575,-1,0,440804,1,3.27064595257563000000
chr22,21866876,21909287,42411,-1,0,7332;150221,2,4.71575770436915000000
chr22,21772188,21797403,25215,-1,0,23119,1,3.96589331746976000000
chr22,21808228,21812994,4766,-1,0,,0,0.00000000000000000000
chr22,21998817,22000352,1535,-1,0,,0,0.00000000000000000000
chr22,22069948,22070130,182,-1,0,29799,1,549.45054945054900000000
chr22,22523705,23245116,721411,-1,0,129025;91227;140883;100423062;7441;23532,6,0.83170342564779300000
chr22,22781487,23244441,462954,-1,0,129025;91227;140883;100423062;23532,5,1.08002090920480000000
chr22,22378081,22598849,220768,-1,0,,0,0.00000000000000000000
chr22,22977920,23242390,264470,-1,0,91227;100423062,2,0.75622944001210000000
chr22,22669466,22911909,242443,-1,0,129025;140883;23532,3,1.23740425584570000000
chr22,23071080,23244717,173637,-1,0,100423062,1,0.57591411968647200000
chr22,22341003,22491223,150220,-1,0,,0,0.00000000000000000000
chr22,22470905,22630641,159736,-1,0,7441,1,0.62603295437471800000
chr22,22977335,23120101,142766,-1,0,91227,1,0.70044688511270200000
chr22,22451477,22561564,110087,-1,0,,0,0.00000000000000000000
chr22,22583095,22685764,102669,-1,0,7441,1,0.97400383757512000000
chr22,23154652,23245409,90757,-1,0,100423062,1,1.10184338398140000000
chr22,22517055,22599641,82586,-1,0,7441,1,1.21085898336280000000
chr22,23106928,23181172,74244,-1,0,,0,0.00000000000000000000
chr22,23025607,23087867,62260,-1,0,,0,0.00000000000000000000
chr22,23198366,23245539,47173,-1,0,100423062,1,2.11985669768724000000
chr22,22456175,22522735,66560,-1,0,,0,0.00000000000000000000
chr22,22315314,22367454,52140,-1,0,8940,1,1.91791331031837000000
chr22,23050019,23108234,58215,-1,0,,0,0.00000000000000000000
chr22,22732085,22783512,51427,-1,0,,0,0.00000000000000000000
chr22,22411253,22442112,30859,-1,0,,0,0.00000000000000000000
chr22,22714017,22736971,22954,-1,0,,0,0.00000000000000000000
chr22,22550262,22581147,30885,-1,0,,0,0.00000000000000000000
chr22,22569633,22599156,29523,-1,0,,0,0.00000000000000000000
chr22,22735502,22765709,30207,-1,0,,0,0.00000000000000000000
chr22,23196210,23224900,28690,-1,0,,0,0.00000000000000000000
chr22,22677670,22707105,29435,-1,0,,0,0.00000000000000000000
chr22,22462496,22486758,24262,-1,0,,0,0.00000000000000000000
chr22,23074777,23099642,24865,-1,0,,0,0.00000000000000000000
chr22,23223448,23238992,15544,-1,0,100423062,1,6.43335048893464000000
chr22,23249531,23262659,13128,-1,0,,0,0.00000000000000000000
chr22,23471436,23479413,7977,-1,0,27156,1,12.53604111821490000000
chr22,22385006,22394144,9138,-1,0,,0,0.00000000000000000000
chr22,22373254,22379663,6409,-1,0,,0,0.00000000000000000000
chr22,22922799,22928839,6040,-1,0,,0,0.00000000000000000000
chr22,22759385,22764549,5164,-1,0,,0,0.00000000000000000000
chr22,22517061,22522501,5440,-1,0,,0,0.00000000000000000000
chr22,22906034,22909457,3423,-1,0,,0,0.00000000000000000000
chr22,23262668,23267193,4525,-1,0,,0,0.00000000000000000000
chr22,23477070,23480254,3184,-1,0,27156,1,31.40703517587940000000
chr22,23378897,23382308,3411,-1,0,,0,0.00000000000000000000
chr22,22416916,22419025,2109,-1,0,,0,0.00000000000000000000
chr22,22687530,22689408,1878,-1,0,,0,0.00000000000000000000
chr22,23478408,23479616,1208,-1,0,27156,1,82.78145695364240000000
chr22,23576849,23577808,959,-1,0,613,1,104.27528675703900000000
chr22,23478587,23479213,626,-1,0,27156,1,159.74440894568700000000
chr22,22928313,22928428,115,-1,0,,0,0.00000000000000000000
chr22,23032119,23032179,60,-1,0,,0,0.00000000000000000000
chr22,22920875,22920926,51,-1,0,,0,0.00000000000000000000
chr22,24274226,24397106,122880,-1,0,2952;1652;100037417;391322;653689,5,4.06901041666667000000
chr22,23917274,23983110,65836,-1,0,51233;3543,2,3.03785163132633000000
chr22,24337632,24399378,61746,-1,0,2952;391322,2,3.23907621546335000000
chr22,24274103,24340284,66181,-1,0,1652;653689;100037417,3,4.53302307308744000000
chr22,25012903,25073295,60392,-1,0,2678,1,1.65584845674924000000
chr22,24271752,24311656,39904,-1,0,653689;100037417,2,5.01202886928629000000
chr22,24360812,24402386,41574,-1,0,2952;391322,2,4.81069899456391000000
chr22,25065701,25109980,44279,-1,0,,0,0.00000000000000000000
chr22,24298368,24333275,34907,-1,0,1652;653689;100037417,3,8.59426476064973000000
chr22,24314289,24334833,20544,-1,0,1652;100037417,2,9.73520249221184000000
chr22,24273894,24294073,20179,-1,0,,0,0.00000000000000000000
chr22,24351330,24366196,14866,-1,0,,0,0.00000000000000000000
chr22,24329027,24346058,17031,-1,0,,0,0.00000000000000000000
chr22,24281736,24294572,12836,-1,0,,0,0.00000000000000000000
chr22,24374283,24385236,10953,-1,0,2952,1,9.12991874372318000000
chr22,24274760,24284207,9447,-1,0,,0,0.00000000000000000000
chr22,24060815,24070645,9830,-1,0,,0,0.00000000000000000000
chr22,24356490,24366280,9790,-1,0,,0,0.00000000000000000000
chr22,24326710,24333474,6764,-1,0,,0,0.00000000000000000000
chr22,24335114,24342345,7231,-1,0,,0,0.00000000000000000000
chr22,23901429,23907777,6348,-1,0,,0,0.00000000000000000000
chr22,24273471,24278069,4598,-1,0,,0,0.00000000000000000000
chr22,24194953,24200317,5364,-1,0,66035,1,18.64280387770320000000
chr22,23961265,23965605,4340,-1,0,51233,1,23.04147465437790000000
chr22,23900590,23903259,2669,-1,0,,0,0.00000000000000000000
chr22,24025878,24029338,3460,-1,0,,0,0.00000000000000000000
chr22,24362192,24364920,2728,-1,0,,0,0.00000000000000000000
chr22,24276431,24279230,2799,-1,0,,0,0.00000000000000000000
chr22,24274427,24276772,2345,-1,0,,0,0.00000000000000000000
chr22,24195932,24198504,2572,-1,0,,0,0.00000000000000000000
chr22,24025592,24027537,1945,-1,0,,0,0.00000000000000000000
chr22,23878664,23880315,1651,-1,0,,0,0.00000000000000000000
chr22,23901256,23902624,1368,-1,0,,0,0.00000000000000000000
chr22,23795367,23796539,1172,-1,0,,0,0.00000000000000000000
chr22,23844748,23845272,524,-1,0,,0,0.00000000000000000000
chr22,24876424,24877005,581,-1,0,,0,0.00000000000000000000
chr22,23965962,23966314,352,-1,0,51233,1,284.09090909090900000000
chr22,24054888,24054968,80,-1,0,,0,0.00000000000000000000
chr22,23964854,23964912,58,-1,0,51233,1,1724.13793103448000000000
chr22,25168504,25192517,24013,-1,0,440822,1,4.16441094407196000000
chr22,25195208,25197448,2240,-1,0,,0,0.00000000000000000000
chr22,25277109,25277486,377,-1,0,129049,1,265.25198938992000000000
chr22,25396001,25396415,414,-1,0,,0,0.00000000000000000000
chr22,25450015,25452626,2611,-1,0,85379,1,38.29950210647260000000
chr22,25450885,25451644,759,-1,0,85379,1,131.75230566534900000000
chr22,25575755,25576204,449,-1,0,85379,1,222.71714922049000000000
chr22,25575991,25576051,60,-1,0,85379,1,1666.66666666667000000000
chr22,25614198,25614754,556,-1,0,,0,0.00000000000000000000
chr22,25688053,25983437,295384,-1,0,91355;157,2,0.67708474392655000000
chr22,25820043,25968253,148210,-1,0,157,1,0.67471830510761800000
chr22,25701463,25783994,82531,-1,0,91355,1,1.21166591947268000000
chr22,25845478,25921198,75720,-1,0,,0,0.00000000000000000000
chr22,25659949,25711425,51476,-1,0,,0,0.00000000000000000000
chr22,25634172,25648090,13918,-1,0,,0,0.00000000000000000000
chr22,25681476,25692626,11150,-1,0,,0,0.00000000000000000000
chr22,25744801,25745213,412,-1,0,,0,0.00000000000000000000
chr22,25628358,25628725,367,-1,0,,0,0.00000000000000000000
chr22,25698531,25698686,155,-1,0,,0,0.00000000000000000000
chr22,26495029,26505239,10210,-1,0,,0,0.00000000000000000000
chr22,26891513,26891668,155,-1,0,24144,1,645.16129032258100000000
chr22,27109453,27111235,1782,-1,0,,0,0.00000000000000000000
chr22,27167873,27169962,2089,-1,0,,0,0.00000000000000000000
chr22,27409437,27415217,5780,-1,0,,0,0.00000000000000000000
chr22,27423561,27423843,282,-1,0,,0,0.00000000000000000000
chr22,27423627,27423777,150,-1,0,,0,0.00000000000000000000
chr22,27423688,27423747,59,-1,0,,0,0.00000000000000000000
chr22,27564181,27564367,186,-1,0,,0,0.00000000000000000000
chr22,27617076,27617243,167,-1,0,,0,0.00000000000000000000
chr22,27654824,27658053,3229,-1,0,,0,0.00000000000000000000
chr22,27720734,27721287,553,-1,0,,0,0.00000000000000000000
chr22,27797082,27797540,458,-1,0,,0,0.00000000000000000000
chr22,27939814,27940007,193,-1,0,,0,0.00000000000000000000
chr22,28130756,28132228,1472,-1,0,,0,0.00000000000000000000
chr22,28480610,28484595,3985,-1,0,23331,1,25.09410288582180000000
chr22,28591784,28610136,18352,-1,0,23331,1,5.44899738448126000000
chr22,29029961,29107949,77988,-1,0,23331;11200,2,2.56449710211827000000
chr22,29060502,29066188,5686,-1,0,23331,1,17.58705592683780000000
chr22,29177285,29177746,461,-1,0,150275,1,216.91973969631200000000
chr22,29383771,29387262,3491,-1,0,84133,1,28.64508736751650000000
chr22,29633088,29635392,2304,-1,0,129080,1,43.40277777777780000000
chr22,29679452,29681891,2439,-1,0,2130,1,41.00041000410000000000
chr22,29695810,29696222,412,-1,0,2130,1,242.71844660194200000000
chr22,29783648,29790472,6824,-1,0,162,1,14.65416178194610000000
chr22,29785703,29789701,3998,-1,0,,0,0.00000000000000000000
chr22,29972098,29975432,3334,-1,0,8508,1,29.99400119976000000000
chr22,30170945,30171241,296,-1,0,,0,0.00000000000000000000
chr22,30214219,30214618,399,-1,0,84164,1,250.62656641604000000000
chr22,30243349,30243486,137,-1,0,,0,0.00000000000000000000
chr22,30289160,30353024,63864,-1,0,8897,1,1.56582738318928000000
chr22,30330378,30371988,41610,-1,0,8897,1,2.40326844508532000000
chr22,30335561,30337615,2054,-1,0,8897,1,48.68549172346640000000
chr22,30336307,30337194,887,-1,0,8897,1,112.73957158962800000000
chr22,30443488,30447859,4371,-1,0,,0,0.00000000000000000000
chr22,30737510,30737615,105,-1,0,10291,1,952.38095238095300000000
chr22,31045431,31046212,781,-1,0,339665,1,128.04097311139600000000
chr22,31419916,31420849,933,-1,0,,0,0.00000000000000000000
chr22,31447614,31448578,964,-1,0,,0,0.00000000000000000000
chr22,31461497,31474534,13037,-1,0,,0,0.00000000000000000000
chr22,31775876,31781445,5569,-1,0,,0,0.00000000000000000000
chr22,31895427,31911048,15621,-1,0,9814,1,6.40163881953780000000
chr22,32002062,32027978,25916,-1,0,9814;23761,2,7.71724031486341000000
chr22,32037546,32038845,1299,-1,0,23761,1,76.98229407236330000000
chr22,32208517,32208844,327,-1,0,9681,1,305.81039755351700000000
chr22,32403851,32405131,1280,-1,0,,0,0.00000000000000000000
chr22,32630846,32631749,903,-1,0,6527,1,110.74197120708700000000
chr22,32680692,32699623,18931,-1,0,,0,0.00000000000000000000
chr22,32701287,32701731,444,-1,0,,0,0.00000000000000000000
chr22,32725708,32729072,3364,-1,0,,0,0.00000000000000000000
chr22,32725795,32726992,1197,-1,0,,0,0.00000000000000000000
chr22,32798544,32798691,147,-1,0,51493,1,680.27210884353700000000
chr22,33295646,33296187,541,-1,0,8224,1,184.84288354898300000000
chr22,33295765,33296083,318,-1,0,8224,1,314.46540880503100000000
chr22,33458833,33473174,14341,-1,0,,0,0.00000000000000000000
chr22,33662104,33665375,3271,-1,0,,0,0.00000000000000000000
chr22,33735897,33737063,1166,-1,0,9215,1,85.76329331046310000000
chr22,33740523,33741019,496,-1,0,9215,1,201.61290322580600000000
chr22,33753888,33760360,6472,-1,0,9215,1,15.45117428924600000000
chr22,33755969,33759985,4016,-1,0,9215,1,24.90039840637450000000
chr22,33751616,33751778,162,-1,0,9215,1,617.28395061728400000000
chr22,33843081,34249990,406909,-1,0,9215,1,0.24575519342162500000
chr22,33963731,33981215,17484,-1,0,9215,1,5.71951498512926000000
chr22,33780434,33783334,2900,-1,0,9215,1,34.48275862068970000000
chr22,33767846,33769892,2046,-1,0,9215,1,48.87585532746820000000
chr22,33787017,33788098,1081,-1,0,9215,1,92.50693802035150000000
chr22,34069578,34070178,600,-1,0,9215,1,166.66666666666700000000
chr22,34076362,34076499,137,-1,0,9215,1,729.92700729927000000000
chr22,34069846,34069967,121,-1,0,9215,1,826.44628099173600000000
chr22,34403634,34407104,3470,-1,0,,0,0.00000000000000000000
chr22,34555808,34582275,26467,-1,0,,0,0.00000000000000000000
chr22,34717177,34725408,8231,-1,0,,0,0.00000000000000000000
chr22,34863809,34866687,2878,-1,0,,0,0.00000000000000000000
chr22,34865156,34865414,258,-1,0,,0,0.00000000000000000000
chr22,34900205,34901241,1036,-1,0,,0,0.00000000000000000000
chr22,34968066,34968732,666,-1,0,,0,0.00000000000000000000
chr22,35007823,35010848,3025,-1,0,,0,0.00000000000000000000
chr22,35106480,35117259,10779,-1,0,,0,0.00000000000000000000
chr22,35459000,35459421,421,-1,0,,0,0.00000000000000000000
chr22,35645163,35646142,979,-1,0,,0,0.00000000000000000000
chr22,35645319,35646016,697,-1,0,,0,0.00000000000000000000
chr22,35645497,35646117,620,-1,0,,0,0.00000000000000000000
chr22,36024144,36026955,2811,-1,0,,0,0.00000000000000000000
chr22,36089524,36096046,6522,-1,0,,0,0.00000000000000000000
chr22,36091421,36097433,6012,-1,0,,0,0.00000000000000000000
chr22,36133479,36134255,776,-1,0,,0,0.00000000000000000000
chr22,36283166,36287628,4462,-1,0,23543,1,22.41147467503360000000
chr22,36476878,36481275,4397,-1,0,,0,0.00000000000000000000
chr22,36535383,36571819,36436,-1,0,80833,1,2.74453836864639000000
chr22,36571870,36575263,3393,-1,0,,0,0.00000000000000000000
chr22,36564708,36564766,58,-1,0,,0,0.00000000000000000000
chr22,36612996,36615998,3002,-1,0,,0,0.00000000000000000000
chr22,36613042,36614283,1241,-1,0,,0,0.00000000000000000000
chr22,36773627,36776501,2874,-1,0,4627,1,34.79471120389700000000
chr22,36798020,36798408,388,-1,0,,0,0.00000000000000000000
chr22,36851668,36852943,1275,-1,0,,0,0.00000000000000000000
chr22,36867658,36869055,1397,-1,0,25828,1,71.58196134574090000000
chr22,36943185,36949766,6581,-1,0,,0,0.00000000000000000000
chr22,36947131,36948280,1149,-1,0,,0,0.00000000000000000000
chr22,37127087,37127347,260,-1,0,,0,0.00000000000000000000
chr22,37143061,37147890,4829,-1,0,,0,0.00000000000000000000
chr22,37143998,37146922,2924,-1,0,,0,0.00000000000000000000
chr22,37143105,37144405,1300,-1,0,,0,0.00000000000000000000
chr22,37146964,37147938,974,-1,0,,0,0.00000000000000000000
chr22,37196063,37196393,330,-1,0,,0,0.00000000000000000000
chr22,37196056,37196216,160,-1,0,,0,0.00000000000000000000
chr22,37268662,37268713,51,-1,0,4689,1,1960.78431372549000000000
chr22,37742311,37750481,8170,-1,0,,0,0.00000000000000000000
chr22,37744341,37750134,5793,-1,0,,0,0.00000000000000000000
chr22,37415303,37420803,5500,-1,0,7263;4357,2,36.36363636363640000000
chr22,37643172,37648102,4930,-1,0,,0,0.00000000000000000000
chr22,38132661,38137315,4654,-1,0,11078,1,21.48689299527290000000
chr22,37618621,37621144,2523,-1,0,,0,0.00000000000000000000
chr22,37748460,37749943,1483,-1,0,,0,0.00000000000000000000
chr22,38126932,38128502,1570,-1,0,11078,1,63.69426751592360000000
chr22,37983065,37984326,1261,-1,0,,0,0.00000000000000000000
chr22,38089992,38091137,1145,-1,0,,0,0.00000000000000000000
chr22,37905649,37906348,699,-1,0,29775,1,143.06151645207400000000
chr22,37493710,37494323,613,-1,0,164656,1,163.13213703099500000000
chr22,37438372,37438888,516,-1,0,,0,0.00000000000000000000
chr22,38342220,38344599,2379,-1,0,84645,1,42.03446826397650000000
chr22,38625618,38626141,523,-1,0,25829,1,191.20458891013400000000
chr22,38736578,38737924,1346,-1,0,102800317,1,74.29420505200590000000
chr22,38738128,38739286,1158,-1,0,102800317,1,86.35578583765110000000
chr22,38816432,38817135,703,-1,0,,0,0.00000000000000000000
chr22,39044359,39044727,368,-1,0,646851,1,271.73913043478300000000
chr22,39292623,39303266,10643,-1,0,,0,0.00000000000000000000
chr22,39294015,39298575,4560,-1,0,,0,0.00000000000000000000
chr22,39295250,39296893,1643,-1,0,,0,0.00000000000000000000
chr22,39319748,39319798,50,-1,0,,0,0.00000000000000000000
chr22,39362993,39405641,42648,-1,0,9582,1,2.34477583942975000000
chr22,39354726,39389270,34544,-1,0,9582;200315,2,5.78971746178786000000
chr22,39358970,39379189,20219,-1,0,9582;200315,2,9.89168603788516000000
chr22,39428830,39452528,23698,-1,0,200316;140564,2,8.43953076208963000000
chr22,39363442,39375291,11849,-1,0,,0,0.00000000000000000000
chr22,39473001,39488200,15199,-1,0,60489,1,6.57938022238305000000
chr22,39374023,39375679,1656,-1,0,,0,0.00000000000000000000
chr22,39360507,39362118,1611,-1,0,,0,0.00000000000000000000
chr22,39469401,39469715,314,-1,0,,0,0.00000000000000000000
chr22,39607662,39607992,330,-1,0,,0,0.00000000000000000000
chr22,39722261,39723446,1185,-1,0,,0,0.00000000000000000000
chr22,39864626,39865201,575,-1,0,4248,1,173.91304347826100000000
chr22,40393539,40397279,3740,-1,0,113828,1,26.73796791443850000000
chr22,40460735,40465634,4899,-1,0,23112,1,20.41232904674420000000
chr22,40589536,40599770,10234,-1,0,23112,1,9.77135040062537000000
chr22,40592243,40599726,7483,-1,0,23112,1,13.36362421488710000000
chr22,40794213,40795236,1023,-1,0,27352,1,97.75171065493650000000
chr22,40793949,40794912,963,-1,0,27352,1,103.84215991692600000000
chr22,40873195,40880937,7742,-1,0,57591,1,12.91655902867480000000
chr22,40935427,40935704,277,-1,0,57591,1,361.01083032491000000000
chr22,41072801,41081100,8299,-1,0,2847,1,12.04964453548620000000
chr22,41090968,41095464,4496,-1,0,,0,0.00000000000000000000
chr22,41145003,41165070,20067,-1,0,,0,0.00000000000000000000
chr22,41140111,41142636,2525,-1,0,,0,0.00000000000000000000
chr22,41152894,41156305,3411,-1,0,,0,0.00000000000000000000
chr22,41420184,41423332,3148,-1,0,,0,0.00000000000000000000
chr22,41455309,41456010,701,-1,0,,0,0.00000000000000000000
chr22,41637800,41639760,1960,-1,0,,0,0.00000000000000000000
chr22,42139943,42141100,1157,-1,0,150365,1,86.43042350907520000000
chr22,42140323,42140799,476,-1,0,150365,1,210.08403361344500000000
chr22,42140507,42140835,328,-1,0,150365,1,304.87804878048800000000
chr22,42298301,42331600,33299,-1,0,6721;440829;115650,3,9.00927955794468000000
chr22,42508664,42508880,216,-1,0,,0,0.00000000000000000000
chr22,42513849,42516672,2823,-1,0,,0,0.00000000000000000000
chr22,42515125,42515416,291,-1,0,,0,0.00000000000000000000
chr22,42517462,42549755,32293,-1,0,1565,1,3.09664633202242000000
chr22,42518236,42531358,13122,-1,0,1565,1,7.62078951379363000000
chr22,42717432,42720134,2702,-1,0,,0,0.00000000000000000000
chr22,42745326,42746270,944,-1,0,,0,0.00000000000000000000
chr22,42902272,42963392,61120,-1,0,27341;253190,2,3.27225130890052000000
chr22,42889257,42936358,47101,-1,0,27341,1,2.12309717415766000000
chr22,42911245,42951476,40231,-1,0,27341;253190,2,4.97129079565509000000
chr22,42955111,42975032,19921,-1,0,253190,1,5.01982832187139000000
chr22,42905523,42934313,28790,-1,0,27341,1,3.47342827370615000000
chr22,42940350,42963432,23082,-1,0,253190,1,4.33238020968720000000
chr22,42934748,42936023,1275,-1,0,,0,0.00000000000000000000
chr22,43098649,43099018,369,-1,0,53947,1,271.00271002710000000000
chr22,43101429,43102189,760,-1,0,53947,1,131.57894736842100000000
chr22,43102582,43104438,1856,-1,0,53947,1,53.87931034482760000000
chr22,43292206,43292644,438,-1,0,11252,1,228.31050228310500000000
chr22,43420750,43422325,1575,-1,0,,0,0.00000000000000000000
chr22,43472216,43474877,2661,-1,0,25809,1,37.57985719654270000000
chr22,43475913,43476573,660,-1,0,25809,1,151.51515151515200000000
chr22,43549196,43549787,591,-1,0,706,1,169.20473773265600000000
chr22,43549271,43549604,333,-1,0,706,1,300.30030030030000000000
chr22,43594738,43595763,1025,-1,0,,0,0.00000000000000000000
chr22,43601502,43601974,472,-1,0,80274,1,211.86440677966100000000
chr22,43675962,43681519,5557,-1,0,80274,1,17.99532121648370000000
chr22,43676630,43678412,1782,-1,0,80274,1,56.11672278338950000000
chr22,43676579,43677609,1030,-1,0,80274,1,97.08737864077670000000
chr22,43865827,43866440,613,-1,0,758,1,163.13213703099500000000
chr22,43895154,43896342,1188,-1,0,758,1,84.17508417508420000000
chr22,43895105,43895285,180,-1,0,758,1,555.55555555555600000000
chr22,43910983,43911102,119,-1,0,,0,0.00000000000000000000
chr22,44031299,44039885,8586,-1,0,64800,1,11.64686699277890000000
chr22,44074584,44080698,6114,-1,0,64800,1,16.35590448151780000000
chr22,44029860,44032520,2660,-1,0,64800,1,37.59398496240600000000
chr22,44026732,44027850,1118,-1,0,64800,1,89.44543828264760000000
chr22,43985160,43985210,50,-1,0,64800,1,2000.00000000000000000000
chr22,44133356,44133670,314,-1,0,64800,1,318.47133757961800000000
chr22,44192124,44193690,1566,-1,0,64800,1,63.85696040868460000000
chr22,44230039,44231449,1410,-1,0,25830,1,70.92198581560280000000
chr22,44345840,44347089,1249,-1,0,,0,0.00000000000000000000
chr22,44380682,44382169,1487,-1,0,25813,1,67.24949562878280000000
chr22,44411394,44415068,3674,-1,0,29780,1,27.21829069134460000000
chr22,44490400,44491022,622,-1,0,29780,1,160.77170418006400000000
chr22,44508424,44512124,3700,-1,0,29780,1,27.02702702702700000000
chr22,44508529,44510090,1561,-1,0,29780,1,64.06149903907750000000
chr22,44523615,44523678,63,-1,0,29780,1,1587.30158730159000000000
chr22,44564892,44566045,1153,-1,0,29780,1,86.73026886383350000000
chr22,44658198,44662027,3829,-1,0,85352,1,26.11647949856360000000
chr22,44698536,44698827,291,-1,0,85352,1,343.64261168384900000000
chr22,44702185,44702565,380,-1,0,85352,1,263.15789473684200000000
chr22,44702091,44702454,363,-1,0,85352,1,275.48209366391200000000
chr22,44824263,44828534,4271,-1,0,,0,0.00000000000000000000
chr22,44930935,44931899,964,-1,0,,0,0.00000000000000000000
chr22,45015430,45015947,517,-1,0,,0,0.00000000000000000000
chr22,45015212,45015568,356,-1,0,,0,0.00000000000000000000
chr22,45048843,45049297,454,-1,0,,0,0.00000000000000000000
chr22,45135272,45138765,3493,-1,0,553158,1,28.62868594331520000000
chr22,45135157,45136949,1792,-1,0,553158,1,55.80357142857140000000
chr22,45135889,45137449,1560,-1,0,553158,1,64.10256410256410000000
chr22,45135804,45136302,498,-1,0,553158,1,200.80321285140600000000
chr22,45209107,45209522,415,-1,0,553158;23779,2,481.92771084337400000000
chr22,45211228,45211799,571,-1,0,553158;23779,2,350.26269702276700000000
chr22,45252409,45253094,685,-1,0,553158;23779,2,291.97080291970800000000
chr22,45258885,45260834,1949,-1,0,,0,0.00000000000000000000
chr22,45279986,45280512,526,-1,0,112885,1,190.11406844106500000000
chr22,45280197,45280398,201,-1,0,112885,1,497.51243781094500000000
chr22,45300328,45300850,522,-1,0,112885,1,191.57088122605400000000
chr22,45374080,45397507,23427,-1,0,112885,1,4.26857899005421000000
chr22,45554723,45557131,2408,-1,0,,0,0.00000000000000000000
chr22,45554974,45556775,1801,-1,0,,0,0.00000000000000000000
chr22,45443353,45445201,1848,-1,0,,0,0.00000000000000000000
chr22,45488253,45488668,415,-1,0,,0,0.00000000000000000000
chr22,45488433,45488496,63,-1,0,,0,0.00000000000000000000
chr22,45653626,45656645,3019,-1,0,,0,0.00000000000000000000
chr22,45698245,45700121,1876,-1,0,,0,0.00000000000000000000
chr22,45654185,45655635,1450,-1,0,,0,0.00000000000000000000
chr22,45723695,45724446,751,-1,0,55007,1,133.15579227696400000000
chr22,45624519,45624939,420,-1,0,23313,1,238.09523809523800000000
chr22,45624774,45625108,334,-1,0,23313,1,299.40119760479000000000
chr22,45723857,45724229,372,-1,0,55007,1,268.81720430107500000000
chr22,45874946,45875397,451,-1,0,,0,0.00000000000000000000
chr22,45964382,45964704,322,-1,0,2192,1,310.55900621118000000000
chr22,45964524,45964789,265,-1,0,2192,1,377.35849056603800000000
chr22,45982953,45983531,578,-1,0,2192,1,173.01038062283700000000
chr22,46258489,46387535,129046,-1,0,7477,1,0.77491747128930800000
chr22,46303065,46311475,8410,-1,0,,0,0.00000000000000000000
chr22,46348810,46349347,537,-1,0,7477,1,186.21973929236500000000
chr22,46363119,46363567,448,-1,0,7477,1,223.21428571428600000000
chr22,46286325,46286671,346,-1,0,,0,0.00000000000000000000
chr22,46349046,46349222,176,-1,0,7477,1,568.18181818181800000000
chr22,46349016,46349135,119,-1,0,7477,1,840.33613445378100000000
chr22,46363318,46363391,73,-1,0,7477,1,1369.86301369863000000000
chr22,46491182,46491833,651,-1,0,,0,0.00000000000000000000
chr22,46537424,46538015,591,-1,0,,0,0.00000000000000000000
chr22,46563971,46566908,2937,-1,0,5465,1,34.04834865509020000000
chr22,46690148,46690480,332,-1,0,,0,0.00000000000000000000
chr22,46991732,46995857,4125,-1,0,,0,0.00000000000000000000
chr22,47011543,47013285,1742,-1,0,,0,0.00000000000000000000
chr22,46924495,46925512,1017,-1,0,9620,1,98.32841691248770000000
chr22,46962859,46964189,1330,-1,0,,0,0.00000000000000000000
chr22,47027216,47028007,791,-1,0,23151,1,126.42225031605600000000
chr22,46962628,46962957,329,-1,0,,0,0.00000000000000000000
chr22,47026746,47026853,107,-1,0,23151,1,934.57943925233600000000
chr22,47082980,47083408,428,-1,0,64781,1,233.64485981308400000000
chr22,47254886,47256608,1722,-1,0,25771,1,58.07200929152150000000
chr22,47310438,47355394,44956,-1,0,25771,1,2.22439718836195000000
chr22,47459612,47460139,527,-1,0,25771,1,189.75332068311200000000
chr22,47465509,47466093,584,-1,0,25771,1,171.23287671232900000000
chr22,47465623,47466271,648,-1,0,25771,1,154.32098765432100000000
chr22,47465454,47465757,303,-1,0,25771,1,330.03300330033000000000
chr22,47459708,47460031,323,-1,0,25771,1,309.59752321981400000000
chr22,47558054,47558601,547,-1,0,25771,1,182.81535648994500000000
chr22,47567491,47567908,417,-1,0,25771,1,239.80815347721800000000
chr22,47570195,47570571,376,-1,0,25771,1,265.95744680851100000000
chr22,47570983,47571435,452,-1,0,25771,1,221.23893805309700000000
chr22,47558266,47558375,109,-1,0,25771,1,917.43119266055100000000
chr22,47586019,47588538,2519,-1,0,,0,0.00000000000000000000
chr22,47606497,47609342,2845,-1,0,,0,0.00000000000000000000
chr22,47607295,47609606,2311,-1,0,,0,0.00000000000000000000
chr22,47656391,47656811,420,-1,0,,0,0.00000000000000000000
chr22,47656573,47656644,71,-1,0,,0,0.00000000000000000000
chr22,47685609,47686681,1072,-1,0,,0,0.00000000000000000000
chr22,47689104,47689575,471,-1,0,,0,0.00000000000000000000
chr22,47696466,47696862,396,-1,0,,0,0.00000000000000000000
chr22,47722840,47879110,156270,-1,0,,0,0.00000000000000000000
chr22,47875318,47876482,1164,-1,0,,0,0.00000000000000000000
chr22,47781745,47782423,678,-1,0,,0,0.00000000000000000000
chr22,47781988,47782204,216,-1,0,,0,0.00000000000000000000
chr22,47801328,47801594,266,-1,0,,0,0.00000000000000000000
chr22,47795748,47796017,269,-1,0,,0,0.00000000000000000000
chr22,48627336,48629960,2624,-1,0,,0,0.00000000000000000000
chr22,48645126,48645631,505,-1,0,,0,0.00000000000000000000
chr22,48645210,48645528,318,-1,0,,0,0.00000000000000000000
chr22,48647451,48649647,2196,-1,0,,0,0.00000000000000000000
chr22,48709965,48711441,1476,-1,0,,0,0.00000000000000000000
chr22,48716038,48716217,179,-1,0,,0,0.00000000000000000000
chr22,48740251,48740656,405,-1,0,,0,0.00000000000000000000
chr22,48874950,48875552,602,-1,0,,0,0.00000000000000000000
chr22,48874911,48875220,309,-1,0,,0,0.00000000000000000000
chr22,48875159,48875350,191,-1,0,,0,0.00000000000000000000
chr22,48893354,48894115,761,-1,0,25817,1,131.40604467805500000000
chr22,48891857,48892386,529,-1,0,25817,1,189.03591682419700000000
chr22,48902999,48903059,60,-1,0,25817,1,1666.66666666667000000000
chr22,49062450,49064460,2010,-1,0,25817,1,49.75124378109450000000
chr22,49114292,49115685,1393,-1,0,25817,1,71.78750897343860000000
chr22,49033981,49034985,1004,-1,0,25817,1,99.60159362549800000000
chr22,49063516,49064483,967,-1,0,25817,1,103.41261633919300000000
chr22,49003059,49003429,370,-1,0,25817,1,270.27027027027000000000
chr22,49077585,49078005,420,-1,0,25817,1,238.09523809523800000000
chr22,49131901,49132268,367,-1,0,25817,1,272.47956403269800000000
chr22,49077610,49077892,282,-1,0,25817,1,354.60992907801400000000
chr22,49246963,49247567,604,-1,0,,0,0.00000000000000000000
chr22,49247185,49247399,214,-1,0,,0,0.00000000000000000000
chr22,49247227,49247431,204,-1,0,,0,0.00000000000000000000
chr22,49300812,49300942,130,-1,0,,0,0.00000000000000000000
chr22,49306293,49306631,338,-1,0,,0,0.00000000000000000000
chr22,49352910,49360223,7313,-1,0,,0,0.00000000000000000000
chr22,49355465,49356552,1087,-1,0,,0,0.00000000000000000000
chr22,49355605,49356072,467,-1,0,,0,0.00000000000000000000
chr22,49356095,49356537,442,-1,0,,0,0.00000000000000000000
chr22,49355842,49355973,131,-1,0,,0,0.00000000000000000000
chr22,49381414,49394355,12941,-1,0,,0,0.00000000000000000000
chr22,49388038,49394196,6158,-1,0,,0,0.00000000000000000000
chr22,49401387,49401484,97,-1,0,,0,0.00000000000000000000
chr22,49483129,49484010,881,-1,0,,0,0.00000000000000000000
chr22,49562003,49562125,122,-1,0,,0,0.00000000000000000000
chr22,49561995,49562080,85,-1,0,,0,0.00000000000000000000
chr22,49636540,49638135,1595,-1,0,,0,0.00000000000000000000
chr22,49661304,49662360,1056,-1,0,,0,0.00000000000000000000
chr22,49845981,49909273,63292,-1,0,,0,0.00000000000000000000
chr22,49818235,49867445,49210,-1,0,,0,0.00000000000000000000
chr22,49828415,49856091,27676,-1,0,,0,0.00000000000000000000
chr22,49875213,49897279,22066,-1,0,,0,0.00000000000000000000
chr22,49764535,49769022,4487,-1,0,,0,0.00000000000000000000
chr22,49711901,49717416,5515,-1,0,,0,0.00000000000000000000
chr22,49748643,49751792,3149,-1,0,,0,0.00000000000000000000
chr22,49709604,49713164,3560,-1,0,,0,0.00000000000000000000
chr22,49714914,49717267,2353,-1,0,,0,0.00000000000000000000
chr22,49779914,49782148,2234,-1,0,,0,0.00000000000000000000
chr22,49715810,49717610,1800,-1,0,,0,0.00000000000000000000
chr22,49800738,49801818,1080,-1,0,,0,0.00000000000000000000
chr22,49692916,49694099,1183,-1,0,,0,0.00000000000000000000
chr22,49716495,49717642,1147,-1,0,,0,0.00000000000000000000
chr22,49863070,49863741,671,-1,0,,0,0.00000000000000000000
chr22,49878258,49878909,651,-1,0,,0,0.00000000000000000000
chr22,49800952,49801637,685,-1,0,,0,0.00000000000000000000
chr22,49826797,49827357,560,-1,0,,0,0.00000000000000000000
chr22,49716779,49717340,561,-1,0,,0,0.00000000000000000000
chr22,49827006,49827245,239,-1,0,,0,0.00000000000000000000
chr22,49863268,49863484,216,-1,0,,0,0.00000000000000000000
chr22,49878469,49878664,195,-1,0,,0,0.00000000000000000000
chr22,49878409,49878547,138,-1,0,,0,0.00000000000000000000
chr22,49716969,49717099,130,-1,0,,0,0.00000000000000000000
chr22,49698614,49698680,66,-1,0,,0,0.00000000000000000000
chr22,50061300,50061720,420,-1,0,,0,0.00000000000000000000
chr22,50250341,50250459,118,-1,0,9889,1,847.45762711864400000000
chr22,50295071,50296452,1381,-1,0,,0,0.00000000000000000000
chr22,50302004,50302433,429,-1,0,79087,1,233.10023310023300000000
chr22,50341139,50424404,83265,-1,0,415116,1,1.20098480754218000000
chr22,50433927,50457622,23695,-1,0,400935,1,4.22029964127453000000
chr22,50443014,50446436,3422,-1,0,400935,1,29.22267679719460000000
chr22,50467091,50467871,780,-1,0,,0,0.00000000000000000000
chr22,50464723,50464945,222,-1,0,,0,0.00000000000000000000
chr22,50464741,50464888,147,-1,0,,0,0.00000000000000000000
chr22,50499136,50499303,167,-1,0,23209,1,598.80239520958100000000
chr22,50674712,50677087,2375,-1,0,85378,1,42.10526315789470000000
chr22,50606519,50607082,563,-1,0,,0,0.00000000000000000000
chr22,50663831,50664244,413,-1,0,85378,1,242.13075060532700000000
chr22,50585625,50585961,336,-1,0,54456,1,297.61904761904800000000
chr22,50782100,50786322,4222,-1,0,9701,1,23.68545712932260000000
chr22,50808781,50810138,1357,-1,0,9701,1,73.69196757553430000000
chr22,50836035,50836374,339,-1,0,9701,1,294.98525073746300000000
chr22,50871228,50873454,2226,-1,0,9701,1,44.92362982929020000000
chr22,50949776,50950138,362,-1,0,29781,1,276.24309392265200000000
chr22,50975827,50976604,777,-1,0,,0,0.00000000000000000000
chr22,51066651,51078918,12267,-1,0,,0,0.00000000000000000000
chr22,51054929,51057499,2570,-1,0,,0,0.00000000000000000000
chr22,51082134,51082724,590,-1,0,,0,0.00000000000000000000
chr22,51106546,51122440,15894,-1,0,85358,1,6.29168239587266000000
chr22,51119871,51121254,1383,-1,0,85358,1,72.30657989877080000000
chr22,51179178,51196712,17534,-1,0,49,1,5.70320520132314000000
chr3,88003,1460892,1372889,-1,0,27255;10752,2,0.14567820122384300000
chr3,392784,940338,547554,-1,0,10752,1,0.18263038896620200000
chr3,2256607,2613577,356970,-1,0,152330,1,0.28013558562344200000
chr3,328108,615958,287850,-1,0,10752,1,0.34740316136876800000
chr3,1031293,1277441,246148,-1,0,27255,1,0.40625964866665600000
chr3,1316860,1563944,247084,-1,0,27255,1,0.40472066179922600000
chr3,1797976,1951962,153986,-1,0,,0,0.00000000000000000000
chr3,1280326,1448306,167980,-1,0,27255,1,0.59530896535301800000
chr3,862052,992562,130510,-1,0,,0,0.00000000000000000000
chr3,1731500,1854781,123281,-1,0,,0,0.00000000000000000000
chr3,1139280,1247479,108199,-1,0,27255,1,0.92422295954676100000
chr3,1173677,1289332,115655,-1,0,27255,1,0.86464052570144000000
chr3,103314,198965,95651,-1,0,,0,0.00000000000000000000
chr3,1493249,1598223,104974,-1,0,,0,0.00000000000000000000
chr3,1805143,1892032,86889,-1,0,,0,0.00000000000000000000
chr3,1902593,1961855,59262,-1,0,,0,0.00000000000000000000
chr3,2214026,2270423,56397,-1,0,152330,1,1.77314396155824000000
chr3,2164378,2224070,59692,-1,0,152330,1,1.67526636735241000000
chr3,2349002,2405437,56435,-1,0,152330,1,1.77195003100913000000
chr3,711677,767659,55982,-1,0,,0,0.00000000000000000000
chr3,612031,663373,51342,-1,0,,0,0.00000000000000000000
chr3,2049295,2090410,41115,-1,0,,0,0.00000000000000000000
chr3,76588,114983,38395,-1,0,,0,0.00000000000000000000
chr3,1854292,1882820,28528,-1,0,,0,0.00000000000000000000
chr3,162196,187549,25353,-1,0,,0,0.00000000000000000000
chr3,1927314,1950965,23651,-1,0,,0,0.00000000000000000000
chr3,1912979,1926212,13233,-1,0,,0,0.00000000000000000000
chr3,226992,234925,7933,-1,0,,0,0.00000000000000000000
chr3,1696211,1708090,11879,-1,0,,0,0.00000000000000000000
chr3,1682686,1694378,11692,-1,0,,0,0.00000000000000000000
chr3,1936539,1946102,9563,-1,0,,0,0.00000000000000000000
chr3,989919,996751,6832,-1,0,,0,0.00000000000000000000
chr3,1771010,1780743,9733,-1,0,,0,0.00000000000000000000
chr3,1032714,1039529,6815,-1,0,,0,0.00000000000000000000
chr3,171890,180304,8414,-1,0,,0,0.00000000000000000000
chr3,1782240,1788516,6276,-1,0,,0,0.00000000000000000000
chr3,853748,860967,7219,-1,0,,0,0.00000000000000000000
chr3,2305511,2312434,6923,-1,0,152330,1,14.44460494005490000000
chr3,228685,234398,5713,-1,0,,0,0.00000000000000000000
chr3,1917829,1923205,5376,-1,0,,0,0.00000000000000000000
chr3,1703679,1707929,4250,-1,0,,0,0.00000000000000000000
chr3,1035093,1039180,4087,-1,0,,0,0.00000000000000000000
chr3,899045,903253,4208,-1,0,,0,0.00000000000000000000
chr3,174536,177998,3462,-1,0,,0,0.00000000000000000000
chr3,60025,63479,3454,-1,0,,0,0.00000000000000000000
chr3,229889,232735,2846,-1,0,,0,0.00000000000000000000
chr3,116967,119390,2423,-1,0,,0,0.00000000000000000000
chr3,1365505,1367269,1764,-1,0,27255,1,56.68934240362810000000
chr3,2877414,2879773,2359,-1,0,152330,1,42.39084357778720000000
chr3,1044155,1046237,2082,-1,0,,0,0.00000000000000000000
chr3,524445,526042,1597,-1,0,,0,0.00000000000000000000
chr3,2495531,2496661,1130,-1,0,152330,1,88.49557522123890000000
chr3,1679937,1680931,994,-1,0,,0,0.00000000000000000000
chr3,176154,177276,1122,-1,0,,0,0.00000000000000000000
chr3,2615817,2617109,1292,-1,0,152330,1,77.39938080495360000000
chr3,1164116,1165211,1095,-1,0,27255,1,91.32420091324200000000
chr3,2426858,2427986,1128,-1,0,152330,1,88.65248226950360000000
chr3,1365564,1366695,1131,-1,0,27255,1,88.41732979664010000000
chr3,2028333,2029195,862,-1,0,,0,0.00000000000000000000
chr3,965732,966584,852,-1,0,,0,0.00000000000000000000
chr3,330019,330858,839,-1,0,10752,1,119.18951132300400000000
chr3,303587,304225,638,-1,0,10752,1,156.73981191222600000000
chr3,1987332,1988125,793,-1,0,,0,0.00000000000000000000
chr3,2311530,2312017,487,-1,0,152330,1,205.33880903490800000000
chr3,2495708,2496402,694,-1,0,152330,1,144.09221902017300000000
chr3,2632949,2633443,494,-1,0,152330,1,202.42914979757100000000
chr3,982503,983021,518,-1,0,,0,0.00000000000000000000
chr3,1781917,1782387,470,-1,0,,0,0.00000000000000000000
chr3,1144202,1144584,382,-1,0,27255,1,261.78010471204200000000
chr3,2320437,2320886,449,-1,0,152330,1,222.71714922049000000000
chr3,2430917,2431220,303,-1,0,152330,1,330.03300330033000000000
chr3,1805792,1806144,352,-1,0,,0,0.00000000000000000000
chr3,1629418,1629662,244,-1,0,,0,0.00000000000000000000
chr3,571752,572097,345,-1,0,,0,0.00000000000000000000
chr3,2311609,2311959,350,-1,0,152330,1,285.71428571428600000000
chr3,2633041,2633369,328,-1,0,152330,1,304.87804878048800000000
chr3,1781984,1782293,309,-1,0,,0,0.00000000000000000000
chr3,661718,662024,306,-1,0,,0,0.00000000000000000000
chr3,2430934,2431003,69,-1,0,152330,1,1449.27536231884000000000
chr3,1629483,1629542,59,-1,0,,0,0.00000000000000000000
chr3,3014469,3015548,1079,-1,0,152330,1,92.67840593141800000000
chr3,3051541,3055466,3925,-1,0,152330,1,25.47770700636940000000
chr3,3158648,3158721,73,-1,0,,0,0.00000000000000000000
chr3,3173187,3177075,3888,-1,0,51095,1,25.72016460905350000000
chr3,3369273,3369439,166,-1,0,,0,0.00000000000000000000
chr3,3481038,3483349,2311,-1,0,,0,0.00000000000000000000
chr3,3481019,3482248,1229,-1,0,,0,0.00000000000000000000
chr3,3588214,3593868,5654,-1,0,,0,0.00000000000000000000
chr3,3723307,3723381,74,-1,0,,0,0.00000000000000000000
chr3,3791263,3792252,989,-1,0,,0,0.00000000000000000000
chr3,3971335,4224290,252955,-1,0,,0,0.00000000000000000000
chr3,3937205,4113395,176190,-1,0,,0,0.00000000000000000000
chr3,4128443,4261770,133327,-1,0,,0,0.00000000000000000000
chr3,4093435,4231371,137936,-1,0,,0,0.00000000000000000000
chr3,4170544,4314101,143557,-1,0,,0,0.00000000000000000000
chr3,4169700,4277562,107862,-1,0,,0,0.00000000000000000000
chr3,3994109,4075298,81189,-1,0,,0,0.00000000000000000000
chr3,4110093,4161446,51353,-1,0,,0,0.00000000000000000000
chr3,3956239,4024086,67847,-1,0,,0,0.00000000000000000000
chr3,4237827,4288164,50337,-1,0,,0,0.00000000000000000000
chr3,4142033,4208968,66935,-1,0,,0,0.00000000000000000000
chr3,4201227,4235975,34748,-1,0,,0,0.00000000000000000000
chr3,4212413,4256314,43901,-1,0,,0,0.00000000000000000000
chr3,4083570,4127733,44163,-1,0,,0,0.00000000000000000000
chr3,4136903,4177675,40772,-1,0,,0,0.00000000000000000000
chr3,4121765,4160011,38246,-1,0,,0,0.00000000000000000000
chr3,4238749,4261025,22276,-1,0,,0,0.00000000000000000000
chr3,4170014,4197717,27703,-1,0,,0,0.00000000000000000000
chr3,4277155,4302252,25097,-1,0,,0,0.00000000000000000000
chr3,3996931,4012273,15342,-1,0,,0,0.00000000000000000000
chr3,4087677,4101170,13493,-1,0,,0,0.00000000000000000000
chr3,4088880,4100326,11446,-1,0,,0,0.00000000000000000000
chr3,4191959,4201227,9268,-1,0,,0,0.00000000000000000000
chr3,4218389,4224399,6010,-1,0,,0,0.00000000000000000000
chr3,4192633,4196935,4302,-1,0,,0,0.00000000000000000000
chr3,4066780,4069764,2984,-1,0,,0,0.00000000000000000000
chr3,3970746,3973033,2287,-1,0,,0,0.00000000000000000000
chr3,4270521,4272365,1844,-1,0,,0,0.00000000000000000000
chr3,4178096,4179792,1696,-1,0,,0,0.00000000000000000000
chr3,3873181,3873629,448,-1,0,57633,1,223.21428571428600000000
chr3,3842248,3842355,107,-1,0,57633,1,934.57943925233600000000
chr3,4398541,4400309,1768,-1,0,,0,0.00000000000000000000
chr3,4644387,4652026,7639,-1,0,3708,1,13.09071868045560000000
chr3,4848600,4849030,430,-1,0,3708,1,232.55813953488400000000
chr3,5039334,5040887,1553,-1,0,,0,0.00000000000000000000
chr3,5077904,5123974,46070,-1,0,,0,0.00000000000000000000
chr3,5275789,5275967,178,-1,0,,0,0.00000000000000000000
chr3,5281099,5281375,276,-1,0,,0,0.00000000000000000000
chr3,5429933,5478806,48873,-1,0,,0,0.00000000000000000000
chr3,5388544,5440087,51543,-1,0,,0,0.00000000000000000000
chr3,6067799,6100784,32985,-1,0,,0,0.00000000000000000000
chr3,5425163,5457167,32004,-1,0,,0,0.00000000000000000000
chr3,6199747,6232595,32848,-1,0,,0,0.00000000000000000000
chr3,6215077,6241059,25982,-1,0,,0,0.00000000000000000000
chr3,6077602,6101752,24150,-1,0,,0,0.00000000000000000000
chr3,6228486,6239700,11214,-1,0,,0,0.00000000000000000000
chr3,6643467,6653627,10160,-1,0,,0,0.00000000000000000000
chr3,5414233,5421344,7111,-1,0,,0,0.00000000000000000000
chr3,5536016,5542671,6655,-1,0,,0,0.00000000000000000000
chr3,5534671,5539155,4484,-1,0,,0,0.00000000000000000000
chr3,6650193,6654634,4441,-1,0,,0,0.00000000000000000000
chr3,6295114,6298851,3737,-1,0,,0,0.00000000000000000000
chr3,5945605,5949119,3514,-1,0,,0,0.00000000000000000000
chr3,6651668,6653868,2200,-1,0,,0,0.00000000000000000000
chr3,5929548,5930692,1144,-1,0,,0,0.00000000000000000000
chr3,6594384,6595205,821,-1,0,,0,0.00000000000000000000
chr3,5670325,5671038,713,-1,0,,0,0.00000000000000000000
chr3,6430275,6430667,392,-1,0,,0,0.00000000000000000000
chr3,5830477,5830819,342,-1,0,,0,0.00000000000000000000
chr3,6430197,6430485,288,-1,0,,0,0.00000000000000000000
chr3,6620516,6620700,184,-1,0,,0,0.00000000000000000000
chr3,6728154,6728911,757,-1,0,,0,0.00000000000000000000
chr3,6700871,6701253,382,-1,0,,0,0.00000000000000000000
chr3,6897148,6900046,2898,-1,0,,0,0.00000000000000000000
chr3,7072238,7170011,97773,-1,0,2917,1,1.02277724934287000000
chr3,7276375,7331647,55272,-1,0,2917,1,1.80923433203068000000
chr3,7347023,7347322,299,-1,0,2917,1,334.44816053511700000000
chr3,7368390,7372711,4321,-1,0,2917,1,23.14279102059710000000
chr3,7399980,7402161,2181,-1,0,2917,1,45.85052728106370000000
chr3,7866558,7985079,118521,-1,0,,0,0.00000000000000000000
chr3,7971552,8031364,59812,-1,0,,0,0.00000000000000000000
chr3,7903866,7912694,8828,-1,0,,0,0.00000000000000000000
chr3,8324882,8326933,2051,-1,0,,0,0.00000000000000000000
chr3,8325629,8326957,1328,-1,0,,0,0.00000000000000000000
chr3,7897951,7899273,1322,-1,0,,0,0.00000000000000000000
chr3,8325659,8326749,1090,-1,0,,0,0.00000000000000000000
chr3,7905945,7906150,205,-1,0,,0,0.00000000000000000000
chr3,8719035,8772511,53476,-1,0,,0,0.00000000000000000000
chr3,8719883,8724188,4305,-1,0,,0,0.00000000000000000000
chr3,8734257,8737649,3392,-1,0,,0,0.00000000000000000000
chr3,8452552,8454958,2406,-1,0,,0,0.00000000000000000000
chr3,8718354,8720065,1711,-1,0,,0,0.00000000000000000000
chr3,8720080,8721153,1073,-1,0,,0,0.00000000000000000000
chr3,8453487,8454369,882,-1,0,,0,0.00000000000000000000
chr3,8722590,8723068,478,-1,0,,0,0.00000000000000000000
chr3,8720440,8720958,518,-1,0,,0,0.00000000000000000000
chr3,8453611,8454010,399,-1,0,,0,0.00000000000000000000
chr3,8667461,8667898,437,-1,0,51066,1,228.83295194508000000000
chr3,8720712,8721085,373,-1,0,,0,0.00000000000000000000
chr3,8722649,8722979,330,-1,0,,0,0.00000000000000000000
chr3,8720297,8720644,347,-1,0,,0,0.00000000000000000000
chr3,8720178,8720463,285,-1,0,,0,0.00000000000000000000
chr3,9010072,9021479,11407,-1,0,,0,0.00000000000000000000
chr3,9359843,9368937,9094,-1,0,,0,0.00000000000000000000
chr3,9454179,9459141,4962,-1,0,55209,1,20.15316404675530000000
chr3,9560889,9563312,2423,-1,0,375323,1,41.27115146512590000000
chr3,9895330,9896803,1473,-1,0,,0,0.00000000000000000000
chr3,9921084,9930034,8950,-1,0,63924,1,11.17318435754190000000
chr3,11955066,12913559,958493,-1,0,55287;5894;100129480;5468;6854;23609;7079;6161;80746;23066,10,1.04330443727810000000
chr3,10035679,10089828,54149,-1,0,55831;2177;401052,3,5.54026851834752000000
chr3,11471568,11498562,26994,-1,0,10533,1,3.70452693191080000000
chr3,10213410,10226633,13223,-1,0,3656,1,7.56258035241624000000
chr3,12903969,12914917,10948,-1,0,,0,0.00000000000000000000
chr3,12402355,12411682,9327,-1,0,5468,1,10.72156105929020000000
chr3,11409969,11414900,4931,-1,0,10533,1,20.27986209693770000000
chr3,11637069,11644550,7481,-1,0,9686,1,13.36719689881030000000
chr3,10766397,10775238,8841,-1,0,,0,0.00000000000000000000
chr3,10273558,10281204,7646,-1,0,3656,1,13.07873397855090000000
chr3,11503181,11508369,5188,-1,0,10533,1,19.27525057825750000000
chr3,11752392,11757603,5211,-1,0,9686,1,19.19017463058910000000
chr3,11108668,11112469,3801,-1,0,,0,0.00000000000000000000
chr3,10173067,10177714,4647,-1,0,,0,0.00000000000000000000
chr3,10218529,10222735,4206,-1,0,3656,1,23.77555872563010000000
chr3,11782238,11784278,2040,-1,0,,0,0.00000000000000000000
chr3,12901018,12903838,2820,-1,0,,0,0.00000000000000000000
chr3,12664994,12667814,2820,-1,0,5894,1,35.46099290780140000000
chr3,10226170,10228943,2773,-1,0,3656,1,36.06202668589980000000
chr3,12259090,12261325,2235,-1,0,,0,0.00000000000000000000
chr3,12900592,12902742,2150,-1,0,,0,0.00000000000000000000
chr3,11983701,11985232,1531,-1,0,,0,0.00000000000000000000
chr3,11782562,11784004,1442,-1,0,,0,0.00000000000000000000
chr3,11645674,11646912,1238,-1,0,9686,1,80.77544426494350000000
chr3,12365508,12366539,1031,-1,0,5468,1,96.99321047526670000000
chr3,10207509,10208543,1034,-1,0,3656,1,96.71179883945840000000
chr3,11760602,11761762,1160,-1,0,9686,1,86.20689655172410000000
chr3,10758047,10758584,537,-1,0,,0,0.00000000000000000000
chr3,10190060,10190864,804,-1,0,7428,1,124.37810945273600000000
chr3,10397383,10397926,543,-1,0,491,1,184.16206261510100000000
chr3,12771189,12771870,681,-1,0,,0,0.00000000000000000000
chr3,11645898,11646575,677,-1,0,9686,1,147.71048744460900000000
chr3,11699677,11700120,443,-1,0,9686,1,225.73363431151200000000
chr3,11614622,11615033,411,-1,0,9686,1,243.30900243309000000000
chr3,11975485,11976132,647,-1,0,,0,0.00000000000000000000
chr3,10060234,10060802,568,-1,0,,0,0.00000000000000000000
chr3,12196345,12196764,419,-1,0,7079;6854,2,477.32696897374700000000
chr3,10991770,10992270,500,-1,0,,0,0.00000000000000000000
chr3,12351916,12352310,394,-1,0,5468,1,253.80710659898500000000
chr3,12489756,12490169,413,-1,0,,0,0.00000000000000000000
chr3,11208534,11208834,300,-1,0,3269,1,333.33333333333300000000
chr3,10397493,10397799,306,-1,0,491,1,326.79738562091500000000
chr3,12489923,12490175,252,-1,0,,0,0.00000000000000000000
chr3,10821756,10821920,164,-1,0,,0,0.00000000000000000000
chr3,10758275,10758356,81,-1,0,,0,0.00000000000000000000
chr3,10549591,10549649,58,-1,0,,0,0.00000000000000000000
chr3,12196528,12196582,54,-1,0,7079;6854,2,3703.70370370370000000000
chr3,13141432,13142588,1156,-1,0,,0,0.00000000000000000000
chr3,13141525,13142360,835,-1,0,,0,0.00000000000000000000
chr3,13332538,13339374,6836,-1,0,,0,0.00000000000000000000
chr3,13706268,13710391,4123,-1,0,,0,0.00000000000000000000
chr3,13681156,13682269,1113,-1,0,,0,0.00000000000000000000
chr3,13720311,13728654,8343,-1,0,,0,0.00000000000000000000
chr3,14385036,14392203,7167,-1,0,,0,0.00000000000000000000
chr3,14291151,14296084,4933,-1,0,,0,0.00000000000000000000
chr3,14784395,14786330,1935,-1,0,84077,1,51.67958656330750000000
chr3,14620630,14622372,1742,-1,0,,0,0.00000000000000000000
chr3,14729789,14731279,1490,-1,0,84077,1,67.11409395973150000000
chr3,14809610,14811006,1396,-1,0,84077,1,71.63323782234960000000
chr3,14132678,14133652,974,-1,0,,0,0.00000000000000000000
chr3,14196079,14196659,580,-1,0,7508,1,172.41379310344800000000
chr3,14178159,14178848,689,-1,0,79188,1,145.13788098693800000000
chr3,14160789,14161131,342,-1,0,131474,1,292.39766081871300000000
chr3,14196264,14196418,154,-1,0,7508,1,649.35064935064900000000
chr3,14196284,14196366,82,-1,0,7508,1,1219.51219512195000000000
chr3,15012709,15013447,738,-1,0,7182,1,135.50135501355000000000
chr3,15313873,15314376,503,-1,0,9467,1,198.80715705765400000000
chr3,15313974,15314286,312,-1,0,9467,1,320.51282051282000000000
chr3,15314080,15314210,130,-1,0,9467,1,769.23076923076900000000
chr3,15566480,15566886,406,-1,0,,0,0.00000000000000000000
chr3,15573453,15574096,643,-1,0,,0,0.00000000000000000000
chr3,15580868,15584509,3641,-1,0,,0,0.00000000000000000000
chr3,15633886,15634665,779,-1,0,26061,1,128.36970474967900000000
chr3,15845172,15846738,1566,-1,0,23243,1,63.85696040868460000000
chr3,15845216,15846725,1509,-1,0,23243,1,66.26905235255140000000
chr3,16239303,16241292,1989,-1,0,117248,1,50.27652086475620000000
chr3,16239232,16240999,1767,-1,0,117248,1,56.59309564233160000000
chr3,16239637,16240561,924,-1,0,117248,1,108.22510822510800000000
chr3,16450063,16450365,302,-1,0,23180,1,331.12582781457000000000
chr3,16581056,16655601,74545,-1,0,1618,1,1.34147159433899000000
chr3,16652672,16658748,6076,-1,0,,0,0.00000000000000000000
chr3,16636397,16640361,3964,-1,0,1618,1,25.22704339051460000000
chr3,16793196,16793254,58,-1,0,,0,0.00000000000000000000
chr3,17025572,17031179,5607,-1,0,23228,1,17.83484929552350000000
chr3,17189971,17190511,540,-1,0,,0,0.00000000000000000000
chr3,17190169,17190300,131,-1,0,,0,0.00000000000000000000
chr3,17390051,17484215,94164,-1,0,9779,1,1.06197697633915000000
chr3,17513051,17513194,143,-1,0,9779,1,699.30069930069900000000
chr3,17917706,17947938,30232,-1,0,,0,0.00000000000000000000
chr3,17540639,17546350,5711,-1,0,9779,1,17.51006828926630000000
chr3,17720059,17725036,4977,-1,0,9779,1,20.09242515571630000000
chr3,17731631,17732114,483,-1,0,9779,1,207.03933747412000000000
chr3,17948536,17948921,385,-1,0,,0,0.00000000000000000000
chr3,17731670,17732018,348,-1,0,9779,1,287.35632183908000000000
chr3,18729953,18730777,824,-1,0,,0,0.00000000000000000000
chr3,18755816,18756126,310,-1,0,,0,0.00000000000000000000
chr3,18804149,18804296,147,-1,0,,0,0.00000000000000000000
chr3,19221565,19221935,370,-1,0,131096,1,270.27027027027000000000
chr3,19316601,19319671,3070,-1,0,131096,1,32.57328990228010000000
chr3,19422671,19426602,3931,-1,0,131096,1,25.43881963876880000000
chr3,19605083,19694907,89824,-1,0,,0,0.00000000000000000000
chr3,19808789,19823243,14454,-1,0,,0,0.00000000000000000000
chr3,19915747,19916118,371,-1,0,,0,0.00000000000000000000
chr3,20011449,20011549,100,-1,0,5868,1,1000.00000000000000000000
chr3,20200447,20201473,1026,-1,0,,0,0.00000000000000000000
chr3,20200745,20201197,452,-1,0,,0,0.00000000000000000000
chr3,20311414,20317726,6312,-1,0,,0,0.00000000000000000000
chr3,20374295,20377042,2747,-1,0,,0,0.00000000000000000000
chr3,20338571,20339753,1182,-1,0,,0,0.00000000000000000000
chr3,20388925,20486348,97423,-1,0,,0,0.00000000000000000000
chr3,20413456,20416889,3433,-1,0,,0,0.00000000000000000000
chr3,20416884,20417324,440,-1,0,,0,0.00000000000000000000
chr3,20653870,20654260,390,-1,0,,0,0.00000000000000000000
chr3,20988433,20996179,7746,-1,0,,0,0.00000000000000000000
chr3,21009499,21013507,4008,-1,0,,0,0.00000000000000000000
chr3,21014469,21018633,4164,-1,0,,0,0.00000000000000000000
chr3,21004485,21006409,1924,-1,0,,0,0.00000000000000000000
chr3,20895980,20897764,1784,-1,0,,0,0.00000000000000000000
chr3,20875061,20876618,1557,-1,0,,0,0.00000000000000000000
chr3,20896962,20897713,751,-1,0,,0,0.00000000000000000000
chr3,20944994,20945559,565,-1,0,,0,0.00000000000000000000
chr3,20919490,20919766,276,-1,0,,0,0.00000000000000000000
chr3,20896531,20896833,302,-1,0,,0,0.00000000000000000000
chr3,20945212,20945311,99,-1,0,,0,0.00000000000000000000
chr3,21457375,21457931,556,-1,0,,0,0.00000000000000000000
chr3,21457498,21457827,329,-1,0,,0,0.00000000000000000000
chr3,22111297,22255804,144507,-1,0,,0,0.00000000000000000000
chr3,21915430,21974548,59118,-1,0,,0,0.00000000000000000000
chr3,22181920,22207478,25558,-1,0,,0,0.00000000000000000000
chr3,21885723,21909688,23965,-1,0,,0,0.00000000000000000000
chr3,21574499,21580795,6296,-1,0,79750,1,15.88310038119440000000
chr3,21803379,21812138,8759,-1,0,,0,0.00000000000000000000
chr3,22092193,22097983,5790,-1,0,,0,0.00000000000000000000
chr3,22251974,22254686,2712,-1,0,,0,0.00000000000000000000
chr3,21723710,21725907,2197,-1,0,79750,1,45.51661356395080000000
chr3,21991553,21993631,2078,-1,0,,0,0.00000000000000000000
chr3,21756487,21757806,1319,-1,0,79750,1,75.81501137225170000000
chr3,21822170,21823306,1136,-1,0,,0,0.00000000000000000000
chr3,22279183,22286432,7249,-1,0,,0,0.00000000000000000000
chr3,22274215,22275476,1261,-1,0,,0,0.00000000000000000000
chr3,22362146,22369426,7280,-1,0,,0,0.00000000000000000000
chr3,22560592,22610335,49743,-1,0,,0,0.00000000000000000000
chr3,22635923,22724703,88780,-1,0,,0,0.00000000000000000000
chr3,22907490,22910977,3487,-1,0,,0,0.00000000000000000000
chr3,23088836,23092110,3274,-1,0,,0,0.00000000000000000000
chr3,23233519,23234181,662,-1,0,,0,0.00000000000000000000
chr3,23514111,23518653,4542,-1,0,7325,1,22.01673271686480000000
chr3,23620804,23621144,340,-1,0,7325,1,294.11764705882400000000
chr3,23685714,23686183,469,-1,0,,0,0.00000000000000000000
chr3,23763955,23764501,546,-1,0,,0,0.00000000000000000000
chr3,23764061,23764398,337,-1,0,,0,0.00000000000000000000
chr3,24090686,24091189,503,-1,0,,0,0.00000000000000000000
chr3,24090751,24091054,303,-1,0,,0,0.00000000000000000000
chr3,24107148,24114589,7441,-1,0,,0,0.00000000000000000000
chr3,24289388,24289997,609,-1,0,7068,1,164.20361247947500000000
chr3,24306054,24306104,50,-1,0,7068,1,2000.00000000000000000000
chr3,24386249,24387187,938,-1,0,7068,1,106.60980810234500000000
chr3,24446168,24450615,4447,-1,0,7068,1,22.48706993478750000000
chr3,24745514,24823970,78456,-1,0,,0,0.00000000000000000000
chr3,24780896,24785640,4744,-1,0,,0,0.00000000000000000000
chr3,24802893,24804504,1611,-1,0,,0,0.00000000000000000000
chr3,24819451,24819889,438,-1,0,,0,0.00000000000000000000
chr3,24891836,24909107,17271,-1,0,5915,1,5.79005268947947000000
chr3,25030546,25032882,2336,-1,0,5915,1,42.80821917808220000000
chr3,25030880,25032245,1365,-1,0,5915,1,73.26007326007330000000
chr3,25172204,25172815,611,-1,0,5915,1,163.66612111293000000000
chr3,25172418,25172499,81,-1,0,5915,1,1234.56790123457000000000
chr3,25234273,25234742,469,-1,0,5915,1,213.21961620469100000000
chr3,25699354,25699599,245,-1,0,7155,1,408.16326530612200000000
chr3,25850774,25861067,10293,-1,0,,0,0.00000000000000000000
chr3,25849764,25855442,5678,-1,0,,0,0.00000000000000000000
chr3,25905593,26185773,280180,-1,0,,0,0.00000000000000000000
chr3,26040131,26162083,121952,-1,0,,0,0.00000000000000000000
chr3,26442658,26474464,31806,-1,0,,0,0.00000000000000000000
chr3,26431490,26444863,13373,-1,0,,0,0.00000000000000000000
chr3,26439487,26445538,6051,-1,0,,0,0.00000000000000000000
chr3,26432304,26439526,7222,-1,0,,0,0.00000000000000000000
chr3,26449245,26452542,3297,-1,0,,0,0.00000000000000000000
chr3,26461523,26463053,1530,-1,0,,0,0.00000000000000000000
chr3,26450947,26452299,1352,-1,0,,0,0.00000000000000000000
chr3,26123719,26124156,437,-1,0,,0,0.00000000000000000000
chr3,26123820,26123977,157,-1,0,,0,0.00000000000000000000
chr3,26469887,26469986,99,-1,0,,0,0.00000000000000000000
chr3,26585488,26588751,3263,-1,0,,0,0.00000000000000000000
chr3,26593542,26617952,24410,-1,0,,0,0.00000000000000000000
chr3,26701562,26709452,7890,-1,0,116135,1,12.67427122940430000000
chr3,26786573,26787014,441,-1,0,,0,0.00000000000000000000
chr3,26931736,26932715,979,-1,0,,0,0.00000000000000000000
chr3,26945651,26945968,317,-1,0,,0,0.00000000000000000000
chr3,27134276,27135225,949,-1,0,,0,0.00000000000000000000
chr3,27639022,27652538,13516,-1,0,,0,0.00000000000000000000
chr3,27701828,27702780,952,-1,0,,0,0.00000000000000000000
chr3,27713480,27718371,4891,-1,0,,0,0.00000000000000000000
chr3,27832096,27832431,335,-1,0,,0,0.00000000000000000000
chr3,27837446,27843492,6046,-1,0,,0,0.00000000000000000000
chr3,28167387,28167824,437,-1,0,,0,0.00000000000000000000
chr3,28167455,28167781,326,-1,0,,0,0.00000000000000000000
chr3,28187059,28197758,10699,-1,0,,0,0.00000000000000000000
chr3,28227604,28228493,889,-1,0,,0,0.00000000000000000000
chr3,28391782,28393535,1753,-1,0,152098,1,57.04506560182540000000
chr3,28538909,28545766,6857,-1,0,152098,1,14.58363715910750000000
chr3,28639494,28644440,4946,-1,0,,0,0.00000000000000000000
chr3,28669510,28671682,2172,-1,0,,0,0.00000000000000000000
chr3,28765918,28766563,645,-1,0,,0,0.00000000000000000000
chr3,28809881,28817810,7929,-1,0,,0,0.00000000000000000000
chr3,28945652,29198276,252624,-1,0,,0,0.00000000000000000000
chr3,28947527,29004867,57340,-1,0,,0,0.00000000000000000000
chr3,29064861,29076418,11557,-1,0,,0,0.00000000000000000000
chr3,28950216,28950797,581,-1,0,,0,0.00000000000000000000
chr3,29433192,29438650,5458,-1,0,27303,1,18.32172957127150000000
chr3,29558383,29569638,11255,-1,0,27303,1,8.88494002665482000000
chr3,29620281,29620604,323,-1,0,27303,1,309.59752321981400000000
chr3,29695041,29700931,5890,-1,0,27303,1,16.97792869269950000000
chr3,29946409,29956538,10129,-1,0,27303,1,9.87264290650607000000
chr3,30067553,30071222,3669,-1,0,,0,0.00000000000000000000
chr3,30253253,30253788,535,-1,0,,0,0.00000000000000000000
chr3,30317073,30328465,11392,-1,0,,0,0.00000000000000000000
chr3,30909971,30913444,3473,-1,0,339896,1,28.79355024474520000000
chr3,30993179,30998683,5504,-1,0,,0,0.00000000000000000000
chr3,31109435,31109758,323,-1,0,,0,0.00000000000000000000
chr3,31532838,31533217,379,-1,0,,0,0.00000000000000000000
chr3,31543563,31544071,508,-1,0,,0,0.00000000000000000000
chr3,31543639,31543940,301,-1,0,,0,0.00000000000000000000
chr3,31854263,31854361,98,-1,0,114884,1,1020.40816326531000000000
chr3,32093480,32127022,33542,-1,0,,0,0.00000000000000000000
chr3,32101981,32107977,5996,-1,0,,0,0.00000000000000000000
chr3,32153455,32154076,621,-1,0,23171,1,161.03059581320500000000
chr3,32153729,32153886,157,-1,0,23171,1,636.94267515923600000000
chr3,32201690,32202199,509,-1,0,23171,1,196.46365422396900000000
chr3,32201776,32202003,227,-1,0,23171,1,440.52863436123400000000
chr3,32203753,32204280,527,-1,0,23171,1,189.75332068311200000000
chr3,32203876,32204163,287,-1,0,23171,1,348.43205574912900000000
chr3,32338852,32339757,905,-1,0,152189,1,110.49723756906100000000
chr3,32420559,32420742,183,-1,0,,0,0.00000000000000000000
chr3,32668141,32668968,827,-1,0,,0,0.00000000000000000000
chr3,32806629,32808097,1468,-1,0,25904,1,68.11989100817440000000
chr3,32806742,32808057,1315,-1,0,25904,1,76.04562737642590000000
chr3,32829415,32831489,2074,-1,0,,0,0.00000000000000000000
chr3,32838584,32839071,487,-1,0,,0,0.00000000000000000000
chr3,32940758,32940854,96,-1,0,,0,0.00000000000000000000
chr3,32957851,32964285,6434,-1,0,,0,0.00000000000000000000
chr3,33022727,33023151,424,-1,0,,0,0.00000000000000000000
chr3,33300851,33301279,428,-1,0,,0,0.00000000000000000000
chr3,33300938,33301247,309,-1,0,,0,0.00000000000000000000
chr3,33421845,33422633,788,-1,0,25827,1,126.90355329949200000000
chr3,33485549,33485889,340,-1,0,,0,0.00000000000000000000
chr3,33553188,33554075,887,-1,0,23122,1,112.73957158962800000000
chr3,34119670,34120469,799,-1,0,,0,0.00000000000000000000
chr3,34134760,34140542,5782,-1,0,,0,0.00000000000000000000
chr3,34264079,34265533,1454,-1,0,,0,0.00000000000000000000
chr3,34532015,34532477,462,-1,0,,0,0.00000000000000000000
chr3,34532140,34532315,175,-1,0,,0,0.00000000000000000000
chr3,34728945,34810784,81839,-1,0,,0,0.00000000000000000000
chr3,34891794,34892435,641,-1,0,,0,0.00000000000000000000
chr3,34891992,34892118,126,-1,0,,0,0.00000000000000000000
chr3,34906131,34947664,41533,-1,0,,0,0.00000000000000000000
chr3,35051518,35052143,625,-1,0,,0,0.00000000000000000000
chr3,35183880,35184187,307,-1,0,,0,0.00000000000000000000
chr3,35051648,35051992,344,-1,0,,0,0.00000000000000000000
chr3,35287051,35289057,2006,-1,0,,0,0.00000000000000000000
chr3,35400040,35414342,14302,-1,0,,0,0.00000000000000000000
chr3,35845271,35846042,771,-1,0,,0,0.00000000000000000000
chr3,36056619,36058169,1550,-1,0,,0,0.00000000000000000000
chr3,36057072,36057561,489,-1,0,,0,0.00000000000000000000
chr3,36108075,36108475,400,-1,0,,0,0.00000000000000000000
chr3,36153993,36154692,699,-1,0,,0,0.00000000000000000000
chr3,36251660,36341342,89682,-1,0,,0,0.00000000000000000000
chr3,36308036,36315337,7301,-1,0,,0,0.00000000000000000000
chr3,36341727,36342039,312,-1,0,,0,0.00000000000000000000
chr3,36396896,36418368,21472,-1,0,,0,0.00000000000000000000
chr3,36439905,36440064,159,-1,0,6769,1,628.93081761006300000000
chr3,36495119,36495286,167,-1,0,6769,1,598.80239520958100000000
chr3,36555705,36557476,1771,-1,0,6769,1,56.46527385657820000000
chr3,36711707,36719486,7779,-1,0,,0,0.00000000000000000000
chr3,36764178,36766154,1976,-1,0,85443,1,50.60728744939270000000
chr3,37244985,37251713,6728,-1,0,,0,0.00000000000000000000
chr3,37440521,37441970,1449,-1,0,339883,1,69.01311249137340000000
chr3,37452877,37455586,2709,-1,0,339883,1,36.91399040236250000000
chr3,37798416,37800201,1785,-1,0,3680,1,56.02240896358540000000
chr3,37978138,37986956,8818,-1,0,10217,1,11.34044000907240000000
chr3,37982537,37992540,10003,-1,0,10217,1,9.99700089973008000000
chr3,37977714,37984527,6813,-1,0,10217,1,14.67782181124320000000
chr3,37982522,37986955,4433,-1,0,10217,1,22.55808707421610000000
chr3,37982480,37984874,2394,-1,0,10217,1,41.77109440267330000000
chr3,38154940,38155075,135,-1,0,9940,1,740.74074074074100000000
chr3,38304330,38347978,43648,-1,0,9390;9389,2,4.58211143695015000000
chr3,38918411,38919514,1103,-1,0,11280,1,90.66183136899370000000
chr3,38918574,38918975,401,-1,0,11280,1,249.37655860349100000000
chr3,38918944,38919279,335,-1,0,11280,1,298.50746268656700000000
chr3,39026369,39027864,1495,-1,0,,0,0.00000000000000000000
chr3,39198892,39218507,19615,-1,0,,0,0.00000000000000000000
chr3,39351485,39414079,62594,-1,0,1237,1,1.59759721379046000000
chr3,39577785,39597989,20204,-1,0,,0,0.00000000000000000000
chr3,39730574,39776225,45651,-1,0,,0,0.00000000000000000000
chr3,39761726,39782318,20592,-1,0,,0,0.00000000000000000000
chr3,40001302,40026305,25003,-1,0,25924,1,3.99952005759309000000
chr3,39998158,39998885,727,-1,0,25924,1,137.55158184319100000000
chr3,40132535,40133143,608,-1,0,25924,1,164.47368421052600000000
chr3,40132609,40132953,344,-1,0,25924,1,290.69767441860500000000
chr3,40452723,40462184,9461,-1,0,956,1,10.56970721911000000000
chr3,40581180,40584123,2943,-1,0,285268,1,33.97893306150190000000
chr3,40753750,40754435,685,-1,0,,0,0.00000000000000000000
chr3,40836326,40836373,47,-1,0,,0,0.00000000000000000000
chr3,41024485,41027213,2728,-1,0,,0,0.00000000000000000000
chr3,41088156,41144890,56734,-1,0,,0,0.00000000000000000000
chr3,41336636,41337202,566,-1,0,54986,1,176.67844522968200000000
chr3,41349794,41830781,480987,-1,0,54986,1,0.20790582697661300000
chr3,41564092,41669303,105211,-1,0,54986,1,0.95047095835986700000
chr3,41407725,41512858,105133,-1,0,54986,1,0.95117612928385900000
chr3,41614347,41637414,23067,-1,0,54986,1,4.33519746824468000000
chr3,41779107,41789001,9894,-1,0,54986,1,10.10713563776030000000
chr3,41813566,41821888,8322,-1,0,54986,1,12.01634222542660000000
chr3,41818058,41821494,3436,-1,0,54986,1,29.10360884749710000000
chr3,41598782,41601034,2252,-1,0,54986,1,44.40497335701600000000
chr3,41731996,41733766,1770,-1,0,54986,1,56.49717514124290000000
chr3,41416863,41418490,1627,-1,0,54986,1,61.46281499692690000000
chr3,41832534,41834159,1625,-1,0,54986,1,61.53846153846150000000
chr3,42356828,42373435,16607,-1,0,,0,0.00000000000000000000
chr3,42639918,42640562,644,-1,0,9117,1,155.27950310559000000000
chr3,42818707,42821504,2797,-1,0,,0,0.00000000000000000000
chr3,42838318,42840888,2570,-1,0,25994,1,38.91050583657590000000
chr3,43029502,43031844,2342,-1,0,729085,1,42.69854824935950000000
chr3,43031067,43031458,391,-1,0,729085,1,255.75447570332500000000
chr3,43053657,43054553,896,-1,0,729085,1,111.60714285714300000000
chr3,43327794,43328639,845,-1,0,54861,1,118.34319526627200000000
chr3,43548728,43562565,13837,-1,0,55129,1,7.22700007227000000000
chr3,43584939,43593162,8223,-1,0,55129,1,12.16101179618140000000
chr3,43859012,43864335,5323,-1,0,,0,0.00000000000000000000
chr3,44075599,44075781,182,-1,0,,0,0.00000000000000000000
chr3,44226797,44229054,2257,-1,0,,0,0.00000000000000000000
chr3,44316309,44317529,1220,-1,0,375337,1,81.96721311475410000000
chr3,44382384,44386871,4487,-1,0,285343,1,22.28660574994430000000
chr3,44640434,44644161,3727,-1,0,,0,0.00000000000000000000
chr3,45073152,45073569,417,-1,0,7123,1,239.80815347721800000000
chr3,45496759,45497824,1065,-1,0,23395,1,93.89671361502350000000
chr3,45542914,45552054,9140,-1,0,23395,1,10.94091903719910000000
chr3,45609825,45610310,485,-1,0,,0,0.00000000000000000000
chr3,45768351,45768676,325,-1,0,22908,1,307.69230769230800000000
chr3,45830833,45831227,394,-1,0,54716,1,253.80710659898500000000
chr3,45831052,45831106,54,-1,0,54716,1,1851.85185185185000000000
chr3,46018834,46018887,53,-1,0,79443,1,1886.79245283019000000000
chr3,46045732,46046283,551,-1,0,,0,0.00000000000000000000
chr3,46045863,46046141,278,-1,0,,0,0.00000000000000000000
chr3,46223245,46223605,360,-1,0,,0,0.00000000000000000000
chr3,46223514,46223794,280,-1,0,,0,0.00000000000000000000
chr3,46437722,46438759,1037,-1,0,,0,0.00000000000000000000
chr3,46550247,46550902,655,-1,0,,0,0.00000000000000000000
chr3,46705709,46709349,3640,-1,0,,0,0.00000000000000000000
chr3,46792463,46859720,67257,-1,0,,0,0.00000000000000000000
chr3,46804785,46845274,40489,-1,0,,0,0.00000000000000000000
chr3,46797335,46826082,28747,-1,0,,0,0.00000000000000000000
chr3,47016701,47054700,37999,-1,0,23218;151903,2,5.26329640253691000000
chr3,47015717,47016644,927,-1,0,151903,1,107.87486515641900000000
chr3,47478509,47493369,14860,-1,0,22937,1,6.72947510094213000000
chr3,47490611,47493501,2890,-1,0,22937,1,34.60207612456750000000
chr3,47524237,47533218,8981,-1,0,,0,0.00000000000000000000
chr3,47571600,47573007,1407,-1,0,,0,0.00000000000000000000
chr3,47827030,47827977,947,-1,0,,0,0.00000000000000000000
chr3,47984938,47988302,3364,-1,0,4134,1,29.72651605231870000000
chr3,47984766,47986374,1608,-1,0,4134,1,62.18905472636820000000
chr3,48173207,48175451,2244,-1,0,,0,0.00000000000000000000
chr3,48197102,48197339,237,-1,0,,0,0.00000000000000000000
chr3,48197171,48197305,134,-1,0,,0,0.00000000000000000000
chr3,48557247,48648386,91139,-1,0,5210;90226;1294;7384,4,4.38890047070958000000
chr3,48648110,48649322,1212,-1,0,,0,0.00000000000000000000
chr3,48599144,48599235,91,-1,0,90226,1,1098.90109890110000000000
chr3,48942680,48946208,3528,-1,0,,0,0.00000000000000000000
chr3,48957700,48959056,1356,-1,0,10425,1,73.74631268436580000000
chr3,49197639,49198371,732,-1,0,,0,0.00000000000000000000
chr3,49197775,49198122,347,-1,0,,0,0.00000000000000000000
chr3,49469457,49473492,4035,-1,0,,0,0.00000000000000000000
chr3,49494175,49494724,549,-1,0,,0,0.00000000000000000000
chr3,49494282,49494610,328,-1,0,,0,0.00000000000000000000
chr3,49517859,49518499,640,-1,0,1605,1,156.25000000000000000000
chr3,49974947,49977280,2333,-1,0,,0,0.00000000000000000000
chr3,49976198,49976972,774,-1,0,,0,0.00000000000000000000
chr3,49986074,49993157,7083,-1,0,10180,1,14.11831144995060000000
chr3,50123680,50124747,1067,-1,0,,0,0.00000000000000000000
chr3,50189901,50476600,286699,-1,0,8692;9254;7869;10641;10991;2771;11334;3373;8372;2779;7866;11186;132228;24142;51364;6405;11068;11070,18,6.27836162665374000000
chr3,50340716,50348824,8108,-1,0,3373,1,12.33349777997040000000
chr3,50443393,50444832,1439,-1,0,9254,1,69.49270326615710000000
chr3,50300575,50301297,722,-1,0,,0,0.00000000000000000000
chr3,50941943,50955168,13225,-1,0,1795,1,7.56143667296786000000
chr3,50996743,51033802,37059,-1,0,1795,1,2.69839984888961000000
chr3,51053193,51058764,5571,-1,0,1795,1,17.95009872554300000000
chr3,51409255,51409983,728,-1,0,1795,1,137.36263736263700000000
chr3,51772673,51773145,472,-1,0,,0,0.00000000000000000000
chr3,51772739,51773030,291,-1,0,,0,0.00000000000000000000
chr3,51772853,51772988,135,-1,0,,0,0.00000000000000000000
chr3,51883906,51883975,69,-1,0,,0,0.00000000000000000000
chr3,52089821,52091148,1327,-1,0,1849,1,75.35795026375280000000
chr3,52478741,52478813,72,-1,0,56920,1,1388.88888888889000000000
chr3,52510901,52564900,53999,-1,0,11188;23166;64943,3,5.55565843811922000000
chr3,52533624,52533962,338,-1,0,23166,1,295.85798816568000000000
chr3,52709760,52710244,484,-1,0,55193,1,206.61157024793400000000
chr3,52709853,52710170,317,-1,0,55193,1,315.45741324921100000000
chr3,53028061,53051430,23369,-1,0,51460,1,4.27917326372545000000
chr3,53021056,53039250,18194,-1,0,51460,1,5.49631746729691000000
chr3,53027222,53041351,14129,-1,0,51460,1,7.07764172977564000000
chr3,53032348,53046018,13670,-1,0,51460,1,7.31528895391368000000
chr3,53023887,53034286,10399,-1,0,51460,1,9.61630926050582000000
chr3,53031957,53039011,7054,-1,0,51460,1,14.17635384179190000000
chr3,53046594,53047795,1201,-1,0,51460,1,83.26394671107410000000
chr3,53069013,53069564,551,-1,0,51460,1,181.48820326678800000000
chr3,53079058,53080369,1311,-1,0,51460,1,76.27765064836000000000
chr3,54005847,54035163,29316,-1,0,,0,0.00000000000000000000
chr3,53495963,53500183,4220,-1,0,,0,0.00000000000000000000
chr3,54732796,54735684,2888,-1,0,55799,1,34.62603878116340000000
chr3,53527446,53529975,2529,-1,0,776,1,39.54132068011070000000
chr3,54241151,54241560,409,-1,0,55799,1,244.49877750611200000000
chr3,55358247,55358720,473,-1,0,,0,0.00000000000000000000
chr3,55358439,55358537,98,-1,0,,0,0.00000000000000000000
chr3,55382755,55385864,3109,-1,0,,0,0.00000000000000000000
chr3,55405784,55406636,852,-1,0,,0,0.00000000000000000000
chr3,55861968,55863189,1221,-1,0,26059,1,81.90008190008190000000
chr3,56548081,56548971,890,-1,0,,0,0.00000000000000000000
chr3,56610381,56626811,16430,-1,0,285331,1,6.08642726719416000000
chr3,56607743,56621613,13870,-1,0,285331,1,7.20980533525595000000
chr3,56603957,56605297,1340,-1,0,285331,1,74.62686567164180000000
chr3,56604627,56604998,371,-1,0,285331,1,269.54177897574100000000
chr3,56604702,56604959,257,-1,0,285331,1,389.10505836575900000000
chr3,56630460,56640977,10517,-1,0,285331,1,9.50841494722830000000
chr3,56794630,56800844,6214,-1,0,50650,1,16.09269391696170000000
chr3,57003270,57003433,163,-1,0,50650,1,613.49693251533700000000
chr3,57005567,57007053,1486,-1,0,50650,1,67.29475100942130000000
chr3,57877496,57878792,1296,-1,0,7871,1,77.16049382716050000000
chr3,57954049,57977868,23819,-1,0,,0,0.00000000000000000000
chr3,58271959,58273080,1121,-1,0,57406,1,89.20606601248880000000
chr3,58477127,58478421,1294,-1,0,200845,1,77.27975270479130000000
chr3,58533735,58537575,3840,-1,0,,0,0.00000000000000000000
chr3,58798364,58800115,1751,-1,0,200844,1,57.11022272986860000000
chr3,59125120,59125663,543,-1,0,,0,0.00000000000000000000
chr3,59125219,59125546,327,-1,0,,0,0.00000000000000000000
chr3,59205432,59207218,1786,-1,0,,0,0.00000000000000000000
chr3,59377954,59378041,87,-1,0,,0,0.00000000000000000000
chr3,59493061,59493181,120,-1,0,,0,0.00000000000000000000
chr3,60067689,60281005,213316,-1,0,2272,1,0.46878808903223400000
chr3,60484433,60618336,133903,-1,0,2272,1,0.74680925744755500000
chr3,60313494,60410135,96641,-1,0,2272,1,1.03475750457880000000
chr3,60528125,60604325,76200,-1,0,2272,1,1.31233595800525000000
chr3,60373634,60459292,85658,-1,0,2272,1,1.16743328118798000000
chr3,60437282,60469626,32344,-1,0,2272,1,3.09176354192431000000
chr3,60318908,60356216,37308,-1,0,2272,1,2.68039026482256000000
chr3,60239305,60253574,14269,-1,0,2272,1,7.00819959352442000000
chr3,60589662,60599879,10217,-1,0,2272,1,9.78760888714887000000
chr3,59954046,59958151,4105,-1,0,2272,1,24.36053593179050000000
chr3,60106209,60109774,3565,-1,0,2272,1,28.05049088359050000000
chr3,59951659,59954923,3264,-1,0,2272,1,30.63725490196080000000
chr3,59699525,59700441,916,-1,0,,0,0.00000000000000000000
chr3,60479629,60480336,707,-1,0,2272,1,141.44271570014100000000
chr3,59792069,59792648,579,-1,0,2272,1,172.71157167530200000000
chr3,60799919,60809547,9628,-1,0,2272,1,10.38637307852100000000
chr3,60825726,60914178,88452,-1,0,2272,1,1.13055668611224000000
chr3,60832980,60843226,10246,-1,0,2272,1,9.75990630489947000000
chr3,60820155,60824493,4338,-1,0,2272,1,23.05209774089440000000
chr3,61070258,61109858,39600,-1,0,2272,1,2.52525252525253000000
chr3,61120730,61127609,6879,-1,0,2272,1,14.53699665649080000000
chr3,61127174,61128182,1008,-1,0,2272,1,99.20634920634920000000
chr3,61416022,61416807,785,-1,0,,0,0.00000000000000000000
chr3,61476762,61494741,17979,-1,0,,0,0.00000000000000000000
chr3,61478857,61488014,9157,-1,0,,0,0.00000000000000000000
chr3,61474971,61475427,456,-1,0,,0,0.00000000000000000000
chr3,61475048,61475371,323,-1,0,,0,0.00000000000000000000
chr3,61657450,61720728,63278,-1,0,5793,1,1.58032807610860000000
chr3,61666414,61666685,271,-1,0,5793,1,369.00369003690000000000
chr3,61794772,61796583,1811,-1,0,5793,1,55.21811154058530000000
chr3,61855720,61856949,1229,-1,0,5793,1,81.36696501220500000000
chr3,62610240,62612299,2059,-1,0,8618,1,48.56726566294320000000
chr3,62664390,62695644,31254,-1,0,8618,1,3.19959045242209000000
chr3,62711292,62715976,4684,-1,0,8618,1,21.34927412467980000000
chr3,62955606,62995114,39508,-1,0,,0,0.00000000000000000000
chr3,62961431,62993083,31652,-1,0,,0,0.00000000000000000000
chr3,63104367,63107213,2846,-1,0,,0,0.00000000000000000000
chr3,63124273,63138753,14480,-1,0,,0,0.00000000000000000000
chr3,63128577,63136540,7963,-1,0,,0,0.00000000000000000000
chr3,63133292,63135796,2504,-1,0,,0,0.00000000000000000000
chr3,63134848,63135306,458,-1,0,,0,0.00000000000000000000
chr3,63224880,63225628,748,-1,0,,0,0.00000000000000000000
chr3,63256381,63256850,469,-1,0,,0,0.00000000000000000000
chr3,63256537,63256644,107,-1,0,,0,0.00000000000000000000
chr3,63271994,63273127,1133,-1,0,132204,1,88.26125330979700000000
chr3,63515492,63515961,469,-1,0,132204,1,213.21961620469100000000
chr3,63736291,63738449,2158,-1,0,,0,0.00000000000000000000
chr3,63750056,63750162,106,-1,0,,0,0.00000000000000000000
chr3,63779974,63780276,302,-1,0,,0,0.00000000000000000000
chr3,63802427,63803979,1552,-1,0,,0,0.00000000000000000000
chr3,64914564,64914757,193,-1,0,,0,0.00000000000000000000
chr3,65117562,65121512,3950,-1,0,,0,0.00000000000000000000
chr3,65117758,65119701,1943,-1,0,,0,0.00000000000000000000
chr3,65123008,65123532,524,-1,0,,0,0.00000000000000000000
chr3,65188761,65214939,26178,-1,0,,0,0.00000000000000000000
chr3,65183957,65203617,19660,-1,0,,0,0.00000000000000000000
chr3,65197697,65213587,15890,-1,0,,0,0.00000000000000000000
chr3,65189212,65199600,10388,-1,0,,0,0.00000000000000000000
chr3,65920123,65920552,429,-1,0,9223,1,233.10023310023300000000
chr3,65988676,65992781,4105,-1,0,9223,1,24.36053593179050000000
chr3,66054571,66055517,946,-1,0,,0,0.00000000000000000000
chr3,66049243,66049558,315,-1,0,,0,0.00000000000000000000
chr3,66550402,66551731,1329,-1,0,26018,1,75.24454477050410000000
chr3,66763122,66763485,363,-1,0,,0,0.00000000000000000000
chr3,66972425,66977892,5467,-1,0,,0,0.00000000000000000000
chr3,67247637,67255121,7484,-1,0,,0,0.00000000000000000000
chr3,67492457,67496852,4395,-1,0,8801,1,22.75312855517630000000
chr3,67971150,67972836,1686,-1,0,,0,0.00000000000000000000
chr3,67562039,67563622,1583,-1,0,8801,1,63.17119393556540000000
chr3,67571964,67573350,1386,-1,0,8801,1,72.15007215007210000000
chr3,68630354,68641600,11246,-1,0,,0,0.00000000000000000000
chr3,68634740,68640255,5515,-1,0,,0,0.00000000000000000000
chr3,68636439,68639497,3058,-1,0,,0,0.00000000000000000000
chr3,68720207,68747410,27203,-1,0,,0,0.00000000000000000000
chr3,68735924,68748259,12335,-1,0,,0,0.00000000000000000000
chr3,68739564,68747893,8329,-1,0,,0,0.00000000000000000000
chr3,68892454,68904005,11551,-1,0,151647,1,8.65725911176522000000
chr3,68870376,68870891,515,-1,0,151647,1,194.17475728155300000000
chr3,68890203,68890495,292,-1,0,151647,1,342.46575342465800000000
chr3,68870490,68870779,289,-1,0,151647,1,346.02076124567500000000
chr3,69179623,69181540,1917,-1,0,,0,0.00000000000000000000
chr3,69316898,69318718,1820,-1,0,23150,1,54.94505494505490000000
chr3,69416527,69416924,397,-1,0,23150,1,251.88916876574300000000
chr3,69416748,69416797,49,-1,0,23150,1,2040.81632653061000000000
chr3,70013456,70013888,432,-1,0,4286,1,231.48148148148100000000
chr3,70056977,70066029,9052,-1,0,,0,0.00000000000000000000
chr3,70414994,70415561,567,-1,0,,0,0.00000000000000000000
chr3,70415105,70415440,335,-1,0,,0,0.00000000000000000000
chr3,70943314,70943649,335,-1,0,,0,0.00000000000000000000
chr3,71242340,71242651,311,-1,0,27086,1,321.54340836012900000000
chr3,71802370,71804102,1732,-1,0,317649;2850,2,115.47344110854500000000
chr3,71803265,71804456,1191,-1,0,317649;2850,2,167.92611251049500000000
chr3,72000673,72002837,2164,-1,0,,0,0.00000000000000000000
chr3,72379688,72380053,365,-1,0,,0,0.00000000000000000000
chr3,72738494,72739579,1085,-1,0,,0,0.00000000000000000000
chr3,72780289,72786795,6506,-1,0,,0,0.00000000000000000000
chr3,72875138,72878653,3515,-1,0,55164,1,28.44950213371270000000
chr3,73063076,73063554,478,-1,0,151987,1,209.20502092050200000000
chr3,73672992,73674813,1821,-1,0,23024,1,54.91488193300380000000
chr3,73939036,73939384,348,-1,0,,0,0.00000000000000000000
chr3,74147588,74154795,7207,-1,0,,0,0.00000000000000000000
chr3,74565354,74566006,652,-1,0,5067,1,153.37423312883400000000
chr3,74685623,74685968,345,-1,0,,0,0.00000000000000000000
chr3,74765302,74765851,549,-1,0,,0,0.00000000000000000000
chr3,74765411,74765735,324,-1,0,,0,0.00000000000000000000
chr3,74789649,74790164,515,-1,0,,0,0.00000000000000000000
chr3,74789875,74789950,75,-1,0,,0,0.00000000000000000000
chr3,74807806,74812949,5143,-1,0,,0,0.00000000000000000000
chr3,75077906,75085966,8060,-1,0,,0,0.00000000000000000000
chr3,75105268,75111212,5944,-1,0,,0,0.00000000000000000000
chr3,75415684,75679604,263920,-1,0,,0,0.00000000000000000000
chr3,75422907,75644624,221717,-1,0,,0,0.00000000000000000000
chr3,75427544,75549317,121773,-1,0,,0,0.00000000000000000000
chr3,75490834,75615755,124921,-1,0,,0,0.00000000000000000000
chr3,75534053,75641744,107691,-1,0,,0,0.00000000000000000000
chr3,75436814,75502284,65470,-1,0,,0,0.00000000000000000000
chr3,75473518,75543339,69821,-1,0,,0,0.00000000000000000000
chr3,75574893,75626142,51249,-1,0,,0,0.00000000000000000000
chr3,75531990,75569185,37195,-1,0,,0,0.00000000000000000000
chr3,75423973,75459841,35868,-1,0,,0,0.00000000000000000000
chr3,75563591,75593907,30316,-1,0,,0,0.00000000000000000000
chr3,75768369,75786276,17907,-1,0,100131827,1,5.58440833193723000000
chr3,76081311,76096601,15290,-1,0,6092,1,6.54022236756050000000
chr3,77825634,77845472,19838,-1,0,,0,0.00000000000000000000
chr3,75597940,75615947,18007,-1,0,,0,0.00000000000000000000
chr3,75983325,75998997,15672,-1,0,6092,1,6.38080653394589000000
chr3,75567345,75581692,14347,-1,0,,0,0.00000000000000000000
chr3,76171321,76185558,14237,-1,0,6092,1,7.02395167521247000000
chr3,75779816,75792974,13158,-1,0,100131827,1,7.59993920048640000000
chr3,77338375,77345654,7279,-1,0,6092,1,13.73815084489630000000
chr3,75512273,75517857,5584,-1,0,,0,0.00000000000000000000
chr3,76477245,76482589,5344,-1,0,6092,1,18.71257485029940000000
chr3,76190049,76192821,2772,-1,0,6092,1,36.07503607503610000000
chr3,77809740,77813849,4109,-1,0,,0,0.00000000000000000000
chr3,78059853,78063745,3892,-1,0,,0,0.00000000000000000000
chr3,76722063,76725470,3407,-1,0,6092,1,29.35133548576460000000
chr3,76730578,76733882,3304,-1,0,6092,1,30.26634382566590000000
chr3,75301535,75304409,2874,-1,0,,0,0.00000000000000000000
chr3,77339293,77341278,1985,-1,0,6092,1,50.37783375314860000000
chr3,75276797,75278989,2192,-1,0,,0,0.00000000000000000000
chr3,75786931,75788327,1396,-1,0,100131827,1,71.63323782234960000000
chr3,77005505,77006864,1359,-1,0,6092,1,73.58351729212660000000
chr3,77909068,77910243,1175,-1,0,,0,0.00000000000000000000
chr3,77342693,77343629,936,-1,0,6092,1,106.83760683760700000000
chr3,77449896,77450896,1000,-1,0,6092,1,100.00000000000000000000
chr3,76062800,76063543,743,-1,0,6092,1,134.58950201884300000000
chr3,75773935,75774558,623,-1,0,,0,0.00000000000000000000
chr3,75790582,75791233,651,-1,0,100131827,1,153.60983102918600000000
chr3,75433682,75434446,764,-1,0,,0,0.00000000000000000000
chr3,76198475,76199108,633,-1,0,6092,1,157.97788309636600000000
chr3,76779537,76780094,557,-1,0,6092,1,179.53321364452400000000
chr3,75767098,75767571,473,-1,0,,0,0.00000000000000000000
chr3,75787197,75787759,562,-1,0,100131827,1,177.93594306049800000000
chr3,75761379,75761807,428,-1,0,,0,0.00000000000000000000
chr3,76488350,76488656,306,-1,0,6092,1,326.79738562091500000000
chr3,76063459,76063894,435,-1,0,6092,1,229.88505747126400000000
chr3,75620268,75620561,293,-1,0,,0,0.00000000000000000000
chr3,75827736,75828078,342,-1,0,100131827,1,292.39766081871300000000
chr3,75778000,75778285,285,-1,0,,0,0.00000000000000000000
chr3,76246304,76246570,266,-1,0,6092,1,375.93984962406000000000
chr3,76017909,76018110,201,-1,0,6092,1,497.51243781094500000000
chr3,76063309,76063566,257,-1,0,6092,1,389.10505836575900000000
chr3,76199228,76199450,222,-1,0,6092,1,450.45045045045000000000
chr3,75620319,75620504,185,-1,0,,0,0.00000000000000000000
chr3,76198693,76198828,135,-1,0,6092,1,740.74074074074100000000
chr3,75774142,75774292,150,-1,0,,0,0.00000000000000000000
chr3,75738951,75739077,126,-1,0,,0,0.00000000000000000000
chr3,75711070,75711207,137,-1,0,,0,0.00000000000000000000
chr3,78342661,78343174,513,-1,0,,0,0.00000000000000000000
chr3,78371293,78372065,772,-1,0,,0,0.00000000000000000000
chr3,78589771,78591653,1882,-1,0,,0,0.00000000000000000000
chr3,78587895,78589348,1453,-1,0,,0,0.00000000000000000000
chr3,78779205,78779955,750,-1,0,6091,1,133.33333333333300000000
chr3,78779417,78779718,301,-1,0,6091,1,332.22591362126200000000
chr3,78807409,78809634,2225,-1,0,6091,1,44.94382022471910000000
chr3,78891424,78891629,205,-1,0,6091,1,487.80487804878000000000
chr3,79809660,79810143,483,-1,0,6091,1,207.03933747412000000000
chr3,79897828,79898218,390,-1,0,,0,0.00000000000000000000
chr3,79960813,79961247,434,-1,0,,0,0.00000000000000000000
chr3,80061334,80064684,3350,-1,0,,0,0.00000000000000000000
chr3,80062838,80064113,1275,-1,0,,0,0.00000000000000000000
chr3,80062813,80063646,833,-1,0,,0,0.00000000000000000000
chr3,80188846,80189433,587,-1,0,,0,0.00000000000000000000
chr3,80402025,80405847,3822,-1,0,,0,0.00000000000000000000
chr3,80361313,80362805,1492,-1,0,,0,0.00000000000000000000
chr3,80516083,80588381,72298,-1,0,,0,0.00000000000000000000
chr3,80657222,80657716,494,-1,0,,0,0.00000000000000000000
chr3,80657433,80657565,132,-1,0,,0,0.00000000000000000000
chr3,80819371,80819856,485,-1,0,,0,0.00000000000000000000
chr3,80819647,80819770,123,-1,0,,0,0.00000000000000000000
chr3,80925001,80927081,2080,-1,0,,0,0.00000000000000000000
chr3,80925294,80926625,1331,-1,0,,0,0.00000000000000000000
chr3,80934314,80936704,2390,-1,0,,0,0.00000000000000000000
chr3,81196496,81202948,6452,-1,0,,0,0.00000000000000000000
chr3,81222950,81223935,985,-1,0,,0,0.00000000000000000000
chr3,81346063,81346411,348,-1,0,,0,0.00000000000000000000
chr3,81554535,81561550,7015,-1,0,2632,1,14.25516749821810000000
chr3,81595502,81599814,4312,-1,0,2632,1,23.19109461966600000000
chr3,81779642,81781100,1458,-1,0,2632,1,68.58710562414270000000
chr3,82091432,82510371,418939,-1,0,,0,0.00000000000000000000
chr3,82914990,83053072,138082,-1,0,,0,0.00000000000000000000
chr3,82711996,82772709,60713,-1,0,,0,0.00000000000000000000
chr3,82867966,82873131,5165,-1,0,,0,0.00000000000000000000
chr3,82314439,82320304,5865,-1,0,,0,0.00000000000000000000
chr3,82868826,82872893,4067,-1,0,,0,0.00000000000000000000
chr3,82020431,82023992,3561,-1,0,,0,0.00000000000000000000
chr3,83339283,83342728,3445,-1,0,,0,0.00000000000000000000
chr3,83017232,83020225,2993,-1,0,,0,0.00000000000000000000
chr3,82909146,82911293,2147,-1,0,,0,0.00000000000000000000
chr3,82203280,82204105,825,-1,0,,0,0.00000000000000000000
chr3,82936529,82937126,597,-1,0,,0,0.00000000000000000000
chr3,81907408,81907950,542,-1,0,,0,0.00000000000000000000
chr3,82203347,82203975,628,-1,0,,0,0.00000000000000000000
chr3,82691159,82691692,533,-1,0,,0,0.00000000000000000000
chr3,83096021,83096377,356,-1,0,,0,0.00000000000000000000
chr3,82823753,82824144,391,-1,0,,0,0.00000000000000000000
chr3,82957298,82957625,327,-1,0,,0,0.00000000000000000000
chr3,81907494,81907819,325,-1,0,,0,0.00000000000000000000
chr3,82936658,82936968,310,-1,0,,0,0.00000000000000000000
chr3,82691337,82691530,193,-1,0,,0,0.00000000000000000000
chr3,83859883,83863635,3752,-1,0,,0,0.00000000000000000000
chr3,83852751,83855510,2759,-1,0,,0,0.00000000000000000000
chr3,84104927,84107397,2470,-1,0,,0,0.00000000000000000000
chr3,84087888,84091215,3327,-1,0,,0,0.00000000000000000000
chr3,84105645,84107542,1897,-1,0,,0,0.00000000000000000000
chr3,84106021,84107176,1155,-1,0,,0,0.00000000000000000000
chr3,83828061,83828473,412,-1,0,,0,0.00000000000000000000
chr3,83828245,83828294,49,-1,0,,0,0.00000000000000000000
chr3,84686032,84707156,21124,-1,0,,0,0.00000000000000000000
chr3,84690237,84703274,13037,-1,0,,0,0.00000000000000000000
chr3,84696539,84701980,5441,-1,0,,0,0.00000000000000000000
chr3,84699496,84702928,3432,-1,0,,0,0.00000000000000000000
chr3,84700334,84701975,1641,-1,0,,0,0.00000000000000000000
chr3,84849428,84876137,26709,-1,0,,0,0.00000000000000000000
chr3,84866529,84871905,5376,-1,0,,0,0.00000000000000000000
chr3,84957891,84958389,498,-1,0,,0,0.00000000000000000000
chr3,84958094,84958221,127,-1,0,,0,0.00000000000000000000
chr3,85188778,85298728,109950,-1,0,253559,1,0.90950432014552100000
chr3,85211741,85213316,1575,-1,0,253559,1,63.49206349206350000000
chr3,85519498,85646279,126781,-1,0,253559,1,0.78876172297110800000
chr3,85433882,85514049,80167,-1,0,253559,1,1.24739606072324000000
chr3,85581604,85616680,35076,-1,0,253559,1,2.85095221804083000000
chr3,85882196,85925871,43675,-1,0,253559,1,2.28963938179737000000
chr3,85878532,85884978,6446,-1,0,253559,1,15.51349674216570000000
chr3,86213402,86213720,318,-1,0,,0,0.00000000000000000000
chr3,86335932,86336361,429,-1,0,,0,0.00000000000000000000
chr3,86459338,86460009,671,-1,0,,0,0.00000000000000000000
chr3,86466093,86467260,1167,-1,0,,0,0.00000000000000000000
chr3,86622743,86624122,1379,-1,0,,0,0.00000000000000000000
chr3,86848231,86855304,7073,-1,0,,0,0.00000000000000000000
chr3,87447650,87456541,8891,-1,0,,0,0.00000000000000000000
chr3,87425085,87429094,4009,-1,0,,0,0.00000000000000000000
chr3,87458140,87460263,2123,-1,0,,0,0.00000000000000000000
chr3,87305552,87306640,1088,-1,0,,0,0.00000000000000000000
chr3,87446344,87446965,621,-1,0,,0,0.00000000000000000000
chr3,87446615,87446782,167,-1,0,,0,0.00000000000000000000
chr3,87656778,87665307,8529,-1,0,,0,0.00000000000000000000
chr3,87701740,87703223,1483,-1,0,,0,0.00000000000000000000
chr3,87852610,87948537,95927,-1,0,3355,1,1.04245937014605000000
chr3,87953137,88008072,54935,-1,0,3355,1,1.82033312096114000000
chr3,87931859,87951724,19865,-1,0,3355,1,5.03397936068462000000
chr3,87889120,87903281,14161,-1,0,3355,1,7.06164818868724000000
chr3,87915692,87916772,1080,-1,0,3355,1,92.59259259259260000000
chr3,88468175,88480102,11927,-1,0,,0,0.00000000000000000000
chr3,88457303,88465503,8200,-1,0,,0,0.00000000000000000000
chr3,88453611,88454157,546,-1,0,,0,0.00000000000000000000
chr3,88484868,88485271,403,-1,0,,0,0.00000000000000000000
chr3,88453730,88454008,278,-1,0,,0,0.00000000000000000000
chr3,88547070,88547681,611,-1,0,,0,0.00000000000000000000
chr3,88705738,88715652,9914,-1,0,,0,0.00000000000000000000
chr3,88894354,88894786,432,-1,0,,0,0.00000000000000000000
chr3,89066929,89076137,9208,-1,0,,0,0.00000000000000000000
chr3,89260717,89261124,407,-1,0,2042,1,245.70024570024600000000
chr3,89393295,89418805,25510,-1,0,2042,1,3.92003136025088000000
chr3,89402304,89421266,18962,-1,0,2042,1,5.27370530534754000000
chr3,89405480,89416582,11102,-1,0,2042,1,9.00738605656638000000
chr3,89509668,89515857,6189,-1,0,2042,1,16.15769914364190000000
chr3,89531427,89547142,15715,-1,0,,0,0.00000000000000000000
chr3,89670009,89678159,8150,-1,0,,0,0.00000000000000000000
chr3,89671652,89674140,2488,-1,0,,0,0.00000000000000000000
chr3,89887243,89892177,4934,-1,0,,0,0.00000000000000000000
chr3,90235085,90237206,2121,-1,0,,0,0.00000000000000000000
chr3,90325052,90504046,178994,-1,0,,0,0.00000000000000000000
chr3,90321881,90399182,77301,-1,0,,0,0.00000000000000000000
chr3,90425537,90444697,19160,-1,0,,0,0.00000000000000000000
chr3,90462642,90476906,14264,-1,0,,0,0.00000000000000000000
chr3,90403897,90409682,5785,-1,0,,0,0.00000000000000000000
chr3,90438615,90440847,2232,-1,0,,0,0.00000000000000000000
chr3,90464913,90467198,2285,-1,0,,0,0.00000000000000000000
chr3,93633013,93635025,2012,-1,0,5627,1,49.70178926441350000000
chr3,93802310,93805448,3138,-1,0,63899,1,31.86743148502230000000
chr3,93954873,93958519,3646,-1,0,,0,0.00000000000000000000
chr3,94301549,94304347,2798,-1,0,,0,0.00000000000000000000
chr3,94395081,94409928,14847,-1,0,,0,0.00000000000000000000
chr3,94918816,94919289,473,-1,0,,0,0.00000000000000000000
chr3,94989315,94991142,1827,-1,0,,0,0.00000000000000000000
chr3,95116113,95116636,523,-1,0,,0,0.00000000000000000000
chr3,95116200,95116515,315,-1,0,,0,0.00000000000000000000
chr3,95146890,95149585,2695,-1,0,,0,0.00000000000000000000
chr3,95386737,95386807,70,-1,0,,0,0.00000000000000000000
chr3,95454399,95479300,24901,-1,0,,0,0.00000000000000000000
chr3,95465701,95470794,5093,-1,0,,0,0.00000000000000000000
chr3,95466169,95468174,2005,-1,0,,0,0.00000000000000000000
chr3,95582778,95587090,4312,-1,0,,0,0.00000000000000000000
chr3,95696504,95713496,16992,-1,0,,0,0.00000000000000000000
chr3,95723780,95724069,289,-1,0,,0,0.00000000000000000000
chr3,96050634,96051857,1223,-1,0,,0,0.00000000000000000000
chr3,96285128,96326000,40872,-1,0,,0,0.00000000000000000000
chr3,96307516,96327221,19705,-1,0,,0,0.00000000000000000000
chr3,96496236,96497087,851,-1,0,,0,0.00000000000000000000
chr3,96532044,96533939,1895,-1,0,285220,1,52.77044854881270000000
chr3,96875611,96882000,6389,-1,0,285220,1,15.65190170605730000000
chr3,97032045,97044456,12411,-1,0,285220,1,8.05736846345983000000
chr3,97220066,97221689,1623,-1,0,285220,1,61.61429451632780000000
chr3,97434994,97435542,548,-1,0,285220,1,182.48175182481800000000
chr3,97878295,97923426,45131,-1,0,403274,1,2.21577186412887000000
chr3,97858636,97899505,40869,-1,0,403274;403273,2,4.89368469989479000000
chr3,97887492,97919334,31842,-1,0,403274,1,3.14050624960744000000
chr3,97908945,97916951,8006,-1,0,,0,0.00000000000000000000
chr3,98111594,98123901,12307,-1,0,,0,0.00000000000000000000
chr3,98410652,98414800,4148,-1,0,,0,0.00000000000000000000
chr3,98394406,98395348,942,-1,0,,0,0.00000000000000000000
chr3,98758506,98809200,50694,-1,0,,0,0.00000000000000000000
chr3,98896884,98904347,7463,-1,0,,0,0.00000000000000000000
chr3,98898959,98902574,3615,-1,0,,0,0.00000000000000000000
chr3,98899609,98901303,1694,-1,0,,0,0.00000000000000000000
chr3,98936926,98964080,27154,-1,0,,0,0.00000000000000000000
chr3,98928968,98949480,20512,-1,0,,0,0.00000000000000000000
chr3,98936939,98950997,14058,-1,0,,0,0.00000000000000000000
chr3,98942848,98949474,6626,-1,0,,0,0.00000000000000000000
chr3,98943674,98948671,4997,-1,0,,0,0.00000000000000000000
chr3,98946780,98948830,2050,-1,0,,0,0.00000000000000000000
chr3,98982431,98982504,73,-1,0,,0,0.00000000000000000000
chr3,99037342,99037885,543,-1,0,,0,0.00000000000000000000
chr3,99037445,99037758,313,-1,0,,0,0.00000000000000000000
chr3,99046719,99056110,9391,-1,0,,0,0.00000000000000000000
chr3,99065553,99069481,3928,-1,0,,0,0.00000000000000000000
chr3,99165486,99166319,833,-1,0,,0,0.00000000000000000000
chr3,99243102,99244978,1876,-1,0,,0,0.00000000000000000000
chr3,99393368,99395775,2407,-1,0,1295,1,41.54549231408390000000
chr3,99604858,99605403,545,-1,0,84319;11259,2,366.97247706422000000000
chr3,99628781,99629630,849,-1,0,84319;11259,2,235.57126030624300000000
chr3,99689245,99904043,214798,-1,0,84319;11259,2,0.93110736599037200000
chr3,99698776,99700911,2135,-1,0,84319;11259,2,93.67681498829040000000
chr3,99785349,99785656,307,-1,0,84319;11259,2,651.46579804560300000000
chr3,99922682,99924935,2253,-1,0,,0,0.00000000000000000000
chr3,100306729,100307107,378,-1,0,,0,0.00000000000000000000
chr3,100521582,100522479,897,-1,0,25890,1,111.48272017837200000000
chr3,100521588,100522127,539,-1,0,25890,1,185.52875695732800000000
chr3,100669470,100673147,3677,-1,0,25890,1,27.19608376393800000000
chr3,100669246,100670868,1622,-1,0,25890,1,61.65228113440200000000
chr3,101188366,101188692,326,-1,0,57337,1,306.74846625766900000000
chr3,101209968,101210533,565,-1,0,57337,1,176.99115044247800000000
chr3,101210127,101210311,184,-1,0,57337,1,543.47826086956500000000
chr3,101210125,101210208,83,-1,0,57337,1,1204.81927710843000000000
chr3,101251459,101253989,2530,-1,0,,0,0.00000000000000000000
chr3,101357606,101359741,2135,-1,0,,0,0.00000000000000000000
chr3,101482575,101482942,367,-1,0,79598,1,272.47956403269800000000
chr3,101493557,101495018,1461,-1,0,,0,0.00000000000000000000
chr3,101521216,101521774,558,-1,0,91775,1,179.21146953405000000000
chr3,101696783,101705266,8483,-1,0,,0,0.00000000000000000000
chr3,101699464,101704710,5246,-1,0,,0,0.00000000000000000000
chr3,102087584,102101026,13442,-1,0,,0,0.00000000000000000000
chr3,102283754,102284159,405,-1,0,,0,0.00000000000000000000
chr3,102527268,102527585,317,-1,0,,0,0.00000000000000000000
chr3,102595402,102595830,428,-1,0,,0,0.00000000000000000000
chr3,102807614,102810503,2889,-1,0,,0,0.00000000000000000000
chr3,102810322,102810723,401,-1,0,,0,0.00000000000000000000
chr3,103078920,103097021,18101,-1,0,,0,0.00000000000000000000
chr3,103073947,103087475,13528,-1,0,,0,0.00000000000000000000
chr3,103181880,103183056,1176,-1,0,,0,0.00000000000000000000
chr3,103265501,103266994,1493,-1,0,,0,0.00000000000000000000
chr3,103431681,103431780,99,-1,0,,0,0.00000000000000000000
chr3,103547911,103548231,320,-1,0,,0,0.00000000000000000000
chr3,103593821,103603269,9448,-1,0,,0,0.00000000000000000000
chr3,104230376,104443668,213292,-1,0,,0,0.00000000000000000000
chr3,104083040,104268543,185503,-1,0,,0,0.00000000000000000000
chr3,104025323,104083784,58461,-1,0,,0,0.00000000000000000000
chr3,104291964,104300462,8498,-1,0,,0,0.00000000000000000000
chr3,104276729,104280549,3820,-1,0,,0,0.00000000000000000000
chr3,104226823,104230388,3565,-1,0,,0,0.00000000000000000000
chr3,104664966,104667893,2927,-1,0,,0,0.00000000000000000000
chr3,103922929,103925292,2363,-1,0,,0,0.00000000000000000000
chr3,104505294,104507398,2104,-1,0,,0,0.00000000000000000000
chr3,104034264,104036059,1795,-1,0,,0,0.00000000000000000000
chr3,104400124,104401614,1490,-1,0,,0,0.00000000000000000000
chr3,104278140,104279049,909,-1,0,,0,0.00000000000000000000
chr3,104416065,104416665,600,-1,0,,0,0.00000000000000000000
chr3,104278482,104279205,723,-1,0,,0,0.00000000000000000000
chr3,103870223,103870823,600,-1,0,,0,0.00000000000000000000
chr3,104645340,104645690,350,-1,0,,0,0.00000000000000000000
chr3,103974703,103974892,189,-1,0,,0,0.00000000000000000000
chr3,104645427,104645601,174,-1,0,,0,0.00000000000000000000
chr3,104416308,104416444,136,-1,0,,0,0.00000000000000000000
chr3,104416391,104416488,97,-1,0,,0,0.00000000000000000000
chr3,104987281,104989483,2202,-1,0,,0,0.00000000000000000000
chr3,104832106,104833753,1647,-1,0,,0,0.00000000000000000000
chr3,104999500,104999859,359,-1,0,,0,0.00000000000000000000
chr3,104999614,104999740,126,-1,0,,0,0.00000000000000000000
chr3,105075657,105077987,2330,-1,0,,0,0.00000000000000000000
chr3,105261373,105272448,11075,-1,0,214,1,9.02934537246050000000
chr3,105299929,105356489,56560,-1,0,,0,0.00000000000000000000
chr3,105305902,105311171,5269,-1,0,,0,0.00000000000000000000
chr3,105828850,105831633,2783,-1,0,,0,0.00000000000000000000
chr3,106242208,106246695,4487,-1,0,,0,0.00000000000000000000
chr3,106436888,106437085,197,-1,0,,0,0.00000000000000000000
chr3,106457036,106457233,197,-1,0,,0,0.00000000000000000000
chr3,106595360,106619818,24458,-1,0,,0,0.00000000000000000000
chr3,106652535,106652927,392,-1,0,,0,0.00000000000000000000
chr3,106735856,106736570,714,-1,0,,0,0.00000000000000000000
chr3,106735976,106736232,256,-1,0,,0,0.00000000000000000000
chr3,106846692,106848182,1490,-1,0,,0,0.00000000000000000000
chr3,106813607,106813817,210,-1,0,,0,0.00000000000000000000
chr3,106888990,106892674,3684,-1,0,,0,0.00000000000000000000
chr3,107037954,107040334,2380,-1,0,,0,0.00000000000000000000
chr3,107038425,107039908,1483,-1,0,,0,0.00000000000000000000
chr3,107165267,107165632,365,-1,0,,0,0.00000000000000000000
chr3,107702468,107705170,2702,-1,0,,0,0.00000000000000000000
chr3,107858470,107859317,847,-1,0,,0,0.00000000000000000000
chr3,107997419,107998041,622,-1,0,,0,0.00000000000000000000
chr3,108400590,108402197,1607,-1,0,9666,1,62.22775357809580000000
chr3,108416784,108653389,236605,-1,0,9626;84666;50852,3,1.26793601149595000000
chr3,108583608,108587230,3622,-1,0,,0,0.00000000000000000000
chr3,108630122,108632880,2758,-1,0,9626,1,36.25815808556930000000
chr3,108599213,108600067,854,-1,0,,0,0.00000000000000000000
chr3,108478342,108478484,142,-1,0,,0,0.00000000000000000000
chr3,108758627,108760827,2200,-1,0,27136,1,45.45454545454550000000
chr3,108804368,108810156,5788,-1,0,27136,1,17.27712508638560000000
chr3,108964417,108966659,2242,-1,0,,0,0.00000000000000000000
chr3,109103289,109104945,1656,-1,0,,0,0.00000000000000000000
chr3,109335279,109338034,2755,-1,0,,0,0.00000000000000000000
chr3,109414773,109416820,2047,-1,0,,0,0.00000000000000000000
chr3,109489073,109489330,257,-1,0,,0,0.00000000000000000000
chr3,109508809,109508859,50,-1,0,,0,0.00000000000000000000
chr3,109919393,109941236,21843,-1,0,,0,0.00000000000000000000
chr3,110117731,110135400,17669,-1,0,,0,0.00000000000000000000
chr3,110258831,110275802,16971,-1,0,,0,0.00000000000000000000
chr3,110494000,110496166,2166,-1,0,,0,0.00000000000000000000
chr3,110647150,110647884,734,-1,0,,0,0.00000000000000000000
chr3,110256971,110257256,285,-1,0,,0,0.00000000000000000000
chr3,110677168,110677551,383,-1,0,,0,0.00000000000000000000
chr3,110677337,110677392,55,-1,0,,0,0.00000000000000000000
chr3,110694137,110699196,5059,-1,0,,0,0.00000000000000000000
chr3,110792514,110796285,3771,-1,0,25945,1,26.51816494298590000000
chr3,110863852,110865250,1398,-1,0,25945,1,71.53075822603720000000
chr3,111243516,111249701,6185,-1,0,,0,0.00000000000000000000
chr3,111243714,111247289,3575,-1,0,,0,0.00000000000000000000
chr3,111751369,111753126,1757,-1,0,,0,0.00000000000000000000
chr3,112101741,112114552,12811,-1,0,,0,0.00000000000000000000
chr3,112743582,112752439,8857,-1,0,,0,0.00000000000000000000
chr3,112222635,112225529,2894,-1,0,,0,0.00000000000000000000
chr3,112467293,112467840,547,-1,0,,0,0.00000000000000000000
chr3,112556545,112557117,572,-1,0,344807,1,174.82517482517500000000
chr3,112467390,112467725,335,-1,0,,0,0.00000000000000000000
chr3,112704871,112705006,135,-1,0,,0,0.00000000000000000000
chr3,113030213,113032597,2384,-1,0,55779,1,41.94630872483220000000
chr3,113118268,113118406,138,-1,0,55779,1,724.63768115942000000000
chr3,113567659,113617970,50311,-1,0,54762,1,1.98763689849138000000
chr3,113666273,113667425,1152,-1,0,254887,1,86.80555555555560000000
chr3,113853989,113854367,378,-1,0,1814,1,264.55026455026500000000
chr3,114022247,114022537,290,-1,0,201633,1,344.82758620689700000000
chr3,114022360,114022489,129,-1,0,201633,1,775.19379844961200000000
chr3,114022357,114022437,80,-1,0,201633,1,1250.00000000000000000000
chr3,114024009,114026772,2763,-1,0,201633,1,36.19254433586680000000
chr3,114288592,114290981,2389,-1,0,26137,1,41.85851820845540000000
chr3,114466349,114466909,560,-1,0,26137,1,178.57142857142900000000
chr3,114466449,114466787,338,-1,0,26137,1,295.85798816568000000000
chr3,114656187,114669035,12848,-1,0,26137,1,7.78331257783313000000
chr3,114660633,114668855,8222,-1,0,26137,1,12.16249087813180000000
chr3,114832604,114833283,679,-1,0,26137,1,147.27540500736400000000
chr3,115023495,115024832,1337,-1,0,,0,0.00000000000000000000
chr3,115024068,115024770,702,-1,0,,0,0.00000000000000000000
chr3,115024234,115024576,342,-1,0,,0,0.00000000000000000000
chr3,115079613,115079691,78,-1,0,,0,0.00000000000000000000
chr3,115247967,115249840,1873,-1,0,,0,0.00000000000000000000
chr3,115354585,115356628,2043,-1,0,2596,1,48.94762604013710000000
chr3,115887252,115902225,14973,-1,0,4045,1,6.67868830561678000000
chr3,116098200,116110060,11860,-1,0,4045,1,8.43170320404722000000
chr3,116204436,116218316,13880,-1,0,,0,0.00000000000000000000
chr3,116204835,116205179,344,-1,0,,0,0.00000000000000000000
chr3,116275204,116275701,497,-1,0,,0,0.00000000000000000000
chr3,116275265,116275595,330,-1,0,,0,0.00000000000000000000
chr3,116653049,116789708,136659,-1,0,,0,0.00000000000000000000
chr3,116523378,116526793,3415,-1,0,,0,0.00000000000000000000
chr3,117534762,117536747,1985,-1,0,,0,0.00000000000000000000
chr3,117770261,117776186,5925,-1,0,,0,0.00000000000000000000
chr3,118281499,118281959,460,-1,0,,0,0.00000000000000000000
chr3,118281606,118281828,222,-1,0,,0,0.00000000000000000000
chr3,118307648,118307698,50,-1,0,,0,0.00000000000000000000
chr3,118914824,118914882,58,-1,0,7348,1,1724.13793103448000000000
chr3,119350552,119354103,3551,-1,0,,0,0.00000000000000000000
chr3,119351563,119354017,2454,-1,0,,0,0.00000000000000000000
chr3,119350333,119352713,2380,-1,0,,0,0.00000000000000000000
chr3,119368552,119412807,44255,-1,0,64091;10063,2,4.51926336007231000000
chr3,119419834,119420548,714,-1,0,,0,0.00000000000000000000
chr3,119419889,119420337,448,-1,0,,0,0.00000000000000000000
chr3,119655175,119656860,1685,-1,0,2932,1,59.34718100890210000000
chr3,119893012,119895289,2277,-1,0,165829,1,43.91743522178310000000
chr3,119893983,119894448,465,-1,0,165829,1,215.05376344086000000000
chr3,120161653,120164950,3297,-1,0,11167,1,30.33060357901120000000
chr3,121256617,121258277,1660,-1,0,10721,1,60.24096385542170000000
chr3,121272644,121273451,807,-1,0,,0,0.00000000000000000000
chr3,121821716,121821779,63,-1,0,942,1,1587.30158730159000000000
chr3,121959608,121963683,4075,-1,0,846,1,24.53987730061350000000
chr3,122082124,122082741,617,-1,0,131076,1,162.07455429497600000000
chr3,122138415,122138833,418,-1,0,,0,0.00000000000000000000
chr3,122239347,122239493,146,-1,0,,0,0.00000000000000000000
chr3,123166813,123168934,2121,-1,0,111,1,47.14757190004710000000
chr3,123197357,123198140,783,-1,0,,0,0.00000000000000000000
chr3,123197425,123198044,619,-1,0,,0,0.00000000000000000000
chr3,123197682,123197970,288,-1,0,,0,0.00000000000000000000
chr3,123236655,123237173,518,-1,0,201562,1,193.05019305019300000000
chr3,123236761,123237086,325,-1,0,201562,1,307.69230769230800000000
chr3,123315416,123316931,1515,-1,0,,0,0.00000000000000000000
chr3,123608919,123610963,2044,-1,0,,0,0.00000000000000000000
chr3,123678494,123678808,314,-1,0,64770,1,318.47133757961800000000
chr3,124507505,124509676,2171,-1,0,3693,1,46.06172270842930000000
chr3,123969626,123971227,1601,-1,0,8997,1,62.46096189881320000000
chr3,124605142,124606275,1133,-1,0,3693,1,88.26125330979700000000
chr3,124889659,124891117,1458,-1,0,84561,1,68.58710562414270000000
chr3,124890041,124890933,892,-1,0,84561,1,112.10762331838600000000
chr3,124901601,124903138,1537,-1,0,84561,1,65.06180871828240000000
chr3,124931492,124937172,5680,-1,0,84561,1,17.60563380281690000000
chr3,124936042,124937489,1447,-1,0,,0,0.00000000000000000000
chr3,124936313,124937199,886,-1,0,,0,0.00000000000000000000
chr3,125062290,125062373,83,-1,0,7707,1,1204.81927710843000000000
chr3,125398966,125399876,910,-1,0,,0,0.00000000000000000000
chr3,125409667,125412467,2800,-1,0,,0,0.00000000000000000000
chr3,125445641,125509095,63454,-1,0,,0,0.00000000000000000000
chr3,125444862,125467504,22642,-1,0,,0,0.00000000000000000000
chr3,125563042,125567719,4677,-1,0,,0,0.00000000000000000000
chr3,125607907,125608110,203,-1,0,,0,0.00000000000000000000
chr3,125671498,125677695,6197,-1,0,,0,0.00000000000000000000
chr3,125672669,125677466,4797,-1,0,,0,0.00000000000000000000
chr3,125672705,125675685,2980,-1,0,,0,0.00000000000000000000
chr3,125676940,125679620,2680,-1,0,,0,0.00000000000000000000
chr3,125706521,125722241,15720,-1,0,,0,0.00000000000000000000
chr3,125712247,125722162,9915,-1,0,,0,0.00000000000000000000
chr3,125864166,125865682,1516,-1,0,10840,1,65.96306068601580000000
chr3,126015667,126058240,42573,-1,0,,0,0.00000000000000000000
chr3,126089968,126090046,78,-1,0,,0,0.00000000000000000000
chr3,126194101,126196104,2003,-1,0,79364,1,49.92511233150280000000
chr3,126253692,126254257,565,-1,0,166012,1,176.99115044247800000000
chr3,126358833,126359397,564,-1,0,114112,1,177.30496453900700000000
chr3,126358930,126359263,333,-1,0,114112,1,300.30030030030000000000
chr3,126521273,126523327,2054,-1,0,84303,1,48.68549172346640000000
chr3,126577950,126584520,6570,-1,0,84303,1,15.22070015220700000000
chr3,126580360,126584468,4108,-1,0,84303,1,24.34274586173320000000
chr3,126668343,126668563,220,-1,0,84303,1,454.54545454545500000000
chr3,126668324,126668436,112,-1,0,84303,1,892.85714285714300000000
chr3,126872959,126874677,1718,-1,0,,0,0.00000000000000000000
chr3,127347693,127348493,800,-1,0,50512,1,125.00000000000000000000
chr3,127404675,127407151,2476,-1,0,,0,0.00000000000000000000
chr3,127527876,127529209,1333,-1,0,11343,1,75.01875468867220000000
chr3,127529636,127530127,491,-1,0,11343,1,203.66598778004100000000
chr3,128172826,128173421,595,-1,0,,0,0.00000000000000000000
chr3,128172917,128173283,366,-1,0,,0,0.00000000000000000000
chr3,128173061,128173159,98,-1,0,,0,0.00000000000000000000
chr3,128270038,128271150,1112,-1,0,,0,0.00000000000000000000
chr3,128314260,128315068,808,-1,0,,0,0.00000000000000000000
chr3,128378977,128404000,25023,-1,0,,0,0.00000000000000000000
chr3,128389934,128403385,13451,-1,0,,0,0.00000000000000000000
chr3,128404051,128413792,9741,-1,0,,0,0.00000000000000000000
chr3,128410572,128415490,4918,-1,0,,0,0.00000000000000000000
chr3,128430298,128432791,2493,-1,0,,0,0.00000000000000000000
chr3,128434860,128435820,960,-1,0,,0,0.00000000000000000000
chr3,128465575,128466801,1226,-1,0,7879,1,81.56606851549760000000
chr3,128672145,128675327,3182,-1,0,,0,0.00000000000000000000
chr3,129046129,129047376,1247,-1,0,,0,0.00000000000000000000
chr3,129048130,129048751,621,-1,0,,0,0.00000000000000000000
chr3,129101434,129208209,106775,-1,0,8930;90288;55764,3,2.80964645282135000000
chr3,129075906,129084228,8322,-1,0,,0,0.00000000000000000000
chr3,129076102,129080099,3997,-1,0,,0,0.00000000000000000000
chr3,129184412,129184846,434,-1,0,55764,1,230.41474654377900000000
chr3,129113414,129113545,131,-1,0,,0,0.00000000000000000000
chr3,129234674,129236224,1550,-1,0,55764,1,64.51612903225810000000
chr3,129537054,129537694,640,-1,0,23023,1,156.25000000000000000000
chr3,129537350,129537525,175,-1,0,23023,1,571.42857142857100000000
chr3,129537245,129537394,149,-1,0,23023,1,671.14093959731500000000
chr3,129633049,129634943,1894,-1,0,,0,0.00000000000000000000
chr3,129657336,129657868,532,-1,0,,0,0.00000000000000000000
chr3,129757527,129883750,126223,-1,0,644974,1,0.79224863931296200000
chr3,129814661,129915740,101079,-1,0,644974,1,0.98932518129384000000
chr3,129763133,129806834,43701,-1,0,644974,1,2.28827715612915000000
chr3,129763196,129799674,36478,-1,0,,0,0.00000000000000000000
chr3,129776880,129806487,29607,-1,0,644974,1,3.37757962643969000000
chr3,129773062,129795005,21943,-1,0,,0,0.00000000000000000000
chr3,129786966,129801106,14140,-1,0,644974,1,7.07213578500707000000
chr3,129785186,129797677,12491,-1,0,,0,0.00000000000000000000
chr3,129774131,129780956,6825,-1,0,,0,0.00000000000000000000
chr3,130131693,130132883,1190,-1,0,256076,1,84.03361344537820000000
chr3,130132025,130132923,898,-1,0,256076,1,111.35857461024500000000
chr3,130176203,130253538,77335,-1,0,256076,1,1.29307558026767000000
chr3,130208595,130218391,9796,-1,0,,0,0.00000000000000000000
chr3,130218309,130218445,136,-1,0,,0,0.00000000000000000000
chr3,130347209,130353549,6340,-1,0,131873,1,15.77287066246060000000
chr3,131097961,131098085,124,-1,0,,0,0.00000000000000000000
chr3,131308042,131313484,5442,-1,0,131034,1,18.37559720690920000000
chr3,131315060,131315622,562,-1,0,131034,1,177.93594306049800000000
chr3,131354536,131355055,519,-1,0,131034,1,192.67822736030800000000
chr3,131354661,131354937,276,-1,0,131034,1,362.31884057971000000000
chr3,131460339,131501067,40728,-1,0,131034,1,2.45531329797682000000
chr3,131514959,131522768,7809,-1,0,131034,1,12.80573697016260000000
chr3,131546139,131547022,883,-1,0,131034,1,113.25028312570800000000
chr3,131677714,131678146,432,-1,0,131034,1,231.48148148148100000000
chr3,131677798,131678119,321,-1,0,131034,1,311.52647975077900000000
chr3,131700955,131713150,12195,-1,0,131034,1,8.20008200082001000000
chr3,131708226,131713652,5426,-1,0,131034,1,18.42978252856620000000
chr3,131711518,131713326,1808,-1,0,131034,1,55.30973451327430000000
chr3,131988304,131995777,7473,-1,0,,0,0.00000000000000000000
chr3,131989569,131993370,3801,-1,0,,0,0.00000000000000000000
chr3,131992773,131995684,2911,-1,0,,0,0.00000000000000000000
chr3,131947969,131950678,2709,-1,0,,0,0.00000000000000000000
chr3,132271961,132280455,8494,-1,0,84129,1,11.77301624676240000000
chr3,132330403,132332881,2478,-1,0,84129,1,40.35512510088780000000
chr3,132597609,132598731,1122,-1,0,,0,0.00000000000000000000
chr3,132654462,132654514,52,-1,0,,0,0.00000000000000000000
chr3,132718624,132723953,5329,-1,0,,0,0.00000000000000000000
chr3,132805126,132807172,2046,-1,0,66000,1,48.87585532746820000000
chr3,133015970,133027497,11527,-1,0,66000,1,8.67528411555478000000
chr3,133132655,133137012,4357,-1,0,8419,1,22.95157218269450000000
chr3,133133071,133135439,2368,-1,0,8419,1,42.22972972972970000000
chr3,133133133,133134124,991,-1,0,8419,1,100.90817356205900000000
chr3,133134064,133134541,477,-1,0,8419,1,209.64360587002100000000
chr3,133235081,133235481,400,-1,0,,0,0.00000000000000000000
chr3,133322443,133324414,1971,-1,0,11073,1,50.73566717402330000000
chr3,133503764,133505083,1319,-1,0,58477,1,75.81501137225170000000
chr3,133686442,133687004,562,-1,0,6578,1,177.93594306049800000000
chr3,133849740,133849827,87,-1,0,,0,0.00000000000000000000
chr3,134294185,134294445,260,-1,0,,0,0.00000000000000000000
chr3,134299661,134300016,355,-1,0,,0,0.00000000000000000000
chr3,134673901,134674555,654,-1,0,2047,1,152.90519877675800000000
chr3,134842624,134844835,2211,-1,0,2047,1,45.22840343735870000000
chr3,135014873,135015821,948,-1,0,,0,0.00000000000000000000
chr3,135661031,135665605,4574,-1,0,,0,0.00000000000000000000
chr3,135697032,135701145,4113,-1,0,5523,1,24.31315341599810000000
chr3,135943475,135958670,15195,-1,0,,0,0.00000000000000000000
chr3,135972304,135973476,1172,-1,0,5096,1,85.32423208191130000000
chr3,136019970,136030869,10899,-1,0,5096,1,9.17515368382420000000
chr3,136020950,136026288,5338,-1,0,5096,1,18.73360809291870000000
chr3,136515176,136517703,2527,-1,0,,0,0.00000000000000000000
chr3,137028708,137043640,14932,-1,0,,0,0.00000000000000000000
chr3,137071978,137073738,1760,-1,0,,0,0.00000000000000000000
chr3,137072360,137073445,1085,-1,0,,0,0.00000000000000000000
chr3,137314458,137316441,1983,-1,0,,0,0.00000000000000000000
chr3,137550848,137551520,672,-1,0,,0,0.00000000000000000000
chr3,137902641,137903178,537,-1,0,,0,0.00000000000000000000
chr3,138727248,138744008,16760,-1,0,389151,1,5.96658711217184000000
chr3,138837193,138837721,528,-1,0,,0,0.00000000000000000000
chr3,139003745,139005342,1597,-1,0,,0,0.00000000000000000000
chr3,139425673,139426092,419,-1,0,,0,0.00000000000000000000
chr3,139618454,139621919,3465,-1,0,,0,0.00000000000000000000
chr3,139653748,139654307,559,-1,0,64084,1,178.89087656529500000000
chr3,139698461,139699974,1513,-1,0,64084,1,66.09385327164570000000
chr3,140193793,140194014,221,-1,0,64084,1,452.48868778280500000000
chr3,140208636,140209178,542,-1,0,64084,1,184.50184501845000000000
chr3,140208824,140208928,104,-1,0,64084,1,961.53846153846200000000
chr3,140267283,140270781,3498,-1,0,64084,1,28.58776443682100000000
chr3,140522401,140523565,1164,-1,0,,0,0.00000000000000000000
chr3,140543610,140547261,3651,-1,0,,0,0.00000000000000000000
chr3,140544622,140547057,2435,-1,0,,0,0.00000000000000000000
chr3,140545595,140547001,1406,-1,0,,0,0.00000000000000000000
chr3,140621322,140622434,1112,-1,0,,0,0.00000000000000000000
chr3,140760336,140765195,4859,-1,0,,0,0.00000000000000000000
chr3,140776972,140778674,1702,-1,0,92369,1,58.75440658049350000000
chr3,141070048,141075586,5538,-1,0,253461,1,18.05706031058140000000
chr3,141080894,141084333,3439,-1,0,253461,1,29.07822041291070000000
chr3,141238342,141245696,7354,-1,0,5922,1,13.59804188196900000000
chr3,141329253,141329316,63,-1,0,5922,1,1587.30158730159000000000
chr3,141384649,141385043,394,-1,0,,0,0.00000000000000000000
chr3,141403098,141404567,1469,-1,0,,0,0.00000000000000000000
chr3,141490074,141490493,419,-1,0,,0,0.00000000000000000000
chr3,141565454,141566897,1443,-1,0,,0,0.00000000000000000000
chr3,141571987,141573763,1776,-1,0,,0,0.00000000000000000000
chr3,141572129,141572866,737,-1,0,,0,0.00000000000000000000
chr3,141595255,141596169,914,-1,0,483,1,109.40919037199100000000
chr3,141683951,141685844,1893,-1,0,7029,1,52.82620179609090000000
chr3,141848425,141856031,7606,-1,0,7029,1,13.14751511964240000000
chr3,141849750,141852483,2733,-1,0,7029,1,36.58982802780830000000
chr3,142610380,142612757,2377,-1,0,,0,0.00000000000000000000
chr3,142641864,142643464,1600,-1,0,,0,0.00000000000000000000
chr3,143150410,143151558,1148,-1,0,285195,1,87.10801393728220000000
chr3,143167237,143169454,2217,-1,0,285195,1,45.10599909788000000000
chr3,143216633,143221895,5262,-1,0,285195,1,19.00418091980240000000
chr3,143219592,143221217,1625,-1,0,285195,1,61.53846153846150000000
chr3,143848217,144047875,199658,-1,0,,0,0.00000000000000000000
chr3,143776096,143864780,88684,-1,0,,0,0.00000000000000000000
chr3,144059236,144064255,5019,-1,0,,0,0.00000000000000000000
chr3,143950929,143954416,3487,-1,0,,0,0.00000000000000000000
chr3,143697262,143697715,453,-1,0,205428,1,220.75055187638000000000
chr3,143608516,143608698,182,-1,0,,0,0.00000000000000000000
chr3,144100816,144119195,18379,-1,0,,0,0.00000000000000000000
chr3,144108808,144108923,115,-1,0,,0,0.00000000000000000000
chr3,144236135,144241318,5183,-1,0,,0,0.00000000000000000000
chr3,144281462,144292974,11512,-1,0,,0,0.00000000000000000000
chr3,144283043,144287715,4672,-1,0,,0,0.00000000000000000000
chr3,144517199,144518950,1751,-1,0,,0,0.00000000000000000000
chr3,144517896,144518527,631,-1,0,,0,0.00000000000000000000
chr3,144693109,144693236,127,-1,0,,0,0.00000000000000000000
chr3,144693162,144693230,68,-1,0,,0,0.00000000000000000000
chr3,144888421,144888910,489,-1,0,,0,0.00000000000000000000
chr3,144953749,145166309,212560,-1,0,,0,0.00000000000000000000
chr3,145220520,145260337,39817,-1,0,,0,0.00000000000000000000
chr3,145205153,145224639,19486,-1,0,,0,0.00000000000000000000
chr3,145146469,145146973,504,-1,0,,0,0.00000000000000000000
chr3,145437424,145497022,59598,-1,0,,0,0.00000000000000000000
chr3,145479208,145479822,614,-1,0,,0,0.00000000000000000000
chr3,145518101,145520218,2117,-1,0,,0,0.00000000000000000000
chr3,145625985,145662453,36468,-1,0,,0,0.00000000000000000000
chr3,145643341,145660770,17429,-1,0,,0,0.00000000000000000000
chr3,145644966,145649188,4222,-1,0,,0,0.00000000000000000000
chr3,145919637,145922154,2517,-1,0,57088,1,39.72983710766790000000
chr3,145931804,145932350,546,-1,0,57088,1,183.15018315018300000000
chr3,145931913,145932225,312,-1,0,57088,1,320.51282051282000000000
chr3,146186957,146261956,74999,-1,0,5359;57047,2,2.66670222269630000000
chr3,146385095,146394853,9758,-1,0,,0,0.00000000000000000000
chr3,146385126,146391161,6035,-1,0,,0,0.00000000000000000000
chr3,146415344,146417874,2530,-1,0,,0,0.00000000000000000000
chr3,146427456,146428285,829,-1,0,,0,0.00000000000000000000
chr3,146484705,146489124,4419,-1,0,,0,0.00000000000000000000
chr3,147154987,147156954,1967,-1,0,,0,0.00000000000000000000
chr3,147444378,147446250,1872,-1,0,,0,0.00000000000000000000
chr3,147477790,147530742,52952,-1,0,,0,0.00000000000000000000
chr3,147606628,147607249,621,-1,0,,0,0.00000000000000000000
chr3,147627178,147628086,908,-1,0,,0,0.00000000000000000000
chr3,147836948,147839935,2987,-1,0,,0,0.00000000000000000000
chr3,148197001,148197445,444,-1,0,,0,0.00000000000000000000
chr3,148281211,148285678,4467,-1,0,,0,0.00000000000000000000
chr3,148410848,148413238,2390,-1,0,,0,0.00000000000000000000
chr3,148464084,148466132,2048,-1,0,,0,0.00000000000000000000
chr3,148566691,148567203,512,-1,0,1360,1,195.31250000000000000000
chr3,148566800,148567119,319,-1,0,1360,1,313.47962382445100000000
chr3,148827567,148830821,3254,-1,0,,0,0.00000000000000000000
chr3,148963305,148975690,12385,-1,0,,0,0.00000000000000000000
chr3,148963331,148969712,6381,-1,0,,0,0.00000000000000000000
chr3,148844265,148844802,537,-1,0,,0,0.00000000000000000000
chr3,148844377,148844709,332,-1,0,,0,0.00000000000000000000
chr3,149231006,149231977,971,-1,0,,0,0.00000000000000000000
chr3,149268451,149270146,1695,-1,0,25937,1,58.99705014749260000000
chr3,149268361,149270108,1747,-1,0,25937,1,57.24098454493420000000
chr3,149345592,149345899,307,-1,0,25937,1,325.73289902280100000000
chr3,149585131,149588992,3861,-1,0,11342,1,25.90002590002590000000
chr3,149665427,149668520,3093,-1,0,11342,1,32.33107015842220000000
chr3,149877956,149878501,545,-1,0,,0,0.00000000000000000000
chr3,149878065,149878373,308,-1,0,,0,0.00000000000000000000
chr3,149899112,149899419,307,-1,0,,0,0.00000000000000000000
chr3,150124574,150128485,3911,-1,0,9819,1,25.56890820761950000000
chr3,150480568,150481293,725,-1,0,6478,1,137.93103448275900000000
chr3,150543287,150544683,1396,-1,0,,0,0.00000000000000000000
chr3,150553859,150555777,1918,-1,0,,0,0.00000000000000000000
chr3,150738789,150744132,5343,-1,0,,0,0.00000000000000000000
chr3,151011342,151011421,79,-1,0,116931,1,1265.82278481013000000000
chr3,151030199,151032644,2445,-1,0,116931;53836,2,81.79959100204500000000
chr3,151086217,151086626,409,-1,0,116931;64805,2,488.99755501222500000000
chr3,151086458,151086550,92,-1,0,116931;64805,2,2173.91304347826000000000
chr3,151477633,151480072,2439,-1,0,,0,0.00000000000000000000
chr3,151510559,151551704,41145,-1,0,13,1,2.43042897071333000000
chr3,151621945,151622986,1041,-1,0,,0,0.00000000000000000000
chr3,151764933,151765378,445,-1,0,,0,0.00000000000000000000
chr3,151770898,151776095,5197,-1,0,,0,0.00000000000000000000
chr3,151799119,151799934,815,-1,0,,0,0.00000000000000000000
chr3,152042478,152043122,644,-1,0,4154,1,155.27950310559000000000
chr3,152306923,152307159,236,-1,0,,0,0.00000000000000000000
chr3,152311596,152313322,1726,-1,0,,0,0.00000000000000000000
chr3,152333327,152355297,21970,-1,0,,0,0.00000000000000000000
chr3,152346869,152356035,9166,-1,0,,0,0.00000000000000000000
chr3,152345931,152354776,8845,-1,0,,0,0.00000000000000000000
chr3,152563141,152564788,1647,-1,0,,0,0.00000000000000000000
chr3,152606122,152612791,6669,-1,0,,0,0.00000000000000000000
chr3,152617191,152617381,190,-1,0,,0,0.00000000000000000000
chr3,152723002,152724167,1165,-1,0,,0,0.00000000000000000000
chr3,152744701,152748846,4145,-1,0,,0,0.00000000000000000000
chr3,153018991,153019149,158,-1,0,,0,0.00000000000000000000
chr3,153019069,153019177,108,-1,0,,0,0.00000000000000000000
chr3,153097978,153099149,1171,-1,0,,0,0.00000000000000000000
chr3,153211683,153219210,7527,-1,0,152118,1,13.28550551348480000000
chr3,153217387,153218768,1381,-1,0,152118,1,72.41129616220130000000
chr3,153226793,153239376,12583,-1,0,,0,0.00000000000000000000
chr3,153386326,153386385,59,-1,0,,0,0.00000000000000000000
chr3,153465023,153470189,5166,-1,0,,0,0.00000000000000000000
chr3,153558138,153565580,7442,-1,0,,0,0.00000000000000000000
chr3,153599218,153613954,14736,-1,0,,0,0.00000000000000000000
chr3,154096609,154097185,576,-1,0,344758,1,173.61111111111100000000
chr3,154096739,154097067,328,-1,0,344758,1,304.87804878048800000000
chr3,154270508,154424036,153528,-1,0,,0,0.00000000000000000000
chr3,154648247,154648800,553,-1,0,,0,0.00000000000000000000
chr3,154648358,154648679,321,-1,0,,0,0.00000000000000000000
chr3,155038946,155051156,12210,-1,0,,0,0.00000000000000000000
chr3,155056950,155103036,46086,-1,0,,0,0.00000000000000000000
chr3,155120490,155124799,4309,-1,0,,0,0.00000000000000000000
chr3,155410823,155411303,480,-1,0,23007,1,208.33333333333300000000
chr3,155478166,155498646,20480,-1,0,285315,1,4.88281250000000000000
chr3,156089677,156096492,6815,-1,0,7881,1,14.67351430667640000000
chr3,156091984,156093836,1852,-1,0,7881,1,53.99568034557240000000
chr3,156092164,156093505,1341,-1,0,7881,1,74.57121551081280000000
chr3,156617188,156617286,98,-1,0,389170,1,1020.40816326531000000000
chr3,157339202,157343072,3870,-1,0,,0,0.00000000000000000000
chr3,157419596,157422094,2498,-1,0,,0,0.00000000000000000000
chr3,157765170,157767719,2549,-1,0,,0,0.00000000000000000000
chr3,158116802,158117361,559,-1,0,51319,1,178.89087656529500000000
chr3,158116895,158117244,349,-1,0,51319,1,286.53295128939800000000
chr3,158171016,158174193,3177,-1,0,51319,1,31.47623544224110000000
chr3,158287502,158288351,849,-1,0,,0,0.00000000000000000000
chr3,158350718,158351910,1192,-1,0,,0,0.00000000000000000000
chr3,158549548,158785269,235721,-1,0,,0,0.00000000000000000000
chr3,158512401,158636113,123712,-1,0,64747,1,0.80832902224521500000
chr3,158758903,158866301,107398,-1,0,100505385;654502,2,1.86223207136073000000
chr3,158808243,158813097,4854,-1,0,100505385;654502,2,41.20313143798930000000
chr3,158898200,158900689,2489,-1,0,100505385;654502,2,80.35355564483730000000
chr3,158701861,158702255,394,-1,0,,0,0.00000000000000000000
chr3,158702037,158702086,49,-1,0,,0,0.00000000000000000000
chr3,159257049,159258081,1032,-1,0,100505385;29970,2,193.79844961240300000000
chr3,159257018,159257690,672,-1,0,100505385;29970,2,297.61904761904800000000
chr3,159428984,159429184,200,-1,0,100505385;29970,2,1000.00000000000000000000
chr3,159461361,159463447,2086,-1,0,100505385;29970,2,95.87727708533080000000
chr3,159518426,159518738,312,-1,0,100505385;29970,2,641.02564102564100000000
chr3,159895413,159899828,4415,-1,0,,0,0.00000000000000000000
chr3,159917717,159918255,538,-1,0,,0,0.00000000000000000000
chr3,160234097,160235714,1617,-1,0,3840,1,61.84291898577610000000
chr3,160355873,160366221,10348,-1,0,,0,0.00000000000000000000
chr3,160357027,160362271,5244,-1,0,,0,0.00000000000000000000
chr3,160402442,160402699,257,-1,0,,0,0.00000000000000000000
chr3,160402352,160402533,181,-1,0,,0,0.00000000000000000000
chr3,160521033,160521537,504,-1,0,151742,1,198.41269841269800000000
chr3,160521202,160521369,167,-1,0,151742,1,598.80239520958100000000
chr3,160661762,160667352,5590,-1,0,151742,1,17.88908765652950000000
chr3,160680360,160686156,5796,-1,0,151742,1,17.25327812284330000000
chr3,160696519,160698459,1940,-1,0,151742,1,51.54639175257730000000
chr3,160771986,160779134,7148,-1,0,151742,1,13.98992725237830000000
chr3,160972708,160973492,784,-1,0,,0,0.00000000000000000000
chr3,161246620,161247153,533,-1,0,,0,0.00000000000000000000
chr3,161246726,161247060,334,-1,0,,0,0.00000000000000000000
chr3,161408161,161550814,142653,-1,0,,0,0.00000000000000000000
chr3,161605028,161605238,210,-1,0,,0,0.00000000000000000000
chr3,161635510,161635691,181,-1,0,,0,0.00000000000000000000
chr3,161768814,161769380,566,-1,0,,0,0.00000000000000000000
chr3,161815109,161816270,1161,-1,0,,0,0.00000000000000000000
chr3,161818066,161818250,184,-1,0,,0,0.00000000000000000000
chr3,163043058,163410403,367345,-1,0,,0,0.00000000000000000000
chr3,163016226,163238963,222737,-1,0,,0,0.00000000000000000000
chr3,162512922,162719398,206476,-1,0,,0,0.00000000000000000000
chr3,163158528,163410210,251682,-1,0,,0,0.00000000000000000000
chr3,162509344,162627229,117885,-1,0,,0,0.00000000000000000000
chr3,162049774,162140048,90274,-1,0,,0,0.00000000000000000000
chr3,162854385,162947630,93245,-1,0,,0,0.00000000000000000000
chr3,162518640,162587795,69155,-1,0,,0,0.00000000000000000000
chr3,162558862,162601697,42835,-1,0,,0,0.00000000000000000000
chr3,162509069,162547228,38159,-1,0,,0,0.00000000000000000000
chr3,162516589,162560157,43568,-1,0,,0,0.00000000000000000000
chr3,163173016,163209326,36310,-1,0,,0,0.00000000000000000000
chr3,162513708,162543247,29539,-1,0,,0,0.00000000000000000000
chr3,162123290,162144301,21011,-1,0,,0,0.00000000000000000000
chr3,162213649,162235702,22053,-1,0,,0,0.00000000000000000000
chr3,162525833,162545198,19365,-1,0,,0,0.00000000000000000000
chr3,162128054,162143821,15767,-1,0,,0,0.00000000000000000000
chr3,162137594,162149452,11858,-1,0,,0,0.00000000000000000000
chr3,162512202,162525833,13631,-1,0,,0,0.00000000000000000000
chr3,162216643,162226773,10130,-1,0,,0,0.00000000000000000000
chr3,162763386,162771663,8277,-1,0,,0,0.00000000000000000000
chr3,162716941,162724304,7363,-1,0,,0,0.00000000000000000000
chr3,162137980,162142697,4717,-1,0,,0,0.00000000000000000000
chr3,162717416,162722038,4622,-1,0,,0,0.00000000000000000000
chr3,162764927,162769659,4732,-1,0,,0,0.00000000000000000000
chr3,163077675,163079744,2069,-1,0,,0,0.00000000000000000000
chr3,162448923,162449818,895,-1,0,,0,0.00000000000000000000
chr3,162408166,162408738,572,-1,0,,0,0.00000000000000000000
chr3,163464071,163464593,522,-1,0,,0,0.00000000000000000000
chr3,162154917,162155289,372,-1,0,,0,0.00000000000000000000
chr3,162408300,162408629,329,-1,0,,0,0.00000000000000000000
chr3,163464180,163464501,321,-1,0,,0,0.00000000000000000000
chr3,163428107,163428320,213,-1,0,,0,0.00000000000000000000
chr3,163428081,163428151,70,-1,0,,0,0.00000000000000000000
chr3,164114937,164175064,60127,-1,0,,0,0.00000000000000000000
chr3,163668198,163702578,34380,-1,0,,0,0.00000000000000000000
chr3,164099476,164115594,16118,-1,0,,0,0.00000000000000000000
chr3,163659798,163672267,12469,-1,0,,0,0.00000000000000000000
chr3,164075186,164087812,12626,-1,0,,0,0.00000000000000000000
chr3,164302020,164312066,10046,-1,0,,0,0.00000000000000000000
chr3,163658812,163665172,6360,-1,0,,0,0.00000000000000000000
chr3,164330722,164336491,5769,-1,0,,0,0.00000000000000000000
chr3,164155223,164155763,540,-1,0,,0,0.00000000000000000000
chr3,163728969,163729554,585,-1,0,,0,0.00000000000000000000
chr3,164125407,164126040,633,-1,0,,0,0.00000000000000000000
chr3,164188239,164188648,409,-1,0,,0,0.00000000000000000000
chr3,164381472,164381770,298,-1,0,,0,0.00000000000000000000
chr3,164463981,164464432,451,-1,0,,0,0.00000000000000000000
chr3,164524879,164552604,27725,-1,0,,0,0.00000000000000000000
chr3,165039926,165084041,44115,-1,0,,0,0.00000000000000000000
chr3,165175053,165176680,1627,-1,0,,0,0.00000000000000000000
chr3,165216500,165216913,413,-1,0,,0,0.00000000000000000000
chr3,165265345,165310852,45507,-1,0,,0,0.00000000000000000000
chr3,165261948,165296848,34900,-1,0,,0,0.00000000000000000000
chr3,165289146,165321789,32643,-1,0,,0,0.00000000000000000000
chr3,165264520,165269271,4751,-1,0,,0,0.00000000000000000000
chr3,165362703,165363147,444,-1,0,,0,0.00000000000000000000
chr3,165493151,165662084,168933,-1,0,590,1,0.59195065499340000000
chr3,165587137,165701820,114683,-1,0,,0,0.00000000000000000000
chr3,165569133,165618945,49812,-1,0,,0,0.00000000000000000000
chr3,165654338,165655584,1246,-1,0,,0,0.00000000000000000000
chr3,165697562,165698103,541,-1,0,,0,0.00000000000000000000
chr3,165578953,165579272,319,-1,0,,0,0.00000000000000000000
chr3,165472011,165472170,159,-1,0,,0,0.00000000000000000000
chr3,165773385,165773436,51,-1,0,,0,0.00000000000000000000
chr3,165961483,166032076,70593,-1,0,,0,0.00000000000000000000
chr3,166070324,166074766,4442,-1,0,,0,0.00000000000000000000
chr3,166053963,166055973,2010,-1,0,,0,0.00000000000000000000
chr3,165988724,165990259,1535,-1,0,,0,0.00000000000000000000
chr3,165987482,165987825,343,-1,0,,0,0.00000000000000000000
chr3,166844616,166849246,4630,-1,0,,0,0.00000000000000000000
chr3,166845218,166847202,1984,-1,0,,0,0.00000000000000000000
chr3,167113218,167116867,3649,-1,0,,0,0.00000000000000000000
chr3,167248453,167249407,954,-1,0,151790,1,104.82180293501000000000
chr3,167971269,167973183,1914,-1,0,,0,0.00000000000000000000
chr3,168263348,168264369,1021,-1,0,,0,0.00000000000000000000
chr3,168369652,168384569,14917,-1,0,,0,0.00000000000000000000
chr3,168428983,168432734,3751,-1,0,,0,0.00000000000000000000
chr3,168607351,168607908,557,-1,0,,0,0.00000000000000000000
chr3,168738456,168738837,381,-1,0,,0,0.00000000000000000000
chr3,168755186,168756541,1355,-1,0,,0,0.00000000000000000000
chr3,169190311,169190462,151,-1,0,2122,1,662.25165562913900000000
chr3,169268599,169268879,280,-1,0,2122,1,357.14285714285700000000
chr3,169586835,169591221,4386,-1,0,79782,1,22.79981760145920000000
chr3,169641306,169642209,903,-1,0,344658,1,110.74197120708700000000
chr3,170062624,170063789,1165,-1,0,,0,0.00000000000000000000
chr3,170115958,170120166,4208,-1,0,,0,0.00000000000000000000
chr3,170119500,170120011,511,-1,0,,0,0.00000000000000000000
chr3,170119575,170119888,313,-1,0,,0,0.00000000000000000000
chr3,170356068,170358469,2401,-1,0,,0,0.00000000000000000000
chr3,170565665,170565917,252,-1,0,,0,0.00000000000000000000
chr3,170661152,170661530,378,-1,0,,0,0.00000000000000000000
chr3,171034761,171034823,62,-1,0,23043,1,1612.90322580645000000000
chr3,171041803,171043507,1704,-1,0,23043,1,58.68544600938970000000
chr3,171220496,171221017,521,-1,0,,0,0.00000000000000000000
chr3,171220746,171221179,433,-1,0,,0,0.00000000000000000000
chr3,171250091,171251420,1329,-1,0,,0,0.00000000000000000000
chr3,171251963,171254235,2272,-1,0,,0,0.00000000000000000000
chr3,171688185,171688564,379,-1,0,,0,0.00000000000000000000
chr3,171747102,171749147,2045,-1,0,,0,0.00000000000000000000
chr3,172274173,172276538,2365,-1,0,,0,0.00000000000000000000
chr3,172400890,172401301,411,-1,0,57552,1,243.30900243309000000000
chr3,172586657,172594234,7577,-1,0,,0,0.00000000000000000000
chr3,173207863,173218004,10141,-1,0,22871,1,9.86096045754856000000
chr3,173207653,173216221,8568,-1,0,22871,1,11.67133520074700000000
chr3,173209649,173216270,6621,-1,0,22871,1,15.10345869204050000000
chr3,173240738,173241894,1156,-1,0,22871,1,86.50519031141870000000
chr3,173268251,173268686,435,-1,0,22871,1,229.88505747126400000000
chr3,173268421,173268479,58,-1,0,22871,1,1724.13793103448000000000
chr3,174077064,174080698,3634,-1,0,,0,0.00000000000000000000
chr3,174161548,174161836,288,-1,0,,0,0.00000000000000000000
chr3,174201951,174202701,750,-1,0,,0,0.00000000000000000000
chr3,174416344,174416747,403,-1,0,,0,0.00000000000000000000
chr3,174621331,174630235,8904,-1,0,254827,1,11.23090745732260000000
chr3,174846583,174859007,12424,-1,0,254827,1,8.04893754024469000000
chr3,175079141,175744686,665545,-1,0,254827,1,0.15025280033656600000
chr3,175926112,175999773,73661,-1,0,,0,0.00000000000000000000
chr3,175894038,175953798,59760,-1,0,,0,0.00000000000000000000
chr3,175884651,175915331,30680,-1,0,,0,0.00000000000000000000
chr3,175773431,175795480,22049,-1,0,,0,0.00000000000000000000
chr3,175077298,175090128,12830,-1,0,254827,1,7.79423226812159000000
chr3,175974518,175988438,13920,-1,0,,0,0.00000000000000000000
chr3,175079093,175083947,4854,-1,0,254827,1,20.60156571899460000000
chr3,175078282,175081620,3338,-1,0,254827,1,29.95805871779510000000
chr3,175080698,175084062,3364,-1,0,254827,1,29.72651605231870000000
chr3,176051552,176052868,1316,-1,0,,0,0.00000000000000000000
chr3,176068601,176069469,868,-1,0,,0,0.00000000000000000000
chr3,175341067,175341116,49,-1,0,254827,1,2040.81632653061000000000
chr3,176194751,176197947,3196,-1,0,,0,0.00000000000000000000
chr3,176242916,176246295,3379,-1,0,,0,0.00000000000000000000
chr3,176486801,176487380,579,-1,0,,0,0.00000000000000000000
chr3,176506079,176506201,122,-1,0,,0,0.00000000000000000000
chr3,176691773,176711108,19335,-1,0,,0,0.00000000000000000000
chr3,176693939,176707918,13979,-1,0,,0,0.00000000000000000000
chr3,176985245,176998281,13036,-1,0,,0,0.00000000000000000000
chr3,176994730,176995026,296,-1,0,,0,0.00000000000000000000
chr3,177383252,177389050,5798,-1,0,,0,0.00000000000000000000
chr3,177294077,177297621,3544,-1,0,,0,0.00000000000000000000
chr3,177381335,177385447,4112,-1,0,,0,0.00000000000000000000
chr3,177362981,177363669,688,-1,0,,0,0.00000000000000000000
chr3,177383124,177383607,483,-1,0,,0,0.00000000000000000000
chr3,177363140,177363472,332,-1,0,,0,0.00000000000000000000
chr3,177652263,177654558,2295,-1,0,,0,0.00000000000000000000
chr3,177753559,177757183,3624,-1,0,,0,0.00000000000000000000
chr3,177780090,177781586,1496,-1,0,,0,0.00000000000000000000
chr3,177896497,177896554,57,-1,0,,0,0.00000000000000000000
chr3,178081823,178136538,54715,-1,0,,0,0.00000000000000000000
chr3,178106022,178107184,1162,-1,0,,0,0.00000000000000000000
chr3,178404640,178405331,691,-1,0,10242,1,144.71780028943600000000
chr3,178549664,178551416,1752,-1,0,10242,1,57.07762557077630000000
chr3,178550124,178550896,772,-1,0,10242,1,129.53367875647700000000
chr3,178567635,178568340,705,-1,0,,0,0.00000000000000000000
chr3,178669077,178669852,775,-1,0,,0,0.00000000000000000000
chr3,178878487,178884028,5541,-1,0,5290,1,18.04728388377550000000
chr3,179264608,179267997,3389,-1,0,,0,0.00000000000000000000
chr3,179398484,179398786,302,-1,0,8975,1,331.12582781457000000000
chr3,179581005,179586844,5839,-1,0,51555,1,17.12622024319230000000
chr3,179618805,179619259,454,-1,0,51555,1,220.26431718061700000000
chr3,179619066,179619118,52,-1,0,51555,1,1923.07692307692000000000
chr3,179654341,179654806,465,-1,0,51555,1,215.05376344086000000000
chr3,179768982,179824624,55642,-1,0,,0,0.00000000000000000000
chr3,180090955,180093831,2876,-1,0,,0,0.00000000000000000000
chr3,180173587,180173841,254,-1,0,,0,0.00000000000000000000
chr3,180262784,180263247,463,-1,0,,0,0.00000000000000000000
chr3,180294402,180295560,1158,-1,0,,0,0.00000000000000000000
chr3,180475665,180475766,101,-1,0,,0,0.00000000000000000000
chr3,180577756,180578195,439,-1,0,,0,0.00000000000000000000
chr3,180851962,180852627,665,-1,0,,0,0.00000000000000000000
chr3,180917940,180918669,729,-1,0,,0,0.00000000000000000000
chr3,180937564,180948243,10679,-1,0,,0,0.00000000000000000000
chr3,180961893,180962227,334,-1,0,,0,0.00000000000000000000
chr3,181005994,181006509,515,-1,0,,0,0.00000000000000000000
chr3,181006175,181006254,79,-1,0,,0,0.00000000000000000000
chr3,181354392,181354530,138,-1,0,,0,0.00000000000000000000
chr3,181460697,181460839,142,-1,0,,0,0.00000000000000000000
chr3,181497473,181497962,489,-1,0,,0,0.00000000000000000000
chr3,182199615,182200037,422,-1,0,,0,0.00000000000000000000
chr3,182239994,182240633,639,-1,0,,0,0.00000000000000000000
chr3,183266543,183266958,415,-1,0,89857,1,240.96385542168700000000
chr3,183068990,183069058,68,-1,0,23101,1,1470.58823529412000000000
chr3,182924725,182924779,54,-1,0,23101,1,1851.85185185185000000000
chr3,183358411,183364659,6248,-1,0,54800,1,16.00512163892450000000
chr3,183542711,183543702,991,-1,0,79929,1,100.90817356205900000000
chr3,183673406,183676032,2626,-1,0,10057,1,38.08073115003810000000
chr3,183673469,183674029,560,-1,0,10057,1,178.57142857142900000000
chr3,183817229,183819309,2080,-1,0,285242,1,48.07692307692310000000
chr3,183876659,183877377,718,-1,0,1857,1,139.27576601671300000000
chr3,183876801,183877389,588,-1,0,1857,1,170.06802721088400000000
chr3,184085640,184086087,447,-1,0,5437,1,223.71364653243800000000
chr3,184125188,184125831,643,-1,0,105374250,1,155.52099533437000000000
chr3,184125352,184125558,206,-1,0,105374250,1,485.43689320388300000000
chr3,184132415,184132651,236,-1,0,105374250,1,423.72881355932200000000
chr3,184169357,184170685,1328,-1,0,,0,0.00000000000000000000
chr3,184303484,184305285,1801,-1,0,,0,0.00000000000000000000
chr3,184335105,184335409,304,-1,0,,0,0.00000000000000000000
chr3,184469201,184476000,6799,-1,0,,0,0.00000000000000000000
chr3,184470554,184472811,2257,-1,0,,0,0.00000000000000000000
chr3,184471137,184472320,1183,-1,0,,0,0.00000000000000000000
chr3,184470871,184471977,1106,-1,0,,0,0.00000000000000000000
chr3,184759683,184765314,5631,-1,0,23355,1,17.75883502042270000000
chr3,184948976,184949462,486,-1,0,1962,1,205.76131687242800000000
chr3,184952086,184952586,500,-1,0,1962,1,200.00000000000000000000
chr3,185017296,185017692,396,-1,0,9175,1,252.52525252525300000000
chr3,185100837,185109236,8399,-1,0,9175,1,11.90617930706040000000
chr3,185512050,185512277,227,-1,0,10644,1,440.52863436123400000000
chr3,185565449,185567770,2321,-1,0,,0,0.00000000000000000000
chr3,185581903,185585067,3164,-1,0,,0,0.00000000000000000000
chr3,185594411,185597929,3518,-1,0,,0,0.00000000000000000000
chr3,185789470,185789883,413,-1,0,2119,1,242.13075060532700000000
chr3,185831265,185831322,57,-1,0,,0,0.00000000000000000000
chr3,185842701,185846000,3299,-1,0,,0,0.00000000000000000000
chr3,185843387,185844371,984,-1,0,,0,0.00000000000000000000
chr3,185843610,185844157,547,-1,0,,0,0.00000000000000000000
chr3,185843860,185844137,277,-1,0,,0,0.00000000000000000000
chr3,185899960,185902327,2367,-1,0,1608,1,42.24757076468100000000
chr3,186094734,186096805,2071,-1,0,,0,0.00000000000000000000
chr3,186182065,186183177,1112,-1,0,,0,0.00000000000000000000
chr3,186386447,186429413,42966,-1,0,3273,1,2.32742168226039000000
chr3,186412848,186427281,14433,-1,0,,0,0.00000000000000000000
chr3,186407784,186420386,12602,-1,0,,0,0.00000000000000000000
chr3,186412848,186417775,4927,-1,0,,0,0.00000000000000000000
chr3,186452565,186453441,876,-1,0,3827,1,114.15525114155300000000
chr3,186581006,186585685,4679,-1,0,,0,0.00000000000000000000
chr3,186702310,186702771,461,-1,0,6480,1,216.91973969631200000000
chr3,186826562,186827084,522,-1,0,,0,0.00000000000000000000
chr3,186826651,186826978,327,-1,0,,0,0.00000000000000000000
chr3,187562991,187563472,481,-1,0,,0,0.00000000000000000000
chr3,187727515,187734864,7349,-1,0,,0,0.00000000000000000000
chr3,187730978,187734940,3962,-1,0,,0,0.00000000000000000000
chr3,187732869,187734833,1964,-1,0,,0,0.00000000000000000000
chr3,187733081,187734691,1610,-1,0,,0,0.00000000000000000000
chr3,188170096,188170446,350,-1,0,4026,1,285.71428571428600000000
chr3,188304789,188305249,460,-1,0,4026,1,217.39130434782600000000
chr3,188304833,188305168,335,-1,0,4026,1,298.50746268656700000000
chr3,188501908,188503784,1876,-1,0,4026,1,53.30490405117270000000
chr3,189091976,189100072,8096,-1,0,,0,0.00000000000000000000
chr3,189224478,189225382,904,-1,0,,0,0.00000000000000000000
chr3,189263967,189264363,396,-1,0,,0,0.00000000000000000000
chr3,189264098,189264187,89,-1,0,,0,0.00000000000000000000
chr3,189264170,189264240,70,-1,0,,0,0.00000000000000000000
chr3,189361298,189371967,10669,-1,0,8626,1,9.37294966726029000000
chr3,189364056,189369015,4959,-1,0,8626,1,20.16535591853200000000
chr3,189360543,189364634,4091,-1,0,8626,1,24.44390124663900000000
chr3,189363696,189366776,3080,-1,0,8626,1,32.46753246753250000000
chr3,189363678,189364638,960,-1,0,8626,1,104.16666666666700000000
chr3,189575771,189576348,577,-1,0,8626,1,173.31022530329300000000
chr3,189575903,189576247,344,-1,0,8626,1,290.69767441860500000000
chr3,189596493,189596842,349,-1,0,8626,1,286.53295128939800000000
chr3,189596462,189596663,201,-1,0,8626,1,497.51243781094500000000
chr3,189735400,189747102,11702,-1,0,55214,1,8.54554776961203000000
chr3,189734663,189740018,5355,-1,0,55214,1,18.67413632119510000000
chr3,189737215,189740646,3431,-1,0,55214,1,29.14602156805600000000
chr3,189839711,189841104,1393,-1,0,55214,1,71.78750897343860000000
chr3,189955398,189955720,322,-1,0,,0,0.00000000000000000000
chr3,190114160,190151471,37311,-1,0,131920;10686,2,5.36034949478706000000
chr3,190118791,190119316,525,-1,0,10686,1,190.47619047619000000000
chr3,190119009,190119120,111,-1,0,10686,1,900.90090090090100000000
chr3,190237973,190240603,2630,-1,0,3556,1,38.02281368821290000000
chr3,190290560,190291037,477,-1,0,3556,1,209.64360587002100000000
chr3,190290629,190290936,307,-1,0,3556,1,325.73289902280100000000
chr3,190468988,190469174,186,-1,0,,0,0.00000000000000000000
chr3,190478349,190478778,429,-1,0,,0,0.00000000000000000000
chr3,190478457,190478634,177,-1,0,,0,0.00000000000000000000
chr3,190669671,190670246,575,-1,0,,0,0.00000000000000000000
chr3,190669796,190670120,324,-1,0,,0,0.00000000000000000000
chr3,190696627,190696937,310,-1,0,,0,0.00000000000000000000
chr3,190891262,190988090,96828,-1,0,344901;257313,2,2.06551823852605000000
chr3,190943515,191028089,84574,-1,0,344901;257313,2,2.36479296237614000000
chr3,191523614,191571325,47711,-1,0,,0,0.00000000000000000000
chr3,191654686,191667929,13243,-1,0,,0,0.00000000000000000000
chr3,191293091,191302232,9141,-1,0,,0,0.00000000000000000000
chr3,191326569,191335521,8952,-1,0,,0,0.00000000000000000000
chr3,191064686,191071665,6979,-1,0,152137,1,14.32870038687490000000
chr3,191712656,191720479,7823,-1,0,,0,0.00000000000000000000
chr3,191240453,191246719,6266,-1,0,,0,0.00000000000000000000
chr3,191504662,191508850,4188,-1,0,,0,0.00000000000000000000
chr3,190785086,190789326,4240,-1,0,,0,0.00000000000000000000
chr3,191011206,191013664,2458,-1,0,257313,1,40.68348250610250000000
chr3,191264228,191266185,1957,-1,0,,0,0.00000000000000000000
chr3,191580648,191581538,890,-1,0,,0,0.00000000000000000000
chr3,190822894,190824225,1331,-1,0,,0,0.00000000000000000000
chr3,190787021,190788044,1023,-1,0,,0,0.00000000000000000000
chr3,190977168,190977825,657,-1,0,344901,1,152.20700152207000000000
chr3,191580746,191581421,675,-1,0,,0,0.00000000000000000000
chr3,190725445,190725806,361,-1,0,,0,0.00000000000000000000
chr3,191667978,191668337,359,-1,0,,0,0.00000000000000000000
chr3,191581028,191581279,251,-1,0,,0,0.00000000000000000000
chr3,191789272,191789856,584,-1,0,,0,0.00000000000000000000
chr3,191788547,191789043,496,-1,0,,0,0.00000000000000000000
chr3,191856027,191856535,508,-1,0,,0,0.00000000000000000000
chr3,191856098,191856436,338,-1,0,,0,0.00000000000000000000
chr3,191885042,191895015,9973,-1,0,2257,1,10.02707309736290000000
chr3,191889935,191891307,1372,-1,0,2257,1,72.88629737609330000000
chr3,191897200,191897946,746,-1,0,2257,1,134.04825737265400000000
chr3,191936815,191988532,51717,-1,0,2257,1,1.93360017015681000000
chr3,192063087,192063604,517,-1,0,2257,1,193.42359767891700000000
chr3,192063192,192063505,313,-1,0,2257,1,319.48881789137400000000
chr3,192095704,192096240,536,-1,0,2257,1,186.56716417910400000000
chr3,192122750,192123463,713,-1,0,2257,1,140.25245441795200000000
chr3,192264656,192268312,3656,-1,0,2257,1,27.35229759299780000000
chr3,192304832,192312853,8021,-1,0,2257,1,12.46727340730580000000
chr3,192358896,192359197,301,-1,0,2257,1,332.22591362126200000000
chr3,192389660,192392069,2409,-1,0,2257,1,41.51100041511000000000
chr3,192544898,192546658,1760,-1,0,151963,1,56.81818181818180000000
chr3,192597857,192610008,12151,-1,0,151963,1,8.22977532713357000000
chr3,192672989,192673624,635,-1,0,,0,0.00000000000000000000
chr3,192673319,192673387,68,-1,0,,0,0.00000000000000000000
chr3,192744093,192745206,1113,-1,0,,0,0.00000000000000000000
chr3,192744355,192744897,542,-1,0,,0,0.00000000000000000000
chr3,192776846,192782615,5769,-1,0,,0,0.00000000000000000000
chr3,192873433,192889410,15977,-1,0,,0,0.00000000000000000000
chr3,192875256,192885569,10313,-1,0,,0,0.00000000000000000000
chr3,192879705,192884966,5261,-1,0,,0,0.00000000000000000000
chr3,193135456,193142943,7487,-1,0,84239,1,13.35648457326030000000
chr3,193136476,193140306,3830,-1,0,84239,1,26.10966057441250000000
chr3,193192217,193196495,4278,-1,0,84239,1,23.37540906965870000000
chr3,193232222,193232464,242,-1,0,84239,1,413.22314049586800000000
chr3,193399325,193403454,4129,-1,0,4976,1,24.21893921046260000000
chr3,194068401,194069100,699,-1,0,1370,1,143.06151645207400000000
chr3,194121163,194121921,758,-1,0,,0,0.00000000000000000000
chr3,194406376,194439879,33503,-1,0,131583,1,2.98480733068680000000
chr3,194393489,194403486,9997,-1,0,,0,0.00000000000000000000
chr3,194442032,194444322,2290,-1,0,,0,0.00000000000000000000
chr3,194398665,194400485,1820,-1,0,,0,0.00000000000000000000
chr3,194355357,194356600,1243,-1,0,,0,0.00000000000000000000
chr3,194384002,194384563,561,-1,0,55341,1,178.25311942959000000000
chr3,194290145,194290741,596,-1,0,,0,0.00000000000000000000
chr3,194384120,194384469,349,-1,0,55341,1,286.53295128939800000000
chr3,194290283,194290528,245,-1,0,,0,0.00000000000000000000
chr3,194457139,194457203,64,-1,0,,0,0.00000000000000000000
chr3,194543179,194546256,3077,-1,0,,0,0.00000000000000000000
chr3,194555614,194556267,653,-1,0,,0,0.00000000000000000000
chr3,194560548,194568606,8058,-1,0,,0,0.00000000000000000000
chr3,194623974,194667172,43198,-1,0,,0,0.00000000000000000000
chr3,194715733,194720540,4807,-1,0,,0,0.00000000000000000000
chr3,194710819,194714323,3504,-1,0,,0,0.00000000000000000000
chr3,194614723,194615039,316,-1,0,,0,0.00000000000000000000
chr3,194744059,194744311,252,-1,0,,0,0.00000000000000000000
chr3,194754902,194755600,698,-1,0,,0,0.00000000000000000000
chr3,194786234,194788885,2651,-1,0,,0,0.00000000000000000000
chr3,194786061,194787539,1478,-1,0,,0,0.00000000000000000000
chr3,194991304,194991991,687,-1,0,152002,1,145.56040756914100000000
chr3,195115648,195115891,243,-1,0,23527,1,411.52263374485600000000
chr3,195133589,195144554,10965,-1,0,23527,1,9.11992704058368000000
chr3,195198681,195234013,35332,-1,0,,0,0.00000000000000000000
chr3,195211625,195233742,22117,-1,0,,0,0.00000000000000000000
chr3,195221679,195233299,11620,-1,0,,0,0.00000000000000000000
chr3,195218437,195226385,7948,-1,0,,0,0.00000000000000000000
chr3,195212620,195216327,3707,-1,0,,0,0.00000000000000000000
chr3,195185893,195187458,1565,-1,0,,0,0.00000000000000000000
chr3,195438740,195725565,286825,-1,0,10188;200958;4585,3,1.04593393183997000000
chr3,195286783,195453437,166654,-1,0,347;200958,2,1.20009120693173000000
chr3,195380278,195469564,89286,-1,0,200958,1,1.11999641601147000000
chr3,195660722,195734693,73971,-1,0,,0,0.00000000000000000000
chr3,195408514,195478424,69910,-1,0,200958;4585,2,2.86082105564297000000
chr3,195430591,195477260,46669,-1,0,200958;4585,2,4.28550001071375000000
chr3,195406176,195449432,43256,-1,0,200958,1,2.31181801368596000000
chr3,195683802,195719902,36100,-1,0,,0,0.00000000000000000000
chr3,195470456,195506394,35938,-1,0,4585,1,2.78256998163504000000
chr3,195448847,195476749,27902,-1,0,200958;4585,2,7.16794495018278000000
chr3,195426197,195451351,25154,-1,0,200958,1,3.97551085314463000000
chr3,195419869,195441831,21962,-1,0,,0,0.00000000000000000000
chr3,195442557,195464856,22299,-1,0,200958,1,4.48450603166061000000
chr3,195502579,195515567,12988,-1,0,4585,1,7.69941484447182000000
chr3,195341611,195356312,14701,-1,0,,0,0.00000000000000000000
chr3,195457311,195471056,13745,-1,0,200958,1,7.27537286285922000000
chr3,195428748,195442856,14108,-1,0,,0,0.00000000000000000000
chr3,195466234,195475769,9535,-1,0,4585,1,10.48767697954900000000
chr3,195341902,195350261,8359,-1,0,,0,0.00000000000000000000
chr3,195453964,195456627,2663,-1,0,200958,1,37.55163349605710000000
chr3,195501968,195504915,2947,-1,0,4585,1,33.93281303020020000000
chr3,195513220,195515099,1879,-1,0,4585,1,53.21979776476850000000
chr3,195654385,195655365,980,-1,0,,0,0.00000000000000000000
chr3,195559848,195561266,1418,-1,0,,0,0.00000000000000000000
chr3,195505831,195507123,1292,-1,0,4585,1,77.39938080495360000000
chr3,195569208,195569925,717,-1,0,,0,0.00000000000000000000
chr3,195635697,195636934,1237,-1,0,10188,1,80.84074373484240000000
chr3,195607330,195608478,1148,-1,0,10188,1,87.10801393728220000000
chr3,195425861,195426432,571,-1,0,,0,0.00000000000000000000
chr3,195413515,195414149,634,-1,0,,0,0.00000000000000000000
chr3,195437787,195438307,520,-1,0,,0,0.00000000000000000000
chr3,195452036,195452577,541,-1,0,200958,1,184.84288354898300000000
chr3,195487185,195487676,491,-1,0,4585,1,203.66598778004100000000
chr3,195421366,195421860,494,-1,0,,0,0.00000000000000000000
chr3,195500243,195500576,333,-1,0,4585,1,300.30030030030000000000
chr3,195440902,195441256,354,-1,0,,0,0.00000000000000000000
chr3,195653521,195653881,360,-1,0,,0,0.00000000000000000000
chr3,195500380,195500567,187,-1,0,4585,1,534.75935828877000000000
chr3,195340211,195340345,134,-1,0,,0,0.00000000000000000000
chr3,195500482,195500566,84,-1,0,4585,1,1190.47619047619000000000
chr3,195762009,195764567,2558,-1,0,,0,0.00000000000000000000
chr3,195773917,195774979,1062,-1,0,,0,0.00000000000000000000
chr3,195818549,195819325,776,-1,0,,0,0.00000000000000000000
chr3,195812068,195812642,574,-1,0,,0,0.00000000000000000000
chr3,195825719,195826563,844,-1,0,,0,0.00000000000000000000
chr3,195830409,195830581,172,-1,0,,0,0.00000000000000000000
chr3,195926625,195928412,1787,-1,0,131540,1,55.95970900951320000000
chr3,195949204,195951334,2130,-1,0,200931,1,46.94835680751170000000
chr3,195949611,195950623,1012,-1,0,200931,1,98.81422924901180000000
chr3,196055728,196057489,1761,-1,0,116211,1,56.78591709256100000000
chr3,196055918,196056883,965,-1,0,116211,1,103.62694300518100000000
chr3,196061601,196062400,799,-1,0,116211,1,125.15644555694600000000
chr3,196061661,196062016,355,-1,0,116211,1,281.69014084507000000000
chr3,196130908,196132256,1348,-1,0,26043,1,74.18397626112760000000
chr3,196172591,196175527,2936,-1,0,,0,0.00000000000000000000
chr3,196188213,196190507,2294,-1,0,,0,0.00000000000000000000
chr3,196188308,196188586,278,-1,0,,0,0.00000000000000000000
chr3,196202622,196206185,3563,-1,0,165918,1,28.06623631770980000000
chr3,196319173,196322019,2846,-1,0,,0,0.00000000000000000000
chr3,196342092,196343259,1167,-1,0,,0,0.00000000000000000000
chr3,196352676,196352736,60,-1,0,,0,0.00000000000000000000
chr3,196556818,196561258,4440,-1,0,5062,1,22.52252252252250000000
chr3,196554741,196557513,2772,-1,0,5062,1,36.07503607503610000000
chr3,196565734,196566711,977,-1,0,,0,0.00000000000000000000
chr3,196729023,196730780,1757,-1,0,4241,1,56.91519635742740000000
chr3,196695481,196696773,1292,-1,0,80235,1,77.39938080495360000000
chr3,196759628,196760541,913,-1,0,,0,0.00000000000000000000
chr3,196761174,196761775,601,-1,0,,0,0.00000000000000000000
chr3,196759331,196759743,412,-1,0,,0,0.00000000000000000000
chr3,196933014,196939229,6215,-1,0,1739,1,16.09010458567980000000
chr3,196934565,196939254,4689,-1,0,1739,1,21.32650885050120000000
chr3,197050391,197057092,6701,-1,0,,0,0.00000000000000000000
chr3,197118097,197119365,1268,-1,0,,0,0.00000000000000000000
chr3,197162936,197165713,2777,-1,0,,0,0.00000000000000000000
chr3,197185855,197187706,1851,-1,0,,0,0.00000000000000000000
chr3,197186398,197187018,620,-1,0,,0,0.00000000000000000000
chr3,197186676,197187086,410,-1,0,,0,0.00000000000000000000
chr3,197206683,197214694,8011,-1,0,,0,0.00000000000000000000
chr3,197342016,197394398,52382,-1,0,,0,0.00000000000000000000
chr3,197383239,197394224,10985,-1,0,,0,0.00000000000000000000
chr3,197307212,197314545,7333,-1,0,,0,0.00000000000000000000
chr3,197320277,197322142,1865,-1,0,,0,0.00000000000000000000
chr3,197433923,197437358,3435,-1,0,9711,1,29.11208151382820000000
chr3,197458811,197605588,146777,-1,0,9711;84248;84859,3,2.04391696246687000000
chr3,197566650,197605588,38938,-1,0,84859,1,2.56818532025271000000
chr3,197485810,197488574,2764,-1,0,84248,1,36.17945007235890000000
chr3,197456326,197458040,1714,-1,0,9711,1,58.34305717619600000000
chr3,197580955,197582014,1059,-1,0,84859,1,94.42870632672330000000
chr3,197673492,197674947,1455,-1,0,84223,1,68.72852233676980000000
chr3,197730374,197732299,1925,-1,0,89782,1,51.94805194805190000000
chr3,197738923,197742598,3675,-1,0,89782,1,27.21088435374150000000
chr3,197781683,197783597,1914,-1,0,,0,0.00000000000000000000
chr3,197825454,197833003,7549,-1,0,,0,0.00000000000000000000
chr3,197825800,197826757,957,-1,0,,0,0.00000000000000000000
chr3,197842428,197896100,53672,-1,0,728262,1,1.86316887762707000000
chr3,197843892,197850046,6154,-1,0,,0,0.00000000000000000000
chr3,197894978,197896885,1907,-1,0,728262,1,52.43838489774520000000
chr4,72279,204237,131958,-1,0,152687;255403,2,1.51563376225769000000
chr4,137312,192858,55546,-1,0,255403,1,1.80030965326036000000
chr4,18938,76369,57431,-1,0,152687,1,1.74121989866100000000
chr4,67011,130735,63724,-1,0,152687;255403,2,3.13853493189379000000
chr4,435868,497284,61416,-1,0,54872;170960,2,3.25648039598802000000
chr4,142192,183243,41051,-1,0,255403,1,2.43599425105357000000
chr4,12270,36720,24450,-1,0,,0,0.00000000000000000000
chr4,212935,226988,14053,-1,0,,0,0.00000000000000000000
chr4,90253,102000,11747,-1,0,,0,0.00000000000000000000
chr4,43503,50086,6583,-1,0,,0,0.00000000000000000000
chr4,477022,484056,7034,-1,0,170960,1,14.21666192777940000000
chr4,91366,96776,5410,-1,0,,0,0.00000000000000000000
chr4,64508,67889,3381,-1,0,152687,1,29.57704821058860000000
chr4,244787,248870,4083,-1,0,,0,0.00000000000000000000
chr4,400948,401479,531,-1,0,,0,0.00000000000000000000
chr4,263957,264238,281,-1,0,,0,0.00000000000000000000
chr4,637475,642220,4745,-1,0,5158,1,21.07481559536350000000
chr4,738697,742568,3871,-1,0,10336,1,25.83311805734950000000
chr4,708668,711292,2624,-1,0,10336,1,38.10975609756100000000
chr4,1241273,1243659,2386,-1,0,1487,1,41.91114836546520000000
chr4,1003313,1005958,2645,-1,0,53834,1,37.80718336483930000000
chr4,1047389,1049453,2064,-1,0,,0,0.00000000000000000000
chr4,738471,740633,2162,-1,0,10336,1,46.25346901017580000000
chr4,1024485,1026521,2036,-1,0,,0,0.00000000000000000000
chr4,752133,753730,1597,-1,0,10336,1,62.61740763932370000000
chr4,1088884,1090526,1642,-1,0,285498,1,60.90133982947620000000
chr4,662118,663587,1469,-1,0,5158,1,68.07351940095300000000
chr4,708775,710135,1360,-1,0,10336,1,73.52941176470590000000
chr4,1391231,1392484,1253,-1,0,,0,0.00000000000000000000
chr4,1139136,1140335,1199,-1,0,,0,0.00000000000000000000
chr4,694727,695874,1147,-1,0,,0,0.00000000000000000000
chr4,783468,784153,685,-1,0,10815,1,145.98540145985400000000
chr4,1366326,1366919,593,-1,0,57654,1,168.63406408094400000000
chr4,752435,753336,901,-1,0,10336,1,110.98779134295200000000
chr4,1089475,1090305,830,-1,0,285498,1,120.48192771084300000000
chr4,1140579,1141310,731,-1,0,,0,0.00000000000000000000
chr4,725383,725952,569,-1,0,10336,1,175.74692442882200000000
chr4,628793,629287,494,-1,0,5158,1,202.42914979757100000000
chr4,1357758,1358127,369,-1,0,57654,1,271.00271002710000000000
chr4,1373372,1373833,461,-1,0,57654,1,216.91973969631200000000
chr4,1289779,1290279,500,-1,0,10296,1,200.00000000000000000000
chr4,553497,553879,382,-1,0,,0,0.00000000000000000000
chr4,1266406,1266690,284,-1,0,,0,0.00000000000000000000
chr4,1059519,1059866,347,-1,0,,0,0.00000000000000000000
chr4,1089190,1089455,265,-1,0,285498,1,377.35849056603800000000
chr4,1276964,1277164,200,-1,0,,0,0.00000000000000000000
chr4,1391226,1391495,269,-1,0,,0,0.00000000000000000000
chr4,730265,730513,248,-1,0,10336,1,403.22580645161300000000
chr4,629152,629324,172,-1,0,5158,1,581.39534883720900000000
chr4,1366535,1366667,132,-1,0,57654,1,757.57575757575800000000
chr4,707008,707133,125,-1,0,10336,1,800.00000000000000000000
chr4,1327842,1327954,112,-1,0,10296,1,892.85714285714300000000
chr4,783738,783853,115,-1,0,10815,1,869.56521739130400000000
chr4,1373549,1373662,113,-1,0,57654,1,884.95575221238900000000
chr4,1086778,1086835,57,-1,0,285498,1,1754.38596491228000000000
chr4,1419406,1421235,1829,-1,0,,0,0.00000000000000000000
chr4,1421097,1422220,1123,-1,0,,0,0.00000000000000000000
chr4,1533801,1631900,98099,-1,0,,0,0.00000000000000000000
chr4,1488301,1523000,34699,-1,0,,0,0.00000000000000000000
chr4,1609469,1611523,2054,-1,0,,0,0.00000000000000000000
chr4,1602728,1604023,1295,-1,0,,0,0.00000000000000000000
chr4,1872337,1873912,1575,-1,0,7468,1,63.49206349206350000000
chr4,1547401,1549048,1647,-1,0,,0,0.00000000000000000000
chr4,1603026,1603682,656,-1,0,,0,0.00000000000000000000
chr4,1557660,1558014,354,-1,0,,0,0.00000000000000000000
chr4,1559295,1559441,146,-1,0,,0,0.00000000000000000000
chr4,2058701,2083900,25199,-1,0,339983;353497,2,7.93682288979721000000
chr4,2059445,2063092,3647,-1,0,339983,1,27.41979709350150000000
chr4,2865700,2867703,2003,-1,0,118,1,49.92511233150280000000
chr4,2537341,2539317,1976,-1,0,,0,0.00000000000000000000
chr4,2397444,2398714,1270,-1,0,57732,1,78.74015748031500000000
chr4,2060387,2061782,1395,-1,0,339983,1,71.68458781362010000000
chr4,2263111,2264500,1389,-1,0,10608,1,71.99424046076310000000
chr4,2550358,2551304,946,-1,0,,0,0.00000000000000000000
chr4,2397806,2398525,719,-1,0,57732,1,139.08205841446500000000
chr4,2512933,2513513,580,-1,0,6047,1,172.41379310344800000000
chr4,2397915,2398208,293,-1,0,57732,1,341.29692832764500000000
chr4,2398239,2398493,254,-1,0,57732,1,393.70078740157500000000
chr4,2628975,2629201,226,-1,0,8603,1,442.47787610619500000000
chr4,2843410,2843583,173,-1,0,,0,0.00000000000000000000
chr4,2629112,2629259,147,-1,0,8603,1,680.27210884353700000000
chr4,3007043,3009193,2150,-1,0,2868,1,46.51162790697670000000
chr4,3018222,3018391,169,-1,0,2868,1,591.71597633136100000000
chr4,3310742,3312152,1410,-1,0,,0,0.00000000000000000000
chr4,3310727,3310998,271,-1,0,,0,0.00000000000000000000
chr4,3310886,3311044,158,-1,0,,0,0.00000000000000000000
chr4,3321464,3322504,1040,-1,0,6002,1,96.15384615384620000000
chr4,3341601,3343700,2099,-1,0,6002,1,47.64173415912340000000
chr4,3352545,3365502,12957,-1,0,6002,1,7.71783591880837000000
chr4,3389755,3390121,366,-1,0,6002,1,273.22404371584700000000
chr4,3414606,3415059,453,-1,0,6002,1,220.75055187638000000000
chr4,3445987,3450411,4424,-1,0,3083,1,22.60397830018080000000
chr4,3491899,3493267,1368,-1,0,285489,1,73.09941520467840000000
chr4,3492016,3492741,725,-1,0,285489,1,137.93103448275900000000
chr4,3484656,3485152,496,-1,0,285489,1,201.61290322580600000000
chr4,3484917,3485005,88,-1,0,285489,1,1136.36363636364000000000
chr4,3565871,3566561,690,-1,0,,0,0.00000000000000000000
chr4,3576298,3576735,437,-1,0,,0,0.00000000000000000000
chr4,3576465,3576573,108,-1,0,,0,0.00000000000000000000
chr4,3579862,3580261,399,-1,0,,0,0.00000000000000000000
chr4,3582007,3582100,93,-1,0,,0,0.00000000000000000000
chr4,3593507,3593608,101,-1,0,,0,0.00000000000000000000
chr4,3596612,3596980,368,-1,0,,0,0.00000000000000000000
chr4,3600577,3601585,1008,-1,0,,0,0.00000000000000000000
chr4,3601077,3601468,391,-1,0,,0,0.00000000000000000000
chr4,3612065,3612616,551,-1,0,,0,0.00000000000000000000
chr4,3613114,3618991,5877,-1,0,,0,0.00000000000000000000
chr4,3614983,3615289,306,-1,0,,0,0.00000000000000000000
chr4,3625960,3626360,400,-1,0,,0,0.00000000000000000000
chr4,3648541,3648711,170,-1,0,,0,0.00000000000000000000
chr4,3767441,3770446,3005,-1,0,152,1,33.27787021630620000000
chr4,3824705,3831802,7097,-1,0,,0,0.00000000000000000000
chr4,3827584,3828254,670,-1,0,,0,0.00000000000000000000
chr4,3827675,3828084,409,-1,0,,0,0.00000000000000000000
chr4,3827789,3827986,197,-1,0,,0,0.00000000000000000000
chr4,3861334,3861399,65,-1,0,,0,0.00000000000000000000
chr4,3893815,4172943,279128,-1,0,,0,0.00000000000000000000
chr4,3906544,3999145,92601,-1,0,,0,0.00000000000000000000
chr4,4114402,4156603,42201,-1,0,,0,0.00000000000000000000
chr4,4131782,4165332,33550,-1,0,,0,0.00000000000000000000
chr4,4138141,4149505,11364,-1,0,,0,0.00000000000000000000
chr4,4154471,4157121,2650,-1,0,,0,0.00000000000000000000
chr4,4131077,4132207,1130,-1,0,,0,0.00000000000000000000
chr4,4041172,4041581,409,-1,0,,0,0.00000000000000000000
chr4,4070537,4070684,147,-1,0,,0,0.00000000000000000000
chr4,4220468,4221239,771,-1,0,133060,1,129.70168612192000000000
chr4,4413924,4415860,1936,-1,0,27065,1,51.65289256198350000000
chr4,4568025,4568623,598,-1,0,,0,0.00000000000000000000
chr4,5145499,5145561,62,-1,0,55351,1,1612.90322580645000000000
chr4,5250130,5322284,72154,-1,0,55351,1,1.38592455026748000000
chr4,5292146,5297217,5071,-1,0,55351,1,19.71997633602840000000
chr4,5410893,5413700,2807,-1,0,55351,1,35.62522265764160000000
chr4,5764297,5783664,19367,-1,0,2121,1,5.16342231631125000000
chr4,5813507,5813565,58,-1,0,2121,1,1724.13793103448000000000
chr4,5834878,5835192,314,-1,0,1400,1,318.47133757961800000000
chr4,5889231,5896095,6864,-1,0,1400,1,14.56876456876460000000
chr4,6006196,6006344,148,-1,0,,0,0.00000000000000000000
chr4,6038567,6040260,1693,-1,0,152789,1,59.06674542232720000000
chr4,6108058,6112433,4375,-1,0,152789,1,22.85714285714290000000
chr4,6140067,6143170,3103,-1,0,152789,1,32.22687721559780000000
chr4,6172019,6172808,789,-1,0,152789,1,126.74271229404300000000
chr4,6172421,6172633,212,-1,0,152789,1,471.69811320754700000000
chr4,6331130,6331610,480,-1,0,5522,1,208.33333333333300000000
chr4,6422339,6424735,2396,-1,0,5522,1,41.73622704507510000000
chr4,6421828,6423503,1675,-1,0,5522,1,59.70149253731340000000
chr4,6617871,6621900,4029,-1,0,23324,1,24.82005460412010000000
chr4,6624425,6626672,2247,-1,0,,0,0.00000000000000000000
chr4,6651586,6652717,1131,-1,0,,0,0.00000000000000000000
chr4,6652051,6652726,675,-1,0,,0,0.00000000000000000000
chr4,6682393,6685862,3469,-1,0,,0,0.00000000000000000000
chr4,6682532,6685557,3025,-1,0,,0,0.00000000000000000000
chr4,6784040,6785591,1551,-1,0,9778,1,64.47453255963890000000
chr4,6896871,6900514,3643,-1,0,,0,0.00000000000000000000
chr4,6897468,6899571,2103,-1,0,,0,0.00000000000000000000
chr4,6894799,6896020,1221,-1,0,,0,0.00000000000000000000
chr4,7021337,7021806,469,-1,0,57533,1,213.21961620469100000000
chr4,7043819,7045801,1982,-1,0,93624;257236,2,100.90817356205900000000
chr4,7145951,7149866,3915,-1,0,,0,0.00000000000000000000
chr4,7162816,7163070,254,-1,0,,0,0.00000000000000000000
chr4,7167044,7167284,240,-1,0,,0,0.00000000000000000000
chr4,7182392,7187495,5103,-1,0,,0,0.00000000000000000000
chr4,7257589,7257694,105,-1,0,57537,1,952.38095238095300000000
chr4,7257546,7257630,84,-1,0,57537,1,1190.47619047619000000000
chr4,7338096,7338504,408,-1,0,57537,1,245.09803921568600000000
chr4,7454282,7457591,3309,-1,0,57537,1,30.22061045633120000000
chr4,7443352,7444676,1324,-1,0,57537,1,75.52870090634440000000
chr4,7483666,7484557,891,-1,0,57537,1,112.23344556677900000000
chr4,7489563,7491696,2133,-1,0,57537,1,46.88232536333800000000
chr4,7497366,7499354,1988,-1,0,57537,1,50.30181086519120000000
chr4,7524294,7524838,544,-1,0,57537,1,183.82352941176500000000
chr4,7524422,7524667,245,-1,0,57537,1,408.16326530612200000000
chr4,7567542,7567947,405,-1,0,57537,1,246.91358024691400000000
chr4,7598680,7599792,1112,-1,0,57537,1,89.92805755395680000000
chr4,7635492,7635857,365,-1,0,57537,1,273.97260273972600000000
chr4,7635511,7635852,341,-1,0,57537,1,293.25513196480900000000
chr4,7678518,7678659,141,-1,0,57537,1,709.21985815602800000000
chr4,7707737,7708677,940,-1,0,57537,1,106.38297872340400000000
chr4,7726057,7726824,767,-1,0,57537,1,130.37809647979100000000
chr4,7750403,7750477,74,-1,0,,0,0.00000000000000000000
chr4,7797573,7799180,1607,-1,0,60312,1,62.22775357809580000000
chr4,7799704,7800265,561,-1,0,60312,1,178.25311942959000000000
chr4,7836458,7837826,1368,-1,0,60312,1,73.09941520467840000000
chr4,7901894,7902318,424,-1,0,60312,1,235.84905660377400000000
chr4,7938078,7938334,256,-1,0,60312,1,390.62500000000000000000
chr4,7970702,7975121,4419,-1,0,84448,1,22.62955419778230000000
chr4,7995732,7997027,1295,-1,0,84448,1,77.22007722007720000000
chr4,8133334,8133641,307,-1,0,84448,1,325.73289902280100000000
chr4,8165236,8174230,8994,-1,0,,0,0.00000000000000000000
chr4,8212388,8214106,1718,-1,0,54436,1,58.20721769499420000000
chr4,8271224,8272065,841,-1,0,94031,1,118.90606420927500000000
chr4,8366033,8366462,429,-1,0,,0,0.00000000000000000000
chr4,8394973,8395251,278,-1,0,8310,1,359.71223021582700000000
chr4,8395023,8395194,171,-1,0,8310,1,584.79532163742700000000
chr4,8186649,8186699,50,-1,0,,0,0.00000000000000000000
chr4,8621975,8639072,17097,-1,0,,0,0.00000000000000000000
chr4,8778620,8778849,229,-1,0,,0,0.00000000000000000000
chr4,8920579,8920807,228,-1,0,,0,0.00000000000000000000
chr4,9371159,9477677,106518,-1,0,644414,1,0.93880846429711400000
chr4,9450218,9515411,65193,-1,0,644414,1,1.53390701455678000000
chr4,9157676,9215992,58316,-1,0,100287144,1,1.71479525344674000000
chr4,9433995,9480784,46789,-1,0,644414,1,2.13725448289128000000
chr4,9370853,9411056,40203,-1,0,,0,0.00000000000000000000
chr4,9416580,9457111,40531,-1,0,644414,1,2.46724729219610000000
chr4,9486907,9516088,29181,-1,0,,0,0.00000000000000000000
chr4,9456001,9483498,27497,-1,0,,0,0.00000000000000000000
chr4,8976920,9000788,23868,-1,0,,0,0.00000000000000000000
chr4,9104599,9126453,21854,-1,0,,0,0.00000000000000000000
chr4,9388247,9405927,17680,-1,0,,0,0.00000000000000000000
chr4,9618919,9632893,13974,-1,0,,0,0.00000000000000000000
chr4,9620809,9629843,9034,-1,0,,0,0.00000000000000000000
chr4,9477410,9484321,6911,-1,0,,0,0.00000000000000000000
chr4,9625982,9631674,5692,-1,0,,0,0.00000000000000000000
chr4,9472335,9477226,4891,-1,0,,0,0.00000000000000000000
chr4,9474443,9478913,4470,-1,0,,0,0.00000000000000000000
chr4,9474433,9477204,2771,-1,0,,0,0.00000000000000000000
chr4,9506478,9509043,2565,-1,0,,0,0.00000000000000000000
chr4,9492915,9495119,2204,-1,0,,0,0.00000000000000000000
chr4,8958655,8960906,2251,-1,0,,0,0.00000000000000000000
chr4,9475350,9476660,1310,-1,0,,0,0.00000000000000000000
chr4,9475748,9476199,451,-1,0,,0,0.00000000000000000000
chr4,9576977,9577450,473,-1,0,,0,0.00000000000000000000
chr4,9572958,9573292,334,-1,0,,0,0.00000000000000000000
chr4,9573061,9573171,110,-1,0,,0,0.00000000000000000000
chr4,9688910,9688981,71,-1,0,,0,0.00000000000000000000
chr4,9754540,9757550,3010,-1,0,,0,0.00000000000000000000
chr4,9863690,9865968,2278,-1,0,56606,1,43.89815627743630000000
chr4,9952183,9952659,476,-1,0,56606,1,210.08403361344500000000
chr4,9952279,9952544,265,-1,0,56606,1,377.35849056603800000000
chr4,9956695,9957263,568,-1,0,56606,1,176.05633802816900000000
chr4,9956825,9957149,324,-1,0,56606,1,308.64197530864200000000
chr4,10119045,10119462,417,-1,0,,0,0.00000000000000000000
chr4,10134738,10140489,5751,-1,0,,0,0.00000000000000000000
chr4,10135855,10136950,1095,-1,0,,0,0.00000000000000000000
chr4,10132975,10133519,544,-1,0,,0,0.00000000000000000000
chr4,10147105,10147678,573,-1,0,,0,0.00000000000000000000
chr4,10136007,10136518,511,-1,0,,0,0.00000000000000000000
chr4,10136415,10136721,306,-1,0,,0,0.00000000000000000000
chr4,10147153,10147346,193,-1,0,,0,0.00000000000000000000
chr4,10211206,10234627,23421,-1,0,,0,0.00000000000000000000
chr4,10212799,10233093,20294,-1,0,,0,0.00000000000000000000
chr4,10223825,10240423,16598,-1,0,,0,0.00000000000000000000
chr4,10193187,10206593,13406,-1,0,,0,0.00000000000000000000
chr4,10217996,10232986,14990,-1,0,,0,0.00000000000000000000
chr4,10259353,10281767,22414,-1,0,,0,0.00000000000000000000
chr4,10272092,10274272,2180,-1,0,,0,0.00000000000000000000
chr4,10272785,10274872,2087,-1,0,,0,0.00000000000000000000
chr4,10325615,10338595,12980,-1,0,,0,0.00000000000000000000
chr4,10388701,10401872,13171,-1,0,,0,0.00000000000000000000
chr4,10399635,10409036,9401,-1,0,,0,0.00000000000000000000
chr4,10392548,10402302,9754,-1,0,,0,0.00000000000000000000
chr4,10397347,10401763,4416,-1,0,,0,0.00000000000000000000
chr4,10398958,10399896,938,-1,0,,0,0.00000000000000000000
chr4,10544773,10552865,8092,-1,0,116449,1,12.35788433020270000000
chr4,10655614,10655698,84,-1,0,116449,1,1190.47619047619000000000
chr4,12132786,12242027,109241,-1,0,,0,0.00000000000000000000
chr4,10709164,10784711,75547,-1,0,,0,0.00000000000000000000
chr4,11489515,11520286,30771,-1,0,,0,0.00000000000000000000
chr4,11303072,11333232,30160,-1,0,,0,0.00000000000000000000
chr4,12365865,12385875,20010,-1,0,,0,0.00000000000000000000
chr4,11965435,11978288,12853,-1,0,,0,0.00000000000000000000
chr4,12153942,12162848,8906,-1,0,,0,0.00000000000000000000
chr4,11666554,11670727,4173,-1,0,,0,0.00000000000000000000
chr4,12159337,12162880,3543,-1,0,,0,0.00000000000000000000
chr4,12153838,12157170,3332,-1,0,,0,0.00000000000000000000
chr4,11640199,11642196,1997,-1,0,,0,0.00000000000000000000
chr4,12326730,12328020,1290,-1,0,,0,0.00000000000000000000
chr4,11041502,11042656,1154,-1,0,,0,0.00000000000000000000
chr4,11935337,11936120,783,-1,0,,0,0.00000000000000000000
chr4,12649926,12650531,605,-1,0,,0,0.00000000000000000000
chr4,12109413,12109933,520,-1,0,,0,0.00000000000000000000
chr4,11193245,11193701,456,-1,0,,0,0.00000000000000000000
chr4,10912129,10912540,411,-1,0,,0,0.00000000000000000000
chr4,11877401,11877482,81,-1,0,,0,0.00000000000000000000
chr4,13063675,13063954,279,-1,0,,0,0.00000000000000000000
chr4,13145169,13147601,2432,-1,0,,0,0.00000000000000000000
chr4,13380640,13382234,1594,-1,0,9364,1,62.73525721455460000000
chr4,13636232,13636749,517,-1,0,,0,0.00000000000000000000
chr4,14188750,14188828,78,-1,0,,0,0.00000000000000000000
chr4,14376133,14377214,1081,-1,0,,0,0.00000000000000000000
chr4,14391086,14391313,227,-1,0,,0,0.00000000000000000000
chr4,14681656,14683646,1990,-1,0,,0,0.00000000000000000000
chr4,14837437,14839380,1943,-1,0,,0,0.00000000000000000000
chr4,14916204,14916301,97,-1,0,,0,0.00000000000000000000
chr4,15003574,15006960,3386,-1,0,132864,1,29.53337271116360000000
chr4,15214210,15214622,412,-1,0,,0,0.00000000000000000000
chr4,15214346,15214447,101,-1,0,,0,0.00000000000000000000
chr4,15214403,15214476,73,-1,0,,0,0.00000000000000000000
chr4,15658294,15658632,338,-1,0,,0,0.00000000000000000000
chr4,15705044,15706579,1535,-1,0,683,1,65.14657980456030000000
chr4,15760335,15768796,8461,-1,0,,0,0.00000000000000000000
chr4,15861199,15861867,668,-1,0,,0,0.00000000000000000000
chr4,16153345,16154370,1025,-1,0,,0,0.00000000000000000000
chr4,16227560,16228537,977,-1,0,202018,1,102.35414534288600000000
chr4,16336481,16376281,39800,-1,0,,0,0.00000000000000000000
chr4,16426702,16427197,495,-1,0,,0,0.00000000000000000000
chr4,16444171,16460851,16680,-1,0,,0,0.00000000000000000000
chr4,16675625,16677295,1670,-1,0,9079,1,59.88023952095810000000
chr4,16811857,16812788,931,-1,0,9079,1,107.41138560687400000000
chr4,16812042,16812592,550,-1,0,9079,1,181.81818181818200000000
chr4,16812104,16812333,229,-1,0,9079,1,436.68122270742400000000
chr4,16812222,16812314,92,-1,0,9079,1,1086.95652173913000000000
chr4,16942688,16951523,8835,-1,0,,0,0.00000000000000000000
chr4,17036070,17040165,4095,-1,0,,0,0.00000000000000000000
chr4,17202663,17203197,534,-1,0,,0,0.00000000000000000000
chr4,17202765,17203075,310,-1,0,,0,0.00000000000000000000
chr4,17461124,17461569,445,-1,0,,0,0.00000000000000000000
chr4,17543412,17569298,25886,-1,0,,0,0.00000000000000000000
chr4,17592930,17595472,2542,-1,0,51056,1,39.33910306845000000000
chr4,18537495,18549185,11690,-1,0,,0,0.00000000000000000000
chr4,18613276,18614347,1071,-1,0,,0,0.00000000000000000000
chr4,18670610,18688137,17527,-1,0,,0,0.00000000000000000000
chr4,18671055,18675303,4248,-1,0,,0,0.00000000000000000000
chr4,18754662,18754922,260,-1,0,,0,0.00000000000000000000
chr4,18769417,18769868,451,-1,0,,0,0.00000000000000000000
chr4,18831390,18941797,110407,-1,0,,0,0.00000000000000000000
chr4,18938096,18981986,43890,-1,0,,0,0.00000000000000000000
chr4,19088415,19126229,37814,-1,0,,0,0.00000000000000000000
chr4,19079196,19085743,6547,-1,0,,0,0.00000000000000000000
chr4,19330902,19333583,2681,-1,0,,0,0.00000000000000000000
chr4,19057441,19057990,549,-1,0,,0,0.00000000000000000000
chr4,19376078,19376206,128,-1,0,,0,0.00000000000000000000
chr4,19357546,19357633,87,-1,0,,0,0.00000000000000000000
chr4,19643015,19643570,555,-1,0,,0,0.00000000000000000000
chr4,19643118,19643463,345,-1,0,,0,0.00000000000000000000
chr4,19735119,19739695,4576,-1,0,,0,0.00000000000000000000
chr4,19870239,19871688,1449,-1,0,,0,0.00000000000000000000
chr4,19987375,19998147,10772,-1,0,,0,0.00000000000000000000
chr4,20081451,20081556,105,-1,0,,0,0.00000000000000000000
chr4,20082550,20088902,6352,-1,0,,0,0.00000000000000000000
chr4,20158166,20162386,4220,-1,0,,0,0.00000000000000000000
chr4,20195534,20196606,1072,-1,0,,0,0.00000000000000000000
chr4,20407588,20408549,961,-1,0,9353,1,104.05827263267400000000
chr4,20474752,20474871,119,-1,0,9353,1,840.33613445378100000000
chr4,20555807,20566111,10304,-1,0,9353,1,9.70496894409938000000
chr4,20933574,20933979,405,-1,0,80333,1,246.91358024691400000000
chr4,20933542,20933641,99,-1,0,80333,1,1010.10101010101000000000
chr4,21081049,21086622,5573,-1,0,80333,1,17.94365691727970000000
chr4,21160081,21167573,7492,-1,0,80333,1,13.34757074212490000000
chr4,21292927,21293047,120,-1,0,80333,1,833.33333333333300000000
chr4,21334214,21359269,25055,-1,0,80333,1,3.99121931750150000000
chr4,21363940,21377068,13128,-1,0,80333,1,7.61730652041438000000
chr4,21370612,21386689,16077,-1,0,80333,1,6.22006593269889000000
chr4,21368994,21377246,8252,-1,0,80333,1,12.11827435773150000000
chr4,21517327,21581533,64206,-1,0,80333,1,1.55748683923621000000
chr4,21543201,21566000,22799,-1,0,80333,1,4.38615728760033000000
chr4,21447784,21467369,19585,-1,0,80333,1,5.10594842992086000000
chr4,21457121,21461121,4000,-1,0,80333,1,25.00000000000000000000
chr4,21456081,21458371,2290,-1,0,80333,1,43.66812227074240000000
chr4,21457505,21458404,899,-1,0,80333,1,111.23470522803100000000
chr4,21694583,21694989,406,-1,0,80333,1,246.30541871921200000000
chr4,21494694,21495131,437,-1,0,80333,1,228.83295194508000000000
chr4,21694731,21694938,207,-1,0,80333,1,483.09178743961300000000
chr4,21521140,21521261,121,-1,0,80333,1,826.44628099173600000000
chr4,21758582,21759124,542,-1,0,80333,1,184.50184501845000000000
chr4,21758792,21758928,136,-1,0,80333,1,735.29411764705900000000
chr4,21758728,21758827,99,-1,0,80333,1,1010.10101010101000000000
chr4,22048651,22073713,25062,-1,0,,0,0.00000000000000000000
chr4,22075966,22077538,1572,-1,0,,0,0.00000000000000000000
chr4,22275313,22276133,820,-1,0,,0,0.00000000000000000000
chr4,22432891,22432952,61,-1,0,166647,1,1639.34426229508000000000
chr4,22495659,22497366,1707,-1,0,166647,1,58.58230814294080000000
chr4,22501920,22502349,429,-1,0,166647,1,233.10023310023300000000
chr4,22502064,22502162,98,-1,0,166647,1,1020.40816326531000000000
chr4,22601286,22606346,5060,-1,0,,0,0.00000000000000000000
chr4,22663113,22666265,3152,-1,0,,0,0.00000000000000000000
chr4,22922122,22923739,1617,-1,0,,0,0.00000000000000000000
chr4,23129264,23131861,2597,-1,0,,0,0.00000000000000000000
chr4,23417044,23419580,2536,-1,0,,0,0.00000000000000000000
chr4,23527294,23571569,44275,-1,0,,0,0.00000000000000000000
chr4,23679829,23681106,1277,-1,0,,0,0.00000000000000000000
chr4,23721648,23722028,380,-1,0,,0,0.00000000000000000000
chr4,24189770,24191882,2112,-1,0,10891,1,47.34848484848490000000
chr4,24294010,24295455,1445,-1,0,10891,1,69.20415224913490000000
chr4,24503111,24504240,1129,-1,0,,0,0.00000000000000000000
chr4,24966275,24967437,1162,-1,0,91050,1,86.05851979345960000000
chr4,24966458,24967136,678,-1,0,91050,1,147.49262536873200000000
chr4,24992951,24995279,2328,-1,0,,0,0.00000000000000000000
chr4,25241049,25241190,141,-1,0,55300,1,709.21985815602800000000
chr4,25471083,25472624,1541,-1,0,,0,0.00000000000000000000
chr4,25497032,25497481,449,-1,0,,0,0.00000000000000000000
chr4,25497135,25497453,318,-1,0,,0,0.00000000000000000000
chr4,25501696,25509005,7309,-1,0,,0,0.00000000000000000000
chr4,25580886,25581351,465,-1,0,,0,0.00000000000000000000
chr4,25617233,25621736,4503,-1,0,,0,0.00000000000000000000
chr4,25711962,25735885,23923,-1,0,,0,0.00000000000000000000
chr4,25964201,25983682,19481,-1,0,,0,0.00000000000000000000
chr4,26057630,26058283,653,-1,0,,0,0.00000000000000000000
chr4,26255174,26256313,1139,-1,0,,0,0.00000000000000000000
chr4,26290326,26295519,5193,-1,0,,0,0.00000000000000000000
chr4,26442742,26454210,11468,-1,0,,0,0.00000000000000000000
chr4,26528303,26528581,278,-1,0,,0,0.00000000000000000000
chr4,26955852,26958584,2732,-1,0,57620,1,36.60322108345530000000
chr4,26955957,26957505,1548,-1,0,57620,1,64.59948320413440000000
chr4,27411969,27414641,2672,-1,0,,0,0.00000000000000000000
chr4,27417020,27417436,416,-1,0,,0,0.00000000000000000000
chr4,27499771,27558597,58826,-1,0,,0,0.00000000000000000000
chr4,27543891,27543955,64,-1,0,,0,0.00000000000000000000
chr4,27627538,27627588,50,-1,0,,0,0.00000000000000000000
chr4,27834433,27834487,54,-1,0,,0,0.00000000000000000000
chr4,28055506,28059312,3806,-1,0,,0,0.00000000000000000000
chr4,28420488,28422683,2195,-1,0,,0,0.00000000000000000000
chr4,28421488,28422040,552,-1,0,,0,0.00000000000000000000
chr4,28421589,28421940,351,-1,0,,0,0.00000000000000000000
chr4,28511966,28513192,1226,-1,0,,0,0.00000000000000000000
chr4,28564278,28564646,368,-1,0,,0,0.00000000000000000000
chr4,28590281,28590335,54,-1,0,,0,0.00000000000000000000
chr4,28640354,28737228,96874,-1,0,,0,0.00000000000000000000
chr4,28943742,28953198,9456,-1,0,,0,0.00000000000000000000
chr4,28960012,28964406,4394,-1,0,,0,0.00000000000000000000
chr4,28997256,28997651,395,-1,0,,0,0.00000000000000000000
chr4,29034062,29040300,6238,-1,0,,0,0.00000000000000000000
chr4,29226564,29233980,7416,-1,0,,0,0.00000000000000000000
chr4,29310207,29320370,10163,-1,0,,0,0.00000000000000000000
chr4,29461002,29462192,1190,-1,0,,0,0.00000000000000000000
chr4,29661015,29661564,549,-1,0,,0,0.00000000000000000000
chr4,29661119,29661451,332,-1,0,,0,0.00000000000000000000
chr4,29715277,29715362,85,-1,0,,0,0.00000000000000000000
chr4,29927879,29932217,4338,-1,0,,0,0.00000000000000000000
chr4,30151421,30152519,1098,-1,0,,0,0.00000000000000000000
chr4,30279785,30280136,351,-1,0,,0,0.00000000000000000000
chr4,30057529,30057892,363,-1,0,,0,0.00000000000000000000
chr4,30127758,30128075,317,-1,0,,0,0.00000000000000000000
chr4,30683245,30683436,191,-1,0,,0,0.00000000000000000000
chr4,30819213,30830142,10929,-1,0,5099,1,9.14996797511209000000
chr4,31013955,31014966,1011,-1,0,5099,1,98.91196834817010000000
chr4,31035120,31035911,791,-1,0,5099,1,126.42225031605600000000
chr4,31205709,31206244,535,-1,0,,0,0.00000000000000000000
chr4,31205803,31206129,326,-1,0,,0,0.00000000000000000000
chr4,31218694,31219425,731,-1,0,,0,0.00000000000000000000
chr4,31337995,31339175,1180,-1,0,,0,0.00000000000000000000
chr4,31338344,31338809,465,-1,0,,0,0.00000000000000000000
chr4,31338470,31338697,227,-1,0,,0,0.00000000000000000000
chr4,31355160,31355273,113,-1,0,,0,0.00000000000000000000
chr4,31406519,31407325,806,-1,0,,0,0.00000000000000000000
chr4,31406646,31407046,400,-1,0,,0,0.00000000000000000000
chr4,31463509,31469537,6028,-1,0,,0,0.00000000000000000000
chr4,31447935,31450551,2616,-1,0,,0,0.00000000000000000000
chr4,31492862,31493299,437,-1,0,,0,0.00000000000000000000
chr4,31688552,31689910,1358,-1,0,,0,0.00000000000000000000
chr4,31906156,31918742,12586,-1,0,,0,0.00000000000000000000
chr4,32065858,32074551,8693,-1,0,,0,0.00000000000000000000
chr4,32479000,32482798,3798,-1,0,,0,0.00000000000000000000
chr4,32070960,32074492,3532,-1,0,,0,0.00000000000000000000
chr4,32518240,32520485,2245,-1,0,,0,0.00000000000000000000
chr4,32321429,32324114,2685,-1,0,,0,0.00000000000000000000
chr4,31914419,31916292,1873,-1,0,,0,0.00000000000000000000
chr4,32137700,32138925,1225,-1,0,,0,0.00000000000000000000
chr4,32251051,32251803,752,-1,0,,0,0.00000000000000000000
chr4,32540481,32541040,559,-1,0,,0,0.00000000000000000000
chr4,32072877,32073314,437,-1,0,,0,0.00000000000000000000
chr4,32540600,32540915,315,-1,0,,0,0.00000000000000000000
chr4,32329235,32329348,113,-1,0,,0,0.00000000000000000000
chr4,32781829,32787670,5841,-1,0,,0,0.00000000000000000000
chr4,32965130,32966081,951,-1,0,,0,0.00000000000000000000
chr4,33036232,33036498,266,-1,0,,0,0.00000000000000000000
chr4,33065190,33073296,8106,-1,0,,0,0.00000000000000000000
chr4,33085119,33085728,609,-1,0,,0,0.00000000000000000000
chr4,33299864,33303979,4115,-1,0,,0,0.00000000000000000000
chr4,33377630,33386835,9205,-1,0,,0,0.00000000000000000000
chr4,33473403,33473743,340,-1,0,,0,0.00000000000000000000
chr4,33846013,33846351,338,-1,0,,0,0.00000000000000000000
chr4,33847184,33848220,1036,-1,0,,0,0.00000000000000000000
chr4,34780503,34837625,57122,-1,0,,0,0.00000000000000000000
chr4,35374688,35415656,40968,-1,0,,0,0.00000000000000000000
chr4,34776815,34815200,38385,-1,0,,0,0.00000000000000000000
chr4,35671652,35718133,46481,-1,0,,0,0.00000000000000000000
chr4,34789471,34825031,35560,-1,0,,0,0.00000000000000000000
chr4,34645551,34665669,20118,-1,0,,0,0.00000000000000000000
chr4,35848018,35856604,8586,-1,0,,0,0.00000000000000000000
chr4,34118376,34126095,7719,-1,0,,0,0.00000000000000000000
chr4,35146795,35152244,5449,-1,0,,0,0.00000000000000000000
chr4,35105607,35111254,5647,-1,0,,0,0.00000000000000000000
chr4,35240069,35244589,4520,-1,0,,0,0.00000000000000000000
chr4,35694024,35698408,4384,-1,0,,0,0.00000000000000000000
chr4,35848351,35851406,3055,-1,0,,0,0.00000000000000000000
chr4,35240233,35242515,2282,-1,0,,0,0.00000000000000000000
chr4,34489251,34491671,2420,-1,0,,0,0.00000000000000000000
chr4,34345613,34347703,2090,-1,0,,0,0.00000000000000000000
chr4,34956540,34958157,1617,-1,0,,0,0.00000000000000000000
chr4,35873512,35875450,1938,-1,0,,0,0.00000000000000000000
chr4,35495310,35496885,1575,-1,0,,0,0.00000000000000000000
chr4,35240809,35242028,1219,-1,0,,0,0.00000000000000000000
chr4,36020524,36021276,752,-1,0,,0,0.00000000000000000000
chr4,36469802,36470366,564,-1,0,,0,0.00000000000000000000
chr4,34121729,34122460,731,-1,0,,0,0.00000000000000000000
chr4,35849606,35850120,514,-1,0,,0,0.00000000000000000000
chr4,35884487,35884956,469,-1,0,,0,0.00000000000000000000
chr4,35740139,35740524,385,-1,0,,0,0.00000000000000000000
chr4,34531616,34531950,334,-1,0,,0,0.00000000000000000000
chr4,36469914,36470255,341,-1,0,,0,0.00000000000000000000
chr4,34268236,34268336,100,-1,0,,0,0.00000000000000000000
chr4,35907726,35907811,85,-1,0,,0,0.00000000000000000000
chr4,34573413,34573487,74,-1,0,,0,0.00000000000000000000
chr4,35849855,35849927,72,-1,0,,0,0.00000000000000000000
chr4,36512732,36583278,70546,-1,0,,0,0.00000000000000000000
chr4,36652566,36652676,110,-1,0,,0,0.00000000000000000000
chr4,36671786,36673838,2052,-1,0,,0,0.00000000000000000000
chr4,36715675,36715912,237,-1,0,,0,0.00000000000000000000
chr4,36715811,36715929,118,-1,0,,0,0.00000000000000000000
chr4,36842746,36843193,447,-1,0,,0,0.00000000000000000000
chr4,36914171,36927622,13451,-1,0,,0,0.00000000000000000000
chr4,37038645,37038819,174,-1,0,,0,0.00000000000000000000
chr4,37125923,37125980,57,-1,0,,0,0.00000000000000000000
chr4,37179635,37184312,4677,-1,0,,0,0.00000000000000000000
chr4,37332010,37333345,1335,-1,0,57495,1,74.90636704119850000000
chr4,37332821,37332903,82,-1,0,57495,1,1219.51219512195000000000
chr4,37462570,37463776,1206,-1,0,55286,1,82.91873963515760000000
chr4,37483081,37483139,58,-1,0,55286,1,1724.13793103448000000000
chr4,37554640,37555038,398,-1,0,55286,1,251.25628140703500000000
chr4,37739604,37739659,55,-1,0,,0,0.00000000000000000000
chr4,37766281,37766610,329,-1,0,,0,0.00000000000000000000
chr4,37885197,37886128,931,-1,0,,0,0.00000000000000000000
chr4,38264230,38265517,1287,-1,0,,0,0.00000000000000000000
chr4,38264300,38265495,1195,-1,0,,0,0.00000000000000000000
chr4,38264703,38265271,568,-1,0,,0,0.00000000000000000000
chr4,38464493,38539833,75340,-1,0,,0,0.00000000000000000000
chr4,38456138,38468203,12065,-1,0,,0,0.00000000000000000000
chr4,38664781,38666768,1987,-1,0,51274,1,50.32712632108710000000
chr4,38810983,38864430,53447,-1,0,10333,1,1.87101240481224000000
chr4,39031000,39031477,477,-1,0,80008,1,209.64360587002100000000
chr4,39031067,39031361,294,-1,0,80008,1,340.13605442176900000000
chr4,39046330,39047018,688,-1,0,51088,1,145.34883720930200000000
chr4,39400104,39400165,61,-1,0,,0,0.00000000000000000000
chr4,39424489,39426352,1863,-1,0,152831,1,53.67686527106820000000
chr4,39495364,39498164,2800,-1,0,,0,0.00000000000000000000
chr4,39539154,39539866,712,-1,0,,0,0.00000000000000000000
chr4,39583964,39589294,5330,-1,0,201895,1,18.76172607879920000000
chr4,39586561,39589162,2601,-1,0,201895,1,38.44675124951940000000
chr4,39704159,39714060,9901,-1,0,3093,1,10.09998990001010000000
chr4,39707736,39712071,4335,-1,0,3093,1,23.06805074971160000000
chr4,39716119,39718048,1929,-1,0,3093,1,51.84033177812340000000
chr4,39707370,39707533,163,-1,0,3093,1,613.49693251533700000000
chr4,39809188,39809440,252,-1,0,,0,0.00000000000000000000
chr4,39814318,39816583,2265,-1,0,,0,0.00000000000000000000
chr4,39968353,39969866,1513,-1,0,23244,1,66.09385327164570000000
chr4,39971205,39972856,1651,-1,0,23244,1,60.56935190793460000000
chr4,39978483,39979638,1155,-1,0,23244,1,86.58008658008660000000
chr4,39994736,39997848,3112,-1,0,,0,0.00000000000000000000
chr4,40010564,40010882,318,-1,0,,0,0.00000000000000000000
chr4,40024745,40026744,1999,-1,0,,0,0.00000000000000000000
chr4,40024925,40026278,1353,-1,0,,0,0.00000000000000000000
chr4,40028253,40028990,737,-1,0,,0,0.00000000000000000000
chr4,40568399,40575539,7140,-1,0,54502,1,14.00560224089640000000
chr4,40635615,40637207,1592,-1,0,,0,0.00000000000000000000
chr4,40643465,40656659,13194,-1,0,,0,0.00000000000000000000
chr4,40677099,40678135,1036,-1,0,,0,0.00000000000000000000
chr4,41068087,41068208,121,-1,0,323,1,826.44628099173600000000
chr4,41227459,41232146,4687,-1,0,,0,0.00000000000000000000
chr4,41406187,41407949,1762,-1,0,22998,1,56.75368898978430000000
chr4,41444678,41445695,1017,-1,0,22998,1,98.32841691248770000000
chr4,41444986,41445526,540,-1,0,22998,1,185.18518518518500000000
chr4,41445194,41445308,114,-1,0,22998,1,877.19298245614000000000
chr4,41458212,41466966,8754,-1,0,22998,1,11.42334932602240000000
chr4,41960548,41961053,505,-1,0,55161,1,198.01980198019800000000
chr4,41969869,41977776,7907,-1,0,,0,0.00000000000000000000
chr4,42023852,42024153,301,-1,0,10463,1,332.22591362126200000000
chr4,42023931,42024099,168,-1,0,10463,1,595.23809523809500000000
chr4,42360467,42361288,821,-1,0,,0,0.00000000000000000000
chr4,42654903,42655052,149,-1,0,10396,1,671.14093959731500000000
chr4,42697553,42709312,11759,-1,0,,0,0.00000000000000000000
chr4,42706125,42709476,3351,-1,0,,0,0.00000000000000000000
chr4,42762069,42773549,11480,-1,0,,0,0.00000000000000000000
chr4,42762664,42769543,6879,-1,0,,0,0.00000000000000000000
chr4,42905161,42905859,698,-1,0,389207,1,143.26647564469900000000
chr4,43266811,43274565,7754,-1,0,,0,0.00000000000000000000
chr4,43269150,43269929,779,-1,0,,0,0.00000000000000000000
chr4,43444096,43444490,394,-1,0,,0,0.00000000000000000000
chr4,43630243,43674337,44094,-1,0,,0,0.00000000000000000000
chr4,43739676,43741838,2162,-1,0,,0,0.00000000000000000000
chr4,43751691,43752217,526,-1,0,,0,0.00000000000000000000
chr4,43882647,43885125,2478,-1,0,,0,0.00000000000000000000
chr4,43931385,43931949,564,-1,0,,0,0.00000000000000000000
chr4,43931493,43931834,341,-1,0,,0,0.00000000000000000000
chr4,44018263,44027189,8926,-1,0,,0,0.00000000000000000000
chr4,44022270,44026190,3920,-1,0,,0,0.00000000000000000000
chr4,44018785,44018993,208,-1,0,,0,0.00000000000000000000
chr4,44018852,44018962,110,-1,0,,0,0.00000000000000000000
chr4,44191228,44191664,436,-1,0,386617,1,229.35779816513800000000
chr4,44292721,44374454,81733,-1,0,386617,1,1.22349601752046000000
chr4,44323848,44331509,7661,-1,0,386617,1,13.05312622373060000000
chr4,44397375,44407987,10612,-1,0,386617,1,9.42329438371655000000
chr4,44487452,44489510,2058,-1,0,,0,0.00000000000000000000
chr4,44507220,44507780,560,-1,0,,0,0.00000000000000000000
chr4,44509283,44509822,539,-1,0,,0,0.00000000000000000000
chr4,44509386,44509703,317,-1,0,,0,0.00000000000000000000
chr4,44971995,44972168,173,-1,0,,0,0.00000000000000000000
chr4,44870720,44870909,189,-1,0,,0,0.00000000000000000000
chr4,45025721,45026389,668,-1,0,,0,0.00000000000000000000
chr4,45028337,45028534,197,-1,0,,0,0.00000000000000000000
chr4,45520808,45527849,7041,-1,0,,0,0.00000000000000000000
chr4,45860153,45862748,2595,-1,0,,0,0.00000000000000000000
chr4,46055832,46058500,2668,-1,0,2565,1,37.48125937031480000000
chr4,46202794,46205027,2233,-1,0,,0,0.00000000000000000000
chr4,46226319,46235270,8951,-1,0,,0,0.00000000000000000000
chr4,46796992,46799146,2154,-1,0,170712,1,46.42525533890440000000
chr4,47423118,47424238,1120,-1,0,2560,1,89.28571428571430000000
chr4,47487653,47488070,417,-1,0,57205,1,239.80815347721800000000
chr4,47487830,47487882,52,-1,0,57205,1,1923.07692307692000000000
chr4,47612088,47616516,4428,-1,0,10699,1,22.58355916892500000000
chr4,47669628,47678341,8713,-1,0,10699,1,11.47710317915760000000
chr4,47977899,47978810,911,-1,0,1259,1,109.76948408342500000000
chr4,47978048,47978478,430,-1,0,1259,1,232.55813953488400000000
chr4,47978244,47978389,145,-1,0,1259,1,689.65517241379300000000
chr4,47991693,47992069,376,-1,0,1259,1,265.95744680851100000000
chr4,48094372,48094827,455,-1,0,7294,1,219.78021978022000000000
chr4,48094558,48094633,75,-1,0,7294,1,1333.33333333333000000000
chr4,48106314,48106607,293,-1,0,7294,1,341.29692832764500000000
chr4,48122167,48122241,74,-1,0,7294,1,1351.35135135135000000000
chr4,48414327,48414549,222,-1,0,57606,1,450.45045045045000000000
chr4,48660875,48662778,1903,-1,0,285527,1,52.54860746190230000000
chr4,48661380,48661958,578,-1,0,285527,1,173.01038062283700000000
chr4,48718211,48722238,4027,-1,0,285527,1,24.83238142537870000000
chr4,48922482,48925326,2844,-1,0,,0,0.00000000000000000000
chr4,48980138,48995708,15570,-1,0,80157,1,6.42260757867694000000
chr4,49116776,49649176,532400,-1,0,,0,0.00000000000000000000
chr4,49120790,49316751,195961,-1,0,,0,0.00000000000000000000
chr4,49510516,49658610,148094,-1,0,,0,0.00000000000000000000
chr4,49177189,49249875,72686,-1,0,,0,0.00000000000000000000
chr4,49095265,49158608,63343,-1,0,,0,0.00000000000000000000
chr4,49281878,49333046,51168,-1,0,,0,0.00000000000000000000
chr4,49601939,49659914,57975,-1,0,,0,0.00000000000000000000
chr4,49520777,49553626,32849,-1,0,,0,0.00000000000000000000
chr4,49115788,49144534,28746,-1,0,,0,0.00000000000000000000
chr4,49246860,49273718,26858,-1,0,,0,0.00000000000000000000
chr4,49125237,49149353,24116,-1,0,,0,0.00000000000000000000
chr4,49203905,49233760,29855,-1,0,,0,0.00000000000000000000
chr4,49102388,49120901,18513,-1,0,,0,0.00000000000000000000
chr4,49634067,49659914,25847,-1,0,,0,0.00000000000000000000
chr4,49114111,49138131,24020,-1,0,,0,0.00000000000000000000
chr4,49125495,49140997,15502,-1,0,,0,0.00000000000000000000
chr4,49095654,49108131,12477,-1,0,,0,0.00000000000000000000
chr4,49107913,49120412,12499,-1,0,,0,0.00000000000000000000
chr4,49112963,49120713,7750,-1,0,,0,0.00000000000000000000
chr4,49142112,49150438,8326,-1,0,,0,0.00000000000000000000
chr4,49650888,49659534,8646,-1,0,,0,0.00000000000000000000
chr4,49100999,49106846,5847,-1,0,,0,0.00000000000000000000
chr4,49151685,49156555,4870,-1,0,,0,0.00000000000000000000
chr4,49134068,49139158,5090,-1,0,,0,0.00000000000000000000
chr4,49094992,49099934,4942,-1,0,,0,0.00000000000000000000
chr4,49645074,49651025,5951,-1,0,,0,0.00000000000000000000
chr4,49106028,49108607,2579,-1,0,,0,0.00000000000000000000
chr4,49112904,49114193,1289,-1,0,,0,0.00000000000000000000
chr4,49149496,49151355,1859,-1,0,,0,0.00000000000000000000
chr4,49122448,49122898,450,-1,0,,0,0.00000000000000000000
chr4,49146858,49147137,279,-1,0,,0,0.00000000000000000000
chr4,52660191,52683472,23281,-1,0,,0,0.00000000000000000000
chr4,52684541,52685231,690,-1,0,,0,0.00000000000000000000
chr4,53212837,53213483,646,-1,0,,0,0.00000000000000000000
chr4,53338311,53344293,5982,-1,0,,0,0.00000000000000000000
chr4,53391063,53395431,4368,-1,0,,0,0.00000000000000000000
chr4,53599777,53600763,986,-1,0,,0,0.00000000000000000000
chr4,53614239,53616058,1819,-1,0,100288413,1,54.97526113249040000000
chr4,54068232,54082012,13780,-1,0,152579,1,7.25689404934688000000
chr4,54138712,54224933,86221,-1,0,152579,1,1.15981025504228000000
chr4,54219686,54220263,577,-1,0,152579,1,173.31022530329300000000
chr4,54219930,54220098,168,-1,0,152579,1,595.23809523809500000000
chr4,54565832,54567778,1946,-1,0,,0,0.00000000000000000000
chr4,55007515,55012927,5412,-1,0,,0,0.00000000000000000000
chr4,55069883,55072150,2267,-1,0,,0,0.00000000000000000000
chr4,55102492,55106769,4277,-1,0,5156,1,23.38087444470420000000
chr4,55219495,55220351,856,-1,0,,0,0.00000000000000000000
chr4,55482328,55482849,521,-1,0,,0,0.00000000000000000000
chr4,55426455,55427004,549,-1,0,,0,0.00000000000000000000
chr4,55482441,55482770,329,-1,0,,0,0.00000000000000000000
chr4,55649676,55649738,62,-1,0,,0,0.00000000000000000000
chr4,55808567,55809087,520,-1,0,,0,0.00000000000000000000
chr4,55808674,55808918,244,-1,0,,0,0.00000000000000000000
chr4,55998553,55998888,335,-1,0,,0,0.00000000000000000000
chr4,56266593,56269198,2605,-1,0,55858,1,38.38771593090210000000
chr4,56266760,56267896,1136,-1,0,55858,1,88.02816901408450000000
chr4,56311270,56311442,172,-1,0,9575,1,581.39534883720900000000
chr4,56379840,56767933,388093,-1,0,55763;10874;9575;132954,4,1.03068079042910000000
chr4,56662763,56668633,5870,-1,0,,0,0.00000000000000000000
chr4,56457555,56462009,4454,-1,0,10874;132954,2,44.90345756623260000000
chr4,56923915,56924195,280,-1,0,,0,0.00000000000000000000
chr4,57539782,57544853,5071,-1,0,84525,1,19.71997633602840000000
chr4,57543251,57544708,1457,-1,0,84525,1,68.63417982155110000000
chr4,57536981,57538519,1538,-1,0,84525,1,65.01950585175550000000
chr4,57501694,57502178,484,-1,0,,0,0.00000000000000000000
chr4,57501814,57501989,175,-1,0,,0,0.00000000000000000000
chr4,57706321,57710342,4021,-1,0,,0,0.00000000000000000000
chr4,57705432,57706374,942,-1,0,,0,0.00000000000000000000
chr4,57719937,57722531,2594,-1,0,,0,0.00000000000000000000
chr4,57742564,57742616,52,-1,0,,0,0.00000000000000000000
chr4,57761148,57762113,965,-1,0,,0,0.00000000000000000000
chr4,57772940,57775400,2460,-1,0,5978,1,40.65040650406500000000
chr4,58087283,58087782,499,-1,0,,0,0.00000000000000000000
chr4,58147913,58148476,563,-1,0,,0,0.00000000000000000000
chr4,58148016,58148351,335,-1,0,,0,0.00000000000000000000
chr4,58205328,58205516,188,-1,0,,0,0.00000000000000000000
chr4,58252039,58262362,10323,-1,0,,0,0.00000000000000000000
chr4,58256160,58261898,5738,-1,0,,0,0.00000000000000000000
chr4,58256367,58258232,1865,-1,0,,0,0.00000000000000000000
chr4,58339443,58345724,6281,-1,0,,0,0.00000000000000000000
chr4,58425953,58435248,9295,-1,0,,0,0.00000000000000000000
chr4,58486240,58490697,4457,-1,0,,0,0.00000000000000000000
chr4,58568328,58572160,3832,-1,0,,0,0.00000000000000000000
chr4,58634992,58642426,7434,-1,0,,0,0.00000000000000000000
chr4,60423997,60449777,25780,-1,0,,0,0.00000000000000000000
chr4,59166913,59182360,15447,-1,0,,0,0.00000000000000000000
chr4,58921595,58934419,12824,-1,0,,0,0.00000000000000000000
chr4,60288474,60296255,7781,-1,0,,0,0.00000000000000000000
chr4,59944222,59951036,6814,-1,0,,0,0.00000000000000000000
chr4,59429057,59435562,6505,-1,0,,0,0.00000000000000000000
chr4,58811815,58818469,6654,-1,0,,0,0.00000000000000000000
chr4,60324149,60330809,6660,-1,0,,0,0.00000000000000000000
chr4,58720536,58725022,4486,-1,0,,0,0.00000000000000000000
chr4,60422168,60427346,5178,-1,0,,0,0.00000000000000000000
chr4,60291305,60294189,2884,-1,0,,0,0.00000000000000000000
chr4,58805631,58808740,3109,-1,0,,0,0.00000000000000000000
chr4,58886883,58888494,1611,-1,0,,0,0.00000000000000000000
chr4,58884544,58886667,2123,-1,0,,0,0.00000000000000000000
chr4,58722734,58723723,989,-1,0,,0,0.00000000000000000000
chr4,58887275,58888333,1058,-1,0,,0,0.00000000000000000000
chr4,59985145,59985705,560,-1,0,,0,0.00000000000000000000
chr4,59808775,59809177,402,-1,0,,0,0.00000000000000000000
chr4,59607590,59607945,355,-1,0,,0,0.00000000000000000000
chr4,59590182,59590536,354,-1,0,,0,0.00000000000000000000
chr4,60483657,60483912,255,-1,0,,0,0.00000000000000000000
chr4,59985366,59985526,160,-1,0,,0,0.00000000000000000000
chr4,60589087,60589207,120,-1,0,,0,0.00000000000000000000
chr4,60816347,60817892,1545,-1,0,,0,0.00000000000000000000
chr4,60878071,60890553,12482,-1,0,,0,0.00000000000000000000
chr4,61035479,61035808,329,-1,0,,0,0.00000000000000000000
chr4,61330102,61333188,3086,-1,0,,0,0.00000000000000000000
chr4,61330036,61332041,2005,-1,0,,0,0.00000000000000000000
chr4,61289228,61289695,467,-1,0,,0,0.00000000000000000000
chr4,61500242,61502221,1979,-1,0,,0,0.00000000000000000000
chr4,61569234,61569698,464,-1,0,,0,0.00000000000000000000
chr4,61621926,61622050,124,-1,0,,0,0.00000000000000000000
chr4,61939095,61942319,3224,-1,0,,0,0.00000000000000000000
chr4,61999384,62001948,2564,-1,0,,0,0.00000000000000000000
chr4,61999405,62000399,994,-1,0,,0,0.00000000000000000000
chr4,62028164,62028828,664,-1,0,,0,0.00000000000000000000
chr4,62028314,62028600,286,-1,0,,0,0.00000000000000000000
chr4,62045749,62046171,422,-1,0,,0,0.00000000000000000000
chr4,62284037,62285319,1282,-1,0,23284,1,78.00312012480500000000
chr4,62284011,62284779,768,-1,0,23284,1,130.20833333333300000000
chr4,62498961,62499663,702,-1,0,23284,1,142.45014245014200000000
chr4,62837304,62840754,3450,-1,0,23284,1,28.98550724637680000000
chr4,62976756,63034074,57318,-1,0,,0,0.00000000000000000000
chr4,63301187,63301674,487,-1,0,,0,0.00000000000000000000
chr4,63376962,63417929,40967,-1,0,,0,0.00000000000000000000
chr4,63478313,63478488,175,-1,0,,0,0.00000000000000000000
chr4,63516134,63517931,1797,-1,0,,0,0.00000000000000000000
chr4,63552088,63552142,54,-1,0,,0,0.00000000000000000000
chr4,63665184,63698173,32989,-1,0,,0,0.00000000000000000000
chr4,63665065,63676294,11229,-1,0,,0,0.00000000000000000000
chr4,63669004,63676250,7246,-1,0,,0,0.00000000000000000000
chr4,63669594,63674030,4436,-1,0,,0,0.00000000000000000000
chr4,63670365,63671710,1345,-1,0,,0,0.00000000000000000000
chr4,63920872,64052796,131924,-1,0,,0,0.00000000000000000000
chr4,64032185,64032558,373,-1,0,,0,0.00000000000000000000
chr4,64030853,64031024,171,-1,0,,0,0.00000000000000000000
chr4,64098142,64098469,327,-1,0,,0,0.00000000000000000000
chr4,64098146,64098467,321,-1,0,,0,0.00000000000000000000
chr4,64123536,64292489,168953,-1,0,,0,0.00000000000000000000
chr4,64134058,64154830,20772,-1,0,,0,0.00000000000000000000
chr4,64140106,64151315,11209,-1,0,,0,0.00000000000000000000
chr4,64244324,64253245,8921,-1,0,,0,0.00000000000000000000
chr4,64133340,64138531,5191,-1,0,,0,0.00000000000000000000
chr4,64442443,64442983,540,-1,0,,0,0.00000000000000000000
chr4,64442556,64442867,311,-1,0,,0,0.00000000000000000000
chr4,64684018,64732697,48679,-1,0,,0,0.00000000000000000000
chr4,64694269,64714800,20531,-1,0,,0,0.00000000000000000000
chr4,64706801,64728688,21887,-1,0,,0,0.00000000000000000000
chr4,64699751,64713603,13852,-1,0,,0,0.00000000000000000000
chr4,64691667,64708146,16479,-1,0,,0,0.00000000000000000000
chr4,64698490,64708358,9868,-1,0,,0,0.00000000000000000000
chr4,65015408,65025842,10434,-1,0,,0,0.00000000000000000000
chr4,64783557,64784718,1161,-1,0,,0,0.00000000000000000000
chr4,65127057,65128014,957,-1,0,,0,0.00000000000000000000
chr4,65097097,65097833,736,-1,0,,0,0.00000000000000000000
chr4,65199442,65199794,352,-1,0,253017,1,284.09090909090900000000
chr4,65719070,65719555,485,-1,0,,0,0.00000000000000000000
chr4,65719096,65719454,358,-1,0,,0,0.00000000000000000000
chr4,65733383,65734829,1446,-1,0,,0,0.00000000000000000000
chr4,65819753,65841866,22113,-1,0,,0,0.00000000000000000000
chr4,65823292,65838518,15226,-1,0,,0,0.00000000000000000000
chr4,66010772,66011365,593,-1,0,,0,0.00000000000000000000
chr4,66010994,66011181,187,-1,0,,0,0.00000000000000000000
chr4,66011056,66011157,101,-1,0,,0,0.00000000000000000000
chr4,66169547,66179422,9875,-1,0,,0,0.00000000000000000000
chr4,66364490,66364948,458,-1,0,2044,1,218.34061135371200000000
chr4,66641036,66641544,508,-1,0,,0,0.00000000000000000000
chr4,66641106,66641426,320,-1,0,,0,0.00000000000000000000
chr4,66660075,66661159,1084,-1,0,,0,0.00000000000000000000
chr4,66755374,66755655,281,-1,0,,0,0.00000000000000000000
chr4,66802417,66806751,4334,-1,0,,0,0.00000000000000000000
chr4,66961479,66970958,9479,-1,0,,0,0.00000000000000000000
chr4,67122070,67123489,1419,-1,0,,0,0.00000000000000000000
chr4,67117692,67117813,121,-1,0,,0,0.00000000000000000000
chr4,67349814,67351037,1223,-1,0,,0,0.00000000000000000000
chr4,67379647,67393539,13892,-1,0,,0,0.00000000000000000000
chr4,67537836,67538382,546,-1,0,,0,0.00000000000000000000
chr4,67537931,67538248,317,-1,0,,0,0.00000000000000000000
chr4,68102496,68121294,18798,-1,0,,0,0.00000000000000000000
chr4,68147854,68151657,3803,-1,0,,0,0.00000000000000000000
chr4,68184285,68187708,3423,-1,0,,0,0.00000000000000000000
chr4,68264954,68266794,1840,-1,0,,0,0.00000000000000000000
chr4,68352938,68354009,1071,-1,0,1060,1,93.37068160597570000000
chr4,68380878,68383455,2577,-1,0,1060,1,38.80481179666280000000
chr4,68453531,68454237,706,-1,0,26228,1,141.64305949008500000000
chr4,68848015,68888000,39985,-1,0,,0,0.00000000000000000000
chr4,68873176,68873249,73,-1,0,,0,0.00000000000000000000
chr4,69036794,69037337,543,-1,0,,0,0.00000000000000000000
chr4,69036886,69037218,332,-1,0,,0,0.00000000000000000000
chr4,69063685,69069632,5947,-1,0,,0,0.00000000000000000000
chr4,69338250,69546061,207811,-1,0,28983;7367;7366,3,1.44361944266665000000
chr4,69375349,69491600,116251,-1,0,7367,1,0.86020765412770700000
chr4,69434653,69541446,106793,-1,0,7366,1,0.93639096195443500000
chr4,69375263,69450650,75387,-1,0,7367,1,1.32648865188958000000
chr4,69490042,69538367,48325,-1,0,7366,1,2.06932229694775000000
chr4,69424065,69488075,64010,-1,0,7367,1,1.56225589751601000000
chr4,69373754,69423199,49445,-1,0,7367,1,2.02244918596420000000
chr4,69440395,69493875,53480,-1,0,,0,0.00000000000000000000
chr4,69426404,69454541,28137,-1,0,7367,1,3.55403916551160000000
chr4,69282205,69288142,5937,-1,0,,0,0.00000000000000000000
chr4,70001463,70254722,253259,-1,0,54490;10720,2,0.78970540040038100000
chr4,70134832,70270391,135559,-1,0,54490,1,0.73768617354804900000
chr4,70122889,70231742,108853,-1,0,54490,1,0.91867013311530200000
chr4,70057009,70171280,114271,-1,0,54490;10720,2,1.75022534151272000000
chr4,69594737,69669679,74942,-1,0,,0,0.00000000000000000000
chr4,70170257,70231771,61514,-1,0,,0,0.00000000000000000000
chr4,70129769,70193973,64204,-1,0,54490,1,1.55753535605258000000
chr4,70046069,70107037,60968,-1,0,10720,1,1.64020469754625000000
chr4,69672008,69710540,38532,-1,0,7365,1,2.59524551022527000000
chr4,70265596,70285517,19921,-1,0,,0,0.00000000000000000000
chr4,70123749,70138963,15214,-1,0,,0,0.00000000000000000000
chr4,70254204,70273463,19259,-1,0,,0,0.00000000000000000000
chr4,70030751,70037836,7085,-1,0,,0,0.00000000000000000000
chr4,69763330,69764342,1012,-1,0,,0,0.00000000000000000000
chr4,69597860,69598376,516,-1,0,,0,0.00000000000000000000
chr4,69959752,69960299,547,-1,0,,0,0.00000000000000000000
chr4,69790851,69791174,323,-1,0,,0,0.00000000000000000000
chr4,69597936,69598288,352,-1,0,,0,0.00000000000000000000
chr4,69959841,69960165,324,-1,0,,0,0.00000000000000000000
chr4,70161533,70161692,159,-1,0,,0,0.00000000000000000000
chr4,70388900,70390234,1334,-1,0,7363,1,74.96251874062970000000
chr4,70397633,70398303,670,-1,0,,0,0.00000000000000000000
chr4,70415661,70416576,915,-1,0,,0,0.00000000000000000000
chr4,70434807,70436191,1384,-1,0,,0,0.00000000000000000000
chr4,70467475,70473561,6086,-1,0,10941;574537,2,32.86230693394680000000
chr4,70467372,70469954,2582,-1,0,10941;574537,2,77.45933384972890000000
chr4,70467621,70469086,1465,-1,0,10941;574537,2,136.51877133105800000000
chr4,70487375,70517413,30038,-1,0,10941;574537,2,6.65823290498702000000
chr4,70559121,70559836,715,-1,0,,0,0.00000000000000000000
chr4,70880562,70880878,316,-1,0,,0,0.00000000000000000000
chr4,70959881,71083918,124037,-1,0,401137;54959,2,1.61242209985730000000
chr4,70973436,70984217,10781,-1,0,,0,0.00000000000000000000
chr4,71107958,71108227,269,-1,0,,0,0.00000000000000000000
chr4,71227530,71249937,22407,-1,0,26952;10879,2,8.92578212165841000000
chr4,71194608,71200088,5480,-1,0,,0,0.00000000000000000000
chr4,71372463,71373209,746,-1,0,,0,0.00000000000000000000
chr4,71544953,71547287,2334,-1,0,,0,0.00000000000000000000
chr4,71926229,71926772,543,-1,0,,0,0.00000000000000000000
chr4,71926413,71926575,162,-1,0,,0,0.00000000000000000000
chr4,71945572,71955962,10390,-1,0,,0,0.00000000000000000000
chr4,71945954,71948962,3008,-1,0,,0,0.00000000000000000000
chr4,72211958,72212399,441,-1,0,8671,1,226.75736961451200000000
chr4,72289679,72293416,3737,-1,0,8671,1,26.75943270002680000000
chr4,72517529,72520453,2924,-1,0,,0,0.00000000000000000000
chr4,72742024,72742398,374,-1,0,,0,0.00000000000000000000
chr4,72742128,72742283,155,-1,0,,0,0.00000000000000000000
chr4,72785695,72786053,358,-1,0,,0,0.00000000000000000000
chr4,72829542,72830058,516,-1,0,,0,0.00000000000000000000
chr4,72829634,72829967,333,-1,0,,0,0.00000000000000000000
chr4,73000703,73003881,3178,-1,0,10886,1,31.46633102580240000000
chr4,73265618,73265842,224,-1,0,9508,1,446.42857142857100000000
chr4,73378369,73423628,45259,-1,0,9508,1,2.20950529176517000000
chr4,73418195,73425936,7741,-1,0,9508,1,12.91822761917070000000
chr4,73552212,73561114,8902,-1,0,,0,0.00000000000000000000
chr4,73420266,73426011,5745,-1,0,9508,1,17.40644038294170000000
chr4,73553838,73558395,4557,-1,0,,0,0.00000000000000000000
chr4,73415520,73415961,441,-1,0,9508,1,226.75736961451200000000
chr4,73418566,73419008,442,-1,0,9508,1,226.24434389140300000000
chr4,73418758,73418847,89,-1,0,9508,1,1123.59550561798000000000
chr4,73627522,73631886,4364,-1,0,,0,0.00000000000000000000
chr4,73729975,73735813,5838,-1,0,,0,0.00000000000000000000
chr4,73830849,73832118,1269,-1,0,,0,0.00000000000000000000
chr4,73831245,73831819,574,-1,0,,0,0.00000000000000000000
chr4,74265644,74269899,4255,-1,0,,0,0.00000000000000000000
chr4,74312121,74312603,482,-1,0,174,1,207.46887966805000000000
chr4,74312304,74312368,64,-1,0,174,1,1562.50000000000000000000
chr4,74475537,74479647,4110,-1,0,166824,1,24.33090024330900000000
chr4,74555301,74557017,1716,-1,0,,0,0.00000000000000000000
chr4,74747478,74747987,509,-1,0,,0,0.00000000000000000000
chr4,74747650,74747812,162,-1,0,,0,0.00000000000000000000
chr4,74941001,74945675,4674,-1,0,,0,0.00000000000000000000
chr4,74942304,74945441,3137,-1,0,,0,0.00000000000000000000
chr4,74942904,74944418,1514,-1,0,,0,0.00000000000000000000
chr4,75011056,75126543,115487,-1,0,441024,1,0.86589832621853500000
chr4,75078561,75083647,5086,-1,0,441024,1,19.66181675186790000000
chr4,75081112,75082206,1094,-1,0,441024,1,91.40767824497260000000
chr4,75014312,75015239,927,-1,0,,0,0.00000000000000000000
chr4,75203186,75203605,419,-1,0,,0,0.00000000000000000000
chr4,75282628,75323181,40553,-1,0,374,1,2.46590881069218000000
chr4,75496155,75496247,92,-1,0,,0,0.00000000000000000000
chr4,75642727,75649528,6801,-1,0,,0,0.00000000000000000000
chr4,76565270,76569348,4078,-1,0,9908,1,24.52182442373710000000
chr4,76743040,76744554,1514,-1,0,,0,0.00000000000000000000
chr4,76931706,76934468,2762,-1,0,419,1,36.20564808110060000000
chr4,76948542,76948973,431,-1,0,419,1,232.01856148491900000000
chr4,76948810,76949074,264,-1,0,419,1,378.78787878787900000000
chr4,76948611,76948872,261,-1,0,419,1,383.14176245210700000000
chr4,76964607,76972284,7677,-1,0,419,1,13.02592158395210000000
chr4,76980261,76980303,42,-1,0,419,1,2380.95238095238000000000
chr4,77071330,77071444,114,-1,0,,0,0.00000000000000000000
chr4,77166189,77179116,12927,-1,0,100129583;100631383,2,15.47149377272380000000
chr4,77781329,77790805,9476,-1,0,,0,0.00000000000000000000
chr4,77781861,77790546,8685,-1,0,,0,0.00000000000000000000
chr4,77783152,77787216,4064,-1,0,,0,0.00000000000000000000
chr4,78172300,78200730,28430,-1,0,,0,0.00000000000000000000
chr4,78199062,78199482,420,-1,0,,0,0.00000000000000000000
chr4,78199222,78199273,51,-1,0,,0,0.00000000000000000000
chr4,78236149,78236661,512,-1,0,,0,0.00000000000000000000
chr4,78236274,78236540,266,-1,0,,0,0.00000000000000000000
chr4,78237662,78277606,39944,-1,0,,0,0.00000000000000000000
chr4,78267966,78268471,505,-1,0,,0,0.00000000000000000000
chr4,78269321,78269726,405,-1,0,,0,0.00000000000000000000
chr4,78491890,78497434,5544,-1,0,10563,1,18.03751803751800000000
chr4,78739915,78741153,1238,-1,0,246175,1,80.77544426494350000000
chr4,80637556,80678653,41097,-1,0,,0,0.00000000000000000000
chr4,80353858,80362731,8873,-1,0,,0,0.00000000000000000000
chr4,79268227,79275494,7267,-1,0,80144,1,13.76083665886890000000
chr4,80887909,80894266,6357,-1,0,118429,1,15.73069057731630000000
chr4,79088456,79094252,5796,-1,0,80144,1,17.25327812284330000000
chr4,80261832,80265797,3965,-1,0,,0,0.00000000000000000000
chr4,79255629,79258247,2618,-1,0,80144,1,38.19709702062640000000
chr4,80360634,80362722,2088,-1,0,,0,0.00000000000000000000
chr4,79632624,79634461,1837,-1,0,,0,0.00000000000000000000
chr4,79298995,79300653,1658,-1,0,80144,1,60.31363088057900000000
chr4,80205614,80206179,565,-1,0,,0,0.00000000000000000000
chr4,79697089,79697707,618,-1,0,55589,1,161.81229773462800000000
chr4,80273931,80274311,380,-1,0,,0,0.00000000000000000000
chr4,79050533,79050927,394,-1,0,80144,1,253.80710659898500000000
chr4,80205730,80206057,327,-1,0,,0,0.00000000000000000000
chr4,80479717,80479801,84,-1,0,,0,0.00000000000000000000
chr4,81123904,81124539,635,-1,0,56978,1,157.48031496063000000000
chr4,81302463,81302980,517,-1,0,255119,1,193.42359767891700000000
chr4,81302536,81302875,339,-1,0,255119,1,294.98525073746300000000
chr4,81456215,81456969,754,-1,0,255119,1,132.62599469496000000000
chr4,81456483,81456714,231,-1,0,255119,1,432.90043290043300000000
chr4,81508721,81509954,1233,-1,0,255119,1,81.10300081103000000000
chr4,81531188,81535900,4712,-1,0,255119,1,21.22241086587440000000
chr4,81775467,81775865,398,-1,0,255119,1,251.25628140703500000000
chr4,81935708,81951591,15883,-1,0,,0,0.00000000000000000000
chr4,81991419,81991949,530,-1,0,,0,0.00000000000000000000
chr4,81991523,81991843,320,-1,0,,0,0.00000000000000000000
chr4,82053902,82054973,1071,-1,0,5593,1,93.37068160597570000000
chr4,82515198,82515641,443,-1,0,,0,0.00000000000000000000
chr4,82929299,82931391,2092,-1,0,,0,0.00000000000000000000
chr4,82890362,82891247,885,-1,0,,0,0.00000000000000000000
chr4,82584650,82585687,1037,-1,0,,0,0.00000000000000000000
chr4,82890722,82890987,265,-1,0,,0,0.00000000000000000000
chr4,83143823,83144019,196,-1,0,,0,0.00000000000000000000
chr4,83179777,83180090,313,-1,0,,0,0.00000000000000000000
chr4,83215363,83215473,110,-1,0,,0,0.00000000000000000000
chr4,83316429,83317722,1293,-1,0,,0,0.00000000000000000000
chr4,83395383,83395962,579,-1,0,,0,0.00000000000000000000
chr4,83395510,83395838,328,-1,0,,0,0.00000000000000000000
chr4,83630072,83633146,3074,-1,0,79966,1,32.53090435914120000000
chr4,83635930,83641104,5174,-1,0,79966,1,19.32740626207960000000
chr4,83895254,83897733,2479,-1,0,132660,1,40.33884630899560000000
chr4,83913981,83919539,5558,-1,0,132660,1,17.99208348326740000000
chr4,84021632,84021688,56,-1,0,51316,1,1785.71428571429000000000
chr4,84041365,84042781,1416,-1,0,,0,0.00000000000000000000
chr4,84221311,84222586,1275,-1,0,10855,1,78.43137254901960000000
chr4,84221623,84222092,469,-1,0,10855,1,213.21961620469100000000
chr4,84221708,84221993,285,-1,0,10855,1,350.87719298245600000000
chr4,84467289,84468562,1273,-1,0,84803,1,78.55459544383350000000
chr4,84570887,84571014,127,-1,0,,0,0.00000000000000000000
chr4,84589441,84591856,2415,-1,0,,0,0.00000000000000000000
chr4,84614114,84614324,210,-1,0,,0,0.00000000000000000000
chr4,85054234,85057747,3513,-1,0,,0,0.00000000000000000000
chr4,85082679,85089800,7121,-1,0,,0,0.00000000000000000000
chr4,85125843,85133544,7701,-1,0,,0,0.00000000000000000000
chr4,86102194,86123969,21775,-1,0,,0,0.00000000000000000000
chr4,86099889,86116229,16340,-1,0,,0,0.00000000000000000000
chr4,86100771,86109622,8851,-1,0,,0,0.00000000000000000000
chr4,86238531,86239639,1108,-1,0,,0,0.00000000000000000000
chr4,86310435,86310941,506,-1,0,,0,0.00000000000000000000
chr4,86238783,86239268,485,-1,0,,0,0.00000000000000000000
chr4,86310519,86310830,311,-1,0,,0,0.00000000000000000000
chr4,86238973,86239074,101,-1,0,,0,0.00000000000000000000
chr4,86462196,86462731,535,-1,0,83478,1,186.91588785046700000000
chr4,86462284,86462605,321,-1,0,83478,1,311.52647975077900000000
chr4,86571208,86573104,1896,-1,0,83478,1,52.74261603375530000000
chr4,86571290,86572594,1304,-1,0,83478,1,76.68711656441720000000
chr4,86564384,86564716,332,-1,0,83478,1,301.20481927710800000000
chr4,86617096,86617485,389,-1,0,83478,1,257.06940874036000000000
chr4,86617165,86617385,220,-1,0,83478,1,454.54545454545500000000
chr4,86660634,86661193,559,-1,0,83478,1,178.89087656529500000000
chr4,86660769,86661091,322,-1,0,83478,1,310.55900621118000000000
chr4,86704788,86707428,2640,-1,0,83478,1,37.87878787878790000000
chr4,86852094,86858904,6810,-1,0,83478,1,14.68428781204110000000
chr4,86975924,86993506,17582,-1,0,5602,1,5.68763508133318000000
chr4,86966327,86983232,16905,-1,0,5602,1,5.91540964211772000000
chr4,86975885,86984548,8663,-1,0,5602,1,11.54334526145680000000
chr4,86975905,86980214,4309,-1,0,5602,1,23.20724065908560000000
chr4,87066204,87066702,498,-1,0,5602,1,200.80321285140600000000
chr4,86967178,86967682,504,-1,0,5602,1,198.41269841269800000000
chr4,87066361,87066547,186,-1,0,5602,1,537.63440860215100000000
chr4,87646397,87651955,5558,-1,0,5783,1,17.99208348326740000000
chr4,88032106,88032551,445,-1,0,4299,1,224.71910112359600000000
chr4,88491716,88574362,82646,-1,0,1834;1758,2,2.41995982866684000000
chr4,88184309,88230166,45857,-1,0,345275,1,2.18069215168895000000
chr4,88268024,88274475,6451,-1,0,51170,1,15.50147263990080000000
chr4,88074758,88079220,4462,-1,0,,0,0.00000000000000000000
chr4,88483646,88486565,2919,-1,0,,0,0.00000000000000000000
chr4,88291772,88292309,537,-1,0,51170,1,186.21973929236500000000
chr4,88667911,88675209,7298,-1,0,,0,0.00000000000000000000
chr4,88668943,88673552,4609,-1,0,,0,0.00000000000000000000
chr4,88775634,88775952,318,-1,0,,0,0.00000000000000000000
chr4,94091865,94510836,418971,-1,0,2895,1,0.23868000410529600000
chr4,92799309,93151939,352630,-1,0,,0,0.00000000000000000000
chr4,93628182,93741567,113385,-1,0,2895,1,0.88195087533624400000
chr4,90843179,90952984,109805,-1,0,22915,1,0.91070534128682700000
chr4,93777871,93874952,97081,-1,0,2895,1,1.03006767544628000000
chr4,93554420,93626389,71969,-1,0,2895,1,1.38948714029652000000
chr4,92648732,92716702,67970,-1,0,,0,0.00000000000000000000
chr4,93816198,93870437,54239,-1,0,2895,1,1.84369180847730000000
chr4,92889024,92939566,50542,-1,0,,0,0.00000000000000000000
chr4,93862122,93893631,31509,-1,0,2895,1,3.17369640420197000000
chr4,93898395,93910731,12336,-1,0,2895,1,8.10635538261997000000
chr4,93562410,93578357,15947,-1,0,2895,1,6.27077193202483000000
chr4,93844452,93859792,15340,-1,0,2895,1,6.51890482398957000000
chr4,91279794,91294275,14481,-1,0,401145,1,6.90560044195843000000
chr4,91885542,91899730,14188,-1,0,401145,1,7.04820975472230000000
chr4,92272262,92285197,12935,-1,0,401145,1,7.73096250483185000000
chr4,90580433,90592288,11855,-1,0,,0,0.00000000000000000000
chr4,92073347,92083039,9692,-1,0,401145,1,10.31778786628150000000
chr4,91284931,91294974,10043,-1,0,401145,1,9.95718410833416000000
chr4,91929739,91935892,6153,-1,0,401145,1,16.25223468226880000000
chr4,91596589,91603180,6591,-1,0,401145,1,15.17220452131690000000
chr4,93853795,93861792,7997,-1,0,2895,1,12.50468925847190000000
chr4,92339522,92346838,7316,-1,0,401145,1,13.66867140513940000000
chr4,93412401,93419535,7134,-1,0,2895,1,14.01738155312590000000
chr4,90297937,90305070,7133,-1,0,,0,0.00000000000000000000
chr4,93855737,93861302,5565,-1,0,2895,1,17.96945193171610000000
chr4,91287276,91292326,5050,-1,0,401145,1,19.80198019801980000000
chr4,94559420,94565582,6162,-1,0,2895,1,16.22849724115550000000
chr4,92472828,92478330,5502,-1,0,401145,1,18.17520901490370000000
chr4,92280361,92285289,4928,-1,0,401145,1,20.29220779220780000000
chr4,92756612,92761131,4519,-1,0,,0,0.00000000000000000000
chr4,90885945,90891418,5473,-1,0,,0,0.00000000000000000000
chr4,89115630,89121101,5471,-1,0,9429,1,18.27819411442150000000
chr4,89809906,89814690,4784,-1,0,10144,1,20.90301003344480000000
chr4,90559248,90563589,4341,-1,0,,0,0.00000000000000000000
chr4,91931543,91935840,4297,-1,0,401145,1,23.27205026762860000000
chr4,90799893,90803963,4070,-1,0,,0,0.00000000000000000000
chr4,89786094,89789767,3673,-1,0,10144,1,27.22570106180230000000
chr4,93567549,93570215,2666,-1,0,2895,1,37.50937734433610000000
chr4,92160162,92162897,2735,-1,0,401145,1,36.56307129798900000000
chr4,92545285,92548183,2898,-1,0,,0,0.00000000000000000000
chr4,93857323,93859570,2247,-1,0,2895,1,44.50378282153980000000
chr4,91350851,91353567,2716,-1,0,401145,1,36.81885125184090000000
chr4,91933850,91936097,2247,-1,0,401145,1,44.50378282153980000000
chr4,91931662,91933534,1872,-1,0,401145,1,53.41880341880340000000
chr4,91802956,91804672,1716,-1,0,401145,1,58.27505827505830000000
chr4,89681045,89682642,1597,-1,0,10144,1,62.61740763932370000000
chr4,92161359,92162752,1393,-1,0,401145,1,71.78750897343860000000
chr4,92035416,92036673,1257,-1,0,401145,1,79.55449482895780000000
chr4,89830693,89831862,1169,-1,0,10144,1,85.54319931565440000000
chr4,90427842,90428675,833,-1,0,,0,0.00000000000000000000
chr4,88928625,88929511,886,-1,0,5311,1,112.86681715575600000000
chr4,93360756,93361510,754,-1,0,2895,1,132.62599469496000000000
chr4,91934941,91935792,851,-1,0,401145,1,117.50881316098700000000
chr4,89037575,89038153,578,-1,0,9429,1,173.01038062283700000000
chr4,94165451,94166014,563,-1,0,2895,1,177.61989342806400000000
chr4,95498868,95499406,538,-1,0,10611,1,185.87360594795500000000
chr4,89681366,89681848,482,-1,0,10144,1,207.46887966805000000000
chr4,89522867,89523308,441,-1,0,8916,1,226.75736961451200000000
chr4,93392955,93393496,541,-1,0,2895,1,184.84288354898300000000
chr4,88920781,88921244,463,-1,0,,0,0.00000000000000000000
chr4,93573753,93574172,419,-1,0,2895,1,238.66348448687400000000
chr4,94438920,94439348,428,-1,0,2895,1,233.64485981308400000000
chr4,90548290,90548614,324,-1,0,,0,0.00000000000000000000
chr4,91569579,91569914,335,-1,0,401145,1,298.50746268656700000000
chr4,91719257,91719671,414,-1,0,401145,1,241.54589371980700000000
chr4,93579940,93580271,331,-1,0,2895,1,302.11480362537800000000
chr4,91382192,91382527,335,-1,0,401145,1,298.50746268656700000000
chr4,89681462,89681798,336,-1,0,10144,1,297.61904761904800000000
chr4,89522908,89523223,315,-1,0,8916,1,317.46031746031700000000
chr4,95498966,95499293,327,-1,0,10611,1,305.81039755351700000000
chr4,89037677,89038013,336,-1,0,9429,1,297.61904761904800000000
chr4,90018100,90018393,293,-1,0,,0,0.00000000000000000000
chr4,89620091,89620356,265,-1,0,8916,1,377.35849056603800000000
chr4,93393078,93393398,320,-1,0,2895,1,312.50000000000000000000
chr4,94165659,94165821,162,-1,0,2895,1,617.28395061728400000000
chr4,94439096,94439190,94,-1,0,2895,1,1063.82978723404000000000
chr4,91569664,91569738,74,-1,0,401145,1,1351.35135135135000000000
chr4,92905955,92906025,70,-1,0,,0,0.00000000000000000000
chr4,89833368,89833420,52,-1,0,10144,1,1923.07692307692000000000
chr4,95637741,95638660,919,-1,0,,0,0.00000000000000000000
chr4,95678917,95680021,1104,-1,0,658,1,90.57971014492750000000
chr4,95711762,95764130,52368,-1,0,658,1,1.90956309196456000000
chr4,95870447,95870766,319,-1,0,658,1,313.47962382445100000000
chr4,96245748,96249994,4246,-1,0,8633,1,23.55157795572300000000
chr4,96246487,96247592,1105,-1,0,8633,1,90.49773755656110000000
chr4,96382139,96383259,1120,-1,0,8633,1,89.28571428571430000000
chr4,96382346,96382818,472,-1,0,8633,1,211.86440677966100000000
chr4,96382443,96382678,235,-1,0,8633,1,425.53191489361700000000
chr4,96401063,96401460,397,-1,0,8633,1,251.88916876574300000000
chr4,96519035,96519848,813,-1,0,,0,0.00000000000000000000
chr4,96528418,96529682,1264,-1,0,,0,0.00000000000000000000
chr4,96912919,96914744,1825,-1,0,,0,0.00000000000000000000
chr4,97035244,97038153,2909,-1,0,,0,0.00000000000000000000
chr4,97078668,97081018,2350,-1,0,,0,0.00000000000000000000
chr4,97213955,97214954,999,-1,0,,0,0.00000000000000000000
chr4,97214400,97214694,294,-1,0,,0,0.00000000000000000000
chr4,97397886,97479755,81869,-1,0,,0,0.00000000000000000000
chr4,97319259,97325789,6530,-1,0,,0,0.00000000000000000000
chr4,97319753,97322281,2528,-1,0,,0,0.00000000000000000000
chr4,97572005,97572556,551,-1,0,,0,0.00000000000000000000
chr4,97572116,97572440,324,-1,0,,0,0.00000000000000000000
chr4,97622598,97627274,4676,-1,0,,0,0.00000000000000000000
chr4,97784763,97790265,5502,-1,0,,0,0.00000000000000000000
chr4,97897193,97897530,337,-1,0,,0,0.00000000000000000000
chr4,98110548,98111086,538,-1,0,,0,0.00000000000000000000
chr4,98110643,98110969,326,-1,0,,0,0.00000000000000000000
chr4,98133265,98133818,553,-1,0,,0,0.00000000000000000000
chr4,98133379,98133697,318,-1,0,,0,0.00000000000000000000
chr4,98172496,98187545,15049,-1,0,,0,0.00000000000000000000
chr4,98181138,98181702,564,-1,0,,0,0.00000000000000000000
chr4,98340658,98359192,18534,-1,0,,0,0.00000000000000000000
chr4,98350623,98360520,9897,-1,0,,0,0.00000000000000000000
chr4,98354313,98359118,4805,-1,0,,0,0.00000000000000000000
chr4,98590578,98591047,469,-1,0,285555,1,213.21961620469100000000
chr4,98590639,98590981,342,-1,0,285555,1,292.39766081871300000000
chr4,98989759,98992144,2385,-1,0,285555,1,41.92872117400420000000
chr4,99287582,99289486,1904,-1,0,5910,1,52.52100840336130000000
chr4,99680784,99682885,2101,-1,0,,0,0.00000000000000000000
chr4,99813747,99817733,3986,-1,0,1977,1,25.08780732563970000000
chr4,100022951,100023465,514,-1,0,,0,0.00000000000000000000
chr4,100023047,100023381,334,-1,0,,0,0.00000000000000000000
chr4,100070197,100070726,529,-1,0,,0,0.00000000000000000000
chr4,100070302,100070622,320,-1,0,,0,0.00000000000000000000
chr4,100509819,100510012,193,-1,0,4547,1,518.13471502590700000000
chr4,100870851,100871677,826,-1,0,3015,1,121.06537530266300000000
chr4,100875819,100876882,1063,-1,0,,0,0.00000000000000000000
chr4,100918564,100919303,739,-1,0,,0,0.00000000000000000000
chr4,101079193,101106326,27133,-1,0,,0,0.00000000000000000000
chr4,101074208,101088572,14364,-1,0,,0,0.00000000000000000000
chr4,101100406,101101969,1563,-1,0,,0,0.00000000000000000000
chr4,101117715,101118342,627,-1,0,,0,0.00000000000000000000
chr4,101244732,101245216,484,-1,0,,0,0.00000000000000000000
chr4,101244833,101245109,276,-1,0,,0,0.00000000000000000000
chr4,101390633,101390812,179,-1,0,51705,1,558.65921787709500000000
chr4,101453780,101454865,1085,-1,0,,0,0.00000000000000000000
chr4,101493242,101493726,484,-1,0,,0,0.00000000000000000000
chr4,101550894,101616281,65387,-1,0,,0,0.00000000000000000000
chr4,101599658,101601598,1940,-1,0,,0,0.00000000000000000000
chr4,101654517,101657785,3268,-1,0,,0,0.00000000000000000000
chr4,101960158,101961195,1037,-1,0,5530,1,96.43201542912250000000
chr4,101960217,101960895,678,-1,0,5530,1,147.49262536873200000000
chr4,102011916,102012306,390,-1,0,5530,1,256.41025641025600000000
chr4,102011953,102012075,122,-1,0,5530,1,819.67213114754100000000
chr4,102077992,102086706,8714,-1,0,5530,1,11.47578609134730000000
chr4,102080938,102085204,4266,-1,0,5530,1,23.44116268166900000000
chr4,102079824,102081845,2021,-1,0,5530,1,49.48045522018800000000
chr4,102266546,102269490,2944,-1,0,5530,1,33.96739130434780000000
chr4,102526623,102536470,9847,-1,0,,0,0.00000000000000000000
chr4,102683144,102697777,14633,-1,0,,0,0.00000000000000000000
chr4,102787715,102788436,721,-1,0,55024,1,138.69625520111000000000
chr4,102712350,102712404,54,-1,0,55024,1,1851.85185185185000000000
chr4,103120738,103120985,247,-1,0,,0,0.00000000000000000000
chr4,103204686,103204797,111,-1,0,64116,1,900.90090090090100000000
chr4,103213586,103217851,4265,-1,0,64116,1,23.44665885111370000000
chr4,103329414,103332051,2637,-1,0,,0,0.00000000000000000000
chr4,103331230,103331972,742,-1,0,,0,0.00000000000000000000
chr4,103331339,103331871,532,-1,0,,0,0.00000000000000000000
chr4,103778802,103787322,8520,-1,0,7323,1,11.73708920187790000000
chr4,103778982,103783720,4738,-1,0,7323,1,21.10595187842970000000
chr4,103780920,103783534,2614,-1,0,7323,1,38.25554705432290000000
chr4,103778922,103781087,2165,-1,0,7323,1,46.18937644341800000000
chr4,103872508,103875877,3369,-1,0,150159,1,29.68239833778570000000
chr4,104060207,104060318,111,-1,0,1062,1,900.90090090090100000000
chr4,104199803,104248910,49107,-1,0,,0,0.00000000000000000000
chr4,104211835,104214415,2580,-1,0,,0,0.00000000000000000000
chr4,104353020,104357355,4335,-1,0,,0,0.00000000000000000000
chr4,104607663,104634991,27328,-1,0,6870,1,3.65925058548009000000
chr4,106462577,106497274,34697,-1,0,54848,1,2.88209355275672000000
chr4,104738391,104759396,21005,-1,0,,0,0.00000000000000000000
chr4,106707369,106717132,9763,-1,0,79807,1,10.24275325207420000000
chr4,106936622,106946430,9808,-1,0,,0,0.00000000000000000000
chr4,105016999,105025435,8436,-1,0,,0,0.00000000000000000000
chr4,107056576,107063375,6799,-1,0,93627,1,14.70804530077950000000
chr4,105266284,105273834,7550,-1,0,,0,0.00000000000000000000
chr4,106577841,106583111,5270,-1,0,54848,1,18.97533206831120000000
chr4,104660503,104665351,4848,-1,0,,0,0.00000000000000000000
chr4,107056641,107060388,3747,-1,0,93627,1,26.68801708033090000000
chr4,106940387,106943210,2823,-1,0,,0,0.00000000000000000000
chr4,107060511,107063311,2800,-1,0,93627,1,35.71428571428570000000
chr4,106387324,106389251,1927,-1,0,27068,1,51.89413596263620000000
chr4,104893902,104894937,1035,-1,0,,0,0.00000000000000000000
chr4,105313705,105314605,900,-1,0,,0,0.00000000000000000000
chr4,106234658,106235221,563,-1,0,,0,0.00000000000000000000
chr4,105751717,105752299,582,-1,0,,0,0.00000000000000000000
chr4,104894031,104894689,658,-1,0,,0,0.00000000000000000000
chr4,106148436,106148943,507,-1,0,54790,1,197.23865877712000000000
chr4,106370065,106370478,413,-1,0,27068,1,242.13075060532700000000
chr4,105502900,105503179,279,-1,0,,0,0.00000000000000000000
chr4,106237897,106238179,282,-1,0,,0,0.00000000000000000000
chr4,105146316,105146584,268,-1,0,,0,0.00000000000000000000
chr4,105751866,105752055,189,-1,0,,0,0.00000000000000000000
chr4,106148623,106148804,181,-1,0,54790,1,552.48618784530400000000
chr4,106148650,106148758,108,-1,0,54790,1,925.92592592592600000000
chr4,106234888,106234946,58,-1,0,,0,0.00000000000000000000
chr4,107185799,107190139,4340,-1,0,93627,1,23.04147465437790000000
chr4,107405054,107408163,3109,-1,0,,0,0.00000000000000000000
chr4,107419549,107419989,440,-1,0,,0,0.00000000000000000000
chr4,107437482,107438682,1200,-1,0,,0,0.00000000000000000000
chr4,107437718,107438504,786,-1,0,,0,0.00000000000000000000
chr4,107440210,107442560,2350,-1,0,,0,0.00000000000000000000
chr4,107604296,107609298,5002,-1,0,,0,0.00000000000000000000
chr4,107814612,107816896,2284,-1,0,,0,0.00000000000000000000
chr4,107840621,107840967,346,-1,0,,0,0.00000000000000000000
chr4,107973915,107974963,1048,-1,0,,0,0.00000000000000000000
chr4,107974227,107974629,402,-1,0,,0,0.00000000000000000000
chr4,107974329,107974487,158,-1,0,,0,0.00000000000000000000
chr4,108065791,108088408,22617,-1,0,,0,0.00000000000000000000
chr4,108059669,108076211,16542,-1,0,,0,0.00000000000000000000
chr4,108063622,108076246,12624,-1,0,,0,0.00000000000000000000
chr4,108127642,108131881,4239,-1,0,,0,0.00000000000000000000
chr4,108153165,108162029,8864,-1,0,,0,0.00000000000000000000
chr4,108276414,108279611,3197,-1,0,,0,0.00000000000000000000
chr4,108333262,108333706,444,-1,0,,0,0.00000000000000000000
chr4,108476486,108478166,1680,-1,0,,0,0.00000000000000000000
chr4,108511075,108514829,3754,-1,0,,0,0.00000000000000000000
chr4,109107619,109108163,544,-1,0,,0,0.00000000000000000000
chr4,109107680,109108000,320,-1,0,,0,0.00000000000000000000
chr4,109347024,109348795,1771,-1,0,,0,0.00000000000000000000
chr4,109373518,109378014,4496,-1,0,,0,0.00000000000000000000
chr4,109607158,109608902,1744,-1,0,,0,0.00000000000000000000
chr4,109632929,109633069,140,-1,0,,0,0.00000000000000000000
chr4,109668295,109668411,116,-1,0,64850,1,862.06896551724100000000
chr4,109721072,109722235,1163,-1,0,,0,0.00000000000000000000
chr4,109716620,109717759,1139,-1,0,,0,0.00000000000000000000
chr4,109721226,109722010,784,-1,0,,0,0.00000000000000000000
chr4,109961903,109965656,3753,-1,0,84570,1,26.64535038635760000000
chr4,110260882,110267547,6665,-1,0,,0,0.00000000000000000000
chr4,110339340,110339490,150,-1,0,,0,0.00000000000000000000
chr4,110385558,110389852,4294,-1,0,10427,1,23.28830926874710000000
chr4,110498656,110499159,503,-1,0,55013,1,198.80715705765400000000
chr4,110498740,110499065,325,-1,0,55013,1,307.69230769230800000000
chr4,110748459,110748525,66,-1,0,,0,0.00000000000000000000
chr4,110840747,110845747,5000,-1,0,1950,1,20.00000000000000000000
chr4,110939653,110942596,2943,-1,0,,0,0.00000000000000000000
chr4,111008874,111013338,4464,-1,0,79071,1,22.40143369175630000000
chr4,111005691,111008604,2913,-1,0,79071,1,34.32887058015790000000
chr4,111004038,111005061,1023,-1,0,79071,1,97.75171065493650000000
chr4,111157394,111160612,3218,-1,0,,0,0.00000000000000000000
chr4,111296398,111301584,5186,-1,0,,0,0.00000000000000000000
chr4,111383099,111383639,540,-1,0,,0,0.00000000000000000000
chr4,111383202,111383535,333,-1,0,,0,0.00000000000000000000
chr4,112297243,112309619,12376,-1,0,,0,0.00000000000000000000
chr4,112882678,112894974,12296,-1,0,,0,0.00000000000000000000
chr4,112238095,112244432,6337,-1,0,,0,0.00000000000000000000
chr4,112677119,112681403,4284,-1,0,,0,0.00000000000000000000
chr4,112422844,112426236,3392,-1,0,,0,0.00000000000000000000
chr4,112238948,112241949,3001,-1,0,,0,0.00000000000000000000
chr4,112569765,112571930,2165,-1,0,,0,0.00000000000000000000
chr4,111625897,111626860,963,-1,0,,0,0.00000000000000000000
chr4,111804716,111805352,636,-1,0,,0,0.00000000000000000000
chr4,111808620,111809201,581,-1,0,,0,0.00000000000000000000
chr4,111516193,111516704,511,-1,0,,0,0.00000000000000000000
chr4,111808758,111809077,319,-1,0,,0,0.00000000000000000000
chr4,111516311,111516515,204,-1,0,,0,0.00000000000000000000
chr4,113043538,113052388,8850,-1,0,,0,0.00000000000000000000
chr4,113225323,113232183,6860,-1,0,80216,1,14.57725947521870000000
chr4,113348332,113348716,384,-1,0,80216,1,260.41666666666700000000
chr4,113348510,113348574,64,-1,0,80216,1,1562.50000000000000000000
chr4,113469863,113470408,545,-1,0,55345,1,183.48623853211000000000
chr4,113469971,113470282,311,-1,0,55345,1,321.54340836012900000000
chr4,113498159,113501934,3775,-1,0,55345,1,26.49006622516560000000
chr4,113985577,113986648,1071,-1,0,287,1,93.37068160597570000000
chr4,113985746,113986516,770,-1,0,287,1,129.87012987013000000000
chr4,113985962,113986314,352,-1,0,287,1,284.09090909090900000000
chr4,114129190,114131077,1887,-1,0,287,1,52.99417064122950000000
chr4,114135091,114135577,486,-1,0,287,1,205.76131687242800000000
chr4,114147800,114149917,2117,-1,0,287,1,47.23665564478030000000
chr4,114255676,114256033,357,-1,0,287,1,280.11204481792700000000
chr4,114255720,114255915,195,-1,0,287,1,512.82051282051300000000
chr4,114354293,114364154,9861,-1,0,,0,0.00000000000000000000
chr4,114538757,114539066,309,-1,0,817,1,323.62459546925600000000
chr4,114822858,114823267,409,-1,0,79642,1,244.49877750611200000000
chr4,115130765,115179039,48274,-1,0,,0,0.00000000000000000000
chr4,115173732,115186862,13130,-1,0,,0,0.00000000000000000000
chr4,115172331,115182688,10357,-1,0,,0,0.00000000000000000000
chr4,115178208,115182289,4081,-1,0,,0,0.00000000000000000000
chr4,115179615,115182239,2624,-1,0,,0,0.00000000000000000000
chr4,115146987,115147212,225,-1,0,,0,0.00000000000000000000
chr4,115441565,115441866,301,-1,0,,0,0.00000000000000000000
chr4,115508201,115521100,12899,-1,0,7368,1,7.75253895650826000000
chr4,115507351,115513902,6551,-1,0,,0,0.00000000000000000000
chr4,115511019,115513826,2807,-1,0,,0,0.00000000000000000000
chr4,115507819,115511040,3221,-1,0,,0,0.00000000000000000000
chr4,115507808,115509144,1336,-1,0,,0,0.00000000000000000000
chr4,115624519,115624981,462,-1,0,,0,0.00000000000000000000
chr4,115624601,115624879,278,-1,0,,0,0.00000000000000000000
chr4,115712379,115717253,4874,-1,0,,0,0.00000000000000000000
chr4,115743886,115744132,246,-1,0,,0,0.00000000000000000000
chr4,115768130,115768693,563,-1,0,64579,1,177.61989342806400000000
chr4,115768251,115768581,330,-1,0,64579,1,303.03030303030300000000
chr4,115885928,115887643,1715,-1,0,64579,1,58.30903790087460000000
chr4,117167554,118168013,1000459,-1,0,133022,1,0.09995412105843420000
chr4,116225606,116349885,124279,-1,0,,0,0.00000000000000000000
chr4,116162129,116196306,34177,-1,0,,0,0.00000000000000000000
chr4,116165267,116178856,13589,-1,0,,0,0.00000000000000000000
chr4,116265999,116276627,10628,-1,0,,0,0.00000000000000000000
chr4,116172611,116180784,8173,-1,0,,0,0.00000000000000000000
chr4,116880205,116888292,8087,-1,0,,0,0.00000000000000000000
chr4,116172679,116176887,4208,-1,0,,0,0.00000000000000000000
chr4,116311756,116315581,3825,-1,0,,0,0.00000000000000000000
chr4,115928725,115931880,3155,-1,0,64579,1,31.69572107765450000000
chr4,117499736,117503017,3281,-1,0,,0,0.00000000000000000000
chr4,117646967,117649877,2910,-1,0,,0,0.00000000000000000000
chr4,117654805,117657734,2929,-1,0,,0,0.00000000000000000000
chr4,117354386,117356420,2034,-1,0,,0,0.00000000000000000000
chr4,116421590,116422601,1011,-1,0,,0,0.00000000000000000000
chr4,117700196,117701107,911,-1,0,,0,0.00000000000000000000
chr4,115928719,115929383,664,-1,0,64579,1,150.60240963855400000000
chr4,117367743,117368477,734,-1,0,,0,0.00000000000000000000
chr4,117251355,117251912,557,-1,0,,0,0.00000000000000000000
chr4,117095043,117095631,588,-1,0,,0,0.00000000000000000000
chr4,117420599,117420975,376,-1,0,,0,0.00000000000000000000
chr4,116421738,116422278,540,-1,0,,0,0.00000000000000000000
chr4,117151702,117152196,494,-1,0,,0,0.00000000000000000000
chr4,116017145,116017581,436,-1,0,64579,1,229.35779816513800000000
chr4,117251476,117251804,328,-1,0,,0,0.00000000000000000000
chr4,117420629,117420908,279,-1,0,,0,0.00000000000000000000
chr4,117095261,117095394,133,-1,0,,0,0.00000000000000000000
chr4,115942666,115942769,103,-1,0,64579,1,970.87378640776700000000
chr4,116017360,116017446,86,-1,0,64579,1,1162.79069767442000000000
chr4,116017275,116017360,85,-1,0,64579,1,1176.47058823529000000000
chr4,118222200,118222279,79,-1,0,,0,0.00000000000000000000
chr4,118383656,118396027,12371,-1,0,,0,0.00000000000000000000
chr4,118505031,118505584,553,-1,0,,0,0.00000000000000000000
chr4,118505142,118505351,209,-1,0,,0,0.00000000000000000000
chr4,118505234,118505374,140,-1,0,,0,0.00000000000000000000
chr4,118809391,118810532,1141,-1,0,,0,0.00000000000000000000
chr4,118841130,118842236,1106,-1,0,,0,0.00000000000000000000
chr4,119115314,119131154,15840,-1,0,9348,1,6.31313131313131000000
chr4,119124285,119130721,6436,-1,0,9348,1,15.53760099440650000000
chr4,119125721,119130798,5077,-1,0,9348,1,19.69667126255660000000
chr4,119243759,119247136,3377,-1,0,8492,1,29.61208172934560000000
chr4,119277947,119310528,32581,-1,0,,0,0.00000000000000000000
chr4,119296319,119296742,423,-1,0,,0,0.00000000000000000000
chr4,119322762,119322885,123,-1,0,,0,0.00000000000000000000
chr4,119398867,119409930,11063,-1,0,,0,0.00000000000000000000
chr4,119867587,119867659,72,-1,0,171024,1,1388.88888888889000000000
chr4,120013807,120014133,326,-1,0,,0,0.00000000000000000000
chr4,120017216,120017615,399,-1,0,,0,0.00000000000000000000
chr4,120027247,120027580,333,-1,0,,0,0.00000000000000000000
chr4,120131511,120132994,1483,-1,0,,0,0.00000000000000000000
chr4,120169374,120169715,341,-1,0,54532,1,293.25513196480900000000
chr4,120236153,120237298,1145,-1,0,,0,0.00000000000000000000
chr4,120244490,120244937,447,-1,0,,0,0.00000000000000000000
chr4,120244557,120244903,346,-1,0,,0,0.00000000000000000000
chr4,120332945,120352176,19231,-1,0,,0,0.00000000000000000000
chr4,120263682,120264654,972,-1,0,,0,0.00000000000000000000
chr4,120552585,120556579,3994,-1,0,,0,0.00000000000000000000
chr4,120579963,120580880,917,-1,0,,0,0.00000000000000000000
chr4,120600195,120606604,6409,-1,0,,0,0.00000000000000000000
chr4,120780797,120781067,270,-1,0,,0,0.00000000000000000000
chr4,120865451,120866622,1171,-1,0,,0,0.00000000000000000000
chr4,120963734,120965106,1372,-1,0,,0,0.00000000000000000000
chr4,121086403,121087663,1260,-1,0,,0,0.00000000000000000000
chr4,121087086,121087292,206,-1,0,,0,0.00000000000000000000
chr4,121407646,121407970,324,-1,0,,0,0.00000000000000000000
chr4,121469771,121470846,1075,-1,0,,0,0.00000000000000000000
chr4,121522997,121545823,22826,-1,0,,0,0.00000000000000000000
chr4,121808932,121809267,335,-1,0,11107,1,298.50746268656700000000
chr4,121856384,121860954,4570,-1,0,,0,0.00000000000000000000
chr4,122208132,122209548,1416,-1,0,,0,0.00000000000000000000
chr4,122232648,122232766,118,-1,0,,0,0.00000000000000000000
chr4,122234711,122234857,146,-1,0,,0,0.00000000000000000000
chr4,122276391,122292236,15845,-1,0,84109,1,6.31113916061849000000
chr4,122282462,122295555,13093,-1,0,84109,1,7.63766898342626000000
chr4,122281840,122290453,8613,-1,0,84109,1,11.61035643794260000000
chr4,122281981,122285227,3246,-1,0,84109,1,30.80714725816390000000
chr4,122334385,122411416,77031,-1,0,,0,0.00000000000000000000
chr4,122387847,122388054,207,-1,0,,0,0.00000000000000000000
chr4,122428808,122429439,631,-1,0,,0,0.00000000000000000000
chr4,122690987,122692834,1847,-1,0,,0,0.00000000000000000000
chr4,123325808,123328279,2471,-1,0,132612,1,40.46944556859570000000
chr4,123411531,123413657,2126,-1,0,,0,0.00000000000000000000
chr4,123411363,123412448,1085,-1,0,,0,0.00000000000000000000
chr4,123502013,123502434,421,-1,0,,0,0.00000000000000000000
chr4,123633914,123635395,1481,-1,0,,0,0.00000000000000000000
chr4,123710268,123710673,405,-1,0,,0,0.00000000000000000000
chr4,123959285,124002783,43498,-1,0,166378,1,2.29895627385167000000
chr4,123973283,123976106,2823,-1,0,166378,1,35.42330853701740000000
chr4,124256336,124260045,3709,-1,0,,0,0.00000000000000000000
chr4,124481350,124481995,645,-1,0,,0,0.00000000000000000000
chr4,124916945,124920368,3423,-1,0,,0,0.00000000000000000000
chr4,124939181,124939694,513,-1,0,,0,0.00000000000000000000
chr4,124943548,124945188,1640,-1,0,,0,0.00000000000000000000
chr4,125016687,125020519,3832,-1,0,,0,0.00000000000000000000
chr4,125285068,125325063,39995,-1,0,,0,0.00000000000000000000
chr4,125671695,125672094,399,-1,0,,0,0.00000000000000000000
chr4,125753956,125754296,340,-1,0,,0,0.00000000000000000000
chr4,125768495,125768908,413,-1,0,,0,0.00000000000000000000
chr4,125867263,125867814,551,-1,0,,0,0.00000000000000000000
chr4,125867375,125867704,329,-1,0,,0,0.00000000000000000000
chr4,126160958,126166827,5869,-1,0,,0,0.00000000000000000000
chr4,126485982,127069540,583558,-1,0,,0,0.00000000000000000000
chr4,126670480,126715960,45480,-1,0,,0,0.00000000000000000000
chr4,126686084,126696846,10762,-1,0,,0,0.00000000000000000000
chr4,126591264,126597787,6523,-1,0,,0,0.00000000000000000000
chr4,126497792,126502583,4791,-1,0,,0,0.00000000000000000000
chr4,127428048,127701663,273615,-1,0,,0,0.00000000000000000000
chr4,127365849,127371224,5375,-1,0,,0,0.00000000000000000000
chr4,127512725,127518063,5338,-1,0,,0,0.00000000000000000000
chr4,127640359,127640696,337,-1,0,,0,0.00000000000000000000
chr4,128156409,128157318,909,-1,0,,0,0.00000000000000000000
chr4,128380531,128390710,10179,-1,0,,0,0.00000000000000000000
chr4,128752700,128753242,542,-1,0,22824,1,184.50184501845000000000
chr4,128982058,128983393,1335,-1,0,55132,1,74.90636704119850000000
chr4,129699700,129699993,293,-1,0,,0,0.00000000000000000000
chr4,129844363,129849893,5530,-1,0,132320,1,18.08318264014470000000
chr4,130062071,130069106,7035,-1,0,,0,0.00000000000000000000
chr4,130067103,130073799,6696,-1,0,,0,0.00000000000000000000
chr4,130066183,130068434,2251,-1,0,,0,0.00000000000000000000
chr4,130066599,130068122,1523,-1,0,,0,0.00000000000000000000
chr4,130143257,130143526,269,-1,0,,0,0.00000000000000000000
chr4,130143289,130143384,95,-1,0,,0,0.00000000000000000000
chr4,130216072,130219716,3644,-1,0,,0,0.00000000000000000000
chr4,130280825,130282940,2115,-1,0,,0,0.00000000000000000000
chr4,130406841,130408097,1256,-1,0,,0,0.00000000000000000000
chr4,130407307,130407920,613,-1,0,,0,0.00000000000000000000
chr4,130407535,130407666,131,-1,0,,0,0.00000000000000000000
chr4,130477682,130481922,4240,-1,0,,0,0.00000000000000000000
chr4,130585151,130587966,2815,-1,0,,0,0.00000000000000000000
chr4,130590834,130591317,483,-1,0,,0,0.00000000000000000000
chr4,130590921,130591222,301,-1,0,,0,0.00000000000000000000
chr4,130592606,130592695,89,-1,0,,0,0.00000000000000000000
chr4,130626126,130626804,678,-1,0,,0,0.00000000000000000000
chr4,130626376,130626648,272,-1,0,,0,0.00000000000000000000
chr4,130933055,130992475,59420,-1,0,,0,0.00000000000000000000
chr4,130966967,131013470,46503,-1,0,,0,0.00000000000000000000
chr4,131519909,131631415,111506,-1,0,,0,0.00000000000000000000
chr4,131487261,131490248,2987,-1,0,,0,0.00000000000000000000
chr4,131568272,131570203,1931,-1,0,,0,0.00000000000000000000
chr4,131610706,131612088,1382,-1,0,,0,0.00000000000000000000
chr4,131611068,131611494,426,-1,0,,0,0.00000000000000000000
chr4,131611179,131611360,181,-1,0,,0,0.00000000000000000000
chr4,131611239,131611319,80,-1,0,,0,0.00000000000000000000
chr4,131694603,131695292,689,-1,0,,0,0.00000000000000000000
chr4,131694837,131695089,252,-1,0,,0,0.00000000000000000000
chr4,132122607,132123600,993,-1,0,,0,0.00000000000000000000
chr4,132122535,132122734,199,-1,0,,0,0.00000000000000000000
chr4,132217227,132219505,2278,-1,0,,0,0.00000000000000000000
chr4,132569270,132596623,27353,-1,0,,0,0.00000000000000000000
chr4,132490407,132493640,3233,-1,0,,0,0.00000000000000000000
chr4,132643126,132686748,43622,-1,0,,0,0.00000000000000000000
chr4,132664314,132664804,490,-1,0,,0,0.00000000000000000000
chr4,132895842,132899583,3741,-1,0,,0,0.00000000000000000000
chr4,132971309,132973075,1766,-1,0,,0,0.00000000000000000000
chr4,133067987,133068451,464,-1,0,,0,0.00000000000000000000
chr4,133068169,133068270,101,-1,0,,0,0.00000000000000000000
chr4,133114019,133114384,365,-1,0,,0,0.00000000000000000000
chr4,133173840,133183343,9503,-1,0,,0,0.00000000000000000000
chr4,133178892,133182382,3490,-1,0,,0,0.00000000000000000000
chr4,133180782,133182978,2196,-1,0,,0,0.00000000000000000000
chr4,133181437,133182510,1073,-1,0,,0,0.00000000000000000000
chr4,133264504,133301652,37148,-1,0,,0,0.00000000000000000000
chr4,133365278,133365764,486,-1,0,,0,0.00000000000000000000
chr4,133365478,133365600,122,-1,0,,0,0.00000000000000000000
chr4,133620865,133624501,3636,-1,0,,0,0.00000000000000000000
chr4,133619795,133620309,514,-1,0,,0,0.00000000000000000000
chr4,133445300,133445830,530,-1,0,,0,0.00000000000000000000
chr4,133445430,133445701,271,-1,0,,0,0.00000000000000000000
chr4,133619884,133620194,310,-1,0,,0,0.00000000000000000000
chr4,133875920,133953070,77150,-1,0,,0,0.00000000000000000000
chr4,133865336,133871624,6288,-1,0,,0,0.00000000000000000000
chr4,133819509,133820061,552,-1,0,,0,0.00000000000000000000
chr4,133790462,133790796,334,-1,0,,0,0.00000000000000000000
chr4,133819613,133819936,323,-1,0,,0,0.00000000000000000000
chr4,133962276,133962449,173,-1,0,,0,0.00000000000000000000
chr4,133962311,133962393,82,-1,0,,0,0.00000000000000000000
chr4,134131785,134134104,2319,-1,0,,0,0.00000000000000000000
chr4,134132404,134133156,752,-1,0,,0,0.00000000000000000000
chr4,134137693,134137747,54,-1,0,,0,0.00000000000000000000
chr4,134141517,134142017,500,-1,0,,0,0.00000000000000000000
chr4,134141610,134141923,313,-1,0,,0,0.00000000000000000000
chr4,134177555,134182959,5404,-1,0,,0,0.00000000000000000000
chr4,134173490,134176764,3274,-1,0,,0,0.00000000000000000000
chr4,134279601,134280473,872,-1,0,,0,0.00000000000000000000
chr4,134295533,134295884,351,-1,0,,0,0.00000000000000000000
chr4,134346774,134346898,124,-1,0,,0,0.00000000000000000000
chr4,134489585,134491480,1895,-1,0,,0,0.00000000000000000000
chr4,134918953,135191179,272226,-1,0,132430,1,0.36734184097037000000
chr4,134919554,135069607,150053,-1,0,,0,0.00000000000000000000
chr4,135093535,135202586,109051,-1,0,132430,1,0.91700213661497800000
chr4,134929085,134997757,68672,-1,0,,0,0.00000000000000000000
chr4,135049233,135096953,47720,-1,0,,0,0.00000000000000000000
chr4,134990816,135016672,25856,-1,0,,0,0.00000000000000000000
chr4,134860484,134861507,1023,-1,0,,0,0.00000000000000000000
chr4,135163158,135163448,290,-1,0,,0,0.00000000000000000000
chr4,138092542,138181530,88988,-1,0,,0,0.00000000000000000000
chr4,137539804,137624752,84948,-1,0,,0,0.00000000000000000000
chr4,136529470,136602051,72581,-1,0,,0,0.00000000000000000000
chr4,138084595,138110381,25786,-1,0,,0,0.00000000000000000000
chr4,138074663,138100427,25764,-1,0,,0,0.00000000000000000000
chr4,135818150,135838305,20155,-1,0,,0,0.00000000000000000000
chr4,138182342,138197449,15107,-1,0,,0,0.00000000000000000000
chr4,136652795,136666455,13660,-1,0,,0,0.00000000000000000000
chr4,138179927,138191489,11562,-1,0,,0,0.00000000000000000000
chr4,138091903,138100638,8735,-1,0,,0,0.00000000000000000000
chr4,138324050,138333418,9368,-1,0,,0,0.00000000000000000000
chr4,136900141,136906335,6194,-1,0,,0,0.00000000000000000000
chr4,137359061,137364851,5790,-1,0,,0,0.00000000000000000000
chr4,135433001,135435702,2701,-1,0,,0,0.00000000000000000000
chr4,136408291,136412245,3954,-1,0,,0,0.00000000000000000000
chr4,138536851,138540621,3770,-1,0,,0,0.00000000000000000000
chr4,136508230,136511666,3436,-1,0,,0,0.00000000000000000000
chr4,137018567,137021758,3191,-1,0,,0,0.00000000000000000000
chr4,138092280,138095121,2841,-1,0,,0,0.00000000000000000000
chr4,135515007,135517979,2972,-1,0,,0,0.00000000000000000000
chr4,137073434,137076058,2624,-1,0,,0,0.00000000000000000000
chr4,138211625,138213834,2209,-1,0,,0,0.00000000000000000000
chr4,136377805,136380192,2387,-1,0,,0,0.00000000000000000000
chr4,135433121,135434946,1825,-1,0,,0,0.00000000000000000000
chr4,136904268,136905955,1687,-1,0,,0,0.00000000000000000000
chr4,136917564,136918857,1293,-1,0,,0,0.00000000000000000000
chr4,138092212,138093414,1202,-1,0,,0,0.00000000000000000000
chr4,137835888,137836852,964,-1,0,,0,0.00000000000000000000
chr4,137207580,137208685,1105,-1,0,,0,0.00000000000000000000
chr4,136458707,136459727,1020,-1,0,,0,0.00000000000000000000
chr4,138667026,138667830,804,-1,0,,0,0.00000000000000000000
chr4,135927417,135927985,568,-1,0,,0,0.00000000000000000000
chr4,135589816,135590283,467,-1,0,,0,0.00000000000000000000
chr4,135927540,135927867,327,-1,0,,0,0.00000000000000000000
chr4,137943915,137944135,220,-1,0,,0,0.00000000000000000000
chr4,135590055,135590172,117,-1,0,,0,0.00000000000000000000
chr4,138816684,138816807,123,-1,0,,0,0.00000000000000000000
chr4,137541597,137541694,97,-1,0,,0,0.00000000000000000000
chr4,138918630,138920598,1968,-1,0,,0,0.00000000000000000000
chr4,138965658,138968326,2668,-1,0,,0,0.00000000000000000000
chr4,138966194,138967212,1018,-1,0,,0,0.00000000000000000000
chr4,138966397,138967119,722,-1,0,,0,0.00000000000000000000
chr4,139039525,139040692,1167,-1,0,,0,0.00000000000000000000
chr4,139347114,139347476,362,-1,0,,0,0.00000000000000000000
chr4,139347265,139347363,98,-1,0,,0,0.00000000000000000000
chr4,139468739,139473417,4678,-1,0,,0,0.00000000000000000000
chr4,139677513,139710109,32596,-1,0,,0,0.00000000000000000000
chr4,139878882,139883559,4677,-1,0,,0,0.00000000000000000000
chr4,139947963,139948412,449,-1,0,25819,1,222.71714922049000000000
chr4,140231147,140238779,7632,-1,0,80155,1,13.10272536687630000000
chr4,140233656,140238527,4871,-1,0,80155,1,20.52966536645450000000
chr4,140528313,140530961,2648,-1,0,,0,0.00000000000000000000
chr4,140722611,140723021,410,-1,0,55534,1,243.90243902439000000000
chr4,141025932,141027057,1125,-1,0,55534,1,88.88888888888890000000
chr4,141145850,141146143,293,-1,0,,0,0.00000000000000000000
chr4,141242724,141247310,4586,-1,0,60592,1,21.80549498473620000000
chr4,141633307,141633603,296,-1,0,23158,1,337.83783783783800000000
chr4,141926901,141927305,404,-1,0,57484,1,247.52475247524800000000
chr4,142105926,142106613,687,-1,0,,0,0.00000000000000000000
chr4,142230540,142233049,2509,-1,0,,0,0.00000000000000000000
chr4,142230988,142232687,1699,-1,0,,0,0.00000000000000000000
chr4,142853135,142853742,607,-1,0,,0,0.00000000000000000000
chr4,142853434,142853557,123,-1,0,,0,0.00000000000000000000
chr4,142975122,142975219,97,-1,0,8821,1,1030.92783505155000000000
chr4,142995930,142996591,661,-1,0,8821,1,151.28593040847200000000
chr4,143029543,143029600,57,-1,0,8821,1,1754.38596491228000000000
chr4,143166899,143167251,352,-1,0,8821,1,284.09090909090900000000
chr4,143167009,143167163,154,-1,0,8821,1,649.35064935064900000000
chr4,143329557,143330577,1020,-1,0,8821,1,98.03921568627450000000
chr4,143502472,143502950,478,-1,0,8821,1,209.20502092050200000000
chr4,143502710,143502813,103,-1,0,8821,1,970.87378640776700000000
chr4,143615981,143621367,5386,-1,0,8821,1,18.56665428889710000000
chr4,143694970,143696455,1485,-1,0,8821,1,67.34006734006730000000
chr4,143793738,143801003,7265,-1,0,,0,0.00000000000000000000
chr4,143794390,143800957,6567,-1,0,,0,0.00000000000000000000
chr4,143857918,143858595,677,-1,0,,0,0.00000000000000000000
chr4,144036753,144039617,2864,-1,0,,0,0.00000000000000000000
chr4,144042349,144042844,495,-1,0,,0,0.00000000000000000000
chr4,144573286,144573614,328,-1,0,166752,1,304.87804878048800000000
chr4,144692680,145044721,352041,-1,0,2993;2996;2994,3,0.85217346843123400000
chr4,144835470,145067183,231713,-1,0,2993;2994,2,0.86313672517295100000
chr4,144747780,144886898,139118,-1,0,2996,1,0.71881424402306000000
chr4,144714438,144845085,130647,-1,0,2996,1,0.76542132616899000000
chr4,144834935,144942344,107409,-1,0,2994,1,0.93102067796925800000
chr4,144807648,144926791,119143,-1,0,2996;2994,2,1.67865506156467000000
chr4,144921101,145039945,118844,-1,0,2993;2994,2,1.68287839520716000000
chr4,144839090,144907679,68589,-1,0,,0,0.00000000000000000000
chr4,144956435,145017624,61189,-1,0,,0,0.00000000000000000000
chr4,144914976,144962140,47164,-1,0,2994,1,2.12026121618183000000
chr4,144996627,145055060,58433,-1,0,2993,1,1.71136173052898000000
chr4,144754067,144784378,30311,-1,0,,0,0.00000000000000000000
chr4,145015415,145039289,23874,-1,0,2993,1,4.18865711652844000000
chr4,145001294,145012605,11311,-1,0,,0,0.00000000000000000000
chr4,144773512,144773961,449,-1,0,,0,0.00000000000000000000
chr4,145315932,145320231,4299,-1,0,,0,0.00000000000000000000
chr4,145333561,145358296,24735,-1,0,,0,0.00000000000000000000
chr4,145486851,145517320,30469,-1,0,,0,0.00000000000000000000
chr4,146053200,146053737,537,-1,0,,0,0.00000000000000000000
chr4,146242471,146242541,70,-1,0,,0,0.00000000000000000000
chr4,146274585,146291571,16986,-1,0,,0,0.00000000000000000000
chr4,146438646,146440989,2343,-1,0,4086,1,42.68032437046520000000
chr4,146447702,146449055,1353,-1,0,4086,1,73.90983000739100000000
chr4,146438834,146440006,1172,-1,0,4086,1,85.32423208191130000000
chr4,146901820,146904359,2539,-1,0,,0,0.00000000000000000000
chr4,146919085,146928367,9282,-1,0,,0,0.00000000000000000000
chr4,146924914,146927654,2740,-1,0,,0,0.00000000000000000000
chr4,147206842,147208377,1535,-1,0,84068,1,65.14657980456030000000
chr4,147322289,147331041,8752,-1,0,84068,1,11.42595978062160000000
chr4,147593946,147593999,53,-1,0,,0,0.00000000000000000000
chr4,147730167,147731079,912,-1,0,83894,1,109.64912280701800000000
chr4,147865493,147866662,1169,-1,0,83894,1,85.54319931565440000000
chr4,147920589,147920903,314,-1,0,,0,0.00000000000000000000
chr4,148016507,148016751,244,-1,0,,0,0.00000000000000000000
chr4,148133818,148135108,1290,-1,0,,0,0.00000000000000000000
chr4,148494954,148501474,6520,-1,0,,0,0.00000000000000000000
chr4,148516395,148535881,19486,-1,0,,0,0.00000000000000000000
chr4,149099302,149101632,2330,-1,0,4306,1,42.91845493562230000000
chr4,149230673,149230912,239,-1,0,4306,1,418.41004184100400000000
chr4,149365409,149367008,1599,-1,0,,0,0.00000000000000000000
chr4,149426625,149430059,3434,-1,0,,0,0.00000000000000000000
chr4,149413756,149413829,73,-1,0,,0,0.00000000000000000000
chr4,149967989,149968239,250,-1,0,,0,0.00000000000000000000
chr4,149968095,149968303,208,-1,0,,0,0.00000000000000000000
chr4,149990577,149992577,2000,-1,0,,0,0.00000000000000000000
chr4,150161034,150161427,393,-1,0,,0,0.00000000000000000000
chr4,150553987,150558354,4367,-1,0,,0,0.00000000000000000000
chr4,150559893,150560292,399,-1,0,,0,0.00000000000000000000
chr4,150950944,150951421,477,-1,0,,0,0.00000000000000000000
chr4,150951040,150951362,322,-1,0,,0,0.00000000000000000000
chr4,150952841,150953362,521,-1,0,,0,0.00000000000000000000
chr4,151049162,151053343,4181,-1,0,166614,1,23.91772303276730000000
chr4,151192533,151192859,326,-1,0,987,1,306.74846625766900000000
chr4,151693466,151697525,4059,-1,0,987,1,24.63661000246370000000
chr4,151754380,151755007,627,-1,0,987,1,159.48963317384400000000
chr4,151867566,151884289,16723,-1,0,987,1,5.97978831549363000000
chr4,151874229,151886412,12183,-1,0,987,1,8.20815890995650000000
chr4,151875780,151887025,11245,-1,0,987,1,8.89284126278346000000
chr4,151877955,151883940,5985,-1,0,987,1,16.70843776106930000000
chr4,151881841,151883776,1935,-1,0,987,1,51.67958656330750000000
chr4,152050277,152052896,2619,-1,0,152503,1,38.18251240931650000000
chr4,152088118,152090192,2074,-1,0,152503,1,48.21600771456120000000
chr4,152161351,152163149,1798,-1,0,,0,0.00000000000000000000
chr4,152252121,152254283,2162,-1,0,,0,0.00000000000000000000
chr4,152252589,152253892,1303,-1,0,,0,0.00000000000000000000
chr4,152253165,152254176,1011,-1,0,,0,0.00000000000000000000
chr4,152285601,152286360,759,-1,0,,0,0.00000000000000000000
chr4,152340661,152341604,943,-1,0,729830,1,106.04453870625700000000
chr4,152342702,152343523,821,-1,0,729830,1,121.80267965895200000000
chr4,152790157,152794767,4610,-1,0,,0,0.00000000000000000000
chr4,152789966,152792851,2885,-1,0,,0,0.00000000000000000000
chr4,152778542,152779017,475,-1,0,,0,0.00000000000000000000
chr4,152891438,152893713,2275,-1,0,,0,0.00000000000000000000
chr4,152990294,152993950,3656,-1,0,,0,0.00000000000000000000
chr4,152991071,152993525,2454,-1,0,,0,0.00000000000000000000
chr4,153095666,153096265,599,-1,0,,0,0.00000000000000000000
chr4,153649459,153649518,59,-1,0,,0,0.00000000000000000000
chr4,153907841,153910422,2581,-1,0,,0,0.00000000000000000000
chr4,154050406,154051621,1215,-1,0,,0,0.00000000000000000000
chr4,154050975,154051292,317,-1,0,,0,0.00000000000000000000
chr4,154232455,154235004,2549,-1,0,23321,1,39.23107100823850000000
chr4,154290796,154293594,2798,-1,0,84057,1,35.73981415296640000000
chr4,154386640,154389458,2818,-1,0,23240,1,35.48616039744500000000
chr4,154396279,154404694,8415,-1,0,23240,1,11.88354129530600000000
chr4,154998232,155046914,48682,-1,0,,0,0.00000000000000000000
chr4,155267658,155270457,2799,-1,0,54798,1,35.72704537334760000000
chr4,155802798,155803299,501,-1,0,,0,0.00000000000000000000
chr4,155802999,155803102,103,-1,0,,0,0.00000000000000000000
chr4,155982155,155983745,1590,-1,0,,0,0.00000000000000000000
chr4,156064652,156077027,12375,-1,0,,0,0.00000000000000000000
chr4,156138377,156140960,2583,-1,0,,0,0.00000000000000000000
chr4,156222534,156223186,652,-1,0,,0,0.00000000000000000000
chr4,156249272,156249675,403,-1,0,,0,0.00000000000000000000
chr4,156475474,156475697,223,-1,0,,0,0.00000000000000000000
chr4,156570156,156597989,27833,-1,0,2982,1,3.59285739948981000000
chr4,156594168,156598399,4231,-1,0,2982,1,23.63507445048450000000
chr4,156594092,156597998,3906,-1,0,2982,1,25.60163850486430000000
chr4,156673800,156678848,5048,-1,0,,0,0.00000000000000000000
chr4,156758158,156758527,369,-1,0,51802,1,271.00271002710000000000
chr4,156879311,156902056,22745,-1,0,,0,0.00000000000000000000
chr4,156885176,156893348,8172,-1,0,,0,0.00000000000000000000
chr4,156879051,156880821,1770,-1,0,,0,0.00000000000000000000
chr4,156930328,156930378,50,-1,0,,0,0.00000000000000000000
chr4,156935077,156935172,95,-1,0,,0,0.00000000000000000000
chr4,156959317,156973990,14673,-1,0,,0,0.00000000000000000000
chr4,156966544,156975797,9253,-1,0,,0,0.00000000000000000000
chr4,156968601,156973166,4565,-1,0,,0,0.00000000000000000000
chr4,157002020,157002362,342,-1,0,,0,0.00000000000000000000
chr4,157128858,157139571,10713,-1,0,,0,0.00000000000000000000
chr4,157305617,157310151,4534,-1,0,,0,0.00000000000000000000
chr4,157305259,157306932,1673,-1,0,,0,0.00000000000000000000
chr4,157407175,157412495,5320,-1,0,,0,0.00000000000000000000
chr4,157424027,157424910,883,-1,0,,0,0.00000000000000000000
chr4,157406913,157406991,78,-1,0,,0,0.00000000000000000000
chr4,157557314,157557891,577,-1,0,,0,0.00000000000000000000
chr4,157680494,157681429,935,-1,0,,0,0.00000000000000000000
chr4,157862405,157868642,6237,-1,0,56034,1,16.03334936668270000000
chr4,157878149,157880579,2430,-1,0,56034,1,41.15226337448560000000
chr4,157977304,157977757,453,-1,0,,0,0.00000000000000000000
chr4,157977511,157977635,124,-1,0,,0,0.00000000000000000000
chr4,158033490,158037697,4207,-1,0,2743,1,23.76990729736150000000
chr4,158399625,158405401,5776,-1,0,,0,0.00000000000000000000
chr4,158555758,158560459,4701,-1,0,,0,0.00000000000000000000
chr4,158620990,158650277,29287,-1,0,,0,0.00000000000000000000
chr4,158727360,158731501,4141,-1,0,,0,0.00000000000000000000
chr4,158729538,158731336,1798,-1,0,,0,0.00000000000000000000
chr4,158938255,158938390,135,-1,0,,0,0.00000000000000000000
chr4,159027378,159028491,1113,-1,0,,0,0.00000000000000000000
chr4,159214251,159220096,5845,-1,0,,0,0.00000000000000000000
chr4,159218935,159219469,534,-1,0,,0,0.00000000000000000000
chr4,159431114,159432014,900,-1,0,,0,0.00000000000000000000
chr4,159661169,159661547,378,-1,0,,0,0.00000000000000000000
chr4,159799922,159801474,1552,-1,0,57600,1,64.43298969072170000000
chr4,160310979,160312839,1860,-1,0,,0,0.00000000000000000000
chr4,160479889,160480280,391,-1,0,,0,0.00000000000000000000
chr4,160670093,160670539,446,-1,0,,0,0.00000000000000000000
chr4,160670212,160670355,143,-1,0,,0,0.00000000000000000000
chr4,160864423,160871495,7072,-1,0,,0,0.00000000000000000000
chr4,161013791,161019512,5721,-1,0,,0,0.00000000000000000000
chr4,161026793,161080534,53741,-1,0,,0,0.00000000000000000000
chr4,161044154,161073070,28916,-1,0,,0,0.00000000000000000000
chr4,161058044,161071633,13589,-1,0,,0,0.00000000000000000000
chr4,161052969,161067748,14779,-1,0,,0,0.00000000000000000000
chr4,161034178,161034593,415,-1,0,,0,0.00000000000000000000
chr4,161034238,161034523,285,-1,0,,0,0.00000000000000000000
chr4,161098930,161099137,207,-1,0,,0,0.00000000000000000000
chr4,161160112,161166796,6684,-1,0,,0,0.00000000000000000000
chr4,161312287,161312360,73,-1,0,,0,0.00000000000000000000
chr4,161371848,161495926,124078,-1,0,,0,0.00000000000000000000
chr4,161669704,161671478,1774,-1,0,,0,0.00000000000000000000
chr4,161752430,161752598,168,-1,0,,0,0.00000000000000000000
chr4,161765949,161766214,265,-1,0,,0,0.00000000000000000000
chr4,161806120,161831292,25172,-1,0,,0,0.00000000000000000000
chr4,161877387,161885666,8279,-1,0,,0,0.00000000000000000000
chr4,161879195,161885984,6789,-1,0,,0,0.00000000000000000000
chr4,161879029,161884943,5914,-1,0,,0,0.00000000000000000000
chr4,162054395,162063250,8855,-1,0,,0,0.00000000000000000000
chr4,162053240,162053668,428,-1,0,,0,0.00000000000000000000
chr4,162053282,162053551,269,-1,0,,0,0.00000000000000000000
chr4,162193943,162205296,11353,-1,0,,0,0.00000000000000000000
chr4,162263520,162264065,545,-1,0,,0,0.00000000000000000000
chr4,162263719,162263893,174,-1,0,,0,0.00000000000000000000
chr4,162274416,162277351,2935,-1,0,,0,0.00000000000000000000
chr4,162734287,162794762,60475,-1,0,56884,1,1.65357585779248000000
chr4,162448732,162454211,5479,-1,0,56884,1,18.25150574922430000000
chr4,162446754,162451996,5242,-1,0,56884,1,19.07668828691340000000
chr4,162448699,162453729,5030,-1,0,56884,1,19.88071570576540000000
chr4,162975233,162977647,2414,-1,0,56884,1,41.42502071251040000000
chr4,162449273,162451673,2400,-1,0,56884,1,41.66666666666670000000
chr4,162802480,162804571,2091,-1,0,56884,1,47.82400765184120000000
chr4,162775904,162776405,501,-1,0,56884,1,199.60079840319400000000
chr4,163062206,163062647,441,-1,0,56884,1,226.75736961451200000000
chr4,162776031,162776290,259,-1,0,56884,1,386.10038610038600000000
chr4,162381492,162381663,171,-1,0,56884,1,584.79532163742700000000
chr4,162776123,162776209,86,-1,0,56884,1,1162.79069767442000000000
chr4,163183919,163186784,2865,-1,0,,0,0.00000000000000000000
chr4,163214160,163214692,532,-1,0,,0,0.00000000000000000000
chr4,163214308,163214448,140,-1,0,,0,0.00000000000000000000
chr4,163232325,163232791,466,-1,0,,0,0.00000000000000000000
chr4,163271229,163278220,6991,-1,0,,0,0.00000000000000000000
chr4,163278026,163281680,3654,-1,0,,0,0.00000000000000000000
chr4,163297302,163297912,610,-1,0,,0,0.00000000000000000000
chr4,164805292,164820731,15439,-1,0,55016,1,6.47710343934193000000
chr4,165203076,165206377,3301,-1,0,55016,1,30.29385034837930000000
chr4,163954429,163957844,3415,-1,0,,0,0.00000000000000000000
chr4,163393859,163396634,2775,-1,0,,0,0.00000000000000000000
chr4,165057649,165061080,3431,-1,0,55016,1,29.14602156805600000000
chr4,165203035,165206213,3178,-1,0,55016,1,31.46633102580240000000
chr4,165037582,165040812,3230,-1,0,55016,1,30.95975232198140000000
chr4,163566888,163569883,2995,-1,0,,0,0.00000000000000000000
chr4,163346370,163349032,2662,-1,0,,0,0.00000000000000000000
chr4,163370280,163372691,2411,-1,0,,0,0.00000000000000000000
chr4,163394520,163396383,1863,-1,0,,0,0.00000000000000000000
chr4,164362956,164364908,1952,-1,0,,0,0.00000000000000000000
chr4,163933170,163935002,1832,-1,0,,0,0.00000000000000000000
chr4,163395449,163396383,934,-1,0,,0,0.00000000000000000000
chr4,164613699,164614905,1206,-1,0,55016,1,82.91873963515760000000
chr4,164658297,164659132,835,-1,0,55016,1,119.76047904191600000000
chr4,164180060,164180954,894,-1,0,,0,0.00000000000000000000
chr4,164125002,164125432,430,-1,0,,0,0.00000000000000000000
chr4,165267523,165268040,517,-1,0,55016,1,193.42359767891700000000
chr4,164501854,164502382,528,-1,0,55016,1,189.39393939393900000000
chr4,164516026,164516551,525,-1,0,55016,1,190.47619047619000000000
chr4,164077047,164077580,533,-1,0,92345,1,187.61726078799300000000
chr4,164501940,164502253,313,-1,0,55016,1,319.48881789137400000000
chr4,164516246,164516390,144,-1,0,55016,1,694.44444444444400000000
chr4,164516291,164516434,143,-1,0,55016,1,699.30069930069900000000
chr4,165379884,165380188,304,-1,0,,0,0.00000000000000000000
chr4,165448077,165448693,616,-1,0,,0,0.00000000000000000000
chr4,165500247,165500804,557,-1,0,,0,0.00000000000000000000
chr4,165500502,165500618,116,-1,0,,0,0.00000000000000000000
chr4,165560573,165564792,4219,-1,0,,0,0.00000000000000000000
chr4,165823217,165823329,112,-1,0,,0,0.00000000000000000000
chr4,165967072,165967680,608,-1,0,,0,0.00000000000000000000
chr4,166002213,166004949,2736,-1,0,201931,1,36.54970760233920000000
chr4,166002564,166005042,2478,-1,0,201931,1,40.35512510088780000000
chr4,166128437,166129207,770,-1,0,11275,1,129.87012987013000000000
chr4,166343351,166352015,8664,-1,0,1363,1,11.54201292705450000000
chr4,166468010,166468315,305,-1,0,,0,0.00000000000000000000
chr4,166750044,166751655,1611,-1,0,,0,0.00000000000000000000
chr4,167004316,167004917,601,-1,0,7092,1,166.38935108153100000000
chr4,167108884,167113944,5060,-1,0,,0,0.00000000000000000000
chr4,167108947,167111990,3043,-1,0,,0,0.00000000000000000000
chr4,167108015,167108518,503,-1,0,,0,0.00000000000000000000
chr4,167108098,167108439,341,-1,0,,0,0.00000000000000000000
chr4,167157262,167186531,29269,-1,0,,0,0.00000000000000000000
chr4,167412024,167412174,150,-1,0,,0,0.00000000000000000000
chr4,167501152,167501825,673,-1,0,,0,0.00000000000000000000
chr4,167669347,167670574,1227,-1,0,50859,1,81.49959250203750000000
chr4,167676725,167683504,6779,-1,0,50859,1,14.75143826523090000000
chr4,167892508,167893675,1167,-1,0,50859,1,85.68980291345330000000
chr4,168108577,168115706,7129,-1,0,50859,1,14.02721279281810000000
chr4,168371938,168373136,1198,-1,0,,0,0.00000000000000000000
chr4,168418193,168424048,5855,-1,0,,0,0.00000000000000000000
chr4,168479424,168480624,1200,-1,0,,0,0.00000000000000000000
chr4,168541219,168541889,670,-1,0,,0,0.00000000000000000000
chr4,168808499,168993068,184569,-1,0,,0,0.00000000000000000000
chr4,168573851,168652125,78274,-1,0,,0,0.00000000000000000000
chr4,168853824,168921582,67758,-1,0,,0,0.00000000000000000000
chr4,168796975,168820765,23790,-1,0,,0,0.00000000000000000000
chr4,168817869,168844126,26257,-1,0,,0,0.00000000000000000000
chr4,168795903,168815917,20014,-1,0,,0,0.00000000000000000000
chr4,168601397,168621364,19967,-1,0,,0,0.00000000000000000000
chr4,168614349,168627921,13572,-1,0,,0,0.00000000000000000000
chr4,168610604,168615136,4532,-1,0,,0,0.00000000000000000000
chr4,168677438,168678251,813,-1,0,,0,0.00000000000000000000
chr4,169116517,169118682,2165,-1,0,,0,0.00000000000000000000
chr4,169120839,169120925,86,-1,0,,0,0.00000000000000000000
chr4,169614179,169614509,330,-1,0,23022,1,303.03030303030300000000
chr4,169614254,169614370,116,-1,0,23022,1,862.06896551724100000000
chr4,169619456,169621229,1773,-1,0,23022,1,56.40157924421880000000
chr4,169675744,169677114,1370,-1,0,23022,1,72.99270072992700000000
chr4,169718311,169719122,811,-1,0,23022,1,123.30456226880400000000
chr4,169898275,169900171,1896,-1,0,,0,0.00000000000000000000
chr4,170150948,170151389,441,-1,0,57630,1,226.75736961451200000000
chr4,170151075,170151214,139,-1,0,57630,1,719.42446043165500000000
chr4,170278459,170278881,422,-1,0,,0,0.00000000000000000000
chr4,170286594,170289033,2439,-1,0,,0,0.00000000000000000000
chr4,170286871,170288363,1492,-1,0,,0,0.00000000000000000000
chr4,170362793,170366399,3606,-1,0,4750,1,27.73155851358850000000
chr4,170719465,170720464,999,-1,0,,0,0.00000000000000000000
chr4,170808336,170808786,450,-1,0,,0,0.00000000000000000000
chr4,170881300,170881358,58,-1,0,,0,0.00000000000000000000
chr4,171070760,171073195,2435,-1,0,,0,0.00000000000000000000
chr4,171071844,171073129,1285,-1,0,,0,0.00000000000000000000
chr4,171243590,171288771,45181,-1,0,,0,0.00000000000000000000
chr4,171267551,171273882,6331,-1,0,,0,0.00000000000000000000
chr4,171269279,171274819,5540,-1,0,,0,0.00000000000000000000
chr4,171276555,171277700,1145,-1,0,,0,0.00000000000000000000
chr4,171291912,171292360,448,-1,0,,0,0.00000000000000000000
chr4,171362395,171362942,547,-1,0,,0,0.00000000000000000000
chr4,171549540,171550109,569,-1,0,,0,0.00000000000000000000
chr4,171654796,171656951,2155,-1,0,,0,0.00000000000000000000
chr4,172009385,172013769,4384,-1,0,,0,0.00000000000000000000
chr4,171888836,171889195,359,-1,0,,0,0.00000000000000000000
chr4,171969679,171969774,95,-1,0,,0,0.00000000000000000000
chr4,171969670,171969740,70,-1,0,,0,0.00000000000000000000
chr4,172342712,172343150,438,-1,0,,0,0.00000000000000000000
chr4,172389898,172495579,105681,-1,0,,0,0.00000000000000000000
chr4,172374184,172383144,8960,-1,0,,0,0.00000000000000000000
chr4,172374433,172379471,5038,-1,0,,0,0.00000000000000000000
chr4,172376210,172379109,2899,-1,0,,0,0.00000000000000000000
chr4,172376514,172379213,2699,-1,0,,0,0.00000000000000000000
chr4,172544719,172622170,77451,-1,0,,0,0.00000000000000000000
chr4,172528585,172529940,1355,-1,0,,0,0.00000000000000000000
chr4,172645715,172651777,6062,-1,0,,0,0.00000000000000000000
chr4,172736296,172738094,1798,-1,0,442117,1,55.61735261401560000000
chr4,172804782,172806330,1548,-1,0,442117,1,64.59948320413440000000
chr4,172834906,172862993,28087,-1,0,442117,1,3.56036600562538000000
chr4,172867892,172868675,783,-1,0,442117,1,127.71392081736900000000
chr4,172987970,172995965,7995,-1,0,442117,1,12.50781738586620000000
chr4,172987881,172993997,6116,-1,0,442117,1,16.35055591890120000000
chr4,172989151,172992669,3518,-1,0,442117,1,28.42524161455370000000
chr4,173176433,173176487,54,-1,0,442117,1,1851.85185185185000000000
chr4,173425031,173433547,8516,-1,0,442117,1,11.74260216063880000000
chr4,173425608,173431581,5973,-1,0,442117,1,16.74200569228190000000
chr4,173424947,173428643,3696,-1,0,442117,1,27.05627705627710000000
chr4,173527771,173527839,68,-1,0,442117,1,1470.58823529412000000000
chr4,174090014,174091177,1163,-1,0,51809,1,85.98452278589850000000
chr4,174466598,174476767,10169,-1,0,,0,0.00000000000000000000
chr4,174533072,174535903,2831,-1,0,,0,0.00000000000000000000
chr4,175186229,175186663,434,-1,0,26269,1,230.41474654377900000000
chr4,175477246,175507090,29844,-1,0,,0,0.00000000000000000000
chr4,175504932,175505358,426,-1,0,,0,0.00000000000000000000
chr4,175625152,175626989,1837,-1,0,8001,1,54.43658138268920000000
chr4,176109753,176111436,1683,-1,0,,0,0.00000000000000000000
chr4,176090948,176091375,427,-1,0,,0,0.00000000000000000000
chr4,176262868,176264834,1966,-1,0,,0,0.00000000000000000000
chr4,176355674,176356234,560,-1,0,,0,0.00000000000000000000
chr4,176356109,176356272,163,-1,0,,0,0.00000000000000000000
chr4,176429276,176433170,3894,-1,0,,0,0.00000000000000000000
chr4,176499949,176503900,3951,-1,0,,0,0.00000000000000000000
chr4,176539329,176540284,955,-1,0,,0,0.00000000000000000000
chr4,176671920,176680671,8751,-1,0,2823,1,11.42726545537650000000
chr4,177967522,178150966,183444,-1,0,,0,0.00000000000000000000
chr4,178748244,178879844,131600,-1,0,,0,0.00000000000000000000
chr4,177539198,177590422,51224,-1,0,,0,0.00000000000000000000
chr4,178593217,178622775,29558,-1,0,,0,0.00000000000000000000
chr4,178467171,178488565,21394,-1,0,,0,0.00000000000000000000
chr4,178206632,178217067,10435,-1,0,,0,0.00000000000000000000
chr4,178593703,178611231,17528,-1,0,,0,0.00000000000000000000
chr4,177150962,177167740,16778,-1,0,140458,1,5.96018595780188000000
chr4,178884772,178893396,8624,-1,0,,0,0.00000000000000000000
chr4,178374724,178386747,12023,-1,0,,0,0.00000000000000000000
chr4,178207098,178215518,8420,-1,0,,0,0.00000000000000000000
chr4,177673226,177680031,6805,-1,0,7424,1,14.69507714915500000000
chr4,178052163,178058157,5994,-1,0,,0,0.00000000000000000000
chr4,177926519,177932346,5827,-1,0,,0,0.00000000000000000000
chr4,178320229,178324689,4460,-1,0,,0,0.00000000000000000000
chr4,178890327,178892333,2006,-1,0,,0,0.00000000000000000000
chr4,177850841,177852526,1685,-1,0,,0,0.00000000000000000000
chr4,178156459,178157988,1529,-1,0,,0,0.00000000000000000000
chr4,177802704,177803941,1237,-1,0,,0,0.00000000000000000000
chr4,177851108,177852254,1146,-1,0,,0,0.00000000000000000000
chr4,177593739,177594295,556,-1,0,,0,0.00000000000000000000
chr4,178156699,178157285,586,-1,0,,0,0.00000000000000000000
chr4,177869237,177869760,523,-1,0,,0,0.00000000000000000000
chr4,178514148,178514665,517,-1,0,,0,0.00000000000000000000
chr4,178335904,178336331,427,-1,0,,0,0.00000000000000000000
chr4,178831102,178831506,404,-1,0,,0,0.00000000000000000000
chr4,178156826,178157164,338,-1,0,,0,0.00000000000000000000
chr4,177869308,177869640,332,-1,0,,0,0.00000000000000000000
chr4,178514244,178514563,319,-1,0,,0,0.00000000000000000000
chr4,176917027,176917146,119,-1,0,2823,1,840.33613445378100000000
chr4,178903623,178903997,374,-1,0,,0,0.00000000000000000000
chr4,178903649,178903876,227,-1,0,,0,0.00000000000000000000
chr4,179043364,179044031,667,-1,0,,0,0.00000000000000000000
chr4,179239388,179247153,7765,-1,0,,0,0.00000000000000000000
chr4,179190558,179195780,5222,-1,0,,0,0.00000000000000000000
chr4,179532772,179534808,2036,-1,0,,0,0.00000000000000000000
chr4,179345679,179347678,1999,-1,0,,0,0.00000000000000000000
chr4,179253863,179255011,1148,-1,0,,0,0.00000000000000000000
chr4,179828406,179884253,55847,-1,0,,0,0.00000000000000000000
chr4,179818528,179820695,2167,-1,0,,0,0.00000000000000000000
chr4,179772398,179773746,1348,-1,0,,0,0.00000000000000000000
chr4,179785422,179786242,820,-1,0,,0,0.00000000000000000000
chr4,180063735,180064246,511,-1,0,,0,0.00000000000000000000
chr4,179956844,179957277,433,-1,0,,0,0.00000000000000000000
chr4,180063820,180064153,333,-1,0,,0,0.00000000000000000000
chr4,180088070,180090060,1990,-1,0,,0,0.00000000000000000000
chr4,180097876,180098515,639,-1,0,,0,0.00000000000000000000
chr4,180484987,180486568,1581,-1,0,,0,0.00000000000000000000
chr4,180540185,180545292,5107,-1,0,,0,0.00000000000000000000
chr4,180600189,180600278,89,-1,0,,0,0.00000000000000000000
chr4,180600240,180600326,86,-1,0,,0,0.00000000000000000000
chr4,181510326,181713546,203220,-1,0,,0,0.00000000000000000000
chr4,180654149,180720936,66787,-1,0,,0,0.00000000000000000000
chr4,181923958,181956462,32504,-1,0,,0,0.00000000000000000000
chr4,183286173,183296685,10512,-1,0,55714,1,9.51293759512938000000
chr4,181735695,181741076,5381,-1,0,,0,0.00000000000000000000
chr4,181135025,181139089,4064,-1,0,,0,0.00000000000000000000
chr4,180680508,180684521,4013,-1,0,,0,0.00000000000000000000
chr4,183569992,183572000,2008,-1,0,55714,1,49.80079681274900000000
chr4,181041177,181043954,2777,-1,0,,0,0.00000000000000000000
chr4,182160346,182162925,2579,-1,0,,0,0.00000000000000000000
chr4,181876687,181878406,1719,-1,0,,0,0.00000000000000000000
chr4,182968147,182970584,2437,-1,0,,0,0.00000000000000000000
chr4,183467705,183470034,2329,-1,0,55714,1,42.93688278231000000000
chr4,182200601,182202151,1550,-1,0,,0,0.00000000000000000000
chr4,182695107,182696220,1113,-1,0,,0,0.00000000000000000000
chr4,183472244,183473057,813,-1,0,55714,1,123.00123001230000000000
chr4,181755821,181756543,722,-1,0,,0,0.00000000000000000000
chr4,183035246,183035666,420,-1,0,,0,0.00000000000000000000
chr4,182056572,182057154,582,-1,0,,0,0.00000000000000000000
chr4,181549336,181549827,491,-1,0,,0,0.00000000000000000000
chr4,181317131,181317604,473,-1,0,,0,0.00000000000000000000
chr4,182776951,182777439,488,-1,0,,0,0.00000000000000000000
chr4,183438515,183438835,320,-1,0,55714,1,312.50000000000000000000
chr4,180799665,180799986,321,-1,0,,0,0.00000000000000000000
chr4,181549428,181549752,324,-1,0,,0,0.00000000000000000000
chr4,182961162,182961389,227,-1,0,,0,0.00000000000000000000
chr4,182526582,182526744,162,-1,0,,0,0.00000000000000000000
chr4,181317280,181317464,184,-1,0,,0,0.00000000000000000000
chr4,182935091,182935206,115,-1,0,,0,0.00000000000000000000
chr4,182935202,182935278,76,-1,0,,0,0.00000000000000000000
chr4,183752597,183756189,3592,-1,0,,0,0.00000000000000000000
chr4,183766327,183766381,54,-1,0,,0,0.00000000000000000000
chr4,183892093,183892347,254,-1,0,,0,0.00000000000000000000
chr4,183985931,183988803,2872,-1,0,,0,0.00000000000000000000
chr4,184008052,184009828,1776,-1,0,,0,0.00000000000000000000
chr4,184019345,184021259,1914,-1,0,80014,1,52.24660397074190000000
chr4,184085457,184085599,142,-1,0,80014,1,704.22535211267600000000
chr4,184085424,184085532,108,-1,0,80014,1,925.92592592592600000000
chr4,184147510,184151566,4056,-1,0,80014,1,24.65483234714000000000
chr4,184257938,184258393,455,-1,0,,0,0.00000000000000000000
chr4,184303538,184304048,510,-1,0,,0,0.00000000000000000000
chr4,184303706,184304041,335,-1,0,,0,0.00000000000000000000
chr4,184311776,184315212,3436,-1,0,,0,0.00000000000000000000
chr4,184385346,184385598,252,-1,0,,0,0.00000000000000000000
chr4,184385404,184385479,75,-1,0,,0,0.00000000000000000000
chr4,184416936,184418066,1130,-1,0,,0,0.00000000000000000000
chr4,184454734,184455892,1158,-1,0,,0,0.00000000000000000000
chr4,184473801,184475500,1699,-1,0,,0,0.00000000000000000000
chr4,184474030,184474649,619,-1,0,,0,0.00000000000000000000
chr4,184582001,184582663,662,-1,0,60684,1,151.05740181268900000000
chr4,184632824,184632914,90,-1,0,60684,1,1111.11111111111000000000
chr4,184655611,184659024,3413,-1,0,,0,0.00000000000000000000
chr4,184674282,184676860,2578,-1,0,,0,0.00000000000000000000
chr4,184674255,184675718,1463,-1,0,,0,0.00000000000000000000
chr4,184754829,184755191,362,-1,0,,0,0.00000000000000000000
chr4,184853035,184854195,1160,-1,0,56977,1,86.20689655172410000000
chr4,184853310,184853805,495,-1,0,56977,1,202.02020202020200000000
chr4,184853483,184853648,165,-1,0,56977,1,606.06060606060600000000
chr4,184985565,184989506,3941,-1,0,,0,0.00000000000000000000
chr4,185140744,185141981,1237,-1,0,,0,0.00000000000000000000
chr4,185140792,185141469,677,-1,0,,0,0.00000000000000000000
chr4,185140949,185141437,488,-1,0,,0,0.00000000000000000000
chr4,185141008,185141215,207,-1,0,,0,0.00000000000000000000
chr4,185157879,185169826,11947,-1,0,,0,0.00000000000000000000
chr4,185545721,185545902,181,-1,0,,0,0.00000000000000000000
chr4,185573833,185574483,650,-1,0,201973,1,153.84615384615400000000
chr4,185574023,185574158,135,-1,0,201973,1,740.74074074074100000000
chr4,185574122,185574239,117,-1,0,201973,1,854.70085470085500000000
chr4,185628050,185628565,515,-1,0,79682,1,194.17475728155300000000
chr4,185665669,185666191,522,-1,0,,0,0.00000000000000000000
chr4,185665782,185666100,318,-1,0,,0,0.00000000000000000000
chr4,185731648,185742109,10461,-1,0,2180,1,9.55931555300640000000
chr4,185752196,185762172,9976,-1,0,,0,0.00000000000000000000
chr4,185759766,185769840,10074,-1,0,,0,0.00000000000000000000
chr4,185767127,185769126,1999,-1,0,,0,0.00000000000000000000
chr4,185746453,185747593,1140,-1,0,2180,1,87.71929824561400000000
chr4,185779357,185780182,825,-1,0,,0,0.00000000000000000000
chr4,185779451,185779838,387,-1,0,,0,0.00000000000000000000
chr4,185883343,185883817,474,-1,0,,0,0.00000000000000000000
chr4,185883568,185883683,115,-1,0,,0,0.00000000000000000000
chr4,185886286,185889128,2842,-1,0,,0,0.00000000000000000000
chr4,185893713,185908118,14405,-1,0,,0,0.00000000000000000000
chr4,185977876,185978391,515,-1,0,,0,0.00000000000000000000
chr4,186048545,186048956,411,-1,0,,0,0.00000000000000000000
chr4,186100114,186102194,2080,-1,0,57587,1,48.07692307692310000000
chr4,186142965,186143594,629,-1,0,83891,1,158.98251192368800000000
chr4,186155452,186155970,518,-1,0,83891,1,193.05019305019300000000
chr4,186155554,186155865,311,-1,0,83891,1,321.54340836012900000000
chr4,186158965,186160425,1460,-1,0,83891,1,68.49315068493150000000
chr4,186198770,186199341,571,-1,0,83891,1,175.13134851138400000000
chr4,186198879,186199179,300,-1,0,83891,1,333.33333333333300000000
chr4,186214741,186222530,7789,-1,0,83891,1,12.83861856464240000000
chr4,186348821,186349148,327,-1,0,,0,0.00000000000000000000
chr4,186396077,186420689,24612,-1,0,,0,0.00000000000000000000
chr4,186441359,186447370,6011,-1,0,27295,1,16.63616702711700000000
chr4,186441631,186444075,2444,-1,0,27295,1,40.91653027823240000000
chr4,186469307,186471007,1700,-1,0,,0,0.00000000000000000000
chr4,186481897,186482154,257,-1,0,,0,0.00000000000000000000
chr4,186625536,186625880,344,-1,0,8470,1,290.69767441860500000000
chr4,186955112,186955928,816,-1,0,,0,0.00000000000000000000
chr4,186977687,186979521,1834,-1,0,,0,0.00000000000000000000
chr4,187002346,187003422,1076,-1,0,7098,1,92.93680297397770000000
chr4,187025686,187026688,1002,-1,0,,0,0.00000000000000000000
chr4,187092387,187098186,5799,-1,0,25854,1,17.24435247456460000000
chr4,187093513,187098308,4795,-1,0,25854,1,20.85505735140770000000
chr4,187159877,187161181,1304,-1,0,3818,1,76.68711656441720000000
chr4,187160120,187160650,530,-1,0,3818,1,188.67924528301900000000
chr4,187159892,187160250,358,-1,0,3818,1,279.32960893854700000000
chr4,187213451,187215123,1672,-1,0,,0,0.00000000000000000000
chr4,187213990,187214826,836,-1,0,,0,0.00000000000000000000
chr4,187231094,187234091,2997,-1,0,,0,0.00000000000000000000
chr4,187293387,187293592,205,-1,0,,0,0.00000000000000000000
chr4,187348090,187358950,10860,-1,0,,0,0.00000000000000000000
chr4,187353431,187357225,3794,-1,0,,0,0.00000000000000000000
chr4,187353586,187355062,1476,-1,0,,0,0.00000000000000000000
chr4,187378707,187378780,73,-1,0,,0,0.00000000000000000000
chr4,187397497,187399941,2444,-1,0,,0,0.00000000000000000000
chr4,187547131,187548134,1003,-1,0,2195,1,99.70089730807580000000
chr4,187547979,187548389,410,-1,0,2195,1,243.90243902439000000000
chr4,187614502,187614852,350,-1,0,2195,1,285.71428571428600000000
chr4,187795621,187796141,520,-1,0,,0,0.00000000000000000000
chr4,187795708,187796027,319,-1,0,,0,0.00000000000000000000
chr4,187843677,187850411,6734,-1,0,,0,0.00000000000000000000
chr4,187850761,187850964,203,-1,0,,0,0.00000000000000000000
chr4,188910118,190421904,1511786,-1,0,205860;132625;339976,3,0.19844078460840400000
chr4,188375471,189534555,1159084,-1,0,205860;132625;339976,3,0.25882507221219500000
chr4,187853123,188675212,822089,-1,0,,0,0.00000000000000000000
chr4,189328533,190058272,729739,-1,0,,0,0.00000000000000000000
chr4,188645606,189064577,418971,-1,0,205860;132625;339976,3,0.71604001231588800000
chr4,189130696,189512937,382241,-1,0,,0,0.00000000000000000000
chr4,190656078,190756061,99983,-1,0,,0,0.00000000000000000000
chr4,189173269,189259416,86147,-1,0,,0,0.00000000000000000000
chr4,189944305,190008240,63935,-1,0,,0,0.00000000000000000000
chr4,190983640,191015811,32171,-1,0,,0,0.00000000000000000000
chr4,190403145,190449772,46627,-1,0,,0,0.00000000000000000000
chr4,189146980,189182464,35484,-1,0,,0,0.00000000000000000000
chr4,188283470,188316494,33024,-1,0,,0,0.00000000000000000000
chr4,188206298,188235022,28724,-1,0,,0,0.00000000000000000000
chr4,189241183,189266751,25568,-1,0,,0,0.00000000000000000000
chr4,188653133,188683767,30634,-1,0,,0,0.00000000000000000000
chr4,187880432,187895308,14876,-1,0,,0,0.00000000000000000000
chr4,188923569,188938262,14693,-1,0,132625,1,6.80596202273191000000
chr4,188149536,188161841,12305,-1,0,,0,0.00000000000000000000
chr4,190754701,190766671,11970,-1,0,,0,0.00000000000000000000
chr4,188927485,188939085,11600,-1,0,,0,0.00000000000000000000
chr4,190191546,190200489,8943,-1,0,,0,0.00000000000000000000
chr4,189577190,189588330,11140,-1,0,,0,0.00000000000000000000
chr4,189039359,189050142,10783,-1,0,,0,0.00000000000000000000
chr4,189094396,189104305,9909,-1,0,,0,0.00000000000000000000
chr4,189424231,189431455,7224,-1,0,,0,0.00000000000000000000
chr4,190391957,190398111,6154,-1,0,,0,0.00000000000000000000
chr4,187971638,187977822,6184,-1,0,,0,0.00000000000000000000
chr4,190057980,190064330,6350,-1,0,,0,0.00000000000000000000
chr4,190929519,190932811,3292,-1,0,,0,0.00000000000000000000
chr4,190193651,190199455,5804,-1,0,,0,0.00000000000000000000
chr4,189835638,189840770,5132,-1,0,,0,0.00000000000000000000
chr4,189365728,189370501,4773,-1,0,,0,0.00000000000000000000
chr4,190195086,190199812,4726,-1,0,,0,0.00000000000000000000
chr4,189425205,189429139,3934,-1,0,,0,0.00000000000000000000
chr4,190606506,190610625,4119,-1,0,,0,0.00000000000000000000
chr4,189072284,189075955,3671,-1,0,,0,0.00000000000000000000
chr4,189893045,189897092,4047,-1,0,,0,0.00000000000000000000
chr4,190193922,190197396,3474,-1,0,,0,0.00000000000000000000
chr4,190982993,190986362,3369,-1,0,,0,0.00000000000000000000
chr4,187874691,187878165,3474,-1,0,,0,0.00000000000000000000
chr4,190535561,190538470,2909,-1,0,,0,0.00000000000000000000
chr4,190154005,190156622,2617,-1,0,,0,0.00000000000000000000
chr4,189437049,189438939,1890,-1,0,,0,0.00000000000000000000
chr4,190680494,190683055,2561,-1,0,,0,0.00000000000000000000
chr4,189971986,189973732,1746,-1,0,,0,0.00000000000000000000
chr4,188345975,188348528,2553,-1,0,,0,0.00000000000000000000
chr4,189073854,189076272,2418,-1,0,,0,0.00000000000000000000
chr4,190228631,190230687,2056,-1,0,,0,0.00000000000000000000
chr4,190386544,190388500,1956,-1,0,,0,0.00000000000000000000
chr4,188041756,188043509,1753,-1,0,,0,0.00000000000000000000
chr4,190411724,190413196,1472,-1,0,,0,0.00000000000000000000
chr4,189189827,189191032,1205,-1,0,,0,0.00000000000000000000
chr4,190767140,190768468,1328,-1,0,,0,0.00000000000000000000
chr4,190757090,190758647,1557,-1,0,,0,0.00000000000000000000
chr4,189427630,189429034,1404,-1,0,,0,0.00000000000000000000
chr4,189894871,189896447,1576,-1,0,,0,0.00000000000000000000
chr4,190566514,190567588,1074,-1,0,,0,0.00000000000000000000
chr4,190075849,190077134,1285,-1,0,,0,0.00000000000000000000
chr4,187971170,187972753,1583,-1,0,,0,0.00000000000000000000
chr4,190572611,190573931,1320,-1,0,,0,0.00000000000000000000
chr4,190623869,190625355,1486,-1,0,,0,0.00000000000000000000
chr4,190198901,190200429,1528,-1,0,,0,0.00000000000000000000
chr4,189402861,189404363,1502,-1,0,,0,0.00000000000000000000
chr4,190155366,190156554,1188,-1,0,,0,0.00000000000000000000
chr4,188135111,188136256,1145,-1,0,,0,0.00000000000000000000
chr4,190471222,190472260,1038,-1,0,,0,0.00000000000000000000
chr4,190284768,190285714,946,-1,0,,0,0.00000000000000000000
chr4,190537071,190538326,1255,-1,0,,0,0.00000000000000000000
chr4,189972109,189973167,1058,-1,0,,0,0.00000000000000000000
chr4,189825925,189826638,713,-1,0,,0,0.00000000000000000000
chr4,189189761,189190749,988,-1,0,,0,0.00000000000000000000
chr4,188161784,188162721,937,-1,0,,0,0.00000000000000000000
chr4,190433469,190434429,960,-1,0,,0,0.00000000000000000000
chr4,190105408,190106160,752,-1,0,,0,0.00000000000000000000
chr4,190228528,190229247,719,-1,0,,0,0.00000000000000000000
chr4,189795351,189796105,754,-1,0,,0,0.00000000000000000000
chr4,190662873,190663728,855,-1,0,,0,0.00000000000000000000
chr4,190235479,190236102,623,-1,0,,0,0.00000000000000000000
chr4,189190222,189190915,693,-1,0,,0,0.00000000000000000000
chr4,190767262,190767977,715,-1,0,,0,0.00000000000000000000
chr4,190489473,190489975,502,-1,0,,0,0.00000000000000000000
chr4,189969593,189970165,572,-1,0,,0,0.00000000000000000000
chr4,190471446,190472090,644,-1,0,,0,0.00000000000000000000
chr4,190300998,190301566,568,-1,0,,0,0.00000000000000000000
chr4,190253734,190254270,536,-1,0,,0,0.00000000000000000000
chr4,190291319,190291854,535,-1,0,,0,0.00000000000000000000
chr4,189717645,189718336,691,-1,0,,0,0.00000000000000000000
chr4,190566523,190567078,555,-1,0,,0,0.00000000000000000000
chr4,189049707,189050328,621,-1,0,,0,0.00000000000000000000
chr4,189364167,189364652,485,-1,0,,0,0.00000000000000000000
chr4,190621560,190622044,484,-1,0,,0,0.00000000000000000000
chr4,190381674,190382280,606,-1,0,,0,0.00000000000000000000
chr4,187987822,187988467,645,-1,0,,0,0.00000000000000000000
chr4,190302298,190302821,523,-1,0,,0,0.00000000000000000000
chr4,189155581,189156160,579,-1,0,,0,0.00000000000000000000
chr4,188685523,188685888,365,-1,0,,0,0.00000000000000000000
chr4,190741409,190741883,474,-1,0,,0,0.00000000000000000000
chr4,188613387,188613881,494,-1,0,,0,0.00000000000000000000
chr4,189424749,189425156,407,-1,0,,0,0.00000000000000000000
chr4,190284952,190285506,554,-1,0,,0,0.00000000000000000000
chr4,190656328,190656879,551,-1,0,,0,0.00000000000000000000
chr4,190381883,190382423,540,-1,0,,0,0.00000000000000000000
chr4,189825966,189826396,430,-1,0,,0,0.00000000000000000000
chr4,189744796,189745166,370,-1,0,,0,0.00000000000000000000
chr4,190555115,190555534,419,-1,0,,0,0.00000000000000000000
chr4,190076470,190076995,525,-1,0,,0,0.00000000000000000000
chr4,190411616,190412063,447,-1,0,,0,0.00000000000000000000
chr4,190199143,190199508,365,-1,0,,0,0.00000000000000000000
chr4,190554456,190554883,427,-1,0,,0,0.00000000000000000000
chr4,187992420,187992766,346,-1,0,,0,0.00000000000000000000
chr4,189785388,189785809,421,-1,0,,0,0.00000000000000000000
chr4,190329376,190329798,422,-1,0,,0,0.00000000000000000000
chr4,190105220,190105616,396,-1,0,,0,0.00000000000000000000
chr4,190643457,190643801,344,-1,0,,0,0.00000000000000000000
chr4,189448648,189449032,384,-1,0,,0,0.00000000000000000000
chr4,189793231,189793567,336,-1,0,,0,0.00000000000000000000
chr4,190624623,190624980,357,-1,0,,0,0.00000000000000000000
chr4,189437086,189437449,363,-1,0,,0,0.00000000000000000000
chr4,189826103,189826415,312,-1,0,,0,0.00000000000000000000
chr4,189969679,189970034,355,-1,0,,0,0.00000000000000000000
chr4,190521346,190521570,224,-1,0,,0,0.00000000000000000000
chr4,190253842,190254169,327,-1,0,,0,0.00000000000000000000
chr4,190154165,190154505,340,-1,0,,0,0.00000000000000000000
chr4,190291419,190291741,322,-1,0,,0,0.00000000000000000000
chr4,190200424,190200672,248,-1,0,,0,0.00000000000000000000
chr4,189364290,189364553,263,-1,0,,0,0.00000000000000000000
chr4,190302416,190302713,297,-1,0,,0,0.00000000000000000000
chr4,190606277,190606547,270,-1,0,,0,0.00000000000000000000
chr4,190051061,190051258,197,-1,0,,0,0.00000000000000000000
chr4,190471667,190471849,182,-1,0,,0,0.00000000000000000000
chr4,190051006,190051181,175,-1,0,,0,0.00000000000000000000
chr4,189364373,189364556,183,-1,0,,0,0.00000000000000000000
chr4,189028167,189028292,125,-1,0,,0,0.00000000000000000000
chr4,188950355,188950465,110,-1,0,,0,0.00000000000000000000
chr4,190790383,190790519,136,-1,0,,0,0.00000000000000000000
chr4,188959365,188959488,123,-1,0,,0,0.00000000000000000000
chr4,190512783,190512906,123,-1,0,,0,0.00000000000000000000
chr4,190616488,190616607,119,-1,0,,0,0.00000000000000000000
chr4,190554615,190554726,111,-1,0,,0,0.00000000000000000000
chr4,189552658,189552764,106,-1,0,,0,0.00000000000000000000
chr4,190522097,190522191,94,-1,0,,0,0.00000000000000000000
chr4,190607188,190607261,73,-1,0,,0,0.00000000000000000000
chr4,189785523,189785608,85,-1,0,,0,0.00000000000000000000
chr4,189785597,189785678,81,-1,0,,0,0.00000000000000000000
chr4,188135857,188135929,72,-1,0,,0,0.00000000000000000000
chr4,190615488,190615544,56,-1,0,,0,0.00000000000000000000
chr5,27968,186934,158966,-1,0,153478,1,0.62906533472566500000
chr5,15223,75450,60227,-1,0,,0,0.00000000000000000000
chr5,206082,234322,28240,-1,0,6389;133957,2,7.08215297450425000000
chr5,257824,267740,9916,-1,0,,0,0.00000000000000000000
chr5,25186,35154,9968,-1,0,,0,0.00000000000000000000
chr5,258095,262471,4376,-1,0,,0,0.00000000000000000000
chr5,18384,23033,4649,-1,0,,0,0.00000000000000000000
chr5,97750,101139,3389,-1,0,,0,0.00000000000000000000
chr5,74338,77003,2665,-1,0,,0,0.00000000000000000000
chr5,164357,166735,2378,-1,0,153478,1,42.05214465937760000000
chr5,83356,85599,2243,-1,0,,0,0.00000000000000000000
chr5,100437,102268,1831,-1,0,,0,0.00000000000000000000
chr5,231819,232851,1032,-1,0,6389,1,96.89922480620150000000
chr5,27336,27992,656,-1,0,,0,0.00000000000000000000
chr5,80943,81292,349,-1,0,,0,0.00000000000000000000
chr5,176129,176386,257,-1,0,153478,1,389.10505836575900000000
chr5,343352,343535,183,-1,0,57491,1,546.44808743169400000000
chr5,391555,392807,1252,-1,0,57491,1,79.87220447284340000000
chr5,415464,415959,495,-1,0,57491,1,202.02020202020200000000
chr5,382848,382940,92,-1,0,57491,1,1086.95652173913000000000
chr5,466876,469669,2793,-1,0,11336,1,35.80379520229140000000
chr5,472279,473889,1610,-1,0,6550,1,62.11180124223600000000
chr5,467744,468741,997,-1,0,,0,0.00000000000000000000
chr5,486958,487710,752,-1,0,6550,1,132.97872340425500000000
chr5,474402,474955,553,-1,0,6550,1,180.83182640144700000000
chr5,484186,484620,434,-1,0,6550,1,230.41474654377900000000
chr5,497796,498065,269,-1,0,6550,1,371.74721189591100000000
chr5,508505,508774,269,-1,0,6550,1,371.74721189591100000000
chr5,561956,565865,3909,-1,0,,0,0.00000000000000000000
chr5,552143,554701,2558,-1,0,,0,0.00000000000000000000
chr5,570713,571127,414,-1,0,,0,0.00000000000000000000
chr5,608726,609114,388,-1,0,,0,0.00000000000000000000
chr5,628799,633852,5053,-1,0,55722,1,19.79022362952700000000
chr5,648140,651565,3425,-1,0,55722,1,29.19708029197080000000
chr5,650332,651340,1008,-1,0,55722,1,99.20634920634920000000
chr5,650503,651199,696,-1,0,55722,1,143.67816091954000000000
chr5,648283,648678,395,-1,0,55722,1,253.16455696202500000000
chr5,701915,833249,131334,-1,0,79844,1,0.76141745473373200000
chr5,687854,780170,92316,-1,0,11076,1,1.08323584210754000000
chr5,766460,876057,109597,-1,0,79844;65980,2,1.82486746900006000000
chr5,728135,812542,84407,-1,0,79844,1,1.18473586313931000000
chr5,791402,852556,61154,-1,0,79844,1,1.63521601203519000000
chr5,775334,824349,49015,-1,0,79844,1,2.04019177802713000000
chr5,691610,748731,57121,-1,0,11076,1,1.75066963113391000000
chr5,744074,779367,35293,-1,0,,0,0.00000000000000000000
chr5,795004,825324,30320,-1,0,79844,1,3.29815303430079000000
chr5,691601,733926,42325,-1,0,11076,1,2.36266981689309000000
chr5,757484,779157,21673,-1,0,,0,0.00000000000000000000
chr5,816090,850196,34106,-1,0,79844,1,2.93203541898786000000
chr5,661601,693700,32099,-1,0,11076,1,3.11536184927879000000
chr5,723221,749059,25838,-1,0,,0,0.00000000000000000000
chr5,746130,762493,16363,-1,0,,0,0.00000000000000000000
chr5,761748,778064,16316,-1,0,,0,0.00000000000000000000
chr5,813468,825564,12096,-1,0,79844,1,8.26719576719577000000
chr5,754741,767683,12942,-1,0,,0,0.00000000000000000000
chr5,747831,753494,5663,-1,0,,0,0.00000000000000000000
chr5,666801,668596,1795,-1,0,11076,1,55.71030640668520000000
chr5,852812,853895,1083,-1,0,,0,0.00000000000000000000
chr5,748796,749806,1010,-1,0,,0,0.00000000000000000000
chr5,836144,837050,906,-1,0,79844,1,110.37527593819000000000
chr5,667934,668548,614,-1,0,11076,1,162.86644951140100000000
chr5,674471,675077,606,-1,0,11076,1,165.01650165016500000000
chr5,748848,749316,468,-1,0,,0,0.00000000000000000000
chr5,667890,668177,287,-1,0,11076,1,348.43205574912900000000
chr5,667962,668106,144,-1,0,11076,1,694.44444444444400000000
chr5,654931,654998,67,-1,0,,0,0.00000000000000000000
chr5,896769,900194,3425,-1,0,9319,1,29.19708029197080000000
chr5,1000973,1051477,50504,-1,0,85409;10723,2,3.96008236971329000000
chr5,1177556,1186103,8547,-1,0,,0,0.00000000000000000000
chr5,1070060,1074042,3982,-1,0,10723,1,25.11300853842290000000
chr5,1097983,1102271,4288,-1,0,10723,1,23.32089552238810000000
chr5,1041702,1046286,4584,-1,0,,0,0.00000000000000000000
chr5,1044601,1047099,2498,-1,0,,0,0.00000000000000000000
chr5,1022798,1025877,3079,-1,0,85409,1,32.47807729782400000000
chr5,1178218,1180640,2422,-1,0,,0,0.00000000000000000000
chr5,1059221,1062071,2850,-1,0,10723,1,35.08771929824560000000
chr5,1289342,1291701,2359,-1,0,7015,1,42.39084357778720000000
chr5,1070171,1072715,2544,-1,0,10723,1,39.30817610062890000000
chr5,1046217,1047964,1747,-1,0,,0,0.00000000000000000000
chr5,1178200,1180028,1828,-1,0,,0,0.00000000000000000000
chr5,1272638,1273963,1325,-1,0,7015,1,75.47169811320750000000
chr5,1191568,1192445,877,-1,0,,0,0.00000000000000000000
chr5,1097881,1098931,1050,-1,0,10723,1,95.23809523809520000000
chr5,1008672,1009626,954,-1,0,85409,1,104.82180293501000000000
chr5,1284732,1285465,733,-1,0,7015,1,136.42564802182800000000
chr5,1275690,1276211,521,-1,0,7015,1,191.93857965451100000000
chr5,1238350,1238761,411,-1,0,348932,1,243.30900243309000000000
chr5,1061161,1061662,501,-1,0,10723,1,199.60079840319400000000
chr5,1048189,1048766,577,-1,0,,0,0.00000000000000000000
chr5,1170373,1170895,522,-1,0,,0,0.00000000000000000000
chr5,1157292,1157716,424,-1,0,,0,0.00000000000000000000
chr5,1080136,1080608,472,-1,0,10723,1,211.86440677966100000000
chr5,1039561,1039966,405,-1,0,,0,0.00000000000000000000
chr5,1043351,1043710,359,-1,0,,0,0.00000000000000000000
chr5,1192312,1192731,419,-1,0,,0,0.00000000000000000000
chr5,1238511,1238804,293,-1,0,348932,1,341.29692832764500000000
chr5,1170458,1170724,266,-1,0,,0,0.00000000000000000000
chr5,1273582,1273846,264,-1,0,7015,1,378.78787878787900000000
chr5,1197537,1197758,221,-1,0,,0,0.00000000000000000000
chr5,1238453,1238639,186,-1,0,348932,1,537.63440860215100000000
chr5,1037000,1037159,159,-1,0,85409,1,628.93081761006300000000
chr5,1080349,1080465,116,-1,0,10723,1,862.06896551724100000000
chr5,1323279,1323504,225,-1,0,81037,1,444.44444444444400000000
chr5,1333043,1333900,857,-1,0,81037,1,116.68611435239200000000
chr5,1333176,1333400,224,-1,0,81037,1,446.42857142857100000000
chr5,1382524,1415867,33343,-1,0,6531,1,2.99913025222685000000
chr5,1422499,1423451,952,-1,0,6531,1,105.04201680672300000000
chr5,1444617,1446697,2080,-1,0,6531,1,48.07692307692310000000
chr5,1483782,1484149,367,-1,0,79888,1,272.47956403269800000000
chr5,1523313,1524208,895,-1,0,79888,1,111.73184357541900000000
chr5,1627139,1628838,1699,-1,0,,0,0.00000000000000000000
chr5,1562101,1562399,298,-1,0,,0,0.00000000000000000000
chr5,1562614,1562705,91,-1,0,,0,0.00000000000000000000
chr5,1645442,1646112,670,-1,0,,0,0.00000000000000000000
chr5,1663315,1664510,1195,-1,0,,0,0.00000000000000000000
chr5,1662926,1663577,651,-1,0,,0,0.00000000000000000000
chr5,1663762,1664350,588,-1,0,,0,0.00000000000000000000
chr5,1663084,1663364,280,-1,0,,0,0.00000000000000000000
chr5,1682462,1682775,313,-1,0,,0,0.00000000000000000000
chr5,1769048,1769300,252,-1,0,,0,0.00000000000000000000
chr5,1843202,1843442,240,-1,0,,0,0.00000000000000000000
chr5,1845603,1845786,183,-1,0,,0,0.00000000000000000000
chr5,1857960,1858597,637,-1,0,,0,0.00000000000000000000
chr5,1870808,1871247,439,-1,0,,0,0.00000000000000000000
chr5,1870491,1870773,282,-1,0,,0,0.00000000000000000000
chr5,1924586,1925201,615,-1,0,,0,0.00000000000000000000
chr5,1924604,1925065,461,-1,0,,0,0.00000000000000000000
chr5,1941039,1941590,551,-1,0,,0,0.00000000000000000000
chr5,1941143,1941453,310,-1,0,,0,0.00000000000000000000
chr5,1950939,1951583,644,-1,0,,0,0.00000000000000000000
chr5,1955918,1956803,885,-1,0,,0,0.00000000000000000000
chr5,1968393,1971584,3191,-1,0,,0,0.00000000000000000000
chr5,1972156,1972506,350,-1,0,,0,0.00000000000000000000
chr5,1972453,1972570,117,-1,0,,0,0.00000000000000000000
chr5,1994459,1994550,91,-1,0,,0,0.00000000000000000000
chr5,2039421,2066245,26824,-1,0,,0,0.00000000000000000000
chr5,2082304,2082821,517,-1,0,,0,0.00000000000000000000
chr5,2152674,2152744,70,-1,0,,0,0.00000000000000000000
chr5,2208533,2211423,2890,-1,0,,0,0.00000000000000000000
chr5,2233955,2237395,3440,-1,0,,0,0.00000000000000000000
chr5,2306100,2307255,1155,-1,0,,0,0.00000000000000000000
chr5,2332841,2332997,156,-1,0,,0,0.00000000000000000000
chr5,2372007,2372428,421,-1,0,,0,0.00000000000000000000
chr5,2490437,2491646,1209,-1,0,,0,0.00000000000000000000
chr5,2490629,2491455,826,-1,0,,0,0.00000000000000000000
chr5,2512364,2512513,149,-1,0,,0,0.00000000000000000000
chr5,2539267,2542190,2923,-1,0,,0,0.00000000000000000000
chr5,2540917,2542246,1329,-1,0,,0,0.00000000000000000000
chr5,2541707,2542206,499,-1,0,,0,0.00000000000000000000
chr5,2541832,2542133,301,-1,0,,0,0.00000000000000000000
chr5,2564577,2564665,88,-1,0,,0,0.00000000000000000000
chr5,2656930,2657419,489,-1,0,,0,0.00000000000000000000
chr5,2712711,2715362,2651,-1,0,,0,0.00000000000000000000
chr5,2784423,2784918,495,-1,0,,0,0.00000000000000000000
chr5,2769217,2769835,618,-1,0,,0,0.00000000000000000000
chr5,2769422,2769638,216,-1,0,,0,0.00000000000000000000
chr5,2784640,2784725,85,-1,0,,0,0.00000000000000000000
chr5,2819327,2821144,1817,-1,0,,0,0.00000000000000000000
chr5,2862571,2863349,778,-1,0,,0,0.00000000000000000000
chr5,2945934,2946339,405,-1,0,,0,0.00000000000000000000
chr5,3015352,3015856,504,-1,0,,0,0.00000000000000000000
chr5,3015437,3015766,329,-1,0,,0,0.00000000000000000000
chr5,3001201,3001568,367,-1,0,,0,0.00000000000000000000
chr5,3078328,3078962,634,-1,0,,0,0.00000000000000000000
chr5,3141446,3141545,99,-1,0,,0,0.00000000000000000000
chr5,3241635,3244327,2692,-1,0,,0,0.00000000000000000000
chr5,3323307,3324072,765,-1,0,,0,0.00000000000000000000
chr5,3332471,3333846,1375,-1,0,,0,0.00000000000000000000
chr5,3346245,3349848,3603,-1,0,,0,0.00000000000000000000
chr5,3420430,3421037,607,-1,0,,0,0.00000000000000000000
chr5,3502249,3502749,500,-1,0,,0,0.00000000000000000000
chr5,3499222,3499699,477,-1,0,,0,0.00000000000000000000
chr5,3499268,3499597,329,-1,0,,0,0.00000000000000000000
chr5,3502327,3502655,328,-1,0,,0,0.00000000000000000000
chr5,3594613,3597185,2572,-1,0,79192,1,38.88024883359250000000
chr5,3630929,3631101,172,-1,0,,0,0.00000000000000000000
chr5,3636878,3639429,2551,-1,0,,0,0.00000000000000000000
chr5,3637895,3639591,1696,-1,0,,0,0.00000000000000000000
chr5,3656963,3660629,3666,-1,0,,0,0.00000000000000000000
chr5,3785902,3786383,481,-1,0,,0,0.00000000000000000000
chr5,3785534,3785977,443,-1,0,,0,0.00000000000000000000
chr5,3957167,3970633,13466,-1,0,,0,0.00000000000000000000
chr5,4133976,4137034,3058,-1,0,,0,0.00000000000000000000
chr5,4424788,4434231,9443,-1,0,,0,0.00000000000000000000
chr5,4459228,4459751,523,-1,0,,0,0.00000000000000000000
chr5,4459406,4459513,107,-1,0,,0,0.00000000000000000000
chr5,4463885,4466666,2781,-1,0,,0,0.00000000000000000000
chr5,4524218,4528509,4291,-1,0,,0,0.00000000000000000000
chr5,4579141,4579437,296,-1,0,,0,0.00000000000000000000
chr5,4842976,4844257,1281,-1,0,,0,0.00000000000000000000
chr5,5026080,5027738,1658,-1,0,,0,0.00000000000000000000
chr5,5107849,5109890,2041,-1,0,,0,0.00000000000000000000
chr5,5139737,5140850,1113,-1,0,170690,1,89.84725965858040000000
chr5,5375693,5378380,2687,-1,0,,0,0.00000000000000000000
chr5,5610698,5611154,456,-1,0,,0,0.00000000000000000000
chr5,5610673,5610961,288,-1,0,,0,0.00000000000000000000
chr5,5678702,5680918,2216,-1,0,,0,0.00000000000000000000
chr5,5753194,5763659,10465,-1,0,,0,0.00000000000000000000
chr5,6524388,6524715,327,-1,0,,0,0.00000000000000000000
chr5,6571175,6571879,704,-1,0,,0,0.00000000000000000000
chr5,6713037,6714828,1791,-1,0,11044,1,55.83472920156340000000
chr5,6814724,6820811,6087,-1,0,,0,0.00000000000000000000
chr5,6955830,6966134,10304,-1,0,,0,0.00000000000000000000
chr5,6982006,6982151,145,-1,0,,0,0.00000000000000000000
chr5,7176210,7205505,29295,-1,0,,0,0.00000000000000000000
chr5,7173632,7193721,20089,-1,0,,0,0.00000000000000000000
chr5,7167510,7176725,9215,-1,0,,0,0.00000000000000000000
chr5,7221776,7222421,645,-1,0,,0,0.00000000000000000000
chr5,7221925,7222255,330,-1,0,,0,0.00000000000000000000
chr5,7238226,7240262,2036,-1,0,,0,0.00000000000000000000
chr5,7371559,7372785,1226,-1,0,,0,0.00000000000000000000
chr5,7371376,7372184,808,-1,0,,0,0.00000000000000000000
chr5,7477838,7480294,2456,-1,0,108,1,40.71661237785020000000
chr5,7907578,7908052,474,-1,0,,0,0.00000000000000000000
chr5,7917043,7920558,3515,-1,0,,0,0.00000000000000000000
chr5,7917042,7919114,2072,-1,0,,0,0.00000000000000000000
chr5,8027060,8027356,296,-1,0,,0,0.00000000000000000000
chr5,8028599,8029212,613,-1,0,,0,0.00000000000000000000
chr5,8081268,8081328,60,-1,0,,0,0.00000000000000000000
chr5,8110588,8122345,11757,-1,0,,0,0.00000000000000000000
chr5,8118679,8119074,395,-1,0,,0,0.00000000000000000000
chr5,8118864,8118932,68,-1,0,,0,0.00000000000000000000
chr5,8234338,8235353,1015,-1,0,,0,0.00000000000000000000
chr5,8236058,8236570,512,-1,0,,0,0.00000000000000000000
chr5,8255861,8260923,5062,-1,0,,0,0.00000000000000000000
chr5,8268314,8292340,24026,-1,0,,0,0.00000000000000000000
chr5,8320505,8321628,1123,-1,0,,0,0.00000000000000000000
chr5,8590576,8598340,7764,-1,0,,0,0.00000000000000000000
chr5,8702639,8749030,46391,-1,0,,0,0.00000000000000000000
chr5,8720845,8747513,26668,-1,0,,0,0.00000000000000000000
chr5,8937780,8938898,1118,-1,0,,0,0.00000000000000000000
chr5,9267241,9275453,8212,-1,0,9037,1,12.17730150998540000000
chr5,9235645,9235876,231,-1,0,9037,1,432.90043290043300000000
chr5,9162562,9162689,127,-1,0,9037,1,787.40157480315000000000
chr5,9400548,9400968,420,-1,0,9037,1,238.09523809523800000000
chr5,9400610,9400880,270,-1,0,9037,1,370.37037037037000000000
chr5,9411735,9412101,366,-1,0,9037,1,273.22404371584700000000
chr5,9512894,9514487,1593,-1,0,9037,1,62.77463904582550000000
chr5,9545673,9546476,803,-1,0,9037,1,124.53300124533000000000
chr5,9734883,9735726,843,-1,0,,0,0.00000000000000000000
chr5,9900717,9925169,24452,-1,0,,0,0.00000000000000000000
chr5,9913785,9924159,10374,-1,0,,0,0.00000000000000000000
chr5,9897449,9899664,2215,-1,0,,0,0.00000000000000000000
chr5,9989918,9990454,536,-1,0,,0,0.00000000000000000000
chr5,9990082,9990327,245,-1,0,,0,0.00000000000000000000
chr5,10005255,10005593,338,-1,0,,0,0.00000000000000000000
chr5,10273282,10275384,2102,-1,0,,0,0.00000000000000000000
chr5,10273896,10274880,984,-1,0,,0,0.00000000000000000000
chr5,10521810,10521865,55,-1,0,,0,0.00000000000000000000
chr5,10526926,10532351,5425,-1,0,,0,0.00000000000000000000
chr5,10562851,10565401,2550,-1,0,651746,1,39.21568627450980000000
chr5,10563366,10564591,1225,-1,0,651746,1,81.63265306122450000000
chr5,10574917,10575361,444,-1,0,651746,1,225.22522522522500000000
chr5,10574993,10575314,321,-1,0,651746,1,311.52647975077900000000
chr5,10638882,10640574,1692,-1,0,651746,1,59.10165484633570000000
chr5,10639114,10640039,925,-1,0,651746,1,108.10810810810800000000
chr5,10639107,10639639,532,-1,0,651746,1,187.96992481203000000000
chr5,10639654,10640101,447,-1,0,651746,1,223.71364653243800000000
chr5,10756183,10756520,337,-1,0,1611,1,296.73590504451000000000
chr5,10760952,10761766,814,-1,0,1611,1,122.85012285012300000000
chr5,11128227,11135517,7290,-1,0,1501,1,13.71742112482850000000
chr5,11120560,11120806,246,-1,0,1501,1,406.50406504065000000000
chr5,11166103,11178832,12729,-1,0,1501,1,7.85607667530835000000
chr5,11338927,11339475,548,-1,0,1501,1,182.48175182481800000000
chr5,11339042,11339366,324,-1,0,1501,1,308.64197530864200000000
chr5,11384718,11385476,758,-1,0,1501,1,131.92612137203200000000
chr5,11816738,11817509,771,-1,0,1501,1,129.70168612192000000000
chr5,11796831,11797680,849,-1,0,1501,1,117.78563015312100000000
chr5,11880215,11881329,1114,-1,0,1501,1,89.76660682226210000000
chr5,12037489,12037569,80,-1,0,,0,0.00000000000000000000
chr5,12571916,12781760,209844,-1,0,,0,0.00000000000000000000
chr5,12680805,12830133,149328,-1,0,,0,0.00000000000000000000
chr5,12526364,12639109,112745,-1,0,,0,0.00000000000000000000
chr5,12791615,12892549,100934,-1,0,,0,0.00000000000000000000
chr5,12261121,12343646,82525,-1,0,,0,0.00000000000000000000
chr5,12188723,12270356,81633,-1,0,,0,0.00000000000000000000
chr5,12676003,12749445,73442,-1,0,,0,0.00000000000000000000
chr5,12762950,12807283,44333,-1,0,,0,0.00000000000000000000
chr5,12790096,12818561,28465,-1,0,,0,0.00000000000000000000
chr5,12803449,12837306,33857,-1,0,,0,0.00000000000000000000
chr5,12815533,12836316,20783,-1,0,,0,0.00000000000000000000
chr5,12806858,12821186,14328,-1,0,,0,0.00000000000000000000
chr5,12815712,12826501,10789,-1,0,,0,0.00000000000000000000
chr5,12811019,12820529,9510,-1,0,,0,0.00000000000000000000
chr5,12722575,12730489,7914,-1,0,,0,0.00000000000000000000
chr5,13053735,13059906,6171,-1,0,,0,0.00000000000000000000
chr5,12814350,12819101,4751,-1,0,,0,0.00000000000000000000
chr5,12691058,12695578,4520,-1,0,,0,0.00000000000000000000
chr5,12851572,12855231,3659,-1,0,,0,0.00000000000000000000
chr5,12425939,12428643,2704,-1,0,,0,0.00000000000000000000
chr5,12427015,12428771,1756,-1,0,,0,0.00000000000000000000
chr5,12186404,12186888,484,-1,0,,0,0.00000000000000000000
chr5,12375824,12376275,451,-1,0,,0,0.00000000000000000000
chr5,12186497,12186776,279,-1,0,,0,0.00000000000000000000
chr5,12426377,12426588,211,-1,0,,0,0.00000000000000000000
chr5,12435650,12435739,89,-1,0,,0,0.00000000000000000000
chr5,12769657,12769711,54,-1,0,,0,0.00000000000000000000
chr5,13199164,13338773,139609,-1,0,,0,0.00000000000000000000
chr5,13213310,13218185,4875,-1,0,,0,0.00000000000000000000
chr5,13359014,13387376,28362,-1,0,,0,0.00000000000000000000
chr5,13416564,13422888,6324,-1,0,,0,0.00000000000000000000
chr5,13399940,13400024,84,-1,0,,0,0.00000000000000000000
chr5,13427687,13427740,53,-1,0,,0,0.00000000000000000000
chr5,13587466,13590071,2605,-1,0,,0,0.00000000000000000000
chr5,13655626,13655916,290,-1,0,,0,0.00000000000000000000
chr5,13855285,13855663,378,-1,0,1767,1,264.55026455026500000000
chr5,13894997,13895444,447,-1,0,1767,1,223.71364653243800000000
chr5,13895092,13895389,297,-1,0,1767,1,336.70033670033700000000
chr5,13967656,13968201,545,-1,0,,0,0.00000000000000000000
chr5,13967847,13968027,180,-1,0,,0,0.00000000000000000000
chr5,14143452,14145209,1757,-1,0,7204,1,56.91519635742740000000
chr5,14207232,14207496,264,-1,0,7204,1,378.78787878787900000000
chr5,14312802,14316381,3579,-1,0,7204,1,27.94076557697680000000
chr5,14370460,14371997,1537,-1,0,7204,1,65.06180871828240000000
chr5,14402824,14404509,1685,-1,0,7204,1,59.34718100890210000000
chr5,14528194,14530730,2536,-1,0,,0,0.00000000000000000000
chr5,14540780,14541800,1020,-1,0,,0,0.00000000000000000000
chr5,14581816,14582531,715,-1,0,54491,1,139.86013986014000000000
chr5,14589090,14591923,2833,-1,0,54491,1,35.29827038475110000000
chr5,14634024,14634795,771,-1,0,,0,0.00000000000000000000
chr5,14871724,14872656,932,-1,0,56172,1,107.29613733905600000000
chr5,14951799,14953904,2105,-1,0,,0,0.00000000000000000000
chr5,14964173,14965824,1651,-1,0,,0,0.00000000000000000000
chr5,15227971,15231026,3055,-1,0,,0,0.00000000000000000000
chr5,15603674,15606607,2933,-1,0,23194,1,34.09478349812480000000
chr5,15719353,15729687,10334,-1,0,23194,1,9.67679504548094000000
chr5,15719155,15722271,3116,-1,0,23194,1,32.09242618741980000000
chr5,15719333,15721048,1715,-1,0,23194,1,58.30903790087460000000
chr5,15719657,15721225,1568,-1,0,23194,1,63.77551020408160000000
chr5,15719905,15720689,784,-1,0,23194,1,127.55102040816300000000
chr5,15747961,15748390,429,-1,0,23194,1,233.10023310023300000000
chr5,15906450,15912716,6266,-1,0,23194,1,15.95914458985000000000
chr5,16008439,16018531,10092,-1,0,,0,0.00000000000000000000
chr5,16124432,16125787,1355,-1,0,441061,1,73.80073800738010000000
chr5,16124831,16125513,682,-1,0,441061,1,146.62756598240500000000
chr5,16149989,16150863,874,-1,0,441061,1,114.41647597254000000000
chr5,16179170,16180154,984,-1,0,441061,1,101.62601626016300000000
chr5,16293762,16306469,12707,-1,0,,0,0.00000000000000000000
chr5,16524804,16525083,279,-1,0,54463,1,358.42293906810000000000
chr5,16535688,16536728,1040,-1,0,54463,1,96.15384615384620000000
chr5,16889591,16891463,1872,-1,0,4651,1,53.41880341880340000000
chr5,16869751,16870788,1037,-1,0,4651,1,96.43201542912250000000
chr5,16888374,16889020,646,-1,0,4651,1,154.79876160990700000000
chr5,16944171,16944483,312,-1,0,,0,0.00000000000000000000
chr5,16944264,16944355,91,-1,0,,0,0.00000000000000000000
chr5,16999166,17012826,13660,-1,0,,0,0.00000000000000000000
chr5,17056854,17058516,1662,-1,0,,0,0.00000000000000000000
chr5,17077330,17078625,1295,-1,0,,0,0.00000000000000000000
chr5,17093109,17098290,5181,-1,0,,0,0.00000000000000000000
chr5,17098285,17100234,1949,-1,0,,0,0.00000000000000000000
chr5,17342058,17357634,15576,-1,0,,0,0.00000000000000000000
chr5,17347801,17356258,8457,-1,0,,0,0.00000000000000000000
chr5,17494809,17659954,165145,-1,0,,0,0.00000000000000000000
chr5,17634405,17792502,158097,-1,0,,0,0.00000000000000000000
chr5,17522977,17605734,82757,-1,0,,0,0.00000000000000000000
chr5,17607030,17684073,77043,-1,0,,0,0.00000000000000000000
chr5,17690853,17744551,53698,-1,0,,0,0.00000000000000000000
chr5,17633889,17688416,54527,-1,0,,0,0.00000000000000000000
chr5,17601452,17653188,51736,-1,0,,0,0.00000000000000000000
chr5,17434122,17480077,45955,-1,0,,0,0.00000000000000000000
chr5,17719624,17765760,46136,-1,0,,0,0.00000000000000000000
chr5,17668977,17713232,44255,-1,0,,0,0.00000000000000000000
chr5,17479777,17517233,37456,-1,0,,0,0.00000000000000000000
chr5,17631187,17653686,22499,-1,0,,0,0.00000000000000000000
chr5,17664392,17692258,27866,-1,0,,0,0.00000000000000000000
chr5,17604667,17631412,26745,-1,0,,0,0.00000000000000000000
chr5,17618964,17643041,24077,-1,0,,0,0.00000000000000000000
chr5,17608461,17621203,12742,-1,0,,0,0.00000000000000000000
chr5,17616816,17632004,15188,-1,0,,0,0.00000000000000000000
chr5,17499460,17513828,14368,-1,0,,0,0.00000000000000000000
chr5,17638980,17651555,12575,-1,0,,0,0.00000000000000000000
chr5,17632248,17643430,11182,-1,0,,0,0.00000000000000000000
chr5,17711307,17719734,8427,-1,0,,0,0.00000000000000000000
chr5,17509888,17517440,7552,-1,0,,0,0.00000000000000000000
chr5,17691709,17699155,7446,-1,0,,0,0.00000000000000000000
chr5,17463717,17471090,7373,-1,0,,0,0.00000000000000000000
chr5,17599871,17606414,6543,-1,0,,0,0.00000000000000000000
chr5,17854021,17860671,6650,-1,0,,0,0.00000000000000000000
chr5,17475008,17480158,5150,-1,0,,0,0.00000000000000000000
chr5,17661369,17664408,3039,-1,0,,0,0.00000000000000000000
chr5,17615702,17617752,2050,-1,0,,0,0.00000000000000000000
chr5,17668058,17670630,2572,-1,0,,0,0.00000000000000000000
chr5,17758803,17760631,1828,-1,0,,0,0.00000000000000000000
chr5,17619257,17620812,1555,-1,0,,0,0.00000000000000000000
chr5,17669326,17670062,736,-1,0,,0,0.00000000000000000000
chr5,17620275,17620942,667,-1,0,,0,0.00000000000000000000
chr5,17960564,17993785,33221,-1,0,,0,0.00000000000000000000
chr5,18808397,19323989,515592,-1,0,,0,0.00000000000000000000
chr5,21024297,21365690,341393,-1,0,,0,0.00000000000000000000
chr5,19025761,19255164,229403,-1,0,,0,0.00000000000000000000
chr5,18568376,18828876,260500,-1,0,,0,0.00000000000000000000
chr5,21229646,21464565,234919,-1,0,,0,0.00000000000000000000
chr5,21394390,21542063,147673,-1,0,,0,0.00000000000000000000
chr5,18834840,18955008,120168,-1,0,,0,0.00000000000000000000
chr5,21273598,21379070,105472,-1,0,,0,0.00000000000000000000
chr5,19323858,19407594,83736,-1,0,,0,0.00000000000000000000
chr5,19010491,19083221,72730,-1,0,,0,0.00000000000000000000
chr5,18610243,18679210,68967,-1,0,,0,0.00000000000000000000
chr5,21392332,21458208,65876,-1,0,,0,0.00000000000000000000
chr5,20057331,20116879,59548,-1,0,1016,1,1.67931752535769000000
chr5,18583286,18638659,55373,-1,0,,0,0.00000000000000000000
chr5,19133904,19179039,45135,-1,0,,0,0.00000000000000000000
chr5,21020221,21060979,40758,-1,0,,0,0.00000000000000000000
chr5,20828273,20851595,23322,-1,0,,0,0.00000000000000000000
chr5,21478284,21497778,19494,-1,0,,0,0.00000000000000000000
chr5,19220970,19232448,11478,-1,0,,0,0.00000000000000000000
chr5,21444163,21452617,8454,-1,0,,0,0.00000000000000000000
chr5,20436991,20445596,8605,-1,0,1016,1,11.62115049389890000000
chr5,20419696,20428723,9027,-1,0,1016,1,11.07787747867510000000
chr5,19277736,19288048,10312,-1,0,,0,0.00000000000000000000
chr5,21490010,21497140,7130,-1,0,,0,0.00000000000000000000
chr5,19956599,19964697,8098,-1,0,1016,1,12.34872808100770000000
chr5,19405063,19413060,7997,-1,0,,0,0.00000000000000000000
chr5,21532445,21539609,7164,-1,0,,0,0.00000000000000000000
chr5,18643238,18648506,5268,-1,0,,0,0.00000000000000000000
chr5,21515123,21519629,4506,-1,0,,0,0.00000000000000000000
chr5,20127204,20131123,3919,-1,0,1016,1,25.51671344730800000000
chr5,18871984,18875077,3093,-1,0,,0,0.00000000000000000000
chr5,21141254,21144208,2954,-1,0,,0,0.00000000000000000000
chr5,21375479,21377334,1855,-1,0,,0,0.00000000000000000000
chr5,21450188,21452511,2323,-1,0,,0,0.00000000000000000000
chr5,19228920,19231060,2140,-1,0,,0,0.00000000000000000000
chr5,19375203,19376625,1422,-1,0,,0,0.00000000000000000000
chr5,20832626,20834509,1883,-1,0,,0,0.00000000000000000000
chr5,18998061,19000134,2073,-1,0,,0,0.00000000000000000000
chr5,18255686,18257507,1821,-1,0,,0,0.00000000000000000000
chr5,18873324,18874985,1661,-1,0,,0,0.00000000000000000000
chr5,20557520,20558511,991,-1,0,1016,1,100.90817356205900000000
chr5,21450841,21452077,1236,-1,0,,0,0.00000000000000000000
chr5,19375312,19376382,1070,-1,0,,0,0.00000000000000000000
chr5,19235369,19236246,877,-1,0,,0,0.00000000000000000000
chr5,21481967,21482783,816,-1,0,,0,0.00000000000000000000
chr5,20886704,20887399,695,-1,0,,0,0.00000000000000000000
chr5,18874081,18874794,713,-1,0,,0,0.00000000000000000000
chr5,21252064,21252656,592,-1,0,,0,0.00000000000000000000
chr5,19078544,19079032,488,-1,0,,0,0.00000000000000000000
chr5,21338269,21338695,426,-1,0,,0,0.00000000000000000000
chr5,21543033,21543315,282,-1,0,,0,0.00000000000000000000
chr5,20907631,20907974,343,-1,0,,0,0.00000000000000000000
chr5,20018895,20019206,311,-1,0,1016,1,321.54340836012900000000
chr5,20990982,20991181,199,-1,0,,0,0.00000000000000000000
chr5,21543054,21543270,216,-1,0,,0,0.00000000000000000000
chr5,19849785,19849924,139,-1,0,1016,1,719.42446043165500000000
chr5,18171816,18171880,64,-1,0,,0,0.00000000000000000000
chr5,19466356,19466418,62,-1,0,,0,0.00000000000000000000
chr5,21574416,21575933,1517,-1,0,,0,0.00000000000000000000
chr5,21611128,21617056,5928,-1,0,,0,0.00000000000000000000
chr5,21611853,21614775,2922,-1,0,,0,0.00000000000000000000
chr5,21613261,21614774,1513,-1,0,,0,0.00000000000000000000
chr5,21649450,21651246,1796,-1,0,,0,0.00000000000000000000
chr5,21651437,21652052,615,-1,0,,0,0.00000000000000000000
chr5,21651576,21651898,322,-1,0,,0,0.00000000000000000000
chr5,21740862,21743454,2592,-1,0,,0,0.00000000000000000000
chr5,21834198,21837549,3351,-1,0,1010,1,29.84183825723660000000
chr5,21850393,21984769,134376,-1,0,1010,1,0.74418050842412300000
chr5,21935587,21996393,60806,-1,0,1010,1,1.64457454856429000000
chr5,21868076,21868558,482,-1,0,1010,1,207.46887966805000000000
chr5,22016044,22018570,2526,-1,0,1010,1,39.58828186856690000000
chr5,22117550,22122732,5182,-1,0,1010,1,19.29756850636820000000
chr5,22117535,22117632,97,-1,0,1010,1,1030.92783505155000000000
chr5,22315051,22315228,177,-1,0,1010,1,564.97175141242900000000
chr5,22566586,22567370,784,-1,0,1010,1,127.55102040816300000000
chr5,22796609,22796928,319,-1,0,1010,1,313.47962382445100000000
chr5,23048808,23051299,2491,-1,0,,0,0.00000000000000000000
chr5,23262669,23270056,7387,-1,0,,0,0.00000000000000000000
chr5,23303353,23304799,1446,-1,0,,0,0.00000000000000000000
chr5,23374537,23374857,320,-1,0,,0,0.00000000000000000000
chr5,23413653,23414175,522,-1,0,,0,0.00000000000000000000
chr5,23633243,23633669,426,-1,0,,0,0.00000000000000000000
chr5,23413765,23414082,317,-1,0,,0,0.00000000000000000000
chr5,23902804,23906644,3840,-1,0,,0,0.00000000000000000000
chr5,23902961,23905238,2277,-1,0,,0,0.00000000000000000000
chr5,23804634,23806599,1965,-1,0,,0,0.00000000000000000000
chr5,24091522,24092042,520,-1,0,,0,0.00000000000000000000
chr5,23910312,23910837,525,-1,0,,0,0.00000000000000000000
chr5,24091607,24091940,333,-1,0,,0,0.00000000000000000000
chr5,23910429,23910726,297,-1,0,,0,0.00000000000000000000
chr5,24221902,24280501,58599,-1,0,,0,0.00000000000000000000
chr5,24308459,24313581,5122,-1,0,,0,0.00000000000000000000
chr5,24370401,24373490,3089,-1,0,,0,0.00000000000000000000
chr5,24429837,24441717,11880,-1,0,,0,0.00000000000000000000
chr5,24452723,24453280,557,-1,0,,0,0.00000000000000000000
chr5,24452849,24453174,325,-1,0,,0,0.00000000000000000000
chr5,24567617,24577661,10044,-1,0,1008,1,9.95619275189168000000
chr5,24758294,24758399,105,-1,0,,0,0.00000000000000000000
chr5,24769821,24781815,11994,-1,0,,0,0.00000000000000000000
chr5,24778286,24786317,8031,-1,0,,0,0.00000000000000000000
chr5,25071554,25074464,2910,-1,0,,0,0.00000000000000000000
chr5,25176602,25224637,48035,-1,0,,0,0.00000000000000000000
chr5,25275285,25275849,564,-1,0,,0,0.00000000000000000000
chr5,25275405,25275731,326,-1,0,,0,0.00000000000000000000
chr5,25314523,25315073,550,-1,0,,0,0.00000000000000000000
chr5,25316197,25316504,307,-1,0,,0,0.00000000000000000000
chr5,25314634,25314952,318,-1,0,,0,0.00000000000000000000
chr5,25541911,25547188,5277,-1,0,,0,0.00000000000000000000
chr5,25653043,25653266,223,-1,0,,0,0.00000000000000000000
chr5,25777210,25777730,520,-1,0,,0,0.00000000000000000000
chr5,25777314,25777637,323,-1,0,,0,0.00000000000000000000
chr5,25821742,25826858,5116,-1,0,,0,0.00000000000000000000
chr5,25821783,25823947,2164,-1,0,,0,0.00000000000000000000
chr5,25821742,25822828,1086,-1,0,,0,0.00000000000000000000
chr5,25833326,25833690,364,-1,0,,0,0.00000000000000000000
chr5,25889792,25892379,2587,-1,0,,0,0.00000000000000000000
chr5,26009470,26011754,2284,-1,0,,0,0.00000000000000000000
chr5,26111097,26111653,556,-1,0,,0,0.00000000000000000000
chr5,26091127,26091631,504,-1,0,,0,0.00000000000000000000
chr5,26111195,26111520,325,-1,0,,0,0.00000000000000000000
chr5,26119154,26119392,238,-1,0,,0,0.00000000000000000000
chr5,26186255,26186315,60,-1,0,,0,0.00000000000000000000
chr5,26228585,26228991,406,-1,0,,0,0.00000000000000000000
chr5,26228797,26228874,77,-1,0,,0,0.00000000000000000000
chr5,26600494,26601135,641,-1,0,,0,0.00000000000000000000
chr5,26385007,26385661,654,-1,0,,0,0.00000000000000000000
chr5,26653698,26654169,471,-1,0,,0,0.00000000000000000000
chr5,26600717,26600836,119,-1,0,,0,0.00000000000000000000
chr5,26653901,26653980,79,-1,0,,0,0.00000000000000000000
chr5,26793983,26802032,8049,-1,0,,0,0.00000000000000000000
chr5,26796780,26801345,4565,-1,0,,0,0.00000000000000000000
chr5,26800064,26802651,2587,-1,0,,0,0.00000000000000000000
chr5,27521137,27536188,15051,-1,0,,0,0.00000000000000000000
chr5,27519178,27530250,11072,-1,0,,0,0.00000000000000000000
chr5,27524500,27526299,1799,-1,0,,0,0.00000000000000000000
chr5,27525383,27526002,619,-1,0,,0,0.00000000000000000000
chr5,27606267,27633896,27629,-1,0,,0,0.00000000000000000000
chr5,27627906,27635876,7970,-1,0,,0,0.00000000000000000000
chr5,28216635,28225276,8641,-1,0,,0,0.00000000000000000000
chr5,28245670,28253298,7628,-1,0,,0,0.00000000000000000000
chr5,28490925,28495630,4705,-1,0,,0,0.00000000000000000000
chr5,28218887,28222685,3798,-1,0,,0,0.00000000000000000000
chr5,28356941,28357230,289,-1,0,,0,0.00000000000000000000
chr5,28309316,28309479,163,-1,0,,0,0.00000000000000000000
chr5,28545719,28547824,2105,-1,0,,0,0.00000000000000000000
chr5,28640657,28729141,88484,-1,0,,0,0.00000000000000000000
chr5,28795742,28871841,76099,-1,0,,0,0.00000000000000000000
chr5,28813380,28813979,599,-1,0,,0,0.00000000000000000000
chr5,28813575,28813828,253,-1,0,,0,0.00000000000000000000
chr5,28932254,28932906,652,-1,0,,0,0.00000000000000000000
chr5,28937873,29146154,208281,-1,0,,0,0.00000000000000000000
chr5,29271612,29271825,213,-1,0,,0,0.00000000000000000000
chr5,29480477,29481451,974,-1,0,,0,0.00000000000000000000
chr5,29499672,29511368,11696,-1,0,,0,0.00000000000000000000
chr5,29530195,29540080,9885,-1,0,,0,0.00000000000000000000
chr5,29709997,29712395,2398,-1,0,,0,0.00000000000000000000
chr5,29533155,29533654,499,-1,0,,0,0.00000000000000000000
chr5,29533323,29533456,133,-1,0,,0,0.00000000000000000000
chr5,29868801,29869243,442,-1,0,,0,0.00000000000000000000
chr5,29863595,29864016,421,-1,0,,0,0.00000000000000000000
chr5,29868949,29869027,78,-1,0,,0,0.00000000000000000000
chr5,30915524,30916060,536,-1,0,,0,0.00000000000000000000
chr5,31346858,31348508,1650,-1,0,,0,0.00000000000000000000
chr5,31391091,31392038,947,-1,0,,0,0.00000000000000000000
chr5,31572372,31576977,4605,-1,0,,0,0.00000000000000000000
chr5,31677332,31677865,533,-1,0,23037,1,187.61726078799300000000
chr5,31677422,31677752,330,-1,0,23037,1,303.03030303030300000000
chr5,32039256,32039578,322,-1,0,23037,1,310.55900621118000000000
chr5,32085292,32085794,502,-1,0,23037,1,199.20318725099600000000
chr5,32161084,32162521,1437,-1,0,64083,1,69.58942240779400000000
chr5,32260091,32261294,1203,-1,0,54545,1,83.12551953449710000000
chr5,32312478,32313163,685,-1,0,54545,1,145.98540145985400000000
chr5,32334369,32335688,1319,-1,0,,0,0.00000000000000000000
chr5,32357129,32364092,6963,-1,0,51663,1,14.36162573603330000000
chr5,32557295,32558514,1219,-1,0,,0,0.00000000000000000000
chr5,32710891,32716476,5585,-1,0,4883,1,17.90510295434200000000
chr5,32852905,32853819,914,-1,0,,0,0.00000000000000000000
chr5,32860899,32862802,1903,-1,0,,0,0.00000000000000000000
chr5,32966161,32970926,4765,-1,0,,0,0.00000000000000000000
chr5,33186521,33193143,6622,-1,0,,0,0.00000000000000000000
chr5,33111781,33112825,1044,-1,0,,0,0.00000000000000000000
chr5,33111748,33112420,672,-1,0,,0,0.00000000000000000000
chr5,33200782,33201268,486,-1,0,,0,0.00000000000000000000
chr5,33200859,33201171,312,-1,0,,0,0.00000000000000000000
chr5,33355557,33355915,358,-1,0,,0,0.00000000000000000000
chr5,33688235,33688733,498,-1,0,81792,1,200.80321285140600000000
chr5,33688469,33688536,67,-1,0,81792,1,1492.53731343284000000000
chr5,34221344,34278686,57342,-1,0,,0,0.00000000000000000000
chr5,34178618,34197161,18543,-1,0,,0,0.00000000000000000000
chr5,34074296,34086570,12274,-1,0,,0,0.00000000000000000000
chr5,34304786,34307907,3121,-1,0,,0,0.00000000000000000000
chr5,34330942,34394284,63342,-1,0,,0,0.00000000000000000000
chr5,34656319,34657401,1082,-1,0,26064,1,92.42144177449170000000
chr5,34855010,34855597,587,-1,0,153657,1,170.35775127768300000000
chr5,34855100,34855512,412,-1,0,153657,1,242.71844660194200000000
chr5,34855248,34855358,110,-1,0,153657,1,909.09090909090900000000
chr5,34860213,34861362,1149,-1,0,153657,1,87.03220191470840000000
chr5,35187198,35189429,2231,-1,0,5618,1,44.82294935006720000000
chr5,35191133,35191471,338,-1,0,5618,1,295.85798816568000000000
chr5,35195982,35196371,389,-1,0,5618,1,257.06940874036000000000
chr5,35196137,35196187,50,-1,0,5618,1,2000.00000000000000000000
chr5,35345470,35346086,616,-1,0,,0,0.00000000000000000000
chr5,35614112,35614532,420,-1,0,,0,0.00000000000000000000
chr5,35672176,35672605,429,-1,0,79925,1,233.10023310023300000000
chr5,35841603,35842161,558,-1,0,,0,0.00000000000000000000
chr5,35841769,35841935,166,-1,0,,0,0.00000000000000000000
chr5,35841815,35841931,116,-1,0,,0,0.00000000000000000000
chr5,35859079,35873201,14122,-1,0,3575,1,7.08114997875655000000
chr5,36357373,36357565,192,-1,0,,0,0.00000000000000000000
chr5,36448895,36467841,18946,-1,0,,0,0.00000000000000000000
chr5,36486027,36486301,274,-1,0,,0,0.00000000000000000000
chr5,36710472,36711058,586,-1,0,,0,0.00000000000000000000
chr5,36751405,36752002,597,-1,0,,0,0.00000000000000000000
chr5,37191536,37192758,1222,-1,0,65250,1,81.83306055646480000000
chr5,37254628,37257743,3115,-1,0,,0,0.00000000000000000000
chr5,37293798,37294131,333,-1,0,9631,1,300.30030030030000000000
chr5,37447561,37472889,25328,-1,0,55100,1,3.94819962097284000000
chr5,37471315,37473323,2008,-1,0,55100,1,49.80079681274900000000
chr5,37504335,37504527,192,-1,0,55100,1,520.83333333333300000000
chr5,37583619,37583682,63,-1,0,55100,1,1587.30158730159000000000
chr5,37777478,37778706,1228,-1,0,,0,0.00000000000000000000
chr5,37784743,37784877,134,-1,0,,0,0.00000000000000000000
chr5,37839636,37840756,1120,-1,0,2668,1,89.28571428571430000000
chr5,37853449,37853897,448,-1,0,,0,0.00000000000000000000
chr5,37911461,37928634,17173,-1,0,,0,0.00000000000000000000
chr5,37972566,37974544,1978,-1,0,,0,0.00000000000000000000
chr5,38134471,38134527,56,-1,0,,0,0.00000000000000000000
chr5,38134502,38134563,61,-1,0,,0,0.00000000000000000000
chr5,38556304,38557018,714,-1,0,3977,1,140.05602240896400000000
chr5,38867736,38868279,543,-1,0,9180,1,184.16206261510100000000
chr5,38867814,38868211,397,-1,0,9180,1,251.88916876574300000000
chr5,38867994,38868108,114,-1,0,9180,1,877.19298245614000000000
chr5,39053798,39054062,264,-1,0,253260,1,378.78787878787900000000
chr5,39076942,39100348,23406,-1,0,,0,0.00000000000000000000
chr5,39074004,39075162,1158,-1,0,253260,1,86.35578583765110000000
chr5,39213784,39214261,477,-1,0,2533,1,209.64360587002100000000
chr5,39323080,39324905,1825,-1,0,735,1,54.79452054794520000000
chr5,39775303,39776636,1333,-1,0,,0,0.00000000000000000000
chr5,39847149,39851058,3909,-1,0,,0,0.00000000000000000000
chr5,39968845,39976666,7821,-1,0,,0,0.00000000000000000000
chr5,40334295,40352074,17779,-1,0,,0,0.00000000000000000000
chr5,40548300,40548380,80,-1,0,,0,0.00000000000000000000
chr5,40779259,40786850,7591,-1,0,5562,1,13.17349492820450000000
chr5,40794618,40794978,360,-1,0,5562,1,277.77777777777800000000
chr5,40851567,40851751,184,-1,0,84674,1,543.47826086956500000000
chr5,40982142,40985547,3405,-1,0,730,1,29.36857562408220000000
chr5,41226678,41243888,17210,-1,0,729,1,5.81057524694945000000
chr5,41411844,41412227,383,-1,0,345557,1,261.09660574412500000000
chr5,41411999,41412097,98,-1,0,345557,1,1020.40816326531000000000
chr5,41420622,41426707,6085,-1,0,345557,1,16.43385373870170000000
chr5,41569268,41582706,13438,-1,0,,0,0.00000000000000000000
chr5,41585688,41596433,10745,-1,0,,0,0.00000000000000000000
chr5,41599444,41600123,679,-1,0,,0,0.00000000000000000000
chr5,41603971,41604359,388,-1,0,,0,0.00000000000000000000
chr5,41754874,41757857,2983,-1,0,5019,1,33.52329869259140000000
chr5,41901910,41903713,1803,-1,0,,0,0.00000000000000000000
chr5,42091851,42095987,4136,-1,0,,0,0.00000000000000000000
chr5,42165927,42167769,1842,-1,0,,0,0.00000000000000000000
chr5,42251232,42253323,2091,-1,0,,0,0.00000000000000000000
chr5,42564239,42564408,169,-1,0,2690,1,591.71597633136100000000
chr5,42627214,42632176,4962,-1,0,2690,1,20.15316404675530000000
chr5,42628549,42631031,2482,-1,0,2690,1,40.29008863819500000000
chr5,42630001,42630980,979,-1,0,2690,1,102.14504596527100000000
chr5,42635968,42644259,8291,-1,0,2690,1,12.06127125799060000000
chr5,43085759,43089004,3245,-1,0,,0,0.00000000000000000000
chr5,43162895,43171048,8153,-1,0,7690,1,12.26542377039130000000
chr5,43216086,43216491,405,-1,0,167359,1,246.91358024691400000000
chr5,43238342,43243084,4742,-1,0,167359,1,21.08814846056520000000
chr5,43479099,43482519,3420,-1,0,64417,1,29.23976608187130000000
chr5,43516450,43516536,86,-1,0,,0,0.00000000000000000000
chr5,43523459,43523900,441,-1,0,,0,0.00000000000000000000
chr5,43550066,43550821,755,-1,0,10605,1,132.45033112582800000000
chr5,43582963,43583870,907,-1,0,,0,0.00000000000000000000
chr5,44162416,44162806,390,-1,0,,0,0.00000000000000000000
chr5,44125521,44125712,191,-1,0,,0,0.00000000000000000000
chr5,44344343,44344992,649,-1,0,2255,1,154.08320493066300000000
chr5,44795007,44795582,575,-1,0,,0,0.00000000000000000000
chr5,45004816,45014529,9713,-1,0,,0,0.00000000000000000000
chr5,45127239,45127670,431,-1,0,,0,0.00000000000000000000
chr5,45156625,45159513,2888,-1,0,,0,0.00000000000000000000
chr5,45191890,45217306,25416,-1,0,,0,0.00000000000000000000
chr5,45191123,45212557,21434,-1,0,,0,0.00000000000000000000
chr5,45191552,45193754,2202,-1,0,,0,0.00000000000000000000
chr5,45373622,45374038,416,-1,0,348980,1,240.38461538461500000000
chr5,45373767,45374019,252,-1,0,348980,1,396.82539682539700000000
chr5,45527065,45527870,805,-1,0,348980,1,124.22360248447200000000
chr5,45526972,45527471,499,-1,0,348980,1,200.40080160320600000000
chr5,45693354,45693943,589,-1,0,348980,1,169.77928692699500000000
chr5,45940738,46354667,413929,-1,0,,0,0.00000000000000000000
chr5,46218937,46369300,150363,-1,0,,0,0.00000000000000000000
chr5,46261534,46371041,109507,-1,0,,0,0.00000000000000000000
chr5,46163228,46247358,84130,-1,0,,0,0.00000000000000000000
chr5,46245316,46295377,50061,-1,0,,0,0.00000000000000000000
chr5,46313315,46389339,76024,-1,0,,0,0.00000000000000000000
chr5,46272796,46318521,45725,-1,0,,0,0.00000000000000000000
chr5,46139400,46184606,45206,-1,0,,0,0.00000000000000000000
chr5,46255080,46292252,37172,-1,0,,0,0.00000000000000000000
chr5,45860696,45889954,29258,-1,0,,0,0.00000000000000000000
chr5,45949701,45971917,22216,-1,0,,0,0.00000000000000000000
chr5,46248797,46268339,19542,-1,0,,0,0.00000000000000000000
chr5,46165420,46185926,20506,-1,0,,0,0.00000000000000000000
chr5,45929786,45943794,14008,-1,0,,0,0.00000000000000000000
chr5,46269595,46283592,13997,-1,0,,0,0.00000000000000000000
chr5,46270634,46275831,5197,-1,0,,0,0.00000000000000000000
chr5,46246631,46253335,6704,-1,0,,0,0.00000000000000000000
chr5,46214705,46220752,6047,-1,0,,0,0.00000000000000000000
chr5,46141950,46146920,4970,-1,0,,0,0.00000000000000000000
chr5,45964597,45968648,4051,-1,0,,0,0.00000000000000000000
chr5,46271305,46274641,3336,-1,0,,0,0.00000000000000000000
chr5,46195900,46199427,3527,-1,0,,0,0.00000000000000000000
chr5,46081626,46083574,1948,-1,0,,0,0.00000000000000000000
chr5,46271008,46273502,2494,-1,0,,0,0.00000000000000000000
chr5,46273547,46275693,2146,-1,0,,0,0.00000000000000000000
chr5,46144215,46145986,1771,-1,0,,0,0.00000000000000000000
chr5,46398184,46399046,862,-1,0,,0,0.00000000000000000000
chr5,46164033,46164553,520,-1,0,,0,0.00000000000000000000
chr5,49405763,49441191,35428,-1,0,,0,0.00000000000000000000
chr5,49465866,49555428,89562,-1,0,,0,0.00000000000000000000
chr5,49455202,49519433,64231,-1,0,,0,0.00000000000000000000
chr5,49460139,49500007,39868,-1,0,,0,0.00000000000000000000
chr5,49543053,49545463,2410,-1,0,,0,0.00000000000000000000
chr5,49835935,49836017,82,-1,0,,0,0.00000000000000000000
chr5,49940697,49946331,5634,-1,0,,0,0.00000000000000000000
chr5,50234319,50239429,5110,-1,0,,0,0.00000000000000000000
chr5,50234439,50237469,3030,-1,0,,0,0.00000000000000000000
chr5,50884626,50885036,410,-1,0,,0,0.00000000000000000000
chr5,51170164,51170908,744,-1,0,,0,0.00000000000000000000
chr5,51280151,51280671,520,-1,0,,0,0.00000000000000000000
chr5,51466865,51472206,5341,-1,0,,0,0.00000000000000000000
chr5,51577112,51580295,3183,-1,0,,0,0.00000000000000000000
chr5,51810051,51811915,1864,-1,0,,0,0.00000000000000000000
chr5,52231408,52232694,1286,-1,0,3672,1,77.76049766718510000000
chr5,52231695,52232177,482,-1,0,3672,1,207.46887966805000000000
chr5,52231764,52232107,343,-1,0,3672,1,291.54518950437300000000
chr5,52404506,52409866,5360,-1,0,4338,1,18.65671641791040000000
chr5,52458759,52459864,1105,-1,0,,0,0.00000000000000000000
chr5,52458952,52459686,734,-1,0,,0,0.00000000000000000000
chr5,52666661,52684265,17604,-1,0,,0,0.00000000000000000000
chr5,52911418,52918622,7204,-1,0,4724,1,13.88117712382010000000
chr5,53053550,53059587,6037,-1,0,,0,0.00000000000000000000
chr5,53176816,53177413,597,-1,0,,0,0.00000000000000000000
chr5,53176931,53177240,309,-1,0,,0,0.00000000000000000000
chr5,53386743,53388263,1520,-1,0,54622,1,65.78947368421050000000
chr5,53755532,53755619,87,-1,0,,0,0.00000000000000000000
chr5,54081758,54081907,149,-1,0,,0,0.00000000000000000000
chr5,54110550,54121328,10778,-1,0,,0,0.00000000000000000000
chr5,54379135,54394857,15722,-1,0,,0,0.00000000000000000000
chr5,54380332,54386958,6626,-1,0,,0,0.00000000000000000000
chr5,54479386,54479871,485,-1,0,,0,0.00000000000000000000
chr5,54542980,54547281,4301,-1,0,,0,0.00000000000000000000
chr5,54625608,54626431,823,-1,0,23517,1,121.50668286755800000000
chr5,54808314,54808383,69,-1,0,8611,1,1449.27536231884000000000
chr5,54908581,54911036,2455,-1,0,,0,0.00000000000000000000
chr5,55429181,55431307,2126,-1,0,79722,1,47.03668861712140000000
chr5,55429204,55430346,1142,-1,0,79722,1,87.56567425569180000000
chr5,55485604,55493475,7871,-1,0,79722,1,12.70486596366410000000
chr5,55611600,55613152,1552,-1,0,,0,0.00000000000000000000
chr5,55870783,55871084,301,-1,0,101928448,1,332.22591362126200000000
chr5,56110881,56112324,1443,-1,0,4214,1,69.30006930006930000000
chr5,56130990,56131407,417,-1,0,4214,1,239.80815347721800000000
chr5,56131225,56131291,66,-1,0,4214,1,1515.15151515152000000000
chr5,56247092,56248201,1109,-1,0,166968,1,90.17132551848510000000
chr5,56404353,56405589,1236,-1,0,,0,0.00000000000000000000
chr5,56517059,56517193,134,-1,0,65056,1,746.26865671641800000000
chr5,57320304,57338103,17799,-1,0,,0,0.00000000000000000000
chr5,57325054,57340261,15207,-1,0,,0,0.00000000000000000000
chr5,57323382,57333750,10368,-1,0,,0,0.00000000000000000000
chr5,57679811,57686361,6550,-1,0,,0,0.00000000000000000000
chr5,57776869,57779086,2217,-1,0,,0,0.00000000000000000000
chr5,57777483,57778152,669,-1,0,,0,0.00000000000000000000
chr5,57858907,57859322,415,-1,0,,0,0.00000000000000000000
chr5,57859441,57860022,581,-1,0,,0,0.00000000000000000000
chr5,57922948,57923602,654,-1,0,115827,1,152.90519877675800000000
chr5,57923160,57923366,206,-1,0,115827,1,485.43689320388300000000
chr5,57955839,57959516,3677,-1,0,115827,1,27.19608376393800000000
chr5,57956046,57959280,3234,-1,0,115827,1,30.92145949288810000000
chr5,58274031,58274167,136,-1,0,5144,1,735.29411764705900000000
chr5,58277129,58277538,409,-1,0,5144,1,244.49877750611200000000
chr5,58674680,58765519,90839,-1,0,5144,1,1.10084875438963000000
chr5,59142873,59144803,1930,-1,0,5144,1,51.81347150259070000000
chr5,59353276,59359222,5946,-1,0,5144,1,16.81802892700980000000
chr5,59376892,59377610,718,-1,0,5144,1,139.27576601671300000000
chr5,59486514,59500527,14013,-1,0,5144,1,7.13623064297438000000
chr5,59489246,59496774,7528,-1,0,5144,1,13.28374070138150000000
chr5,59488191,59495047,6856,-1,0,5144,1,14.58576429404900000000
chr5,59491086,59495890,4804,-1,0,5144,1,20.81598667776850000000
chr5,59627555,60003460,375905,-1,0,5144;55789,2,0.53204932097205400000
chr5,59948732,59951851,3119,-1,0,55789,1,32.06155819172810000000
chr5,60001472,60003868,2396,-1,0,,0,0.00000000000000000000
chr5,60001818,60003423,1605,-1,0,,0,0.00000000000000000000
chr5,59947779,59949262,1483,-1,0,55789,1,67.43088334457180000000
chr5,60178351,60242361,64010,-1,0,91942;1161,2,3.12451179503203000000
chr5,60207824,60213193,5369,-1,0,1161,1,18.62544235425590000000
chr5,60379388,60380337,949,-1,0,91942,1,105.37407797681800000000
chr5,60400886,60404523,3637,-1,0,91942,1,27.49518834204010000000
chr5,60572742,60577679,4937,-1,0,,0,0.00000000000000000000
chr5,60628932,60638723,9791,-1,0,57688,1,10.21346134204880000000
chr5,60626612,60629646,3034,-1,0,57688,1,32.95978905735000000000
chr5,60881827,60891448,9621,-1,0,,0,0.00000000000000000000
chr5,60962831,60963327,496,-1,0,285668,1,201.61290322580600000000
chr5,61293519,61294070,551,-1,0,,0,0.00000000000000000000
chr5,61293628,61293961,333,-1,0,,0,0.00000000000000000000
chr5,61424571,61471539,46968,-1,0,,0,0.00000000000000000000
chr5,61574799,61576531,1732,-1,0,,0,0.00000000000000000000
chr5,61575524,61576317,793,-1,0,,0,0.00000000000000000000
chr5,61697620,61705803,8183,-1,0,27292,1,12.22045704509350000000
chr5,61747954,61749385,1431,-1,0,51194,1,69.88120195667360000000
chr5,61807560,61810481,2921,-1,0,51194,1,34.23485107839780000000
chr5,61894225,61894537,312,-1,0,51194,1,320.51282051282000000000
chr5,61894235,61894374,139,-1,0,51194,1,719.42446043165500000000
chr5,62895028,62990697,95669,-1,0,,0,0.00000000000000000000
chr5,62508767,62512460,3693,-1,0,,0,0.00000000000000000000
chr5,62150230,62151134,904,-1,0,,0,0.00000000000000000000
chr5,62168520,62169244,724,-1,0,,0,0.00000000000000000000
chr5,62704352,62704869,517,-1,0,,0,0.00000000000000000000
chr5,62687274,62687851,577,-1,0,,0,0.00000000000000000000
chr5,62620657,62621022,365,-1,0,,0,0.00000000000000000000
chr5,62687437,62687708,271,-1,0,,0,0.00000000000000000000
chr5,62704442,62704769,327,-1,0,,0,0.00000000000000000000
chr5,62304702,62304822,120,-1,0,,0,0.00000000000000000000
chr5,62487995,62488045,50,-1,0,,0,0.00000000000000000000
chr5,63118295,63119972,1677,-1,0,,0,0.00000000000000000000
chr5,63695697,63701479,5782,-1,0,,0,0.00000000000000000000
chr5,63698344,63701372,3028,-1,0,,0,0.00000000000000000000
chr5,63699721,63701263,1542,-1,0,,0,0.00000000000000000000
chr5,63732433,63732952,519,-1,0,,0,0.00000000000000000000
chr5,63732622,63732704,82,-1,0,,0,0.00000000000000000000
chr5,63846268,63847527,1259,-1,0,401190,1,79.42811755361400000000
chr5,63863340,63866638,3298,-1,0,401190,1,30.32140691328080000000
chr5,64285940,64286514,574,-1,0,10283,1,174.21602787456400000000
chr5,64286058,64286399,341,-1,0,10283,1,293.25513196480900000000
chr5,64440461,64442183,1722,-1,0,,0,0.00000000000000000000
chr5,64604240,64605031,791,-1,0,11174,1,126.42225031605600000000
chr5,64634369,64640719,6350,-1,0,11174,1,15.74803149606300000000
chr5,65028072,65030373,2301,-1,0,57486,1,43.45936549326380000000
chr5,65129640,65129858,218,-1,0,,0,0.00000000000000000000
chr5,65221310,65222431,1121,-1,0,55914,1,89.20606601248880000000
chr5,65268490,65270354,1864,-1,0,55914,1,53.64806866952790000000
chr5,65345951,65346504,553,-1,0,55914,1,180.83182640144700000000
chr5,65346040,65346374,334,-1,0,55914,1,299.40119760479000000000
chr5,65443655,65444193,538,-1,0,140890,1,185.87360594795500000000
chr5,65613813,65614127,314,-1,0,,0,0.00000000000000000000
chr5,66106340,66132019,25679,-1,0,375449,1,3.89423264145800000000
chr5,66337487,66338088,601,-1,0,375449,1,166.38935108153100000000
chr5,66599424,66601596,2172,-1,0,,0,0.00000000000000000000
chr5,66608570,66612715,4145,-1,0,,0,0.00000000000000000000
chr5,66941628,66943713,2085,-1,0,,0,0.00000000000000000000
chr5,67182910,67184490,1580,-1,0,,0,0.00000000000000000000
chr5,67361071,67362423,1352,-1,0,,0,0.00000000000000000000
chr5,67404910,67406177,1267,-1,0,,0,0.00000000000000000000
chr5,67497316,67498194,878,-1,0,,0,0.00000000000000000000
chr5,68105925,68106127,202,-1,0,,0,0.00000000000000000000
chr5,68105931,68106027,96,-1,0,,0,0.00000000000000000000
chr5,68260924,68261183,259,-1,0,,0,0.00000000000000000000
chr5,68319277,68320951,1674,-1,0,,0,0.00000000000000000000
chr5,68471095,68471149,54,-1,0,891,1,1851.85185185185000000000
chr5,68723984,68724606,622,-1,0,153562,1,160.77170418006400000000
chr5,68847066,70654059,1806993,-1,0,2966;6606;8293;728492;728340;6607;100506658;4671,8,0.44272445991766400000
chr5,69764086,70029313,265227,-1,0,,0,0.00000000000000000000
chr5,68925014,69199523,274509,-1,0,,0,0.00000000000000000000
chr5,69191102,69369757,178655,-1,0,6607;728492,2,1.11947608519213000000
chr5,70291261,70392591,101330,-1,0,2966;4671,2,1.97374913648475000000
chr5,70077048,70175152,98104,-1,0,,0,0.00000000000000000000
chr5,70408525,70516782,108257,-1,0,,0,0.00000000000000000000
chr5,68842951,68922649,79698,-1,0,100506658;728340,2,2.50947326156240000000
chr5,70286037,70368813,82776,-1,0,2966;4671,2,2.41615927321929000000
chr5,69705883,69782895,77012,-1,0,,0,0.00000000000000000000
chr5,68828345,68881492,53147,-1,0,100506658;728340,2,3.76314749656613000000
chr5,69781325,69830085,48760,-1,0,,0,0.00000000000000000000
chr5,70196907,70245182,48275,-1,0,8293;6606,2,4.14293112377007000000
chr5,70351115,70390232,39117,-1,0,2966,1,2.55643326430964000000
chr5,70496965,70534122,37157,-1,0,,0,0.00000000000000000000
chr5,69496526,69533723,37197,-1,0,,0,0.00000000000000000000
chr5,68821588,68854548,32960,-1,0,100506658,1,3.03398058252427000000
chr5,69345182,69374511,29329,-1,0,6607,1,3.40959459920216000000
chr5,68925477,68953957,28480,-1,0,,0,0.00000000000000000000
chr5,70066773,70088489,21716,-1,0,,0,0.00000000000000000000
chr5,68909285,68928099,18814,-1,0,,0,0.00000000000000000000
chr5,70368390,70391629,23239,-1,0,,0,0.00000000000000000000
chr5,69190762,69211860,21098,-1,0,,0,0.00000000000000000000
chr5,68915245,68926892,11647,-1,0,,0,0.00000000000000000000
chr5,70306495,70313226,6731,-1,0,4671,1,14.85663348685190000000
chr5,70306602,70307474,872,-1,0,4671,1,114.67889908256900000000
chr5,70971795,70973782,1987,-1,0,,0,0.00000000000000000000
chr5,71157448,71157957,509,-1,0,,0,0.00000000000000000000
chr5,71157669,71157744,75,-1,0,,0,0.00000000000000000000
chr5,71173055,71173691,636,-1,0,,0,0.00000000000000000000
chr5,71916536,71916871,335,-1,0,,0,0.00000000000000000000
chr5,72183055,72183129,74,-1,0,3842,1,1351.35135135135000000000
chr5,72657376,72662114,4738,-1,0,,0,0.00000000000000000000
chr5,72742000,72744213,2213,-1,0,2297,1,45.18752824220520000000
chr5,72743038,72744551,1513,-1,0,2297,1,66.09385327164570000000
chr5,73129254,73133515,4261,-1,0,64283,1,23.46866932644920000000
chr5,73063000,73064878,1878,-1,0,64283,1,53.24813631522900000000
chr5,73275884,73276022,138,-1,0,,0,0.00000000000000000000
chr5,73071699,73071758,59,-1,0,64283,1,1694.91525423729000000000
chr5,73648894,73649413,519,-1,0,,0,0.00000000000000000000
chr5,73648984,73649310,326,-1,0,,0,0.00000000000000000000
chr5,73979775,73996398,16623,-1,0,3074,1,6.01576129459183000000
chr5,74165930,74167977,2047,-1,0,,0,0.00000000000000000000
chr5,74182251,74187148,4897,-1,0,,0,0.00000000000000000000
chr5,74223028,74223930,902,-1,0,,0,0.00000000000000000000
chr5,74348714,74349569,855,-1,0,,0,0.00000000000000000000
chr5,74759684,74763020,3336,-1,0,10087,1,29.97601918465230000000
chr5,74829983,74837722,7739,-1,0,51426,1,12.92156609381060000000
chr5,75054981,75055425,444,-1,0,,0,0.00000000000000000000
chr5,75082257,75082636,379,-1,0,,0,0.00000000000000000000
chr5,75435672,75435792,120,-1,0,22987,1,833.33333333333300000000
chr5,75665485,75667046,1561,-1,0,,0,0.00000000000000000000
chr5,75995487,75995707,220,-1,0,10788,1,454.54545454545500000000
chr5,76107394,76108626,1232,-1,0,,0,0.00000000000000000000
chr5,76317619,76323215,5596,-1,0,,0,0.00000000000000000000
chr5,76505907,76507256,1349,-1,0,8622,1,74.12898443291330000000
chr5,77002870,77003665,795,-1,0,6902,1,125.78616352201300000000
chr5,77048298,77048732,434,-1,0,6902,1,230.41474654377900000000
chr5,77062211,77062725,514,-1,0,6902,1,194.55252918287900000000
chr5,77062308,77062634,326,-1,0,6902,1,306.74846625766900000000
chr5,77105126,77105650,524,-1,0,,0,0.00000000000000000000
chr5,77105217,77105549,332,-1,0,,0,0.00000000000000000000
chr5,77181522,77182749,1227,-1,0,,0,0.00000000000000000000
chr5,77574157,77574503,346,-1,0,8546,1,289.01734104046200000000
chr5,77687854,77687903,49,-1,0,9522,1,2040.81632653061000000000
chr5,77725503,77726291,788,-1,0,9522,1,126.90355329949200000000
chr5,77725809,77726046,237,-1,0,9522,1,421.94092827004200000000
chr5,77725918,77726097,179,-1,0,9522,1,558.65921787709500000000
chr5,77880803,77881127,324,-1,0,10184,1,308.64197530864200000000
chr5,77888347,77888722,375,-1,0,10184,1,266.66666666666700000000
chr5,77888444,77888575,131,-1,0,10184,1,763.35877862595400000000
chr5,77944002,77945005,1003,-1,0,10184,1,99.70089730807580000000
chr5,77945233,77945838,605,-1,0,,0,0.00000000000000000000
chr5,78109207,78117298,8091,-1,0,411,1,12.35941169200350000000
chr5,78109796,78111867,2071,-1,0,411,1,48.28585224529210000000
chr5,78277590,78278165,575,-1,0,411,1,173.91304347826100000000
chr5,78276665,78277203,538,-1,0,411,1,185.87360594795500000000
chr5,78277726,78278045,319,-1,0,411,1,313.47962382445100000000
chr5,78276765,78277093,328,-1,0,411,1,304.87804878048800000000
chr5,78280505,78281289,784,-1,0,411,1,127.55102040816300000000
chr5,78474153,78478618,4465,-1,0,,0,0.00000000000000000000
chr5,78518029,78518915,886,-1,0,,0,0.00000000000000000000
chr5,78952498,78959990,7492,-1,0,167153,1,13.34757074212490000000
chr5,78876895,78882034,5139,-1,0,,0,0.00000000000000000000
chr5,78925358,78929795,4437,-1,0,167153,1,22.53775073247690000000
chr5,79114455,79114892,437,-1,0,,0,0.00000000000000000000
chr5,79013701,79014009,308,-1,0,202333,1,324.67532467532500000000
chr5,79478140,79483422,5282,-1,0,256987,1,18.93222264293830000000
chr5,79409520,79413830,4310,-1,0,256987,1,23.20185614849190000000
chr5,79556665,79558161,1496,-1,0,,0,0.00000000000000000000
chr5,79557091,79557639,548,-1,0,,0,0.00000000000000000000
chr5,79557188,79557502,314,-1,0,,0,0.00000000000000000000
chr5,79567048,79568018,970,-1,0,,0,0.00000000000000000000
chr5,79652762,79659321,6559,-1,0,,0,0.00000000000000000000
chr5,79666488,79695078,28590,-1,0,,0,0.00000000000000000000
chr5,79878613,79878927,314,-1,0,,0,0.00000000000000000000
chr5,79902094,79904632,2538,-1,0,,0,0.00000000000000000000
chr5,79914504,79914791,287,-1,0,,0,0.00000000000000000000
chr5,79945817,79948668,2851,-1,0,100462981;1719,2,70.15082427218520000000
chr5,79982147,79982674,527,-1,0,4437,1,189.75332068311200000000
chr5,80039271,80039784,513,-1,0,4437,1,194.93177387914200000000
chr5,80039381,80039690,309,-1,0,4437,1,323.62459546925600000000
chr5,80255351,80256937,1586,-1,0,5924,1,63.05170239596470000000
chr5,80530229,80545347,15118,-1,0,1160,1,6.61463156502183000000
chr5,80685493,80686473,980,-1,0,134526,1,102.04081632653100000000
chr5,80751059,80751621,562,-1,0,23635,1,177.93594306049800000000
chr5,80751140,80751473,333,-1,0,23635,1,300.30030030030000000000
chr5,81007662,81008895,1233,-1,0,23635,1,81.10300081103000000000
chr5,81008066,81008531,465,-1,0,23635,1,215.05376344086000000000
chr5,81008164,81008449,285,-1,0,23635,1,350.87719298245600000000
chr5,81182376,81182965,589,-1,0,,0,0.00000000000000000000
chr5,81182488,81182838,350,-1,0,,0,0.00000000000000000000
chr5,81242160,81242665,505,-1,0,,0,0.00000000000000000000
chr5,81265023,81274143,9120,-1,0,83734,1,10.96491228070180000000
chr5,81420538,81433034,12496,-1,0,83734,1,8.00256081946223000000
chr5,81566079,81569472,3393,-1,0,6228,1,29.47244326554670000000
chr5,82005129,82008751,3622,-1,0,,0,0.00000000000000000000
chr5,82063264,82066166,2902,-1,0,,0,0.00000000000000000000
chr5,82063356,82064370,1014,-1,0,,0,0.00000000000000000000
chr5,82155611,82174104,18493,-1,0,,0,0.00000000000000000000
chr5,82156630,82157155,525,-1,0,,0,0.00000000000000000000
chr5,82156725,82157044,319,-1,0,,0,0.00000000000000000000
chr5,82204506,82204685,179,-1,0,,0,0.00000000000000000000
chr5,82421922,82429066,7144,-1,0,7518,1,13.99776035834270000000
chr5,82482699,82483232,533,-1,0,7518,1,187.61726078799300000000
chr5,82482755,82483061,306,-1,0,7518,1,326.79738562091500000000
chr5,82905956,82906492,536,-1,0,,0,0.00000000000000000000
chr5,82906080,82906364,284,-1,0,,0,0.00000000000000000000
chr5,82951136,82957354,6218,-1,0,1404,1,16.08234158893530000000
chr5,83049467,83054979,5512,-1,0,,0,0.00000000000000000000
chr5,83350687,83351272,585,-1,0,10085,1,170.94017094017100000000
chr5,83456426,83456762,336,-1,0,10085,1,297.61904761904800000000
chr5,83589260,83590017,757,-1,0,10085,1,132.10039630118900000000
chr5,83614906,83615363,457,-1,0,10085,1,218.81838074398200000000
chr5,83779319,83913116,133797,-1,0,,0,0.00000000000000000000
chr5,83904599,83907498,2899,-1,0,,0,0.00000000000000000000
chr5,83947914,83955374,7460,-1,0,,0,0.00000000000000000000
chr5,83950786,83954673,3887,-1,0,,0,0.00000000000000000000
chr5,84048823,84099205,50382,-1,0,,0,0.00000000000000000000
chr5,84148443,84203724,55281,-1,0,,0,0.00000000000000000000
chr5,84359996,84362198,2202,-1,0,,0,0.00000000000000000000
chr5,84387477,84409996,22519,-1,0,,0,0.00000000000000000000
chr5,84673263,84679422,6159,-1,0,,0,0.00000000000000000000
chr5,84814481,84814554,73,-1,0,,0,0.00000000000000000000
chr5,84822818,84822888,70,-1,0,,0,0.00000000000000000000
chr5,84903326,84904229,903,-1,0,,0,0.00000000000000000000
chr5,85350027,85350149,122,-1,0,,0,0.00000000000000000000
chr5,85405340,85405510,170,-1,0,,0,0.00000000000000000000
chr5,85462111,85462504,393,-1,0,,0,0.00000000000000000000
chr5,85559860,85564853,4993,-1,0,,0,0.00000000000000000000
chr5,86115638,86121629,5991,-1,0,,0,0.00000000000000000000
chr5,86115365,86118964,3599,-1,0,,0,0.00000000000000000000
chr5,86217001,86217057,56,-1,0,,0,0.00000000000000000000
chr5,86245991,86247125,1134,-1,0,,0,0.00000000000000000000
chr5,86315244,86315323,79,-1,0,,0,0.00000000000000000000
chr5,86355867,86356039,172,-1,0,,0,0.00000000000000000000
chr5,86359208,86363228,4020,-1,0,,0,0.00000000000000000000
chr5,86815103,86816029,926,-1,0,,0,0.00000000000000000000
chr5,86857852,86858239,387,-1,0,,0,0.00000000000000000000
chr5,86858023,86858135,112,-1,0,,0,0.00000000000000000000
chr5,86984932,86987440,2508,-1,0,,0,0.00000000000000000000
chr5,87112053,87113128,1075,-1,0,,0,0.00000000000000000000
chr5,87208650,87209718,1068,-1,0,,0,0.00000000000000000000
chr5,87279127,87291810,12683,-1,0,,0,0.00000000000000000000
chr5,87328487,87328971,484,-1,0,,0,0.00000000000000000000
chr5,87328657,87328813,156,-1,0,,0,0.00000000000000000000
chr5,87378227,87382127,3900,-1,0,,0,0.00000000000000000000
chr5,87379606,87381771,2165,-1,0,,0,0.00000000000000000000
chr5,87668418,87668605,187,-1,0,,0,0.00000000000000000000
chr5,88032000,88032391,391,-1,0,4208,1,255.75447570332500000000
chr5,88043137,88043466,329,-1,0,4208,1,303.95136778115500000000
chr5,88412584,88412793,209,-1,0,,0,0.00000000000000000000
chr5,88572739,88578907,6168,-1,0,,0,0.00000000000000000000
chr5,88606333,88606581,248,-1,0,,0,0.00000000000000000000
chr5,89003715,89004039,324,-1,0,,0,0.00000000000000000000
chr5,89113277,89114892,1615,-1,0,,0,0.00000000000000000000
chr5,89737809,89740390,2581,-1,0,,0,0.00000000000000000000
chr5,89860437,89860840,403,-1,0,84059,1,248.13895781637700000000
chr5,89860453,89860782,329,-1,0,84059,1,303.95136778115500000000
chr5,90498611,90504201,5590,-1,0,,0,0.00000000000000000000
chr5,90497560,90502065,4505,-1,0,,0,0.00000000000000000000
chr5,90499766,90502128,2362,-1,0,,0,0.00000000000000000000
chr5,90574605,90575110,505,-1,0,,0,0.00000000000000000000
chr5,90574692,90574985,293,-1,0,,0,0.00000000000000000000
chr5,90616403,90624344,7941,-1,0,,0,0.00000000000000000000
chr5,90624243,90626159,1916,-1,0,,0,0.00000000000000000000
chr5,90615248,90617034,1786,-1,0,,0,0.00000000000000000000
chr5,91066662,91081189,14527,-1,0,,0,0.00000000000000000000
chr5,91071110,91072389,1279,-1,0,,0,0.00000000000000000000
chr5,91480669,91481231,562,-1,0,,0,0.00000000000000000000
chr5,91480767,91481128,361,-1,0,,0,0.00000000000000000000
chr5,91546050,91548445,2395,-1,0,,0,0.00000000000000000000
chr5,92305437,92305490,53,-1,0,,0,0.00000000000000000000
chr5,92920108,92922140,2032,-1,0,7025,1,49.21259842519690000000
chr5,92919794,92920972,1178,-1,0,7025,1,84.88964346349740000000
chr5,93209040,93209100,60,-1,0,83989,1,1666.66666666667000000000
chr5,93603032,93606324,3292,-1,0,285600,1,30.37667071688940000000
chr5,93902122,93908376,6254,-1,0,285600,1,15.98976654940840000000
chr5,93903758,93906300,2542,-1,0,285600,1,39.33910306845000000000
chr5,93916086,93916881,795,-1,0,285600,1,125.78616352201300000000
chr5,93916268,93916658,390,-1,0,285600,1,256.41025641025600000000
chr5,94109566,94110058,492,-1,0,79772,1,203.25203252032500000000
chr5,94109613,94109943,330,-1,0,79772,1,303.03030303030300000000
chr5,94332572,94333956,1384,-1,0,79772,1,72.25433526011560000000
chr5,94648741,94649186,445,-1,0,,0,0.00000000000000000000
chr5,94956293,94956813,520,-1,0,285601,1,192.30769230769200000000
chr5,95343244,95343748,504,-1,0,,0,0.00000000000000000000
chr5,95343316,95343675,359,-1,0,,0,0.00000000000000000000
chr5,97049197,97112468,63271,-1,0,,0,0.00000000000000000000
chr5,97045384,97093711,48327,-1,0,,0,0.00000000000000000000
chr5,97063485,97098307,34822,-1,0,,0,0.00000000000000000000
chr5,96247538,96257848,10310,-1,0,64167,1,9.69932104752667000000
chr5,97088828,97097705,8877,-1,0,,0,0.00000000000000000000
chr5,97116979,97120387,3408,-1,0,,0,0.00000000000000000000
chr5,97400459,97403848,3389,-1,0,,0,0.00000000000000000000
chr5,95703239,95706425,3186,-1,0,,0,0.00000000000000000000
chr5,96744259,96747187,2928,-1,0,,0,0.00000000000000000000
chr5,97119616,97120938,1322,-1,0,,0,0.00000000000000000000
chr5,97401557,97402759,1202,-1,0,,0,0.00000000000000000000
chr5,95966486,95967333,847,-1,0,,0,0.00000000000000000000
chr5,97119778,97120557,779,-1,0,,0,0.00000000000000000000
chr5,95909621,95910163,542,-1,0,,0,0.00000000000000000000
chr5,96804769,96805488,719,-1,0,,0,0.00000000000000000000
chr5,96617776,96618266,490,-1,0,,0,0.00000000000000000000
chr5,97035244,97035577,333,-1,0,,0,0.00000000000000000000
chr5,95909731,95910077,346,-1,0,,0,0.00000000000000000000
chr5,97413946,97414039,93,-1,0,,0,0.00000000000000000000
chr5,97933118,97939858,6740,-1,0,,0,0.00000000000000000000
chr5,97933043,97935372,2329,-1,0,,0,0.00000000000000000000
chr5,98049770,98052069,2299,-1,0,,0,0.00000000000000000000
chr5,98089926,98098609,8683,-1,0,,0,0.00000000000000000000
chr5,98089684,98095944,6260,-1,0,,0,0.00000000000000000000
chr5,98345116,98347479,2363,-1,0,,0,0.00000000000000000000
chr5,98477532,98478340,808,-1,0,,0,0.00000000000000000000
chr5,98585330,98585836,506,-1,0,,0,0.00000000000000000000
chr5,98689463,98696731,7268,-1,0,,0,0.00000000000000000000
chr5,98714336,98715657,1321,-1,0,,0,0.00000000000000000000
chr5,98743168,98744483,1315,-1,0,,0,0.00000000000000000000
chr5,98760895,98821905,61010,-1,0,,0,0.00000000000000000000
chr5,98764339,98804814,40475,-1,0,,0,0.00000000000000000000
chr5,98809278,98843644,34366,-1,0,,0,0.00000000000000000000
chr5,98836331,98843114,6783,-1,0,,0,0.00000000000000000000
chr5,98840091,98842784,2693,-1,0,,0,0.00000000000000000000
chr5,98854075,98872101,18026,-1,0,,0,0.00000000000000000000
chr5,98858458,98859686,1228,-1,0,,0,0.00000000000000000000
chr5,98868035,98869032,997,-1,0,,0,0.00000000000000000000
chr5,99174191,99174762,571,-1,0,,0,0.00000000000000000000
chr5,99174319,99174647,328,-1,0,,0,0.00000000000000000000
chr5,99161928,99162196,268,-1,0,,0,0.00000000000000000000
chr5,99205702,99206082,380,-1,0,,0,0.00000000000000000000
chr5,99205807,99205947,140,-1,0,,0,0.00000000000000000000
chr5,99405277,99713336,308059,-1,0,,0,0.00000000000000000000
chr5,101238959,101485159,246200,-1,0,,0,0.00000000000000000000
chr5,99623806,99809789,185983,-1,0,,0,0.00000000000000000000
chr5,101331818,101452388,120570,-1,0,,0,0.00000000000000000000
chr5,99322096,99446338,124242,-1,0,,0,0.00000000000000000000
chr5,99432071,99535691,103620,-1,0,,0,0.00000000000000000000
chr5,99619956,99707583,87627,-1,0,,0,0.00000000000000000000
chr5,99747408,99820770,73362,-1,0,,0,0.00000000000000000000
chr5,99234820,99323868,89048,-1,0,,0,0.00000000000000000000
chr5,101013196,101097361,84165,-1,0,,0,0.00000000000000000000
chr5,101194688,101253320,58632,-1,0,,0,0.00000000000000000000
chr5,101160626,101206544,45918,-1,0,,0,0.00000000000000000000
chr5,100774610,100833609,58999,-1,0,,0,0.00000000000000000000
chr5,101473347,101520643,47296,-1,0,,0,0.00000000000000000000
chr5,101231399,101280760,49361,-1,0,,0,0.00000000000000000000
chr5,99753724,99780187,26463,-1,0,,0,0.00000000000000000000
chr5,99542236,99582761,40525,-1,0,,0,0.00000000000000000000
chr5,101173464,101206790,33326,-1,0,,0,0.00000000000000000000
chr5,101530512,101560291,29779,-1,0,,0,0.00000000000000000000
chr5,99653622,99685611,31989,-1,0,,0,0.00000000000000000000
chr5,99253062,99270914,17852,-1,0,,0,0.00000000000000000000
chr5,99711617,99730182,18565,-1,0,,0,0.00000000000000000000
chr5,99396319,99408368,12049,-1,0,,0,0.00000000000000000000
chr5,99380968,99391857,10889,-1,0,,0,0.00000000000000000000
chr5,100058000,100069625,11625,-1,0,,0,0.00000000000000000000
chr5,99513810,99520375,6565,-1,0,,0,0.00000000000000000000
chr5,100954089,100960065,5976,-1,0,,0,0.00000000000000000000
chr5,101356953,101361675,4722,-1,0,,0,0.00000000000000000000
chr5,99843338,99846819,3481,-1,0,,0,0.00000000000000000000
chr5,99725708,99728274,2566,-1,0,,0,0.00000000000000000000
chr5,99854595,99855988,1393,-1,0,,0,0.00000000000000000000
chr5,101277994,101279149,1155,-1,0,,0,0.00000000000000000000
chr5,99608065,99608575,510,-1,0,,0,0.00000000000000000000
chr5,99759353,99759885,532,-1,0,,0,0.00000000000000000000
chr5,99923413,99923964,551,-1,0,,0,0.00000000000000000000
chr5,100983850,100984297,447,-1,0,,0,0.00000000000000000000
chr5,99757278,99757676,398,-1,0,,0,0.00000000000000000000
chr5,99759470,99759798,328,-1,0,,0,0.00000000000000000000
chr5,99608146,99608458,312,-1,0,,0,0.00000000000000000000
chr5,99923534,99923844,310,-1,0,,0,0.00000000000000000000
chr5,100422741,100422940,199,-1,0,,0,0.00000000000000000000
chr5,100984042,100984098,56,-1,0,,0,0.00000000000000000000
chr5,101606910,101608239,1329,-1,0,353189,1,75.24454477050410000000
chr5,101638381,101733177,94796,-1,0,133482,1,1.05489683108992000000
chr5,101693795,101694723,928,-1,0,,0,0.00000000000000000000
chr5,101796440,101796830,390,-1,0,133482,1,256.41025641025600000000
chr5,101796595,101796653,58,-1,0,133482,1,1724.13793103448000000000
chr5,102048596,102048655,59,-1,0,,0,0.00000000000000000000
chr5,102163276,102163705,429,-1,0,5066,1,233.10023310023300000000
chr5,102163343,102163621,278,-1,0,5066,1,359.71223021582700000000
chr5,102967699,102982107,14408,-1,0,,0,0.00000000000000000000
chr5,103062515,103073270,10755,-1,0,,0,0.00000000000000000000
chr5,103030441,103031055,614,-1,0,,0,0.00000000000000000000
chr5,103062249,103062726,477,-1,0,,0,0.00000000000000000000
chr5,103030562,103030896,334,-1,0,,0,0.00000000000000000000
chr5,103062311,103062626,315,-1,0,,0,0.00000000000000000000
chr5,103441067,103453798,12731,-1,0,,0,0.00000000000000000000
chr5,103508263,103535333,27070,-1,0,,0,0.00000000000000000000
chr5,103788551,104848654,1060103,-1,0,,0,0.00000000000000000000
chr5,104364002,104574380,210378,-1,0,,0,0.00000000000000000000
chr5,104199459,104341036,141577,-1,0,,0,0.00000000000000000000
chr5,104433581,104576696,143115,-1,0,,0,0.00000000000000000000
chr5,103707633,103782211,74578,-1,0,,0,0.00000000000000000000
chr5,104646207,104730581,84374,-1,0,,0,0.00000000000000000000
chr5,104429028,104505826,76798,-1,0,,0,0.00000000000000000000
chr5,104328608,104397562,68954,-1,0,,0,0.00000000000000000000
chr5,104302514,104372790,70276,-1,0,,0,0.00000000000000000000
chr5,104479475,104533337,53862,-1,0,,0,0.00000000000000000000
chr5,104214749,104253288,38539,-1,0,,0,0.00000000000000000000
chr5,104171791,104210111,38320,-1,0,,0,0.00000000000000000000
chr5,104567404,104601356,33952,-1,0,,0,0.00000000000000000000
chr5,104271877,104300142,28265,-1,0,,0,0.00000000000000000000
chr5,104311039,104336202,25163,-1,0,,0,0.00000000000000000000
chr5,104509854,104530475,20621,-1,0,,0,0.00000000000000000000
chr5,104480254,104497563,17309,-1,0,,0,0.00000000000000000000
chr5,103853413,103860549,7136,-1,0,,0,0.00000000000000000000
chr5,104848917,104855010,6093,-1,0,,0,0.00000000000000000000
chr5,104350570,104356377,5807,-1,0,,0,0.00000000000000000000
chr5,103761340,103766666,5326,-1,0,,0,0.00000000000000000000
chr5,103781475,103785002,3527,-1,0,,0,0.00000000000000000000
chr5,104590833,104591408,575,-1,0,,0,0.00000000000000000000
chr5,104590953,104591281,328,-1,0,,0,0.00000000000000000000
chr5,104876922,104877218,296,-1,0,,0,0.00000000000000000000
chr5,104877046,104877138,92,-1,0,,0,0.00000000000000000000
chr5,104966908,104967262,354,-1,0,,0,0.00000000000000000000
chr5,105003738,105007708,3970,-1,0,,0,0.00000000000000000000
chr5,105499030,105501251,2221,-1,0,,0,0.00000000000000000000
chr5,105563422,105566701,3279,-1,0,,0,0.00000000000000000000
chr5,105627721,105670353,42632,-1,0,,0,0.00000000000000000000
chr5,106020504,106241273,220769,-1,0,,0,0.00000000000000000000
chr5,106156995,106201122,44127,-1,0,,0,0.00000000000000000000
chr5,106226528,106260590,34062,-1,0,,0,0.00000000000000000000
chr5,106226903,106240802,13899,-1,0,,0,0.00000000000000000000
chr5,106222376,106233155,10779,-1,0,,0,0.00000000000000000000
chr5,106228066,106234230,6164,-1,0,,0,0.00000000000000000000
chr5,106236882,106239672,2790,-1,0,,0,0.00000000000000000000
chr5,105894354,105896039,1685,-1,0,,0,0.00000000000000000000
chr5,106231910,106231968,58,-1,0,,0,0.00000000000000000000
chr5,107353897,107446819,92922,-1,0,64839,1,1.07617141258260000000
chr5,107362487,107373318,10831,-1,0,64839,1,9.23275782476226000000
chr5,106324751,106326436,1685,-1,0,,0,0.00000000000000000000
chr5,107547777,107549642,1865,-1,0,64839,1,53.61930294906170000000
chr5,107198488,107199340,852,-1,0,64839,1,117.37089201877900000000
chr5,106533360,106534252,892,-1,0,,0,0.00000000000000000000
chr5,107198474,107199258,784,-1,0,64839,1,127.55102040816300000000
chr5,106396222,106396756,534,-1,0,,0,0.00000000000000000000
chr5,106970168,106970550,382,-1,0,1946,1,261.78010471204200000000
chr5,106892794,106893252,458,-1,0,1946,1,218.34061135371200000000
chr5,106741631,106741757,126,-1,0,1946,1,793.65079365079400000000
chr5,107045564,107045706,142,-1,0,,0,0.00000000000000000000
chr5,108305143,108306195,1052,-1,0,2241,1,95.05703422053230000000
chr5,108594850,108601306,6456,-1,0,,0,0.00000000000000000000
chr5,108603650,108608236,4586,-1,0,,0,0.00000000000000000000
chr5,108617628,108619574,1946,-1,0,,0,0.00000000000000000000
chr5,108758413,108758474,61,-1,0,,0,0.00000000000000000000
chr5,109271224,109327168,55944,-1,0,,0,0.00000000000000000000
chr5,109360386,109382866,22480,-1,0,,0,0.00000000000000000000
chr5,109297078,109297457,379,-1,0,,0,0.00000000000000000000
chr5,109459917,109478777,18860,-1,0,,0,0.00000000000000000000
chr5,109563690,109573932,10242,-1,0,,0,0.00000000000000000000
chr5,109460576,109467308,6732,-1,0,,0,0.00000000000000000000
chr5,109833391,109834480,1089,-1,0,642987,1,91.82736455463730000000
chr5,110415464,110450342,34878,-1,0,134430,1,2.86713687711451000000
chr5,110375626,110382620,6994,-1,0,,0,0.00000000000000000000
chr5,110694919,110695353,434,-1,0,814,1,230.41474654377900000000
chr5,110855356,110855739,383,-1,0,,0,0.00000000000000000000
chr5,110903792,110913753,9961,-1,0,,0,0.00000000000000000000
chr5,110905931,110911040,5109,-1,0,,0,0.00000000000000000000
chr5,110909150,110910826,1676,-1,0,,0,0.00000000000000000000
chr5,111339389,111348976,9587,-1,0,,0,0.00000000000000000000
chr5,111373504,111444044,70540,-1,0,,0,0.00000000000000000000
chr5,111355104,111372372,17268,-1,0,,0,0.00000000000000000000
chr5,111626250,111683947,57697,-1,0,64097,1,1.73319236702082000000
chr5,111779552,111794260,14708,-1,0,,0,0.00000000000000000000
chr5,111779710,111786785,7075,-1,0,,0,0.00000000000000000000
chr5,111939560,111944419,4859,-1,0,,0,0.00000000000000000000
chr5,112224228,112226890,2662,-1,0,7905;6728,2,75.13148009015780000000
chr5,112263338,112281376,18038,-1,0,,0,0.00000000000000000000
chr5,112380631,112443861,63230,-1,0,4163,1,1.58152775581211000000
chr5,112472131,112475671,3540,-1,0,4163,1,28.24858757062150000000
chr5,112477795,112478379,584,-1,0,4163,1,171.23287671232900000000
chr5,112666834,112672319,5485,-1,0,4163,1,18.23154056517780000000
chr5,112881308,112881874,566,-1,0,64848,1,176.67844522968200000000
chr5,112881401,112881733,332,-1,0,64848,1,301.20481927710800000000
chr5,112937766,112952780,15014,-1,0,,0,0.00000000000000000000
chr5,112959040,112988483,29443,-1,0,,0,0.00000000000000000000
chr5,113078457,113189063,110606,-1,0,,0,0.00000000000000000000
chr5,113156431,113172847,16416,-1,0,,0,0.00000000000000000000
chr5,113326430,113336784,10354,-1,0,,0,0.00000000000000000000
chr5,113379461,113380564,1103,-1,0,,0,0.00000000000000000000
chr5,113475455,113516437,40982,-1,0,,0,0.00000000000000000000
chr5,113459019,113459384,365,-1,0,,0,0.00000000000000000000
chr5,113566249,113568867,2618,-1,0,,0,0.00000000000000000000
chr5,113598883,113599354,471,-1,0,,0,0.00000000000000000000
chr5,113607892,113608273,381,-1,0,,0,0.00000000000000000000
chr5,113938149,114010951,72802,-1,0,,0,0.00000000000000000000
chr5,114012275,114017684,5409,-1,0,,0,0.00000000000000000000
chr5,113978671,113978866,195,-1,0,,0,0.00000000000000000000
chr5,114117381,114143429,26048,-1,0,,0,0.00000000000000000000
chr5,114207548,114216553,9005,-1,0,,0,0.00000000000000000000
chr5,114207724,114210899,3175,-1,0,,0,0.00000000000000000000
chr5,114254974,114262088,7114,-1,0,,0,0.00000000000000000000
chr5,114256593,114260255,3662,-1,0,,0,0.00000000000000000000
chr5,114258495,114261004,2509,-1,0,,0,0.00000000000000000000
chr5,114324928,114335748,10820,-1,0,,0,0.00000000000000000000
chr5,114403249,114409351,6102,-1,0,,0,0.00000000000000000000
chr5,114393573,114393965,392,-1,0,,0,0.00000000000000000000
chr5,114706235,114721106,14871,-1,0,,0,0.00000000000000000000
chr5,114731283,114731665,382,-1,0,,0,0.00000000000000000000
chr5,114756269,114758140,1871,-1,0,,0,0.00000000000000000000
chr5,114756487,114757895,1408,-1,0,,0,0.00000000000000000000
chr5,114880854,114882684,1830,-1,0,,0,0.00000000000000000000
chr5,114969365,114969916,551,-1,0,,0,0.00000000000000000000
chr5,114990578,114990651,73,-1,0,,0,0.00000000000000000000
chr5,115130393,115130890,497,-1,0,,0,0.00000000000000000000
chr5,115130458,115130794,336,-1,0,,0,0.00000000000000000000
chr5,115238715,115249230,10515,-1,0,1176,1,9.51022349025202000000
chr5,115303191,115305013,1822,-1,0,206338,1,54.88474204171240000000
chr5,115414541,115636855,222314,-1,0,51397,1,0.44981422672436300000
chr5,115560733,115607214,46481,-1,0,51397,1,2.15141670790215000000
chr5,115622228,115672928,50700,-1,0,51397,1,1.97238658777120000000
chr5,115585018,115621806,36788,-1,0,51397,1,2.71827769924976000000
chr5,115517176,115539731,22555,-1,0,51397,1,4.43360673908224000000
chr5,115505183,115508666,3483,-1,0,51397,1,28.71088142405970000000
chr5,115455195,115456929,1734,-1,0,51397,1,57.67012687427910000000
chr5,115465099,115465358,259,-1,0,51397,1,386.10038610038600000000
chr5,115465180,115465443,263,-1,0,51397,1,380.22813688212900000000
chr5,115894056,115894575,519,-1,0,57556,1,192.67822736030800000000
chr5,115894120,115894445,325,-1,0,57556,1,307.69230769230800000000
chr5,116213258,116229307,16049,-1,0,,0,0.00000000000000000000
chr5,116179198,116185276,6078,-1,0,,0,0.00000000000000000000
chr5,116185734,116188338,2604,-1,0,,0,0.00000000000000000000
chr5,116254193,116254695,502,-1,0,,0,0.00000000000000000000
chr5,116254295,116254616,321,-1,0,,0,0.00000000000000000000
chr5,116254332,116254420,88,-1,0,,0,0.00000000000000000000
chr5,116222073,116222134,61,-1,0,,0,0.00000000000000000000
chr5,116382509,116387779,5270,-1,0,,0,0.00000000000000000000
chr5,116428101,116428534,433,-1,0,,0,0.00000000000000000000
chr5,116428166,116428498,332,-1,0,,0,0.00000000000000000000
chr5,116694455,116694858,403,-1,0,,0,0.00000000000000000000
chr5,116836077,116836394,317,-1,0,,0,0.00000000000000000000
chr5,116845503,116857085,11582,-1,0,,0,0.00000000000000000000
chr5,116878753,116882882,4129,-1,0,,0,0.00000000000000000000
chr5,117864355,117997857,133502,-1,0,,0,0.00000000000000000000
chr5,117643335,117780062,136727,-1,0,,0,0.00000000000000000000
chr5,117766734,117883090,116356,-1,0,,0,0.00000000000000000000
chr5,117005036,117060535,55499,-1,0,,0,0.00000000000000000000
chr5,117812276,117860759,48483,-1,0,,0,0.00000000000000000000
chr5,117967517,118002524,35007,-1,0,,0,0.00000000000000000000
chr5,117868237,117878164,9927,-1,0,,0,0.00000000000000000000
chr5,117803408,117813038,9630,-1,0,,0,0.00000000000000000000
chr5,117387158,117394223,7065,-1,0,,0,0.00000000000000000000
chr5,117874848,117880424,5576,-1,0,,0,0.00000000000000000000
chr5,117877436,117878351,915,-1,0,,0,0.00000000000000000000
chr5,117448912,117449387,475,-1,0,,0,0.00000000000000000000
chr5,117877703,117878190,487,-1,0,,0,0.00000000000000000000
chr5,117868219,117868530,311,-1,0,,0,0.00000000000000000000
chr5,117876795,117876924,129,-1,0,,0,0.00000000000000000000
chr5,117449108,117449199,91,-1,0,,0,0.00000000000000000000
chr5,118250936,118254336,3400,-1,0,285605,1,29.41176470588240000000
chr5,118773559,118774043,484,-1,0,,0,0.00000000000000000000
chr5,118925340,118932279,6939,-1,0,,0,0.00000000000000000000
chr5,118923526,118927740,4214,-1,0,,0,0.00000000000000000000
chr5,118937020,118938761,1741,-1,0,,0,0.00000000000000000000
chr5,118956103,118961869,5766,-1,0,,0,0.00000000000000000000
chr5,119006272,119020396,14124,-1,0,,0,0.00000000000000000000
chr5,119015040,119015569,529,-1,0,,0,0.00000000000000000000
chr5,119015144,119015472,328,-1,0,,0,0.00000000000000000000
chr5,119038075,119041695,3620,-1,0,,0,0.00000000000000000000
chr5,120286345,120460386,174041,-1,0,,0,0.00000000000000000000
chr5,120195175,120315692,120517,-1,0,,0,0.00000000000000000000
chr5,120586168,120692863,106695,-1,0,,0,0.00000000000000000000
chr5,120084360,120155064,70704,-1,0,,0,0.00000000000000000000
chr5,120664697,120745932,81235,-1,0,,0,0.00000000000000000000
chr5,120187171,120247410,60239,-1,0,,0,0.00000000000000000000
chr5,120418832,120468256,49424,-1,0,,0,0.00000000000000000000
chr5,120369117,120425362,56245,-1,0,,0,0.00000000000000000000
chr5,120678559,120708893,30334,-1,0,,0,0.00000000000000000000
chr5,120191667,120214032,22365,-1,0,,0,0.00000000000000000000
chr5,119377429,119386186,8757,-1,0,,0,0.00000000000000000000
chr5,119439578,119448278,8700,-1,0,,0,0.00000000000000000000
chr5,119379916,119382748,2832,-1,0,,0,0.00000000000000000000
chr5,120649376,120652360,2984,-1,0,,0,0.00000000000000000000
chr5,119710869,119714965,4096,-1,0,,0,0.00000000000000000000
chr5,119924328,119927898,3570,-1,0,51334,1,28.01120448179270000000
chr5,119380316,119382703,2387,-1,0,,0,0.00000000000000000000
chr5,120595554,120596493,939,-1,0,,0,0.00000000000000000000
chr5,119407342,119408212,870,-1,0,,0,0.00000000000000000000
chr5,119910221,119910848,627,-1,0,51334,1,159.48963317384400000000
chr5,119969229,119969706,477,-1,0,51334,1,209.64360587002100000000
chr5,120313010,120313364,354,-1,0,,0,0.00000000000000000000
chr5,120330447,120330719,272,-1,0,,0,0.00000000000000000000
chr5,119969450,119969521,71,-1,0,51334,1,1408.45070422535000000000
chr5,121012920,121015472,2552,-1,0,,0,0.00000000000000000000
chr5,121041067,121041288,221,-1,0,,0,0.00000000000000000000
chr5,121058894,121060623,1729,-1,0,,0,0.00000000000000000000
chr5,121059231,121060007,776,-1,0,,0,0.00000000000000000000
chr5,121094824,121095367,543,-1,0,,0,0.00000000000000000000
chr5,121095003,121095103,100,-1,0,,0,0.00000000000000000000
chr5,121129445,121137548,8103,-1,0,,0,0.00000000000000000000
chr5,121132603,121135954,3351,-1,0,,0,0.00000000000000000000
chr5,121259862,121260367,505,-1,0,,0,0.00000000000000000000
chr5,121259928,121260311,383,-1,0,,0,0.00000000000000000000
chr5,121260039,121260121,82,-1,0,,0,0.00000000000000000000
chr5,121342397,121343481,1084,-1,0,153443,1,92.25092250922510000000
chr5,121426748,121427493,745,-1,0,,0,0.00000000000000000000
chr5,121575894,121581133,5239,-1,0,,0,0.00000000000000000000
chr5,121834196,121834507,311,-1,0,,0,0.00000000000000000000
chr5,121924251,121927455,3204,-1,0,,0,0.00000000000000000000
chr5,122274223,122274837,614,-1,0,28966,1,162.86644951140100000000
chr5,122274346,122274675,329,-1,0,28966,1,303.95136778115500000000
chr5,122723529,122723959,430,-1,0,153241,1,232.55813953488400000000
chr5,122723710,122723773,63,-1,0,153241,1,1587.30158730159000000000
chr5,122808491,122822014,13523,-1,0,,0,0.00000000000000000000
chr5,123062438,123064380,1942,-1,0,,0,0.00000000000000000000
chr5,123134764,123140893,6129,-1,0,,0,0.00000000000000000000
chr5,123315149,123343862,28713,-1,0,,0,0.00000000000000000000
chr5,123538601,123546314,7713,-1,0,,0,0.00000000000000000000
chr5,123675077,123675184,107,-1,0,,0,0.00000000000000000000
chr5,124167852,124177015,9163,-1,0,,0,0.00000000000000000000
chr5,124627035,124628134,1099,-1,0,,0,0.00000000000000000000
chr5,124484158,124484618,460,-1,0,,0,0.00000000000000000000
chr5,124363720,124364288,568,-1,0,,0,0.00000000000000000000
chr5,124717248,124717790,542,-1,0,,0,0.00000000000000000000
chr5,124717351,124717685,334,-1,0,,0,0.00000000000000000000
chr5,124363835,124364161,326,-1,0,,0,0.00000000000000000000
chr5,124484391,124484443,52,-1,0,,0,0.00000000000000000000
chr5,124946743,124946999,256,-1,0,,0,0.00000000000000000000
chr5,125139126,125165800,26674,-1,0,,0,0.00000000000000000000
chr5,125156977,125176457,19480,-1,0,,0,0.00000000000000000000
chr5,125138688,125141376,2688,-1,0,,0,0.00000000000000000000
chr5,125153243,125154712,1469,-1,0,,0,0.00000000000000000000
chr5,125412790,125417290,4500,-1,0,,0,0.00000000000000000000
chr5,125496693,125498752,2059,-1,0,,0,0.00000000000000000000
chr5,125841098,125841381,283,-1,0,,0,0.00000000000000000000
chr5,125861115,125861472,357,-1,0,,0,0.00000000000000000000
chr5,125886143,125886359,216,-1,0,501,1,462.96296296296300000000
chr5,125997381,126050652,53271,-1,0,,0,0.00000000000000000000
chr5,126081861,126083532,1671,-1,0,,0,0.00000000000000000000
chr5,126125993,126127671,1678,-1,0,4001,1,59.59475566150180000000
chr5,126180012,126180289,277,-1,0,,0,0.00000000000000000000
chr5,126195220,126201861,6641,-1,0,,0,0.00000000000000000000
chr5,126230199,126241526,11327,-1,0,115123,1,8.82846296459786000000
chr5,126370045,126370696,651,-1,0,,0,0.00000000000000000000
chr5,126458367,126458811,444,-1,0,,0,0.00000000000000000000
chr5,126582882,126583309,427,-1,0,,0,0.00000000000000000000
chr5,126583081,126583159,78,-1,0,,0,0.00000000000000000000
chr5,126942318,126942684,366,-1,0,,0,0.00000000000000000000
chr5,127172064,127173522,1458,-1,0,728586,1,68.58710562414270000000
chr5,127172318,127173286,968,-1,0,728586,1,103.30578512396700000000
chr5,127335450,127337770,2320,-1,0,,0,0.00000000000000000000
chr5,127335935,127336913,978,-1,0,,0,0.00000000000000000000
chr5,127407193,127411156,3963,-1,0,,0,0.00000000000000000000
chr5,127408045,127410373,2328,-1,0,,0,0.00000000000000000000
chr5,127409375,127410767,1392,-1,0,,0,0.00000000000000000000
chr5,127745955,127874517,128562,-1,0,2201,1,0.77783481899783800000
chr5,127776685,127778348,1663,-1,0,2201,1,60.13229104028860000000
chr5,127954544,127957191,2647,-1,0,,0,0.00000000000000000000
chr5,128059748,128060560,812,-1,0,,0,0.00000000000000000000
chr5,128327593,128328154,561,-1,0,28965,1,178.25311942959000000000
chr5,128327694,128328080,386,-1,0,28965,1,259.06735751295300000000
chr5,128327876,128327995,119,-1,0,28965,1,840.33613445378100000000
chr5,128327792,128327877,85,-1,0,28965,1,1176.47058823529000000000
chr5,128378680,128378992,312,-1,0,,0,0.00000000000000000000
chr5,128488357,128698358,210001,-1,0,,0,0.00000000000000000000
chr5,128665007,128747208,82201,-1,0,,0,0.00000000000000000000
chr5,128524449,128525037,588,-1,0,,0,0.00000000000000000000
chr5,128743611,128743683,72,-1,0,,0,0.00000000000000000000
chr5,128881302,128884141,2839,-1,0,171019,1,35.22367030644590000000
chr5,128882171,128883153,982,-1,0,171019,1,101.83299389002000000000
chr5,128924411,128926513,2102,-1,0,171019,1,47.57373929590870000000
chr5,128926875,128930034,3159,-1,0,171019,1,31.65558721114280000000
chr5,129309778,129324112,14334,-1,0,337876,1,6.97641970140924000000
chr5,129383456,129383895,439,-1,0,337876,1,227.79043280182200000000
chr5,129613884,129618218,4334,-1,0,,0,0.00000000000000000000
chr5,129729022,129729181,159,-1,0,,0,0.00000000000000000000
chr5,130449449,130454048,4599,-1,0,,0,0.00000000000000000000
chr5,130489652,130490192,540,-1,0,,0,0.00000000000000000000
chr5,130583781,130584974,1193,-1,0,,0,0.00000000000000000000
chr5,131174215,131237599,63384,-1,0,728637,1,1.57768522024486000000
chr5,131236166,131242561,6395,-1,0,728637,1,15.63721657544960000000
chr5,130804130,130804420,290,-1,0,51735,1,344.82758620689700000000
chr5,130804190,130804318,128,-1,0,51735,1,781.25000000000000000000
chr5,132007923,132008298,375,-1,0,,0,0.00000000000000000000
chr5,132016178,132016580,402,-1,0,3565,1,248.75621890547300000000
chr5,132379873,132382616,2743,-1,0,,0,0.00000000000000000000
chr5,132874857,132875614,757,-1,0,23105,1,132.10039630118900000000
chr5,132921276,132933770,12494,-1,0,23105,1,8.00384184408516000000
chr5,132918693,132925197,6504,-1,0,23105,1,15.37515375153750000000
chr5,133032012,133048707,16695,-1,0,,0,0.00000000000000000000
chr5,133134134,133137606,3472,-1,0,,0,0.00000000000000000000
chr5,133134679,133136485,1806,-1,0,,0,0.00000000000000000000
chr5,133237715,133239134,1419,-1,0,,0,0.00000000000000000000
chr5,133395442,133398675,3233,-1,0,,0,0.00000000000000000000
chr5,133462718,133463826,1108,-1,0,6932,1,90.25270758122740000000
chr5,133954851,133955845,994,-1,0,51128,1,100.60362173038200000000
chr5,134259210,134264030,4820,-1,0,84105,1,20.74688796680500000000
chr5,134651029,134652917,1888,-1,0,100996485,1,52.96610169491530000000
chr5,134952606,134953812,1206,-1,0,,0,0.00000000000000000000
chr5,135098864,135144278,45414,-1,0,,0,0.00000000000000000000
chr5,135115144,135120705,5561,-1,0,,0,0.00000000000000000000
chr5,135126451,135133280,6829,-1,0,,0,0.00000000000000000000
chr5,135282181,135294805,12624,-1,0,3950,1,7.92141951837769000000
chr5,135302158,135334939,32781,-1,0,,0,0.00000000000000000000
chr5,135344591,135346295,1704,-1,0,,0,0.00000000000000000000
chr5,135621845,135625410,3565,-1,0,57113,1,28.05049088359050000000
chr5,135666696,135667669,973,-1,0,57113,1,102.77492291880800000000
chr5,135876759,135880785,4026,-1,0,,0,0.00000000000000000000
chr5,136321125,136323492,2367,-1,0,6695,1,42.24757076468100000000
chr5,136851112,136857393,6281,-1,0,,0,0.00000000000000000000
chr5,136854554,136856558,2004,-1,0,,0,0.00000000000000000000
chr5,136852438,136852985,547,-1,0,,0,0.00000000000000000000
chr5,137004496,137005148,652,-1,0,26249,1,153.37423312883400000000
chr5,137022352,137024044,1692,-1,0,26249,1,59.10165484633570000000
chr5,137022589,137023875,1286,-1,0,26249,1,77.76049766718510000000
chr5,137122866,137134105,11239,-1,0,,0,0.00000000000000000000
chr5,137181300,137188003,6703,-1,0,,0,0.00000000000000000000
chr5,137479294,137479368,74,-1,0,10902,1,1351.35135135135000000000
chr5,137532497,137533409,912,-1,0,8697,1,109.64912280701800000000
chr5,137607290,137607727,437,-1,0,2676,1,228.83295194508000000000
chr5,137806935,137816996,10061,-1,0,,0,0.00000000000000000000
chr5,137810014,137816239,6225,-1,0,,0,0.00000000000000000000
chr5,137873444,137874049,605,-1,0,2107,1,165.28925619834700000000
chr5,138065545,138076779,11234,-1,0,,0,0.00000000000000000000
chr5,138108512,138108593,81,-1,0,1495,1,1234.56790123457000000000
chr5,138231288,138233154,1866,-1,0,1495,1,53.59056806002140000000
chr5,138366063,138372991,6928,-1,0,64374,1,14.43418013856810000000
chr5,138658634,138661592,2958,-1,0,9782,1,33.80662609871530000000
chr5,138734392,138734853,461,-1,0,202051,1,216.91973969631200000000
chr5,138734450,138734744,294,-1,0,202051,1,340.13605442176900000000
chr5,138927238,138933502,6264,-1,0,,0,0.00000000000000000000
chr5,139367513,139369505,1992,-1,0,9542,1,50.20080321285140000000
chr5,139703459,139703852,393,-1,0,,0,0.00000000000000000000
chr5,139752752,139757353,4601,-1,0,83697,1,21.73440556400780000000
chr5,140004143,140006221,2078,-1,0,,0,0.00000000000000000000
chr5,140094880,140106584,11704,-1,0,,0,0.00000000000000000000
chr5,140087934,140096536,8602,-1,0,,0,0.00000000000000000000
chr5,140096767,140104053,7286,-1,0,,0,0.00000000000000000000
chr5,140141351,140141713,362,-1,0,,0,0.00000000000000000000
chr5,140219535,140244942,25407,-1,0,56142;56145;56140;56147;56139;56144;56141;56146;9752;56143,10,39.35923170779710000000
chr5,140222242,140239243,17001,-1,0,56142;56145;56140;56147;56139;56144;56141;56146;9752;56143,10,58.82006940768190000000
chr5,140218429,140231682,13253,-1,0,56142;56145;56140;56147;56144;56141;56146;9752;56143,9,67.90915264468420000000
chr5,140229790,140235882,6092,-1,0,56142;56145;56140;56147;56139;56144;56141;56146;9752;56143,10,164.14970453053200000000
chr5,140223385,140230302,6917,-1,0,56142;56145;56140;56147;56144;56141;56146;9752;56143,9,130.11421136330800000000
chr5,140215713,140222054,6341,-1,0,56142;56145;56140;56147;56144;56141;56146;56143,8,126.16306576249800000000
chr5,140490449,140520440,29991,-1,0,26167;56131,2,6.66866726684672000000
chr5,140476779,140482095,5316,-1,0,56133;56132,2,37.62227238525210000000
chr5,140531398,140536786,5388,-1,0,56130,1,18.55976243504080000000
chr5,140550459,140609314,58855,-1,0,56126;57717;56124;56129;56127;56125;56128;56122;56123,9,15.29181887690090000000
chr5,140558024,140594154,36130,-1,0,57717;56126;56128;56124;56127;56125;56123,7,19.37448104068640000000
chr5,140552088,140558156,6068,-1,0,56129;56128,2,32.95978905735000000000
chr5,140568772,140573581,4809,-1,0,56127;56126,2,41.58868787689750000000
chr5,140554408,140558942,4534,-1,0,56129;56128,2,44.11116012351120000000
chr5,140717472,140727718,10246,-1,0,56114;56113;56112,3,29.27971891469840000000
chr5,140769046,140777511,8465,-1,0,56113;56103;56112;9708;56102;56111;8641;56108;56104;56109;56114;56110,12,141.76018901358500000000
chr5,141053512,141057059,3547,-1,0,64411,1,28.19283901888920000000
chr5,141070646,141070834,188,-1,0,,0,0.00000000000000000000
chr5,141158313,141159750,1437,-1,0,,0,0.00000000000000000000
chr5,141438195,141440056,1861,-1,0,,0,0.00000000000000000000
chr5,141459199,141459508,309,-1,0,,0,0.00000000000000000000
chr5,141753400,141756386,2986,-1,0,,0,0.00000000000000000000
chr5,141995795,141999180,3385,-1,0,2246,1,29.54209748892170000000
chr5,142015575,142021264,5689,-1,0,2246,1,17.57778168395150000000
chr5,142016223,142021495,5272,-1,0,2246,1,18.96813353566010000000
chr5,142017896,142020013,2117,-1,0,2246,1,47.23665564478030000000
chr5,142263109,142447062,183953,-1,0,23092,1,0.54361711959033000000
chr5,142270499,142272277,1778,-1,0,23092,1,56.24296962879640000000
chr5,142618531,142619858,1327,-1,0,,0,0.00000000000000000000
chr5,142664289,142664898,609,-1,0,2908,1,164.20361247947500000000
chr5,142664502,142664645,143,-1,0,2908,1,699.30069930069900000000
chr5,142664647,142664712,65,-1,0,2908,1,1538.46153846154000000000
chr5,142861175,142866081,4906,-1,0,,0,0.00000000000000000000
chr5,142935283,142935697,414,-1,0,,0,0.00000000000000000000
chr5,142935351,142935675,324,-1,0,,0,0.00000000000000000000
chr5,143080255,143080458,203,-1,0,,0,0.00000000000000000000
chr5,143181037,143186198,5161,-1,0,,0,0.00000000000000000000
chr5,143353615,143353858,243,-1,0,,0,0.00000000000000000000
chr5,143370674,143370767,93,-1,0,,0,0.00000000000000000000
chr5,143406172,143409523,3351,-1,0,,0,0.00000000000000000000
chr5,143512645,143516767,4122,-1,0,,0,0.00000000000000000000
chr5,143512860,143515075,2215,-1,0,,0,0.00000000000000000000
chr5,143666655,143667109,454,-1,0,57528,1,220.26431718061700000000
chr5,143707540,143708914,1374,-1,0,57528,1,72.78020378457060000000
chr5,144473233,144473693,460,-1,0,,0,0.00000000000000000000
chr5,144527508,144568373,40865,-1,0,,0,0.00000000000000000000
chr5,144635346,144636870,1524,-1,0,,0,0.00000000000000000000
chr5,144872076,144874969,2893,-1,0,,0,0.00000000000000000000
chr5,144871903,144872806,903,-1,0,,0,0.00000000000000000000
chr5,144994872,144995191,319,-1,0,,0,0.00000000000000000000
chr5,145691090,145692944,1854,-1,0,,0,0.00000000000000000000
chr5,145792432,145793413,981,-1,0,,0,0.00000000000000000000
chr5,145863345,145865611,2266,-1,0,10915,1,44.13062665489850000000
chr5,146304835,146317147,12312,-1,0,5521,1,8.12215724496426000000
chr5,146379957,146380463,506,-1,0,5521,1,197.62845849802400000000
chr5,146380181,146380256,75,-1,0,5521,1,1333.33333333333000000000
chr5,146392321,146397299,4978,-1,0,5521,1,20.08838891120930000000
chr5,146394713,146397307,2594,-1,0,5521,1,38.55050115651500000000
chr5,146622653,146623086,433,-1,0,202374,1,230.94688221709000000000
chr5,146639710,146639784,74,-1,0,202374,1,1351.35135135135000000000
chr5,146728609,146729401,792,-1,0,202374,1,126.26262626262600000000
chr5,146841560,146843782,2222,-1,0,1809,1,45.00450045004500000000
chr5,146940747,146941180,433,-1,0,,0,0.00000000000000000000
chr5,147178236,147187327,9091,-1,0,,0,0.00000000000000000000
chr5,147742471,147750004,7533,-1,0,,0,0.00000000000000000000
chr5,147552509,147555664,3155,-1,0,408187,1,31.69572107765450000000
chr5,147553094,147554650,1556,-1,0,408187,1,64.26735218509000000000
chr5,147462091,147462572,481,-1,0,11005,1,207.90020790020800000000
chr5,147345129,147345615,486,-1,0,,0,0.00000000000000000000
chr5,147462154,147462477,323,-1,0,11005,1,309.59752321981400000000
chr5,148224744,148225260,516,-1,0,,0,0.00000000000000000000
chr5,148385841,148385940,99,-1,0,79628,1,1010.10101010101000000000
chr5,148401304,148401728,424,-1,0,79628,1,235.84905660377400000000
chr5,148401413,148401593,180,-1,0,79628,1,555.55555555555600000000
chr5,148571158,148571245,87,-1,0,22885,1,1149.42528735632000000000
chr5,148577388,148577834,446,-1,0,22885,1,224.21524663677100000000
chr5,148577546,148577620,74,-1,0,22885,1,1351.35135135135000000000
chr5,148706622,148706863,241,-1,0,134265,1,414.93775933610000000000
chr5,148866099,148866975,876,-1,0,,0,0.00000000000000000000
chr5,149261417,149262448,1031,-1,0,5145,1,96.99321047526670000000
chr5,149298998,149303738,4740,-1,0,5145,1,21.09704641350210000000
chr5,149441744,149442170,426,-1,0,1436,1,234.74178403755900000000
chr5,149640665,149640734,69,-1,0,815,1,1449.27536231884000000000
chr5,149746190,149746517,327,-1,0,6949,1,305.81039755351700000000
chr5,149896242,149898444,2202,-1,0,3340,1,45.41326067211630000000
chr5,150157208,150313245,156037,-1,0,85027;345611;91975,3,1.92262091683383000000
chr5,150175209,150222262,47053,-1,0,85027,1,2.12526300129641000000
chr5,150200030,150225308,25278,-1,0,,0,0.00000000000000000000
chr5,150205194,150223322,18128,-1,0,,0,0.00000000000000000000
chr5,150211610,150223733,12123,-1,0,,0,0.00000000000000000000
chr5,150273964,150284391,10427,-1,0,345611;91975,2,19.18097247530450000000
chr5,150177443,150183453,6010,-1,0,,0,0.00000000000000000000
chr5,150216986,150223402,6416,-1,0,,0,0.00000000000000000000
chr5,150177601,150181589,3988,-1,0,,0,0.00000000000000000000
chr5,150285163,150288151,2988,-1,0,,0,0.00000000000000000000
chr5,150210002,150210129,127,-1,0,,0,0.00000000000000000000
chr5,150789474,150793885,4411,-1,0,,0,0.00000000000000000000
chr5,150789745,150792648,2903,-1,0,,0,0.00000000000000000000
chr5,150880821,150883029,2208,-1,0,,0,0.00000000000000000000
chr5,151141126,151145012,3886,-1,0,,0,0.00000000000000000000
chr5,151249047,151253195,4148,-1,0,2741,1,24.10800385728060000000
chr5,151514293,151523128,8835,-1,0,,0,0.00000000000000000000
chr5,151511061,151518820,7759,-1,0,,0,0.00000000000000000000
chr5,151456407,151463429,7022,-1,0,,0,0.00000000000000000000
chr5,151514802,151518868,4066,-1,0,,0,0.00000000000000000000
chr5,151515812,151518346,2534,-1,0,,0,0.00000000000000000000
chr5,151476114,151476512,398,-1,0,,0,0.00000000000000000000
chr5,151476232,151476363,131,-1,0,,0,0.00000000000000000000
chr5,151580860,151583690,2830,-1,0,,0,0.00000000000000000000
chr5,151663314,151704508,41194,-1,0,,0,0.00000000000000000000
chr5,151678071,151682832,4761,-1,0,,0,0.00000000000000000000
chr5,151760884,151761270,386,-1,0,,0,0.00000000000000000000
chr5,151851515,151852469,954,-1,0,,0,0.00000000000000000000
chr5,151895048,151895134,86,-1,0,,0,0.00000000000000000000
chr5,151956984,151961471,4487,-1,0,,0,0.00000000000000000000
chr5,152251102,152313158,62056,-1,0,,0,0.00000000000000000000
chr5,152420112,152421074,962,-1,0,,0,0.00000000000000000000
chr5,152684094,152692406,8312,-1,0,,0,0.00000000000000000000
chr5,152897445,152899638,2193,-1,0,2890,1,45.59963520291840000000
chr5,152986348,152986513,165,-1,0,2890,1,606.06060606060600000000
chr5,152986414,152986512,98,-1,0,2890,1,1020.40816326531000000000
chr5,153302440,153303511,1071,-1,0,,0,0.00000000000000000000
chr5,153366089,153369814,3725,-1,0,10827,1,26.84563758389260000000
chr5,153689953,153693924,3971,-1,0,55568,1,25.18257365902800000000
chr5,153802482,153807056,4574,-1,0,,0,0.00000000000000000000
chr5,153805391,153807222,1831,-1,0,,0,0.00000000000000000000
chr5,154124179,154124538,359,-1,0,23367,1,278.55153203342600000000
chr5,154315687,154316236,549,-1,0,25929,1,182.14936247723100000000
chr5,154315906,154316006,100,-1,0,25929,1,1000.00000000000000000000
chr5,154567691,154568103,412,-1,0,,0,0.00000000000000000000
chr5,155078540,155082978,4438,-1,0,,0,0.00000000000000000000
chr5,155311424,155312902,1478,-1,0,,0,0.00000000000000000000
chr5,155311784,155312578,794,-1,0,,0,0.00000000000000000000
chr5,155473982,155503454,29472,-1,0,,0,0.00000000000000000000
chr5,155474704,155493188,18484,-1,0,,0,0.00000000000000000000
chr5,155482572,155497835,15263,-1,0,,0,0.00000000000000000000
chr5,155474568,155486746,12178,-1,0,,0,0.00000000000000000000
chr5,155472549,155482222,9673,-1,0,,0,0.00000000000000000000
chr5,155478244,155482667,4423,-1,0,,0,0.00000000000000000000
chr5,155488927,155494981,6054,-1,0,,0,0.00000000000000000000
chr5,155566875,155591588,24713,-1,0,,0,0.00000000000000000000
chr5,155577603,155590140,12537,-1,0,,0,0.00000000000000000000
chr5,155593383,155594540,1157,-1,0,,0,0.00000000000000000000
chr5,155614351,155614751,400,-1,0,,0,0.00000000000000000000
chr5,155876172,155881988,5816,-1,0,6444,1,17.19394773039890000000
chr5,155948368,155954308,5940,-1,0,6444,1,16.83501683501680000000
chr5,156144814,156145945,1131,-1,0,6444,1,88.41732979664010000000
chr5,156421783,156427684,5901,-1,0,,0,0.00000000000000000000
chr5,156421452,156425669,4217,-1,0,,0,0.00000000000000000000
chr5,156538026,156540524,2498,-1,0,,0,0.00000000000000000000
chr5,156848562,156850879,2317,-1,0,,0,0.00000000000000000000
chr5,157080683,157119806,39123,-1,0,100190949;11063,2,5.11208240676840000000
chr5,157291193,157292957,1764,-1,0,,0,0.00000000000000000000
chr5,157303378,157304571,1193,-1,0,,0,0.00000000000000000000
chr5,157333021,157334730,1709,-1,0,,0,0.00000000000000000000
chr5,157644367,157655314,10947,-1,0,,0,0.00000000000000000000
chr5,157736956,157737166,210,-1,0,,0,0.00000000000000000000
chr5,158592282,158592854,572,-1,0,153830,1,174.82517482517500000000
chr5,158592385,158592737,352,-1,0,153830,1,284.09090909090900000000
chr5,158895791,158900807,5016,-1,0,,0,0.00000000000000000000
chr5,158895394,158898706,3312,-1,0,,0,0.00000000000000000000
chr5,159022306,159022987,681,-1,0,,0,0.00000000000000000000
chr5,159474103,159474744,641,-1,0,7265,1,156.00624024961000000000
chr5,159529951,159535385,5434,-1,0,114825,1,18.40264998159730000000
chr5,159549310,159549783,473,-1,0,,0,0.00000000000000000000
chr5,159653480,159654418,938,-1,0,2172,1,106.60980810234500000000
chr5,159742554,159742662,108,-1,0,,0,0.00000000000000000000
chr5,159922224,159923723,1499,-1,0,,0,0.00000000000000000000
chr5,160184151,160186472,2321,-1,0,23120,1,43.08487720810000000000
chr5,160431190,160431775,585,-1,0,,0,0.00000000000000000000
chr5,160431311,160431649,338,-1,0,,0,0.00000000000000000000
chr5,160414080,160414211,131,-1,0,,0,0.00000000000000000000
chr5,160540664,160550326,9662,-1,0,,0,0.00000000000000000000
chr5,160588805,160590305,1500,-1,0,,0,0.00000000000000000000
chr5,160589005,160590017,1012,-1,0,,0,0.00000000000000000000
chr5,160620010,160621161,1151,-1,0,,0,0.00000000000000000000
chr5,160716129,160717305,1176,-1,0,2561,1,85.03401360544220000000
chr5,160796694,160797008,314,-1,0,2561,1,318.47133757961800000000
chr5,160991246,160991715,469,-1,0,,0,0.00000000000000000000
chr5,161066819,161070914,4095,-1,0,,0,0.00000000000000000000
chr5,161543172,161543860,688,-1,0,2566,1,145.34883720930200000000
chr5,161558845,161559238,393,-1,0,2566,1,254.45292620865100000000
chr5,161590120,161597095,6975,-1,0,,0,0.00000000000000000000
chr5,161614166,161642256,28090,-1,0,,0,0.00000000000000000000
chr5,162435309,162435711,402,-1,0,,0,0.00000000000000000000
chr5,162467355,162580760,113405,-1,0,,0,0.00000000000000000000
chr5,162486747,162486919,172,-1,0,,0,0.00000000000000000000
chr5,162745349,162806393,61044,-1,0,,0,0.00000000000000000000
chr5,162821975,162823138,1163,-1,0,,0,0.00000000000000000000
chr5,162861764,162863299,1535,-1,0,,0,0.00000000000000000000
chr5,163014538,163025019,10481,-1,0,,0,0.00000000000000000000
chr5,163172098,163183841,11743,-1,0,,0,0.00000000000000000000
chr5,163220137,163225741,5604,-1,0,,0,0.00000000000000000000
chr5,163665021,163666462,1441,-1,0,,0,0.00000000000000000000
chr5,163665467,163666676,1209,-1,0,,0,0.00000000000000000000
chr5,163950347,163950973,626,-1,0,,0,0.00000000000000000000
chr5,163978426,163978500,74,-1,0,,0,0.00000000000000000000
chr5,164141586,164143377,1791,-1,0,,0,0.00000000000000000000
chr5,164366205,164366724,519,-1,0,,0,0.00000000000000000000
chr5,164366294,164366614,320,-1,0,,0,0.00000000000000000000
chr5,164722264,164726000,3736,-1,0,,0,0.00000000000000000000
chr5,165181927,165182304,377,-1,0,,0,0.00000000000000000000
chr5,165182090,165182160,70,-1,0,,0,0.00000000000000000000
chr5,165227138,165228563,1425,-1,0,,0,0.00000000000000000000
chr5,165227871,165228238,367,-1,0,,0,0.00000000000000000000
chr5,165383105,165389753,6648,-1,0,,0,0.00000000000000000000
chr5,165765938,165781932,15994,-1,0,,0,0.00000000000000000000
chr5,165838918,165850192,11274,-1,0,,0,0.00000000000000000000
chr5,166150651,166151176,525,-1,0,,0,0.00000000000000000000
chr5,166294040,166294368,328,-1,0,,0,0.00000000000000000000
chr5,166294101,166294346,245,-1,0,,0,0.00000000000000000000
chr5,166402762,166403633,871,-1,0,,0,0.00000000000000000000
chr5,166402804,166403337,533,-1,0,,0,0.00000000000000000000
chr5,166474183,166474684,501,-1,0,,0,0.00000000000000000000
chr5,166474431,166474513,82,-1,0,,0,0.00000000000000000000
chr5,166724388,166729765,5377,-1,0,57451,1,18.59773107680860000000
chr5,166822450,166837231,14781,-1,0,57451,1,6.76544212164265000000
chr5,166858802,166859549,747,-1,0,57451,1,133.86880856760400000000
chr5,166942504,166950008,7504,-1,0,57451,1,13.32622601279320000000
chr5,167080823,167088995,8172,-1,0,57451,1,12.23690651003430000000
chr5,167118365,167126435,8070,-1,0,57451,1,12.39157372986370000000
chr5,167072943,167073466,523,-1,0,57451,1,191.20458891013400000000
chr5,167073172,167073254,82,-1,0,57451,1,1219.51219512195000000000
chr5,167400949,167401420,471,-1,0,57451,1,212.31422505307900000000
chr5,167401061,167401356,295,-1,0,57451,1,338.98305084745800000000
chr5,167612936,167612989,53,-1,0,57451,1,1886.79245283019000000000
chr5,168394411,168394762,351,-1,0,6586,1,284.90028490028500000000
chr5,168742368,168742896,528,-1,0,,0,0.00000000000000000000
chr5,168742512,168742761,249,-1,0,,0,0.00000000000000000000
chr5,169440172,169441101,929,-1,0,1794,1,107.64262648008600000000
chr5,169467689,169467949,260,-1,0,1794,1,384.61538461538500000000
chr5,169865055,169869696,4641,-1,0,30820,1,21.54708037060980000000
chr5,169944533,169945159,626,-1,0,30820,1,159.74440894568700000000
chr5,169990735,169993224,2489,-1,0,30820,1,40.17677782241860000000
chr5,170026452,170026861,409,-1,0,30820,1,244.49877750611200000000
chr5,170094223,170096745,2522,-1,0,30820,1,39.65107057890560000000
chr5,170129679,170132223,2544,-1,0,30820,1,39.30817610062890000000
chr5,170129819,170131346,1527,-1,0,30820,1,65.48788474132290000000
chr5,170131206,170131521,315,-1,0,30820,1,317.46031746031700000000
chr5,170158619,170159175,556,-1,0,30820,1,179.85611510791400000000
chr5,170158817,170158962,145,-1,0,30820,1,689.65517241379300000000
chr5,170158820,170158909,89,-1,0,30820,1,1123.59550561798000000000
chr5,170343146,170343287,141,-1,0,64901,1,709.21985815602800000000
chr5,170343074,170343182,108,-1,0,64901,1,925.92592592592600000000
chr5,170481926,170510460,28534,-1,0,64901,1,3.50459101422864000000
chr5,171514534,171515043,509,-1,0,6793,1,196.46365422396900000000
chr5,171616679,171617072,393,-1,0,,0,0.00000000000000000000
chr5,171714782,171719866,5084,-1,0,,0,0.00000000000000000000
chr5,171723467,171724335,868,-1,0,,0,0.00000000000000000000
chr5,171723829,171724077,248,-1,0,,0,0.00000000000000000000
chr5,171905068,171905958,890,-1,0,,0,0.00000000000000000000
chr5,171911733,171912346,613,-1,0,,0,0.00000000000000000000
chr5,171911589,171911938,349,-1,0,,0,0.00000000000000000000
chr5,171997853,171998247,394,-1,0,,0,0.00000000000000000000
chr5,171998033,171998117,84,-1,0,,0,0.00000000000000000000
chr5,172145674,172145926,252,-1,0,,0,0.00000000000000000000
chr5,172145634,172145726,92,-1,0,,0,0.00000000000000000000
chr5,172229602,172236462,6860,-1,0,,0,0.00000000000000000000
chr5,172350034,172350212,178,-1,0,57222,1,561.79775280898900000000
chr5,172430169,172438651,8482,-1,0,8992,1,11.78967224711150000000
chr5,172459260,172468273,9013,-1,0,8992,1,11.09508487739930000000
chr5,172495983,172498835,2852,-1,0,153222,1,35.06311360448810000000
chr5,172601401,172613291,11890,-1,0,,0,0.00000000000000000000
chr5,172700230,172700557,327,-1,0,,0,0.00000000000000000000
chr5,172823742,172826072,2330,-1,0,,0,0.00000000000000000000
chr5,172887789,172888276,487,-1,0,,0,0.00000000000000000000
chr5,172888715,172890769,2054,-1,0,,0,0.00000000000000000000
chr5,172889594,172890245,651,-1,0,,0,0.00000000000000000000
chr5,172889719,172890067,348,-1,0,,0,0.00000000000000000000
chr5,172973009,172974750,1741,-1,0,,0,0.00000000000000000000
chr5,173012310,173012654,344,-1,0,,0,0.00000000000000000000
chr5,173035197,173036343,1146,-1,0,91272,1,87.26003490401400000000
chr5,173086176,173087223,1047,-1,0,,0,0.00000000000000000000
chr5,173090336,173091240,904,-1,0,,0,0.00000000000000000000
chr5,173453103,173457960,4857,-1,0,,0,0.00000000000000000000
chr5,173606988,173607536,548,-1,0,,0,0.00000000000000000000
chr5,173607093,173607413,320,-1,0,,0,0.00000000000000000000
chr5,173640106,173641281,1175,-1,0,,0,0.00000000000000000000
chr5,173640442,173640535,93,-1,0,,0,0.00000000000000000000
chr5,173747521,173747900,379,-1,0,,0,0.00000000000000000000
chr5,173758368,173760238,1870,-1,0,,0,0.00000000000000000000
chr5,174129823,174131995,2172,-1,0,,0,0.00000000000000000000
chr5,174248331,174249099,768,-1,0,,0,0.00000000000000000000
chr5,174287145,174287400,255,-1,0,,0,0.00000000000000000000
chr5,174435769,174440580,4811,-1,0,,0,0.00000000000000000000
chr5,174436833,174439243,2410,-1,0,,0,0.00000000000000000000
chr5,174445795,174446349,554,-1,0,,0,0.00000000000000000000
chr5,174782523,174783258,735,-1,0,,0,0.00000000000000000000
chr5,174819650,174820283,633,-1,0,,0,0.00000000000000000000
chr5,175215506,175215920,414,-1,0,,0,0.00000000000000000000
chr5,175215640,175215717,77,-1,0,,0,0.00000000000000000000
chr5,175255511,175257633,2122,-1,0,10814,1,47.12535344015080000000
chr5,175345739,175351272,5533,-1,0,,0,0.00000000000000000000
chr5,175468116,175659574,191458,-1,0,202134,1,0.52230776462722900000
chr5,175555798,175643914,88116,-1,0,,0,0.00000000000000000000
chr5,175615301,175627400,12099,-1,0,,0,0.00000000000000000000
chr5,175504283,175507768,3485,-1,0,202134,1,28.69440459110470000000
chr5,175564963,175567153,2190,-1,0,,0,0.00000000000000000000
chr5,175561228,175561314,86,-1,0,,0,0.00000000000000000000
chr5,176038355,176038412,57,-1,0,,0,0.00000000000000000000
chr5,176229102,176231758,2656,-1,0,,0,0.00000000000000000000
chr5,176228483,176228954,471,-1,0,,0,0.00000000000000000000
chr5,176286575,176286987,412,-1,0,90249,1,242.71844660194200000000
chr5,176299237,176299488,251,-1,0,90249,1,398.40637450199200000000
chr5,176228709,176228834,125,-1,0,,0,0.00000000000000000000
chr5,176387578,176390181,2603,-1,0,51720,1,38.41721091048790000000
chr5,176438043,176439666,1623,-1,0,,0,0.00000000000000000000
chr5,176494903,176498048,3145,-1,0,23567,1,31.79650238473770000000
chr5,176495010,176496254,1244,-1,0,23567,1,80.38585209003220000000
chr5,176524804,176529233,4429,-1,0,2264,1,22.57846014901780000000
chr5,176531877,176532136,259,-1,0,,0,0.00000000000000000000
chr5,176533774,176535531,1757,-1,0,,0,0.00000000000000000000
chr5,176535224,176535672,448,-1,0,,0,0.00000000000000000000
chr5,176591699,176600840,9141,-1,0,64324,1,10.93972213105790000000
chr5,176753884,176753937,53,-1,0,,0,0.00000000000000000000
chr5,176823395,176823694,299,-1,0,6569,1,334.44816053511700000000
chr5,176823407,176823569,162,-1,0,6569,1,617.28395061728400000000
chr5,176878417,176878799,382,-1,0,80758,1,261.78010471204200000000
chr5,176944455,176946052,1597,-1,0,,0,0.00000000000000000000
chr5,177138351,177229748,91397,-1,0,285596,1,1.09412781601147000000
chr5,177166127,177254952,88825,-1,0,285596,1,1.12580917534478000000
chr5,177155023,177216990,61967,-1,0,285596,1,1.61376216373231000000
chr5,177110721,177143857,33136,-1,0,,0,0.00000000000000000000
chr5,177227412,177236356,8944,-1,0,,0,0.00000000000000000000
chr5,177228836,177235888,7052,-1,0,,0,0.00000000000000000000
chr5,177329345,177352731,23386,-1,0,,0,0.00000000000000000000
chr5,177383208,177410298,27090,-1,0,,0,0.00000000000000000000
chr5,177388451,177401076,12625,-1,0,,0,0.00000000000000000000
chr5,177405613,177407685,2072,-1,0,,0,0.00000000000000000000
chr5,177388181,177389606,1425,-1,0,,0,0.00000000000000000000
chr5,177405751,177406550,799,-1,0,,0,0.00000000000000000000
chr5,177521924,177524123,2199,-1,0,,0,0.00000000000000000000
chr5,177521917,177522499,582,-1,0,,0,0.00000000000000000000
chr5,177606343,177608714,2371,-1,0,,0,0.00000000000000000000
chr5,177690121,177691482,1361,-1,0,91522,1,73.47538574577520000000
chr5,177721146,177721628,482,-1,0,91522,1,207.46887966805000000000
chr5,177721260,177721497,237,-1,0,91522,1,421.94092827004200000000
chr5,177728760,177729123,363,-1,0,91522,1,275.48209366391200000000
chr5,177821731,177824061,2330,-1,0,91522,1,42.91845493562230000000
chr5,177821974,177823379,1405,-1,0,91522,1,71.17437722419930000000
chr5,177847705,177852529,4824,-1,0,91522,1,20.72968490878940000000
chr5,177873677,177878914,5237,-1,0,91522,1,19.09490166125640000000
chr5,177951332,177952798,1466,-1,0,91522,1,68.21282401091400000000
chr5,177951872,177952938,1066,-1,0,91522,1,93.80863039399630000000
chr5,177951879,177952470,591,-1,0,91522,1,169.20473773265600000000
chr5,177952093,177952693,600,-1,0,91522,1,166.66666666666700000000
chr5,178113432,178124434,11002,-1,0,,0,0.00000000000000000000
chr5,178106751,178113183,6432,-1,0,,0,0.00000000000000000000
chr5,178108593,178113763,5170,-1,0,,0,0.00000000000000000000
chr5,178119207,178121202,1995,-1,0,,0,0.00000000000000000000
chr5,178111399,178113119,1720,-1,0,,0,0.00000000000000000000
chr5,178118291,178119256,965,-1,0,,0,0.00000000000000000000
chr5,178258764,178260185,1421,-1,0,,0,0.00000000000000000000
chr5,178268019,178268234,215,-1,0,,0,0.00000000000000000000
chr5,178344766,178353359,8593,-1,0,80108,1,11.63737926219020000000
chr5,178348352,178353194,4842,-1,0,80108,1,20.65262288310620000000
chr5,178386750,178391345,4595,-1,0,285676,1,21.76278563656150000000
chr5,178515610,178516493,883,-1,0,,0,0.00000000000000000000
chr5,178548556,178565418,16862,-1,0,9509,1,5.93049460324991000000
chr5,178561561,178562781,1220,-1,0,9509,1,81.96721311475410000000
chr5,178640975,178641419,444,-1,0,9509,1,225.22522522522500000000
chr5,178641141,178641291,150,-1,0,9509,1,666.66666666666700000000
chr5,178656253,178656400,147,-1,0,9509,1,680.27210884353700000000
chr5,178740359,178740787,428,-1,0,9509,1,233.64485981308400000000
chr5,178838451,178840564,2113,-1,0,,0,0.00000000000000000000
chr5,178838942,178839750,808,-1,0,,0,0.00000000000000000000
chr5,178856475,178857104,629,-1,0,,0,0.00000000000000000000
chr5,178838862,178839222,360,-1,0,,0,0.00000000000000000000
chr5,178856653,178856908,255,-1,0,,0,0.00000000000000000000
chr5,178935757,178937555,1798,-1,0,,0,0.00000000000000000000
chr5,179067099,179067859,760,-1,0,,0,0.00000000000000000000
chr5,179102189,179103571,1382,-1,0,,0,0.00000000000000000000
chr5,179120343,179120486,143,-1,0,,0,0.00000000000000000000
chr5,179231288,179240766,9478,-1,0,8878;11282,2,21.10149820637270000000
chr5,179276030,179276784,754,-1,0,51149,1,132.62599469496000000000
chr5,179298824,179299110,286,-1,0,23061,1,349.65034965035000000000
chr5,179342029,179344311,2282,-1,0,,0,0.00000000000000000000
chr5,179443161,179507831,64670,-1,0,55819,1,1.54631204577084000000
chr5,179540248,179540657,409,-1,0,255426,1,244.49877750611200000000
chr5,179615615,179632637,17022,-1,0,255426,1,5.87475032311127000000
chr5,179617424,179617605,181,-1,0,255426,1,552.48618784530400000000
chr5,179713144,179713726,582,-1,0,5601,1,171.82130584192400000000
chr5,179723611,179724070,459,-1,0,,0,0.00000000000000000000
chr5,179723746,179723855,109,-1,0,,0,0.00000000000000000000
chr5,179810567,179811723,1156,-1,0,,0,0.00000000000000000000
chr5,179847339,179848566,1227,-1,0,,0,0.00000000000000000000
chr5,179865362,179866858,1496,-1,0,,0,0.00000000000000000000
chr5,180043250,180045421,2171,-1,0,2324,1,46.06172270842930000000
chr5,180042160,180043142,982,-1,0,2324,1,101.83299389002000000000
chr5,180066060,180066532,472,-1,0,2324,1,211.86440677966100000000
chr5,180066159,180066317,158,-1,0,2324,1,632.91139240506300000000
chr5,180181363,180195648,14285,-1,0,,0,0.00000000000000000000
chr5,180184453,180184722,269,-1,0,,0,0.00000000000000000000
chr5,180374598,180432394,57796,-1,0,79908;10917,2,3.46044708976400000000
chr5,180388186,180424301,36115,-1,0,10917,1,2.76893257649176000000
chr5,180378592,180404889,26297,-1,0,,0,0.00000000000000000000
chr5,180410751,180431471,20720,-1,0,10917,1,4.82625482625483000000
chr5,180343973,180344517,544,-1,0,79908,1,183.82352941176500000000
chr5,180501761,180540731,38970,-1,0,,0,0.00000000000000000000
chr5,180510614,180518677,8063,-1,0,,0,0.00000000000000000000
chr5,180515231,180518897,3666,-1,0,,0,0.00000000000000000000
chr5,180560460,180563141,2681,-1,0,,0,0.00000000000000000000
chr5,180567691,180570673,2982,-1,0,,0,0.00000000000000000000
chr5,180561664,180563036,1372,-1,0,,0,0.00000000000000000000
chr5,180569233,180569985,752,-1,0,,0,0.00000000000000000000
chr5,180585393,180596489,11096,-1,0,,0,0.00000000000000000000
chr5,180591001,180596624,5623,-1,0,,0,0.00000000000000000000
chr5,180671366,180709528,38162,-1,0,84851,1,2.62040773544364000000
chr5,180700082,180715577,15495,-1,0,,0,0.00000000000000000000
chr5,180680085,180681429,1344,-1,0,,0,0.00000000000000000000
chr5,180806444,180888413,81969,-1,0,,0,0.00000000000000000000
chr5,180840220,180888013,47793,-1,0,,0,0.00000000000000000000
chr5,180875996,180878640,2644,-1,0,,0,0.00000000000000000000
chr6,255129,384285,129156,-1,0,56940,1,0.77425748706990000000
chr6,83824,202184,118360,-1,0,,0,0.00000000000000000000
chr6,255939,325126,69187,-1,0,56940,1,1.44535823203781000000
chr6,306401,378945,72544,-1,0,56940,1,1.37847375385973000000
chr6,129245,202392,73147,-1,0,,0,0.00000000000000000000
chr6,341395,383375,41980,-1,0,56940,1,2.38208670795617000000
chr6,255580,299413,43833,-1,0,56940,1,2.28138617023704000000
chr6,257491,282356,24865,-1,0,,0,0.00000000000000000000
chr6,192162,209476,17314,-1,0,,0,0.00000000000000000000
chr6,237791,249435,11644,-1,0,,0,0.00000000000000000000
chr6,666376,667821,1445,-1,0,55770,1,69.20415224913490000000
chr6,468152,470270,2118,-1,0,,0,0.00000000000000000000
chr6,675532,677228,1696,-1,0,55770,1,58.96226415094340000000
chr6,518726,520809,2083,-1,0,55770,1,48.00768122899660000000
chr6,171683,173694,2011,-1,0,,0,0.00000000000000000000
chr6,601224,602516,1292,-1,0,55770,1,77.39938080495360000000
chr6,481411,483211,1800,-1,0,,0,0.00000000000000000000
chr6,594991,596565,1574,-1,0,55770,1,63.53240152477760000000
chr6,666422,667778,1356,-1,0,55770,1,73.74631268436580000000
chr6,725488,726517,1029,-1,0,,0,0.00000000000000000000
chr6,676851,677224,373,-1,0,55770,1,268.09651474530800000000
chr6,675465,675848,383,-1,0,55770,1,261.09660574412500000000
chr6,425826,425956,130,-1,0,,0,0.00000000000000000000
chr6,861983,863775,1792,-1,0,,0,0.00000000000000000000
chr6,856847,858209,1362,-1,0,,0,0.00000000000000000000
chr6,909788,911071,1283,-1,0,,0,0.00000000000000000000
chr6,877955,879058,1103,-1,0,,0,0.00000000000000000000
chr6,774093,775361,1268,-1,0,,0,0.00000000000000000000
chr6,773628,774800,1172,-1,0,,0,0.00000000000000000000
chr6,1210718,1211231,513,-1,0,,0,0.00000000000000000000
chr6,857122,857599,477,-1,0,,0,0.00000000000000000000
chr6,774135,774653,518,-1,0,,0,0.00000000000000000000
chr6,878277,878565,288,-1,0,,0,0.00000000000000000000
chr6,857730,857805,75,-1,0,,0,0.00000000000000000000
chr6,1318793,1321502,2709,-1,0,,0,0.00000000000000000000
chr6,1270712,1270998,286,-1,0,,0,0.00000000000000000000
chr6,1441635,1441733,98,-1,0,,0,0.00000000000000000000
chr6,1477891,1479024,1133,-1,0,,0,0.00000000000000000000
chr6,1478134,1478758,624,-1,0,,0,0.00000000000000000000
chr6,1478304,1478602,298,-1,0,,0,0.00000000000000000000
chr6,1478434,1478596,162,-1,0,,0,0.00000000000000000000
chr6,1533095,1535292,2197,-1,0,,0,0.00000000000000000000
chr6,1534051,1534842,791,-1,0,,0,0.00000000000000000000
chr6,1683960,1684522,562,-1,0,2762,1,177.93594306049800000000
chr6,1682669,1683209,540,-1,0,2762,1,185.18518518518500000000
chr6,1682805,1683131,326,-1,0,2762,1,306.74846625766900000000
chr6,1745426,1745850,424,-1,0,2762,1,235.84905660377400000000
chr6,1745628,1745703,75,-1,0,2762,1,1333.33333333333000000000
chr6,1827474,1827875,401,-1,0,2762,1,249.37655860349100000000
chr6,1898193,1898296,103,-1,0,2762,1,970.87378640776700000000
chr6,2009617,2018411,8794,-1,0,2762,1,11.37138958380710000000
chr6,2207342,2208384,1042,-1,0,2762,1,95.96928982725530000000
chr6,2568026,2571957,3931,-1,0,,0,0.00000000000000000000
chr6,2605425,2605552,127,-1,0,,0,0.00000000000000000000
chr6,2605523,2605583,60,-1,0,,0,0.00000000000000000000
chr6,2791560,2810213,18653,-1,0,,0,0.00000000000000000000
chr6,2907364,2907708,344,-1,0,,0,0.00000000000000000000
chr6,2945881,2959378,13497,-1,0,5269,1,7.40905386382159000000
chr6,3070627,3073039,2412,-1,0,8737,1,41.45936981757880000000
chr6,3091068,3094423,3355,-1,0,8737,1,29.80625931445600000000
chr6,3144966,3147218,2252,-1,0,670,1,44.40497335701600000000
chr6,3145966,3147203,1237,-1,0,670,1,80.84074373484240000000
chr6,3145126,3146356,1230,-1,0,670,1,81.30081300813010000000
chr6,3156198,3179686,23488,-1,0,7280,1,4.25749318801090000000
chr6,3181789,3182592,803,-1,0,,0,0.00000000000000000000
chr6,3195374,3195958,584,-1,0,,0,0.00000000000000000000
chr6,3327064,3327476,412,-1,0,63027,1,242.71844660194200000000
chr6,3331659,3336180,4521,-1,0,63027,1,22.11900022119000000000
chr6,3365409,3366481,1072,-1,0,63027,1,93.28358208955220000000
chr6,3516517,3517592,1075,-1,0,,0,0.00000000000000000000
chr6,3619204,3621879,2675,-1,0,,0,0.00000000000000000000
chr6,3885268,3887486,2218,-1,0,,0,0.00000000000000000000
chr6,3924435,3926213,1778,-1,0,,0,0.00000000000000000000
chr6,3955963,3957990,2027,-1,0,,0,0.00000000000000000000
chr6,4020873,4021239,366,-1,0,,0,0.00000000000000000000
chr6,4021012,4021062,50,-1,0,,0,0.00000000000000000000
chr6,4050147,4050667,520,-1,0,8899,1,192.30769230769200000000
chr6,4050252,4050572,320,-1,0,8899,1,312.50000000000000000000
chr6,4170150,4174738,4588,-1,0,,0,0.00000000000000000000
chr6,4254766,4467549,212783,-1,0,,0,0.00000000000000000000
chr6,4272799,4273089,290,-1,0,,0,0.00000000000000000000
chr6,4455087,4455460,373,-1,0,,0,0.00000000000000000000
chr6,4272807,4273069,262,-1,0,,0,0.00000000000000000000
chr6,4734098,4736491,2393,-1,0,,0,0.00000000000000000000
chr6,5035201,5039100,3899,-1,0,,0,0.00000000000000000000
chr6,5037248,5039186,1938,-1,0,,0,0.00000000000000000000
chr6,5117574,5119936,2362,-1,0,57128,1,42.33700254022010000000
chr6,5331975,5459023,127048,-1,0,10667,1,0.78710408664441800000
chr6,5257344,5339457,82113,-1,0,10667;57128,2,2.43566792103565000000
chr6,5135253,5135915,662,-1,0,57128,1,151.05740181268900000000
chr6,5205408,5205771,363,-1,0,57128,1,275.48209366391200000000
chr6,5555048,5559456,4408,-1,0,10667,1,22.68602540834850000000
chr6,5559769,5562473,2704,-1,0,10667,1,36.98224852071010000000
chr6,5705553,5710787,5234,-1,0,10667,1,19.10584638899500000000
chr6,5728448,5729943,1495,-1,0,10667,1,66.88963210702340000000
chr6,5898410,5899005,595,-1,0,,0,0.00000000000000000000
chr6,5927539,5928003,464,-1,0,,0,0.00000000000000000000
chr6,6068774,6069202,428,-1,0,,0,0.00000000000000000000
chr6,6254383,6257151,2768,-1,0,2162,1,36.12716763005780000000
chr6,6277222,6277725,503,-1,0,2162,1,198.80715705765400000000
chr6,6277339,6277602,263,-1,0,2162,1,380.22813688212900000000
chr6,6316107,6316737,630,-1,0,2162,1,158.73015873015900000000
chr6,6598788,6599195,407,-1,0,9450,1,245.70024570024600000000
chr6,6801627,6811075,9448,-1,0,,0,0.00000000000000000000
chr6,6916492,6916865,373,-1,0,,0,0.00000000000000000000
chr6,7012439,7012610,171,-1,0,,0,0.00000000000000000000
chr6,7012541,7012672,131,-1,0,,0,0.00000000000000000000
chr6,7272045,7274011,1966,-1,0,,0,0.00000000000000000000
chr6,7434558,7443254,8696,-1,0,,0,0.00000000000000000000
chr6,7440801,7450900,10099,-1,0,,0,0.00000000000000000000
chr6,7442563,7443453,890,-1,0,,0,0.00000000000000000000
chr6,7632949,7633823,874,-1,0,,0,0.00000000000000000000
chr6,7717278,7717819,541,-1,0,,0,0.00000000000000000000
chr6,7717384,7717719,335,-1,0,,0,0.00000000000000000000
chr6,7741675,7741883,208,-1,0,654,1,480.76923076923100000000
chr6,7781550,7782494,944,-1,0,654,1,105.93220338983100000000
chr6,7793246,7793599,353,-1,0,654,1,283.28611898017000000000
chr6,8337646,8341595,3949,-1,0,,0,0.00000000000000000000
chr6,8164326,8170829,6503,-1,0,,0,0.00000000000000000000
chr6,8337732,8340723,2991,-1,0,,0,0.00000000000000000000
chr6,8227831,8228352,521,-1,0,,0,0.00000000000000000000
chr6,8078491,8078905,414,-1,0,9521,1,241.54589371980700000000
chr6,8227923,8228241,318,-1,0,,0,0.00000000000000000000
chr6,8368382,8369412,1030,-1,0,,0,0.00000000000000000000
chr6,8432413,8435222,2809,-1,0,51000,1,35.59985760056960000000
chr6,8590485,8719999,129514,-1,0,,0,0.00000000000000000000
chr6,8654394,8718667,64273,-1,0,,0,0.00000000000000000000
chr6,8922451,8932944,10493,-1,0,,0,0.00000000000000000000
chr6,9014595,9015234,639,-1,0,,0,0.00000000000000000000
chr6,9014824,9014937,113,-1,0,,0,0.00000000000000000000
chr6,9025516,9025971,455,-1,0,,0,0.00000000000000000000
chr6,9025729,9025780,51,-1,0,,0,0.00000000000000000000
chr6,9075183,9075733,550,-1,0,,0,0.00000000000000000000
chr6,9075292,9075623,331,-1,0,,0,0.00000000000000000000
chr6,9273819,9274953,1134,-1,0,,0,0.00000000000000000000
chr6,9273735,9274570,835,-1,0,,0,0.00000000000000000000
chr6,9274267,9274893,626,-1,0,,0,0.00000000000000000000
chr6,9359535,9360386,851,-1,0,,0,0.00000000000000000000
chr6,9460258,9460847,589,-1,0,,0,0.00000000000000000000
chr6,9460370,9460714,344,-1,0,,0,0.00000000000000000000
chr6,9805277,9946989,141712,-1,0,,0,0.00000000000000000000
chr6,9834174,9839362,5188,-1,0,,0,0.00000000000000000000
chr6,9762105,9766083,3978,-1,0,,0,0.00000000000000000000
chr6,10063807,10069835,6028,-1,0,,0,0.00000000000000000000
chr6,10070699,10071222,523,-1,0,,0,0.00000000000000000000
chr6,10070784,10071104,320,-1,0,,0,0.00000000000000000000
chr6,10202570,10202951,381,-1,0,,0,0.00000000000000000000
chr6,10202735,10202785,50,-1,0,,0,0.00000000000000000000
chr6,10495236,10581415,86179,-1,0,2651,1,1.16037549751099000000
chr6,10467102,10534246,67144,-1,0,2651,1,1.48933635172167000000
chr6,10521353,10555814,34461,-1,0,2651,1,2.90183105539595000000
chr6,10520848,10536745,15897,-1,0,2651,1,6.29049506196138000000
chr6,10264248,10266147,1899,-1,0,,0,0.00000000000000000000
chr6,10534524,10536765,2241,-1,0,2651,1,44.62293618920120000000
chr6,10521020,10522601,1581,-1,0,2651,1,63.25110689437070000000
chr6,10264417,10265330,913,-1,0,,0,0.00000000000000000000
chr6,10487510,10488008,498,-1,0,,0,0.00000000000000000000
chr6,10293995,10294140,145,-1,0,,0,0.00000000000000000000
chr6,10487734,10487828,94,-1,0,,0,0.00000000000000000000
chr6,10657926,10660840,2914,-1,0,,0,0.00000000000000000000
chr6,10729524,10754260,24736,-1,0,51522;81853,2,8.08538163001294000000
chr6,10740680,10744946,4266,-1,0,,0,0.00000000000000000000
chr6,10750306,10754125,3819,-1,0,81853,1,26.18486514794450000000
chr6,11034669,11034840,171,-1,0,54898,1,584.79532163742700000000
chr6,11059480,11088041,28561,-1,0,,0,0.00000000000000000000
chr6,11072806,11077601,4795,-1,0,,0,0.00000000000000000000
chr6,11313637,11313793,156,-1,0,4739,1,641.02564102564100000000
chr6,11444338,11444651,313,-1,0,,0,0.00000000000000000000
chr6,11555999,11556537,538,-1,0,100113407,1,185.87360594795500000000
chr6,11556104,11556425,321,-1,0,100113407,1,311.52647975077900000000
chr6,11616090,11616620,530,-1,0,,0,0.00000000000000000000
chr6,11616274,11616430,156,-1,0,,0,0.00000000000000000000
chr6,11634919,11641264,6345,-1,0,,0,0.00000000000000000000
chr6,11903327,11903872,545,-1,0,,0,0.00000000000000000000
chr6,11903447,11903763,316,-1,0,,0,0.00000000000000000000
chr6,12393276,12394188,912,-1,0,,0,0.00000000000000000000
chr6,12478903,12483430,4527,-1,0,,0,0.00000000000000000000
chr6,12527809,12529564,1755,-1,0,,0,0.00000000000000000000
chr6,12664177,12664510,333,-1,0,,0,0.00000000000000000000
chr6,12831615,12837912,6297,-1,0,221692,1,15.88057805304110000000
chr6,13191154,13191926,772,-1,0,221692,1,129.53367875647700000000
chr6,13230734,13231944,1210,-1,0,221692,1,82.64462809917350000000
chr6,13231435,13231940,505,-1,0,221692,1,198.01980198019800000000
chr6,13542362,13542626,264,-1,0,,0,0.00000000000000000000
chr6,13847670,13856980,9310,-1,0,,0,0.00000000000000000000
chr6,13882548,13883852,1304,-1,0,,0,0.00000000000000000000
chr6,14380004,14381175,1171,-1,0,,0,0.00000000000000000000
chr6,14739449,14740973,1524,-1,0,,0,0.00000000000000000000
chr6,14743973,14745958,1985,-1,0,,0,0.00000000000000000000
chr6,14745281,14745689,408,-1,0,,0,0.00000000000000000000
chr6,14819003,14820582,1579,-1,0,,0,0.00000000000000000000
chr6,14839445,14842016,2571,-1,0,,0,0.00000000000000000000
chr6,14935428,14941371,5943,-1,0,,0,0.00000000000000000000
chr6,15174514,15179611,5097,-1,0,,0,0.00000000000000000000
chr6,15188401,15190827,2426,-1,0,,0,0.00000000000000000000
chr6,15191325,15192579,1254,-1,0,,0,0.00000000000000000000
chr6,15248316,15249040,724,-1,0,3720,1,138.12154696132600000000
chr6,15418880,15419371,491,-1,0,3720,1,203.66598778004100000000
chr6,15666748,15667668,920,-1,0,,0,0.00000000000000000000
chr6,15683311,15684846,1535,-1,0,,0,0.00000000000000000000
chr6,15761813,15775297,13484,-1,0,,0,0.00000000000000000000
chr6,16266176,16266566,390,-1,0,2766,1,256.41025641025600000000
chr6,16266300,16266358,58,-1,0,2766,1,1724.13793103448000000000
chr6,16567841,16573511,5670,-1,0,6310,1,17.63668430335100000000
chr6,16883612,16886289,2677,-1,0,,0,0.00000000000000000000
chr6,16884966,16886109,1143,-1,0,,0,0.00000000000000000000
chr6,17110721,17112747,2026,-1,0,401236,1,49.35834155972360000000
chr6,17252648,17255060,2412,-1,0,,0,0.00000000000000000000
chr6,17267392,17271537,4145,-1,0,,0,0.00000000000000000000
chr6,17376711,17381475,4764,-1,0,,0,0.00000000000000000000
chr6,17377827,17380462,2635,-1,0,,0,0.00000000000000000000
chr6,17438256,17441907,3651,-1,0,10486,1,27.38975623116950000000
chr6,17472226,17472699,473,-1,0,10486,1,211.41649048625800000000
chr6,17472287,17472614,327,-1,0,10486,1,305.81039755351700000000
chr6,17727716,17728746,1030,-1,0,,0,0.00000000000000000000
chr6,17750447,17750886,439,-1,0,,0,0.00000000000000000000
chr6,17774459,17775812,1353,-1,0,63971,1,73.90983000739100000000
chr6,17949603,17951920,2317,-1,0,63971,1,43.15925766076820000000
chr6,18106595,18113122,6527,-1,0,,0,0.00000000000000000000
chr6,18300574,18302596,2022,-1,0,,0,0.00000000000000000000
chr6,18327023,18331732,4709,-1,0,,0,0.00000000000000000000
chr6,18326416,18327801,1385,-1,0,,0,0.00000000000000000000
chr6,18327671,18327770,99,-1,0,,0,0.00000000000000000000
chr6,18400467,18403019,2552,-1,0,255488,1,39.18495297805640000000
chr6,18401799,18403209,1410,-1,0,255488,1,70.92198581560280000000
chr6,18402111,18402923,812,-1,0,255488,1,123.15270935960600000000
chr6,18789285,18789644,359,-1,0,,0,0.00000000000000000000
chr6,18808627,18810542,1915,-1,0,,0,0.00000000000000000000
chr6,18888811,18888904,93,-1,0,,0,0.00000000000000000000
chr6,18943629,18943680,51,-1,0,,0,0.00000000000000000000
chr6,19040969,19050431,9462,-1,0,,0,0.00000000000000000000
chr6,19041577,19046449,4872,-1,0,,0,0.00000000000000000000
chr6,19041571,19044865,3294,-1,0,,0,0.00000000000000000000
chr6,19155524,19156091,567,-1,0,,0,0.00000000000000000000
chr6,19155628,19155975,347,-1,0,,0,0.00000000000000000000
chr6,19175628,19180701,5073,-1,0,,0,0.00000000000000000000
chr6,19224040,19249238,25198,-1,0,,0,0.00000000000000000000
chr6,19347040,19348037,997,-1,0,,0,0.00000000000000000000
chr6,19347231,19347930,699,-1,0,,0,0.00000000000000000000
chr6,19423499,19424021,522,-1,0,,0,0.00000000000000000000
chr6,19423613,19423851,238,-1,0,,0,0.00000000000000000000
chr6,19483151,19496576,13425,-1,0,,0,0.00000000000000000000
chr6,19676399,19677445,1046,-1,0,,0,0.00000000000000000000
chr6,19684845,19687792,2947,-1,0,,0,0.00000000000000000000
chr6,19685581,19687230,1649,-1,0,,0,0.00000000000000000000
chr6,19685572,19686529,957,-1,0,,0,0.00000000000000000000
chr6,19765017,19771499,6482,-1,0,,0,0.00000000000000000000
chr6,19773032,19790936,17904,-1,0,,0,0.00000000000000000000
chr6,19814797,19821289,6492,-1,0,,0,0.00000000000000000000
chr6,19837789,19839772,1983,-1,0,3400,1,50.42864346949070000000
chr6,19952967,19953128,161,-1,0,,0,0.00000000000000000000
chr6,19966326,19970505,4179,-1,0,,0,0.00000000000000000000
chr6,20024104,20024533,429,-1,0,,0,0.00000000000000000000
chr6,20394845,20398484,3639,-1,0,,0,0.00000000000000000000
chr6,20765267,20765791,524,-1,0,54901,1,190.83969465648900000000
chr6,20765381,20765701,320,-1,0,54901,1,312.50000000000000000000
chr6,21164075,21164784,709,-1,0,54901,1,141.04372355430200000000
chr6,21082201,21082283,82,-1,0,54901,1,1219.51219512195000000000
chr6,21361700,21367192,5492,-1,0,,0,0.00000000000000000000
chr6,21675815,21683622,7807,-1,0,,0,0.00000000000000000000
chr6,21825251,21834594,9343,-1,0,,0,0.00000000000000000000
chr6,21827604,21831777,4173,-1,0,,0,0.00000000000000000000
chr6,22050322,22055437,5115,-1,0,,0,0.00000000000000000000
chr6,22051196,22053965,2769,-1,0,,0,0.00000000000000000000
chr6,22052727,22053754,1027,-1,0,,0,0.00000000000000000000
chr6,22167186,22175940,8754,-1,0,,0,0.00000000000000000000
chr6,22227388,22227898,510,-1,0,,0,0.00000000000000000000
chr6,22201278,22201665,387,-1,0,,0,0.00000000000000000000
chr6,22227478,22227763,285,-1,0,,0,0.00000000000000000000
chr6,22261644,22263924,2280,-1,0,,0,0.00000000000000000000
chr6,22501806,22501905,99,-1,0,,0,0.00000000000000000000
chr6,22782609,22783045,436,-1,0,,0,0.00000000000000000000
chr6,22896627,22896820,193,-1,0,,0,0.00000000000000000000
chr6,22901499,23040719,139220,-1,0,,0,0.00000000000000000000
chr6,22930411,22930793,382,-1,0,,0,0.00000000000000000000
chr6,22930583,22930781,198,-1,0,,0,0.00000000000000000000
chr6,23159770,23163845,4075,-1,0,,0,0.00000000000000000000
chr6,23300249,23300830,581,-1,0,,0,0.00000000000000000000
chr6,23300366,23300692,326,-1,0,,0,0.00000000000000000000
chr6,23394026,23394210,184,-1,0,,0,0.00000000000000000000
chr6,23460321,23465438,5117,-1,0,,0,0.00000000000000000000
chr6,23685914,23686391,477,-1,0,,0,0.00000000000000000000
chr6,23685995,23686324,329,-1,0,,0,0.00000000000000000000
chr6,23743261,23745947,2686,-1,0,,0,0.00000000000000000000
chr6,23858064,23960952,102888,-1,0,,0,0.00000000000000000000
chr6,23948024,23950303,2279,-1,0,,0,0.00000000000000000000
chr6,23908472,23909712,1240,-1,0,,0,0.00000000000000000000
chr6,23878141,23879063,922,-1,0,,0,0.00000000000000000000
chr6,23948742,23948985,243,-1,0,,0,0.00000000000000000000
chr6,24324335,24328706,4371,-1,0,51473,1,22.87805994051700000000
chr6,24325357,24327822,2465,-1,0,51473,1,40.56795131845840000000
chr6,24325384,24327616,2232,-1,0,51473,1,44.80286738351250000000
chr6,24448374,24448785,411,-1,0,2822,1,243.30900243309000000000
chr6,24646510,24646549,39,-1,0,,0,0.00000000000000000000
chr6,24811805,24818032,6227,-1,0,9750,1,16.05909747872170000000
chr6,24879111,24879424,313,-1,0,9750,1,319.48881789137400000000
chr6,25450845,25452339,1494,-1,0,55604,1,66.93440428380190000000
chr6,25529572,25530312,740,-1,0,55604,1,135.13513513513500000000
chr6,25529870,25530011,141,-1,0,55604,1,709.21985815602800000000
chr6,25893913,25905605,11692,-1,0,,0,0.00000000000000000000
chr6,26343674,26351639,7965,-1,0,,0,0.00000000000000000000
chr6,26368708,26444495,75787,-1,0,10384;11118;10385;11119,4,5.27795004420283000000
chr6,26368929,26406147,37218,-1,0,11118;10385;11119,3,8.06061583104949000000
chr6,26373711,26380604,6893,-1,0,11118,1,14.50747134774410000000
chr6,26611155,26617877,6722,-1,0,,0,0.00000000000000000000
chr6,26656702,26658679,1977,-1,0,79692,1,50.58168942842690000000
chr6,26677121,26686237,9116,-1,0,,0,0.00000000000000000000
chr6,26705147,26762511,57364,-1,0,,0,0.00000000000000000000
chr6,26731013,26786851,55838,-1,0,,0,0.00000000000000000000
chr6,26728347,26767450,39103,-1,0,,0,0.00000000000000000000
chr6,26718709,26748866,30157,-1,0,,0,0.00000000000000000000
chr6,26730396,26752340,21944,-1,0,,0,0.00000000000000000000
chr6,26745202,26754627,9425,-1,0,,0,0.00000000000000000000
chr6,26739614,26748928,9314,-1,0,,0,0.00000000000000000000
chr6,26753502,26761950,8448,-1,0,,0,0.00000000000000000000
chr6,26743805,26745358,1553,-1,0,,0,0.00000000000000000000
chr6,26851110,26871742,20632,-1,0,,0,0.00000000000000000000
chr6,27158541,27159905,1364,-1,0,,0,0.00000000000000000000
chr6,27298530,27306656,8126,-1,0,,0,0.00000000000000000000
chr6,27655564,27689502,33938,-1,0,,0,0.00000000000000000000
chr6,27674964,27679458,4494,-1,0,,0,0.00000000000000000000
chr6,28019034,28022418,3384,-1,0,,0,0.00000000000000000000
chr6,28190090,28190648,558,-1,0,,0,0.00000000000000000000
chr6,28190192,28190540,348,-1,0,,0,0.00000000000000000000
chr6,28307497,28307950,453,-1,0,64288,1,220.75055187638000000000
chr6,28307622,28307722,100,-1,0,64288,1,1000.00000000000000000000
chr6,28350468,28350993,525,-1,0,,0,0.00000000000000000000
chr6,28626281,28628375,2094,-1,0,,0,0.00000000000000000000
chr6,28762004,28780002,17998,-1,0,,0,0.00000000000000000000
chr6,28770459,28784929,14470,-1,0,,0,0.00000000000000000000
chr6,28897460,28898086,626,-1,0,,0,0.00000000000000000000
chr6,28958061,28959164,1103,-1,0,,0,0.00000000000000000000
chr6,28996072,29152595,156523,-1,0,442186;26707;442184;26692,4,2.55553496930164000000
chr6,29080915,29181204,100289,-1,0,26707,1,0.99711832803198800000
chr6,28971962,28972574,612,-1,0,,0,0.00000000000000000000
chr6,28972075,28972489,414,-1,0,,0,0.00000000000000000000
chr6,28972214,28972318,104,-1,0,,0,0.00000000000000000000
chr6,29332245,29332645,400,-1,0,,0,0.00000000000000000000
chr6,29363461,29364516,1055,-1,0,26529,1,94.78672985781990000000
chr6,29363686,29364276,590,-1,0,,0,0.00000000000000000000
chr6,29363897,29364068,171,-1,0,,0,0.00000000000000000000
chr6,29365072,29385698,20626,-1,0,26529,1,4.84824978182876000000
chr6,29513086,29513400,314,-1,0,,0,0.00000000000000000000
chr6,29543648,29554119,10471,-1,0,,0,0.00000000000000000000
chr6,29650415,29651088,673,-1,0,,0,0.00000000000000000000
chr6,29685294,29688242,2948,-1,0,,0,0.00000000000000000000
chr6,29731393,29940992,209599,-1,0,3135;3105,2,0.95420302577779500000
chr6,29821062,29971153,150091,-1,0,3105,1,0.66626246743642200000
chr6,29798914,29913749,114835,-1,0,3105,1,0.87081464710236400000
chr6,29885131,29970085,84954,-1,0,3105,1,1.17710761117781000000
chr6,29843854,29919272,75418,-1,0,3105,1,1.32594340873532000000
chr6,29912588,29976714,64126,-1,0,3105,1,1.55942987243864000000
chr6,29834722,29879701,44979,-1,0,,0,0.00000000000000000000
chr6,29874381,29931913,57532,-1,0,3105,1,1.73816310922617000000
chr6,29829637,29874884,45247,-1,0,,0,0.00000000000000000000
chr6,29856132,29896771,40639,-1,0,,0,0.00000000000000000000
chr6,29914638,29937662,23024,-1,0,,0,0.00000000000000000000
chr6,29864146,29885116,20970,-1,0,,0,0.00000000000000000000
chr6,29882736,29902049,19313,-1,0,,0,0.00000000000000000000
chr6,29873939,29890153,16214,-1,0,,0,0.00000000000000000000
chr6,29899497,29914725,15228,-1,0,3105,1,6.56685053848174000000
chr6,29892560,29905834,13274,-1,0,,0,0.00000000000000000000
chr6,29837200,29849273,12073,-1,0,,0,0.00000000000000000000
chr6,29916207,29925881,9674,-1,0,,0,0.00000000000000000000
chr6,29884689,29896153,11464,-1,0,,0,0.00000000000000000000
chr6,29901871,29911280,9409,-1,0,3105,1,10.62812201084070000000
chr6,29843490,29850131,6641,-1,0,,0,0.00000000000000000000
chr6,29927096,29932987,5891,-1,0,,0,0.00000000000000000000
chr6,29914708,29918748,4040,-1,0,,0,0.00000000000000000000
chr6,29910369,29913804,3435,-1,0,3105,1,29.11208151382820000000
chr6,29899725,29901557,1832,-1,0,,0,0.00000000000000000000
chr6,29946601,29948418,1817,-1,0,,0,0.00000000000000000000
chr6,29914927,29917023,2096,-1,0,,0,0.00000000000000000000
chr6,30065975,30068803,2828,-1,0,,0,0.00000000000000000000
chr6,29920446,29923016,2570,-1,0,,0,0.00000000000000000000
chr6,29899944,29901525,1581,-1,0,,0,0.00000000000000000000
chr6,29762910,29764096,1186,-1,0,,0,0.00000000000000000000
chr6,29941757,29942849,1092,-1,0,,0,0.00000000000000000000
chr6,29814959,29815584,625,-1,0,,0,0.00000000000000000000
chr6,29819213,29819858,645,-1,0,,0,0.00000000000000000000
chr6,30207802,30208224,422,-1,0,,0,0.00000000000000000000
chr6,29843099,29843361,262,-1,0,,0,0.00000000000000000000
chr6,29690406,29690789,383,-1,0,,0,0.00000000000000000000
chr6,29815236,29815607,371,-1,0,,0,0.00000000000000000000
chr6,29763322,29763559,237,-1,0,,0,0.00000000000000000000
chr6,29903683,29903830,147,-1,0,,0,0.00000000000000000000
chr6,30230519,30230591,72,-1,0,,0,0.00000000000000000000
chr6,30343638,30348585,4947,-1,0,,0,0.00000000000000000000
chr6,30388258,31252251,863993,-1,0,135656;5460;8870;9656;170680;5514;1041;80742;79969;221545;29113;10211;203068;6941;57176;2968;394263;23;2794;780;170954;389376;100507679;11270;170679;54535;3133;28973;3107;8449,30,3.47225035388018000000
chr6,31192610,31495318,302708,-1,0,4277;3107;3106;100507436,4,1.32140544683325000000
chr6,31338237,31479588,141351,-1,0,4277;100507436,2,1.41491747493827000000
chr6,31229114,31317962,88848,-1,0,3107,1,1.12551773815955000000
chr6,31206945,31285451,78506,-1,0,3107,1,1.27378799072682000000
chr6,31405874,31452972,47098,-1,0,,0,0.00000000000000000000
chr6,31280083,31340576,60493,-1,0,3106,1,1.65308382788091000000
chr6,31279196,31310274,31078,-1,0,,0,0.00000000000000000000
chr6,31284311,31312208,27897,-1,0,,0,0.00000000000000000000
chr6,30422498,30450875,28377,-1,0,,0,0.00000000000000000000
chr6,31322637,31350216,27579,-1,0,3106,1,3.62594727872657000000
chr6,30968924,30991487,22563,-1,0,100507679,1,4.43203474715242000000
chr6,31272938,31289503,16565,-1,0,,0,0.00000000000000000000
chr6,31214649,31231501,16852,-1,0,,0,0.00000000000000000000
chr6,31299622,31315952,16330,-1,0,,0,0.00000000000000000000
chr6,31281404,31296614,15210,-1,0,,0,0.00000000000000000000
chr6,31278233,31289238,11005,-1,0,,0,0.00000000000000000000
chr6,31301154,31312208,11054,-1,0,,0,0.00000000000000000000
chr6,31219497,31229823,10326,-1,0,,0,0.00000000000000000000
chr6,31279146,31288033,8887,-1,0,,0,0.00000000000000000000
chr6,31269166,31278302,9136,-1,0,,0,0.00000000000000000000
chr6,31296376,31304896,8520,-1,0,,0,0.00000000000000000000
chr6,31337768,31342065,4297,-1,0,,0,0.00000000000000000000
chr6,31274244,31279581,5337,-1,0,,0,0.00000000000000000000
chr6,31308595,31313661,5066,-1,0,,0,0.00000000000000000000
chr6,31268887,31272727,3840,-1,0,,0,0.00000000000000000000
chr6,31338288,31341173,2885,-1,0,,0,0.00000000000000000000
chr6,31421419,31424501,3082,-1,0,,0,0.00000000000000000000
chr6,31237024,31240035,3011,-1,0,3107,1,33.21155762205250000000
chr6,31276897,31279418,2521,-1,0,,0,0.00000000000000000000
chr6,31236319,31238667,2348,-1,0,3107,1,42.58943781942080000000
chr6,31284858,31287240,2382,-1,0,,0,0.00000000000000000000
chr6,31292091,31293878,1787,-1,0,,0,0.00000000000000000000
chr6,31056059,31058047,1988,-1,0,,0,0.00000000000000000000
chr6,30994916,30996773,1857,-1,0,100507679,1,53.85029617662900000000
chr6,31211511,31213175,1664,-1,0,,0,0.00000000000000000000
chr6,31338810,31340516,1706,-1,0,,0,0.00000000000000000000
chr6,30996140,30997736,1596,-1,0,100507679,1,62.65664160401000000000
chr6,31287831,31289437,1606,-1,0,,0,0.00000000000000000000
chr6,31270366,31271970,1604,-1,0,,0,0.00000000000000000000
chr6,31277297,31278687,1390,-1,0,,0,0.00000000000000000000
chr6,31193275,31194538,1263,-1,0,,0,0.00000000000000000000
chr6,30994016,30995083,1067,-1,0,100507679,1,93.72071227741330000000
chr6,31237388,31238488,1100,-1,0,3107,1,90.90909090909090000000
chr6,31324718,31325602,884,-1,0,3106,1,113.12217194570100000000
chr6,31012669,31013140,471,-1,0,,0,0.00000000000000000000
chr6,30954678,30955181,503,-1,0,394263,1,198.80715705765400000000
chr6,31023165,31023635,470,-1,0,,0,0.00000000000000000000
chr6,31288027,31288262,235,-1,0,,0,0.00000000000000000000
chr6,31274812,31274989,177,-1,0,,0,0.00000000000000000000
chr6,30932630,30932804,174,-1,0,,0,0.00000000000000000000
chr6,30886430,30886570,140,-1,0,57176,1,714.28571428571400000000
chr6,31012852,31012940,88,-1,0,,0,0.00000000000000000000
chr6,31638184,31639130,946,-1,0,58496,1,105.70824524312900000000
chr6,31784467,31796752,12285,-1,0,3303;3304,2,16.28001628001630000000
chr6,31812886,31817163,4277,-1,0,,0,0.00000000000000000000
chr6,31871129,31878578,7449,-1,0,717,1,13.42462075446370000000
chr6,31871239,31875169,3930,-1,0,717,1,25.44529262086510000000
chr6,31876077,31878132,2055,-1,0,717,1,48.66180048661800000000
chr6,31945048,31945737,689,-1,0,8859,1,145.13788098693800000000
chr6,31948296,32012630,64334,-1,0,7148;8859;721;1589;720,5,7.77194018714832000000
chr6,31975945,32009872,33927,-1,0,7148;1589;721,3,8.84251481121231000000
chr6,31984843,31991610,6767,-1,0,721,1,14.77759716270130000000
chr6,31952521,31958676,6155,-1,0,720,1,16.24695369618200000000
chr6,32025918,32029373,3455,-1,0,7148,1,28.94356005788710000000
chr6,32172902,32175046,2144,-1,0,4855,1,46.64179104477610000000
chr6,32247470,32248668,1198,-1,0,,0,0.00000000000000000000
chr6,32313634,32314206,572,-1,0,10665,1,174.82517482517500000000
chr6,32313752,32314083,331,-1,0,10665,1,302.11480362537800000000
chr6,32315459,32316338,879,-1,0,10665,1,113.76564277588200000000
chr6,32358297,32370603,12306,-1,0,56244,1,8.12611734113441000000
chr6,32377159,32379256,2097,-1,0,,0,0.00000000000000000000
chr6,32377876,32378653,777,-1,0,,0,0.00000000000000000000
chr6,32416771,32417217,446,-1,0,,0,0.00000000000000000000
chr6,32455702,32651896,196194,-1,0,3123;3119;3117;3127,4,2.03879833226296000000
chr6,32615608,32725160,109552,-1,0,3118;3119;3120,3,2.73842558784869000000
chr6,32439692,32561028,121336,-1,0,3123;3127,2,1.64831542163908000000
chr6,32453735,32513536,59801,-1,0,3127,1,1.67221283925018000000
chr6,32660492,32748092,87600,-1,0,3118;3120,2,2.28310502283105000000
chr6,32496873,32571502,74629,-1,0,3123;3127,2,2.67992335419207000000
chr6,32449184,32492255,43071,-1,0,3127,1,2.32174781175269000000
chr6,32582327,32630167,47840,-1,0,3119;3117,2,4.18060200668896000000
chr6,32524286,32572663,48377,-1,0,3123,1,2.06709800111623000000
chr6,32603542,32648834,45292,-1,0,3119;3117,2,4.41579086814448000000
chr6,32475856,32514239,38383,-1,0,3127,1,2.60532006356981000000
chr6,32521664,32549356,27692,-1,0,3123,1,3.61115123501372000000
chr6,32490709,32526593,35884,-1,0,3127,1,2.78675732917178000000
chr6,32454932,32478435,23503,-1,0,,0,0.00000000000000000000
chr6,32516836,32541693,24857,-1,0,,0,0.00000000000000000000
chr6,32609378,32626100,16722,-1,0,3117,1,5.98014591556034000000
chr6,32627550,32648423,20873,-1,0,3119,1,4.79087816796819000000
chr6,32540153,32558650,18497,-1,0,3123,1,5.40628209979997000000
chr6,32592983,32613894,20911,-1,0,3117,1,4.78217206255081000000
chr6,32503719,32521100,17381,-1,0,,0,0.00000000000000000000
chr6,32536921,32553045,16124,-1,0,3123,1,6.20193500372116000000
chr6,32493370,32506740,13370,-1,0,3127,1,7.47943156320120000000
chr6,32690476,32705501,15025,-1,0,,0,0.00000000000000000000
chr6,32461313,32468854,7541,-1,0,,0,0.00000000000000000000
chr6,32612502,32625723,13221,-1,0,,0,0.00000000000000000000
chr6,32636158,32648687,12529,-1,0,,0,0.00000000000000000000
chr6,32550889,32559734,8845,-1,0,3123,1,11.30582249858680000000
chr6,32604936,32616132,11196,-1,0,3117,1,8.93176134333691000000
chr6,32487905,32497345,9440,-1,0,3127,1,10.59322033898310000000
chr6,32590668,32600591,9923,-1,0,,0,0.00000000000000000000
chr6,32594431,32603963,9532,-1,0,,0,0.00000000000000000000
chr6,32626693,32634717,8024,-1,0,3119,1,12.46261216350950000000
chr6,32650533,32657517,6984,-1,0,,0,0.00000000000000000000
chr6,32441899,32450725,8826,-1,0,,0,0.00000000000000000000
chr6,32541530,32547810,6280,-1,0,3123,1,15.92356687898090000000
chr6,32497355,32505192,7837,-1,0,3127,1,12.75998468801840000000
chr6,32600591,32607907,7316,-1,0,3117,1,13.66867140513940000000
chr6,32487524,32493530,6006,-1,0,3127,1,16.65001665001660000000
chr6,32501910,32508235,6325,-1,0,,0,0.00000000000000000000
chr6,32642935,32648031,5096,-1,0,,0,0.00000000000000000000
chr6,32652025,32657442,5417,-1,0,,0,0.00000000000000000000
chr6,32481597,32485227,3630,-1,0,3127,1,27.54820936639120000000
chr6,32455584,32459289,3705,-1,0,,0,0.00000000000000000000
chr6,32492630,32497153,4523,-1,0,3127,1,22.10921954455010000000
chr6,32615898,32620131,4233,-1,0,,0,0.00000000000000000000
chr6,32623293,32627965,4672,-1,0,3119,1,21.40410958904110000000
chr6,32485758,32489977,4219,-1,0,3127,1,23.70229912301490000000
chr6,32561729,32564735,3006,-1,0,,0,0.00000000000000000000
chr6,32549028,32552693,3665,-1,0,3123,1,27.28512960436560000000
chr6,32593162,32595436,2274,-1,0,,0,0.00000000000000000000
chr6,32591579,32594316,2737,-1,0,,0,0.00000000000000000000
chr6,32455459,32457700,2241,-1,0,,0,0.00000000000000000000
chr6,32543249,32545616,2367,-1,0,,0,0.00000000000000000000
chr6,32594404,32596506,2102,-1,0,,0,0.00000000000000000000
chr6,32623589,32625655,2066,-1,0,,0,0.00000000000000000000
chr6,32518593,32520605,2012,-1,0,,0,0.00000000000000000000
chr6,32499262,32500811,1549,-1,0,,0,0.00000000000000000000
chr6,32778681,32779821,1140,-1,0,,0,0.00000000000000000000
chr6,32486911,32488474,1563,-1,0,3127,1,63.97952655150350000000
chr6,32522933,32524632,1699,-1,0,,0,0.00000000000000000000
chr6,32549028,32550469,1441,-1,0,3123,1,69.39625260235950000000
chr6,32514817,32516267,1450,-1,0,,0,0.00000000000000000000
chr6,32593358,32594248,890,-1,0,,0,0.00000000000000000000
chr6,32676286,32677300,1014,-1,0,,0,0.00000000000000000000
chr6,32570997,32572243,1246,-1,0,,0,0.00000000000000000000
chr6,32496979,32498202,1223,-1,0,3127,1,81.76614881439080000000
chr6,32623532,32624604,1072,-1,0,,0,0.00000000000000000000
chr6,32626056,32627047,991,-1,0,,0,0.00000000000000000000
chr6,32624896,32625863,967,-1,0,,0,0.00000000000000000000
chr6,32459783,32460825,1042,-1,0,,0,0.00000000000000000000
chr6,32559879,32560794,915,-1,0,,0,0.00000000000000000000
chr6,32431774,32432563,789,-1,0,,0,0.00000000000000000000
chr6,32600906,32601719,813,-1,0,,0,0.00000000000000000000
chr6,32592170,32592698,528,-1,0,,0,0.00000000000000000000
chr6,32549365,32549963,598,-1,0,3123,1,167.22408026755900000000
chr6,32480578,32481212,634,-1,0,,0,0.00000000000000000000
chr6,32593606,32594095,489,-1,0,,0,0.00000000000000000000
chr6,32571292,32571687,395,-1,0,,0,0.00000000000000000000
chr6,32614929,32615258,329,-1,0,,0,0.00000000000000000000
chr6,32512655,32513034,379,-1,0,,0,0.00000000000000000000
chr6,32676561,32677027,466,-1,0,,0,0.00000000000000000000
chr6,32559954,32560367,413,-1,0,,0,0.00000000000000000000
chr6,32643976,32644323,347,-1,0,,0,0.00000000000000000000
chr6,32749235,32749548,313,-1,0,,0,0.00000000000000000000
chr6,32585103,32585466,363,-1,0,,0,0.00000000000000000000
chr6,32547571,32547932,361,-1,0,3123,1,277.00831024930700000000
chr6,32645119,32645448,329,-1,0,,0,0.00000000000000000000
chr6,32559206,32559505,299,-1,0,,0,0.00000000000000000000
chr6,32571330,32571624,294,-1,0,,0,0.00000000000000000000
chr6,32661797,32661940,143,-1,0,,0,0.00000000000000000000
chr6,32795502,32795680,178,-1,0,6891,1,561.79775280898900000000
chr6,33027588,33059586,31998,-1,0,3115;3113,2,6.25039064941559000000
chr6,33025085,33038945,13860,-1,0,3113,1,7.21500721500721000000
chr6,33049227,33056564,7337,-1,0,3115,1,13.62954886193270000000
chr6,33049586,33054555,4969,-1,0,3115,1,20.12477359629700000000
chr6,33051704,33055345,3641,-1,0,3115,1,27.46498214776160000000
chr6,33026687,33028640,1953,-1,0,,0,0.00000000000000000000
chr6,33125923,33126848,925,-1,0,,0,0.00000000000000000000
chr6,32979992,32980971,979,-1,0,,0,0.00000000000000000000
chr6,33093406,33093738,332,-1,0,,0,0.00000000000000000000
chr6,33248944,33250353,1409,-1,0,9277,1,70.97232079489000000000
chr6,33292908,33295403,2495,-1,0,,0,0.00000000000000000000
chr6,33475543,33475895,352,-1,0,,0,0.00000000000000000000
chr6,33475649,33475853,204,-1,0,,0,0.00000000000000000000
chr6,33495895,33524307,28412,-1,0,,0,0.00000000000000000000
chr6,33492818,33498941,6123,-1,0,,0,0.00000000000000000000
chr6,33493151,33493968,817,-1,0,,0,0.00000000000000000000
chr6,33568911,33571415,2504,-1,0,,0,0.00000000000000000000
chr6,33572537,33574190,1653,-1,0,,0,0.00000000000000000000
chr6,33576148,33579972,3824,-1,0,,0,0.00000000000000000000
chr6,33583108,33585950,2842,-1,0,,0,0.00000000000000000000
chr6,33583986,33585328,1342,-1,0,,0,0.00000000000000000000
chr6,33797220,33797854,634,-1,0,,0,0.00000000000000000000
chr6,33797208,33797587,379,-1,0,,0,0.00000000000000000000
chr6,33937182,33943913,6731,-1,0,,0,0.00000000000000000000
chr6,33938743,33942705,3962,-1,0,,0,0.00000000000000000000
chr6,33941657,33943036,1379,-1,0,,0,0.00000000000000000000
chr6,33963299,33969148,5849,-1,0,,0,0.00000000000000000000
chr6,34006249,34007313,1064,-1,0,2914,1,93.98496240601500000000
chr6,34012177,34012822,645,-1,0,2914,1,155.03875968992200000000
chr6,34039539,34040419,880,-1,0,2914,1,113.63636363636400000000
chr6,34178552,34178966,414,-1,0,,0,0.00000000000000000000
chr6,34202605,34205899,3294,-1,0,3159,1,30.35822707953860000000
chr6,34218883,34219850,967,-1,0,,0,0.00000000000000000000
chr6,34317076,34319406,2330,-1,0,100529239;11165,2,85.83690987124460000000
chr6,34339757,34341163,1406,-1,0,100529239;11165,2,142.24751066856300000000
chr6,34402201,34408241,6040,-1,0,,0,0.00000000000000000000
chr6,34699946,34701098,1152,-1,0,,0,0.00000000000000000000
chr6,34712671,34716416,3745,-1,0,,0,0.00000000000000000000
chr6,34793178,34799044,5866,-1,0,54887,1,17.04739174906240000000
chr6,35103785,35106056,2271,-1,0,6954,1,44.03346543372960000000
chr6,35104268,35104869,601,-1,0,6954,1,166.38935108153100000000
chr6,35332962,35334380,1418,-1,0,5467,1,70.52186177715090000000
chr6,35464170,35465651,1481,-1,0,7287;7005,2,135.04388926401100000000
chr6,35496509,35498485,1976,-1,0,,0,0.00000000000000000000
chr6,35626430,35629746,3316,-1,0,2289,1,30.15681544028950000000
chr6,35649599,35650122,523,-1,0,2289,1,191.20458891013400000000
chr6,35649832,35649945,113,-1,0,2289,1,884.95575221238900000000
chr6,36069918,36070413,495,-1,0,1432,1,202.02020202020200000000
chr6,36070119,36070193,74,-1,0,1432,1,1351.35135135135000000000
chr6,36581729,36582601,872,-1,0,,0,0.00000000000000000000
chr6,36655365,36659238,3873,-1,0,,0,0.00000000000000000000
chr6,36700216,36707291,7075,-1,0,401258,1,14.13427561837460000000
chr6,37294848,37295402,554,-1,0,55633,1,180.50541516245500000000
chr6,37294953,37295275,322,-1,0,55633,1,310.55900621118000000000
chr6,37340390,37343434,3044,-1,0,9025,1,32.85151116951380000000
chr6,37721551,37721780,229,-1,0,,0,0.00000000000000000000
chr6,37851224,37852576,1352,-1,0,60685,1,73.96449704142010000000
chr6,37989212,38012326,23114,-1,0,60685,1,4.32638227913818000000
chr6,38071253,38071307,54,-1,0,60685,1,1851.85185185185000000000
chr6,38339379,38439005,99626,-1,0,114781,1,1.00375404011001000000
chr6,38399362,38492045,92683,-1,0,114781,1,1.07894651662117000000
chr6,38391623,38404655,13032,-1,0,114781,1,7.67341927562922000000
chr6,38498270,38498415,145,-1,0,114781,1,689.65517241379300000000
chr6,38683566,38683798,232,-1,0,1769,1,431.03448275862100000000
chr6,38889798,38889849,51,-1,0,1769,1,1960.78431372549000000000
chr6,38922075,38922632,557,-1,0,1769,1,179.53321364452400000000
chr6,38922187,38922504,317,-1,0,1769,1,315.45741324921100000000
chr6,39068461,39072864,4403,-1,0,55776,1,22.71178741766980000000
chr6,39305309,39307531,2222,-1,0,221458,1,45.00450045004500000000
chr6,40066340,40102454,36114,-1,0,,0,0.00000000000000000000
chr6,40081467,40081982,515,-1,0,,0,0.00000000000000000000
chr6,40365496,40368854,3358,-1,0,57497,1,29.77963073257890000000
chr6,40434158,40436446,2288,-1,0,57497,1,43.70629370629370000000
chr6,40517417,40518476,1059,-1,0,57497,1,94.42870632672330000000
chr6,40661114,40662105,991,-1,0,,0,0.00000000000000000000
chr6,40715113,40717908,2795,-1,0,,0,0.00000000000000000000
chr6,41404043,41404415,372,-1,0,,0,0.00000000000000000000
chr6,41563030,41564409,1379,-1,0,116113,1,72.51631617113850000000
chr6,41618833,41619283,450,-1,0,4188,1,222.22222222222200000000
chr6,41701884,41703517,1633,-1,0,7942,1,61.23698714023270000000
chr6,41705686,41706127,441,-1,0,5225,1,226.75736961451200000000
chr6,41864732,41865301,569,-1,0,,0,0.00000000000000000000
chr6,41920823,41922165,1342,-1,0,896,1,74.51564828614010000000
chr6,41953103,41956548,3445,-1,0,896,1,29.02757619738750000000
chr6,41953263,41953681,418,-1,0,896,1,239.23444976076600000000
chr6,41953273,41953610,337,-1,0,896,1,296.73590504451000000000
chr6,42230034,42230481,447,-1,0,55809,1,223.71364653243800000000
chr6,42569519,42569931,412,-1,0,23304,1,242.71844660194200000000
chr6,42569618,42569779,161,-1,0,23304,1,621.11801242236000000000
chr6,42837379,42839298,1919,-1,0,,0,0.00000000000000000000
chr6,43035360,43035811,451,-1,0,89953,1,221.72949002217300000000
chr6,43385748,43386288,540,-1,0,,0,0.00000000000000000000
chr6,43385956,43386094,138,-1,0,,0,0.00000000000000000000
chr6,43385991,43386067,76,-1,0,,0,0.00000000000000000000
chr6,43598356,43600679,2323,-1,0,9587,1,43.04778303917350000000
chr6,43723826,43725142,1316,-1,0,,0,0.00000000000000000000
chr6,44126521,44126922,401,-1,0,11131,1,249.37655860349100000000
chr6,44149931,44150029,98,-1,0,11131,1,1020.40816326531000000000
chr6,44337498,44338919,1421,-1,0,221409,1,70.37297677691770000000
chr6,44503047,44512413,9366,-1,0,,0,0.00000000000000000000
chr6,44511557,44515722,4165,-1,0,,0,0.00000000000000000000
chr6,44513341,44514951,1610,-1,0,,0,0.00000000000000000000
chr6,44522869,44524475,1606,-1,0,,0,0.00000000000000000000
chr6,44613407,44613900,493,-1,0,,0,0.00000000000000000000
chr6,44613484,44613800,316,-1,0,,0,0.00000000000000000000
chr6,44678732,44679318,586,-1,0,,0,0.00000000000000000000
chr6,44803037,44803409,372,-1,0,8464,1,268.81720430107500000000
chr6,45054956,45178722,123766,-1,0,8464,1,0.80797634245269300000
chr6,45173226,45257101,83875,-1,0,8464,1,1.19225037257824000000
chr6,44993601,45042112,48511,-1,0,8464,1,2.06138813877265000000
chr6,45201952,45205555,3603,-1,0,8464,1,27.75464890369140000000
chr6,45199596,45201597,2001,-1,0,8464,1,49.97501249375310000000
chr6,45098284,45099828,1544,-1,0,8464,1,64.76683937823830000000
chr6,45967443,45967824,381,-1,0,53405,1,262.46719160105000000000
chr6,46228597,46230062,1465,-1,0,10231,1,68.25938566552900000000
chr6,46597599,46599034,1435,-1,0,51302,1,69.68641114982580000000
chr6,46970360,46972260,1900,-1,0,266977,1,52.63157894736840000000
chr6,47091746,47092160,414,-1,0,,0,0.00000000000000000000
chr6,47297268,47300283,3015,-1,0,,0,0.00000000000000000000
chr6,47279892,47280432,540,-1,0,,0,0.00000000000000000000
chr6,47280002,47280340,338,-1,0,,0,0.00000000000000000000
chr6,47280148,47280233,85,-1,0,,0,0.00000000000000000000
chr6,47350137,47350698,561,-1,0,,0,0.00000000000000000000
chr6,47562981,47565738,2757,-1,0,23607,1,36.27130939426910000000
chr6,47564683,47566937,2254,-1,0,23607,1,44.36557231588290000000
chr6,47564784,47565841,1057,-1,0,23607,1,94.60737937559130000000
chr6,47631327,47631795,468,-1,0,222611,1,213.67521367521400000000
chr6,47631538,47631590,52,-1,0,222611,1,1923.07692307692000000000
chr6,48096845,48100866,4021,-1,0,,0,0.00000000000000000000
chr6,48674096,48677624,3528,-1,0,,0,0.00000000000000000000
chr6,47982741,47984615,1874,-1,0,442213,1,53.36179295624330000000
chr6,47906745,47908100,1355,-1,0,442213,1,73.80073800738010000000
chr6,48784813,48785228,415,-1,0,,0,0.00000000000000000000
chr6,48930496,48938384,7888,-1,0,,0,0.00000000000000000000
chr6,48931083,48937787,6704,-1,0,,0,0.00000000000000000000
chr6,48990967,48995041,4074,-1,0,,0,0.00000000000000000000
chr6,48932699,48936105,3406,-1,0,,0,0.00000000000000000000
chr6,49281671,49295130,13459,-1,0,,0,0.00000000000000000000
chr6,49497482,49497891,409,-1,0,,0,0.00000000000000000000
chr6,49497670,49497729,59,-1,0,,0,0.00000000000000000000
chr6,49628035,49634858,6823,-1,0,,0,0.00000000000000000000
chr6,49637013,49637403,390,-1,0,,0,0.00000000000000000000
chr6,49870091,49870248,157,-1,0,,0,0.00000000000000000000
chr6,49949838,49957990,8152,-1,0,,0,0.00000000000000000000
chr6,50000410,50000984,574,-1,0,,0,0.00000000000000000000
chr6,50345934,50396985,51051,-1,0,,0,0.00000000000000000000
chr6,50452445,50452821,376,-1,0,,0,0.00000000000000000000
chr6,50559385,50561691,2306,-1,0,,0,0.00000000000000000000
chr6,50765815,50766454,639,-1,0,,0,0.00000000000000000000
chr6,50765956,50766267,311,-1,0,,0,0.00000000000000000000
chr6,51199297,51201437,2140,-1,0,,0,0.00000000000000000000
chr6,51198890,51200246,1356,-1,0,,0,0.00000000000000000000
chr6,51199450,51200126,676,-1,0,,0,0.00000000000000000000
chr6,51256164,51256775,611,-1,0,,0,0.00000000000000000000
chr6,51256282,51256613,331,-1,0,,0,0.00000000000000000000
chr6,51368916,51370999,2083,-1,0,,0,0.00000000000000000000
chr6,51413783,51414012,229,-1,0,,0,0.00000000000000000000
chr6,51447100,51477528,30428,-1,0,,0,0.00000000000000000000
chr6,51517252,51517776,524,-1,0,5314,1,190.83969465648900000000
chr6,51517347,51517685,338,-1,0,5314,1,295.85798816568000000000
chr6,51666944,51669367,2423,-1,0,5314,1,41.27115146512590000000
chr6,51739375,51745833,6458,-1,0,5314,1,15.48467017652520000000
chr6,51736109,51736804,695,-1,0,5314,1,143.88489208633100000000
chr6,51803087,51808883,5796,-1,0,5314,1,17.25327812284330000000
chr6,52166162,52171444,5282,-1,0,,0,0.00000000000000000000
chr6,52617025,52698421,81396,-1,0,2938;2939;221357,3,3.68568480023588000000
chr6,52622345,52662562,40217,-1,0,2938;2939,2,4.97302135912674000000
chr6,52645457,52684761,39304,-1,0,2938,1,2.54427030327702000000
chr6,52651096,52652664,1568,-1,0,,0,0.00000000000000000000
chr6,52626258,52626997,739,-1,0,2939,1,135.31799729364000000000
chr6,52797150,52803940,6790,-1,0,,0,0.00000000000000000000
chr6,52792918,52796436,3518,-1,0,,0,0.00000000000000000000
chr6,52808613,52810164,1551,-1,0,,0,0.00000000000000000000
chr6,52811911,52812266,355,-1,0,,0,0.00000000000000000000
chr6,53037673,53038128,455,-1,0,,0,0.00000000000000000000
chr6,53478447,53480634,2187,-1,0,,0,0.00000000000000000000
chr6,53530743,53530877,134,-1,0,,0,0.00000000000000000000
chr6,53728634,53732285,3651,-1,0,55227,1,27.38975623116950000000
chr6,53855499,53866427,10928,-1,0,,0,0.00000000000000000000
chr6,53927708,53934750,7042,-1,0,90523,1,14.20051121840390000000
chr6,53929726,53936189,6463,-1,0,90523,1,15.47269070091290000000
chr6,53928827,53934662,5835,-1,0,90523,1,17.13796058269070000000
chr6,53931083,53931869,786,-1,0,90523,1,127.22646310432600000000
chr6,54098718,54123902,25184,-1,0,90523,1,3.97077509529860000000
chr6,54417674,54418926,1252,-1,0,,0,0.00000000000000000000
chr6,54553847,54557389,3542,-1,0,,0,0.00000000000000000000
chr6,54556337,54556919,582,-1,0,,0,0.00000000000000000000
chr6,54556441,54556779,338,-1,0,,0,0.00000000000000000000
chr6,54662537,54665918,3381,-1,0,,0,0.00000000000000000000
chr6,54780305,54780634,329,-1,0,222584,1,303.95136778115500000000
chr6,54845536,54851460,5924,-1,0,,0,0.00000000000000000000
chr6,54846408,54850955,4547,-1,0,,0,0.00000000000000000000
chr6,54846382,54849171,2789,-1,0,,0,0.00000000000000000000
chr6,54848348,54849939,1591,-1,0,,0,0.00000000000000000000
chr6,54864278,54864800,522,-1,0,,0,0.00000000000000000000
chr6,54864364,54864692,328,-1,0,,0,0.00000000000000000000
chr6,54876373,54880639,4266,-1,0,,0,0.00000000000000000000
chr6,55281051,55281217,166,-1,0,,0,0.00000000000000000000
chr6,55341641,55345661,4020,-1,0,54511,1,24.87562189054730000000
chr6,55341737,55342333,596,-1,0,54511,1,167.78523489932900000000
chr6,55407927,55408174,247,-1,0,54511,1,404.85829959514200000000
chr6,55413601,55417886,4285,-1,0,54511,1,23.33722287047840000000
chr6,55461796,55461915,119,-1,0,,0,0.00000000000000000000
chr6,55732997,55736370,3373,-1,0,653,1,29.64719833975690000000
chr6,55831055,55910117,79062,-1,0,,0,0.00000000000000000000
chr6,55824315,55852724,28409,-1,0,,0,0.00000000000000000000
chr6,55825861,55846698,20837,-1,0,,0,0.00000000000000000000
chr6,55825032,55838003,12971,-1,0,,0,0.00000000000000000000
chr6,55907915,55917821,9906,-1,0,,0,0.00000000000000000000
chr6,55907554,55912729,5175,-1,0,,0,0.00000000000000000000
chr6,55903846,55909091,5245,-1,0,,0,0.00000000000000000000
chr6,55843192,55846436,3244,-1,0,,0,0.00000000000000000000
chr6,56075959,56076009,50,-1,0,81578,1,2000.00000000000000000000
chr6,56182597,56190711,8114,-1,0,81578,1,12.32437761893020000000
chr6,56615011,56618556,3545,-1,0,667,1,28.20874471086040000000
chr6,56758011,56761278,3267,-1,0,667,1,30.60912151821240000000
chr6,56898271,56898740,469,-1,0,,0,0.00000000000000000000
chr6,56898487,56898555,68,-1,0,,0,0.00000000000000000000
chr6,56912918,56955199,42281,-1,0,57691;26036,2,4.73025708947281000000
chr6,56942778,56946241,3463,-1,0,,0,0.00000000000000000000
chr6,56915799,56916507,708,-1,0,57691,1,141.24293785310700000000
chr6,57102041,57148082,46041,-1,0,,0,0.00000000000000000000
chr6,57160287,57168351,8064,-1,0,,0,0.00000000000000000000
chr6,57239129,57239490,361,-1,0,5558,1,277.00831024930700000000
chr6,57284825,57289121,4296,-1,0,5558,1,23.27746741154560000000
chr6,57297214,57301371,4157,-1,0,5558,1,24.05580947798890000000
chr6,57301356,57301524,168,-1,0,5558,1,595.23809523809500000000
chr6,57381670,57382254,584,-1,0,5558,1,171.23287671232900000000
chr6,57354304,57354513,209,-1,0,5558,1,478.46889952153100000000
chr6,57381856,57382103,247,-1,0,5558,1,404.85829959514200000000
chr6,57937967,58544169,606202,-1,0,,0,0.00000000000000000000
chr6,57766166,58372608,606442,-1,0,,0,0.00000000000000000000
chr6,58020757,58073980,53223,-1,0,,0,0.00000000000000000000
chr6,57427679,57459261,31582,-1,0,5558,1,3.16636058514344000000
chr6,58249480,58268049,18569,-1,0,,0,0.00000000000000000000
chr6,57617582,57628997,11415,-1,0,,0,0.00000000000000000000
chr6,58301704,58314497,12793,-1,0,,0,0.00000000000000000000
chr6,57583294,57590498,7204,-1,0,,0,0.00000000000000000000
chr6,57423085,57429185,6100,-1,0,5558,1,16.39344262295080000000
chr6,57622892,57628682,5790,-1,0,,0,0.00000000000000000000
chr6,58423747,58428885,5138,-1,0,,0,0.00000000000000000000
chr6,58618325,58624205,5880,-1,0,,0,0.00000000000000000000
chr6,58602714,58608401,5687,-1,0,,0,0.00000000000000000000
chr6,58186791,58190918,4127,-1,0,,0,0.00000000000000000000
chr6,57447660,57451718,4058,-1,0,5558,1,24.64268112370630000000
chr6,57660981,57663119,2138,-1,0,,0,0.00000000000000000000
chr6,57477774,57479317,1543,-1,0,5558,1,64.80881399870380000000
chr6,57553327,57554461,1134,-1,0,,0,0.00000000000000000000
chr6,57618405,57619177,772,-1,0,,0,0.00000000000000000000
chr6,57553631,57554218,587,-1,0,,0,0.00000000000000000000
chr6,57478153,57478861,708,-1,0,5558,1,141.24293785310700000000
chr6,57540519,57540969,450,-1,0,,0,0.00000000000000000000
chr6,58717580,58718225,645,-1,0,,0,0.00000000000000000000
chr6,57449515,57449959,444,-1,0,5558,1,225.22522522522500000000
chr6,57525742,57526091,349,-1,0,,0,0.00000000000000000000
chr6,57618680,57618879,199,-1,0,,0,0.00000000000000000000
chr6,57733728,57733844,116,-1,0,,0,0.00000000000000000000
chr6,57738612,57738721,109,-1,0,,0,0.00000000000000000000
chr6,57540682,57540785,103,-1,0,,0,0.00000000000000000000
chr6,58526247,58526316,69,-1,0,,0,0.00000000000000000000
chr6,57480808,57480875,67,-1,0,5558,1,1492.53731343284000000000
chr6,58773804,58780132,6328,-1,0,,0,0.00000000000000000000
chr6,58776769,58780132,3363,-1,0,,0,0.00000000000000000000
chr6,58774887,58777975,3088,-1,0,,0,0.00000000000000000000
chr6,61897843,61905970,8127,-1,0,,0,0.00000000000000000000
chr6,61901253,61904725,3472,-1,0,,0,0.00000000000000000000
chr6,61929300,61929702,402,-1,0,,0,0.00000000000000000000
chr6,62053907,62054395,488,-1,0,,0,0.00000000000000000000
chr6,62053994,62054315,321,-1,0,,0,0.00000000000000000000
chr6,62045444,62045602,158,-1,0,,0,0.00000000000000000000
chr6,61970762,61970859,97,-1,0,,0,0.00000000000000000000
chr6,62118670,62241126,122456,-1,0,,0,0.00000000000000000000
chr6,62183820,62254606,70786,-1,0,,0,0.00000000000000000000
chr6,62205721,62240706,34985,-1,0,,0,0.00000000000000000000
chr6,62200353,62206532,6179,-1,0,,0,0.00000000000000000000
chr6,62278883,62278959,76,-1,0,,0,0.00000000000000000000
chr6,62307637,62308321,684,-1,0,,0,0.00000000000000000000
chr6,62439078,62465366,26288,-1,0,202559,1,3.80401704199635000000
chr6,62486662,62927082,440420,-1,0,202559,1,0.22705599200762900000
chr6,62682638,62809877,127239,-1,0,202559,1,0.78592255519141200000
chr6,62924259,62929107,4848,-1,0,202559,1,20.62706270627060000000
chr6,62832616,62832846,230,-1,0,202559,1,434.78260869565200000000
chr6,62665357,62665525,168,-1,0,202559,1,595.23809523809500000000
chr6,62664601,62664753,152,-1,0,202559,1,657.89473684210500000000
chr6,62558377,62558498,121,-1,0,202559,1,826.44628099173600000000
chr6,63513337,63650892,137555,-1,0,,0,0.00000000000000000000
chr6,63583853,63601786,17933,-1,0,,0,0.00000000000000000000
chr6,63597436,63600347,2911,-1,0,,0,0.00000000000000000000
chr6,63563666,63566018,2352,-1,0,,0,0.00000000000000000000
chr6,63597636,63598982,1346,-1,0,,0,0.00000000000000000000
chr6,63842404,63849385,6981,-1,0,,0,0.00000000000000000000
chr6,63929831,63948936,19105,-1,0,,0,0.00000000000000000000
chr6,64206471,64209919,3448,-1,0,,0,0.00000000000000000000
chr6,64494530,64497098,2568,-1,0,346007,1,38.94080996884740000000
chr6,64666792,64668371,1579,-1,0,346007,1,63.33122229259020000000
chr6,64667009,64668266,1257,-1,0,346007,1,79.55449482895780000000
chr6,64910082,64912026,1944,-1,0,346007,1,51.44032921810700000000
chr6,65006419,65006515,96,-1,0,346007,1,1041.66666666667000000000
chr6,65014275,65014705,430,-1,0,346007,1,232.55813953488400000000
chr6,65521869,65703437,181568,-1,0,346007,1,0.55075784279168100000
chr6,66211536,66341102,129566,-1,0,346007,1,0.77180741861290800000
chr6,66396415,66488048,91633,-1,0,346007,1,1.09130989927210000000
chr6,65824625,65917326,92701,-1,0,346007,1,1.07873701470319000000
chr6,65637508,65709059,71551,-1,0,346007,1,1.39760450587693000000
chr6,65600598,65659173,58575,-1,0,346007,1,1.70721297481861000000
chr6,66382221,66424848,42627,-1,0,346007,1,2.34593098271049000000
chr6,65784904,65816881,31977,-1,0,346007,1,3.12724770929105000000
chr6,65860949,65894561,33612,-1,0,346007,1,2.97512793050101000000
chr6,66385674,66403839,18165,-1,0,346007,1,5.50509221029452000000
chr6,66399472,66414706,15234,-1,0,346007,1,6.56426414598923000000
chr6,66395553,66405305,9752,-1,0,346007,1,10.25430680885970000000
chr6,66399249,66404717,5468,-1,0,346007,1,18.28822238478420000000
chr6,66073918,66081482,7564,-1,0,346007,1,13.22051824431520000000
chr6,65710950,65715715,4765,-1,0,346007,1,20.98635886673660000000
chr6,65344078,65349288,5210,-1,0,346007,1,19.19385796545110000000
chr6,66022682,66027036,4354,-1,0,346007,1,22.96738631143780000000
chr6,65711486,65714754,3268,-1,0,346007,1,30.59975520195840000000
chr6,66401250,66404807,3557,-1,0,346007,1,28.11357885858870000000
chr6,66259916,66262274,2358,-1,0,346007,1,42.40882103477520000000
chr6,65347543,65349484,1941,-1,0,346007,1,51.51983513652760000000
chr6,66401861,66404888,3027,-1,0,346007,1,33.03600925008260000000
chr6,65347539,65349066,1527,-1,0,346007,1,65.48788474132290000000
chr6,66496631,66498024,1393,-1,0,,0,0.00000000000000000000
chr6,65909901,65910680,779,-1,0,346007,1,128.36970474967900000000
chr6,65348384,65349133,749,-1,0,346007,1,133.51134846461900000000
chr6,65768325,65768778,453,-1,0,346007,1,220.75055187638000000000
chr6,66274833,66275195,362,-1,0,346007,1,276.24309392265200000000
chr6,65185135,65185494,359,-1,0,346007,1,278.55153203342600000000
chr6,66188899,66189079,180,-1,0,346007,1,555.55555555555600000000
chr6,66188921,66189010,89,-1,0,346007,1,1123.59550561798000000000
chr6,66594516,66596232,1716,-1,0,,0,0.00000000000000000000
chr6,66595035,66595830,795,-1,0,,0,0.00000000000000000000
chr6,66911042,66915730,4688,-1,0,,0,0.00000000000000000000
chr6,67469750,68567477,1097727,-1,0,,0,0.00000000000000000000
chr6,66951097,67419710,468613,-1,0,,0,0.00000000000000000000
chr6,68230776,68450798,220022,-1,0,,0,0.00000000000000000000
chr6,67005162,67049278,44116,-1,0,,0,0.00000000000000000000
chr6,67017568,67043631,26063,-1,0,,0,0.00000000000000000000
chr6,68282542,68314049,31507,-1,0,,0,0.00000000000000000000
chr6,67025160,67049402,24242,-1,0,,0,0.00000000000000000000
chr6,68441030,68454198,13168,-1,0,,0,0.00000000000000000000
chr6,67012878,67031555,18677,-1,0,,0,0.00000000000000000000
chr6,67782976,67797012,14036,-1,0,,0,0.00000000000000000000
chr6,68101436,68112234,10798,-1,0,,0,0.00000000000000000000
chr6,67589164,67595001,5837,-1,0,,0,0.00000000000000000000
chr6,67853527,67858925,5398,-1,0,,0,0.00000000000000000000
chr6,67060061,67064155,4094,-1,0,,0,0.00000000000000000000
chr6,67210350,67215491,5141,-1,0,,0,0.00000000000000000000
chr6,67430778,67434919,4141,-1,0,,0,0.00000000000000000000
chr6,67942695,67946878,4183,-1,0,,0,0.00000000000000000000
chr6,67971645,67974165,2520,-1,0,,0,0.00000000000000000000
chr6,67040805,67043184,2379,-1,0,,0,0.00000000000000000000
chr6,67770193,67772499,2306,-1,0,,0,0.00000000000000000000
chr6,67024956,67027284,2328,-1,0,,0,0.00000000000000000000
chr6,68142747,68144010,1263,-1,0,,0,0.00000000000000000000
chr6,67042086,67043333,1247,-1,0,,0,0.00000000000000000000
chr6,67325064,67326026,962,-1,0,,0,0.00000000000000000000
chr6,68141850,68142478,628,-1,0,,0,0.00000000000000000000
chr6,66937690,66938462,772,-1,0,,0,0.00000000000000000000
chr6,67042415,67043215,800,-1,0,,0,0.00000000000000000000
chr6,67235180,67235721,541,-1,0,,0,0.00000000000000000000
chr6,67111011,67111370,359,-1,0,,0,0.00000000000000000000
chr6,67866018,67866391,373,-1,0,,0,0.00000000000000000000
chr6,67235262,67235605,343,-1,0,,0,0.00000000000000000000
chr6,68353221,68353507,286,-1,0,,0,0.00000000000000000000
chr6,68223035,68223314,279,-1,0,,0,0.00000000000000000000
chr6,68334707,68334857,150,-1,0,,0,0.00000000000000000000
chr6,69138427,69139375,948,-1,0,,0,0.00000000000000000000
chr6,69142163,69143107,944,-1,0,,0,0.00000000000000000000
chr6,69406911,69413364,6453,-1,0,577,1,15.49666821633350000000
chr6,69371367,69371450,83,-1,0,577,1,1204.81927710843000000000
chr6,69471188,69471717,529,-1,0,577,1,189.03591682419700000000
chr6,69685424,69695144,9720,-1,0,577,1,10.28806584362140000000
chr6,69683110,69691846,8736,-1,0,577,1,11.44688644688640000000
chr6,69687540,69691816,4276,-1,0,577,1,23.38634237605240000000
chr6,69794623,69797621,2998,-1,0,577,1,33.35557038025350000000
chr6,70013910,70018437,4527,-1,0,577,1,22.08968411751710000000
chr6,70109913,70111785,1872,-1,0,,0,0.00000000000000000000
chr6,70191041,70200534,9493,-1,0,,0,0.00000000000000000000
chr6,70190684,70192279,1595,-1,0,,0,0.00000000000000000000
chr6,70212269,70213847,1578,-1,0,,0,0.00000000000000000000
chr6,70332515,70333434,919,-1,0,,0,0.00000000000000000000
chr6,70378046,70379199,1153,-1,0,,0,0.00000000000000000000
chr6,70720213,70726297,6084,-1,0,1310,1,16.43655489809340000000
chr6,71056691,71057255,564,-1,0,,0,0.00000000000000000000
chr6,71333315,71334229,914,-1,0,,0,0.00000000000000000000
chr6,71598996,71601670,2674,-1,0,135152,1,37.39715781600600000000
chr6,71639666,71651965,12299,-1,0,135152,1,8.13074233677535000000
chr6,71738171,71739003,832,-1,0,,0,0.00000000000000000000
chr6,71738440,71738751,311,-1,0,,0,0.00000000000000000000
chr6,71975102,71977198,2096,-1,0,,0,0.00000000000000000000
chr6,72227083,72227729,646,-1,0,,0,0.00000000000000000000
chr6,72339471,72340574,1103,-1,0,,0,0.00000000000000000000
chr6,72542507,72542696,189,-1,0,,0,0.00000000000000000000
chr6,72571321,72571871,550,-1,0,,0,0.00000000000000000000
chr6,72571436,72571769,333,-1,0,,0,0.00000000000000000000
chr6,72585297,72585809,512,-1,0,,0,0.00000000000000000000
chr6,72585353,72585726,373,-1,0,,0,0.00000000000000000000
chr6,72585455,72585540,85,-1,0,,0,0.00000000000000000000
chr6,72620214,72620666,452,-1,0,22999,1,221.23893805309700000000
chr6,72827643,72834477,6834,-1,0,22999,1,14.63271875914540000000
chr6,72863666,72873628,9962,-1,0,22999,1,10.03814495081310000000
chr6,72861948,72868290,6342,-1,0,22999,1,15.76789656259850000000
chr6,72863806,72868550,4744,-1,0,22999,1,21.07925801011800000000
chr6,72863798,72867828,4030,-1,0,22999,1,24.81389578163770000000
chr6,73151747,73152415,668,-1,0,,0,0.00000000000000000000
chr6,73152037,73152154,117,-1,0,,0,0.00000000000000000000
chr6,73221984,73222806,822,-1,0,,0,0.00000000000000000000
chr6,73361994,73365203,3209,-1,0,56479,1,31.16235587410410000000
chr6,73650887,73651314,427,-1,0,56479,1,234.19203747072600000000
chr6,73651268,73651678,410,-1,0,56479,1,243.90243902439000000000
chr6,73651015,73651198,183,-1,0,56479,1,546.44808743169400000000
chr6,73651053,73651106,53,-1,0,56479,1,1886.79245283019000000000
chr6,73728748,73729951,1203,-1,0,56479,1,83.12551953449710000000
chr6,73980153,73982423,2270,-1,0,80759,1,44.05286343612340000000
chr6,74050354,74051729,1375,-1,0,,0,0.00000000000000000000
chr6,74139307,74140582,1275,-1,0,115004,1,78.43137254901960000000
chr6,74156141,74156634,493,-1,0,115004,1,202.83975659229200000000
chr6,74156166,74156491,325,-1,0,115004,1,307.69230769230800000000
chr6,74187741,74189036,1295,-1,0,25821,1,77.22007722007720000000
chr6,74232260,74232369,109,-1,0,,0,0.00000000000000000000
chr6,74340583,74342636,2053,-1,0,26503,1,48.70920603994150000000
chr6,74421138,74421668,530,-1,0,135228,1,188.67924528301900000000
chr6,74421259,74421577,318,-1,0,135228,1,314.46540880503100000000
chr6,74591971,74602405,10434,-1,0,,0,0.00000000000000000000
chr6,74592410,74602711,10301,-1,0,,0,0.00000000000000000000
chr6,74592137,74600530,8393,-1,0,,0,0.00000000000000000000
chr6,74613584,74620413,6829,-1,0,,0,0.00000000000000000000
chr6,74741795,74791178,49383,-1,0,,0,0.00000000000000000000
chr6,74818497,74819227,730,-1,0,,0,0.00000000000000000000
chr6,74831563,74851896,20333,-1,0,,0,0.00000000000000000000
chr6,74832464,74833463,999,-1,0,,0,0.00000000000000000000
chr6,74832503,74833459,956,-1,0,,0,0.00000000000000000000
chr6,74849680,74849812,132,-1,0,,0,0.00000000000000000000
chr6,74865431,74866584,1153,-1,0,,0,0.00000000000000000000
chr6,74865454,74866584,1130,-1,0,,0,0.00000000000000000000
chr6,74868414,74869550,1136,-1,0,,0,0.00000000000000000000
chr6,74932709,74933071,362,-1,0,,0,0.00000000000000000000
chr6,75040090,75040185,95,-1,0,,0,0.00000000000000000000
chr6,75303881,75304335,454,-1,0,,0,0.00000000000000000000
chr6,75957697,75958173,476,-1,0,,0,0.00000000000000000000
chr6,75957791,75958126,335,-1,0,,0,0.00000000000000000000
chr6,76153719,76162499,8780,-1,0,27145,1,11.38952164009110000000
chr6,76155426,76161260,5834,-1,0,27145,1,17.14089818306480000000
chr6,76242120,76266538,24418,-1,0,,0,0.00000000000000000000
chr6,76401195,76402886,1691,-1,0,26054,1,59.13660555884090000000
chr6,76687412,76687985,573,-1,0,3617,1,174.52006980802800000000
chr6,76746337,76746750,413,-1,0,3617,1,242.13075060532700000000
chr6,76746477,76746651,174,-1,0,3617,1,574.71264367816100000000
chr6,76746505,76746590,85,-1,0,3617,1,1176.47058823529000000000
chr6,77011008,77028098,17090,-1,0,,0,0.00000000000000000000
chr6,76884359,76904095,19736,-1,0,,0,0.00000000000000000000
chr6,77016707,77029160,12453,-1,0,,0,0.00000000000000000000
chr6,77016666,77025721,9055,-1,0,,0,0.00000000000000000000
chr6,77097456,77102667,5211,-1,0,,0,0.00000000000000000000
chr6,77022510,77027564,5054,-1,0,,0,0.00000000000000000000
chr6,77097567,77100304,2737,-1,0,,0,0.00000000000000000000
chr6,77098103,77099368,1265,-1,0,,0,0.00000000000000000000
chr6,77220540,77221637,1097,-1,0,,0,0.00000000000000000000
chr6,77266328,77266759,431,-1,0,,0,0.00000000000000000000
chr6,77266527,77266620,93,-1,0,,0,0.00000000000000000000
chr6,77309410,77327865,18455,-1,0,,0,0.00000000000000000000
chr6,77315710,77327851,12141,-1,0,,0,0.00000000000000000000
chr6,77435708,77459879,24171,-1,0,,0,0.00000000000000000000
chr6,77438041,77460052,22011,-1,0,,0,0.00000000000000000000
chr6,77437425,77453258,15833,-1,0,,0,0.00000000000000000000
chr6,77449468,77452784,3316,-1,0,,0,0.00000000000000000000
chr6,77865249,77875779,10530,-1,0,,0,0.00000000000000000000
chr6,78009186,78011975,2789,-1,0,,0,0.00000000000000000000
chr6,77624033,77625803,1770,-1,0,,0,0.00000000000000000000
chr6,77920011,77920531,520,-1,0,,0,0.00000000000000000000
chr6,77920107,77920427,320,-1,0,,0,0.00000000000000000000
chr6,78312346,78312523,177,-1,0,,0,0.00000000000000000000
chr6,78325003,78334725,9722,-1,0,,0,0.00000000000000000000
chr6,78426682,78436138,9456,-1,0,101928601,1,10.57529610829100000000
chr6,78440510,78446725,6215,-1,0,101928601,1,16.09010458567980000000
chr6,78353868,78356980,3112,-1,0,,0,0.00000000000000000000
chr6,78892808,79053430,160622,-1,0,,0,0.00000000000000000000
chr6,78967140,79036517,69377,-1,0,,0,0.00000000000000000000
chr6,78974978,79013477,38499,-1,0,,0,0.00000000000000000000
chr6,78997863,79032195,34332,-1,0,,0,0.00000000000000000000
chr6,78965525,79000103,34578,-1,0,,0,0.00000000000000000000
chr6,78987659,79013765,26106,-1,0,,0,0.00000000000000000000
chr6,79011451,79032882,21431,-1,0,,0,0.00000000000000000000
chr6,78879306,78901499,22193,-1,0,,0,0.00000000000000000000
chr6,79003749,79022558,18809,-1,0,,0,0.00000000000000000000
chr6,79012441,79026731,14290,-1,0,,0,0.00000000000000000000
chr6,79172836,79173656,820,-1,0,,0,0.00000000000000000000
chr6,79521080,79530704,9624,-1,0,,0,0.00000000000000000000
chr6,79520897,79528198,7301,-1,0,,0,0.00000000000000000000
chr6,79520975,79524760,3785,-1,0,,0,0.00000000000000000000
chr6,79887601,79891475,3874,-1,0,,0,0.00000000000000000000
chr6,80159451,80161340,1889,-1,0,,0,0.00000000000000000000
chr6,80556246,80570701,14455,-1,0,,0,0.00000000000000000000
chr6,80705219,80709197,3978,-1,0,,0,0.00000000000000000000
chr6,80993708,80999799,6091,-1,0,594,1,16.41766540797900000000
chr6,81168496,81174215,5719,-1,0,,0,0.00000000000000000000
chr6,81194746,81195390,644,-1,0,,0,0.00000000000000000000
chr6,81276565,81293502,16937,-1,0,,0,0.00000000000000000000
chr6,81283722,81293585,9863,-1,0,,0,0.00000000000000000000
chr6,81284601,81289416,4815,-1,0,,0,0.00000000000000000000
chr6,81343812,81348464,4652,-1,0,,0,0.00000000000000000000
chr6,81470586,81470975,389,-1,0,,0,0.00000000000000000000
chr6,81507242,81514132,6890,-1,0,,0,0.00000000000000000000
chr6,81602198,81731035,128837,-1,0,,0,0.00000000000000000000
chr6,81625966,81630664,4698,-1,0,,0,0.00000000000000000000
chr6,81852391,81853898,1507,-1,0,,0,0.00000000000000000000
chr6,81977975,81981467,3492,-1,0,,0,0.00000000000000000000
chr6,82094015,82096443,2428,-1,0,,0,0.00000000000000000000
chr6,82116896,82119882,2986,-1,0,,0,0.00000000000000000000
chr6,82124621,82125891,1270,-1,0,,0,0.00000000000000000000
chr6,82149005,82175381,26376,-1,0,,0,0.00000000000000000000
chr6,82176340,82176955,615,-1,0,,0,0.00000000000000000000
chr6,82178252,82178406,154,-1,0,,0,0.00000000000000000000
chr6,82178128,82178319,191,-1,0,,0,0.00000000000000000000
chr6,82388892,82395749,6857,-1,0,,0,0.00000000000000000000
chr6,82386126,82387173,1047,-1,0,,0,0.00000000000000000000
chr6,82647557,82656912,9355,-1,0,,0,0.00000000000000000000
chr6,83115580,83200896,85316,-1,0,,0,0.00000000000000000000
chr6,83094463,83094881,418,-1,0,,0,0.00000000000000000000
chr6,83510517,83511753,1236,-1,0,,0,0.00000000000000000000
chr6,83675961,83676501,540,-1,0,90025,1,185.18518518518500000000
chr6,83676073,83676386,313,-1,0,90025,1,319.48881789137400000000
chr6,83735439,83737022,1583,-1,0,90025,1,63.17119393556540000000
chr6,84021461,84039054,17593,-1,0,4199,1,5.68407889501506000000
chr6,84092494,84096573,4079,-1,0,4199,1,24.51581269919100000000
chr6,84141507,84152303,10796,-1,0,,0,0.00000000000000000000
chr6,84734607,84739291,4684,-1,0,,0,0.00000000000000000000
chr6,84922198,84922946,748,-1,0,22832,1,133.68983957219300000000
chr6,84958644,84959006,362,-1,0,,0,0.00000000000000000000
chr6,85317957,85324410,6453,-1,0,,0,0.00000000000000000000
chr6,85220358,85220961,603,-1,0,,0,0.00000000000000000000
chr6,86026247,86026834,587,-1,0,,0,0.00000000000000000000
chr6,86026352,86026677,325,-1,0,,0,0.00000000000000000000
chr6,86116795,86126132,9337,-1,0,,0,0.00000000000000000000
chr6,86144211,86144756,545,-1,0,,0,0.00000000000000000000
chr6,86144298,86144632,334,-1,0,,0,0.00000000000000000000
chr6,86372928,86373942,1014,-1,0,,0,0.00000000000000000000
chr6,86474368,86548622,74254,-1,0,,0,0.00000000000000000000
chr6,86544550,86572487,27937,-1,0,,0,0.00000000000000000000
chr6,86624129,86631912,7783,-1,0,,0,0.00000000000000000000
chr6,86623853,86625880,2027,-1,0,,0,0.00000000000000000000
chr6,86624129,86624900,771,-1,0,,0,0.00000000000000000000
chr6,86708737,86714791,6054,-1,0,,0,0.00000000000000000000
chr6,87028071,87031467,3396,-1,0,,0,0.00000000000000000000
chr6,87074063,87082969,8906,-1,0,,0,0.00000000000000000000
chr6,87108978,87114011,5033,-1,0,,0,0.00000000000000000000
chr6,87181720,87183193,1473,-1,0,,0,0.00000000000000000000
chr6,87222966,87232695,9729,-1,0,,0,0.00000000000000000000
chr6,87306219,87317382,11163,-1,0,,0,0.00000000000000000000
chr6,87367194,87528670,161476,-1,0,,0,0.00000000000000000000
chr6,87371647,87412382,40735,-1,0,,0,0.00000000000000000000
chr6,87392505,87412347,19842,-1,0,,0,0.00000000000000000000
chr6,87405761,87418079,12318,-1,0,,0,0.00000000000000000000
chr6,87346691,87358385,11694,-1,0,,0,0.00000000000000000000
chr6,87399755,87411026,11271,-1,0,,0,0.00000000000000000000
chr6,87406640,87412973,6333,-1,0,,0,0.00000000000000000000
chr6,87346919,87351740,4821,-1,0,,0,0.00000000000000000000
chr6,87409791,87411086,1295,-1,0,,0,0.00000000000000000000
chr6,87838371,87838455,84,-1,0,,0,0.00000000000000000000
chr6,88032749,88032838,89,-1,0,57150;375519,2,2247.19101123596000000000
chr6,88117989,88118508,519,-1,0,154313,1,192.67822736030800000000
chr6,88118184,88118324,140,-1,0,154313,1,714.28571428571400000000
chr6,88284583,88287168,2585,-1,0,57038,1,38.68471953578340000000
chr6,88285742,88286284,542,-1,0,57038,1,184.50184501845000000000
chr6,88320197,88320551,354,-1,0,23595,1,282.48587570621500000000
chr6,88426299,88429362,3063,-1,0,,0,0.00000000000000000000
chr6,88651308,88651380,72,-1,0,,0,0.00000000000000000000
chr6,88731225,88733297,2072,-1,0,,0,0.00000000000000000000
chr6,88801028,88802777,1749,-1,0,,0,0.00000000000000000000
chr6,88801147,88802416,1269,-1,0,,0,0.00000000000000000000
chr6,88833874,88838936,5062,-1,0,,0,0.00000000000000000000
chr6,89424151,89424460,309,-1,0,8732,1,323.62459546925600000000
chr6,89491190,89492316,1126,-1,0,8732,1,88.80994671403200000000
chr6,89499971,89501021,1050,-1,0,8732,1,95.23809523809520000000
chr6,89706747,89707600,853,-1,0,,0,0.00000000000000000000
chr6,89841956,89846888,4932,-1,0,,0,0.00000000000000000000
chr6,89921680,89922196,516,-1,0,2569,1,193.79844961240300000000
chr6,90317539,90317665,126,-1,0,22881,1,793.65079365079400000000
chr6,90506531,90509910,3379,-1,0,23195,1,29.59455460195320000000
chr6,91005093,91006843,1750,-1,0,60468,1,57.14285714285710000000
chr6,91237448,91238013,565,-1,0,6885,1,176.99115044247800000000
chr6,91237590,91237911,321,-1,0,6885,1,311.52647975077900000000
chr6,91358818,91360324,1506,-1,0,,0,0.00000000000000000000
chr6,91423876,91425108,1232,-1,0,,0,0.00000000000000000000
chr6,91798754,91800573,1819,-1,0,,0,0.00000000000000000000
chr6,91985320,92118947,133627,-1,0,,0,0.00000000000000000000
chr6,91989968,91998886,8918,-1,0,,0,0.00000000000000000000
chr6,92180852,92181228,376,-1,0,,0,0.00000000000000000000
chr6,92345756,92347759,2003,-1,0,,0,0.00000000000000000000
chr6,92807928,92808338,410,-1,0,,0,0.00000000000000000000
chr6,92807980,92808323,343,-1,0,,0,0.00000000000000000000
chr6,92861023,92862448,1425,-1,0,,0,0.00000000000000000000
chr6,92910613,92911031,418,-1,0,,0,0.00000000000000000000
chr6,93183733,93184214,481,-1,0,,0,0.00000000000000000000
chr6,93367653,93394168,26515,-1,0,,0,0.00000000000000000000
chr6,93524543,93524772,229,-1,0,,0,0.00000000000000000000
chr6,93575067,93587053,11986,-1,0,,0,0.00000000000000000000
chr6,93575089,93580012,4923,-1,0,,0,0.00000000000000000000
chr6,93575151,93578894,3743,-1,0,,0,0.00000000000000000000
chr6,93596266,93599321,3055,-1,0,,0,0.00000000000000000000
chr6,93778169,93778284,115,-1,0,,0,0.00000000000000000000
chr6,93834771,93835167,396,-1,0,,0,0.00000000000000000000
chr6,93834938,93835000,62,-1,0,,0,0.00000000000000000000
chr6,94703537,95217914,514377,-1,0,,0,0.00000000000000000000
chr6,95418678,95589444,170766,-1,0,,0,0.00000000000000000000
chr6,95317867,95494518,176651,-1,0,,0,0.00000000000000000000
chr6,95083398,95254586,171188,-1,0,,0,0.00000000000000000000
chr6,95522499,95657793,135294,-1,0,,0,0.00000000000000000000
chr6,94929983,95059256,129273,-1,0,,0,0.00000000000000000000
chr6,95411095,95530219,119124,-1,0,,0,0.00000000000000000000
chr6,94473313,94581753,108440,-1,0,,0,0.00000000000000000000
chr6,95495888,95571616,75728,-1,0,,0,0.00000000000000000000
chr6,95195457,95271886,76429,-1,0,,0,0.00000000000000000000
chr6,95579575,95674210,94635,-1,0,,0,0.00000000000000000000
chr6,95462701,95512251,49550,-1,0,,0,0.00000000000000000000
chr6,95523244,95592727,69483,-1,0,,0,0.00000000000000000000
chr6,95356219,95407230,51011,-1,0,,0,0.00000000000000000000
chr6,95571374,95626690,55316,-1,0,,0,0.00000000000000000000
chr6,95513624,95560894,47270,-1,0,,0,0.00000000000000000000
chr6,95435352,95487273,51921,-1,0,,0,0.00000000000000000000
chr6,95648649,95679402,30753,-1,0,,0,0.00000000000000000000
chr6,95500120,95533738,33618,-1,0,,0,0.00000000000000000000
chr6,95339061,95359921,20860,-1,0,,0,0.00000000000000000000
chr6,94581924,94592955,11031,-1,0,,0,0.00000000000000000000
chr6,94546228,94553596,7368,-1,0,,0,0.00000000000000000000
chr6,94963053,94969110,6057,-1,0,,0,0.00000000000000000000
chr6,95288315,95292444,4129,-1,0,,0,0.00000000000000000000
chr6,95134197,95139449,5252,-1,0,,0,0.00000000000000000000
chr6,94539951,94545085,5134,-1,0,,0,0.00000000000000000000
chr6,94973307,94977886,4579,-1,0,,0,0.00000000000000000000
chr6,95289148,95291835,2687,-1,0,,0,0.00000000000000000000
chr6,95193323,95194337,1014,-1,0,,0,0.00000000000000000000
chr6,94734494,94735844,1350,-1,0,,0,0.00000000000000000000
chr6,95193347,95194309,962,-1,0,,0,0.00000000000000000000
chr6,95335506,95336045,539,-1,0,,0,0.00000000000000000000
chr6,95400637,95401118,481,-1,0,,0,0.00000000000000000000
chr6,95658798,95659244,446,-1,0,,0,0.00000000000000000000
chr6,95335622,95335937,315,-1,0,,0,0.00000000000000000000
chr6,95177103,95177355,252,-1,0,,0,0.00000000000000000000
chr6,94657358,94657534,176,-1,0,,0,0.00000000000000000000
chr6,94837973,94838064,91,-1,0,,0,0.00000000000000000000
chr6,95400826,95400921,95,-1,0,,0,0.00000000000000000000
chr6,95932442,96050019,117577,-1,0,79694,1,0.85050647660681900000
chr6,96387601,96389422,1821,-1,0,,0,0.00000000000000000000
chr6,96545276,96547122,1846,-1,0,10690,1,54.17118093174430000000
chr6,96580133,96580235,102,-1,0,10690,1,980.39215686274500000000
chr6,96852810,96853152,342,-1,0,,0,0.00000000000000000000
chr6,96964381,96965669,1288,-1,0,,0,0.00000000000000000000
chr6,97160237,97160467,230,-1,0,,0,0.00000000000000000000
chr6,97194914,97210787,15873,-1,0,,0,0.00000000000000000000
chr6,97468045,97470534,2489,-1,0,114792,1,40.17677782241860000000
chr6,97487336,97487711,375,-1,0,114792,1,266.66666666666700000000
chr6,97487390,97487606,216,-1,0,114792,1,462.96296296296300000000
chr6,97504971,97505494,523,-1,0,114792,1,191.20458891013400000000
chr6,97505053,97505370,317,-1,0,114792,1,315.45741324921100000000
chr6,98132878,98136973,4095,-1,0,,0,0.00000000000000000000
chr6,98331498,98392312,60814,-1,0,,0,0.00000000000000000000
chr6,98404271,98404881,610,-1,0,,0,0.00000000000000000000
chr6,98416729,98418537,1808,-1,0,,0,0.00000000000000000000
chr6,98479264,98487202,7938,-1,0,,0,0.00000000000000000000
chr6,98598906,98611418,12512,-1,0,,0,0.00000000000000000000
chr6,98595581,98598036,2455,-1,0,,0,0.00000000000000000000
chr6,98693600,98698546,4946,-1,0,,0,0.00000000000000000000
chr6,99967184,99972552,5368,-1,0,100130890,1,18.62891207153500000000
chr6,100034243,100035684,1441,-1,0,,0,0.00000000000000000000
chr6,99389133,99391106,1973,-1,0,26235,1,50.68423720223010000000
chr6,100034542,100035354,812,-1,0,,0,0.00000000000000000000
chr6,99142462,99143345,883,-1,0,,0,0.00000000000000000000
chr6,100259982,100260438,456,-1,0,,0,0.00000000000000000000
chr6,100260118,100260282,164,-1,0,,0,0.00000000000000000000
chr6,100066822,100066891,69,-1,0,,0,0.00000000000000000000
chr6,100404352,100409223,4871,-1,0,84539,1,20.52966536645450000000
chr6,100475779,100480535,4756,-1,0,,0,0.00000000000000000000
chr6,100297524,100297574,50,-1,0,,0,0.00000000000000000000
chr6,100537545,100540392,2847,-1,0,,0,0.00000000000000000000
chr6,100537902,100539252,1350,-1,0,,0,0.00000000000000000000
chr6,101380108,101384969,4861,-1,0,,0,0.00000000000000000000
chr6,101482770,101487006,4236,-1,0,,0,0.00000000000000000000
chr6,101494425,101496588,2163,-1,0,,0,0.00000000000000000000
chr6,101595788,101596140,352,-1,0,,0,0.00000000000000000000
chr6,101618210,101644329,26119,-1,0,,0,0.00000000000000000000
chr6,101776932,101778758,1826,-1,0,,0,0.00000000000000000000
chr6,101933292,101939973,6681,-1,0,2898,1,14.96781918874420000000
chr6,101934904,101939750,4846,-1,0,2898,1,20.63557573256290000000
chr6,101933764,101937905,4141,-1,0,2898,1,24.14875633904850000000
chr6,102307659,102313477,5818,-1,0,2898,1,17.18803712616020000000
chr6,102314598,102319512,4914,-1,0,2898,1,20.35002035002030000000
chr6,102418494,102419108,614,-1,0,2898,1,162.86644951140100000000
chr6,102546989,102556944,9955,-1,0,,0,0.00000000000000000000
chr6,102814992,102815873,881,-1,0,,0,0.00000000000000000000
chr6,102880342,102883148,2806,-1,0,,0,0.00000000000000000000
chr6,102911687,102912317,630,-1,0,,0,0.00000000000000000000
chr6,103130761,103155379,24618,-1,0,,0,0.00000000000000000000
chr6,103263992,103264443,451,-1,0,,0,0.00000000000000000000
chr6,103514100,103567640,53540,-1,0,,0,0.00000000000000000000
chr6,103456540,103459971,3431,-1,0,,0,0.00000000000000000000
chr6,103585654,103588040,2386,-1,0,,0,0.00000000000000000000
chr6,103654875,103658406,3531,-1,0,,0,0.00000000000000000000
chr6,103737440,103763167,25727,-1,0,,0,0.00000000000000000000
chr6,103738134,103759767,21633,-1,0,,0,0.00000000000000000000
chr6,103746513,103760772,14259,-1,0,,0,0.00000000000000000000
chr6,103744283,103754474,10191,-1,0,,0,0.00000000000000000000
chr6,103752105,103761918,9813,-1,0,,0,0.00000000000000000000
chr6,103762970,103763134,164,-1,0,,0,0.00000000000000000000
chr6,103988618,103994755,6137,-1,0,,0,0.00000000000000000000
chr6,103990087,103993815,3728,-1,0,,0,0.00000000000000000000
chr6,104136137,104140635,4498,-1,0,,0,0.00000000000000000000
chr6,104183158,104183568,410,-1,0,,0,0.00000000000000000000
chr6,104183149,104183484,335,-1,0,,0,0.00000000000000000000
chr6,104188329,104188391,62,-1,0,,0,0.00000000000000000000
chr6,104228565,104228916,351,-1,0,,0,0.00000000000000000000
chr6,104463737,104468688,4951,-1,0,,0,0.00000000000000000000
chr6,104634901,104634957,56,-1,0,,0,0.00000000000000000000
chr6,104905477,104943368,37891,-1,0,,0,0.00000000000000000000
chr6,104872066,104872257,191,-1,0,,0,0.00000000000000000000
chr6,105175103,105175747,644,-1,0,,0,0.00000000000000000000
chr6,105175425,105175631,206,-1,0,,0,0.00000000000000000000
chr6,105221889,105222388,499,-1,0,57531,1,200.40080160320600000000
chr6,105259830,105271408,11578,-1,0,57531,1,8.63707030575229000000
chr6,105260871,105265154,4283,-1,0,57531,1,23.34812047630170000000
chr6,105260861,105262595,1734,-1,0,57531,1,57.67012687427910000000
chr6,105388369,105389996,1627,-1,0,,0,0.00000000000000000000
chr6,105567746,105568300,554,-1,0,11149,1,180.50541516245500000000
chr6,105567845,105568174,329,-1,0,11149,1,303.95136778115500000000
chr6,105619597,105620665,1068,-1,0,64208,1,93.63295880149810000000
chr6,106154647,106157562,2915,-1,0,,0,0.00000000000000000000
chr6,106279762,106305971,26209,-1,0,,0,0.00000000000000000000
chr6,106357260,106357790,530,-1,0,,0,0.00000000000000000000
chr6,106357484,106357539,55,-1,0,,0,0.00000000000000000000
chr6,106403838,106406223,2385,-1,0,,0,0.00000000000000000000
chr6,106454178,106455428,1250,-1,0,,0,0.00000000000000000000
chr6,106824386,106829362,4976,-1,0,,0,0.00000000000000000000
chr6,106928724,106929304,580,-1,0,,0,0.00000000000000000000
chr6,106928821,106929149,328,-1,0,,0,0.00000000000000000000
chr6,106983539,106984051,512,-1,0,202,1,195.31250000000000000000
chr6,106983636,106983955,319,-1,0,202,1,313.47962382445100000000
chr6,107007216,107008683,1467,-1,0,202,1,68.16632583503750000000
chr6,107015927,107015977,50,-1,0,202,1,2000.00000000000000000000
chr6,107045499,107049047,3548,-1,0,84816,1,28.18489289740700000000
chr6,107124407,107124965,558,-1,0,,0,0.00000000000000000000
chr6,107124531,107124847,316,-1,0,,0,0.00000000000000000000
chr6,107581112,107584618,3506,-1,0,57107,1,28.52253280091270000000
chr6,107544298,107546470,2172,-1,0,57107,1,46.04051565377530000000
chr6,107435603,107436858,1255,-1,0,57673,1,79.68127490039840000000
chr6,108031203,108032564,1361,-1,0,256380,1,73.47538574577520000000
chr6,108117324,108119141,1817,-1,0,256380,1,55.03577325261420000000
chr6,108247920,108248755,835,-1,0,11231,1,119.76047904191600000000
chr6,108266097,108266545,448,-1,0,11231,1,223.21428571428600000000
chr6,108266110,108266419,309,-1,0,11231,1,323.62459546925600000000
chr6,108333870,108334089,219,-1,0,,0,0.00000000000000000000
chr6,108610562,108615105,4543,-1,0,,0,0.00000000000000000000
chr6,108610886,108613924,3038,-1,0,,0,0.00000000000000000000
chr6,108614257,108614618,361,-1,0,,0,0.00000000000000000000
chr6,108823328,108823560,232,-1,0,246269,1,431.03448275862100000000
chr6,108878970,108883212,4242,-1,0,2309,1,23.57378595002360000000
chr6,109040064,109040382,318,-1,0,,0,0.00000000000000000000
chr6,109078383,109083218,4835,-1,0,,0,0.00000000000000000000
chr6,109210449,109211620,1171,-1,0,84071,1,85.39709649871900000000
chr6,109252073,109253959,1886,-1,0,84071,1,53.02226935312830000000
chr6,109851787,109998454,146667,-1,0,221264,1,0.68181663223492700000
chr6,110172695,110174429,1734,-1,0,,0,0.00000000000000000000
chr6,110234345,110234610,265,-1,0,,0,0.00000000000000000000
chr6,110395252,110414864,19612,-1,0,,0,0.00000000000000000000
chr6,110400145,110417242,17097,-1,0,,0,0.00000000000000000000
chr6,110476725,110479767,3042,-1,0,8936,1,32.87310979618670000000
chr6,110569659,110572542,2883,-1,0,728464,1,34.68609087755810000000
chr6,110569840,110571595,1755,-1,0,728464,1,56.98005698005700000000
chr6,110602909,110603959,1050,-1,0,728464,1,95.23809523809520000000
chr6,110623559,110623945,386,-1,0,728464,1,259.06735751295300000000
chr6,111071012,111071568,556,-1,0,23097,1,179.85611510791400000000
chr6,111168560,111169534,974,-1,0,262,1,102.66940451745400000000
chr6,111295209,111295517,308,-1,0,,0,0.00000000000000000000
chr6,111942226,111944733,2507,-1,0,,0,0.00000000000000000000
chr6,112171975,112175597,3622,-1,0,2534,1,27.60905577029270000000
chr6,112203727,112204315,588,-1,0,,0,0.00000000000000000000
chr6,112203847,112204194,347,-1,0,,0,0.00000000000000000000
chr6,112224194,112229922,5728,-1,0,,0,0.00000000000000000000
chr6,112645056,112645826,770,-1,0,,0,0.00000000000000000000
chr6,112769860,112770282,422,-1,0,,0,0.00000000000000000000
chr6,112875191,112879501,4310,-1,0,,0,0.00000000000000000000
chr6,113350588,113350859,271,-1,0,,0,0.00000000000000000000
chr6,113350641,113350804,163,-1,0,,0,0.00000000000000000000
chr6,113368548,113371449,2901,-1,0,,0,0.00000000000000000000
chr6,113645144,113651019,5875,-1,0,,0,0.00000000000000000000
chr6,113700958,113703167,2209,-1,0,,0,0.00000000000000000000
chr6,113701944,113703002,1058,-1,0,,0,0.00000000000000000000
chr6,113899549,113899705,156,-1,0,,0,0.00000000000000000000
chr6,114223385,114225122,1737,-1,0,,0,0.00000000000000000000
chr6,114223973,114225052,1079,-1,0,,0,0.00000000000000000000
chr6,114663097,114665140,2043,-1,0,,0,0.00000000000000000000
chr6,114675357,114683591,8234,-1,0,,0,0.00000000000000000000
chr6,114865759,114870655,4896,-1,0,,0,0.00000000000000000000
chr6,114963522,114965388,1866,-1,0,,0,0.00000000000000000000
chr6,115049875,115106783,56908,-1,0,,0,0.00000000000000000000
chr6,115168753,115169511,758,-1,0,,0,0.00000000000000000000
chr6,115352631,115358419,5788,-1,0,,0,0.00000000000000000000
chr6,115379157,115379497,340,-1,0,,0,0.00000000000000000000
chr6,115379162,115379379,217,-1,0,,0,0.00000000000000000000
chr6,115703966,115718359,14393,-1,0,,0,0.00000000000000000000
chr6,115662020,115664705,2685,-1,0,,0,0.00000000000000000000
chr6,115776113,115778189,2076,-1,0,,0,0.00000000000000000000
chr6,115642570,115643688,1118,-1,0,,0,0.00000000000000000000
chr6,115624480,115624910,430,-1,0,,0,0.00000000000000000000
chr6,115624542,115624873,331,-1,0,,0,0.00000000000000000000
chr6,116750742,116751211,469,-1,0,29940,1,213.21961620469100000000
chr6,116750814,116751132,318,-1,0,29940,1,314.46540880503100000000
chr6,117069667,117071681,2014,-1,0,,0,0.00000000000000000000
chr6,117093262,117097777,4515,-1,0,,0,0.00000000000000000000
chr6,117499634,117575985,76351,-1,0,,0,0.00000000000000000000
chr6,117780356,117780870,514,-1,0,,0,0.00000000000000000000
chr6,117780555,117780657,102,-1,0,,0,0.00000000000000000000
chr6,117837811,117839698,1887,-1,0,285761,1,52.99417064122950000000
chr6,117846525,117850626,4101,-1,0,285761,1,24.38429651304560000000
chr6,118077183,118084808,7625,-1,0,,0,0.00000000000000000000
chr6,118115715,118143800,28085,-1,0,,0,0.00000000000000000000
chr6,118245177,118245643,466,-1,0,222553,1,214.59227467811200000000
chr6,119011179,119020242,9063,-1,0,387119,1,11.03387399315900000000
chr6,119012244,119013926,1682,-1,0,387119,1,59.45303210463730000000
chr6,119039478,119040493,1015,-1,0,,0,0.00000000000000000000
chr6,119165082,119172657,7575,-1,0,254394,1,13.20132013201320000000
chr6,119417489,119417873,384,-1,0,79632,1,260.41666666666700000000
chr6,119444005,119444247,242,-1,0,79632,1,413.22314049586800000000
chr6,119741340,119752977,11637,-1,0,,0,0.00000000000000000000
chr6,119639566,119644407,4841,-1,0,4121,1,20.65688907250570000000
chr6,119596393,119596801,408,-1,0,4121,1,245.09803921568600000000
chr6,120928682,120929533,851,-1,0,,0,0.00000000000000000000
chr6,120958010,120965686,7676,-1,0,,0,0.00000000000000000000
chr6,120982296,121015573,33277,-1,0,,0,0.00000000000000000000
chr6,120988308,121002253,13945,-1,0,,0,0.00000000000000000000
chr6,121178573,121179645,1072,-1,0,,0,0.00000000000000000000
chr6,121178875,121179436,561,-1,0,,0,0.00000000000000000000
chr6,121179098,121179243,145,-1,0,,0,0.00000000000000000000
chr6,121179105,121179238,133,-1,0,,0,0.00000000000000000000
chr6,121263603,121264005,402,-1,0,,0,0.00000000000000000000
chr6,121263706,121263930,224,-1,0,,0,0.00000000000000000000
chr6,121287405,121469049,181644,-1,0,221322,1,0.55052740525423400000
chr6,121519236,121526000,6764,-1,0,221322,1,14.78415138971020000000
chr6,121521453,121524581,3128,-1,0,221322,1,31.96930946291560000000
chr6,121319272,121319675,403,-1,0,,0,0.00000000000000000000
chr6,121629410,121629872,462,-1,0,221322,1,216.45021645021600000000
chr6,121748779,121749525,746,-1,0,,0,0.00000000000000000000
chr6,121795380,121800478,5098,-1,0,,0,0.00000000000000000000
chr6,121797484,121799939,2455,-1,0,,0,0.00000000000000000000
chr6,121797438,121798052,614,-1,0,,0,0.00000000000000000000
chr6,121808931,121809164,233,-1,0,,0,0.00000000000000000000
chr6,121849981,121851913,1932,-1,0,,0,0.00000000000000000000
chr6,121957523,121958336,813,-1,0,,0,0.00000000000000000000
chr6,121961433,121970898,9465,-1,0,,0,0.00000000000000000000
chr6,122080338,122083405,3067,-1,0,,0,0.00000000000000000000
chr6,122090655,122093019,2364,-1,0,,0,0.00000000000000000000
chr6,122159128,122168933,9805,-1,0,,0,0.00000000000000000000
chr6,122301596,122302045,449,-1,0,,0,0.00000000000000000000
chr6,122316846,122320065,3219,-1,0,,0,0.00000000000000000000
chr6,122571373,122576456,5083,-1,0,,0,0.00000000000000000000
chr6,122675773,122676442,669,-1,0,,0,0.00000000000000000000
chr6,122675961,122676016,55,-1,0,,0,0.00000000000000000000
chr6,123168914,123171596,2682,-1,0,,0,0.00000000000000000000
chr6,123373881,123374224,343,-1,0,134829,1,291.54518950437300000000
chr6,123514971,123515457,486,-1,0,,0,0.00000000000000000000
chr6,123515064,123515379,315,-1,0,,0,0.00000000000000000000
chr6,123533267,123534890,1623,-1,0,,0,0.00000000000000000000
chr6,123592397,123593184,787,-1,0,10345,1,127.06480304955500000000
chr6,123763415,123763721,306,-1,0,10345,1,326.79738562091500000000
chr6,124135291,124137431,2140,-1,0,154215,1,46.72897196261680000000
chr6,124234282,124236649,2367,-1,0,154215,1,42.24757076468100000000
chr6,124269210,124359900,90690,-1,0,154215,1,1.10265740434447000000
chr6,124306971,124309017,2046,-1,0,154215,1,48.87585532746820000000
chr6,124317265,124317732,467,-1,0,154215,1,214.13276231263400000000
chr6,124317426,124317603,177,-1,0,154215,1,564.97175141242900000000
chr6,124317460,124317534,74,-1,0,154215,1,1351.35135135135000000000
chr6,124498811,124499325,514,-1,0,154215,1,194.55252918287900000000
chr6,124498893,124499224,331,-1,0,154215,1,302.11480362537800000000
chr6,124557878,124559022,1144,-1,0,154215,1,87.41258741258740000000
chr6,124836681,124837182,501,-1,0,154215,1,199.60079840319400000000
chr6,124836855,124836981,126,-1,0,154215,1,793.65079365079400000000
chr6,124847066,124852223,5157,-1,0,154215,1,19.39111886755870000000
chr6,125037764,125038163,399,-1,0,154215,1,250.62656641604000000000
chr6,125169108,125170476,1368,-1,0,,0,0.00000000000000000000
chr6,125462756,125463388,632,-1,0,,0,0.00000000000000000000
chr6,125563129,125564192,1063,-1,0,7164,1,94.07337723424270000000
chr6,125706510,125711184,4674,-1,0,,0,0.00000000000000000000
chr6,125708748,125711352,2604,-1,0,,0,0.00000000000000000000
chr6,125817767,125822988,5221,-1,0,,0,0.00000000000000000000
chr6,125864141,125865362,1221,-1,0,,0,0.00000000000000000000
chr6,125928150,125930244,2094,-1,0,,0,0.00000000000000000000
chr6,126160396,126161793,1397,-1,0,135112,1,71.58196134574090000000
chr6,126182956,126187358,4402,-1,0,135112,1,22.71694684234440000000
chr6,126182194,126186519,4325,-1,0,135112,1,23.12138728323700000000
chr6,126467948,126468303,355,-1,0,,0,0.00000000000000000000
chr6,126468008,126468246,238,-1,0,,0,0.00000000000000000000
chr6,127183507,127188103,4596,-1,0,,0,0.00000000000000000000
chr6,127679790,127680349,559,-1,0,,0,0.00000000000000000000
chr6,128232171,128233137,966,-1,0,387357,1,103.51966873706000000000
chr6,128420238,128436775,16537,-1,0,5796,1,6.04704601802020000000
chr6,128429436,128440183,10747,-1,0,5796,1,9.30492230389876000000
chr6,128428938,128436233,7295,-1,0,5796,1,13.70801919122690000000
chr6,128432715,128437597,4882,-1,0,5796,1,20.48340843916430000000
chr6,128516165,128516708,543,-1,0,5796,1,184.16206261510100000000
chr6,128827511,128829555,2044,-1,0,5796,1,48.92367906066540000000
chr6,128976263,128976674,411,-1,0,,0,0.00000000000000000000
chr6,128976346,128976564,218,-1,0,,0,0.00000000000000000000
chr6,128989738,128990260,522,-1,0,,0,0.00000000000000000000
chr6,128989832,128990173,341,-1,0,,0,0.00000000000000000000
chr6,129020132,129163146,143014,-1,0,,0,0.00000000000000000000
chr6,129202198,129202638,440,-1,0,,0,0.00000000000000000000
chr6,129224280,129224920,640,-1,0,3908,1,156.25000000000000000000
chr6,129319440,129325631,6191,-1,0,3908,1,16.15247940558880000000
chr6,129608176,129608246,70,-1,0,3908,1,1428.57142857143000000000
chr6,129736990,129737435,445,-1,0,3908,1,224.71910112359600000000
chr6,129737070,129737384,314,-1,0,3908,1,318.47133757961800000000
chr6,129930681,129931142,461,-1,0,93663,1,216.91973969631200000000
chr6,130506609,130508062,1453,-1,0,154075,1,68.82312456985550000000
chr6,130927059,130927107,48,-1,0,,0,0.00000000000000000000
chr6,130959384,130959768,384,-1,0,,0,0.00000000000000000000
chr6,131076463,131119173,42710,-1,0,,0,0.00000000000000000000
chr6,131077083,131077552,469,-1,0,,0,0.00000000000000000000
chr6,131216353,131219638,3285,-1,0,2037,1,30.44140030441400000000
chr6,131418011,131418980,969,-1,0,,0,0.00000000000000000000
chr6,131440359,131440779,420,-1,0,,0,0.00000000000000000000
chr6,131440527,131440606,79,-1,0,,0,0.00000000000000000000
chr6,131659977,131665339,5362,-1,0,,0,0.00000000000000000000
chr6,131803217,131803516,299,-1,0,,0,0.00000000000000000000
chr6,132017229,132035308,18079,-1,0,643854;79541;5169,3,16.59383815476520000000
chr6,132105351,132124707,19356,-1,0,,0,0.00000000000000000000
chr6,132113857,132118895,5038,-1,0,,0,0.00000000000000000000
chr6,132106581,132108823,2242,-1,0,,0,0.00000000000000000000
chr6,132106571,132108576,2005,-1,0,,0,0.00000000000000000000
chr6,131951236,131953124,1888,-1,0,,0,0.00000000000000000000
chr6,132337010,132337085,75,-1,0,,0,0.00000000000000000000
chr6,132375237,132378965,3728,-1,0,,0,0.00000000000000000000
chr6,132697539,132698090,551,-1,0,26002,1,181.48820326678800000000
chr6,132697637,132697967,330,-1,0,26002,1,303.03030303030300000000
chr6,132704375,132712519,8144,-1,0,26002,1,12.27897838899800000000
chr6,132707464,132712434,4970,-1,0,26002,1,20.12072434607650000000
chr6,132707172,132707476,304,-1,0,26002,1,328.94736842105300000000
chr6,133079352,133080502,1150,-1,0,8875,1,86.95652173913040000000
chr6,133341686,133348139,6453,-1,0,,0,0.00000000000000000000
chr6,133371355,133371946,591,-1,0,,0,0.00000000000000000000
chr6,133371487,133371829,342,-1,0,,0,0.00000000000000000000
chr6,133726412,133750620,24208,-1,0,2070,1,4.13086582947786000000
chr6,133745771,133747365,1594,-1,0,2070,1,62.73525721455460000000
chr6,133948779,133949781,1002,-1,0,,0,0.00000000000000000000
chr6,133949669,133950539,870,-1,0,,0,0.00000000000000000000
chr6,133954690,133956964,2274,-1,0,,0,0.00000000000000000000
chr6,134154264,134154923,659,-1,0,,0,0.00000000000000000000
chr6,134154569,134154724,155,-1,0,,0,0.00000000000000000000
chr6,134154514,134154660,146,-1,0,,0,0.00000000000000000000
chr6,134268951,134269719,768,-1,0,,0,0.00000000000000000000
chr6,134268993,134269578,585,-1,0,,0,0.00000000000000000000
chr6,134351730,134354377,2647,-1,0,154091,1,37.77861730260670000000
chr6,134464995,134466548,1553,-1,0,,0,0.00000000000000000000
chr6,134589569,134594871,5302,-1,0,6446,1,18.86080724255000000000
chr6,134592207,134592493,286,-1,0,6446,1,349.65034965035000000000
chr6,134717278,134717562,284,-1,0,,0,0.00000000000000000000
chr6,134717329,134717508,179,-1,0,,0,0.00000000000000000000
chr6,134719864,134720554,690,-1,0,,0,0.00000000000000000000
chr6,134817312,134817767,455,-1,0,,0,0.00000000000000000000
chr6,134817361,134817678,317,-1,0,,0,0.00000000000000000000
chr6,134987073,134987708,635,-1,0,,0,0.00000000000000000000
chr6,135008369,135009444,1075,-1,0,,0,0.00000000000000000000
chr6,135154713,135160063,5350,-1,0,,0,0.00000000000000000000
chr6,135351931,135353467,1536,-1,0,10767,1,65.10416666666670000000
chr6,135608885,135610966,2081,-1,0,54806,1,48.05382027871220000000
chr6,135782144,135783686,1542,-1,0,54806,1,64.85084306095980000000
chr6,136241503,136253538,12035,-1,0,27115,1,8.30909846281678000000
chr6,136235556,136236043,487,-1,0,27115,1,205.33880903490800000000
chr6,136235628,136235924,296,-1,0,27115,1,337.83783783783800000000
chr6,136273034,136288407,15373,-1,0,27115,1,6.50491120796201000000
chr6,136294229,136294623,394,-1,0,27115,1,253.80710659898500000000
chr6,136582614,136589303,6689,-1,0,9774,1,14.94991777545220000000
chr6,136582229,136582408,179,-1,0,9774,1,558.65921787709500000000
chr6,136594359,136596840,2481,-1,0,9774,1,40.30632809351070000000
chr6,136597553,136599005,1452,-1,0,9774,1,68.87052341597800000000
chr6,136601094,136610834,9740,-1,0,9774,1,10.26694045174540000000
chr6,136599837,136600911,1074,-1,0,9774,1,93.10986964618250000000
chr6,136817446,136821246,3800,-1,0,9053,1,26.31578947368420000000
chr6,136826436,136827781,1345,-1,0,9053,1,74.34944237918220000000
chr6,136851633,136852989,1356,-1,0,9053,1,73.74631268436580000000
chr6,136851719,136852897,1178,-1,0,9053,1,84.88964346349740000000
chr6,137313691,137314187,496,-1,0,,0,0.00000000000000000000
chr6,138182489,138183401,912,-1,0,,0,0.00000000000000000000
chr6,138492158,138492552,394,-1,0,57221,1,253.80710659898500000000
chr6,138508052,138517139,9087,-1,0,57221,1,11.00473203477500000000
chr6,138653248,138653697,449,-1,0,57221,1,222.71714922049000000000
chr6,138776431,138776866,435,-1,0,57224,1,229.88505747126400000000
chr6,138947626,138948179,553,-1,0,,0,0.00000000000000000000
chr6,138947734,138948055,321,-1,0,,0,0.00000000000000000000
chr6,139602305,139607187,4882,-1,0,167838,1,20.48340843916430000000
chr6,139603760,139606906,3146,-1,0,167838,1,31.78639542275910000000
chr6,139602636,139603039,403,-1,0,167838,1,248.13895781637700000000
chr6,139602667,139602984,317,-1,0,167838,1,315.45741324921100000000
chr6,139644681,139646060,1379,-1,0,,0,0.00000000000000000000
chr6,139820922,139828668,7746,-1,0,,0,0.00000000000000000000
chr6,139887444,139887677,233,-1,0,,0,0.00000000000000000000
chr6,140866676,140996026,129350,-1,0,,0,0.00000000000000000000
chr6,140801497,140895423,93926,-1,0,,0,0.00000000000000000000
chr6,140764543,140853711,89168,-1,0,,0,0.00000000000000000000
chr6,140849465,140904220,54755,-1,0,,0,0.00000000000000000000
chr6,140863613,140916258,52645,-1,0,,0,0.00000000000000000000
chr6,141033754,141060922,27168,-1,0,,0,0.00000000000000000000
chr6,140383221,140392235,9014,-1,0,,0,0.00000000000000000000
chr6,140770599,140781962,11363,-1,0,,0,0.00000000000000000000
chr6,140954712,140957506,2794,-1,0,,0,0.00000000000000000000
chr6,140387743,140390401,2658,-1,0,,0,0.00000000000000000000
chr6,140952796,140953286,490,-1,0,,0,0.00000000000000000000
chr6,141055171,141055748,577,-1,0,,0,0.00000000000000000000
chr6,140952890,140953178,288,-1,0,,0,0.00000000000000000000
chr6,141325613,141326170,557,-1,0,,0,0.00000000000000000000
chr6,141325734,141326081,347,-1,0,,0,0.00000000000000000000
chr6,141363441,141384540,21099,-1,0,,0,0.00000000000000000000
chr6,141372195,141383509,11314,-1,0,,0,0.00000000000000000000
chr6,141377704,141380207,2503,-1,0,,0,0.00000000000000000000
chr6,141546066,141549942,3876,-1,0,,0,0.00000000000000000000
chr6,141548595,141550030,1435,-1,0,,0,0.00000000000000000000
chr6,141549270,141549966,696,-1,0,,0,0.00000000000000000000
chr6,142165732,142242935,77203,-1,0,,0,0.00000000000000000000
chr6,142072214,142135787,63573,-1,0,,0,0.00000000000000000000
chr6,142380100,142399014,18914,-1,0,4829,1,5.28708892883578000000
chr6,142019749,142034399,14650,-1,0,,0,0.00000000000000000000
chr6,142043302,142050757,7455,-1,0,,0,0.00000000000000000000
chr6,142110655,142115102,4447,-1,0,,0,0.00000000000000000000
chr6,142098445,142103340,4895,-1,0,,0,0.00000000000000000000
chr6,142165318,142168523,3205,-1,0,,0,0.00000000000000000000
chr6,142313751,142314901,1150,-1,0,,0,0.00000000000000000000
chr6,142285927,142286709,782,-1,0,,0,0.00000000000000000000
chr6,142755371,142756708,1337,-1,0,57211,1,74.79431563201200000000
chr6,142969740,142974401,4661,-1,0,,0,0.00000000000000000000
chr6,143161237,143161724,487,-1,0,3097,1,205.33880903490800000000
chr6,143161453,143161562,109,-1,0,3097,1,917.43119266055100000000
chr6,143378319,143378809,490,-1,0,,0,0.00000000000000000000
chr6,143536166,143537319,1153,-1,0,51390,1,86.73026886383350000000
chr6,143606918,143611302,4384,-1,0,51390,1,22.81021897810220000000
chr6,143869338,143872442,3104,-1,0,,0,0.00000000000000000000
chr6,144062380,144062609,229,-1,0,9749,1,436.68122270742400000000
chr6,144195319,144199855,4536,-1,0,153918,1,22.04585537918870000000
chr6,144198767,144199855,1088,-1,0,153918,1,91.91176470588230000000
chr6,144572226,144572352,126,-1,0,,0,0.00000000000000000000
chr6,144647227,144654927,7700,-1,0,7402,1,12.98701298701300000000
chr6,144879895,144881193,1298,-1,0,7402,1,77.04160246533130000000
chr6,145061280,145064207,2927,-1,0,7402,1,34.16467372736590000000
chr6,145127690,145128021,331,-1,0,7402,1,302.11480362537800000000
chr6,145134053,145139257,5204,-1,0,7402,1,19.21598770176790000000
chr6,145136511,145137142,631,-1,0,7402,1,158.47860538827300000000
chr6,145688874,145691209,2335,-1,0,,0,0.00000000000000000000
chr6,145705436,145706545,1109,-1,0,,0,0.00000000000000000000
chr6,145802383,145814728,12345,-1,0,,0,0.00000000000000000000
chr6,145818427,145818979,552,-1,0,,0,0.00000000000000000000
chr6,145818570,145818892,322,-1,0,,0,0.00000000000000000000
chr6,145818651,145818781,130,-1,0,,0,0.00000000000000000000
chr6,146144462,146148913,4451,-1,0,,0,0.00000000000000000000
chr6,146290448,146309052,18604,-1,0,,0,0.00000000000000000000
chr6,146715291,146716478,1187,-1,0,2911,1,84.24599831508000000000
chr6,146869215,146875935,6720,-1,0,10981,1,14.88095238095240000000
chr6,147091813,147094496,2683,-1,0,79747,1,37.27171077152440000000
chr6,147108612,147109066,454,-1,0,79747,1,220.26431718061700000000
chr6,147130390,147137433,7043,-1,0,79747,1,14.19849495953430000000
chr6,147209885,147220352,10467,-1,0,,0,0.00000000000000000000
chr6,147323962,147334544,10582,-1,0,,0,0.00000000000000000000
chr6,147384288,147393235,8947,-1,0,,0,0.00000000000000000000
chr6,147438401,147444456,6055,-1,0,,0,0.00000000000000000000
chr6,147568584,147569698,1114,-1,0,134957,1,89.76660682226210000000
chr6,147817062,147821033,3971,-1,0,,0,0.00000000000000000000
chr6,147855200,147864850,9650,-1,0,389432,1,10.36269430051810000000
chr6,147933824,147937590,3766,-1,0,,0,0.00000000000000000000
chr6,147934267,147936399,2132,-1,0,,0,0.00000000000000000000
chr6,148001698,148003373,1675,-1,0,,0,0.00000000000000000000
chr6,148177678,148178855,1177,-1,0,,0,0.00000000000000000000
chr6,148506082,148506642,560,-1,0,,0,0.00000000000000000000
chr6,148506312,148506447,135,-1,0,,0,0.00000000000000000000
chr6,148708605,148708967,362,-1,0,23328,1,276.24309392265200000000
chr6,149197483,149200186,2703,-1,0,10090,1,36.99593044765080000000
chr6,149320726,149320948,222,-1,0,10090,1,450.45045045045000000000
chr6,149376142,149376711,569,-1,0,10090,1,175.74692442882200000000
chr6,149498857,149499225,368,-1,0,,0,0.00000000000000000000
chr6,149632459,149633172,713,-1,0,23118,1,140.25245441795200000000
chr6,149632778,149632944,166,-1,0,23118,1,602.40963855421700000000
chr6,149801942,149802924,982,-1,0,340152,1,101.83299389002000000000
chr6,149947516,149949350,1834,-1,0,11104,1,54.52562704471100000000
chr6,149989304,149995421,6117,-1,0,9113,1,16.34788294915810000000
chr6,150083672,150084389,717,-1,0,5110,1,139.47001394700100000000
chr6,150325722,150389994,64272,-1,0,154064;79465,2,3.11177495643515000000
chr6,150409267,150425067,15800,-1,0,,0,0.00000000000000000000
chr6,150366287,150370731,4444,-1,0,,0,0.00000000000000000000
chr6,150410809,150412315,1506,-1,0,,0,0.00000000000000000000
chr6,150375272,150376673,1401,-1,0,,0,0.00000000000000000000
chr6,150286090,150286583,493,-1,0,80329,1,202.83975659229200000000
chr6,150305261,150305565,304,-1,0,,0,0.00000000000000000000
chr6,150302658,150302804,146,-1,0,,0,0.00000000000000000000
chr6,150624108,150628702,4594,-1,0,,0,0.00000000000000000000
chr6,150643428,150647845,4417,-1,0,,0,0.00000000000000000000
chr6,150693535,150693720,185,-1,0,389434,1,540.54054054054100000000
chr6,150753422,150755147,1725,-1,0,,0,0.00000000000000000000
chr6,151097535,151097891,356,-1,0,57480,1,280.89887640449400000000
chr6,151097538,151097796,258,-1,0,57480,1,387.59689922480600000000
chr6,151268123,151270090,1967,-1,0,25902,1,50.83884087442810000000
chr6,151364955,151367984,3029,-1,0,25902,1,33.01419610432490000000
chr6,151484695,151487742,3047,-1,0,,0,0.00000000000000000000
chr6,151485913,151486960,1047,-1,0,,0,0.00000000000000000000
chr6,151506495,151512506,6011,-1,0,,0,0.00000000000000000000
chr6,151514128,151518173,4045,-1,0,,0,0.00000000000000000000
chr6,151507262,151509697,2435,-1,0,,0,0.00000000000000000000
chr6,151513871,151513962,91,-1,0,,0,0.00000000000000000000
chr6,151582084,151585704,3620,-1,0,9590,1,27.62430939226520000000
chr6,151618058,151623889,5831,-1,0,9590,1,17.14971702966900000000
chr6,151661605,151661976,371,-1,0,9590,1,269.54177897574100000000
chr6,151819720,151820925,1205,-1,0,80129,1,82.98755186721990000000
chr6,152303695,152311880,8185,-1,0,2099,1,12.21747098350640000000
chr6,152389944,152392267,2323,-1,0,2099,1,43.04778303917350000000
chr6,152391132,152392400,1268,-1,0,2099,1,78.86435331230280000000
chr6,152612194,152612322,128,-1,0,23345,1,781.25000000000000000000
chr6,152612270,152612344,74,-1,0,23345,1,1351.35135135135000000000
chr6,153029739,153033968,4229,-1,0,80177,1,23.64625206904710000000
chr6,153165967,153166093,126,-1,0,,0,0.00000000000000000000
chr6,153210574,153211049,475,-1,0,,0,0.00000000000000000000
chr6,153226547,153227739,1192,-1,0,,0,0.00000000000000000000
chr6,153426200,153426908,708,-1,0,26575,1,141.24293785310700000000
chr6,153643226,153657653,14427,-1,0,,0,0.00000000000000000000
chr6,153771872,153772601,729,-1,0,,0,0.00000000000000000000
chr6,154088233,154115523,27290,-1,0,,0,0.00000000000000000000
chr6,154121562,154129898,8336,-1,0,,0,0.00000000000000000000
chr6,153958327,153961512,3185,-1,0,,0,0.00000000000000000000
chr6,154174263,154174691,428,-1,0,,0,0.00000000000000000000
chr6,153932324,153932886,562,-1,0,,0,0.00000000000000000000
chr6,153932500,153932659,159,-1,0,,0,0.00000000000000000000
chr6,154284115,154284567,452,-1,0,,0,0.00000000000000000000
chr6,154446826,154447356,530,-1,0,4988,1,188.67924528301900000000
chr6,154446915,154447237,322,-1,0,4988,1,310.55900621118000000000
chr6,154463090,154463336,246,-1,0,4988,1,406.50406504065000000000
chr6,154463243,154463334,91,-1,0,4988,1,1098.90109890110000000000
chr6,154586459,154588533,2074,-1,0,26034,1,48.21600771456120000000
chr6,154619983,154621503,1520,-1,0,26034,1,65.78947368421050000000
chr6,154681016,154683165,2149,-1,0,,0,0.00000000000000000000
chr6,154686526,154686804,278,-1,0,,0,0.00000000000000000000
chr6,154707427,154725969,18542,-1,0,,0,0.00000000000000000000
chr6,154817446,154817648,202,-1,0,154043,1,495.04950495049500000000
chr6,154825768,154826971,1203,-1,0,154043,1,83.12551953449710000000
chr6,154882351,154882470,119,-1,0,,0,0.00000000000000000000
chr6,154962602,154964587,1985,-1,0,,0,0.00000000000000000000
chr6,155116150,155127169,11019,-1,0,22828,1,9.07523368726745000000
chr6,155118167,155123187,5020,-1,0,22828,1,19.92031872509960000000
chr6,155295018,155296603,1585,-1,0,,0,0.00000000000000000000
chr6,155312299,155314143,1844,-1,0,,0,0.00000000000000000000
chr6,155379891,155381573,1682,-1,0,,0,0.00000000000000000000
chr6,155386352,155391615,5263,-1,0,,0,0.00000000000000000000
chr6,155918195,155919682,1487,-1,0,,0,0.00000000000000000000
chr6,156051776,156053427,1651,-1,0,,0,0.00000000000000000000
chr6,156144052,156144287,235,-1,0,,0,0.00000000000000000000
chr6,156302347,156302627,280,-1,0,,0,0.00000000000000000000
chr6,156499834,156500302,468,-1,0,,0,0.00000000000000000000
chr6,157410354,157411112,758,-1,0,57492,1,131.92612137203200000000
chr6,157468368,157469009,641,-1,0,57492,1,156.00624024961000000000
chr6,157699894,157703262,3368,-1,0,,0,0.00000000000000000000
chr6,157703951,157704336,385,-1,0,,0,0.00000000000000000000
chr6,157731472,157735268,3796,-1,0,729515,1,26.34351949420440000000
chr6,157732609,157733178,569,-1,0,729515,1,175.74692442882200000000
chr6,157732206,157732783,577,-1,0,729515,1,173.31022530329300000000
chr6,157943805,157944010,205,-1,0,79683,1,487.80487804878000000000
chr6,157957812,157958202,390,-1,0,79683,1,256.41025641025600000000
chr6,158108101,158108348,247,-1,0,,0,0.00000000000000000000
chr6,158346234,158346978,744,-1,0,51429,1,134.40860215053800000000
chr6,158547810,158549363,1553,-1,0,84947,1,64.39150032195750000000
chr6,158548262,158549119,857,-1,0,84947,1,116.68611435239200000000
chr6,158716616,158719801,3185,-1,0,,0,0.00000000000000000000
chr6,158784767,158786012,1245,-1,0,56995,1,80.32128514056230000000
chr6,158876075,158876404,329,-1,0,56995,1,303.95136778115500000000
chr6,158912384,158912646,262,-1,0,56995,1,381.67938931297700000000
chr6,158991345,158992492,1147,-1,0,57583,1,87.18395815170010000000
chr6,158992373,158992577,204,-1,0,57583,1,490.19607843137300000000
chr6,159125885,159126522,637,-1,0,94120,1,156.98587127158600000000
chr6,159125730,159126172,442,-1,0,94120,1,226.24434389140300000000
chr6,159166129,159174999,8870,-1,0,94120,1,11.27395715896280000000
chr6,159232325,159232401,76,-1,0,7430,1,1315.78947368421000000000
chr6,159314189,159319014,4825,-1,0,100130967,1,20.72538860103630000000
chr6,159348682,159350057,1375,-1,0,,0,0.00000000000000000000
chr6,159352734,159353788,1054,-1,0,,0,0.00000000000000000000
chr6,159418881,159419710,829,-1,0,83861,1,120.62726176115800000000
chr6,159554617,159554690,73,-1,0,,0,0.00000000000000000000
chr6,159651966,159652568,602,-1,0,84624,1,166.11295681063100000000
chr6,159652108,159652422,314,-1,0,84624,1,318.47133757961800000000
chr6,159666650,159667197,547,-1,0,84624,1,182.81535648994500000000
chr6,159666755,159667088,333,-1,0,84624,1,300.30030030030000000000
chr6,159816180,159817960,1780,-1,0,,0,0.00000000000000000000
chr6,159876297,159879644,3347,-1,0,,0,0.00000000000000000000
chr6,159968200,159970837,2637,-1,0,,0,0.00000000000000000000
chr6,160086250,160088726,2476,-1,0,,0,0.00000000000000000000
chr6,160086571,160088519,1948,-1,0,,0,0.00000000000000000000
chr6,160086852,160087831,979,-1,0,,0,0.00000000000000000000
chr6,160086678,160087433,755,-1,0,,0,0.00000000000000000000
chr6,160131956,160133571,1615,-1,0,6648,1,61.91950464396290000000
chr6,160355701,160355849,148,-1,0,,0,0.00000000000000000000
chr6,160627745,160638091,10346,-1,0,6582,1,9.66557123526000000000
chr6,160648902,160655018,6116,-1,0,6582,1,16.35055591890120000000
chr6,161026085,161068213,42128,-1,0,4018,1,2.37371819217622000000
chr6,160903454,160907864,4410,-1,0,,0,0.00000000000000000000
chr6,161001931,161004271,2340,-1,0,4018,1,42.73504273504270000000
chr6,161215592,161218705,3113,-1,0,,0,0.00000000000000000000
chr6,161261534,161279884,18350,-1,0,,0,0.00000000000000000000
chr6,161252547,161268401,15854,-1,0,,0,0.00000000000000000000
chr6,161262689,161278154,15465,-1,0,,0,0.00000000000000000000
chr6,161276230,161281616,5386,-1,0,,0,0.00000000000000000000
chr6,161274229,161274833,604,-1,0,,0,0.00000000000000000000
chr6,161511464,161511816,352,-1,0,4216,1,284.09090909090900000000
chr6,161511363,161511702,339,-1,0,4216,1,294.98525073746300000000
chr6,161511641,161511903,262,-1,0,4216,1,381.67938931297700000000
chr6,161565991,161567391,1400,-1,0,56895,1,71.42857142857140000000
chr6,161683924,161684347,423,-1,0,56895,1,236.40661938534300000000
chr6,161684126,161684228,102,-1,0,56895,1,980.39215686274500000000
chr6,161726307,161727876,1569,-1,0,,0,0.00000000000000000000
chr6,161726693,161727904,1211,-1,0,,0,0.00000000000000000000
chr6,162358262,163268904,910642,-1,0,135138;5071,2,0.21962527535518900000
chr6,162607969,163002490,394521,-1,0,5071,1,0.25347193178563400000
chr6,162554715,162778855,224140,-1,0,5071,1,0.44614972784866600000
chr6,162808787,163085596,276809,-1,0,5071,1,0.36125993013232900000
chr6,162693163,162867515,174352,-1,0,5071,1,0.57355235385886000000
chr6,162784316,162952282,167966,-1,0,5071,1,0.59535858447543000000
chr6,162561824,162707658,145834,-1,0,5071,1,0.68571115103473800000
chr6,163255683,163370739,115056,-1,0,135138,1,0.86914198303434800000
chr6,162899933,163011471,111538,-1,0,5071,1,0.89655543402248600000
chr6,162725902,162841434,115532,-1,0,5071,1,0.86556105667693800000
chr6,162369856,162479278,109422,-1,0,5071,1,0.91389300140739500000
chr6,162967887,163065730,97843,-1,0,5071,1,1.02204552190755000000
chr6,162690350,162783652,93302,-1,0,5071,1,1.07178838610105000000
chr6,163010055,163095654,85599,-1,0,5071,1,1.16823794670498000000
chr6,163194898,163277643,82745,-1,0,135138,1,1.20853223759744000000
chr6,162565989,162647731,81742,-1,0,5071,1,1.22336130752857000000
chr6,162750946,162800605,49659,-1,0,5071,1,2.01373366358565000000
chr6,162910240,162962830,52590,-1,0,5071,1,1.90150218672751000000
chr6,162314554,162370778,56224,-1,0,5071,1,1.77859988616961000000
chr6,162999037,163054047,55010,-1,0,5071,1,1.81785129976368000000
chr6,162715262,162752397,37135,-1,0,5071,1,2.69287733943719000000
chr6,161814879,161860182,45303,-1,0,5071,1,2.20735933602631000000
chr6,162843999,162891532,47533,-1,0,5071,1,2.10380156943597000000
chr6,162932223,162970753,38530,-1,0,5071,1,2.59538022320270000000
chr6,162795986,162824959,28973,-1,0,5071,1,3.45148931764056000000
chr6,162896343,162920370,24027,-1,0,5071,1,4.16198443417822000000
chr6,162993162,163018611,25449,-1,0,5071,1,3.92942748241581000000
chr6,163407671,163432884,25213,-1,0,135138,1,3.96620790861857000000
chr6,162731335,162747822,16487,-1,0,5071,1,6.06538484866865000000
chr6,162494607,162511260,16653,-1,0,5071,1,6.00492403771092000000
chr6,162615757,162627851,12094,-1,0,5071,1,8.26856292376385000000
chr6,162967549,162977272,9723,-1,0,5071,1,10.28489149439470000000
chr6,162734484,162744404,9920,-1,0,5071,1,10.08064516129030000000
chr6,162579694,162586849,7155,-1,0,5071,1,13.97624039133470000000
chr6,162496325,162502119,5794,-1,0,5071,1,17.25923369002420000000
chr6,162962838,162969584,6746,-1,0,5071,1,14.82359916987840000000
chr6,162734724,162741078,6354,-1,0,5071,1,15.73811772112060000000
chr6,162583522,162587286,3764,-1,0,5071,1,26.56748140276300000000
chr6,161811730,161814818,3088,-1,0,5071,1,32.38341968911920000000
chr6,162737988,162740307,2319,-1,0,5071,1,43.12203536006900000000
chr6,162384921,162387427,2506,-1,0,5071,1,39.90422984836390000000
chr6,162758844,162761264,2420,-1,0,5071,1,41.32231404958680000000
chr6,162403245,162404952,1707,-1,0,5071,1,58.58230814294080000000
chr6,162578541,162580295,1754,-1,0,5071,1,57.01254275940710000000
chr6,162150845,162152544,1699,-1,0,5071,1,58.85815185403180000000
chr6,162724690,162725962,1272,-1,0,5071,1,78.61635220125790000000
chr6,162725087,162725908,821,-1,0,5071,1,121.80267965895200000000
chr6,162151085,162151725,640,-1,0,5071,1,156.25000000000000000000
chr6,162851969,162852454,485,-1,0,5071,1,206.18556701030900000000
chr6,162066968,162067570,602,-1,0,5071,1,166.11295681063100000000
chr6,162316354,162316874,520,-1,0,5071,1,192.30769230769200000000
chr6,162748432,162748884,452,-1,0,5071,1,221.23893805309700000000
chr6,162432367,162432614,247,-1,0,5071,1,404.85829959514200000000
chr6,162316498,162316718,220,-1,0,5071,1,454.54545454545500000000
chr6,162852206,162852295,89,-1,0,5071,1,1123.59550561798000000000
chr6,162748554,162748680,126,-1,0,5071,1,793.65079365079400000000
chr6,163750285,163750850,565,-1,0,,0,0.00000000000000000000
chr6,163743883,163744246,363,-1,0,,0,0.00000000000000000000
chr6,163747977,163748168,191,-1,0,,0,0.00000000000000000000
chr6,163721945,163722069,124,-1,0,135138,1,806.45161290322600000000
chr6,163834591,163836760,2169,-1,0,9444,1,46.10419548178880000000
chr6,163918548,163943982,25434,-1,0,9444,1,3.93174490839034000000
chr6,163936983,163945599,8616,-1,0,9444,1,11.60631383472610000000
chr6,164014907,164015311,404,-1,0,,0,0.00000000000000000000
chr6,164034747,164035212,465,-1,0,,0,0.00000000000000000000
chr6,164250807,164250915,108,-1,0,,0,0.00000000000000000000
chr6,164413989,164415859,1870,-1,0,,0,0.00000000000000000000
chr6,164542589,164547708,5119,-1,0,,0,0.00000000000000000000
chr6,164543223,164547132,3909,-1,0,,0,0.00000000000000000000
chr6,164544374,164546399,2025,-1,0,,0,0.00000000000000000000
chr6,164743244,164749839,6595,-1,0,,0,0.00000000000000000000
chr6,164688782,164691816,3034,-1,0,,0,0.00000000000000000000
chr6,164877412,164878452,1040,-1,0,,0,0.00000000000000000000
chr6,165344090,165344554,464,-1,0,,0,0.00000000000000000000
chr6,165724640,165732123,7483,-1,0,,0,0.00000000000000000000
chr6,165727042,165731752,4710,-1,0,,0,0.00000000000000000000
chr6,166239849,166239898,49,-1,0,,0,0.00000000000000000000
chr6,166497497,166502752,5255,-1,0,,0,0.00000000000000000000
chr6,166672947,166673334,387,-1,0,,0,0.00000000000000000000
chr6,166696333,166697057,724,-1,0,,0,0.00000000000000000000
chr6,166695996,166696775,779,-1,0,,0,0.00000000000000000000
chr6,166696421,166696916,495,-1,0,,0,0.00000000000000000000
chr6,166696571,166696819,248,-1,0,,0,0.00000000000000000000
chr6,166767200,166767760,560,-1,0,,0,0.00000000000000000000
chr6,166895061,166895548,487,-1,0,6196,1,205.33880903490800000000
chr6,166998973,167000168,1195,-1,0,6196,1,83.68200836820080000000
chr6,167162034,167163352,1318,-1,0,6196,1,75.87253414264040000000
chr6,167162223,167163031,808,-1,0,6196,1,123.76237623762400000000
chr6,167162795,167163329,534,-1,0,6196,1,187.26591760299600000000
chr6,167178530,167178669,139,-1,0,6196,1,719.42446043165500000000
chr6,167197345,167198057,712,-1,0,6196,1,140.44943820224700000000
chr6,167312760,167313281,521,-1,0,,0,0.00000000000000000000
chr6,167313067,167313590,523,-1,0,,0,0.00000000000000000000
chr6,167197702,167198149,447,-1,0,6196,1,223.71364653243800000000
chr6,167272498,167272559,61,-1,0,6196,1,1639.34426229508000000000
chr6,167417868,167418458,590,-1,0,11116,1,169.49152542372900000000
chr6,167418101,167418170,69,-1,0,11116,1,1449.27536231884000000000
chr6,167488091,167489637,1546,-1,0,,0,0.00000000000000000000
chr6,167488158,167489433,1275,-1,0,,0,0.00000000000000000000
chr6,167517433,167517855,422,-1,0,,0,0.00000000000000000000
chr6,167542963,167544369,1406,-1,0,1235,1,71.12375533428170000000
chr6,167665525,167814036,148511,-1,0,83887;54346;6953,3,2.02005238669190000000
chr6,167629834,167732441,102607,-1,0,54346,1,0.97459237673842900000
chr6,167736868,167772961,36093,-1,0,83887,1,2.77062034189455000000
chr6,167613430,167621930,8500,-1,0,,0,0.00000000000000000000
chr6,167799041,167800209,1168,-1,0,,0,0.00000000000000000000
chr6,167657442,167657861,419,-1,0,,0,0.00000000000000000000
chr6,167835426,167837116,1690,-1,0,,0,0.00000000000000000000
chr6,167880173,167880443,270,-1,0,,0,0.00000000000000000000
chr6,168055843,168056078,235,-1,0,,0,0.00000000000000000000
chr6,168059100,168059652,552,-1,0,,0,0.00000000000000000000
chr6,168059208,168059550,342,-1,0,,0,0.00000000000000000000
chr6,168105014,168105318,304,-1,0,,0,0.00000000000000000000
chr6,168135825,168136530,705,-1,0,,0,0.00000000000000000000
chr6,168135859,168136168,309,-1,0,,0,0.00000000000000000000
chr6,168243896,168248408,4512,-1,0,4301,1,22.16312056737590000000
chr6,168340873,168342649,1776,-1,0,4301,1,56.30630630630630000000
chr6,168376865,168377335,470,-1,0,100128124,1,212.76595744680900000000
chr6,168476359,168476817,458,-1,0,79981,1,218.34061135371200000000
chr6,168476532,168476598,66,-1,0,79981,1,1515.15151515152000000000
chr6,168487225,168487290,65,-1,0,,0,0.00000000000000000000
chr6,168537067,168537561,494,-1,0,,0,0.00000000000000000000
chr6,168569028,168570099,1071,-1,0,,0,0.00000000000000000000
chr6,168569236,168569800,564,-1,0,,0,0.00000000000000000000
chr6,168590989,168591509,520,-1,0,,0,0.00000000000000000000
chr6,168591120,168591280,160,-1,0,,0,0.00000000000000000000
chr6,168597970,168598377,407,-1,0,,0,0.00000000000000000000
chr6,168610756,168611292,536,-1,0,,0,0.00000000000000000000
chr6,168611005,168611093,88,-1,0,,0,0.00000000000000000000
chr6,168634248,168638814,4566,-1,0,,0,0.00000000000000000000
chr6,168646464,168646943,479,-1,0,,0,0.00000000000000000000
chr6,168696743,168696824,81,-1,0,168002,1,1234.56790123457000000000
chr6,168715101,168719600,4499,-1,0,168002,1,22.22716159146480000000
chr6,168716997,168719073,2076,-1,0,168002,1,48.16955684007710000000
chr6,168716919,168718524,1605,-1,0,168002,1,62.30529595015580000000
chr6,168757310,168759828,2518,-1,0,,0,0.00000000000000000000
chr6,168778944,168781191,2247,-1,0,,0,0.00000000000000000000
chr6,168780509,168781134,625,-1,0,,0,0.00000000000000000000
chr6,168872673,168877711,5038,-1,0,64094,1,19.84914648670110000000
chr6,168905686,168906122,436,-1,0,64094,1,229.35779816513800000000
chr6,168905694,168905967,273,-1,0,64094,1,366.30036630036600000000
chr6,168907751,168908724,973,-1,0,64094,1,102.77492291880800000000
chr6,168961173,168963189,2016,-1,0,64094,1,49.60317460317460000000
chr6,168961270,168962659,1389,-1,0,64094,1,71.99424046076310000000
chr6,168972538,168974169,1631,-1,0,64094,1,61.31207847946050000000
chr6,168972910,168974057,1147,-1,0,64094,1,87.18395815170010000000
chr6,168976237,168977720,1483,-1,0,64094,1,67.43088334457180000000
chr6,168990320,168990772,452,-1,0,64094,1,221.23893805309700000000
chr6,168993293,168997221,3928,-1,0,64094,1,25.45824847250510000000
chr6,168992907,168994901,1994,-1,0,64094,1,50.15045135406220000000
chr6,168996756,168997221,465,-1,0,64094,1,215.05376344086000000000
chr6,169004997,169006609,1612,-1,0,64094,1,62.03473945409430000000
chr6,169013795,169017349,3554,-1,0,64094,1,28.13731007315700000000
chr6,169014193,169016252,2059,-1,0,64094,1,48.56726566294320000000
chr6,169015840,169016351,511,-1,0,64094,1,195.69471624266100000000
chr6,169012904,169013208,304,-1,0,64094,1,328.94736842105300000000
chr6,169012818,169013075,257,-1,0,64094,1,389.10505836575900000000
chr6,169012955,169013136,181,-1,0,64094,1,552.48618784530400000000
chr6,169126193,169127195,1002,-1,0,,0,0.00000000000000000000
chr6,169143017,169143255,238,-1,0,,0,0.00000000000000000000
chr6,169221724,169223007,1283,-1,0,,0,0.00000000000000000000
chr6,169222988,169223384,396,-1,0,,0,0.00000000000000000000
chr6,169223165,169223444,279,-1,0,,0,0.00000000000000000000
chr6,169240015,169241304,1289,-1,0,,0,0.00000000000000000000
chr6,169246925,169248038,1113,-1,0,,0,0.00000000000000000000
chr6,169247597,169248038,441,-1,0,,0,0.00000000000000000000
chr6,169271380,169273955,2575,-1,0,,0,0.00000000000000000000
chr6,169275539,169275930,391,-1,0,,0,0.00000000000000000000
chr6,169275589,169275811,222,-1,0,,0,0.00000000000000000000
chr6,169292102,169292634,532,-1,0,,0,0.00000000000000000000
chr6,169309878,169310613,735,-1,0,,0,0.00000000000000000000
chr6,169311609,169311697,88,-1,0,,0,0.00000000000000000000
chr6,169331312,169332857,1545,-1,0,,0,0.00000000000000000000
chr6,169390752,169391314,562,-1,0,,0,0.00000000000000000000
chr6,169391653,169391868,215,-1,0,,0,0.00000000000000000000
chr6,169424783,169425421,638,-1,0,,0,0.00000000000000000000
chr6,169506178,169521363,15185,-1,0,,0,0.00000000000000000000
chr6,169525803,169529808,4005,-1,0,,0,0.00000000000000000000
chr6,169527785,169529813,2028,-1,0,,0,0.00000000000000000000
chr6,169507299,169507731,432,-1,0,,0,0.00000000000000000000
chr6,169507494,169507558,64,-1,0,,0,0.00000000000000000000
chr6,170123481,170125418,1937,-1,0,55274,1,51.62622612287040000000
chr6,169617901,169619600,1699,-1,0,7058,1,58.85815185403180000000
chr6,169633454,169634906,1452,-1,0,7058,1,68.87052341597800000000
chr6,170165589,170166582,993,-1,0,55780,1,100.70493454179300000000
chr6,170092398,170093396,998,-1,0,253769,1,100.20040080160300000000
chr6,169855983,169857033,1050,-1,0,,0,0.00000000000000000000
chr6,169591832,169592872,1040,-1,0,,0,0.00000000000000000000
chr6,170228805,170229590,785,-1,0,,0,0.00000000000000000000
chr6,170206023,170206856,833,-1,0,,0,0.00000000000000000000
chr6,169633791,169634533,742,-1,0,7058,1,134.77088948787100000000
chr6,170165782,170166315,533,-1,0,55780,1,187.61726078799300000000
chr6,170044780,170045177,397,-1,0,253769,1,251.88916876574300000000
chr6,170062636,170063085,449,-1,0,253769,1,222.71714922049000000000
chr6,170354706,170355171,465,-1,0,,0,0.00000000000000000000
chr6,169773893,169774306,413,-1,0,,0,0.00000000000000000000
chr6,170009192,170009650,458,-1,0,253769,1,218.34061135371200000000
chr6,170209983,170210367,384,-1,0,,0,0.00000000000000000000
chr6,170229042,170229409,367,-1,0,,0,0.00000000000000000000
chr6,169591903,169592289,386,-1,0,,0,0.00000000000000000000
chr6,170038117,170038445,328,-1,0,253769,1,304.87804878048800000000
chr6,170206111,170206456,345,-1,0,,0,0.00000000000000000000
chr6,169662916,169663249,333,-1,0,,0,0.00000000000000000000
chr6,169905551,169905661,110,-1,0,253769,1,909.09090909090900000000
chr6,169618115,169618212,97,-1,0,7058,1,1030.92783505155000000000
chr6,169725808,169725913,105,-1,0,,0,0.00000000000000000000
chr6,170379902,170381711,1809,-1,0,,0,0.00000000000000000000
chr6,170381086,170381821,735,-1,0,,0,0.00000000000000000000
chr6,170402676,170403227,551,-1,0,,0,0.00000000000000000000
chr6,170423525,170423598,73,-1,0,,0,0.00000000000000000000
chr6,170483638,170487347,3709,-1,0,,0,0.00000000000000000000
chr6,170564527,170567947,3420,-1,0,,0,0.00000000000000000000
chr6,170484382,170486248,1866,-1,0,,0,0.00000000000000000000
chr6,170554745,170556792,2047,-1,0,,0,0.00000000000000000000
chr6,170546384,170547284,900,-1,0,,0,0.00000000000000000000
chr6,170555282,170556214,932,-1,0,,0,0.00000000000000000000
chr6,170546362,170547032,670,-1,0,,0,0.00000000000000000000
chr6,170562240,170562688,448,-1,0,,0,0.00000000000000000000
chr6,170546640,170547136,496,-1,0,,0,0.00000000000000000000
chr6,170465194,170465692,498,-1,0,,0,0.00000000000000000000
chr6,170573812,170574327,515,-1,0,,0,0.00000000000000000000
chr6,170484141,170484675,534,-1,0,,0,0.00000000000000000000
chr6,170529029,170529322,293,-1,0,,0,0.00000000000000000000
chr6,170573974,170574181,207,-1,0,,0,0.00000000000000000000
chr6,170470647,170470768,121,-1,0,,0,0.00000000000000000000
chr6,170464820,170464881,61,-1,0,,0,0.00000000000000000000
chr6,170465435,170465498,63,-1,0,,0,0.00000000000000000000
chr6,170575338,170577481,2143,-1,0,,0,0.00000000000000000000
chr6,170575839,170576802,963,-1,0,,0,0.00000000000000000000
chr6,170924694,171046242,121548,-1,0,,0,0.00000000000000000000
chr6,170996477,171045824,49347,-1,0,,0,0.00000000000000000000
chr6,170802724,170840750,38026,-1,0,,0,0.00000000000000000000
chr6,170803651,170806185,2534,-1,0,,0,0.00000000000000000000
chr6,170766674,170769437,2763,-1,0,,0,0.00000000000000000000
chr6,170652344,170653589,1245,-1,0,84498,1,80.32128514056230000000
chr6,170707389,170709461,2072,-1,0,84498,1,48.26254826254830000000
chr6,170766829,170768559,1730,-1,0,,0,0.00000000000000000000
chr6,170778251,170779415,1164,-1,0,,0,0.00000000000000000000
chr6,170767974,170769350,1376,-1,0,,0,0.00000000000000000000
chr6,170685957,170687122,1165,-1,0,84498,1,85.83690987124460000000
chr6,170811586,170812201,615,-1,0,,0,0.00000000000000000000
chr7,82951,110309,27358,-1,0,,0,0.00000000000000000000
chr7,60011,63827,3816,-1,0,,0,0.00000000000000000000
chr7,102763,104505,1742,-1,0,,0,0.00000000000000000000
chr7,60154,60345,191,-1,0,,0,0.00000000000000000000
chr7,110502,110600,98,-1,0,,0,0.00000000000000000000
chr7,127589,183736,56147,-1,0,,0,0.00000000000000000000
chr7,313170,335029,21859,-1,0,,0,0.00000000000000000000
chr7,209759,229225,19466,-1,0,56975,1,5.13716223158327000000
chr7,149364,160142,10778,-1,0,,0,0.00000000000000000000
chr7,151127,160561,9434,-1,0,,0,0.00000000000000000000
chr7,153109,158596,5487,-1,0,,0,0.00000000000000000000
chr7,224095,226143,2048,-1,0,56975,1,48.82812500000000000000
chr7,213993,216340,2347,-1,0,56975,1,42.60758414997870000000
chr7,192015,193970,1955,-1,0,56975,1,51.15089514066500000000
chr7,215255,216491,1236,-1,0,56975,1,80.90614886731390000000
chr7,322008,323251,1243,-1,0,,0,0.00000000000000000000
chr7,206526,207332,806,-1,0,56975,1,124.06947890818900000000
chr7,140155,140606,451,-1,0,,0,0.00000000000000000000
chr7,208424,208606,182,-1,0,56975,1,549.45054945054900000000
chr7,382804,384094,1290,-1,0,,0,0.00000000000000000000
chr7,515124,515581,457,-1,0,,0,0.00000000000000000000
chr7,591436,591964,528,-1,0,5575,1,189.39393939393900000000
chr7,522806,523127,321,-1,0,,0,0.00000000000000000000
chr7,571116,571530,414,-1,0,,0,0.00000000000000000000
chr7,515142,515445,303,-1,0,,0,0.00000000000000000000
chr7,491210,491329,119,-1,0,,0,0.00000000000000000000
chr7,638093,638199,106,-1,0,5575,1,943.39622641509400000000
chr7,639413,639605,192,-1,0,5575,1,520.83333333333300000000
chr7,675505,676105,600,-1,0,5575,1,166.66666666666700000000
chr7,682348,683308,960,-1,0,5575,1,104.16666666666700000000
chr7,712072,713232,1160,-1,0,5575,1,86.20689655172410000000
chr7,781856,782257,401,-1,0,54919,1,249.37655860349100000000
chr7,778611,778976,365,-1,0,54919,1,273.97260273972600000000
chr7,807767,807823,56,-1,0,54919,1,1785.71428571429000000000
chr7,895601,1114300,218699,-1,0,23353;54905;115330;11033;51608;84310;90639,7,3.20074623112131000000
chr7,1076284,1079897,3613,-1,0,84310,1,27.67783005812340000000
chr7,867216,871030,3814,-1,0,23353,1,26.21919244887260000000
chr7,993160,994683,1523,-1,0,11033,1,65.65988181221270000000
chr7,1113168,1113941,773,-1,0,84310,1,129.36610608020700000000
chr7,945008,946066,1058,-1,0,11033,1,94.51795841209830000000
chr7,879077,879573,496,-1,0,23353,1,201.61290322580600000000
chr7,879119,879435,316,-1,0,23353,1,316.45569620253200000000
chr7,929848,930095,247,-1,0,51608,1,404.85829959514200000000
chr7,951351,951470,119,-1,0,11033,1,840.33613445378100000000
chr7,1121142,1121620,478,-1,0,84310,1,209.20502092050200000000
chr7,1154887,1157523,2636,-1,0,84310,1,37.93626707132020000000
chr7,1155164,1155874,710,-1,0,84310,1,140.84507042253500000000
chr7,1167178,1169316,2138,-1,0,84310,1,46.77268475210480000000
chr7,1167094,1167619,525,-1,0,84310,1,190.47619047619000000000
chr7,1185069,1187665,2596,-1,0,,0,0.00000000000000000000
chr7,1191278,1191754,476,-1,0,,0,0.00000000000000000000
chr7,1195642,1196244,602,-1,0,90637,1,166.11295681063100000000
chr7,1199143,1199450,307,-1,0,90637,1,325.73289902280100000000
chr7,1232830,1243349,10519,-1,0,,0,0.00000000000000000000
chr7,1311430,1313780,2350,-1,0,,0,0.00000000000000000000
chr7,1311739,1312823,1084,-1,0,,0,0.00000000000000000000
chr7,1312800,1313800,1000,-1,0,,0,0.00000000000000000000
chr7,1235734,1236553,819,-1,0,,0,0.00000000000000000000
chr7,1320144,1320806,662,-1,0,,0,0.00000000000000000000
chr7,1313088,1313624,536,-1,0,,0,0.00000000000000000000
chr7,1320461,1320833,372,-1,0,,0,0.00000000000000000000
chr7,1264467,1264771,304,-1,0,,0,0.00000000000000000000
chr7,1346006,1346191,185,-1,0,,0,0.00000000000000000000
chr7,1334355,1334424,69,-1,0,,0,0.00000000000000000000
chr7,1420901,1715300,294399,-1,0,84262;79778;26173;7975;202915,5,1.69837533415535000000
chr7,1703745,1711183,7438,-1,0,,0,0.00000000000000000000
chr7,1664252,1667556,3304,-1,0,,0,0.00000000000000000000
chr7,1495188,1495960,772,-1,0,79778,1,129.53367875647700000000
chr7,1565630,1566130,500,-1,0,,0,0.00000000000000000000
chr7,1742059,1742573,514,-1,0,,0,0.00000000000000000000
chr7,1795341,1795888,547,-1,0,,0,0.00000000000000000000
chr7,1837477,1839202,1725,-1,0,,0,0.00000000000000000000
chr7,1838353,1839079,726,-1,0,,0,0.00000000000000000000
chr7,1944681,2038635,93954,-1,0,8379,1,1.06435063967473000000
chr7,1856007,1863587,7580,-1,0,8379,1,13.19261213720320000000
chr7,1942382,1945418,3036,-1,0,8379,1,32.93807641633730000000
chr7,2357959,2360506,2547,-1,0,,0,0.00000000000000000000
chr7,2030351,2032256,1905,-1,0,8379,1,52.49343832021000000000
chr7,2074858,2076015,1157,-1,0,8379,1,86.43042350907520000000
chr7,2246367,2248038,1671,-1,0,8379,1,59.84440454817470000000
chr7,2030442,2031768,1326,-1,0,8379,1,75.41478129713420000000
chr7,1944292,1945191,899,-1,0,8379,1,111.23470522803100000000
chr7,1910448,1911245,797,-1,0,8379,1,125.47051442910900000000
chr7,1927308,1928117,809,-1,0,8379,1,123.60939431396800000000
chr7,2075408,2076069,661,-1,0,8379,1,151.28593040847200000000
chr7,1970547,1971053,506,-1,0,8379,1,197.62845849802400000000
chr7,1969610,1970099,489,-1,0,8379,1,204.49897750511200000000
chr7,2036265,2036727,462,-1,0,8379,1,216.45021645021600000000
chr7,1922407,1922862,455,-1,0,8379,1,219.78021978022000000000
chr7,2264688,2265128,440,-1,0,8379,1,227.27272727272700000000
chr7,2249944,2250353,409,-1,0,8379,1,244.49877750611200000000
chr7,1943455,1943747,292,-1,0,8379,1,342.46575342465800000000
chr7,1885033,1885418,385,-1,0,8379,1,259.74025974026000000000
chr7,1922566,1922771,205,-1,0,8379,1,487.80487804878000000000
chr7,1885064,1885198,134,-1,0,8379,1,746.26865671641800000000
chr7,1970770,1970857,87,-1,0,8379,1,1149.42528735632000000000
chr7,1898679,1898746,67,-1,0,8379,1,1492.53731343284000000000
chr7,2417186,2417806,620,-1,0,8662,1,161.29032258064500000000
chr7,2417910,2418312,402,-1,0,8662,1,248.75621890547300000000
chr7,2417445,2417886,441,-1,0,8662,1,226.75736961451200000000
chr7,2428671,2428963,292,-1,0,,0,0.00000000000000000000
chr7,2533401,2533909,508,-1,0,,0,0.00000000000000000000
chr7,2533490,2533830,340,-1,0,,0,0.00000000000000000000
chr7,2631801,2743000,111199,-1,0,155185;80727;23288,3,2.69786598800349000000
chr7,2727927,2733862,5935,-1,0,155185,1,16.84919966301600000000
chr7,2730708,2731292,584,-1,0,155185,1,171.23287671232900000000
chr7,2631515,2631877,362,-1,0,23288,1,276.24309392265200000000
chr7,2899046,2899197,151,-1,0,,0,0.00000000000000000000
chr7,2965347,2965887,540,-1,0,84433,1,185.18518518518500000000
chr7,2949116,2949426,310,-1,0,84433,1,322.58064516129000000000
chr7,3135290,3138172,2882,-1,0,,0,0.00000000000000000000
chr7,3303992,3304234,242,-1,0,,0,0.00000000000000000000
chr7,3374496,3514568,140072,-1,0,221935,1,0.71391855617111200000
chr7,3366160,3419484,53324,-1,0,221935,1,1.87532818243193000000
chr7,3388333,3457368,69035,-1,0,221935,1,1.44854059535018000000
chr7,3376522,3402923,26401,-1,0,221935,1,3.78773531305632000000
chr7,3401179,3426034,24855,-1,0,221935,1,4.02333534500101000000
chr7,3603028,3623530,20502,-1,0,221935,1,4.87757291971515000000
chr7,3610392,3619546,9154,-1,0,221935,1,10.92418614813200000000
chr7,3602058,3615034,12976,-1,0,221935,1,7.70653514180025000000
chr7,3433517,3441806,8289,-1,0,221935,1,12.06418144528890000000
chr7,3610595,3618269,7674,-1,0,221935,1,13.03101381287460000000
chr7,3610440,3615157,4717,-1,0,221935,1,21.19991520033920000000
chr7,3339915,3341921,2006,-1,0,221935,1,49.85044865403790000000
chr7,3519802,3520303,501,-1,0,221935,1,199.60079840319400000000
chr7,3654434,3655574,1140,-1,0,221935,1,87.71929824561400000000
chr7,3708209,3765709,57500,-1,0,221935,1,1.73913043478261000000
chr7,3720933,3723156,2223,-1,0,221935,1,44.98425551057130000000
chr7,3836378,3856529,20151,-1,0,221935,1,4.96253287678031000000
chr7,4002388,4003640,1252,-1,0,221935,1,79.87220447284340000000
chr7,4015431,4017306,1875,-1,0,221935,1,53.33333333333330000000
chr7,4069958,4084566,14608,-1,0,221935,1,6.84556407447974000000
chr7,4080655,4082572,1917,-1,0,221935,1,52.16484089723530000000
chr7,4081249,4082295,1046,-1,0,221935,1,95.60229445506690000000
chr7,4158166,4160316,2150,-1,0,221935,1,46.51162790697670000000
chr7,4158669,4160840,2171,-1,0,221935,1,46.06172270842930000000
chr7,4179090,4179309,219,-1,0,221935,1,456.62100456621000000000
chr7,4233922,4234095,173,-1,0,221935,1,578.03468208092500000000
chr7,4293177,4299855,6678,-1,0,221935,1,14.97454327643010000000
chr7,4317259,4318864,1605,-1,0,,0,0.00000000000000000000
chr7,4323726,4324004,278,-1,0,,0,0.00000000000000000000
chr7,4323765,4323910,145,-1,0,,0,0.00000000000000000000
chr7,4349794,4594533,244739,-1,0,,0,0.00000000000000000000
chr7,4465573,4608986,143413,-1,0,,0,0.00000000000000000000
chr7,4416336,4471434,55098,-1,0,,0,0.00000000000000000000
chr7,4629479,4640799,11320,-1,0,,0,0.00000000000000000000
chr7,4504764,4511313,6549,-1,0,,0,0.00000000000000000000
chr7,4416527,4420228,3701,-1,0,,0,0.00000000000000000000
chr7,4384757,4386105,1348,-1,0,,0,0.00000000000000000000
chr7,4577824,4579137,1313,-1,0,,0,0.00000000000000000000
chr7,4424738,4425678,940,-1,0,,0,0.00000000000000000000
chr7,4733188,4738046,4858,-1,0,221937,1,20.58460271716760000000
chr7,4802287,5086597,284310,-1,0,56903;221938;221937;55698;57786;9907;100533952,7,2.46210122753333000000
chr7,4882506,5015036,132530,-1,0,56903;55698;221938,3,2.26363842148947000000
chr7,4838163,4931895,93732,-1,0,56903;55698,2,2.13374301199164000000
chr7,4798951,4851159,52208,-1,0,221937;55698;9907,3,5.74624578608642000000
chr7,5140994,5188681,47687,-1,0,,0,0.00000000000000000000
chr7,4868567,4914139,45572,-1,0,56903;55698,2,4.38865970332660000000
chr7,4905951,4930034,24083,-1,0,55698,1,4.15230660631981000000
chr7,4820445,4846653,26208,-1,0,55698;9907,2,7.63125763125763000000
chr7,5149014,5174443,25429,-1,0,,0,0.00000000000000000000
chr7,5140823,5155091,14268,-1,0,,0,0.00000000000000000000
chr7,4936713,4950821,14108,-1,0,221938,1,7.08817692089595000000
chr7,5061295,5066836,5541,-1,0,,0,0.00000000000000000000
chr7,5187618,5189106,1488,-1,0,,0,0.00000000000000000000
chr7,4972255,4973287,1032,-1,0,221938,1,96.89922480620150000000
chr7,4807749,4808068,319,-1,0,221937,1,313.47962382445100000000
chr7,5327883,5329722,1839,-1,0,222962,1,54.37737901033170000000
chr7,5335349,5335409,60,-1,0,222962,1,1666.66666666667000000000
chr7,5488831,5489084,253,-1,0,,0,0.00000000000000000000
chr7,5532003,5533525,1522,-1,0,80028,1,65.70302233902760000000
chr7,5606727,5610740,4013,-1,0,,0,0.00000000000000000000
chr7,5834454,5874213,39759,-1,0,,0,0.00000000000000000000
chr7,5840699,5855919,15220,-1,0,,0,0.00000000000000000000
chr7,5936562,5951173,14611,-1,0,51622,1,6.84415851071111000000
chr7,5881223,5887911,6688,-1,0,,0,0.00000000000000000000
chr7,5883969,5884586,617,-1,0,,0,0.00000000000000000000
chr7,5842759,5843188,429,-1,0,,0,0.00000000000000000000
chr7,5842872,5843107,235,-1,0,,0,0.00000000000000000000
chr7,6104466,6110326,5860,-1,0,,0,0.00000000000000000000
chr7,6121568,6144782,23214,-1,0,84132,1,4.30774532609632000000
chr7,6130463,6141412,10949,-1,0,,0,0.00000000000000000000
chr7,6137446,6139075,1629,-1,0,,0,0.00000000000000000000
chr7,6196137,6197090,953,-1,0,84132,1,104.93179433368300000000
chr7,6491563,6497844,6281,-1,0,,0,0.00000000000000000000
chr7,6605152,6605821,669,-1,0,,0,0.00000000000000000000
chr7,6630301,6692500,62199,-1,0,100131017;54753;79034,3,4.82322866927121000000
chr7,6691976,6694703,2727,-1,0,100131017,1,36.67033370003670000000
chr7,6666275,6666675,400,-1,0,,0,0.00000000000000000000
chr7,7016446,7142209,125763,-1,0,,0,0.00000000000000000000
chr7,7328070,7433637,105567,-1,0,340267,1,0.94726571750641800000
chr7,7000559,7089273,88714,-1,0,,0,0.00000000000000000000
chr7,7282348,7336375,54027,-1,0,56913,1,1.85092638865752000000
chr7,6862417,6922216,59799,-1,0,221960,1,1.67226876703624000000
chr7,6971729,7026720,54991,-1,0,,0,0.00000000000000000000
chr7,7012194,7052477,40283,-1,0,,0,0.00000000000000000000
chr7,7292415,7323234,30819,-1,0,,0,0.00000000000000000000
chr7,6900773,6923243,22470,-1,0,,0,0.00000000000000000000
chr7,7045396,7053980,8584,-1,0,,0,0.00000000000000000000
chr7,6785074,6789128,4054,-1,0,,0,0.00000000000000000000
chr7,7096524,7102305,5781,-1,0,,0,0.00000000000000000000
chr7,7176509,7178992,2483,-1,0,,0,0.00000000000000000000
chr7,7106872,7108486,1614,-1,0,,0,0.00000000000000000000
chr7,7107728,7108328,600,-1,0,,0,0.00000000000000000000
chr7,6742135,6742563,428,-1,0,7559,1,233.64485981308400000000
chr7,7508632,7594956,86324,-1,0,340267,1,1.15842639358695000000
chr7,7446564,7484474,37910,-1,0,340267,1,2.63782643102084000000
chr7,7504705,7510777,6072,-1,0,340267,1,16.46903820816860000000
chr7,7583519,7584968,1449,-1,0,,0,0.00000000000000000000
chr7,7451801,7453174,1373,-1,0,340267,1,72.83321194464680000000
chr7,7542205,7542734,529,-1,0,340267,1,189.03591682419700000000
chr7,7542314,7542628,314,-1,0,340267,1,318.47133757961800000000
chr7,7948936,7968559,19623,-1,0,,0,0.00000000000000000000
chr7,7924059,7926157,2098,-1,0,,0,0.00000000000000000000
chr7,8118940,8120436,1496,-1,0,113263,1,66.84491978609630000000
chr7,8230581,8236706,6125,-1,0,3382,1,16.32653061224490000000
chr7,8463551,8465546,1995,-1,0,,0,0.00000000000000000000
chr7,8319688,8319740,52,-1,0,,0,0.00000000000000000000
chr7,8546515,8547109,594,-1,0,30010,1,168.35016835016800000000
chr7,8698489,8698979,490,-1,0,30010,1,204.08163265306100000000
chr7,8698627,8698846,219,-1,0,30010,1,456.62100456621000000000
chr7,8750165,8750701,536,-1,0,30010,1,186.56716417910400000000
chr7,8750264,8750591,327,-1,0,30010,1,305.81039755351700000000
chr7,8921725,9174917,253192,-1,0,,0,0.00000000000000000000
chr7,9020575,9136300,115725,-1,0,,0,0.00000000000000000000
chr7,9144450,9225746,81296,-1,0,,0,0.00000000000000000000
chr7,8826223,8866254,40031,-1,0,,0,0.00000000000000000000
chr7,8849483,8869907,20424,-1,0,,0,0.00000000000000000000
chr7,9093834,9103214,9380,-1,0,,0,0.00000000000000000000
chr7,9191952,9193895,1943,-1,0,,0,0.00000000000000000000
chr7,9021038,9021649,611,-1,0,,0,0.00000000000000000000
chr7,9057171,9057554,383,-1,0,,0,0.00000000000000000000
chr7,9399344,9400820,1476,-1,0,,0,0.00000000000000000000
chr7,9434361,9473676,39315,-1,0,,0,0.00000000000000000000
chr7,9547768,9576378,28610,-1,0,,0,0.00000000000000000000
chr7,10398207,10655852,257645,-1,0,,0,0.00000000000000000000
chr7,10655663,10787104,131441,-1,0,,0,0.00000000000000000000
chr7,10042651,10095995,53344,-1,0,,0,0.00000000000000000000
chr7,10554835,10588157,33322,-1,0,,0,0.00000000000000000000
chr7,10788562,10803082,14520,-1,0,,0,0.00000000000000000000
chr7,9631543,9637417,5874,-1,0,,0,0.00000000000000000000
chr7,9754122,9760963,6841,-1,0,,0,0.00000000000000000000
chr7,9676190,9679968,3778,-1,0,,0,0.00000000000000000000
chr7,10504231,10506269,2038,-1,0,,0,0.00000000000000000000
chr7,9634544,9636119,1575,-1,0,,0,0.00000000000000000000
chr7,9790993,9793394,2401,-1,0,,0,0.00000000000000000000
chr7,10504282,10506128,1846,-1,0,,0,0.00000000000000000000
chr7,10628773,10630091,1318,-1,0,,0,0.00000000000000000000
chr7,9803655,9804199,544,-1,0,,0,0.00000000000000000000
chr7,9647842,9648266,424,-1,0,,0,0.00000000000000000000
chr7,10444486,10444932,446,-1,0,,0,0.00000000000000000000
chr7,9886062,9886321,259,-1,0,,0,0.00000000000000000000
chr7,9647920,9648098,178,-1,0,,0,0.00000000000000000000
chr7,9798418,9798521,103,-1,0,,0,0.00000000000000000000
chr7,10834703,10834895,192,-1,0,,0,0.00000000000000000000
chr7,10834751,10834879,128,-1,0,,0,0.00000000000000000000
chr7,11136377,11256502,120125,-1,0,9678,1,0.83246618106139400000
chr7,11309541,11363127,53586,-1,0,,0,0.00000000000000000000
chr7,11719120,11747843,28723,-1,0,221981,1,3.48153048079936000000
chr7,11331461,11340249,8788,-1,0,,0,0.00000000000000000000
chr7,11211230,11218473,7243,-1,0,,0,0.00000000000000000000
chr7,11229264,11229731,467,-1,0,,0,0.00000000000000000000
chr7,11561035,11561448,413,-1,0,221981,1,242.13075060532700000000
chr7,11561088,11561339,251,-1,0,221981,1,398.40637450199200000000
chr7,11875795,11878587,2792,-1,0,,0,0.00000000000000000000
chr7,11920548,11922861,2313,-1,0,,0,0.00000000000000000000
chr7,11920837,11922009,1172,-1,0,,0,0.00000000000000000000
chr7,11946460,11946977,517,-1,0,,0,0.00000000000000000000
chr7,12003268,12010573,7305,-1,0,,0,0.00000000000000000000
chr7,12016234,12018632,2398,-1,0,,0,0.00000000000000000000
chr7,12024151,12024588,437,-1,0,,0,0.00000000000000000000
chr7,12024229,12024499,270,-1,0,,0,0.00000000000000000000
chr7,12058439,12059693,1254,-1,0,,0,0.00000000000000000000
chr7,12058642,12059145,503,-1,0,,0,0.00000000000000000000
chr7,12058713,12059025,312,-1,0,,0,0.00000000000000000000
chr7,12277219,12284169,6950,-1,0,,0,0.00000000000000000000
chr7,12281634,12282091,457,-1,0,,0,0.00000000000000000000
chr7,12281702,12282024,322,-1,0,,0,0.00000000000000000000
chr7,12356138,12356352,214,-1,0,,0,0.00000000000000000000
chr7,12458610,12460378,1768,-1,0,,0,0.00000000000000000000
chr7,12524610,12525558,948,-1,0,,0,0.00000000000000000000
chr7,12642802,12644918,2116,-1,0,85477,1,47.25897920604910000000
chr7,12566288,12568295,2007,-1,0,,0,0.00000000000000000000
chr7,12553339,12554557,1218,-1,0,,0,0.00000000000000000000
chr7,13106772,13230152,123380,-1,0,,0,0.00000000000000000000
chr7,13171722,13228154,56432,-1,0,,0,0.00000000000000000000
chr7,13271978,13313105,41127,-1,0,,0,0.00000000000000000000
chr7,13403320,13442501,39181,-1,0,,0,0.00000000000000000000
chr7,13099964,13129786,29822,-1,0,,0,0.00000000000000000000
chr7,13561232,13577661,16429,-1,0,,0,0.00000000000000000000
chr7,13108058,13120765,12707,-1,0,,0,0.00000000000000000000
chr7,13022052,13028601,6549,-1,0,,0,0.00000000000000000000
chr7,13585554,13591276,5722,-1,0,,0,0.00000000000000000000
chr7,12744375,12750041,5666,-1,0,,0,0.00000000000000000000
chr7,13278185,13281311,3126,-1,0,,0,0.00000000000000000000
chr7,13167358,13169300,1942,-1,0,,0,0.00000000000000000000
chr7,13590325,13591570,1245,-1,0,,0,0.00000000000000000000
chr7,13109378,13110876,1498,-1,0,,0,0.00000000000000000000
chr7,13242202,13243162,960,-1,0,,0,0.00000000000000000000
chr7,13049587,13050776,1189,-1,0,,0,0.00000000000000000000
chr7,13109811,13110363,552,-1,0,,0,0.00000000000000000000
chr7,13663103,13663551,448,-1,0,,0,0.00000000000000000000
chr7,13242480,13242972,492,-1,0,,0,0.00000000000000000000
chr7,13170606,13170983,377,-1,0,,0,0.00000000000000000000
chr7,13742760,13743136,376,-1,0,,0,0.00000000000000000000
chr7,13676796,13677211,415,-1,0,,0,0.00000000000000000000
chr7,13110044,13110337,293,-1,0,,0,0.00000000000000000000
chr7,13663191,13663472,281,-1,0,,0,0.00000000000000000000
chr7,13110169,13110387,218,-1,0,,0,0.00000000000000000000
chr7,13242610,13242796,186,-1,0,,0,0.00000000000000000000
chr7,13109964,13110044,80,-1,0,,0,0.00000000000000000000
chr7,13615457,13615529,72,-1,0,,0,0.00000000000000000000
chr7,13370199,13370258,59,-1,0,,0,0.00000000000000000000
chr7,13865934,13871169,5235,-1,0,,0,0.00000000000000000000
chr7,13881804,13886119,4315,-1,0,,0,0.00000000000000000000
chr7,14114420,14186040,71620,-1,0,1607,1,1.39625802848366000000
chr7,14111714,14111847,133,-1,0,,0,0.00000000000000000000
chr7,14250375,14252498,2123,-1,0,1607,1,47.10315591144610000000
chr7,14251146,14251988,842,-1,0,1607,1,118.76484560570100000000
chr7,14227982,14228344,362,-1,0,1607,1,276.24309392265200000000
chr7,14448949,14449504,555,-1,0,1607,1,180.18018018018000000000
chr7,14451138,14451551,413,-1,0,1607,1,242.13075060532700000000
chr7,14449039,14449371,332,-1,0,1607,1,301.20481927710800000000
chr7,14451263,14451429,166,-1,0,1607,1,602.40963855421700000000
chr7,14552050,14604330,52280,-1,0,1607,1,1.91277735271614000000
chr7,14728241,14728688,447,-1,0,1607,1,223.71364653243800000000
chr7,14680696,14681132,436,-1,0,1607,1,229.35779816513800000000
chr7,14680871,14680951,80,-1,0,1607,1,1250.00000000000000000000
chr7,14910304,14910854,550,-1,0,,0,0.00000000000000000000
chr7,14910401,14910730,329,-1,0,,0,0.00000000000000000000
chr7,14918493,14919026,533,-1,0,,0,0.00000000000000000000
chr7,14987005,14987385,380,-1,0,,0,0.00000000000000000000
chr7,15335433,15598954,263521,-1,0,392636,1,0.37947639846539700000
chr7,15148877,15251997,103120,-1,0,392636,1,0.96974398758727700000
chr7,15057222,15153483,96261,-1,0,,0,0.00000000000000000000
chr7,15252875,15325473,72598,-1,0,392636,1,1.37744841455687000000
chr7,15314904,15322103,7199,-1,0,392636,1,13.89081816919020000000
chr7,15154310,15159223,4913,-1,0,,0,0.00000000000000000000
chr7,15413725,15418516,4791,-1,0,392636,1,20.87246921310790000000
chr7,15280710,15285314,4604,-1,0,392636,1,21.72024326672460000000
chr7,15089225,15092188,2963,-1,0,,0,0.00000000000000000000
chr7,15277686,15280547,2861,-1,0,392636,1,34.95281370150300000000
chr7,15224127,15224701,574,-1,0,,0,0.00000000000000000000
chr7,15229478,15230114,636,-1,0,,0,0.00000000000000000000
chr7,15127675,15127966,291,-1,0,,0,0.00000000000000000000
chr7,15224204,15224599,395,-1,0,,0,0.00000000000000000000
chr7,15224374,15224683,309,-1,0,,0,0.00000000000000000000
chr7,15229669,15229881,212,-1,0,,0,0.00000000000000000000
chr7,15393921,15394104,183,-1,0,392636,1,546.44808743169400000000
chr7,15127801,15127923,122,-1,0,,0,0.00000000000000000000
chr7,15168878,15168940,62,-1,0,,0,0.00000000000000000000
chr7,15636005,15638119,2114,-1,0,,0,0.00000000000000000000
chr7,15885456,15885876,420,-1,0,,0,0.00000000000000000000
chr7,16042779,16079784,37005,-1,0,,0,0.00000000000000000000
chr7,16073531,16074386,855,-1,0,,0,0.00000000000000000000
chr7,16171770,16174073,2303,-1,0,729920,1,43.42162396873640000000
chr7,16247634,16330968,83334,-1,0,729920,1,1.19999040007680000000
chr7,16237156,16238388,1232,-1,0,729920,1,81.16883116883120000000
chr7,16375784,16482665,106881,-1,0,729920,1,0.93561998858543600000
chr7,16350613,16402734,52121,-1,0,729920,1,1.91861245946931000000
chr7,16493116,16493881,765,-1,0,,0,0.00000000000000000000
chr7,16667283,16667698,415,-1,0,57037,1,240.96385542168700000000
chr7,16683127,16683587,460,-1,0,57037,1,217.39130434782600000000
chr7,16697251,16701825,4574,-1,0,28969,1,21.86270222999560000000
chr7,16699802,16702329,2527,-1,0,28969,1,39.57261574990110000000
chr7,16794649,16800498,5849,-1,0,27075,1,17.09693964780300000000
chr7,16899620,16917237,17617,-1,0,155465,1,5.67633535789294000000
chr7,16936178,16936728,550,-1,0,,0,0.00000000000000000000
chr7,16936294,16936633,339,-1,0,,0,0.00000000000000000000
chr7,17090611,17097204,6593,-1,0,,0,0.00000000000000000000
chr7,17209303,17393007,183704,-1,0,196,1,0.54435396071941800000
chr7,17115399,17279397,163998,-1,0,,0,0.00000000000000000000
chr7,17397867,17477026,79159,-1,0,,0,0.00000000000000000000
chr7,17118876,17187079,68203,-1,0,,0,0.00000000000000000000
chr7,17147005,17194073,47068,-1,0,,0,0.00000000000000000000
chr7,17578190,17609211,31021,-1,0,,0,0.00000000000000000000
chr7,17637043,17677033,39990,-1,0,,0,0.00000000000000000000
chr7,17509207,17530790,21583,-1,0,,0,0.00000000000000000000
chr7,17554141,17570614,16473,-1,0,,0,0.00000000000000000000
chr7,17169793,17182255,12462,-1,0,,0,0.00000000000000000000
chr7,17499668,17501430,1762,-1,0,,0,0.00000000000000000000
chr7,17277238,17277738,500,-1,0,,0,0.00000000000000000000
chr7,17969493,17969939,446,-1,0,23161,1,224.21524663677100000000
chr7,18075654,18080343,4689,-1,0,,0,0.00000000000000000000
chr7,18087244,18113701,26457,-1,0,,0,0.00000000000000000000
chr7,18396222,18397294,1072,-1,0,9734,1,93.28358208955220000000
chr7,18691218,18692187,969,-1,0,9734,1,103.19917440660500000000
chr7,18826093,18826427,334,-1,0,9734,1,299.40119760479000000000
chr7,18954298,18954421,123,-1,0,9734,1,813.00813008130100000000
chr7,19087883,19135303,47420,-1,0,,0,0.00000000000000000000
chr7,19096550,19096926,376,-1,0,,0,0.00000000000000000000
chr7,19096687,19096747,60,-1,0,,0,0.00000000000000000000
chr7,19178709,19180700,1991,-1,0,,0,0.00000000000000000000
chr7,19463131,19471844,8713,-1,0,,0,0.00000000000000000000
chr7,19534473,19534677,204,-1,0,,0,0.00000000000000000000
chr7,19718958,19721641,2683,-1,0,,0,0.00000000000000000000
chr7,19576207,19577309,1102,-1,0,,0,0.00000000000000000000
chr7,20013159,20106279,93120,-1,0,,0,0.00000000000000000000
chr7,20048197,20096560,48363,-1,0,,0,0.00000000000000000000
chr7,20270784,20278152,7368,-1,0,,0,0.00000000000000000000
chr7,20707274,20709366,2092,-1,0,340273,1,47.80114722753350000000
chr7,20720441,20720825,384,-1,0,340273,1,260.41666666666700000000
chr7,20746468,20753775,7307,-1,0,340273,1,13.68550704803610000000
chr7,20748756,20753784,5028,-1,0,340273,1,19.88862370723950000000
chr7,20749345,20752392,3047,-1,0,340273,1,32.81916639317360000000
chr7,20992257,20994124,1867,-1,0,,0,0.00000000000000000000
chr7,21249728,21250148,420,-1,0,,0,0.00000000000000000000
chr7,21249859,21249945,86,-1,0,,0,0.00000000000000000000
chr7,21408323,21410361,2038,-1,0,,0,0.00000000000000000000
chr7,21450260,21450939,679,-1,0,,0,0.00000000000000000000
chr7,21587693,21587877,184,-1,0,8701,1,543.47826086956500000000
chr7,21587706,21587827,121,-1,0,8701,1,826.44628099173600000000
chr7,21836904,21837195,291,-1,0,8701,1,343.64261168384900000000
chr7,22058975,22060257,1282,-1,0,,0,0.00000000000000000000
chr7,22068712,22069045,333,-1,0,,0,0.00000000000000000000
chr7,22446712,22453691,6979,-1,0,,0,0.00000000000000000000
chr7,22434786,22436761,1975,-1,0,,0,0.00000000000000000000
chr7,22202495,22203122,627,-1,0,9771,1,159.48963317384400000000
chr7,22472870,22473229,359,-1,0,256227,1,278.55153203342600000000
chr7,22472952,22473144,192,-1,0,256227,1,520.83333333333300000000
chr7,22472964,22473080,116,-1,0,256227,1,862.06896551724100000000
chr7,22202758,22202865,107,-1,0,9771,1,934.57943925233600000000
chr7,23095780,23096206,426,-1,0,,0,0.00000000000000000000
chr7,23095964,23096016,52,-1,0,,0,0.00000000000000000000
chr7,23124368,23141150,16782,-1,0,,0,0.00000000000000000000
chr7,23132489,23141819,9330,-1,0,,0,0.00000000000000000000
chr7,23139870,23144322,4452,-1,0,,0,0.00000000000000000000
chr7,23262135,23263731,1596,-1,0,,0,0.00000000000000000000
chr7,23271436,23271545,109,-1,0,,0,0.00000000000000000000
chr7,23410395,23411884,1489,-1,0,10643,1,67.15916722632640000000
chr7,23491064,23492405,1341,-1,0,10643,1,74.57121551081280000000
chr7,24017978,24041397,23419,-1,0,,0,0.00000000000000000000
chr7,24300500,24314262,13762,-1,0,,0,0.00000000000000000000
chr7,24097148,24114942,17794,-1,0,,0,0.00000000000000000000
chr7,24302414,24312362,9948,-1,0,,0,0.00000000000000000000
chr7,24120055,24125842,5787,-1,0,,0,0.00000000000000000000
chr7,24359665,24363514,3849,-1,0,,0,0.00000000000000000000
chr7,24151961,24154305,2344,-1,0,,0,0.00000000000000000000
chr7,24038168,24040064,1896,-1,0,,0,0.00000000000000000000
chr7,24258084,24258483,399,-1,0,,0,0.00000000000000000000
chr7,23849918,23850133,215,-1,0,56164,1,465.11627906976700000000
chr7,23850123,23850204,81,-1,0,56164,1,1234.56790123457000000000
chr7,24591355,24592827,1472,-1,0,,0,0.00000000000000000000
chr7,24677835,24678350,515,-1,0,51678,1,194.17475728155300000000
chr7,24677945,24678278,333,-1,0,51678,1,300.30030030030000000000
chr7,25044536,25045011,475,-1,0,,0,0.00000000000000000000
chr7,25044614,25044946,332,-1,0,,0,0.00000000000000000000
chr7,25057024,25060031,3007,-1,0,,0,0.00000000000000000000
chr7,25350763,25373956,23193,-1,0,,0,0.00000000000000000000
chr7,25360557,25362570,2013,-1,0,,0,0.00000000000000000000
chr7,25398490,25416190,17700,-1,0,,0,0.00000000000000000000
chr7,25572157,25579730,7573,-1,0,,0,0.00000000000000000000
chr7,25775390,25785003,9613,-1,0,,0,0.00000000000000000000
chr7,25740254,25744778,4524,-1,0,,0,0.00000000000000000000
chr7,25776868,25777014,146,-1,0,,0,0.00000000000000000000
chr7,25979585,25982580,2995,-1,0,,0,0.00000000000000000000
chr7,26043621,26044076,455,-1,0,,0,0.00000000000000000000
chr7,26132129,26144414,12285,-1,0,,0,0.00000000000000000000
chr7,26137023,26148181,11158,-1,0,,0,0.00000000000000000000
chr7,26140434,26145276,4842,-1,0,,0,0.00000000000000000000
chr7,26178534,26179354,820,-1,0,,0,0.00000000000000000000
chr7,26219370,26222359,2989,-1,0,9603,1,33.45600535296090000000
chr7,26221950,26222773,823,-1,0,9603,1,121.50668286755800000000
chr7,26246117,26248018,1901,-1,0,11335,1,52.60389268805890000000
chr7,26248181,26251705,3524,-1,0,11335,1,28.37684449489220000000
chr7,26305501,26308131,2630,-1,0,,0,0.00000000000000000000
chr7,26444963,26456500,11537,-1,0,,0,0.00000000000000000000
chr7,26509259,26509602,343,-1,0,,0,0.00000000000000000000
chr7,26616528,26619872,3344,-1,0,,0,0.00000000000000000000
chr7,26939058,26939732,674,-1,0,,0,0.00000000000000000000
chr7,27110967,27116470,5503,-1,0,,0,0.00000000000000000000
chr7,27295346,27297283,1937,-1,0,,0,0.00000000000000000000
chr7,27506066,27506451,385,-1,0,,0,0.00000000000000000000
chr7,27514240,27514713,473,-1,0,,0,0.00000000000000000000
chr7,27514334,27514610,276,-1,0,,0,0.00000000000000000000
chr7,27783365,27783864,499,-1,0,8887,1,200.40080160320600000000
chr7,28214287,28214661,374,-1,0,221895,1,267.37967914438500000000
chr7,28573966,28575400,1434,-1,0,9586,1,69.73500697350070000000
chr7,28574298,28575148,850,-1,0,9586,1,117.64705882352900000000
chr7,28596641,28596859,218,-1,0,9586,1,458.71559633027500000000
chr7,28931308,28931741,433,-1,0,,0,0.00000000000000000000
chr7,28964125,28981624,17499,-1,0,,0,0.00000000000000000000
chr7,29024301,29033669,9368,-1,0,,0,0.00000000000000000000
chr7,29042399,29042880,481,-1,0,54504,1,207.90020790020800000000
chr7,29261742,29375954,114212,-1,0,1124,1,0.87556473925682100000
chr7,29415344,29417049,1705,-1,0,1124,1,58.65102639296190000000
chr7,29476797,29477355,558,-1,0,1124,1,179.21146953405000000000
chr7,29292174,29292511,337,-1,0,1124,1,296.73590504451000000000
chr7,29476900,29477243,343,-1,0,1124,1,291.54518950437300000000
chr7,29672432,29836608,164176,-1,0,,0,0.00000000000000000000
chr7,29666944,29687752,20808,-1,0,,0,0.00000000000000000000
chr7,29679029,29686189,7160,-1,0,,0,0.00000000000000000000
chr7,29774208,29782009,7801,-1,0,,0,0.00000000000000000000
chr7,29688448,29690145,1697,-1,0,,0,0.00000000000000000000
chr7,29688646,29690151,1505,-1,0,,0,0.00000000000000000000
chr7,29801950,29802633,683,-1,0,,0,0.00000000000000000000
chr7,29942286,29943172,886,-1,0,644150,1,112.86681715575600000000
chr7,30155200,30155492,292,-1,0,84725,1,342.46575342465800000000
chr7,30535504,30536030,526,-1,0,,0,0.00000000000000000000
chr7,30535587,30535915,328,-1,0,,0,0.00000000000000000000
chr7,30743482,30744389,907,-1,0,,0,0.00000000000000000000
chr7,30896979,30897470,491,-1,0,84182,1,203.66598778004100000000
chr7,30897063,30897361,298,-1,0,84182,1,335.57046979865800000000
chr7,30984601,30985401,800,-1,0,,0,0.00000000000000000000
chr7,31070497,31070981,484,-1,0,,0,0.00000000000000000000
chr7,31315500,31319248,3748,-1,0,,0,0.00000000000000000000
chr7,31523579,31525522,1943,-1,0,,0,0.00000000000000000000
chr7,31590265,31591994,1729,-1,0,223075,1,57.83689994216310000000
chr7,31712925,31716012,3087,-1,0,,0,0.00000000000000000000
chr7,32063744,32063975,231,-1,0,5137,1,432.90043290043300000000
chr7,32168785,32169332,547,-1,0,5137,1,182.81535648994500000000
chr7,32168926,32169172,246,-1,0,5137,1,406.50406504065000000000
chr7,32222693,32226717,4024,-1,0,5137,1,24.85089463220680000000
chr7,32286735,32287224,489,-1,0,5137,1,204.49897750511200000000
chr7,32286849,32287119,270,-1,0,5137,1,370.37037037037000000000
chr7,32390163,32393247,3084,-1,0,5137,1,32.42542153047990000000
chr7,32444614,32447412,2798,-1,0,5137,1,35.73981415296640000000
chr7,32459841,32460023,182,-1,0,5137,1,549.45054945054900000000
chr7,32478792,32479326,534,-1,0,,0,0.00000000000000000000
chr7,32478937,32479140,203,-1,0,,0,0.00000000000000000000
chr7,32549931,32550875,944,-1,0,23080,1,105.93220338983100000000
chr7,33770269,34471888,701619,-1,0,168667,1,0.14252749711738100000
chr7,34402145,34474508,72363,-1,0,,0,0.00000000000000000000
chr7,34897714,34920422,22708,-1,0,387129,1,4.40373436674300000000
chr7,34895856,34910810,14954,-1,0,387129,1,6.68717400026749000000
chr7,33504440,33517819,13379,-1,0,27241,1,7.47440017938560000000
chr7,32725787,32737270,11483,-1,0,,0,0.00000000000000000000
chr7,34671855,34676667,4812,-1,0,,0,0.00000000000000000000
chr7,34342535,34346276,3741,-1,0,,0,0.00000000000000000000
chr7,32774367,32778079,3712,-1,0,,0,0.00000000000000000000
chr7,34278337,34281633,3296,-1,0,,0,0.00000000000000000000
chr7,33402700,33404895,2195,-1,0,27241,1,45.55808656036450000000
chr7,33905293,33907857,2564,-1,0,,0,0.00000000000000000000
chr7,33177788,33179376,1588,-1,0,27241,1,62.97229219143580000000
chr7,35083948,35086223,2275,-1,0,,0,0.00000000000000000000
chr7,34647351,34648409,1058,-1,0,,0,0.00000000000000000000
chr7,33046835,33048217,1382,-1,0,,0,0.00000000000000000000
chr7,33711800,33712305,505,-1,0,,0,0.00000000000000000000
chr7,34647562,34648206,644,-1,0,,0,0.00000000000000000000
chr7,33403434,33403970,536,-1,0,27241,1,186.56716417910400000000
chr7,33898756,33899279,523,-1,0,,0,0.00000000000000000000
chr7,35076688,35077358,670,-1,0,23333,1,149.25373134328400000000
chr7,32811032,32811469,437,-1,0,,0,0.00000000000000000000
chr7,33403550,33403856,306,-1,0,27241,1,326.79738562091500000000
chr7,33898843,33899180,337,-1,0,,0,0.00000000000000000000
chr7,34647700,34648015,315,-1,0,,0,0.00000000000000000000
chr7,32822225,32822512,287,-1,0,,0,0.00000000000000000000
chr7,34647777,34648021,244,-1,0,,0,0.00000000000000000000
chr7,33708273,33708407,134,-1,0,,0,0.00000000000000000000
chr7,32801931,32802006,75,-1,0,,0,0.00000000000000000000
chr7,33712015,33712076,61,-1,0,,0,0.00000000000000000000
chr7,35607992,35608052,60,-1,0,,0,0.00000000000000000000
chr7,35721698,35724967,3269,-1,0,64224,1,30.59039461609050000000
chr7,36441167,36441941,774,-1,0,54443,1,129.19896640826900000000
chr7,36525701,36527505,1804,-1,0,,0,0.00000000000000000000
chr7,36526237,36526950,713,-1,0,,0,0.00000000000000000000
chr7,36526418,36526635,217,-1,0,,0,0.00000000000000000000
chr7,36563267,36563898,631,-1,0,313,1,158.47860538827300000000
chr7,36574566,36574615,49,-1,0,313,1,2040.81632653061000000000
chr7,36878880,36878968,88,-1,0,,0,0.00000000000000000000
chr7,37216836,37217267,431,-1,0,9844,1,232.01856148491900000000
chr7,37323563,37324871,1308,-1,0,9844,1,76.45259938837920000000
chr7,37465624,37468500,2876,-1,0,9844,1,34.77051460361610000000
chr7,37477263,37477637,374,-1,0,9844,1,267.37967914438500000000
chr7,37700146,37701568,1422,-1,0,,0,0.00000000000000000000
chr7,37726136,37729564,3428,-1,0,353345,1,29.17152858809800000000
chr7,37786623,37789677,3054,-1,0,,0,0.00000000000000000000
chr7,37998385,37998935,550,-1,0,,0,0.00000000000000000000
chr7,37998519,37998821,302,-1,0,,0,0.00000000000000000000
chr7,38292451,38398255,105804,-1,0,445347,1,0.94514385089410600000
chr7,38296285,38356627,60342,-1,0,445347,1,1.65722050976103000000
chr7,38329902,38385253,55351,-1,0,,0,0.00000000000000000000
chr7,38295724,38345129,49405,-1,0,445347,1,2.02408663090780000000
chr7,38357040,38398621,41581,-1,0,,0,0.00000000000000000000
chr7,38382016,38418299,36283,-1,0,,0,0.00000000000000000000
chr7,38322322,38354151,31829,-1,0,,0,0.00000000000000000000
chr7,38316623,38339256,22633,-1,0,,0,0.00000000000000000000
chr7,38282211,38304191,21980,-1,0,445347,1,4.54959053685168000000
chr7,38297747,38317376,19629,-1,0,445347,1,5.09450303122930000000
chr7,38388741,38405542,16801,-1,0,,0,0.00000000000000000000
chr7,38319296,38335033,15737,-1,0,,0,0.00000000000000000000
chr7,38386563,38397743,11180,-1,0,,0,0.00000000000000000000
chr7,38392782,38403555,10773,-1,0,,0,0.00000000000000000000
chr7,38390654,38397743,7089,-1,0,,0,0.00000000000000000000
chr7,38282237,38285909,3672,-1,0,,0,0.00000000000000000000
chr7,38388231,38392673,4442,-1,0,,0,0.00000000000000000000
chr7,38383668,38387988,4320,-1,0,,0,0.00000000000000000000
chr7,38508426,38508845,419,-1,0,273,1,238.66348448687400000000
chr7,38513005,38513343,338,-1,0,273,1,295.85798816568000000000
chr7,38580687,38581142,455,-1,0,273,1,219.78021978022000000000
chr7,38580887,38580938,51,-1,0,273,1,1960.78431372549000000000
chr7,39190378,39200735,10357,-1,0,11281,1,9.65530559042194000000
chr7,39380184,39380576,392,-1,0,11281,1,255.10204081632700000000
chr7,39380350,39380421,71,-1,0,11281,1,1408.45070422535000000000
chr7,39387268,39387887,619,-1,0,11281,1,161.55088852988700000000
chr7,39449191,39449866,675,-1,0,11281,1,148.14814814814800000000
chr7,39546333,39551974,5641,-1,0,,0,0.00000000000000000000
chr7,39547914,39554056,6142,-1,0,,0,0.00000000000000000000
chr7,39592056,39592371,315,-1,0,,0,0.00000000000000000000
chr7,39597372,39597638,266,-1,0,,0,0.00000000000000000000
chr7,39820097,39825207,5110,-1,0,,0,0.00000000000000000000
chr7,39832147,39833574,1427,-1,0,,0,0.00000000000000000000
chr7,40293842,40295383,1541,-1,0,79783,1,64.89292667099290000000
chr7,40428723,40476507,47784,-1,0,79783,1,2.09275071153524000000
chr7,40441247,40480690,39443,-1,0,79783,1,2.53530410972796000000
chr7,40363924,40368793,4869,-1,0,79783,1,20.53809817210930000000
chr7,41420358,41423303,2945,-1,0,,0,0.00000000000000000000
chr7,41758664,41759462,798,-1,0,,0,0.00000000000000000000
chr7,41819017,41820796,1779,-1,0,,0,0.00000000000000000000
chr7,42246851,42250390,3539,-1,0,2737,1,28.25656965244420000000
chr7,42362979,42399794,36815,-1,0,,0,0.00000000000000000000
chr7,42449327,42449404,77,-1,0,,0,0.00000000000000000000
chr7,42549606,42550133,527,-1,0,,0,0.00000000000000000000
chr7,42549703,42550027,324,-1,0,,0,0.00000000000000000000
chr7,42604543,42605087,544,-1,0,,0,0.00000000000000000000
chr7,42604631,42604974,343,-1,0,,0,0.00000000000000000000
chr7,43105841,43107758,1917,-1,0,,0,0.00000000000000000000
chr7,43169048,43169420,372,-1,0,23072,1,268.81720430107500000000
chr7,43220628,43221587,959,-1,0,23072,1,104.27528675703900000000
chr7,43379812,43384082,4270,-1,0,23072,1,23.41920374707260000000
chr7,43414929,43424754,9825,-1,0,23072,1,10.17811704834610000000
chr7,43414046,43414479,433,-1,0,23072,1,230.94688221709000000000
chr7,43414104,43414390,286,-1,0,23072,1,349.65034965035000000000
chr7,43624653,43632187,7534,-1,0,9263,1,13.27316166710910000000
chr7,43627630,43636131,8501,-1,0,9263,1,11.76332196212210000000
chr7,43627267,43631371,4104,-1,0,9263,1,24.36647173489280000000
chr7,43734735,43735392,657,-1,0,55744,1,152.20700152207000000000
chr7,43893430,43896033,2603,-1,0,,0,0.00000000000000000000
chr7,44390957,44392352,1395,-1,0,,0,0.00000000000000000000
chr7,44493686,44494279,593,-1,0,23386,1,168.63406408094400000000
chr7,44600172,44600320,148,-1,0,,0,0.00000000000000000000
chr7,44961245,44962992,1747,-1,0,,0,0.00000000000000000000
chr7,44962348,44962763,415,-1,0,,0,0.00000000000000000000
chr7,45000071,45001229,1158,-1,0,,0,0.00000000000000000000
chr7,45000662,45001401,739,-1,0,,0,0.00000000000000000000
chr7,45117629,45119692,2063,-1,0,,0,0.00000000000000000000
chr7,45472164,45472362,198,-1,0,,0,0.00000000000000000000
chr7,45481899,45488075,6176,-1,0,,0,0.00000000000000000000
chr7,45504912,45507413,2501,-1,0,,0,0.00000000000000000000
chr7,45775762,45776218,456,-1,0,,0,0.00000000000000000000
chr7,45850674,45854281,3607,-1,0,,0,0.00000000000000000000
chr7,46113683,46115522,1839,-1,0,,0,0.00000000000000000000
chr7,46253901,46256236,2335,-1,0,,0,0.00000000000000000000
chr7,46355952,46362407,6455,-1,0,,0,0.00000000000000000000
chr7,46365545,46366992,1447,-1,0,,0,0.00000000000000000000
chr7,46829904,46832456,2552,-1,0,,0,0.00000000000000000000
chr7,46874617,46887604,12987,-1,0,,0,0.00000000000000000000
chr7,47089527,47092785,3258,-1,0,,0,0.00000000000000000000
chr7,47219078,47219174,96,-1,0,,0,0.00000000000000000000
chr7,47283606,47290339,6733,-1,0,,0,0.00000000000000000000
chr7,47575692,47576175,483,-1,0,64759,1,207.03933747412000000000
chr7,47895141,47895511,370,-1,0,168507,1,270.27027027027000000000
chr7,47933945,47936816,2871,-1,0,168507,1,34.83106931382790000000
chr7,48012133,48012488,355,-1,0,3364,1,281.69014084507000000000
chr7,48079334,48079406,72,-1,0,136288,1,1388.88888888889000000000
chr7,48356214,48552033,195819,-1,0,154664,1,0.51067567498557300000
chr7,48581269,48594736,13467,-1,0,154664,1,7.42555877329769000000
chr7,48391641,48402155,10514,-1,0,154664,1,9.51112801978315000000
chr7,48340695,48341494,799,-1,0,154664,1,125.15644555694600000000
chr7,48653039,48654881,1842,-1,0,154664,1,54.28881650380020000000
chr7,49173339,49180032,6693,-1,0,,0,0.00000000000000000000
chr7,49552064,49552383,319,-1,0,,0,0.00000000000000000000
chr7,49719642,49726154,6512,-1,0,,0,0.00000000000000000000
chr7,50018843,50022589,3746,-1,0,11055,1,26.69514148424990000000
chr7,50043778,50049025,5247,-1,0,11055,1,19.05850962454740000000
chr7,50104570,50106354,1784,-1,0,11055,1,56.05381165919280000000
chr7,50104767,50106066,1299,-1,0,11055,1,76.98229407236330000000
chr7,50654692,50654750,58,-1,0,,0,0.00000000000000000000
chr7,50993031,51000955,7924,-1,0,,0,0.00000000000000000000
chr7,51081676,51081738,62,-1,0,,0,0.00000000000000000000
chr7,51270875,51271203,328,-1,0,23242,1,304.87804878048800000000
chr7,51356435,51356586,151,-1,0,23242,1,662.25165562913900000000
chr7,51408351,51408520,169,-1,0,,0,0.00000000000000000000
chr7,51413994,51414860,866,-1,0,,0,0.00000000000000000000
chr7,51454725,51455863,1138,-1,0,,0,0.00000000000000000000
chr7,51594874,51602051,7177,-1,0,,0,0.00000000000000000000
chr7,51594044,51598231,4187,-1,0,,0,0.00000000000000000000
chr7,51594820,51598249,3429,-1,0,,0,0.00000000000000000000
chr7,51691773,51692333,560,-1,0,,0,0.00000000000000000000
chr7,51691895,51692218,323,-1,0,,0,0.00000000000000000000
chr7,51850898,51853868,2970,-1,0,,0,0.00000000000000000000
chr7,53460521,53602210,141689,-1,0,,0,0.00000000000000000000
chr7,52921795,52988264,66469,-1,0,,0,0.00000000000000000000
chr7,53213770,53236545,22775,-1,0,,0,0.00000000000000000000
chr7,52070472,52084550,14078,-1,0,,0,0.00000000000000000000
chr7,53455162,53466704,11542,-1,0,,0,0.00000000000000000000
chr7,53213833,53220151,6318,-1,0,,0,0.00000000000000000000
chr7,53197972,53206473,8501,-1,0,,0,0.00000000000000000000
chr7,53322212,53328122,5910,-1,0,,0,0.00000000000000000000
chr7,53279696,53285732,6036,-1,0,,0,0.00000000000000000000
chr7,53555730,53560919,5189,-1,0,,0,0.00000000000000000000
chr7,53214002,53218810,4808,-1,0,,0,0.00000000000000000000
chr7,52425593,52429130,3537,-1,0,,0,0.00000000000000000000
chr7,52963201,52964916,1715,-1,0,,0,0.00000000000000000000
chr7,52428281,52429228,947,-1,0,,0,0.00000000000000000000
chr7,53267280,53267855,575,-1,0,,0,0.00000000000000000000
chr7,52275044,52275640,596,-1,0,,0,0.00000000000000000000
chr7,52094866,52095390,524,-1,0,,0,0.00000000000000000000
chr7,52192703,52193134,431,-1,0,,0,0.00000000000000000000
chr7,52107106,52107424,318,-1,0,,0,0.00000000000000000000
chr7,53196010,53196354,344,-1,0,,0,0.00000000000000000000
chr7,53267355,53267715,360,-1,0,,0,0.00000000000000000000
chr7,52520168,52520372,204,-1,0,,0,0.00000000000000000000
chr7,52094969,52095282,313,-1,0,,0,0.00000000000000000000
chr7,52204580,52204809,229,-1,0,,0,0.00000000000000000000
chr7,52192847,52192979,132,-1,0,,0,0.00000000000000000000
chr7,53702840,53703265,425,-1,0,,0,0.00000000000000000000
chr7,53702932,53703101,169,-1,0,,0,0.00000000000000000000
chr7,57154214,57806865,652651,-1,0,90827;441234,2,0.30644249376772600000
chr7,55741690,56490277,748587,-1,0,5723;51142;349075;2631;51373;25870;908;389493;5260;346288,10,1.33585007487440000000
chr7,56739464,57212434,472970,-1,0,90827,1,0.21142990041651700000
chr7,56505345,56779051,273706,-1,0,,0,0.00000000000000000000
chr7,56805135,56974751,169616,-1,0,,0,0.00000000000000000000
chr7,57936165,58027242,91077,-1,0,,0,0.00000000000000000000
chr7,57062764,57088685,25921,-1,0,,0,0.00000000000000000000
chr7,57241262,57264726,23464,-1,0,,0,0.00000000000000000000
chr7,57541770,57556962,15192,-1,0,,0,0.00000000000000000000
chr7,56610663,56631239,20576,-1,0,,0,0.00000000000000000000
chr7,56815024,56826458,11434,-1,0,,0,0.00000000000000000000
chr7,57547096,57556719,9623,-1,0,,0,0.00000000000000000000
chr7,57600617,57610624,10007,-1,0,,0,0.00000000000000000000
chr7,57965608,57975300,9692,-1,0,,0,0.00000000000000000000
chr7,57165045,57173694,8649,-1,0,,0,0.00000000000000000000
chr7,56761880,56770173,8293,-1,0,,0,0.00000000000000000000
chr7,57993874,58000023,6149,-1,0,,0,0.00000000000000000000
chr7,56435249,56442819,7570,-1,0,,0,0.00000000000000000000
chr7,57939896,57947864,7968,-1,0,,0,0.00000000000000000000
chr7,54380642,54388276,7634,-1,0,,0,0.00000000000000000000
chr7,54185490,54191704,6214,-1,0,,0,0.00000000000000000000
chr7,56652468,56658519,6051,-1,0,,0,0.00000000000000000000
chr7,57546090,57552095,6005,-1,0,,0,0.00000000000000000000
chr7,57551448,57556083,4635,-1,0,,0,0.00000000000000000000
chr7,57459435,57464355,4920,-1,0,,0,0.00000000000000000000
chr7,55780740,55785632,4892,-1,0,,0,0.00000000000000000000
chr7,56282853,56287100,4247,-1,0,,0,0.00000000000000000000
chr7,55286720,55289109,2389,-1,0,,0,0.00000000000000000000
chr7,55789482,55793397,3915,-1,0,,0,0.00000000000000000000
chr7,56217559,56220587,3028,-1,0,,0,0.00000000000000000000
chr7,57879425,57881840,2415,-1,0,,0,0.00000000000000000000
chr7,58034218,58037899,3681,-1,0,,0,0.00000000000000000000
chr7,55809125,55812137,3012,-1,0,,0,0.00000000000000000000
chr7,56493673,56496853,3180,-1,0,,0,0.00000000000000000000
chr7,54520712,54523632,2920,-1,0,,0,0.00000000000000000000
chr7,57255974,57258273,2299,-1,0,,0,0.00000000000000000000
chr7,57957714,57959407,1693,-1,0,,0,0.00000000000000000000
chr7,57638082,57639424,1342,-1,0,,0,0.00000000000000000000
chr7,56877485,56879071,1586,-1,0,,0,0.00000000000000000000
chr7,54596406,54597500,1094,-1,0,,0,0.00000000000000000000
chr7,55234267,55235324,1057,-1,0,1956,1,94.60737937559130000000
chr7,56800800,56802117,1317,-1,0,,0,0.00000000000000000000
chr7,55676872,55677782,910,-1,0,,0,0.00000000000000000000
chr7,54484533,54485572,1039,-1,0,,0,0.00000000000000000000
chr7,55134880,55135867,987,-1,0,1956,1,101.31712259371800000000
chr7,55363295,55364244,949,-1,0,,0,0.00000000000000000000
chr7,54562782,54563582,800,-1,0,,0,0.00000000000000000000
chr7,54596601,54597335,734,-1,0,,0,0.00000000000000000000
chr7,57568721,57569300,579,-1,0,,0,0.00000000000000000000
chr7,56005967,56006374,407,-1,0,349075,1,245.70024570024600000000
chr7,57364828,57365292,464,-1,0,,0,0.00000000000000000000
chr7,54668975,54669541,566,-1,0,,0,0.00000000000000000000
chr7,56483194,56483702,508,-1,0,,0,0.00000000000000000000
chr7,57284616,57285011,395,-1,0,,0,0.00000000000000000000
chr7,55971769,55972134,365,-1,0,349075,1,273.97260273972600000000
chr7,58040881,58041341,460,-1,0,,0,0.00000000000000000000
chr7,56314080,56314400,320,-1,0,,0,0.00000000000000000000
chr7,57568838,57569177,339,-1,0,,0,0.00000000000000000000
chr7,55409860,55410106,246,-1,0,,0,0.00000000000000000000
chr7,56834967,56835104,137,-1,0,,0,0.00000000000000000000
chr7,56797608,56797729,121,-1,0,,0,0.00000000000000000000
chr7,55305437,55305501,64,-1,0,,0,0.00000000000000000000
chr7,61066031,61825153,759122,-1,0,,0,0.00000000000000000000
chr7,64589517,65204627,615110,-1,0,168374,1,0.16257254799954500000
chr7,61296475,61867864,571389,-1,0,,0,0.00000000000000000000
chr7,61837159,62101428,264269,-1,0,,0,0.00000000000000000000
chr7,64677496,64959102,281606,-1,0,168374,1,0.35510607018316400000
chr7,61738274,62002611,264337,-1,0,,0,0.00000000000000000000
chr7,62101616,62356314,254698,-1,0,,0,0.00000000000000000000
chr7,63551776,63831792,280016,-1,0,730291;728927;168417,3,1.07136735043712000000
chr7,62623119,62835718,212599,-1,0,,0,0.00000000000000000000
chr7,63482832,63739370,256538,-1,0,442319;730291;168417,3,1.16941739625319000000
chr7,62015392,62239911,224519,-1,0,,0,0.00000000000000000000
chr7,62849387,63083344,233957,-1,0,,0,0.00000000000000000000
chr7,61077915,61266889,188974,-1,0,,0,0.00000000000000000000
chr7,61665938,61839403,173465,-1,0,,0,0.00000000000000000000
chr7,64133709,64279274,145565,-1,0,7697;51427,2,1.37395665166764000000
chr7,61786532,61885095,98563,-1,0,,0,0.00000000000000000000
chr7,62672044,62789947,117903,-1,0,,0,0.00000000000000000000
chr7,62140256,62242665,102409,-1,0,,0,0.00000000000000000000
chr7,61986363,62076487,90124,-1,0,,0,0.00000000000000000000
chr7,64842454,64888397,45943,-1,0,168374,1,2.17661014735651000000
chr7,61759527,61836016,76489,-1,0,,0,0.00000000000000000000
chr7,64576930,64634611,57681,-1,0,,0,0.00000000000000000000
chr7,61835667,61888128,52461,-1,0,,0,0.00000000000000000000
chr7,61744813,61787580,42767,-1,0,,0,0.00000000000000000000
chr7,65094648,65147318,52670,-1,0,,0,0.00000000000000000000
chr7,61810663,61853577,42914,-1,0,,0,0.00000000000000000000
chr7,62687315,62723648,36333,-1,0,,0,0.00000000000000000000
chr7,63925822,63960053,34231,-1,0,,0,0.00000000000000000000
chr7,65057477,65096871,39394,-1,0,,0,0.00000000000000000000
chr7,62711973,62747350,35377,-1,0,,0,0.00000000000000000000
chr7,62253623,62288112,34489,-1,0,,0,0.00000000000000000000
chr7,64940539,64974354,33815,-1,0,,0,0.00000000000000000000
chr7,61743028,61766686,23658,-1,0,,0,0.00000000000000000000
chr7,62365874,62383390,17516,-1,0,,0,0.00000000000000000000
chr7,62157201,62182283,25082,-1,0,,0,0.00000000000000000000
chr7,61779995,61802293,22298,-1,0,,0,0.00000000000000000000
chr7,64324812,64345264,20452,-1,0,,0,0.00000000000000000000
chr7,62028516,62051105,22589,-1,0,,0,0.00000000000000000000
chr7,64583171,64601077,17906,-1,0,,0,0.00000000000000000000
chr7,61740072,61759187,19115,-1,0,,0,0.00000000000000000000
chr7,65094610,65112495,17885,-1,0,,0,0.00000000000000000000
chr7,65020080,65037588,17508,-1,0,,0,0.00000000000000000000
chr7,61846988,61862365,15377,-1,0,,0,0.00000000000000000000
chr7,62963166,62979392,16226,-1,0,,0,0.00000000000000000000
chr7,62146469,62162985,16516,-1,0,,0,0.00000000000000000000
chr7,63210042,63225477,15435,-1,0,,0,0.00000000000000000000
chr7,61786558,61798103,11545,-1,0,,0,0.00000000000000000000
chr7,61967431,61978757,11326,-1,0,,0,0.00000000000000000000
chr7,61514319,61525570,11251,-1,0,,0,0.00000000000000000000
chr7,64718038,64724732,6694,-1,0,,0,0.00000000000000000000
chr7,64592901,64604300,11399,-1,0,,0,0.00000000000000000000
chr7,62280558,62291546,10988,-1,0,,0,0.00000000000000000000
chr7,65589726,65598577,8851,-1,0,27297,1,11.29815840018080000000
chr7,61748501,61756495,7994,-1,0,,0,0.00000000000000000000
chr7,62089854,62096013,6159,-1,0,,0,0.00000000000000000000
chr7,61848650,61857783,9133,-1,0,,0,0.00000000000000000000
chr7,63320990,63328481,7491,-1,0,,0,0.00000000000000000000
chr7,62979350,62986873,7523,-1,0,,0,0.00000000000000000000
chr7,61971046,61975626,4580,-1,0,,0,0.00000000000000000000
chr7,62015890,62022246,6356,-1,0,,0,0.00000000000000000000
chr7,62829536,62835416,5880,-1,0,,0,0.00000000000000000000
chr7,61527798,61533957,6159,-1,0,,0,0.00000000000000000000
chr7,62027516,62033534,6018,-1,0,,0,0.00000000000000000000
chr7,64718371,64722246,3875,-1,0,,0,0.00000000000000000000
chr7,61967826,61973107,5281,-1,0,,0,0.00000000000000000000
chr7,64721232,64725911,4679,-1,0,,0,0.00000000000000000000
chr7,61971236,61976169,4933,-1,0,,0,0.00000000000000000000
chr7,62366079,62369695,3616,-1,0,,0,0.00000000000000000000
chr7,64315439,64318493,3054,-1,0,,0,0.00000000000000000000
chr7,61787405,61791145,3740,-1,0,,0,0.00000000000000000000
chr7,62951724,62955357,3633,-1,0,,0,0.00000000000000000000
chr7,65587800,65591945,4145,-1,0,27297,1,24.12545235223160000000
chr7,62142466,62145998,3532,-1,0,,0,0.00000000000000000000
chr7,65616393,65620222,3829,-1,0,27297,1,26.11647949856360000000
chr7,61967861,61970576,2715,-1,0,,0,0.00000000000000000000
chr7,61862249,61864632,2383,-1,0,,0,0.00000000000000000000
chr7,64719664,64722773,3109,-1,0,,0,0.00000000000000000000
chr7,61969919,61972524,2605,-1,0,,0,0.00000000000000000000
chr7,61743886,61746711,2825,-1,0,,0,0.00000000000000000000
chr7,65857641,65860105,2464,-1,0,,0,0.00000000000000000000
chr7,64280113,64283086,2973,-1,0,7697,1,33.63605785401950000000
chr7,65589659,65592030,2371,-1,0,27297,1,42.17629692113030000000
chr7,61973193,61975902,2709,-1,0,,0,0.00000000000000000000
chr7,62002293,62004874,2581,-1,0,,0,0.00000000000000000000
chr7,65483009,65485515,2506,-1,0,,0,0.00000000000000000000
chr7,61967808,61969773,1965,-1,0,,0,0.00000000000000000000
chr7,64315824,64318075,2251,-1,0,,0,0.00000000000000000000
chr7,61977768,61979465,1697,-1,0,,0,0.00000000000000000000
chr7,64497798,64499924,2126,-1,0,,0,0.00000000000000000000
chr7,61969192,61970786,1594,-1,0,,0,0.00000000000000000000
chr7,61973233,61975342,2109,-1,0,,0,0.00000000000000000000
chr7,62116860,62118903,2043,-1,0,,0,0.00000000000000000000
chr7,62313265,62315204,1939,-1,0,,0,0.00000000000000000000
chr7,64719791,64721811,2020,-1,0,,0,0.00000000000000000000
chr7,64677366,64679290,1924,-1,0,,0,0.00000000000000000000
chr7,64594065,64595698,1633,-1,0,,0,0.00000000000000000000
chr7,64413162,64414312,1150,-1,0,,0,0.00000000000000000000
chr7,62512884,62514308,1424,-1,0,,0,0.00000000000000000000
chr7,63148349,63149617,1268,-1,0,,0,0.00000000000000000000
chr7,65590555,65591713,1158,-1,0,27297,1,86.35578583765110000000
chr7,61762081,61763415,1334,-1,0,,0,0.00000000000000000000
chr7,63586529,63587814,1285,-1,0,,0,0.00000000000000000000
chr7,63935803,63936788,985,-1,0,,0,0.00000000000000000000
chr7,61970656,61971797,1141,-1,0,,0,0.00000000000000000000
chr7,62183208,62184078,870,-1,0,,0,0.00000000000000000000
chr7,64413377,64414031,654,-1,0,,0,0.00000000000000000000
chr7,64748145,64748523,378,-1,0,,0,0.00000000000000000000
chr7,61826439,61826995,556,-1,0,,0,0.00000000000000000000
chr7,62112097,62112657,560,-1,0,,0,0.00000000000000000000
chr7,65316663,65317134,471,-1,0,,0,0.00000000000000000000
chr7,63409105,63409588,483,-1,0,,0,0.00000000000000000000
chr7,62349299,62349687,388,-1,0,,0,0.00000000000000000000
chr7,63833134,63833440,306,-1,0,,0,0.00000000000000000000
chr7,62035023,62035277,254,-1,0,,0,0.00000000000000000000
chr7,61894418,61894592,174,-1,0,,0,0.00000000000000000000
chr7,61896602,61896785,183,-1,0,,0,0.00000000000000000000
chr7,63750007,63750161,154,-1,0,,0,0.00000000000000000000
chr7,63800017,63800170,153,-1,0,728927,1,653.59477124183000000000
chr7,65930158,65942229,12071,-1,0,,0,0.00000000000000000000
chr7,66188659,66188876,217,-1,0,27342,1,460.82949308755800000000
chr7,66218939,66219236,297,-1,0,27342,1,336.70033670033700000000
chr7,66338771,66357658,18887,-1,0,,0,0.00000000000000000000
chr7,66397586,66397934,348,-1,0,55069,1,287.35632183908000000000
chr7,66629358,66645186,15828,-1,0,55253,1,6.31791761435431000000
chr7,66791173,66802139,10966,-1,0,,0,0.00000000000000000000
chr7,66786025,66792897,6872,-1,0,,0,0.00000000000000000000
chr7,66825802,66831827,6025,-1,0,,0,0.00000000000000000000
chr7,66697540,66699258,1718,-1,0,55253,1,58.20721769499420000000
chr7,66755275,66756603,1328,-1,0,,0,0.00000000000000000000
chr7,66858327,66859615,1288,-1,0,,0,0.00000000000000000000
chr7,66924568,66924762,194,-1,0,,0,0.00000000000000000000
chr7,67198298,67207016,8718,-1,0,,0,0.00000000000000000000
chr7,67345772,67352987,7215,-1,0,,0,0.00000000000000000000
chr7,67217466,67222977,5511,-1,0,,0,0.00000000000000000000
chr7,67041888,67045202,3314,-1,0,,0,0.00000000000000000000
chr7,67282450,67285176,2726,-1,0,,0,0.00000000000000000000
chr7,67131150,67132159,1009,-1,0,,0,0.00000000000000000000
chr7,67862128,67863173,1045,-1,0,,0,0.00000000000000000000
chr7,67131722,67132220,498,-1,0,,0,0.00000000000000000000
chr7,67113326,67113452,126,-1,0,,0,0.00000000000000000000
chr7,66991953,66992051,98,-1,0,,0,0.00000000000000000000
chr7,68129065,68129198,133,-1,0,,0,0.00000000000000000000
chr7,68395992,68398402,2410,-1,0,,0,0.00000000000000000000
chr7,68461956,68462508,552,-1,0,,0,0.00000000000000000000
chr7,68462081,68462414,333,-1,0,,0,0.00000000000000000000
chr7,68641452,68642091,639,-1,0,,0,0.00000000000000000000
chr7,68890863,68891418,555,-1,0,,0,0.00000000000000000000
chr7,69289039,69290518,1479,-1,0,26053,1,67.61325219743070000000
chr7,69967821,69969465,1644,-1,0,26053,1,60.82725060827250000000
chr7,70109121,70110604,1483,-1,0,26053,1,67.43088334457180000000
chr7,70196037,70203037,7000,-1,0,26053,1,14.28571428571430000000
chr7,70353235,70353287,52,-1,0,,0,0.00000000000000000000
chr7,70420644,70426391,5747,-1,0,,0,0.00000000000000000000
chr7,70422963,70426064,3101,-1,0,,0,0.00000000000000000000
chr7,70447584,70448133,549,-1,0,,0,0.00000000000000000000
chr7,70447759,70448016,257,-1,0,,0,0.00000000000000000000
chr7,70566645,70567992,1347,-1,0,,0,0.00000000000000000000
chr7,70567022,70567444,422,-1,0,,0,0.00000000000000000000
chr7,70619713,70624903,5190,-1,0,64409,1,19.26782273603080000000
chr7,70676247,70678251,2004,-1,0,64409,1,49.90019960079840000000
chr7,70958919,70959785,866,-1,0,64409,1,115.47344110854500000000
chr7,71211624,71213186,1562,-1,0,,0,0.00000000000000000000
chr7,71211913,71212970,1057,-1,0,,0,0.00000000000000000000
chr7,71263873,71264722,849,-1,0,83698,1,117.78563015312100000000
chr7,71665417,71716294,50877,-1,0,83698,1,1.96552469681782000000
chr7,71686844,71690064,3220,-1,0,83698,1,31.05590062111800000000
chr7,71692719,71695103,2384,-1,0,83698,1,41.94630872483220000000
chr7,71756995,71757816,821,-1,0,83698,1,121.80267965895200000000
chr7,71817331,71858303,40972,-1,0,83698,1,2.44069120374890000000
chr7,71821184,71823816,2632,-1,0,83698,1,37.99392097264440000000
chr7,72000607,72316926,316319,-1,0,441250,1,0.31613655834774400000
chr7,72411100,72711201,300101,-1,0,378108;9883,2,0.66644229775975400000
chr7,72210435,72273084,62649,-1,0,441250,1,1.59619467190219000000
chr7,72471374,72533940,62566,-1,0,,0,0.00000000000000000000
chr7,72269657,72276468,6811,-1,0,441250,1,14.68213184554400000000
chr7,72257057,72262095,5038,-1,0,441250,1,19.84914648670110000000
chr7,72270273,72274912,4639,-1,0,441250,1,21.55636990730760000000
chr7,72308818,72310424,1606,-1,0,,0,0.00000000000000000000
chr7,72809371,72811822,2451,-1,0,,0,0.00000000000000000000
chr7,72831521,72833121,1600,-1,0,,0,0.00000000000000000000
chr7,72859076,72859956,880,-1,0,9031,1,113.63636363636400000000
chr7,73190257,73190595,338,-1,0,,0,0.00000000000000000000
chr7,73329230,73331248,2018,-1,0,,0,0.00000000000000000000
chr7,73344230,73352874,8644,-1,0,,0,0.00000000000000000000
chr7,73577415,73581002,3587,-1,0,,0,0.00000000000000000000
chr7,73573683,73575595,1912,-1,0,,0,0.00000000000000000000
chr7,73549763,73550956,1193,-1,0,,0,0.00000000000000000000
chr7,73510318,73510811,493,-1,0,3984,1,202.83975659229200000000
chr7,73784188,73784485,297,-1,0,7461,1,336.70033670033700000000
chr7,73828268,73831618,3350,-1,0,,0,0.00000000000000000000
chr7,73828495,73831356,2861,-1,0,,0,0.00000000000000000000
chr7,73981917,73983397,1480,-1,0,9569,1,67.56756756756760000000
chr7,74378312,74480711,102399,-1,0,729438;81554,2,1.95314407367259000000
chr7,74472377,74473817,1440,-1,0,81554,1,69.44444444444440000000
chr7,74772350,74774219,1869,-1,0,,0,0.00000000000000000000
chr7,75195153,75197075,1922,-1,0,3092,1,52.02913631633720000000
chr7,75293272,75293374,102,-1,0,3092,1,980.39215686274500000000
chr7,75313242,75313301,59,-1,0,3092,1,1694.91525423729000000000
chr7,75356604,75374802,18198,-1,0,3092,1,5.49510935267612000000
chr7,75426483,75438427,11944,-1,0,,0,0.00000000000000000000
chr7,75356068,75365673,9605,-1,0,3092,1,10.41124414367520000000
chr7,75390985,75394568,3583,-1,0,,0,0.00000000000000000000
chr7,75377735,75381657,3922,-1,0,,0,0.00000000000000000000
chr7,75379288,75379594,306,-1,0,,0,0.00000000000000000000
chr7,75660698,75675050,14352,-1,0,51657,1,6.96767001114827000000
chr7,75664105,75670438,6333,-1,0,51657,1,15.79030475288170000000
chr7,75664273,75667827,3554,-1,0,51657,1,28.13731007315700000000
chr7,75668004,75668700,696,-1,0,51657,1,143.67816091954000000000
chr7,75571787,75572284,497,-1,0,5447,1,201.20724346076500000000
chr7,75922397,75922752,355,-1,0,,0,0.00000000000000000000
chr7,76041163,76047805,6642,-1,0,7784,1,15.05570611261670000000
chr7,76122906,76629061,506155,-1,0,113878;22932;105375355,3,0.59270381602473600000
chr7,76326290,76575888,249598,-1,0,,0,0.00000000000000000000
chr7,76264533,76439720,175187,-1,0,,0,0.00000000000000000000
chr7,76459212,76594685,135473,-1,0,,0,0.00000000000000000000
chr7,76628148,76674915,46767,-1,0,,0,0.00000000000000000000
chr7,76713530,76754788,41258,-1,0,57639,1,2.42377235930001000000
chr7,76760280,76799477,39197,-1,0,57639,1,2.55121565425925000000
chr7,76144533,76164272,19739,-1,0,105375355,1,5.06611277167030000000
chr7,76130043,76145287,15244,-1,0,113878;105375355,2,13.11991603253740000000
chr7,76144787,76157012,12225,-1,0,105375355,1,8.17995910020450000000
chr7,76779783,76790061,10278,-1,0,57639,1,9.72951936174353000000
chr7,76702224,76708170,5946,-1,0,,0,0.00000000000000000000
chr7,76754230,76761123,6893,-1,0,57639,1,14.50747134774410000000
chr7,76144981,76150330,5349,-1,0,105375355,1,18.69508319312020000000
chr7,76144835,76147773,2938,-1,0,105375355,1,34.03675970047650000000
chr7,76260737,76263755,3018,-1,0,,0,0.00000000000000000000
chr7,76804362,76805860,1498,-1,0,57639,1,66.75567423230970000000
chr7,76144747,76146202,1455,-1,0,105375355,1,68.72852233676980000000
chr7,76627740,76628264,524,-1,0,,0,0.00000000000000000000
chr7,76607168,76607454,286,-1,0,,0,0.00000000000000000000
chr7,76870391,76870773,382,-1,0,57639,1,261.78010471204200000000
chr7,76870543,76870796,253,-1,0,57639,1,395.25691699604700000000
chr7,77142521,77142981,460,-1,0,,0,0.00000000000000000000
chr7,77306166,77316401,10235,-1,0,,0,0.00000000000000000000
chr7,77322126,77324168,2042,-1,0,,0,0.00000000000000000000
chr7,77863876,77863961,85,-1,0,9863,1,1176.47058823529000000000
chr7,77959535,77960072,537,-1,0,9863,1,186.21973929236500000000
chr7,78135008,78135440,432,-1,0,9863,1,231.48148148148100000000
chr7,77959645,77959970,325,-1,0,9863,1,307.69230769230800000000
chr7,78205848,78205927,79,-1,0,9863,1,1265.82278481013000000000
chr7,78357839,78358180,341,-1,0,9863,1,293.25513196480900000000
chr7,78434133,78437205,3072,-1,0,9863,1,32.55208333333330000000
chr7,78511297,78512750,1453,-1,0,9863,1,68.82312456985550000000
chr7,78700602,78701511,909,-1,0,9863,1,110.01100110011000000000
chr7,78803649,78854817,51168,-1,0,9863,1,1.95434646654159000000
chr7,79165307,79165627,320,-1,0,,0,0.00000000000000000000
chr7,79207626,79208519,893,-1,0,,0,0.00000000000000000000
chr7,79428554,79428615,61,-1,0,,0,0.00000000000000000000
chr7,79471629,79481975,10346,-1,0,,0,0.00000000000000000000
chr7,79469300,79475976,6676,-1,0,,0,0.00000000000000000000
chr7,79493596,79522992,29396,-1,0,,0,0.00000000000000000000
chr7,79742021,79742554,533,-1,0,,0,0.00000000000000000000
chr7,79742094,79742428,334,-1,0,,0,0.00000000000000000000
chr7,79948934,79950361,1427,-1,0,,0,0.00000000000000000000
chr7,79960928,79966371,5443,-1,0,,0,0.00000000000000000000
chr7,80126736,80127104,368,-1,0,346562,1,271.73913043478300000000
chr7,80157652,80157796,144,-1,0,,0,0.00000000000000000000
chr7,80259615,80280145,20530,-1,0,948,1,4.87092060399416000000
chr7,80478585,80478783,198,-1,0,10512,1,505.05050505050500000000
chr7,80602257,80602873,616,-1,0,,0,0.00000000000000000000
chr7,80607950,80610484,2534,-1,0,,0,0.00000000000000000000
chr7,80614974,80621003,6029,-1,0,,0,0.00000000000000000000
chr7,80801663,80802060,397,-1,0,,0,0.00000000000000000000
chr7,81006478,81008064,1586,-1,0,,0,0.00000000000000000000
chr7,81358251,81358708,457,-1,0,3082,1,218.81838074398200000000
chr7,81358331,81358613,282,-1,0,3082,1,354.60992907801400000000
chr7,81441545,81442495,950,-1,0,,0,0.00000000000000000000
chr7,81441722,81442368,646,-1,0,,0,0.00000000000000000000
chr7,81441678,81442151,473,-1,0,,0,0.00000000000000000000
chr7,81728726,81729064,338,-1,0,781,1,295.85798816568000000000
chr7,81799962,81800795,833,-1,0,781,1,120.04801920768300000000
chr7,81819549,81827681,8132,-1,0,781,1,12.29709788489920000000
chr7,81920042,81927510,7468,-1,0,781,1,13.39046598821640000000
chr7,81955920,81956208,288,-1,0,781,1,347.22222222222200000000
chr7,82126279,82131473,5194,-1,0,,0,0.00000000000000000000
chr7,82161460,82165475,4015,-1,0,,0,0.00000000000000000000
chr7,83264471,83267214,2743,-1,0,9723,1,36.45643456070000000000
chr7,82825539,82827763,2224,-1,0,,0,0.00000000000000000000
chr7,83018429,83019831,1402,-1,0,9723,1,71.32667617689020000000
chr7,83050173,83051199,1026,-1,0,9723,1,97.46588693957110000000
chr7,83709750,83710320,570,-1,0,10371,1,175.43859649122800000000
chr7,82946346,82946888,542,-1,0,,0,0.00000000000000000000
chr7,83050659,83051171,512,-1,0,9723,1,195.31250000000000000000
chr7,83536249,83536750,501,-1,0,,0,0.00000000000000000000
chr7,83709873,83710208,335,-1,0,10371,1,298.50746268656700000000
chr7,83728386,83728668,282,-1,0,10371,1,354.60992907801400000000
chr7,83750919,83751254,335,-1,0,10371,1,298.50746268656700000000
chr7,82946462,82946780,318,-1,0,,0,0.00000000000000000000
chr7,83018645,83018848,203,-1,0,9723,1,492.61083743842400000000
chr7,83536470,83536537,67,-1,0,,0,0.00000000000000000000
chr7,82910896,82910958,62,-1,0,,0,0.00000000000000000000
chr7,83782475,83786688,4213,-1,0,10371,1,23.73605506764780000000
chr7,83844275,83844880,605,-1,0,,0,0.00000000000000000000
chr7,83930367,84082804,152437,-1,0,,0,0.00000000000000000000
chr7,83916759,83936182,19423,-1,0,,0,0.00000000000000000000
chr7,84005613,84005964,351,-1,0,,0,0.00000000000000000000
chr7,84114331,84167195,52864,-1,0,,0,0.00000000000000000000
chr7,84194521,84390387,195866,-1,0,,0,0.00000000000000000000
chr7,84184263,84314384,130121,-1,0,,0,0.00000000000000000000
chr7,84199866,84239156,39290,-1,0,,0,0.00000000000000000000
chr7,84215016,84227097,12081,-1,0,,0,0.00000000000000000000
chr7,84320333,84320512,179,-1,0,,0,0.00000000000000000000
chr7,84701562,84773285,71723,-1,0,223117,1,1.39425288958911000000
chr7,84841769,84843042,1273,-1,0,,0,0.00000000000000000000
chr7,84943592,84945675,2083,-1,0,,0,0.00000000000000000000
chr7,84969005,84973186,4181,-1,0,,0,0.00000000000000000000
chr7,85079581,85104834,25253,-1,0,,0,0.00000000000000000000
chr7,85509206,85523688,14482,-1,0,,0,0.00000000000000000000
chr7,85588797,85751586,162789,-1,0,,0,0.00000000000000000000
chr7,85634517,85654928,20411,-1,0,,0,0.00000000000000000000
chr7,86214129,86271166,57037,-1,0,,0,0.00000000000000000000
chr7,86231262,86245315,14053,-1,0,,0,0.00000000000000000000
chr7,86234984,86241960,6976,-1,0,,0,0.00000000000000000000
chr7,86615295,86615942,647,-1,0,222223,1,154.55950540958300000000
chr7,86615474,86615763,289,-1,0,222223,1,346.02076124567500000000
chr7,86836515,86837038,523,-1,0,79161,1,191.20458891013400000000
chr7,86836614,86836925,311,-1,0,79161,1,321.54340836012900000000
chr7,86937461,86949288,11827,-1,0,,0,0.00000000000000000000
chr7,87308333,87311104,2771,-1,0,5243;154661,2,72.17610970768670000000
chr7,87667589,87672691,5102,-1,0,53616,1,19.60015680125440000000
chr7,87668663,87672935,4272,-1,0,53616,1,23.40823970037450000000
chr7,87670755,87672309,1554,-1,0,53616,1,64.35006435006430000000
chr7,87864388,87869825,5437,-1,0,,0,0.00000000000000000000
chr7,88031128,88031362,234,-1,0,,0,0.00000000000000000000
chr7,88069034,88069298,264,-1,0,,0,0.00000000000000000000
chr7,88091292,88091859,567,-1,0,,0,0.00000000000000000000
chr7,88135589,88257662,122073,-1,0,,0,0.00000000000000000000
chr7,88142158,88154451,12293,-1,0,,0,0.00000000000000000000
chr7,88583059,89168056,584997,-1,0,219578,1,0.17094104756092800000
chr7,89618948,89755326,136378,-1,0,,0,0.00000000000000000000
chr7,89342000,89437398,95398,-1,0,,0,0.00000000000000000000
chr7,89518882,89531599,12717,-1,0,,0,0.00000000000000000000
chr7,88585812,88596920,11108,-1,0,219578,1,9.00252070579762000000
chr7,89791720,89800901,9181,-1,0,26872,1,10.89205968848710000000
chr7,89519310,89525746,6436,-1,0,,0,0.00000000000000000000
chr7,89810408,89812601,2193,-1,0,,0,0.00000000000000000000
chr7,89617237,89619584,2347,-1,0,,0,0.00000000000000000000
chr7,89553590,89554881,1291,-1,0,,0,0.00000000000000000000
chr7,88677441,88678486,1045,-1,0,219578,1,95.69377990430620000000
chr7,89553991,89554701,710,-1,0,,0,0.00000000000000000000
chr7,89598814,89599311,497,-1,0,,0,0.00000000000000000000
chr7,89032540,89032988,448,-1,0,,0,0.00000000000000000000
chr7,90022019,90022566,547,-1,0,,0,0.00000000000000000000
chr7,89554141,89554538,397,-1,0,,0,0.00000000000000000000
chr7,90022136,90022454,318,-1,0,,0,0.00000000000000000000
chr7,89598878,89599194,316,-1,0,,0,0.00000000000000000000
chr7,89156998,89157085,87,-1,0,,0,0.00000000000000000000
chr7,90426005,90427623,1618,-1,0,5218,1,61.80469715698390000000
chr7,90478509,90479604,1095,-1,0,5218,1,91.32420091324200000000
chr7,90583827,90584348,521,-1,0,5218,1,191.93857965451100000000
chr7,90583946,90584276,330,-1,0,5218,1,303.03030303030300000000
chr7,91030895,91042689,11794,-1,0,,0,0.00000000000000000000
chr7,91214111,91220933,6822,-1,0,,0,0.00000000000000000000
chr7,91254534,91260445,5911,-1,0,,0,0.00000000000000000000
chr7,91333187,91334080,893,-1,0,,0,0.00000000000000000000
chr7,91341297,91341550,253,-1,0,,0,0.00000000000000000000
chr7,91358343,91360428,2085,-1,0,,0,0.00000000000000000000
chr7,91358557,91360407,1850,-1,0,,0,0.00000000000000000000
chr7,91530995,91532788,1793,-1,0,,0,0.00000000000000000000
chr7,91562340,91564427,2087,-1,0,,0,0.00000000000000000000
chr7,91800056,91809480,9424,-1,0,,0,0.00000000000000000000
chr7,91994838,91996360,1522,-1,0,54467,1,65.70302233902760000000
chr7,92181628,92183488,1860,-1,0,,0,0.00000000000000000000
chr7,92227324,92228402,1078,-1,0,,0,0.00000000000000000000
chr7,92261139,92267269,6130,-1,0,1021,1,16.31321370309950000000
chr7,92480343,92518657,38314,-1,0,,0,0.00000000000000000000
chr7,92543288,92555149,11861,-1,0,,0,0.00000000000000000000
chr7,92994297,93001248,6951,-1,0,,0,0.00000000000000000000
chr7,92991879,92997172,5293,-1,0,,0,0.00000000000000000000
chr7,92994938,92997488,2550,-1,0,,0,0.00000000000000000000
chr7,93004710,93007360,2650,-1,0,,0,0.00000000000000000000
chr7,93173237,93175938,2701,-1,0,799,1,37.02332469455760000000
chr7,93169987,93170104,117,-1,0,799,1,854.70085470085500000000
chr7,93287842,93292638,4796,-1,0,,0,0.00000000000000000000
chr7,93326652,93332994,6342,-1,0,,0,0.00000000000000000000
chr7,93327176,93331424,4248,-1,0,,0,0.00000000000000000000
chr7,93416851,93425272,8421,-1,0,,0,0.00000000000000000000
chr7,93541198,93545455,4257,-1,0,,0,0.00000000000000000000
chr7,93541821,93542539,718,-1,0,,0,0.00000000000000000000
chr7,93541827,93542280,453,-1,0,,0,0.00000000000000000000
chr7,93892581,93892779,198,-1,0,,0,0.00000000000000000000
chr7,94109873,94112923,3050,-1,0,,0,0.00000000000000000000
chr7,94468980,94469046,66,-1,0,,0,0.00000000000000000000
chr7,94711620,94721344,9724,-1,0,55607,1,10.28383381324560000000
chr7,95364631,95369116,4485,-1,0,,0,0.00000000000000000000
chr7,95386186,95386634,448,-1,0,,0,0.00000000000000000000
chr7,95386214,95386574,360,-1,0,,0,0.00000000000000000000
chr7,95776199,95776600,401,-1,0,10165,1,249.37655860349100000000
chr7,96067441,96067834,393,-1,0,,0,0.00000000000000000000
chr7,96067499,96067841,342,-1,0,,0,0.00000000000000000000
chr7,96116385,96117391,1006,-1,0,7979,1,99.40357852882700000000
chr7,96475524,96482110,6586,-1,0,,0,0.00000000000000000000
chr7,96505368,96505826,458,-1,0,,0,0.00000000000000000000
chr7,96505545,96505623,78,-1,0,,0,0.00000000000000000000
chr7,96522722,96523100,378,-1,0,,0,0.00000000000000000000
chr7,96543208,96549304,6096,-1,0,,0,0.00000000000000000000
chr7,96543285,96546593,3308,-1,0,,0,0.00000000000000000000
chr7,96549934,96552032,2098,-1,0,,0,0.00000000000000000000
chr7,96789388,96792874,3486,-1,0,57001,1,28.68617326448650000000
chr7,96894616,96895118,502,-1,0,,0,0.00000000000000000000
chr7,96894731,96894986,255,-1,0,,0,0.00000000000000000000
chr7,97145782,97147522,1740,-1,0,,0,0.00000000000000000000
chr7,97252238,97258169,5931,-1,0,,0,0.00000000000000000000
chr7,97384609,97402557,17948,-1,0,,0,0.00000000000000000000
chr7,97388958,97403097,14139,-1,0,,0,0.00000000000000000000
chr7,97395286,97402651,7365,-1,0,,0,0.00000000000000000000
chr7,97396873,97402579,5706,-1,0,,0,0.00000000000000000000
chr7,97397354,97401296,3942,-1,0,,0,0.00000000000000000000
chr7,97397889,97398195,306,-1,0,,0,0.00000000000000000000
chr7,97496332,97496665,333,-1,0,440,1,300.30030030030000000000
chr7,97654954,97657784,2830,-1,0,,0,0.00000000000000000000
chr7,97655742,97657562,1820,-1,0,,0,0.00000000000000000000
chr7,97769267,97769728,461,-1,0,22853,1,216.91973969631200000000
chr7,97993563,97993915,352,-1,0,55971,1,284.09090909090900000000
chr7,98022326,98022491,165,-1,0,55971,1,606.06060606060600000000
chr7,98052524,98053064,540,-1,0,,0,0.00000000000000000000
chr7,98082835,98083160,325,-1,0,,0,0.00000000000000000000
chr7,98228490,98230785,2295,-1,0,,0,0.00000000000000000000
chr7,98437108,98437247,139,-1,0,,0,0.00000000000000000000
chr7,98778290,98778441,151,-1,0,402569,1,662.25165562913900000000
chr7,98791999,98797648,5649,-1,0,402569,1,17.70224818551960000000
chr7,99130125,99131278,1153,-1,0,23660,1,86.73026886383350000000
chr7,99190617,99194715,4098,-1,0,,0,0.00000000000000000000
chr7,99203012,99203174,162,-1,0,100289187,1,617.28395061728400000000
chr7,99461355,99463538,2183,-1,0,64816,1,45.80852038479160000000
chr7,100549634,100615451,65817,-1,0,10071;4584,2,3.03872859595545000000
chr7,100326954,100343007,16053,-1,0,7455,1,6.22936522768330000000
chr7,100633905,100648575,14670,-1,0,10071,1,6.81663258350375000000
chr7,100351329,100363031,11702,-1,0,7455,1,8.54554776961203000000
chr7,100327898,100337832,9934,-1,0,7455,1,10.06643849406080000000
chr7,100677969,100683704,5735,-1,0,140453,1,17.43679163034000000000
chr7,100549214,100553083,3869,-1,0,4584,1,25.84647195657790000000
chr7,100337885,100340565,2680,-1,0,7455,1,37.31343283582090000000
chr7,99648976,99652146,3170,-1,0,7589,1,31.54574132492110000000
chr7,100681311,100684493,3182,-1,0,140453,1,31.42677561282210000000
chr7,100533438,100536245,2807,-1,0,,0,0.00000000000000000000
chr7,100341260,100343275,2015,-1,0,7455,1,49.62779156327540000000
chr7,100678692,100680105,1413,-1,0,140453,1,70.77140835102620000000
chr7,100610913,100611422,509,-1,0,4584,1,196.46365422396900000000
chr7,100608969,100609366,397,-1,0,4584,1,251.88916876574300000000
chr7,100609067,100609238,171,-1,0,4584,1,584.79532163742700000000
chr7,100680261,100680438,177,-1,0,140453,1,564.97175141242900000000
chr7,100963805,100972118,8313,-1,0,64792,1,12.02935161794780000000
chr7,101001018,101007033,6015,-1,0,136227,1,16.62510390689940000000
chr7,101001069,101003955,2886,-1,0,,0,0.00000000000000000000
chr7,101059153,101060266,1113,-1,0,136227,1,89.84725965858040000000
chr7,101081261,101082226,965,-1,0,136227,1,103.62694300518100000000
chr7,101060893,101060958,65,-1,0,136227,1,1538.46153846154000000000
chr7,101110588,101110943,355,-1,0,136227,1,281.69014084507000000000
chr7,101252761,101253275,514,-1,0,,0,0.00000000000000000000
chr7,101333250,101335360,2110,-1,0,,0,0.00000000000000000000
chr7,101334093,101334614,521,-1,0,,0,0.00000000000000000000
chr7,101334181,101334525,344,-1,0,,0,0.00000000000000000000
chr7,101380877,101384098,3221,-1,0,,0,0.00000000000000000000
chr7,101382505,101384031,1526,-1,0,,0,0.00000000000000000000
chr7,101724543,101728053,3510,-1,0,1523,1,28.49002849002850000000
chr7,101802287,101802501,214,-1,0,1523,1,467.28971962616800000000
chr7,101968967,102022209,53242,-1,0,100289561;729597,2,3.75643289132640000000
chr7,101972766,101973998,1232,-1,0,,0,0.00000000000000000000
chr7,102081622,102082587,965,-1,0,80228,1,103.62694300518100000000
chr7,102126128,102300497,174369,-1,0,10156;100134938;548644;441273;246721;100271927;100310812,7,4.01447505003756000000
chr7,102234682,102331202,96520,-1,0,10156;246721;100134938;100310812,4,4.14421881475342000000
chr7,102349415,102391725,42310,-1,0,222234,1,2.36350744504845000000
chr7,102344334,102370395,26061,-1,0,,0,0.00000000000000000000
chr7,102351914,102366766,14852,-1,0,,0,0.00000000000000000000
chr7,102351743,102358614,6871,-1,0,,0,0.00000000000000000000
chr7,102366702,102374343,7641,-1,0,,0,0.00000000000000000000
chr7,102488671,102489088,417,-1,0,222235,1,239.80815347721800000000
chr7,102509329,102510204,875,-1,0,222235,1,114.28571428571400000000
chr7,102595600,102596836,1236,-1,0,222235,1,80.90614886731390000000
chr7,102621123,102624671,3548,-1,0,222235,1,28.18489289740700000000
chr7,102800548,102801377,829,-1,0,,0,0.00000000000000000000
chr7,102828995,102870104,41109,-1,0,,0,0.00000000000000000000
chr7,102875312,102877938,2626,-1,0,,0,0.00000000000000000000
chr7,103092928,103096572,3644,-1,0,,0,0.00000000000000000000
chr7,103266116,103268134,2018,-1,0,5649,1,49.55401387512390000000
chr7,103462970,103463512,542,-1,0,5649,1,184.50184501845000000000
chr7,103463079,103463403,324,-1,0,5649,1,308.64197530864200000000
chr7,103772252,103774820,2568,-1,0,5001,1,38.94080996884740000000
chr7,103874815,103875378,563,-1,0,,0,0.00000000000000000000
chr7,103856424,103856880,456,-1,0,,0,0.00000000000000000000
chr7,103874937,103875244,307,-1,0,,0,0.00000000000000000000
chr7,103856466,103856762,296,-1,0,,0,0.00000000000000000000
chr7,104129508,104129805,297,-1,0,375612,1,336.70033670033700000000
chr7,104187272,104187858,586,-1,0,375612,1,170.64846416382300000000
chr7,104187391,104187728,337,-1,0,375612,1,296.73590504451000000000
chr7,104440081,104441806,1725,-1,0,375612,1,57.97101449275360000000
chr7,104464519,104476834,12315,-1,0,375612,1,8.12017864393017000000
chr7,104590101,104590403,302,-1,0,,0,0.00000000000000000000
chr7,104590132,104590236,104,-1,0,,0,0.00000000000000000000
chr7,104615172,104615598,426,-1,0,,0,0.00000000000000000000
chr7,104615174,104615519,345,-1,0,,0,0.00000000000000000000
chr7,104927640,104931274,3634,-1,0,6733,1,27.51788662630710000000
chr7,104990326,104990720,394,-1,0,6733,1,253.80710659898500000000
chr7,104992245,104992660,415,-1,0,6733,1,240.96385542168700000000
chr7,104992338,104992606,268,-1,0,6733,1,373.13432835820900000000
chr7,104992294,104992386,92,-1,0,6733,1,1086.95652173913000000000
chr7,104992386,104992476,90,-1,0,6733,1,1111.11111111111000000000
chr7,105144576,105144718,142,-1,0,54517,1,704.22535211267600000000
chr7,105307849,105308165,316,-1,0,222255,1,316.45569620253200000000
chr7,105389500,105391111,1611,-1,0,222255,1,62.07324643078830000000
chr7,105703565,105706733,3168,-1,0,,0,0.00000000000000000000
chr7,105733990,105734331,341,-1,0,6856,1,293.25513196480900000000
chr7,105733986,105734324,338,-1,0,6856,1,295.85798816568000000000
chr7,106028286,106030227,1941,-1,0,,0,0.00000000000000000000
chr7,106268845,106269631,786,-1,0,,0,0.00000000000000000000
chr7,106270934,106271333,399,-1,0,,0,0.00000000000000000000
chr7,106584562,106586910,2348,-1,0,,0,0.00000000000000000000
chr7,106723788,106729533,5745,-1,0,5577,1,17.40644038294170000000
chr7,106988504,106994393,5889,-1,0,10466,1,16.98081168279840000000
chr7,107173440,107176022,2582,-1,0,10466,1,38.72966692486440000000
chr7,107464068,107464742,674,-1,0,,0,0.00000000000000000000
chr7,107529119,107529239,120,-1,0,,0,0.00000000000000000000
chr7,107683560,107684508,948,-1,0,22798,1,105.48523206751100000000
chr7,107683782,107684340,558,-1,0,22798,1,179.21146953405000000000
chr7,107683969,107684158,189,-1,0,22798,1,529.10052910052900000000
chr7,107818037,107818159,122,-1,0,4897,1,819.67213114754100000000
chr7,108222296,108226129,3833,-1,0,,0,0.00000000000000000000
chr7,108349704,108354200,4496,-1,0,,0,0.00000000000000000000
chr7,108352734,108353303,569,-1,0,,0,0.00000000000000000000
chr7,108352851,108353178,327,-1,0,,0,0.00000000000000000000
chr7,108501423,108501583,160,-1,0,,0,0.00000000000000000000
chr7,108501444,108501545,101,-1,0,,0,0.00000000000000000000
chr7,109067394,109100324,32930,-1,0,,0,0.00000000000000000000
chr7,109296881,109297545,664,-1,0,,0,0.00000000000000000000
chr7,108884473,108885076,603,-1,0,,0,0.00000000000000000000
chr7,108884724,108884869,145,-1,0,,0,0.00000000000000000000
chr7,109430782,109455702,24920,-1,0,,0,0.00000000000000000000
chr7,109436867,109453944,17077,-1,0,,0,0.00000000000000000000
chr7,109453113,109464542,11429,-1,0,,0,0.00000000000000000000
chr7,109442845,109453416,10571,-1,0,,0,0.00000000000000000000
chr7,109412630,109414010,1380,-1,0,,0,0.00000000000000000000
chr7,109541895,109643490,101595,-1,0,,0,0.00000000000000000000
chr7,109693498,109693947,449,-1,0,,0,0.00000000000000000000
chr7,110148241,110152436,4195,-1,0,,0,0.00000000000000000000
chr7,110181934,110188435,6501,-1,0,,0,0.00000000000000000000
chr7,110182414,110184985,2571,-1,0,,0,0.00000000000000000000
chr7,110463828,110576719,112891,-1,0,83943,1,0.88581020630519700000
chr7,110378331,110427124,48793,-1,0,83943,1,2.04947430983953000000
chr7,110387881,110408229,20348,-1,0,83943,1,4.91448791035974000000
chr7,110428661,110433215,4554,-1,0,83943,1,21.95871761089150000000
chr7,110581969,110585817,3848,-1,0,83943,1,25.98752598752600000000
chr7,110430837,110432340,1503,-1,0,83943,1,66.53359946773120000000
chr7,110536422,110536836,414,-1,0,83943,1,241.54589371980700000000
chr7,110542682,110543009,327,-1,0,83943,1,305.81039755351700000000
chr7,110536528,110536725,197,-1,0,83943,1,507.61421319796900000000
chr7,110835545,111333976,498431,-1,0,83943,1,0.20062957560825900000
chr7,111183610,111533520,349910,-1,0,83943;9732,2,0.57157554799805700000
chr7,110974900,111286879,311979,-1,0,83943,1,0.32053439494324900000
chr7,110905610,111173793,268183,-1,0,83943,1,0.37287971273346900000
chr7,111099305,111282380,183075,-1,0,83943,1,0.54622422504438100000
chr7,110844231,111031110,186879,-1,0,83943,1,0.53510560309077000000
chr7,111024623,111177075,152452,-1,0,83943,1,0.65594416603258700000
chr7,111188472,111316758,128286,-1,0,83943,1,0.77950828617308200000
chr7,111070877,111195220,124343,-1,0,83943,1,0.80422701720241600000
chr7,110810428,110890541,80113,-1,0,83943,1,1.24823686542758000000
chr7,110982529,111068343,85814,-1,0,83943,1,1.16531102151164000000
chr7,111145514,111213912,68398,-1,0,83943,1,1.46203105353958000000
chr7,110872057,110963922,91865,-1,0,83943,1,1.08855385620204000000
chr7,110951831,111026646,74815,-1,0,83943,1,1.33663035487536000000
chr7,111022673,111100065,77392,-1,0,83943,1,1.29212321686996000000
chr7,111273866,111336586,62720,-1,0,,0,0.00000000000000000000
chr7,111229550,111285310,55760,-1,0,,0,0.00000000000000000000
chr7,110818063,110883472,65409,-1,0,83943,1,1.52884159672216000000
chr7,111087990,111144516,56526,-1,0,83943,1,1.76909740650320000000
chr7,110932630,110993169,60539,-1,0,83943,1,1.65182774740250000000
chr7,111215344,111260268,44924,-1,0,,0,0.00000000000000000000
chr7,111080203,111114275,34072,-1,0,83943,1,2.93496125851139000000
chr7,111140886,111185886,45000,-1,0,83943,1,2.22222222222222000000
chr7,111003901,111050745,46844,-1,0,83943,1,2.13474511143369000000
chr7,111047356,111083341,35985,-1,0,83943,1,2.77893566763929000000
chr7,111313173,111352734,39561,-1,0,,0,0.00000000000000000000
chr7,110993311,111024873,31562,-1,0,83943,1,3.16836702363602000000
chr7,110905998,110939886,33888,-1,0,83943,1,2.95089707271010000000
chr7,110816346,110837937,21591,-1,0,83943,1,4.63155944606549000000
chr7,111288615,111309021,20406,-1,0,,0,0.00000000000000000000
chr7,111050466,111068368,17902,-1,0,83943,1,5.58596804826276000000
chr7,111250034,111256704,6670,-1,0,,0,0.00000000000000000000
chr7,111048679,111056874,8195,-1,0,83943,1,12.20256253813300000000
chr7,110960206,110967710,7504,-1,0,83943,1,13.32622601279320000000
chr7,111035777,111043105,7328,-1,0,83943,1,13.64628820960700000000
chr7,111356770,111360605,3835,-1,0,,0,0.00000000000000000000
chr7,111065327,111067278,1951,-1,0,83943,1,51.25576627370580000000
chr7,111020863,111022458,1595,-1,0,83943,1,62.69592476489030000000
chr7,111222251,111222479,228,-1,0,,0,0.00000000000000000000
chr7,111179224,111179296,72,-1,0,83943,1,1388.88888888889000000000
chr7,111565968,111566703,735,-1,0,9732,1,136.05442176870700000000
chr7,111565988,111566312,324,-1,0,9732,1,308.64197530864200000000
chr7,111683385,111684032,647,-1,0,9732,1,154.55950540958300000000
chr7,111941594,111963186,21592,-1,0,11179,1,4.63134494257132000000
chr7,111982468,111989742,7274,-1,0,11179,1,13.74759417102010000000
chr7,112329361,112330350,989,-1,0,,0,0.00000000000000000000
chr7,112512989,112520703,7714,-1,0,154743,1,12.96344309048480000000
chr7,112866138,112869366,3228,-1,0,,0,0.00000000000000000000
chr7,112905239,112953375,48136,-1,0,,0,0.00000000000000000000
chr7,113416050,113422540,6490,-1,0,,0,0.00000000000000000000
chr7,113652517,113659360,6843,-1,0,,0,0.00000000000000000000
chr7,113715927,113717961,2034,-1,0,,0,0.00000000000000000000
chr7,113953404,113953937,533,-1,0,,0,0.00000000000000000000
chr7,113953501,113953813,312,-1,0,,0,0.00000000000000000000
chr7,114449375,114449611,236,-1,0,,0,0.00000000000000000000
chr7,114528943,114528997,54,-1,0,,0,0.00000000000000000000
chr7,114530540,114530820,280,-1,0,,0,0.00000000000000000000
chr7,114688004,114688162,158,-1,0,,0,0.00000000000000000000
chr7,115179034,115185711,6677,-1,0,,0,0.00000000000000000000
chr7,115330642,115333831,3189,-1,0,,0,0.00000000000000000000
chr7,115546016,115546587,571,-1,0,,0,0.00000000000000000000
chr7,115583464,115587908,4444,-1,0,22797,1,22.50225022502250000000
chr7,115853805,115856749,2944,-1,0,26136,1,33.96739130434780000000
chr7,115929653,115941775,12122,-1,0,,0,0.00000000000000000000
chr7,115935126,115941606,6480,-1,0,,0,0.00000000000000000000
chr7,115937368,115940021,2653,-1,0,,0,0.00000000000000000000
chr7,115939171,115940616,1445,-1,0,,0,0.00000000000000000000
chr7,115953622,115955262,1640,-1,0,,0,0.00000000000000000000
chr7,116033179,116034318,1139,-1,0,,0,0.00000000000000000000
chr7,116594086,116598128,4042,-1,0,7982,1,24.74022761009400000000
chr7,116841928,116842440,512,-1,0,7982,1,195.31250000000000000000
chr7,116842011,116842321,310,-1,0,7982,1,322.58064516129000000000
chr7,117015451,117019208,3757,-1,0,136991,1,26.61698163428270000000
chr7,117518124,117520108,1984,-1,0,,0,0.00000000000000000000
chr7,117665105,117665471,366,-1,0,,0,0.00000000000000000000
chr7,117739232,117792940,53708,-1,0,,0,0.00000000000000000000
chr7,117906929,118126354,219425,-1,0,,0,0.00000000000000000000
chr7,118131823,118164403,32580,-1,0,,0,0.00000000000000000000
chr7,117915799,117960366,44567,-1,0,,0,0.00000000000000000000
chr7,118133049,118160085,27036,-1,0,,0,0.00000000000000000000
chr7,118027472,118037842,10370,-1,0,,0,0.00000000000000000000
chr7,118144655,118154949,10294,-1,0,,0,0.00000000000000000000
chr7,117893855,117894348,493,-1,0,,0,0.00000000000000000000
chr7,117893957,117894262,305,-1,0,,0,0.00000000000000000000
chr7,118343698,118344296,598,-1,0,,0,0.00000000000000000000
chr7,118343815,118344170,355,-1,0,,0,0.00000000000000000000
chr7,118382698,118391259,8561,-1,0,,0,0.00000000000000000000
chr7,118630294,118672428,42134,-1,0,,0,0.00000000000000000000
chr7,118590926,118599044,8118,-1,0,,0,0.00000000000000000000
chr7,118796281,118802547,6266,-1,0,,0,0.00000000000000000000
chr7,118847242,119032393,185151,-1,0,,0,0.00000000000000000000
chr7,118831140,118835113,3973,-1,0,,0,0.00000000000000000000
chr7,118953238,118955478,2240,-1,0,,0,0.00000000000000000000
chr7,119077360,119082687,5327,-1,0,,0,0.00000000000000000000
chr7,119293377,119568848,275471,-1,0,,0,0.00000000000000000000
chr7,119384800,119499358,114558,-1,0,,0,0.00000000000000000000
chr7,119557971,119629494,71523,-1,0,,0,0.00000000000000000000
chr7,119344114,119390242,46128,-1,0,,0,0.00000000000000000000
chr7,119218390,119233851,15461,-1,0,,0,0.00000000000000000000
chr7,119155142,119164931,9789,-1,0,,0,0.00000000000000000000
chr7,119605898,119614289,8391,-1,0,,0,0.00000000000000000000
chr7,119374544,119386622,12078,-1,0,,0,0.00000000000000000000
chr7,119652185,119662449,10264,-1,0,,0,0.00000000000000000000
chr7,119153884,119162546,8662,-1,0,,0,0.00000000000000000000
chr7,119227971,119236054,8083,-1,0,,0,0.00000000000000000000
chr7,119158617,119165142,6525,-1,0,,0,0.00000000000000000000
chr7,119372889,119377636,4747,-1,0,,0,0.00000000000000000000
chr7,119443855,119447512,3657,-1,0,,0,0.00000000000000000000
chr7,119142489,119145741,3252,-1,0,,0,0.00000000000000000000
chr7,119395780,119398114,2334,-1,0,,0,0.00000000000000000000
chr7,119728622,119731167,2545,-1,0,,0,0.00000000000000000000
chr7,119952365,119953664,1299,-1,0,3751,1,76.98229407236330000000
chr7,120021974,120023728,1754,-1,0,3751,1,57.01254275940710000000
chr7,120290170,120291382,1212,-1,0,3751,1,82.50825082508250000000
chr7,120303964,120316204,12240,-1,0,3751,1,8.16993464052288000000
chr7,120310827,120313172,2345,-1,0,3751,1,42.64392324093820000000
chr7,120647788,120648870,1082,-1,0,79974,1,92.42144177449170000000
chr7,120881095,120881479,384,-1,0,79974,1,260.41666666666700000000
chr7,121083270,121084332,1062,-1,0,,0,0.00000000000000000000
chr7,121083577,121083872,295,-1,0,,0,0.00000000000000000000
chr7,121083643,121083850,207,-1,0,,0,0.00000000000000000000
chr7,121062319,121062479,160,-1,0,,0,0.00000000000000000000
chr7,121164558,121181983,17425,-1,0,,0,0.00000000000000000000
chr7,121220579,121226175,5596,-1,0,,0,0.00000000000000000000
chr7,121322937,121329383,6446,-1,0,,0,0.00000000000000000000
chr7,121340905,121343117,2212,-1,0,,0,0.00000000000000000000
chr7,121681320,121681603,283,-1,0,5803,1,353.35689045936400000000
chr7,121899836,121900486,650,-1,0,,0,0.00000000000000000000
chr7,122855543,122862021,6478,-1,0,,0,0.00000000000000000000
chr7,122769348,122770737,1389,-1,0,6561,1,71.99424046076310000000
chr7,122682832,122683207,375,-1,0,,0,0.00000000000000000000
chr7,122460586,122460912,326,-1,0,93664,1,306.74846625766900000000
chr7,123048164,123048592,428,-1,0,,0,0.00000000000000000000
chr7,123480632,123484306,3674,-1,0,,0,0.00000000000000000000
chr7,123636854,123637309,455,-1,0,,0,0.00000000000000000000
chr7,124299819,124300150,331,-1,0,,0,0.00000000000000000000
chr7,124299901,124300028,127,-1,0,,0,0.00000000000000000000
chr7,124594461,124672656,78195,-1,0,,0,0.00000000000000000000
chr7,124634568,124637719,3151,-1,0,,0,0.00000000000000000000
chr7,124601649,124601978,329,-1,0,,0,0.00000000000000000000
chr7,124893342,124896681,3339,-1,0,,0,0.00000000000000000000
chr7,124982501,124987813,5312,-1,0,,0,0.00000000000000000000
chr7,125839058,126063951,224893,-1,0,,0,0.00000000000000000000
chr7,125599435,125760644,161209,-1,0,,0,0.00000000000000000000
chr7,125442853,125594718,151865,-1,0,,0,0.00000000000000000000
chr7,125567308,125674338,107030,-1,0,,0,0.00000000000000000000
chr7,125324848,125432510,107662,-1,0,,0,0.00000000000000000000
chr7,125562430,125609129,46699,-1,0,,0,0.00000000000000000000
chr7,126043899,126061429,17530,-1,0,,0,0.00000000000000000000
chr7,125470352,125477540,7188,-1,0,,0,0.00000000000000000000
chr7,126045655,126051930,6275,-1,0,,0,0.00000000000000000000
chr7,125423466,125429513,6047,-1,0,,0,0.00000000000000000000
chr7,125351010,125355269,4259,-1,0,,0,0.00000000000000000000
chr7,125472699,125476043,3344,-1,0,,0,0.00000000000000000000
chr7,125235692,125238892,3200,-1,0,,0,0.00000000000000000000
chr7,126045483,126046637,1154,-1,0,,0,0.00000000000000000000
chr7,125265004,125265526,522,-1,0,,0,0.00000000000000000000
chr7,125102275,125102977,702,-1,0,,0,0.00000000000000000000
chr7,125858395,125858711,316,-1,0,,0,0.00000000000000000000
chr7,125265110,125265441,331,-1,0,,0,0.00000000000000000000
chr7,125858196,125858355,159,-1,0,,0,0.00000000000000000000
chr7,126297006,126297502,496,-1,0,2918,1,201.61290322580600000000
chr7,126394444,126401697,7253,-1,0,2918,1,13.78739831793740000000
chr7,126465474,126509558,44084,-1,0,2918,1,2.26839669721441000000
chr7,126514822,126532358,17536,-1,0,2918,1,5.70255474452555000000
chr7,126799628,126809746,10118,-1,0,2918,1,9.88337616129670000000
chr7,126776077,126781462,5385,-1,0,2918,1,18.57010213556170000000
chr7,126775317,126775982,665,-1,0,2918,1,150.37593984962400000000
chr7,126775616,126775706,90,-1,0,2918,1,1111.11111111111000000000
chr7,127214967,127217986,3019,-1,0,,0,0.00000000000000000000
chr7,127620095,127620577,482,-1,0,27044,1,207.46887966805000000000
chr7,127620162,127620484,322,-1,0,27044,1,310.55900621118000000000
chr7,127766310,127766840,530,-1,0,,0,0.00000000000000000000
chr7,127766414,127766728,314,-1,0,,0,0.00000000000000000000
chr7,127982257,128050785,68528,-1,0,55131;401399;3614,3,4.37777258930656000000
chr7,128084661,128106740,22079,-1,0,29923,1,4.52919063363377000000
chr7,128139569,128639670,500101,-1,0,813;84691;2318;100130705;346653;23534;375616;9296;64753;55798;611;3663,12,2.39951529790982000000
chr7,128468001,128502400,34399,-1,0,2318,1,2.90706125178058000000
chr7,128294019,128301298,7279,-1,0,,0,0.00000000000000000000
chr7,128233110,128234790,1680,-1,0,,0,0.00000000000000000000
chr7,128552563,128553551,988,-1,0,,0,0.00000000000000000000
chr7,128309116,128309603,487,-1,0,,0,0.00000000000000000000
chr7,128243340,128243791,451,-1,0,,0,0.00000000000000000000
chr7,128309212,128309535,323,-1,0,,0,0.00000000000000000000
chr7,128243549,128243633,84,-1,0,,0,0.00000000000000000000
chr7,128730721,128730983,262,-1,0,,0,0.00000000000000000000
chr7,128770122,128772248,2126,-1,0,,0,0.00000000000000000000
chr7,128841043,128841745,702,-1,0,6608,1,142.45014245014200000000
chr7,128981437,128994674,13237,-1,0,23382,1,7.55458185389439000000
chr7,129085601,129086597,996,-1,0,57464,1,100.40160642570300000000
chr7,129141159,129143204,2045,-1,0,100287482,1,48.89975550122250000000
chr7,129224007,129224657,650,-1,0,,0,0.00000000000000000000
chr7,129230954,129231955,1001,-1,0,,0,0.00000000000000000000
chr7,129300088,129301990,1902,-1,0,4899,1,52.57623554153520000000
chr7,129544755,129545868,1113,-1,0,7328,1,89.84725965858040000000
chr7,129596907,129597919,1012,-1,0,,0,0.00000000000000000000
chr7,129602762,129603664,902,-1,0,,0,0.00000000000000000000
chr7,129682199,129685639,3440,-1,0,51530,1,29.06976744186050000000
chr7,129786490,129787050,560,-1,0,,0,0.00000000000000000000
chr7,130800830,130801959,1129,-1,0,4289,1,88.57395925597870000000
chr7,131078702,131080887,2185,-1,0,4289,1,45.76659038901600000000
chr7,131180702,131181462,760,-1,0,4289,1,131.57894736842100000000
chr7,131336071,131337567,1496,-1,0,,0,0.00000000000000000000
chr7,131373050,131373957,907,-1,0,,0,0.00000000000000000000
chr7,131394335,131396545,2210,-1,0,,0,0.00000000000000000000
chr7,131458227,131460764,2537,-1,0,,0,0.00000000000000000000
chr7,131560447,131562547,2100,-1,0,,0,0.00000000000000000000
chr7,131702933,131704847,1914,-1,0,,0,0.00000000000000000000
chr7,131777401,131809119,31718,-1,0,91584,1,3.15278390819093000000
chr7,131774439,131780765,6326,-1,0,,0,0.00000000000000000000
chr7,131777500,131780163,2663,-1,0,,0,0.00000000000000000000
chr7,131817157,131817227,70,-1,0,91584,1,1428.57142857143000000000
chr7,132246786,132247739,953,-1,0,91584,1,104.93179433368300000000
chr7,132273009,132273555,546,-1,0,91584,1,183.15018315018300000000
chr7,132457279,132457554,275,-1,0,,0,0.00000000000000000000
chr7,132541931,132542387,456,-1,0,54927,1,219.29824561403500000000
chr7,132836014,132836368,354,-1,0,,0,0.00000000000000000000
chr7,132836176,132836347,171,-1,0,,0,0.00000000000000000000
chr7,133011750,133014251,2501,-1,0,60412,1,39.98400639744100000000
chr7,133039954,133040587,633,-1,0,60412,1,157.97788309636600000000
chr7,133065021,133119192,54171,-1,0,60412,1,1.84600616566059000000
chr7,133107310,133109300,1990,-1,0,60412,1,50.25125628140700000000
chr7,133107539,133108130,591,-1,0,60412,1,169.20473773265600000000
chr7,133107684,133108016,332,-1,0,60412,1,301.20481927710800000000
chr7,133434407,133641426,207019,-1,0,60412,1,0.48304744975098900000
chr7,133542735,133549321,6586,-1,0,60412,1,15.18372304889160000000
chr7,133739433,133854689,115256,-1,0,60412;136332,2,1.73526757826057000000
chr7,133765633,133797965,32332,-1,0,,0,0.00000000000000000000
chr7,133789177,133815438,26261,-1,0,136332,1,3.80792810631735000000
chr7,133784199,133799916,15717,-1,0,,0,0.00000000000000000000
chr7,133778423,133790437,12014,-1,0,,0,0.00000000000000000000
chr7,133785183,133790439,5256,-1,0,,0,0.00000000000000000000
chr7,133916288,133916424,136,-1,0,136332,1,735.29411764705900000000
chr7,134132510,134160920,28410,-1,0,231,1,3.51988736360436000000
chr7,134207653,134249268,41615,-1,0,57016;441282,2,4.80595938964316000000
chr7,134222477,134261166,38689,-1,0,57016;441282,2,5.16942800279149000000
chr7,134310493,134312181,1688,-1,0,,0,0.00000000000000000000
chr7,134349974,134350460,486,-1,0,669,1,205.76131687242800000000
chr7,134584822,134590520,5698,-1,0,800,1,17.55001755001760000000
chr7,134542004,134543406,1402,-1,0,800,1,71.32667617689020000000
chr7,134605010,134605100,90,-1,0,800,1,1111.11111111111000000000
chr7,134698346,134699132,786,-1,0,340351,1,127.22646310432600000000
chr7,134709564,134713162,3598,-1,0,340351,1,27.79321845469710000000
chr7,134919300,134920495,1195,-1,0,346673,1,83.68200836820080000000
chr7,135131652,135131963,311,-1,0,4850,1,321.54340836012900000000
chr7,135141052,135144125,3073,-1,0,4850,1,32.54149040026030000000
chr7,135189194,135189536,342,-1,0,4850,1,292.39766081871300000000
chr7,135206443,135218478,12035,-1,0,,0,0.00000000000000000000
chr7,135248065,135249644,1579,-1,0,23165,1,63.33122229259020000000
chr7,135272937,135275130,2193,-1,0,23165,1,45.59963520291840000000
chr7,135362916,135364678,1762,-1,0,,0,0.00000000000000000000
chr7,135482165,135482253,88,-1,0,,0,0.00000000000000000000
chr7,135501812,135508784,6972,-1,0,,0,0.00000000000000000000
chr7,135741401,135742193,792,-1,0,,0,0.00000000000000000000
chr7,135993875,136000878,7003,-1,0,,0,0.00000000000000000000
chr7,136152472,136159768,7296,-1,0,,0,0.00000000000000000000
chr7,136447955,136458367,10412,-1,0,,0,0.00000000000000000000
chr7,136524477,136539303,14826,-1,0,,0,0.00000000000000000000
chr7,136834357,136834877,520,-1,0,,0,0.00000000000000000000
chr7,136851500,136852059,559,-1,0,,0,0.00000000000000000000
chr7,136851614,136851930,316,-1,0,,0,0.00000000000000000000
chr7,136834449,136834751,302,-1,0,,0,0.00000000000000000000
chr7,136936335,136937662,1327,-1,0,5764,1,75.35795026375280000000
chr7,136996515,136996747,232,-1,0,5764,1,431.03448275862100000000
chr7,137133118,137133644,526,-1,0,9162,1,190.11406844106500000000
chr7,137208562,137208914,352,-1,0,9162,1,284.09090909090900000000
chr7,137429299,137430903,1604,-1,0,9162,1,62.34413965087280000000
chr7,137455270,137455578,308,-1,0,9162,1,324.67532467532500000000
chr7,137455291,137455582,291,-1,0,9162,1,343.64261168384900000000
chr7,137573009,137573823,814,-1,0,64764,1,122.85012285012300000000
chr7,139967571,139980313,12742,-1,0,,0,0.00000000000000000000
chr7,137991566,138004884,13318,-1,0,,0,0.00000000000000000000
chr7,138362733,138376253,13520,-1,0,136306,1,7.39644970414201000000
chr7,140003935,140009963,6028,-1,0,,0,0.00000000000000000000
chr7,139601169,139604275,3106,-1,0,6916,1,32.19575016097870000000
chr7,140113065,140115879,2814,-1,0,401409,1,35.53660270078180000000
chr7,139875484,139877598,2114,-1,0,80853,1,47.30368968779560000000
chr7,137787533,137789930,2397,-1,0,6718,1,41.71881518564870000000
chr7,139322752,139324415,1663,-1,0,28996,1,60.13229104028860000000
chr7,138107043,138108674,1631,-1,0,,0,0.00000000000000000000
chr7,139714480,139715947,1467,-1,0,6916,1,68.16632583503750000000
chr7,137989368,137990677,1309,-1,0,,0,0.00000000000000000000
chr7,138869541,138870922,1381,-1,0,79989,1,72.41129616220130000000
chr7,137872090,137873442,1352,-1,0,,0,0.00000000000000000000
chr7,138033888,138035119,1231,-1,0,,0,0.00000000000000000000
chr7,137995517,137996408,891,-1,0,,0,0.00000000000000000000
chr7,138296413,138297250,837,-1,0,136306,1,119.47431302270000000000
chr7,138358758,138359437,679,-1,0,136306,1,147.27540500736400000000
chr7,139109489,139110066,577,-1,0,,0,0.00000000000000000000
chr7,138742165,138742698,533,-1,0,56829,1,187.61726078799300000000
chr7,138402830,138403257,427,-1,0,50617,1,234.19203747072600000000
chr7,139207105,139207501,396,-1,0,,0,0.00000000000000000000
chr7,138300242,138300493,251,-1,0,136306,1,398.40637450199200000000
chr7,139043007,139043333,326,-1,0,51631;100996928,2,613.49693251533700000000
chr7,138742268,138742602,334,-1,0,56829,1,299.40119760479000000000
chr7,138039835,138040047,212,-1,0,,0,0.00000000000000000000
chr7,138322196,138322259,63,-1,0,136306,1,1587.30158730159000000000
chr7,140192870,140206533,13663,-1,0,,0,0.00000000000000000000
chr7,140192502,140198985,6483,-1,0,,0,0.00000000000000000000
chr7,140181724,140190313,8589,-1,0,,0,0.00000000000000000000
chr7,140195038,140202224,7186,-1,0,,0,0.00000000000000000000
chr7,140189008,140190962,1954,-1,0,,0,0.00000000000000000000
chr7,140189246,140190275,1029,-1,0,,0,0.00000000000000000000
chr7,140189297,140189741,444,-1,0,,0,0.00000000000000000000
chr7,140231367,140231835,468,-1,0,27147,1,213.67521367521400000000
chr7,140283040,140283982,942,-1,0,27147,1,106.15711252653900000000
chr7,140582192,140588033,5841,-1,0,673,1,17.12035610340690000000
chr7,140608585,140608803,218,-1,0,673,1,458.71559633027500000000
chr7,140828729,140838730,10001,-1,0,100507421,1,9.99900009999000000000
chr7,141110841,141111038,197,-1,0,100507421,1,507.61421319796900000000
chr7,141113773,141114291,518,-1,0,100507421,1,193.05019305019300000000
chr7,141113884,141114205,321,-1,0,100507421,1,311.52647975077900000000
chr7,141165114,141168545,3431,-1,0,100507421,1,29.14602156805600000000
chr7,141277879,141283829,5950,-1,0,55750,1,16.80672268907560000000
chr7,141491749,141491983,234,-1,0,,0,0.00000000000000000000
chr7,141620420,141626540,6120,-1,0,,0,0.00000000000000000000
chr7,141755551,141791945,36394,-1,0,8972,1,2.74770566576908000000
chr7,141761426,141787966,26540,-1,0,8972,1,3.76789751318764000000
chr7,141750023,141776158,26135,-1,0,8972,1,3.82628658886551000000
chr7,141771194,141785381,14187,-1,0,8972,1,7.04870656234581000000
chr7,141781488,141792097,10609,-1,0,8972,1,9.42595909133754000000
chr7,141786232,141786775,543,-1,0,8972,1,184.16206261510100000000
chr7,142100173,142247649,147476,-1,0,,0,0.00000000000000000000
chr7,142107233,142164487,57254,-1,0,,0,0.00000000000000000000
chr7,142047792,142106796,59004,-1,0,,0,0.00000000000000000000
chr7,142111962,142149487,37525,-1,0,,0,0.00000000000000000000
chr7,142133273,142170344,37071,-1,0,,0,0.00000000000000000000
chr7,142150181,142172516,22335,-1,0,,0,0.00000000000000000000
chr7,142010999,142043965,32966,-1,0,,0,0.00000000000000000000
chr7,142109031,142128943,19912,-1,0,,0,0.00000000000000000000
chr7,142154887,142173493,18606,-1,0,,0,0.00000000000000000000
chr7,142099063,142108894,9831,-1,0,,0,0.00000000000000000000
chr7,142136452,142144700,8248,-1,0,,0,0.00000000000000000000
chr7,142259078,142267770,8692,-1,0,,0,0.00000000000000000000
chr7,142042362,142047311,4949,-1,0,,0,0.00000000000000000000
chr7,142344852,142494030,149178,-1,0,100463482;5644,2,1.34068026116451000000
chr7,142425215,142467065,41850,-1,0,5644,1,2.38948626045400000000
chr7,142460176,142482236,22060,-1,0,5644,1,4.53309156844968000000
chr7,142461276,142474923,13647,-1,0,,0,0.00000000000000000000
chr7,142475534,142486159,10625,-1,0,,0,0.00000000000000000000
chr7,142475811,142484757,8946,-1,0,,0,0.00000000000000000000
chr7,142479483,142486482,6999,-1,0,,0,0.00000000000000000000
chr7,142372884,142375750,2866,-1,0,100463482,1,34.89183531053730000000
chr7,142357958,142360306,2348,-1,0,,0,0.00000000000000000000
chr7,142360544,142362011,1467,-1,0,,0,0.00000000000000000000
chr7,142367391,142367723,332,-1,0,,0,0.00000000000000000000
chr7,142527558,142528209,651,-1,0,,0,0.00000000000000000000
chr7,142814100,142895185,81085,-1,0,5304;259285,2,2.46654745020657000000
chr7,142835053,142881423,46370,-1,0,5304;259285,2,4.31313349148156000000
chr7,142877619,142902737,25118,-1,0,259285,1,3.98120869495979000000
chr7,142872163,142883384,11221,-1,0,259285,1,8.91186168790660000000
chr7,143223503,143532472,308969,-1,0,285966;441294;340307,3,0.97097119775770400000
chr7,143880615,144075919,195304,-1,0,402317;401427;346528;100142659;7984;445328;100128553,7,3.58415598246836000000
chr7,143232100,143401629,169529,-1,0,285966;441294,2,1.17973915967180000000
chr7,143438743,143572103,133360,-1,0,9747;340307,2,1.49970005998800000000
chr7,143966078,144081057,114979,-1,0,7984;346528;100142659,3,2.60917210968960000000
chr7,143921388,144018664,97276,-1,0,402317;401427;346528;100142659,4,4.11201118467042000000
chr7,143318901,143424500,105599,-1,0,285966,1,0.94697866457068700000
chr7,143882241,143972485,90244,-1,0,402317;401427;100142659;445328;100128553,5,5.54053455077346000000
chr7,143219973,143301916,81943,-1,0,441294,1,1.22036049449007000000
chr7,143952300,144034629,82329,-1,0,401427;346528;100142659,3,3.64391648143425000000
chr7,143920927,143960017,39090,-1,0,402317;401427,2,5.11639805576874000000
chr7,143425931,143466591,40660,-1,0,285966;340307,2,4.91883915395967000000
chr7,143936259,143969627,33368,-1,0,401427;100142659,2,5.99376648285783000000
chr7,143425343,143441500,16157,-1,0,285966,1,6.18926780961812000000
chr7,143682950,143690550,7600,-1,0,,0,0.00000000000000000000
chr7,144034180,144036377,2197,-1,0,,0,0.00000000000000000000
chr7,143908658,143910415,1757,-1,0,,0,0.00000000000000000000
chr7,144034930,144036473,1543,-1,0,,0,0.00000000000000000000
chr7,144382302,144383503,1201,-1,0,27010,1,83.26394671107410000000
chr7,144382544,144383163,619,-1,0,27010,1,161.55088852988700000000
chr7,144382740,144382935,195,-1,0,27010,1,512.82051282051300000000
chr7,144442259,144442656,397,-1,0,27010,1,251.88916876574300000000
chr7,146229511,146495773,266262,-1,0,26047,1,0.37556992736477600000
chr7,146350043,146448211,98168,-1,0,26047,1,1.01866188574688000000
chr7,146332143,146371048,38905,-1,0,26047,1,2.57036370646446000000
chr7,146218586,146255453,36867,-1,0,26047,1,2.71245287113136000000
chr7,145001295,145019890,18595,-1,0,,0,0.00000000000000000000
chr7,145147896,145157678,9782,-1,0,,0,0.00000000000000000000
chr7,146133674,146140139,6465,-1,0,26047,1,15.46790409899460000000
chr7,144643437,144651334,7897,-1,0,,0,0.00000000000000000000
chr7,144770164,144774851,4687,-1,0,,0,0.00000000000000000000
chr7,145793301,145799132,5831,-1,0,,0,0.00000000000000000000
chr7,144917815,144923053,5238,-1,0,,0,0.00000000000000000000
chr7,144636636,144642091,5455,-1,0,,0,0.00000000000000000000
chr7,144771412,144773851,2439,-1,0,,0,0.00000000000000000000
chr7,146299966,146302663,2697,-1,0,26047,1,37.07823507601040000000
chr7,147011522,147012742,1220,-1,0,26047,1,81.96721311475410000000
chr7,146268819,146270053,1234,-1,0,26047,1,81.03727714748780000000
chr7,146253815,146254819,1004,-1,0,26047,1,99.60159362549800000000
chr7,147011446,147012336,890,-1,0,26047,1,112.35955056179800000000
chr7,145268650,145269202,552,-1,0,,0,0.00000000000000000000
chr7,145228797,145229365,568,-1,0,,0,0.00000000000000000000
chr7,145499017,145499419,402,-1,0,,0,0.00000000000000000000
chr7,146224577,146224982,405,-1,0,26047,1,246.91358024691400000000
chr7,145019620,145019970,350,-1,0,,0,0.00000000000000000000
chr7,146883955,146884169,214,-1,0,26047,1,467.28971962616800000000
chr7,145063221,145063384,163,-1,0,,0,0.00000000000000000000
chr7,147355063,147355378,315,-1,0,26047,1,317.46031746031700000000
chr7,147416345,147417200,855,-1,0,26047,1,116.95906432748500000000
chr7,147714621,147716947,2326,-1,0,26047,1,42.99226139294930000000
chr7,147847233,147851579,4346,-1,0,26047,1,23.00966405890470000000
chr7,148027336,148028005,669,-1,0,26047,1,149.47683109118100000000
chr7,148062817,148063241,424,-1,0,26047,1,235.84905660377400000000
chr7,148063045,148063278,233,-1,0,26047,1,429.18454935622300000000
chr7,148072775,148076353,3578,-1,0,26047,1,27.94857462269420000000
chr7,148074473,148076279,1806,-1,0,26047,1,55.37098560354370000000
chr7,148091311,148094248,2937,-1,0,26047,1,34.04834865509020000000
chr7,148106839,148107111,272,-1,0,26047,1,367.64705882352900000000
chr7,148111421,148111857,436,-1,0,26047,1,229.35779816513800000000
chr7,148438526,148438972,446,-1,0,8454,1,224.21524663677100000000
chr7,148438670,148438863,193,-1,0,8454,1,518.13471502590700000000
chr7,148438633,148438768,135,-1,0,8454,1,740.74074074074100000000
chr7,148600929,148628133,27204,-1,0,,0,0.00000000000000000000
chr7,148670000,148676808,6808,-1,0,,0,0.00000000000000000000
chr7,148730409,148731410,1001,-1,0,,0,0.00000000000000000000
chr7,148818052,148818592,540,-1,0,155054,1,185.18518518518500000000
chr7,148818185,148818508,323,-1,0,155054,1,309.59752321981400000000
chr7,149190154,149317105,126951,-1,0,155061,1,0.78770549267040000000
chr7,149282468,149306150,23682,-1,0,,0,0.00000000000000000000
chr7,149314129,149316992,2863,-1,0,,0,0.00000000000000000000
chr7,149526700,149527202,502,-1,0,23145,1,199.20318725099600000000
chr7,149575758,149576323,565,-1,0,155066,1,176.99115044247800000000
chr7,149575928,149576094,166,-1,0,155066,1,602.40963855421700000000
chr7,149575942,149576083,141,-1,0,155066,1,709.21985815602800000000
chr7,149689009,149689208,199,-1,0,,0,0.00000000000000000000
chr7,149689070,149689210,140,-1,0,,0,0.00000000000000000000
chr7,149707646,149711451,3805,-1,0,,0,0.00000000000000000000
chr7,149714469,149716600,2131,-1,0,,0,0.00000000000000000000
chr7,149735932,149739611,3679,-1,0,,0,0.00000000000000000000
chr7,149731203,149735124,3921,-1,0,,0,0.00000000000000000000
chr7,149737068,149739024,1956,-1,0,,0,0.00000000000000000000
chr7,149730497,149733033,2536,-1,0,,0,0.00000000000000000000
chr7,149732976,149734645,1669,-1,0,,0,0.00000000000000000000
chr7,149732176,149733049,873,-1,0,,0,0.00000000000000000000
chr7,149732353,149732485,132,-1,0,,0,0.00000000000000000000
chr7,149862870,149883284,20414,-1,0,,0,0.00000000000000000000
chr7,149847619,149849125,1506,-1,0,,0,0.00000000000000000000
chr7,150082393,150082786,393,-1,0,285971,1,254.45292620865100000000
chr7,150125703,150128802,3099,-1,0,,0,0.00000000000000000000
chr7,150234003,150243957,9954,-1,0,,0,0.00000000000000000000
chr7,150286146,150307909,21763,-1,0,,0,0.00000000000000000000
chr7,150300943,150306784,5841,-1,0,,0,0.00000000000000000000
chr7,150295357,150296213,856,-1,0,,0,0.00000000000000000000
chr7,150463030,150463481,451,-1,0,,0,0.00000000000000000000
chr7,150477028,150477312,284,-1,0,,0,0.00000000000000000000
chr7,150484364,150485812,1448,-1,0,,0,0.00000000000000000000
chr7,150551683,150575126,23443,-1,0,26,1,4.26566565712579000000
chr7,150565475,150574469,8994,-1,0,,0,0.00000000000000000000
chr7,150552933,150562322,9389,-1,0,26,1,10.65076152944940000000
chr7,150566180,150572402,6222,-1,0,,0,0.00000000000000000000
chr7,150718837,150719491,654,-1,0,285973,1,152.90519877675800000000
chr7,150675810,150676219,409,-1,0,,0,0.00000000000000000000
chr7,150724463,150724515,52,-1,0,,0,0.00000000000000000000
chr7,150811726,150812758,1032,-1,0,116988,1,96.89922480620150000000
chr7,150812236,150812966,730,-1,0,116988,1,136.98630136986300000000
chr7,151013463,151013785,322,-1,0,,0,0.00000000000000000000
chr7,151057758,151058282,524,-1,0,51667,1,190.83969465648900000000
chr7,151057980,151058124,144,-1,0,51667,1,694.44444444444400000000
chr7,151229573,151231573,2000,-1,0,,0,0.00000000000000000000
chr7,151300187,151300729,542,-1,0,51422,1,184.50184501845000000000
chr7,151333123,151333990,867,-1,0,51422,1,115.34025374855800000000
chr7,151434929,151435325,396,-1,0,51422,1,252.52525252525300000000
chr7,151526508,151528219,1711,-1,0,51422,1,58.44535359438920000000
chr7,151551941,151552682,741,-1,0,51422,1,134.95276653171400000000
chr7,151539121,151539516,395,-1,0,51422,1,253.16455696202500000000
chr7,151552066,151552513,447,-1,0,51422,1,223.71364653243800000000
chr7,151517443,151517802,359,-1,0,51422,1,278.55153203342600000000
chr7,151590795,151599793,8998,-1,0,,0,0.00000000000000000000
chr7,151591697,151592258,561,-1,0,,0,0.00000000000000000000
chr7,151591759,151592129,370,-1,0,,0,0.00000000000000000000
chr7,151613129,151613610,481,-1,0,,0,0.00000000000000000000
chr7,151671054,151671588,534,-1,0,168391,1,187.26591760299600000000
chr7,151671197,151671374,177,-1,0,168391,1,564.97175141242900000000
chr7,151744837,151746193,1356,-1,0,63917,1,73.74631268436580000000
chr7,151988856,152073672,84816,-1,0,58508,1,1.17902282588191000000
chr7,152017523,152022487,4964,-1,0,58508,1,20.14504431909750000000
chr7,152082433,152082909,476,-1,0,58508,1,210.08403361344500000000
chr7,152099293,152112113,12820,-1,0,58508,1,7.80031201248050000000
chr7,152146890,152147614,724,-1,0,,0,0.00000000000000000000
chr7,152166195,152167076,881,-1,0,,0,0.00000000000000000000
chr7,152188932,152192449,3517,-1,0,,0,0.00000000000000000000
chr7,152229584,152230507,923,-1,0,,0,0.00000000000000000000
chr7,152245348,152246306,958,-1,0,,0,0.00000000000000000000
chr7,152292297,152297221,4924,-1,0,,0,0.00000000000000000000
chr7,152281458,152284482,3024,-1,0,,0,0.00000000000000000000
chr7,152318986,152319380,394,-1,0,,0,0.00000000000000000000
chr7,152417756,152420831,3075,-1,0,,0,0.00000000000000000000
chr7,152419297,152419847,550,-1,0,,0,0.00000000000000000000
chr7,152419399,152419715,316,-1,0,,0,0.00000000000000000000
chr7,152426834,152435164,8330,-1,0,,0,0.00000000000000000000
chr7,152567693,152568434,741,-1,0,,0,0.00000000000000000000
chr7,152567921,152568246,325,-1,0,,0,0.00000000000000000000
chr7,152568021,152568177,156,-1,0,,0,0.00000000000000000000
chr7,152573736,152580896,7160,-1,0,,0,0.00000000000000000000
chr7,152575399,152580274,4875,-1,0,,0,0.00000000000000000000
chr7,152578977,152580179,1202,-1,0,,0,0.00000000000000000000
chr7,152589484,152751639,162155,-1,0,,0,0.00000000000000000000
chr7,152597458,152618404,20946,-1,0,,0,0.00000000000000000000
chr7,152613132,152617703,4571,-1,0,,0,0.00000000000000000000
chr7,152708459,152708845,386,-1,0,,0,0.00000000000000000000
chr7,152809935,152810055,120,-1,0,,0,0.00000000000000000000
chr7,152986601,152987563,962,-1,0,,0,0.00000000000000000000
chr7,153000064,153000466,402,-1,0,,0,0.00000000000000000000
chr7,153000082,153000228,146,-1,0,,0,0.00000000000000000000
chr7,153064510,153064561,51,-1,0,,0,0.00000000000000000000
chr7,153124149,153125248,1099,-1,0,,0,0.00000000000000000000
chr7,153151310,153209682,58372,-1,0,,0,0.00000000000000000000
chr7,153262901,153264029,1128,-1,0,,0,0.00000000000000000000
chr7,153310119,153310857,738,-1,0,,0,0.00000000000000000000
chr7,153479019,153498805,19786,-1,0,,0,0.00000000000000000000
chr7,153502892,153506453,3561,-1,0,,0,0.00000000000000000000
chr7,153529758,153529829,71,-1,0,,0,0.00000000000000000000
chr7,153692278,153695547,3269,-1,0,1804,1,30.59039461609050000000
chr7,153759170,153759951,781,-1,0,1804,1,128.04097311139600000000
chr7,153911697,153919766,8069,-1,0,1804,1,12.39310943115630000000
chr7,153919842,153922259,2417,-1,0,1804,1,41.37360364087710000000
chr7,153932268,153933319,1051,-1,0,1804,1,95.14747859181730000000
chr7,153932391,153932788,397,-1,0,1804,1,251.88916876574300000000
chr7,153932476,153932705,229,-1,0,1804,1,436.68122270742400000000
chr7,153938622,153940315,1693,-1,0,1804,1,59.06674542232720000000
chr7,154007549,154062015,54466,-1,0,1804,1,1.83600778467301000000
chr7,154140496,154140938,442,-1,0,1804,1,226.24434389140300000000
chr7,154153742,154155104,1362,-1,0,1804,1,73.42143906020560000000
chr7,154266125,154267643,1518,-1,0,1804,1,65.87615283267460000000
chr7,154391747,154400125,8378,-1,0,1804,1,11.93602291716400000000
chr7,154392057,154399934,7877,-1,0,1804,1,12.69518852354960000000
chr7,154447863,154449514,1651,-1,0,1804,1,60.56935190793460000000
chr7,154448782,154449382,600,-1,0,1804,1,166.66666666666700000000
chr7,154447976,154448059,83,-1,0,1804,1,1204.81927710843000000000
chr7,154452632,154456017,3385,-1,0,1804,1,29.54209748892170000000
chr7,154454225,154455836,1611,-1,0,1804,1,62.07324643078830000000
chr7,154454541,154455300,759,-1,0,1804,1,131.75230566534900000000
chr7,154468005,154468191,186,-1,0,1804,1,537.63440860215100000000
chr7,154609287,154609726,439,-1,0,1804,1,227.79043280182200000000
chr7,154609437,154609525,88,-1,0,1804,1,1136.36363636364000000000
chr7,154671045,154671318,273,-1,0,1804,1,366.30036630036600000000
chr7,154675173,154675328,155,-1,0,1804,1,645.16129032258100000000
chr7,154709715,154714059,4344,-1,0,,0,0.00000000000000000000
chr7,154876919,154880449,3530,-1,0,3361,1,28.32861189801700000000
chr7,154885112,154889560,4448,-1,0,,0,0.00000000000000000000
chr7,154909972,154910613,641,-1,0,,0,0.00000000000000000000
chr7,154910415,154910483,68,-1,0,,0,0.00000000000000000000
chr7,154915794,154915969,175,-1,0,,0,0.00000000000000000000
chr7,154931724,154932961,1237,-1,0,,0,0.00000000000000000000
chr7,154932001,154932512,511,-1,0,,0,0.00000000000000000000
chr7,154936350,154952671,16321,-1,0,,0,0.00000000000000000000
chr7,154941837,154942360,523,-1,0,,0,0.00000000000000000000
chr7,154951228,154951700,472,-1,0,,0,0.00000000000000000000
chr7,154941878,154942224,346,-1,0,,0,0.00000000000000000000
chr7,154962698,154965659,2961,-1,0,,0,0.00000000000000000000
chr7,154999971,155000307,336,-1,0,,0,0.00000000000000000000
chr7,155017691,155018957,1266,-1,0,,0,0.00000000000000000000
chr7,155055933,155081890,25957,-1,0,,0,0.00000000000000000000
chr7,155054810,155055048,238,-1,0,,0,0.00000000000000000000
chr7,155120325,155121131,806,-1,0,,0,0.00000000000000000000
chr7,155137713,155141549,3836,-1,0,,0,0.00000000000000000000
chr7,155138818,155142795,3977,-1,0,,0,0.00000000000000000000
chr7,155138879,155141319,2440,-1,0,,0,0.00000000000000000000
chr7,155138955,155140407,1452,-1,0,,0,0.00000000000000000000
chr7,155140324,155141444,1120,-1,0,,0,0.00000000000000000000
chr7,155139460,155140050,590,-1,0,,0,0.00000000000000000000
chr7,155143037,155143476,439,-1,0,,0,0.00000000000000000000
chr7,155143216,155143504,288,-1,0,,0,0.00000000000000000000
chr7,155221341,155224129,2788,-1,0,,0,0.00000000000000000000
chr7,155199760,155202255,2495,-1,0,,0,0.00000000000000000000
chr7,155200402,155201135,733,-1,0,,0,0.00000000000000000000
chr7,155199580,155200153,573,-1,0,,0,0.00000000000000000000
chr7,155201098,155201552,454,-1,0,,0,0.00000000000000000000
chr7,155408017,155412851,4834,-1,0,,0,0.00000000000000000000
chr7,155407658,155410306,2648,-1,0,,0,0.00000000000000000000
chr7,155409466,155410267,801,-1,0,,0,0.00000000000000000000
chr7,155503856,155509010,5154,-1,0,155435,1,19.40240589833140000000
chr7,155622143,155623027,884,-1,0,,0,0.00000000000000000000
chr7,155685244,155685419,175,-1,0,,0,0.00000000000000000000
chr7,155725259,155725552,293,-1,0,,0,0.00000000000000000000
chr7,155726028,155728103,2075,-1,0,,0,0.00000000000000000000
chr7,155726699,155727213,514,-1,0,,0,0.00000000000000000000
chr7,155727126,155727566,440,-1,0,,0,0.00000000000000000000
chr7,155726698,155726985,287,-1,0,,0,0.00000000000000000000
chr7,155848539,155851155,2616,-1,0,,0,0.00000000000000000000
chr7,155882383,155886856,4473,-1,0,,0,0.00000000000000000000
chr7,155919301,155919755,454,-1,0,,0,0.00000000000000000000
chr7,155926157,155926317,160,-1,0,,0,0.00000000000000000000
chr7,155930660,155931341,681,-1,0,,0,0.00000000000000000000
chr7,155946656,155948821,2165,-1,0,,0,0.00000000000000000000
chr7,155957720,155958614,894,-1,0,,0,0.00000000000000000000
chr7,156135014,156135455,441,-1,0,,0,0.00000000000000000000
chr7,156290405,156311823,21418,-1,0,,0,0.00000000000000000000
chr7,156301185,156309915,8730,-1,0,,0,0.00000000000000000000
chr7,156312960,156313279,319,-1,0,,0,0.00000000000000000000
chr7,156313041,156313167,126,-1,0,,0,0.00000000000000000000
chr7,156313080,156313134,54,-1,0,,0,0.00000000000000000000
chr7,156324604,156335538,10934,-1,0,,0,0.00000000000000000000
chr7,156386151,156394725,8574,-1,0,,0,0.00000000000000000000
chr7,156387180,156391284,4104,-1,0,,0,0.00000000000000000000
chr7,156390917,156394617,3700,-1,0,,0,0.00000000000000000000
chr7,156389824,156390267,443,-1,0,,0,0.00000000000000000000
chr7,156390198,156390408,210,-1,0,,0,0.00000000000000000000
chr7,156582535,156583531,996,-1,0,64327,1,100.40160642570300000000
chr7,156633029,156643415,10386,-1,0,64327,1,9.62834585018294000000
chr7,156634602,156635136,534,-1,0,64327,1,187.26591760299600000000
chr7,156750756,156752026,1270,-1,0,64434,1,78.74015748031500000000
chr7,156879310,156879751,441,-1,0,,0,0.00000000000000000000
chr7,156948477,156950365,1888,-1,0,9690,1,52.96610169491530000000
chr7,157116629,157122715,6086,-1,0,,0,0.00000000000000000000
chr7,157133344,157135792,2448,-1,0,10049,1,40.84967320261440000000
chr7,157118660,157120654,1994,-1,0,,0,0.00000000000000000000
chr7,157096074,157096916,842,-1,0,,0,0.00000000000000000000
chr7,157162218,157162799,581,-1,0,10049,1,172.11703958691900000000
chr7,157223268,157223533,265,-1,0,,0,0.00000000000000000000
chr7,157234036,157235318,1282,-1,0,,0,0.00000000000000000000
chr7,157230509,157231044,535,-1,0,,0,0.00000000000000000000
chr7,157232326,157232387,61,-1,0,,0,0.00000000000000000000
chr7,157272566,157273160,594,-1,0,,0,0.00000000000000000000
chr7,157272680,157273027,347,-1,0,,0,0.00000000000000000000
chr7,157288164,157298633,10469,-1,0,,0,0.00000000000000000000
chr7,157375272,157376364,1092,-1,0,5799,1,91.57509157509160000000
chr7,157388157,157388301,144,-1,0,5799,1,694.44444444444400000000
chr7,157439593,157444590,4997,-1,0,5799,1,20.01200720432260000000
chr7,157438008,157442048,4040,-1,0,5799,1,24.75247524752480000000
chr7,157439676,157442802,3126,-1,0,5799,1,31.98976327575180000000
chr7,157439461,157441580,2119,-1,0,5799,1,47.19207173194900000000
chr7,157459691,157459933,242,-1,0,5799,1,413.22314049586800000000
chr7,157503476,157504051,575,-1,0,5799,1,173.91304347826100000000
chr7,157524049,157526972,2923,-1,0,5799,1,34.21142661648990000000
chr7,157524453,157525950,1497,-1,0,5799,1,66.80026720106880000000
chr7,157524327,157524454,127,-1,0,5799,1,787.40157480315000000000
chr7,157541121,157542374,1253,-1,0,5799,1,79.80845969672790000000
chr7,157601914,157606431,4517,-1,0,5799,1,22.13858755811380000000
chr7,157650527,157652660,2133,-1,0,5799,1,46.88232536333800000000
chr7,157665941,157666576,635,-1,0,5799,1,157.48031496063000000000
chr7,157673702,157674134,432,-1,0,5799,1,231.48148148148100000000
chr7,157687775,157688276,501,-1,0,5799,1,199.60079840319400000000
chr7,157694245,157694722,477,-1,0,5799,1,209.64360587002100000000
chr7,157694393,157694609,216,-1,0,5799,1,462.96296296296300000000
chr7,157717421,157717954,533,-1,0,5799,1,187.61726078799300000000
chr7,157719657,157720426,769,-1,0,5799,1,130.03901170351100000000
chr7,157732215,157735356,3141,-1,0,5799,1,31.83699458771090000000
chr7,157733250,157734190,940,-1,0,5799,1,106.38297872340400000000
chr7,157733465,157734068,603,-1,0,5799,1,165.83747927031500000000
chr7,157733816,157734110,294,-1,0,5799,1,340.13605442176900000000
chr7,157769102,157772020,2918,-1,0,5799,1,34.27004797806720000000
chr7,157774659,157775068,409,-1,0,5799,1,244.49877750611200000000
chr7,157787403,157787696,293,-1,0,5799,1,341.29692832764500000000
chr7,157825631,157826125,494,-1,0,5799,1,202.42914979757100000000
chr7,157850892,157853654,2762,-1,0,5799,1,36.20564808110060000000
chr7,157863614,157864112,498,-1,0,5799,1,200.80321285140600000000
chr7,157870227,157870281,54,-1,0,5799,1,1851.85185185185000000000
chr7,157876755,157879120,2365,-1,0,5799,1,42.28329809725160000000
chr7,157880226,157883155,2929,-1,0,5799,1,34.14134516899970000000
chr7,157880661,157882390,1729,-1,0,5799,1,57.83689994216310000000
chr7,157882182,157882883,701,-1,0,5799,1,142.65335235378000000000
chr7,157885880,157885956,76,-1,0,5799,1,1315.78947368421000000000
chr7,157891692,157892454,762,-1,0,5799,1,131.23359580052500000000
chr7,157939982,157946849,6867,-1,0,5799,1,14.56239988350080000000
chr7,157939755,157941919,2164,-1,0,5799,1,46.21072088724580000000
chr7,157939660,157941031,1371,-1,0,5799,1,72.93946024799420000000
chr7,157940590,157941624,1034,-1,0,5799,1,96.71179883945840000000
chr7,157940399,157941051,652,-1,0,5799,1,153.37423312883400000000
chr7,157941238,157941817,579,-1,0,5799,1,172.71157167530200000000
chr7,157951199,157952053,854,-1,0,5799,1,117.09601873536300000000
chr7,157957048,157957110,62,-1,0,5799,1,1612.90322580645000000000
chr7,157980716,157981426,710,-1,0,5799,1,140.84507042253500000000
chr7,158029090,158030672,1582,-1,0,5799,1,63.21112515802780000000
chr7,158020591,158022699,2108,-1,0,5799,1,47.43833017077800000000
chr7,158046308,158047614,1306,-1,0,5799,1,76.56967840735070000000
chr7,158037863,158039667,1804,-1,0,5799,1,55.43237250554320000000
chr7,158066095,158067131,1036,-1,0,5799,1,96.52509652509650000000
chr7,158068695,158069412,717,-1,0,5799,1,139.47001394700100000000
chr7,158029473,158030453,980,-1,0,5799,1,102.04081632653100000000
chr7,158046568,158047317,749,-1,0,5799,1,133.51134846461900000000
chr7,158052273,158052816,543,-1,0,5799,1,184.16206261510100000000
chr7,158037709,158038136,427,-1,0,5799,1,234.19203747072600000000
chr7,158041298,158041781,483,-1,0,5799,1,207.03933747412000000000
chr7,158087822,158088165,343,-1,0,5799,1,291.54518950437300000000
chr7,158052406,158052568,162,-1,0,5799,1,617.28395061728400000000
chr7,158068952,158069179,227,-1,0,5799,1,440.52863436123400000000
chr7,158052500,158052658,158,-1,0,5799,1,632.91139240506300000000
chr7,158104673,158105049,376,-1,0,5799,1,265.95744680851100000000
chr7,158111501,158138200,26699,-1,0,5799,1,3.74545863140942000000
chr7,158122939,158134625,11686,-1,0,5799,1,8.55724798904672000000
chr7,158112306,158113079,773,-1,0,5799,1,129.36610608020700000000
chr7,158112508,158112895,387,-1,0,5799,1,258.39793281653700000000
chr7,158133584,158133853,269,-1,0,5799,1,371.74721189591100000000
chr7,158209668,158211417,1749,-1,0,5799,1,57.17552887364210000000
chr7,158217932,158220666,2734,-1,0,5799,1,36.57644476956840000000
chr7,158217880,158218361,481,-1,0,5799,1,207.90020790020800000000
chr7,158245541,158246288,747,-1,0,5799,1,133.86880856760400000000
chr7,158249917,158250732,815,-1,0,5799,1,122.69938650306700000000
chr7,158233018,158233804,786,-1,0,5799,1,127.22646310432600000000
chr7,158233518,158234235,717,-1,0,5799,1,139.47001394700100000000
chr7,158252395,158252732,337,-1,0,5799,1,296.73590504451000000000
chr7,158245801,158246112,311,-1,0,5799,1,321.54340836012900000000
chr7,158250232,158250405,173,-1,0,5799,1,578.03468208092500000000
chr7,158250283,158250425,142,-1,0,5799,1,704.22535211267600000000
chr7,158316098,158317205,1107,-1,0,5799,1,90.33423667570010000000
chr7,158314304,158315135,831,-1,0,5799,1,120.33694344163700000000
chr7,158314210,158314595,385,-1,0,5799,1,259.74025974026000000000
chr7,158314325,158314639,314,-1,0,5799,1,318.47133757961800000000
chr7,158388569,158416448,27879,-1,0,,0,0.00000000000000000000
chr7,158460014,158461151,1137,-1,0,54892,1,87.95074758135440000000
chr7,158460046,158460795,749,-1,0,54892,1,133.51134846461900000000
chr7,158459931,158460399,468,-1,0,54892,1,213.67521367521400000000
chr7,158395072,158395266,194,-1,0,,0,0.00000000000000000000
chr7,158459993,158460216,223,-1,0,54892,1,448.43049327354300000000
chr7,158496115,158504942,8827,-1,0,54892,1,11.32887730825880000000
chr7,158500761,158504853,4092,-1,0,,0,0.00000000000000000000
chr7,158521295,158523142,1847,-1,0,,0,0.00000000000000000000
chr7,158521781,158522531,750,-1,0,,0,0.00000000000000000000
chr7,158574558,158574751,193,-1,0,57488,1,518.13471502590700000000
chr7,158589144,158590104,960,-1,0,57488,1,104.16666666666700000000
chr7,158589354,158589972,618,-1,0,57488,1,161.81229773462800000000
chr7,158589604,158589813,209,-1,0,57488,1,478.46889952153100000000
chr7,158589562,158589690,128,-1,0,57488,1,781.25000000000000000000
chr7,158589662,158589717,55,-1,0,57488,1,1818.18181818182000000000
chr7,158596466,158596746,280,-1,0,57488,1,357.14285714285700000000
chr7,158631329,158632171,842,-1,0,,0,0.00000000000000000000
chr7,158644084,158645300,1216,-1,0,,0,0.00000000000000000000
chr7,159075322,159119351,44029,-1,0,,0,0.00000000000000000000
chr7,159050730,159064396,13666,-1,0,,0,0.00000000000000000000
chr7,159105672,159121331,15659,-1,0,,0,0.00000000000000000000
chr7,159065025,159077129,12104,-1,0,,0,0.00000000000000000000
chr7,159049401,159059557,10156,-1,0,,0,0.00000000000000000000
chr7,159117356,159123375,6019,-1,0,,0,0.00000000000000000000
chr7,158707956,158710214,2258,-1,0,55112,1,44.28697962798940000000
chr7,159117277,159119707,2430,-1,0,,0,0.00000000000000000000
chr7,158995376,158996447,1071,-1,0,,0,0.00000000000000000000
chr7,158998636,158999694,1058,-1,0,,0,0.00000000000000000000
chr7,159001322,159001847,525,-1,0,,0,0.00000000000000000000
chr7,159001247,159001568,321,-1,0,,0,0.00000000000000000000
chr7,158710078,158710354,276,-1,0,55112,1,362.31884057971000000000
chr7,158954890,158955051,161,-1,0,,0,0.00000000000000000000
chr8,769649,856831,87182,-1,0,9228,1,1.14702576219862000000
chr8,19195,70037,50842,-1,0,,0,0.00000000000000000000
chr8,578901,621800,42899,-1,0,157697,1,2.33105666798760000000
chr8,255473,264166,8693,-1,0,,0,0.00000000000000000000
chr8,594393,599420,5027,-1,0,157697,1,19.89258006763480000000
chr8,594761,598389,3628,-1,0,157697,1,27.56339581036380000000
chr8,579372,581152,1780,-1,0,157697,1,56.17977528089890000000
chr8,625103,626578,1475,-1,0,157697,1,67.79661016949150000000
chr8,645437,646933,1496,-1,0,157697,1,66.84491978609630000000
chr8,594937,596594,1657,-1,0,157697,1,60.35003017501510000000
chr8,535054,536534,1480,-1,0,,0,0.00000000000000000000
chr8,232210,233297,1087,-1,0,,0,0.00000000000000000000
chr8,625600,626360,760,-1,0,157697,1,131.57894736842100000000
chr8,645279,645863,584,-1,0,157697,1,171.23287671232900000000
chr8,646115,646932,817,-1,0,157697,1,122.39902080783400000000
chr8,579578,580358,780,-1,0,157697,1,128.20512820512800000000
chr8,589501,590022,521,-1,0,157697,1,191.93857965451100000000
chr8,478389,478667,278,-1,0,157695,1,359.71223021582700000000
chr8,790407,790725,318,-1,0,9228,1,314.46540880503100000000
chr8,453851,454017,166,-1,0,157695,1,602.40963855421700000000
chr8,589659,589844,185,-1,0,157697,1,540.54054054054100000000
chr8,664449,664612,163,-1,0,157697,1,613.49693251533700000000
chr8,645554,645719,165,-1,0,157697,1,606.06060606060600000000
chr8,893414,893913,499,-1,0,9228,1,200.40080160320600000000
chr8,915044,915864,820,-1,0,9228,1,121.95121951219500000000
chr8,915303,915564,261,-1,0,9228,1,383.14176245210700000000
chr8,915201,915436,235,-1,0,9228,1,425.53191489361700000000
chr8,927783,928818,1035,-1,0,9228,1,96.61835748792270000000
chr8,928304,928769,465,-1,0,9228,1,215.05376344086000000000
chr8,940289,943567,3278,-1,0,9228,1,30.50640634533250000000
chr8,940216,940717,501,-1,0,9228,1,199.60079840319400000000
chr8,1120923,1149771,28848,-1,0,9228,1,3.46644481419856000000
chr8,1340651,1356564,15913,-1,0,9228,1,6.28417017532835000000
chr8,1343991,1354568,10577,-1,0,9228,1,9.45447669471495000000
chr8,963508,967697,4189,-1,0,9228,1,23.87204583432800000000
chr8,1263433,1266647,3214,-1,0,9228,1,31.11387678904790000000
chr8,983627,986217,2590,-1,0,9228,1,38.61003861003860000000
chr8,1409212,1410764,1552,-1,0,9228,1,64.43298969072170000000
chr8,1196818,1198798,1980,-1,0,9228,1,50.50505050505050000000
chr8,1294430,1296770,2340,-1,0,9228,1,42.73504273504270000000
chr8,1298273,1300485,2212,-1,0,9228,1,45.20795660036170000000
chr8,1366500,1368171,1671,-1,0,9228,1,59.84440454817470000000
chr8,1305154,1307083,1929,-1,0,9228,1,51.84033177812340000000
chr8,1204675,1206575,1900,-1,0,9228,1,52.63157894736840000000
chr8,1323103,1324440,1337,-1,0,9228,1,74.79431563201200000000
chr8,989044,990838,1794,-1,0,9228,1,55.74136008918620000000
chr8,1336141,1337473,1332,-1,0,9228,1,75.07507507507510000000
chr8,1409393,1410670,1277,-1,0,9228,1,78.30853563038370000000
chr8,1196899,1197692,793,-1,0,9228,1,126.10340479192900000000
chr8,1299557,1300342,785,-1,0,9228,1,127.38853503184700000000
chr8,1130693,1131364,671,-1,0,9228,1,149.03129657228000000000
chr8,1190662,1191265,603,-1,0,9228,1,165.83747927031500000000
chr8,1047040,1047909,869,-1,0,9228,1,115.07479861910200000000
chr8,1390067,1390610,543,-1,0,9228,1,184.16206261510100000000
chr8,1071430,1071954,524,-1,0,9228,1,190.83969465648900000000
chr8,1185510,1185966,456,-1,0,9228,1,219.29824561403500000000
chr8,1197508,1198111,603,-1,0,9228,1,165.83747927031500000000
chr8,1397978,1398540,562,-1,0,9228,1,177.93594306049800000000
chr8,1266023,1266489,466,-1,0,9228,1,214.59227467811200000000
chr8,1051569,1052005,436,-1,0,9228,1,229.35779816513800000000
chr8,1184911,1185288,377,-1,0,9228,1,265.25198938992000000000
chr8,1147490,1147894,404,-1,0,9228,1,247.52475247524800000000
chr8,1190757,1191168,411,-1,0,9228,1,243.30900243309000000000
chr8,1079872,1080314,442,-1,0,9228,1,226.24434389140300000000
chr8,1286810,1287184,374,-1,0,9228,1,267.37967914438500000000
chr8,1390324,1390551,227,-1,0,9228,1,440.52863436123400000000
chr8,1130906,1131176,270,-1,0,9228,1,370.37037037037000000000
chr8,1333607,1333904,297,-1,0,9228,1,336.70033670033700000000
chr8,1236900,1237148,248,-1,0,9228,1,403.22580645161300000000
chr8,1296444,1296644,200,-1,0,9228,1,500.00000000000000000000
chr8,1053487,1053672,185,-1,0,9228,1,540.54054054054100000000
chr8,1266111,1266281,170,-1,0,9228,1,588.23529411764700000000
chr8,1130963,1131137,174,-1,0,9228,1,574.71264367816100000000
chr8,1246202,1246298,96,-1,0,9228,1,1041.66666666667000000000
chr8,1237118,1237179,61,-1,0,9228,1,1639.34426229508000000000
chr8,1324908,1324972,64,-1,0,9228,1,1562.50000000000000000000
chr8,1147655,1147708,53,-1,0,9228,1,1886.79245283019000000000
chr8,1431454,1431947,493,-1,0,9228,1,202.83975659229200000000
chr8,1451429,1452390,961,-1,0,9228,1,104.05827263267400000000
chr8,1469239,1469699,460,-1,0,9228,1,217.39130434782600000000
chr8,1509691,1511819,2128,-1,0,9228,1,46.99248120300750000000
chr8,1519817,1520644,827,-1,0,9228,1,120.91898428053200000000
chr8,1516417,1516622,205,-1,0,9228,1,487.80487804878000000000
chr8,1752959,1761635,8676,-1,0,,0,0.00000000000000000000
chr8,1835712,1839861,4149,-1,0,9639,1,24.10219329959030000000
chr8,1835836,1838342,2506,-1,0,9639,1,39.90422984836390000000
chr8,1743801,1747700,3899,-1,0,,0,0.00000000000000000000
chr8,1590065,1592295,2230,-1,0,9228,1,44.84304932735430000000
chr8,1836372,1838479,2107,-1,0,9639,1,47.46084480303750000000
chr8,1836045,1837276,1231,-1,0,9639,1,81.23476848090980000000
chr8,1837704,1839105,1401,-1,0,9639,1,71.37758743754460000000
chr8,1630739,1632243,1504,-1,0,9228,1,66.48936170212770000000
chr8,1745998,1747233,1235,-1,0,,0,0.00000000000000000000
chr8,1631711,1633395,1684,-1,0,9228,1,59.38242280285040000000
chr8,1590144,1591477,1333,-1,0,9228,1,75.01875468867220000000
chr8,1836886,1837946,1060,-1,0,9639,1,94.33962264150940000000
chr8,1574028,1574865,837,-1,0,9228,1,119.47431302270000000000
chr8,1658841,1659622,781,-1,0,,0,0.00000000000000000000
chr8,1776363,1777073,710,-1,0,9639,1,140.84507042253500000000
chr8,1837328,1837905,577,-1,0,9639,1,173.31022530329300000000
chr8,1746374,1747014,640,-1,0,,0,0.00000000000000000000
chr8,1836452,1837157,705,-1,0,9639,1,141.84397163120600000000
chr8,1836173,1836894,721,-1,0,9639,1,138.69625520111000000000
chr8,1658811,1659134,323,-1,0,,0,0.00000000000000000000
chr8,1822993,1823447,454,-1,0,9639,1,220.26431718061700000000
chr8,1798090,1798523,433,-1,0,9639,1,230.94688221709000000000
chr8,1588302,1588673,371,-1,0,9228,1,269.54177897574100000000
chr8,1797964,1798277,313,-1,0,9639,1,319.48881789137400000000
chr8,1789974,1790251,277,-1,0,9639,1,361.01083032491000000000
chr8,1658878,1659124,246,-1,0,,0,0.00000000000000000000
chr8,1781067,1781212,145,-1,0,9639,1,689.65517241379300000000
chr8,1836368,1836496,128,-1,0,9639,1,781.25000000000000000000
chr8,1867121,1868311,1190,-1,0,9639,1,84.03361344537820000000
chr8,1901203,1901683,480,-1,0,9639,1,208.33333333333300000000
chr8,1901396,1901543,147,-1,0,9639,1,680.27210884353700000000
chr8,1939700,1942461,2761,-1,0,9920,1,36.21876131836290000000
chr8,1949350,1951397,2047,-1,0,9920,1,48.85197850512950000000
chr8,1969802,2009533,39731,-1,0,9172,1,2.51692632956633000000
chr8,1997838,2016809,18971,-1,0,9172,1,5.27120341573981000000
chr8,2002935,2003479,544,-1,0,9172,1,183.82352941176500000000
chr8,2003078,2003273,195,-1,0,9172,1,512.82051282051300000000
chr8,2029077,2029131,54,-1,0,9172,1,1851.85185185185000000000
chr8,2033550,2034337,787,-1,0,9172,1,127.06480304955500000000
chr8,2033686,2034170,484,-1,0,9172,1,206.61157024793400000000
chr8,2142322,2184087,41765,-1,0,,0,0.00000000000000000000
chr8,2139216,2161704,22488,-1,0,,0,0.00000000000000000000
chr8,2141820,2158434,16614,-1,0,,0,0.00000000000000000000
chr8,2150536,2161596,11060,-1,0,,0,0.00000000000000000000
chr8,2078363,2085953,7590,-1,0,9172,1,13.17523056653490000000
chr8,2129491,2135024,5533,-1,0,,0,0.00000000000000000000
chr8,2152997,2157782,4785,-1,0,,0,0.00000000000000000000
chr8,2164671,2165160,489,-1,0,,0,0.00000000000000000000
chr8,2122021,2122406,385,-1,0,,0,0.00000000000000000000
chr8,2149074,2149561,487,-1,0,,0,0.00000000000000000000
chr8,2075371,2075716,345,-1,0,9172,1,289.85507246376800000000
chr8,2135265,2135614,349,-1,0,,0,0.00000000000000000000
chr8,2122086,2122351,265,-1,0,,0,0.00000000000000000000
chr8,2077988,2078209,221,-1,0,9172,1,452.48868778280500000000
chr8,2156942,2157220,278,-1,0,,0,0.00000000000000000000
chr8,2075498,2075759,261,-1,0,9172,1,383.14176245210700000000
chr8,2078104,2078363,259,-1,0,9172,1,386.10038610038600000000
chr8,2148345,2148431,86,-1,0,,0,0.00000000000000000000
chr8,2199677,2200081,404,-1,0,,0,0.00000000000000000000
chr8,2215089,2216326,1237,-1,0,,0,0.00000000000000000000
chr8,2215305,2216105,800,-1,0,,0,0.00000000000000000000
chr8,2215303,2215807,504,-1,0,,0,0.00000000000000000000
chr8,2250566,2266580,16014,-1,0,,0,0.00000000000000000000
chr8,2309975,2329305,19330,-1,0,,0,0.00000000000000000000
chr8,2254313,2263451,9138,-1,0,,0,0.00000000000000000000
chr8,2254210,2259415,5205,-1,0,,0,0.00000000000000000000
chr8,2321827,2322915,1088,-1,0,,0,0.00000000000000000000
chr8,2321951,2322412,461,-1,0,,0,0.00000000000000000000
chr8,2322141,2322255,114,-1,0,,0,0.00000000000000000000
chr8,2479846,2481797,1951,-1,0,,0,0.00000000000000000000
chr8,2480274,2481061,787,-1,0,,0,0.00000000000000000000
chr8,2480464,2480903,439,-1,0,,0,0.00000000000000000000
chr8,2480441,2480687,246,-1,0,,0,0.00000000000000000000
chr8,2596042,2660504,64462,-1,0,,0,0.00000000000000000000
chr8,3116038,3127841,11803,-1,0,64478,1,8.47242226552572000000
chr8,2616320,2627476,11156,-1,0,,0,0.00000000000000000000
chr8,2887138,2891303,4165,-1,0,64478,1,24.00960384153660000000
chr8,2588163,2593045,4882,-1,0,,0,0.00000000000000000000
chr8,2887168,2890520,3352,-1,0,64478,1,29.83293556085920000000
chr8,3145423,3148452,3029,-1,0,64478,1,33.01419610432490000000
chr8,2652389,2652949,560,-1,0,,0,0.00000000000000000000
chr8,2739684,2740175,491,-1,0,,0,0.00000000000000000000
chr8,3047545,3048045,500,-1,0,64478,1,200.00000000000000000000
chr8,3181505,3181985,480,-1,0,64478,1,208.33333333333300000000
chr8,2778561,2778787,226,-1,0,,0,0.00000000000000000000
chr8,3040856,3041065,209,-1,0,64478,1,478.46889952153100000000
chr8,2739874,2740098,224,-1,0,,0,0.00000000000000000000
chr8,3047769,3047846,77,-1,0,64478,1,1298.70129870130000000000
chr8,3367620,3369261,1641,-1,0,64478,1,60.93845216331510000000
chr8,3415554,3415995,441,-1,0,64478,1,226.75736961451200000000
chr8,3529987,3543047,13060,-1,0,64478,1,7.65696784073507000000
chr8,3581364,3581874,510,-1,0,64478,1,196.07843137254900000000
chr8,3581499,3581752,253,-1,0,64478,1,395.25691699604700000000
chr8,4009016,4170808,161792,-1,0,64478,1,0.61807753164557000000
chr8,3891014,4032503,141489,-1,0,64478,1,0.70676872407042200000
chr8,3681523,3765045,83522,-1,0,64478,1,1.19728933694117000000
chr8,3944432,4049458,105026,-1,0,64478,1,0.95214518309751900000
chr8,3754379,3832694,78315,-1,0,64478,1,1.27689459235140000000
chr8,3981834,4026993,45159,-1,0,64478,1,2.21439801589938000000
chr8,3618749,3653714,34965,-1,0,64478,1,2.86000286000286000000
chr8,4003968,4027660,23692,-1,0,64478,1,4.22083403680567000000
chr8,3759579,3783144,23565,-1,0,64478,1,4.24358158285593000000
chr8,3987902,4005041,17139,-1,0,64478,1,5.83464612871229000000
chr8,4037152,4056463,19311,-1,0,64478,1,5.17839573300192000000
chr8,3775035,3790092,15057,-1,0,64478,1,6.64142923557149000000
chr8,3996856,4004666,7810,-1,0,64478,1,12.80409731113960000000
chr8,3866763,3876780,10017,-1,0,64478,1,9.98302885095338000000
chr8,3787595,3797755,10160,-1,0,64478,1,9.84251968503937000000
chr8,3995643,4002735,7092,-1,0,64478,1,14.10039481105470000000
chr8,3912943,3921370,8427,-1,0,64478,1,11.86661920018990000000
chr8,4025391,4033797,8406,-1,0,64478,1,11.89626457292410000000
chr8,4131876,4139786,7910,-1,0,64478,1,12.64222503160560000000
chr8,3785294,3790969,5675,-1,0,64478,1,17.62114537444930000000
chr8,4049229,4052986,3757,-1,0,64478,1,26.61698163428270000000
chr8,4000102,4004048,3946,-1,0,64478,1,25.34211860111510000000
chr8,4002173,4004416,2243,-1,0,64478,1,44.58314757021850000000
chr8,3966364,3969804,3440,-1,0,64478,1,29.06976744186050000000
chr8,3787178,3790187,3009,-1,0,64478,1,33.23363243602530000000
chr8,4135711,4138756,3045,-1,0,64478,1,32.84072249589490000000
chr8,4027273,4029278,2005,-1,0,64478,1,49.87531172069820000000
chr8,4122885,4124967,2082,-1,0,64478,1,48.03073967339100000000
chr8,3788491,3790227,1736,-1,0,64478,1,57.60368663594470000000
chr8,4050899,4052544,1645,-1,0,64478,1,60.79027355623100000000
chr8,3783893,3785136,1243,-1,0,64478,1,80.45052292839900000000
chr8,3994779,3995419,640,-1,0,64478,1,156.25000000000000000000
chr8,3973936,3974952,1016,-1,0,64478,1,98.42519685039370000000
chr8,3912831,3913339,508,-1,0,64478,1,196.85039370078700000000
chr8,3973884,3974329,445,-1,0,64478,1,224.71910112359600000000
chr8,3994861,3995320,459,-1,0,64478,1,217.86492374727700000000
chr8,4218241,4219280,1039,-1,0,64478,1,96.24639076034650000000
chr8,4221975,4222471,496,-1,0,64478,1,201.61290322580600000000
chr8,4222049,4222389,340,-1,0,64478,1,294.11764705882400000000
chr8,4310316,4439981,129665,-1,0,64478,1,0.77121813905063000000
chr8,4318822,4386880,68058,-1,0,64478,1,1.46933497898851000000
chr8,4383196,4415872,32676,-1,0,64478,1,3.06035010405190000000
chr8,4318508,4350648,32140,-1,0,64478,1,3.11138767890479000000
chr8,4284338,4305962,21624,-1,0,64478,1,4.62449130595634000000
chr8,4451901,4463645,11744,-1,0,64478,1,8.51498637602180000000
chr8,4322845,4334535,11690,-1,0,64478,1,8.55431993156544000000
chr8,4343424,4343971,547,-1,0,64478,1,182.81535648994500000000
chr8,4318527,4319052,525,-1,0,64478,1,190.47619047619000000000
chr8,4389486,4389788,302,-1,0,64478,1,331.12582781457000000000
chr8,4343649,4343787,138,-1,0,64478,1,724.63768115942000000000
chr8,4475859,4486137,10278,-1,0,64478,1,9.72951936174353000000
chr8,4520128,4625836,105708,-1,0,64478,1,0.94600219472509200000
chr8,4595856,4693890,98034,-1,0,64478,1,1.02005426688700000000
chr8,4632716,4710684,77968,-1,0,64478,1,1.28257746767905000000
chr8,4592747,4659854,67107,-1,0,64478,1,1.49015750964877000000
chr8,4718002,4759457,41455,-1,0,64478,1,2.41225425159812000000
chr8,4633176,4659409,26233,-1,0,64478,1,3.81199252849464000000
chr8,4827814,4843206,15392,-1,0,64478,1,6.49688149688150000000
chr8,4819971,4833259,13288,-1,0,64478,1,7.52558699578567000000
chr8,4646654,4651179,4525,-1,0,64478,1,22.09944751381220000000
chr8,4510406,4514179,3773,-1,0,64478,1,26.50410813676120000000
chr8,4967915,5043613,75698,-1,0,,0,0.00000000000000000000
chr8,4951606,4964759,13153,-1,0,,0,0.00000000000000000000
chr8,4906310,4915226,8916,-1,0,,0,0.00000000000000000000
chr8,5070727,5076329,5602,-1,0,,0,0.00000000000000000000
chr8,4908073,4911422,3349,-1,0,,0,0.00000000000000000000
chr8,4979964,4981256,1292,-1,0,,0,0.00000000000000000000
chr8,4980314,4980976,662,-1,0,,0,0.00000000000000000000
chr8,4941212,4941536,324,-1,0,,0,0.00000000000000000000
chr8,5241510,5242102,592,-1,0,,0,0.00000000000000000000
chr8,5241276,5241629,353,-1,0,,0,0.00000000000000000000
chr8,5341192,5350789,9597,-1,0,,0,0.00000000000000000000
chr8,5410429,5411407,978,-1,0,,0,0.00000000000000000000
chr8,5468028,5637278,169250,-1,0,,0,0.00000000000000000000
chr8,5653716,5727347,73631,-1,0,,0,0.00000000000000000000
chr8,5485698,5548365,62667,-1,0,,0,0.00000000000000000000
chr8,5562107,5591333,29226,-1,0,,0,0.00000000000000000000
chr8,5595306,5609532,14226,-1,0,,0,0.00000000000000000000
chr8,5595417,5605697,10280,-1,0,,0,0.00000000000000000000
chr8,5597404,5604183,6779,-1,0,,0,0.00000000000000000000
chr8,5601305,5608082,6777,-1,0,,0,0.00000000000000000000
chr8,5600460,5603783,3323,-1,0,,0,0.00000000000000000000
chr8,5439563,5443032,3469,-1,0,,0,0.00000000000000000000
chr8,5642685,5645829,3144,-1,0,,0,0.00000000000000000000
chr8,5496962,5499268,2306,-1,0,,0,0.00000000000000000000
chr8,5728020,5729353,1333,-1,0,,0,0.00000000000000000000
chr8,5913304,6189061,275757,-1,0,,0,0.00000000000000000000
chr8,5789998,6009799,219801,-1,0,,0,0.00000000000000000000
chr8,6084101,6252939,168838,-1,0,,0,0.00000000000000000000
chr8,6086619,6175649,89030,-1,0,,0,0.00000000000000000000
chr8,6166702,6236577,69875,-1,0,,0,0.00000000000000000000
chr8,6208382,6273235,64853,-1,0,79648,1,1.54194871478575000000
chr8,6052134,6111162,59028,-1,0,,0,0.00000000000000000000
chr8,6089764,6139061,49297,-1,0,,0,0.00000000000000000000
chr8,6165988,6210028,44040,-1,0,,0,0.00000000000000000000
chr8,5997250,6022510,25260,-1,0,,0,0.00000000000000000000
chr8,6228203,6259243,31040,-1,0,,0,0.00000000000000000000
chr8,5802957,5824019,21062,-1,0,,0,0.00000000000000000000
chr8,5920681,5943120,22439,-1,0,,0,0.00000000000000000000
chr8,6174435,6195702,21267,-1,0,,0,0.00000000000000000000
chr8,6155276,6176558,21282,-1,0,,0,0.00000000000000000000
chr8,5937648,5960006,22358,-1,0,,0,0.00000000000000000000
chr8,5742207,5758561,16354,-1,0,,0,0.00000000000000000000
chr8,6022657,6036189,13532,-1,0,,0,0.00000000000000000000
chr8,6103634,6114207,10573,-1,0,,0,0.00000000000000000000
chr8,6119929,6128651,8722,-1,0,,0,0.00000000000000000000
chr8,6062566,6069695,7129,-1,0,,0,0.00000000000000000000
chr8,6120461,6125042,4581,-1,0,,0,0.00000000000000000000
chr8,6187501,6190378,2877,-1,0,,0,0.00000000000000000000
chr8,6229934,6230946,1012,-1,0,,0,0.00000000000000000000
chr8,6205343,6207239,1896,-1,0,,0,0.00000000000000000000
chr8,6230009,6230729,720,-1,0,,0,0.00000000000000000000
chr8,5748146,5748543,397,-1,0,,0,0.00000000000000000000
chr8,6828491,6878701,50210,-1,0,728358;1667;1668,3,5.97490539733121000000
chr8,6790900,6818892,27992,-1,0,1669,1,3.57244927122035000000
chr8,6833341,6859393,26052,-1,0,728358;1667,2,7.67695378473822000000
chr8,6839540,6857646,18106,-1,0,728358,1,5.52303103943444000000
chr8,6827353,6838526,11173,-1,0,1667,1,8.95014767743668000000
chr8,6745140,6754866,9726,-1,0,,0,0.00000000000000000000
chr8,6790935,6798140,7205,-1,0,1669,1,13.87925052047190000000
chr8,6708807,6713484,4677,-1,0,,0,0.00000000000000000000
chr8,6826008,6828203,2195,-1,0,,0,0.00000000000000000000
chr8,6789908,6791454,1546,-1,0,,0,0.00000000000000000000
chr8,6647992,6648564,572,-1,0,,0,0.00000000000000000000
chr8,6587731,6588254,523,-1,0,55326,1,191.20458891013400000000
chr8,6790870,6791193,323,-1,0,,0,0.00000000000000000000
chr8,6756528,6756949,421,-1,0,,0,0.00000000000000000000
chr8,6708386,6708735,349,-1,0,,0,0.00000000000000000000
chr8,6718939,6719307,368,-1,0,,0,0.00000000000000000000
chr8,6587827,6588159,332,-1,0,55326,1,301.20481927710800000000
chr8,6790867,6791182,315,-1,0,,0,0.00000000000000000000
chr8,6648156,6648408,252,-1,0,,0,0.00000000000000000000
chr8,6740379,6740491,112,-1,0,,0,0.00000000000000000000
chr8,7079600,7921541,841941,-1,0,401447;503614;504180;503841;140596;100133251;653423;100131980;645402;55894;245910;1673;100131608;245908;100132396;503618;392188;100289462;245909;414325;10407;645836,22,2.61300970020465000000
chr8,7264862,7791089,526227,-1,0,503614;504180;503841;140596;100133251;653423;55894;245910;1673;100131608;245908;100132396;503618;100289462;245909;414325;10407,17,3.23054499294031000000
chr8,8047555,8527621,480066,-1,0,157285,1,0.20830469143826100000
chr8,7085462,7537934,452472,-1,0,401447;100131608;503614;504180;503841;503618;100289462;100131980;645402;55894;10407,11,2.43108965858661000000
chr8,7256801,7622000,365199,-1,0,100131608;503614;504180;503841;503618;100289462;55894;10407,8,2.19058650215362000000
chr8,7626301,7987600,361299,-1,0,645836;140596;245908;100132396;392188;100133251;653423;245909;414325;245910;1673,11,3.04456973310195000000
chr8,7020668,7232900,212232,-1,0,401447;100131980;645402,3,1.41354743865204000000
chr8,7524225,7771248,247023,-1,0,140596;245908;100133251;653423;245909;414325;245910;1673,8,3.23856482999559000000
chr8,7203749,7430143,226394,-1,0,100131608;503614;504180;503841;503618;100289462;100131980;55894;10407,9,3.97537037200633000000
chr8,7817507,7971362,153855,-1,0,645836;392188,2,1.29992525429788000000
chr8,7651064,7844921,193857,-1,0,645836;140596;245908;100132396;392188;653423;245909;414325;245910;1673,10,5.15844153164446000000
chr8,7209732,7342431,132699,-1,0,100131980;55894;10407;503841;503618;100289462,6,4.52151108900595000000
chr8,7279091,7408733,129642,-1,0,10407;100131608;55894;503614;504180;503841;503618,7,5.39948473488530000000
chr8,7952334,8058960,106626,-1,0,,0,0.00000000000000000000
chr8,7645479,7767277,121798,-1,0,245909;414325;1673;140596;245908;245910;653423,7,5.74722080822345000000
chr8,8317584,8450566,132982,-1,0,,0,0.00000000000000000000
chr8,7837262,7952067,114805,-1,0,,0,0.00000000000000000000
chr8,7358923,7445829,86906,-1,0,100131608;503614,2,2.30133707684164000000
chr8,7257130,7344978,87848,-1,0,55894;10407;503841;503618;100289462,5,5.69164921227575000000
chr8,7570162,7647088,76926,-1,0,100133251,1,1.29995060187713000000
chr8,7175663,7256570,80907,-1,0,401447;100131980;645402,3,3.70796099225036000000
chr8,7774703,7854862,80159,-1,0,100132396;392188;645836,3,3.74256165870333000000
chr8,6941132,7028131,86999,-1,0,,0,0.00000000000000000000
chr8,7110642,7170399,59757,-1,0,,0,0.00000000000000000000
chr8,7940904,8003299,62395,-1,0,,0,0.00000000000000000000
chr8,8110060,8168609,58549,-1,0,,0,0.00000000000000000000
chr8,8584580,8648023,63443,-1,0,9258,1,1.57621802247687000000
chr8,8263197,8336792,73595,-1,0,,0,0.00000000000000000000
chr8,7799328,7871031,71703,-1,0,100132396;392188;645836,3,4.18392535877160000000
chr8,7334189,7397443,63254,-1,0,504180;503841;100131608;503614,4,6.32371075347014000000
chr8,7270246,7330367,60121,-1,0,10407;503618;55894;100289462,4,6.65324928061742000000
chr8,9060628,9110487,49859,-1,0,,0,0.00000000000000000000
chr8,7214768,7282456,67688,-1,0,100131980;100289462,2,2.95473348303983000000
chr8,7181524,7228139,46615,-1,0,401447;100131980;645402,3,6.43569666416390000000
chr8,7839524,7891744,52220,-1,0,,0,0.00000000000000000000
chr8,7291157,7340303,49146,-1,0,10407;503841;503618,3,6.10426077402027000000
chr8,7111460,7155895,44435,-1,0,,0,0.00000000000000000000
chr8,7936909,7978366,41457,-1,0,,0,0.00000000000000000000
chr8,7404168,7443400,39232,-1,0,,0,0.00000000000000000000
chr8,7235596,7275116,39520,-1,0,100289462,1,2.53036437246964000000
chr8,8064080,8086965,22885,-1,0,,0,0.00000000000000000000
chr8,8131008,8167915,36907,-1,0,,0,0.00000000000000000000
chr8,7370292,7400177,29885,-1,0,100131608,1,3.34616028107746000000
chr8,7755564,7786258,30694,-1,0,100132396,1,3.25796572620056000000
chr8,7984876,8015687,30811,-1,0,,0,0.00000000000000000000
chr8,8761641,8791521,29880,-1,0,,0,0.00000000000000000000
chr8,7868548,7891481,22933,-1,0,,0,0.00000000000000000000
chr8,7212700,7228042,15342,-1,0,100131980,1,6.51805501238430000000
chr8,6958514,6980276,21762,-1,0,,0,0.00000000000000000000
chr8,9283191,9299178,15987,-1,0,,0,0.00000000000000000000
chr8,9047637,9063018,15381,-1,0,,0,0.00000000000000000000
chr8,7210509,7222844,12335,-1,0,100131980,1,8.10701256586948000000
chr8,7342144,7355372,13228,-1,0,504180;503841;503614,3,22.67916540671300000000
chr8,7854624,7866113,11489,-1,0,,0,0.00000000000000000000
chr8,9055007,9062837,7830,-1,0,,0,0.00000000000000000000
chr8,8283475,8291565,8090,-1,0,,0,0.00000000000000000000
chr8,7355394,7364865,9471,-1,0,503614,1,10.55854714391300000000
chr8,8583007,8589311,6304,-1,0,,0,0.00000000000000000000
chr8,9055939,9061569,5630,-1,0,,0,0.00000000000000000000
chr8,6991343,6995732,4389,-1,0,,0,0.00000000000000000000
chr8,8286261,8290844,4583,-1,0,,0,0.00000000000000000000
chr8,9312623,9317087,4464,-1,0,,0,0.00000000000000000000
chr8,8585080,8588829,3749,-1,0,,0,0.00000000000000000000
chr8,8634287,8637852,3565,-1,0,,0,0.00000000000000000000
chr8,8385997,8386925,928,-1,0,,0,0.00000000000000000000
chr8,8749942,8751417,1475,-1,0,9258,1,67.79661016949150000000
chr8,8836397,8837093,696,-1,0,,0,0.00000000000000000000
chr8,8679963,8680356,393,-1,0,9258,1,254.45292620865100000000
chr8,8245069,8245145,76,-1,0,,0,0.00000000000000000000
chr8,9358749,9359428,679,-1,0,,0,0.00000000000000000000
chr8,9497620,9500878,3258,-1,0,8658,1,30.69367710251690000000
chr8,9498388,9500502,2114,-1,0,8658,1,47.30368968779560000000
chr8,9498043,9499551,1508,-1,0,8658,1,66.31299734748010000000
chr8,9663830,9669859,6029,-1,0,,0,0.00000000000000000000
chr8,9628876,9628967,91,-1,0,8658,1,1098.90109890110000000000
chr8,9688647,9688698,51,-1,0,,0,0.00000000000000000000
chr8,9701553,9739669,38116,-1,0,,0,0.00000000000000000000
chr8,9729669,9731245,1576,-1,0,,0,0.00000000000000000000
chr8,10085587,10087256,1669,-1,0,4482,1,59.91611743559020000000
chr8,10041364,10041662,298,-1,0,4482,1,335.57046979865800000000
chr8,10291531,10292934,1403,-1,0,,0,0.00000000000000000000
chr8,10609528,10658691,49163,-1,0,54984,1,2.03404999694892000000
chr8,10987240,10992698,5458,-1,0,286046,1,18.32172957127150000000
chr8,11236323,11247475,11152,-1,0,,0,0.00000000000000000000
chr8,11245529,11247217,1688,-1,0,,0,0.00000000000000000000
chr8,11245567,11247072,1505,-1,0,,0,0.00000000000000000000
chr8,11228364,11229282,918,-1,0,,0,0.00000000000000000000
chr8,11312680,11314577,1897,-1,0,83648,1,52.71481286241430000000
chr8,11492099,11495079,2980,-1,0,,0,0.00000000000000000000
chr8,11495039,11495303,264,-1,0,,0,0.00000000000000000000
chr8,11699424,11701344,1920,-1,0,1508,1,52.08333333333330000000
chr8,11736666,11738990,2324,-1,0,,0,0.00000000000000000000
chr8,11811923,12537671,725748,-1,0,392197;377630;728957;100133267;245940;613211;85002;653333;613210;613209,10,1.37788874375127000000
chr8,11999943,12316509,316566,-1,0,245940;653333;85002,3,0.94766968025625000000
chr8,12247655,12440134,192479,-1,0,653333,1,0.51953719626556700000
chr8,12249059,12372778,123719,-1,0,653333,1,0.80828328712647200000
chr8,12318065,12449866,131801,-1,0,,0,0.00000000000000000000
chr8,11887230,12041131,153901,-1,0,392197;377630;728957;100133267;85002,5,3.24884178790261000000
chr8,12211061,12296482,85421,-1,0,653333,1,1.17067231711172000000
chr8,11787581,11892376,104795,-1,0,613210;613211;613209,3,2.86273200057255000000
chr8,12180938,12253252,72314,-1,0,,0,0.00000000000000000000
chr8,12235376,12327146,91770,-1,0,653333,1,1.08968072354800000000
chr8,11997944,12043945,46001,-1,0,85002,1,2.17386578552640000000
chr8,11945724,11996312,50588,-1,0,392197;377630;728957,3,5.93026014074484000000
chr8,12200474,12250066,49592,-1,0,,0,0.00000000000000000000
chr8,12235388,12277471,42083,-1,0,,0,0.00000000000000000000
chr8,11862723,11896968,34245,-1,0,,0,0.00000000000000000000
chr8,12203974,12235252,31278,-1,0,,0,0.00000000000000000000
chr8,12469239,12502833,33594,-1,0,,0,0.00000000000000000000
chr8,12000094,12026929,26835,-1,0,,0,0.00000000000000000000
chr8,12216060,12242023,25963,-1,0,,0,0.00000000000000000000
chr8,11767221,11789283,22062,-1,0,,0,0.00000000000000000000
chr8,12015921,12033026,17105,-1,0,,0,0.00000000000000000000
chr8,12542187,12560421,18234,-1,0,,0,0.00000000000000000000
chr8,12260743,12280380,19637,-1,0,,0,0.00000000000000000000
chr8,12253988,12269742,15754,-1,0,,0,0.00000000000000000000
chr8,11996081,12012945,16864,-1,0,377630,1,5.92979127134725000000
chr8,12237293,12251502,14209,-1,0,,0,0.00000000000000000000
chr8,11987757,12001980,14223,-1,0,392197;377630,2,14.06173099908600000000
chr8,12220303,12232315,12012,-1,0,,0,0.00000000000000000000
chr8,12259983,12269773,9790,-1,0,,0,0.00000000000000000000
chr8,11895145,11904789,9644,-1,0,,0,0.00000000000000000000
chr8,12235109,12240931,5822,-1,0,,0,0.00000000000000000000
chr8,12269192,12277316,8124,-1,0,,0,0.00000000000000000000
chr8,12027226,12035008,7782,-1,0,,0,0.00000000000000000000
chr8,12240178,12247150,6972,-1,0,,0,0.00000000000000000000
chr8,11991871,11998611,6740,-1,0,377630,1,14.83679525222550000000
chr8,12388847,12395515,6668,-1,0,,0,0.00000000000000000000
chr8,12233574,12236244,2670,-1,0,,0,0.00000000000000000000
chr8,12240065,12241698,1633,-1,0,,0,0.00000000000000000000
chr8,12240476,12241319,843,-1,0,,0,0.00000000000000000000
chr8,12537900,12538608,708,-1,0,,0,0.00000000000000000000
chr8,12528664,12529060,396,-1,0,,0,0.00000000000000000000
chr8,13622300,13747000,124700,-1,0,,0,0.00000000000000000000
chr8,13902125,14044459,142334,-1,0,137868,1,0.70257282167296600000
chr8,13828144,13962564,134420,-1,0,137868,1,0.74393691414968000000
chr8,13513405,13584271,70866,-1,0,,0,0.00000000000000000000
chr8,13176059,13250360,74301,-1,0,10395,1,1.34587690609817000000
chr8,13649011,13719707,70696,-1,0,,0,0.00000000000000000000
chr8,13613097,13651406,38309,-1,0,,0,0.00000000000000000000
chr8,13035301,13083157,47856,-1,0,10395,1,2.08960213975259000000
chr8,14039310,14065251,25941,-1,0,137868,1,3.85490150726649000000
chr8,13626059,13646536,20477,-1,0,,0,0.00000000000000000000
chr8,13674890,13696685,21795,-1,0,,0,0.00000000000000000000
chr8,13598921,13609931,11010,-1,0,,0,0.00000000000000000000
chr8,13524866,13539217,14351,-1,0,,0,0.00000000000000000000
chr8,13599199,13609188,9989,-1,0,,0,0.00000000000000000000
chr8,13810229,13815237,5008,-1,0,,0,0.00000000000000000000
chr8,13194214,13198230,4016,-1,0,10395,1,24.90039840637450000000
chr8,13331005,13332687,1682,-1,0,10395,1,59.45303210463730000000
chr8,13594045,13595139,1094,-1,0,,0,0.00000000000000000000
chr8,13599319,13600742,1423,-1,0,,0,0.00000000000000000000
chr8,13777967,13778493,526,-1,0,,0,0.00000000000000000000
chr8,13169467,13170013,546,-1,0,10395,1,183.15018315018300000000
chr8,13786328,13787013,685,-1,0,,0,0.00000000000000000000
chr8,13594253,13594858,605,-1,0,,0,0.00000000000000000000
chr8,13778074,13778401,327,-1,0,,0,0.00000000000000000000
chr8,13594462,13594645,183,-1,0,,0,0.00000000000000000000
chr8,13888833,13888926,93,-1,0,,0,0.00000000000000000000
chr8,13310919,13311000,81,-1,0,10395,1,1234.56790123457000000000
chr8,14258565,14275515,16950,-1,0,137868,1,5.89970501474926000000
chr8,14345479,14347082,1603,-1,0,137868,1,62.38303181534620000000
chr8,14452003,14452644,641,-1,0,137868,1,156.00624024961000000000
chr8,14489207,14530792,41585,-1,0,137868,1,2.40471323794638000000
chr8,14506940,14515329,8389,-1,0,137868,1,11.92037191560380000000
chr8,14501601,14506603,5002,-1,0,137868,1,19.99200319872050000000
chr8,14501345,14503872,2527,-1,0,137868,1,39.57261574990110000000
chr8,14587985,14588759,774,-1,0,137868,1,129.19896640826900000000
chr8,15493122,15634510,141388,-1,0,7991,1,0.70727360172008900000
chr8,15326586,15400911,74325,-1,0,7991,1,1.34544231416078000000
chr8,15262552,15300937,38385,-1,0,,0,0.00000000000000000000
chr8,15402906,15430127,27221,-1,0,7991,1,3.67363432643915000000
chr8,15414097,15434286,20189,-1,0,7991,1,4.95319233245827000000
chr8,15401667,15414780,13113,-1,0,7991,1,7.62601998017235000000
chr8,14621191,14634845,13654,-1,0,137868,1,7.32386113959279000000
chr8,15402968,15410573,7605,-1,0,7991,1,13.14924391847470000000
chr8,14787309,14793746,6437,-1,0,137868,1,15.53518719900570000000
chr8,15392148,15396615,4467,-1,0,,0,0.00000000000000000000
chr8,15048085,15051286,3201,-1,0,137868,1,31.24023742580440000000
chr8,15286825,15289172,2347,-1,0,,0,0.00000000000000000000
chr8,15142499,15143900,1401,-1,0,,0,0.00000000000000000000
chr8,15092197,15093210,1013,-1,0,137868,1,98.71668311944720000000
chr8,15309938,15310610,672,-1,0,,0,0.00000000000000000000
chr8,15410745,15411254,509,-1,0,7991,1,196.46365422396900000000
chr8,15387201,15387709,508,-1,0,,0,0.00000000000000000000
chr8,15231343,15231736,393,-1,0,,0,0.00000000000000000000
chr8,15496432,15496764,332,-1,0,7991,1,301.20481927710800000000
chr8,15001253,15001621,368,-1,0,137868,1,271.73913043478300000000
chr8,15053378,15053740,362,-1,0,137868,1,276.24309392265200000000
chr8,15410977,15411074,97,-1,0,7991,1,1030.92783505155000000000
chr8,15219341,15219427,86,-1,0,,0,0.00000000000000000000
chr8,15878929,15997034,118105,-1,0,4481,1,0.84670420388637200000
chr8,16018225,16097705,79480,-1,0,4481,1,1.25817815802718000000
chr8,15945421,16023521,78100,-1,0,4481,1,1.28040973111396000000
chr8,15913796,15941351,27555,-1,0,,0,0.00000000000000000000
chr8,16091440,16107290,15850,-1,0,,0,0.00000000000000000000
chr8,15934931,15945569,10638,-1,0,,0,0.00000000000000000000
chr8,15777307,15787140,9833,-1,0,,0,0.00000000000000000000
chr8,16059342,16069309,9967,-1,0,,0,0.00000000000000000000
chr8,15742713,15745571,2858,-1,0,,0,0.00000000000000000000
chr8,15717699,15718839,1140,-1,0,,0,0.00000000000000000000
chr8,15997257,15997334,77,-1,0,4481,1,1298.70129870130000000000
chr8,16440969,16531377,90408,-1,0,,0,0.00000000000000000000
chr8,16433454,16469448,35994,-1,0,,0,0.00000000000000000000
chr8,16211032,16245171,34139,-1,0,,0,0.00000000000000000000
chr8,16271627,16304792,33165,-1,0,,0,0.00000000000000000000
chr8,16452260,16477052,24792,-1,0,,0,0.00000000000000000000
chr8,16262143,16283208,21065,-1,0,,0,0.00000000000000000000
chr8,16395497,16413235,17738,-1,0,,0,0.00000000000000000000
chr8,16808188,16828187,19999,-1,0,,0,0.00000000000000000000
chr8,16261960,16274682,12722,-1,0,,0,0.00000000000000000000
chr8,16199433,16207781,8348,-1,0,,0,0.00000000000000000000
chr8,16198919,16206443,7524,-1,0,,0,0.00000000000000000000
chr8,16321279,16326620,5341,-1,0,,0,0.00000000000000000000
chr8,16800741,16804197,3456,-1,0,,0,0.00000000000000000000
chr8,16733742,16737044,3302,-1,0,,0,0.00000000000000000000
chr8,16797354,16799893,2539,-1,0,,0,0.00000000000000000000
chr8,16546526,16547112,586,-1,0,,0,0.00000000000000000000
chr8,16821864,16822240,376,-1,0,,0,0.00000000000000000000
chr8,16685740,16686160,420,-1,0,,0,0.00000000000000000000
chr8,16545406,16545732,326,-1,0,,0,0.00000000000000000000
chr8,16546751,16546872,121,-1,0,,0,0.00000000000000000000
chr8,16206954,16207123,169,-1,0,,0,0.00000000000000000000
chr8,16685929,16685981,52,-1,0,,0,0.00000000000000000000
chr8,16962095,16962657,562,-1,0,286097,1,177.93594306049800000000
chr8,16962209,16962537,328,-1,0,286097,1,304.87804878048800000000
chr8,16984987,16985047,60,-1,0,,0,0.00000000000000000000
chr8,16992853,16998092,5239,-1,0,,0,0.00000000000000000000
chr8,17057077,17057163,86,-1,0,51201,1,1162.79069767442000000000
chr8,17265586,17265982,396,-1,0,9108,1,252.52525252525300000000
chr8,17436444,17446653,10209,-1,0,5157,1,9.79527867567832000000
chr8,17580681,17581861,1180,-1,0,57509,1,84.74576271186440000000
chr8,17580639,17581766,1127,-1,0,57509,1,88.73114463176580000000
chr8,17676863,17677029,166,-1,0,,0,0.00000000000000000000
chr8,17677643,17677715,72,-1,0,,0,0.00000000000000000000
chr8,17732840,17733329,489,-1,0,2267,1,204.49897750511200000000
chr8,17733012,17733167,155,-1,0,2267,1,645.16129032258100000000
chr8,17732991,17733099,108,-1,0,2267,1,925.92592592592600000000
chr8,17734199,17764501,30302,-1,0,2267,1,3.30011220381493000000
chr8,17749119,17752757,3638,-1,0,2267,1,27.48763056624520000000
chr8,17750955,17752486,1531,-1,0,2267,1,65.31678641410840000000
chr8,17852205,17853243,1038,-1,0,5108,1,96.33911368015410000000
chr8,17859399,17860428,1029,-1,0,5108,1,97.18172983479110000000
chr8,18340757,18343002,2245,-1,0,,0,0.00000000000000000000
chr8,18454540,18456179,1639,-1,0,23362,1,61.01281269066500000000
chr8,18475687,18476153,466,-1,0,23362,1,214.59227467811200000000
chr8,18651144,18652691,1547,-1,0,23362,1,64.64124111182930000000
chr8,18651449,18652424,975,-1,0,23362,1,102.56410256410300000000
chr8,18850677,18865368,14691,-1,0,23362,1,6.80688857123409000000
chr8,18853456,18859216,5760,-1,0,23362,1,17.36111111111110000000
chr8,18853909,18858485,4576,-1,0,23362,1,21.85314685314690000000
chr8,18855858,18857962,2104,-1,0,23362,1,47.52851711026620000000
chr8,18959724,18959972,248,-1,0,,0,0.00000000000000000000
chr8,19091180,19092332,1152,-1,0,,0,0.00000000000000000000
chr8,19091218,19091834,616,-1,0,,0,0.00000000000000000000
chr8,19091463,19091763,300,-1,0,,0,0.00000000000000000000
chr8,19055257,19055530,273,-1,0,,0,0.00000000000000000000
chr8,19115557,19162874,47317,-1,0,,0,0.00000000000000000000
chr8,19159621,19159764,143,-1,0,,0,0.00000000000000000000
chr8,19254816,19311496,56680,-1,0,55790,1,1.76429075511644000000
chr8,19299036,19301992,2956,-1,0,55790,1,33.82949932341000000000
chr8,19318863,19319568,705,-1,0,55790,1,141.84397163120600000000
chr8,19318912,19319146,234,-1,0,55790,1,427.35042735042700000000
chr8,19337259,19337333,74,-1,0,55790,1,1351.35135135135000000000
chr8,19337338,19337407,69,-1,0,55790,1,1449.27536231884000000000
chr8,19625360,19670937,45577,-1,0,,0,0.00000000000000000000
chr8,19587314,19590946,3632,-1,0,,0,0.00000000000000000000
chr8,19533635,19534258,623,-1,0,55790,1,160.51364365971100000000
chr8,19524348,19524533,185,-1,0,55790,1,540.54054054054100000000
chr8,19786160,19792425,6265,-1,0,,0,0.00000000000000000000
chr8,19885064,19893936,8872,-1,0,,0,0.00000000000000000000
chr8,19980172,19980708,536,-1,0,,0,0.00000000000000000000
chr8,19980262,19980577,315,-1,0,,0,0.00000000000000000000
chr8,19984664,20024629,39965,-1,0,6570,1,2.50218941573877000000
chr8,20025253,20026209,956,-1,0,6570,1,104.60251046025100000000
chr8,20056836,20057912,1076,-1,0,526,1,92.93680297397770000000
chr8,20081819,20083030,1211,-1,0,,0,0.00000000000000000000
chr8,20493055,20493528,473,-1,0,,0,0.00000000000000000000
chr8,20515072,20641553,126481,-1,0,,0,0.00000000000000000000
chr8,20597275,20600833,3558,-1,0,,0,0.00000000000000000000
chr8,20783592,20784740,1148,-1,0,,0,0.00000000000000000000
chr8,20899801,20901745,1944,-1,0,,0,0.00000000000000000000
chr8,20937783,20938270,487,-1,0,,0,0.00000000000000000000
chr8,20943402,20943806,404,-1,0,,0,0.00000000000000000000
chr8,21027792,21042653,14861,-1,0,,0,0.00000000000000000000
chr8,21170136,21171637,1501,-1,0,,0,0.00000000000000000000
chr8,21170734,21171652,918,-1,0,,0,0.00000000000000000000
chr8,21210555,21211010,455,-1,0,,0,0.00000000000000000000
chr8,21329360,21336879,7519,-1,0,,0,0.00000000000000000000
chr8,22188655,22191978,3323,-1,0,55124,1,30.09328919650920000000
chr8,22202934,22205549,2615,-1,0,55124,1,38.24091778202680000000
chr8,22253962,22254091,129,-1,0,23516,1,775.19379844961200000000
chr8,22335669,22336767,1098,-1,0,5533,1,91.07468123861570000000
chr8,22870541,22871274,733,-1,0,23221,1,136.42564802182800000000
chr8,22886399,23057053,170654,-1,0,8794;8795;8797;8793,4,2.34392396310664000000
chr8,22930135,22963839,33704,-1,0,8794,1,2.96700688345597000000
chr8,22981649,22987670,6021,-1,0,,0,0.00000000000000000000
chr8,23005401,23006539,1138,-1,0,8793,1,87.87346221441120000000
chr8,23407103,23407883,780,-1,0,51312,1,128.20512820512800000000
chr8,23447840,23447890,50,-1,0,,0,0.00000000000000000000
chr8,23491294,23491683,389,-1,0,,0,0.00000000000000000000
chr8,23755750,23755968,218,-1,0,,0,0.00000000000000000000
chr8,23755915,23756025,110,-1,0,,0,0.00000000000000000000
chr8,23898463,23898598,135,-1,0,,0,0.00000000000000000000
chr8,24089256,24095490,6234,-1,0,,0,0.00000000000000000000
chr8,24115419,24118567,3148,-1,0,,0,0.00000000000000000000
chr8,24143538,24151265,7727,-1,0,,0,0.00000000000000000000
chr8,24145431,24151064,5633,-1,0,,0,0.00000000000000000000
chr8,24206854,24207584,730,-1,0,10863,1,136.98630136986300000000
chr8,24322177,24322544,367,-1,0,8756,1,272.47956403269800000000
chr8,24442376,24446907,4531,-1,0,,0,0.00000000000000000000
chr8,24593545,24595567,2022,-1,0,,0,0.00000000000000000000
chr8,24705383,24708411,3028,-1,0,,0,0.00000000000000000000
chr8,24971859,24991401,19542,-1,0,,0,0.00000000000000000000
chr8,24974427,24984574,10147,-1,0,,0,0.00000000000000000000
chr8,24979491,24979953,462,-1,0,,0,0.00000000000000000000
chr8,25038854,25041414,2560,-1,0,,0,0.00000000000000000000
chr8,25063255,25071888,8633,-1,0,80005,1,11.58345882080390000000
chr8,25066563,25070709,4146,-1,0,80005,1,24.11963338157260000000
chr8,25068909,25070632,1723,-1,0,80005,1,58.03830528148580000000
chr8,25120499,25124598,4099,-1,0,80005,1,24.39619419370580000000
chr8,25203975,25204415,440,-1,0,80005,1,227.27272727272700000000
chr8,25204075,25204300,225,-1,0,80005,1,444.44444444444400000000
chr8,25327025,25327503,478,-1,0,157313,1,209.20502092050200000000
chr8,25327221,25327278,57,-1,0,157313,1,1754.38596491228000000000
chr8,25410550,25416654,6104,-1,0,,0,0.00000000000000000000
chr8,25411868,25415123,3255,-1,0,,0,0.00000000000000000000
chr8,25511993,25596018,84025,-1,0,,0,0.00000000000000000000
chr8,25550458,25551692,1234,-1,0,,0,0.00000000000000000000
chr8,25630980,25631094,114,-1,0,,0,0.00000000000000000000
chr8,25681877,25683625,1748,-1,0,,0,0.00000000000000000000
chr8,26070685,26071113,428,-1,0,,0,0.00000000000000000000
chr8,26070868,26070919,51,-1,0,,0,0.00000000000000000000
chr8,26079258,26079504,246,-1,0,,0,0.00000000000000000000
chr8,26794266,26803949,9683,-1,0,,0,0.00000000000000000000
chr8,26879417,26880948,1531,-1,0,,0,0.00000000000000000000
chr8,26883023,26883882,859,-1,0,,0,0.00000000000000000000
chr8,26943491,26945194,1703,-1,0,,0,0.00000000000000000000
chr8,27005031,27005270,239,-1,0,,0,0.00000000000000000000
chr8,27263934,27266413,2479,-1,0,2185,1,40.33884630899560000000
chr8,27683763,27684557,794,-1,0,55872,1,125.94458438287200000000
chr8,27662499,27662830,331,-1,0,,0,0.00000000000000000000
chr8,27684044,27684331,287,-1,0,55872,1,348.43205574912900000000
chr8,27776143,27776203,60,-1,0,286133,1,1666.66666666667000000000
chr8,27776174,27776228,54,-1,0,286133,1,1851.85185185185000000000
chr8,27871345,27873760,2415,-1,0,,0,0.00000000000000000000
chr8,28310721,28312502,1781,-1,0,157574,1,56.14823133071310000000
chr8,28343983,28345043,1060,-1,0,157574,1,94.33962264150940000000
chr8,28455034,28466644,11610,-1,0,,0,0.00000000000000000000
chr8,28463583,28464265,682,-1,0,,0,0.00000000000000000000
chr8,28736763,28737662,899,-1,0,55756,1,111.23470522803100000000
chr8,28753898,28754231,333,-1,0,79618,1,300.30030030030000000000
chr8,28785246,28789680,4434,-1,0,79618,1,22.55299954894000000000
chr8,28768853,28771607,2754,-1,0,79618,1,36.31082062454610000000
chr8,28843143,28845269,2126,-1,0,79618,1,47.03668861712140000000
chr8,28895254,28896254,1000,-1,0,79618,1,100.00000000000000000000
chr8,28923611,28924211,600,-1,0,,0,0.00000000000000000000
chr8,29179811,29180393,582,-1,0,,0,0.00000000000000000000
chr8,29328348,29334732,6384,-1,0,,0,0.00000000000000000000
chr8,29462471,29462545,74,-1,0,,0,0.00000000000000000000
chr8,29471177,29472646,1469,-1,0,,0,0.00000000000000000000
chr8,29818283,29818407,124,-1,0,,0,0.00000000000000000000
chr8,29832380,29843721,11341,-1,0,,0,0.00000000000000000000
chr8,29837501,29838269,768,-1,0,,0,0.00000000000000000000
chr8,29924433,29927288,2855,-1,0,51669,1,35.02626970227670000000
chr8,30072474,30072792,318,-1,0,,0,0.00000000000000000000
chr8,30072447,30072624,177,-1,0,,0,0.00000000000000000000
chr8,30167253,30193868,26615,-1,0,,0,0.00000000000000000000
chr8,30392191,30392689,498,-1,0,11030,1,200.80321285140600000000
chr8,30392284,30392588,304,-1,0,11030,1,328.94736842105300000000
chr8,30475920,30482810,6890,-1,0,2961,1,14.51378809869380000000
chr8,30535237,30536395,1158,-1,0,2936,1,86.35578583765110000000
chr8,30596274,30596886,612,-1,0,,0,0.00000000000000000000
chr8,30603909,30605528,1619,-1,0,7993,1,61.76652254478070000000
chr8,30604354,30605550,1196,-1,0,7993,1,83.61204013377930000000
chr8,30711696,30714476,2780,-1,0,,0,0.00000000000000000000
chr8,30766590,30768313,1723,-1,0,,0,0.00000000000000000000
chr8,30808505,30808785,280,-1,0,,0,0.00000000000000000000
chr8,30841645,30842179,534,-1,0,,0,0.00000000000000000000
chr8,30841852,30841929,77,-1,0,,0,0.00000000000000000000
chr8,31102354,31103726,1372,-1,0,,0,0.00000000000000000000
chr8,31298835,31298885,50,-1,0,,0,0.00000000000000000000
chr8,31571146,31571684,538,-1,0,3084,1,185.87360594795500000000
chr8,31571248,31571601,353,-1,0,3084,1,283.28611898017000000000
chr8,31648348,31650828,2480,-1,0,3084,1,40.32258064516130000000
chr8,32152232,32155001,2769,-1,0,3084,1,36.11412062116290000000
chr8,32664027,32664085,58,-1,0,,0,0.00000000000000000000
chr8,32679954,32691265,11311,-1,0,,0,0.00000000000000000000
chr8,32680340,32686275,5935,-1,0,,0,0.00000000000000000000
chr8,32683126,32687790,4664,-1,0,,0,0.00000000000000000000
chr8,32966988,32976291,9303,-1,0,,0,0.00000000000000000000
chr8,33000925,33001535,610,-1,0,,0,0.00000000000000000000
chr8,33027971,33028910,939,-1,0,,0,0.00000000000000000000
chr8,33158744,33160398,1654,-1,0,,0,0.00000000000000000000
chr8,33418119,33420166,2047,-1,0,79845,1,48.85197850512950000000
chr8,33434232,33435906,1674,-1,0,,0,0.00000000000000000000
chr8,33501598,33530648,29050,-1,0,,0,0.00000000000000000000
chr8,33656781,33658322,1541,-1,0,,0,0.00000000000000000000
chr8,34022523,34022805,282,-1,0,,0,0.00000000000000000000
chr8,34166428,34166497,69,-1,0,,0,0.00000000000000000000
chr8,34360006,34360383,377,-1,0,,0,0.00000000000000000000
chr8,34422104,34426932,4828,-1,0,,0,0.00000000000000000000
chr8,34426035,34426423,388,-1,0,,0,0.00000000000000000000
chr8,34426177,34426265,88,-1,0,,0,0.00000000000000000000
chr8,34472526,34473147,621,-1,0,,0,0.00000000000000000000
chr8,34629994,34630384,390,-1,0,,0,0.00000000000000000000
chr8,34682954,34683343,389,-1,0,,0,0.00000000000000000000
chr8,34835274,34854718,19444,-1,0,,0,0.00000000000000000000
chr8,34947266,34947628,362,-1,0,,0,0.00000000000000000000
chr8,35055998,35059337,3339,-1,0,,0,0.00000000000000000000
chr8,35308875,35310078,1203,-1,0,137970,1,83.12551953449710000000
chr8,35432477,35433678,1201,-1,0,137970,1,83.26394671107410000000
chr8,35568236,35568687,451,-1,0,137970,1,221.72949002217300000000
chr8,35568428,35568626,198,-1,0,137970,1,505.05050505050500000000
chr8,36070124,36077365,7241,-1,0,,0,0.00000000000000000000
chr8,36075144,36079641,4497,-1,0,,0,0.00000000000000000000
chr8,36255136,36362117,106981,-1,0,,0,0.00000000000000000000
chr8,36273634,36279773,6139,-1,0,,0,0.00000000000000000000
chr8,36369985,36371862,1877,-1,0,,0,0.00000000000000000000
chr8,36517486,36519309,1823,-1,0,,0,0.00000000000000000000
chr8,37050676,37052309,1633,-1,0,,0,0.00000000000000000000
chr8,37050878,37051853,975,-1,0,,0,0.00000000000000000000
chr8,37389886,37395604,5718,-1,0,,0,0.00000000000000000000
chr8,37551731,37555224,3493,-1,0,80139,1,28.62868594331520000000
chr8,37821624,37824930,3306,-1,0,155,1,30.24803387779790000000
chr8,37867910,37872483,4573,-1,0,,0,0.00000000000000000000
chr8,37935092,37938286,3194,-1,0,,0,0.00000000000000000000
chr8,38211047,38213270,2223,-1,0,54904,1,44.98425551057130000000
chr8,38221734,38236107,14373,-1,0,54904,1,6.95748973770264000000
chr8,38238346,38239022,676,-1,0,54904,1,147.92899408284000000000
chr8,38406032,38407772,1740,-1,0,,0,0.00000000000000000000
chr8,38383398,38383475,77,-1,0,389649,1,1298.70129870130000000000
chr8,38452287,38452468,181,-1,0,,0,0.00000000000000000000
chr8,38737278,38737354,76,-1,0,,0,0.00000000000000000000
chr8,38953620,38953881,261,-1,0,8754,1,383.14176245210700000000
chr8,39008245,39008689,444,-1,0,203102,1,225.22522522522500000000
chr8,39008455,39008553,98,-1,0,203102,1,1020.40816326531000000000
chr8,39141074,39157509,16435,-1,0,203102,1,6.08457560085184000000
chr8,39163836,39168774,4938,-1,0,,0,0.00000000000000000000
chr8,39206925,39388642,181717,-1,0,,0,0.00000000000000000000
chr8,39236810,39333483,96673,-1,0,,0,0.00000000000000000000
chr8,39298593,39386164,87571,-1,0,,0,0.00000000000000000000
chr8,39231989,39287865,55876,-1,0,,0,0.00000000000000000000
chr8,39345516,39386558,41042,-1,0,,0,0.00000000000000000000
chr8,39318185,39353415,35230,-1,0,,0,0.00000000000000000000
chr8,39225807,39260868,35061,-1,0,,0,0.00000000000000000000
chr8,39283895,39299000,15105,-1,0,,0,0.00000000000000000000
chr8,39232385,39243002,10617,-1,0,,0,0.00000000000000000000
chr8,39303973,39308305,4332,-1,0,,0,0.00000000000000000000
chr8,39413508,39414134,626,-1,0,,0,0.00000000000000000000
chr8,39604591,39612178,7587,-1,0,2515,1,13.18044022670360000000
chr8,39632576,39643366,10790,-1,0,2515,1,9.26784059314180000000
chr8,39684810,39694956,10146,-1,0,2515,1,9.85610092647349000000
chr8,39737279,39737510,231,-1,0,,0,0.00000000000000000000
chr8,39765229,39765752,523,-1,0,,0,0.00000000000000000000
chr8,39765320,39765658,338,-1,0,,0,0.00000000000000000000
chr8,39832633,39833337,704,-1,0,169355,1,142.04545454545500000000
chr8,39885683,39890755,5072,-1,0,,0,0.00000000000000000000
chr8,39976058,39976154,96,-1,0,,0,0.00000000000000000000
chr8,40182394,40195746,13352,-1,0,,0,0.00000000000000000000
chr8,40183149,40191940,8791,-1,0,,0,0.00000000000000000000
chr8,40184299,40189747,5448,-1,0,,0,0.00000000000000000000
chr8,40250557,40255198,4641,-1,0,,0,0.00000000000000000000
chr8,40289686,40296198,6512,-1,0,,0,0.00000000000000000000
chr8,40458932,40459398,466,-1,0,79698,1,214.59227467811200000000
chr8,40469713,40470385,672,-1,0,79698,1,148.80952380952400000000
chr8,40771818,40787666,15848,-1,0,,0,0.00000000000000000000
chr8,40774569,40779793,5224,-1,0,,0,0.00000000000000000000
chr8,40807936,40812563,4627,-1,0,,0,0.00000000000000000000
chr8,40919597,40923719,4122,-1,0,,0,0.00000000000000000000
chr8,40946385,40946836,451,-1,0,,0,0.00000000000000000000
chr8,41278830,41280211,1381,-1,0,,0,0.00000000000000000000
chr8,41279248,41279745,497,-1,0,,0,0.00000000000000000000
chr8,41279327,41279652,325,-1,0,,0,0.00000000000000000000
chr8,41328688,41330684,1996,-1,0,,0,0.00000000000000000000
chr8,41415821,41416073,252,-1,0,,0,0.00000000000000000000
chr8,41540737,41542075,1338,-1,0,286,1,74.73841554559040000000
chr8,41865344,41869209,3865,-1,0,7994,1,25.87322121604140000000
chr8,41930247,41930563,316,-1,0,,0,0.00000000000000000000
chr8,42185310,42185711,401,-1,0,3551,1,249.37655860349100000000
chr8,42190348,42194421,4073,-1,0,,0,0.00000000000000000000
chr8,42210873,42212803,1930,-1,0,5423,1,51.81347150259070000000
chr8,42298939,42299583,644,-1,0,6575,1,155.27950310559000000000
chr8,42476528,42480070,3542,-1,0,,0,0.00000000000000000000
chr8,42573330,42589956,16626,-1,0,1142,1,6.01467580897390000000
chr8,42569426,42573622,4196,-1,0,1142,1,23.83222116301240000000
chr8,42585908,42586255,347,-1,0,1142,1,288.18443804034600000000
chr8,42920592,42921610,1018,-1,0,2339,1,98.23182711198430000000
chr8,43092822,43097461,4639,-1,0,,0,0.00000000000000000000
chr8,43095527,43096967,1440,-1,0,,0,0.00000000000000000000
chr8,43093303,43093703,400,-1,0,,0,0.00000000000000000000
chr8,43095546,43095753,207,-1,0,,0,0.00000000000000000000
chr8,43096201,43096351,150,-1,0,,0,0.00000000000000000000
chr8,43100205,43100716,511,-1,0,,0,0.00000000000000000000
chr8,43100402,43100489,87,-1,0,,0,0.00000000000000000000
chr8,43215531,43215713,182,-1,0,340441,1,549.45054945054900000000
chr8,43416437,43418556,2119,-1,0,,0,0.00000000000000000000
chr8,46860042,47731446,871404,-1,0,,0,0.00000000000000000000
chr8,43430719,43743205,312486,-1,0,,0,0.00000000000000000000
chr8,43433370,43635095,201725,-1,0,,0,0.00000000000000000000
chr8,47035432,47181798,146366,-1,0,,0,0.00000000000000000000
chr8,43424993,43508827,83834,-1,0,,0,0.00000000000000000000
chr8,43617824,43719374,101550,-1,0,,0,0.00000000000000000000
chr8,47002391,47085243,82852,-1,0,,0,0.00000000000000000000
chr8,47381312,47452924,71612,-1,0,,0,0.00000000000000000000
chr8,47736512,47803287,66775,-1,0,,0,0.00000000000000000000
chr8,47298308,47360884,62576,-1,0,,0,0.00000000000000000000
chr8,46844829,46899375,54546,-1,0,,0,0.00000000000000000000
chr8,47363595,47412022,48427,-1,0,,0,0.00000000000000000000
chr8,43559273,43620185,60912,-1,0,,0,0.00000000000000000000
chr8,43648115,43705483,57368,-1,0,,0,0.00000000000000000000
chr8,47725589,47775860,50271,-1,0,,0,0.00000000000000000000
chr8,43625199,43673360,48161,-1,0,,0,0.00000000000000000000
chr8,47402874,47442460,39586,-1,0,,0,0.00000000000000000000
chr8,46838946,46856597,17651,-1,0,,0,0.00000000000000000000
chr8,47400710,47418657,17947,-1,0,,0,0.00000000000000000000
chr8,47391490,47405908,14418,-1,0,,0,0.00000000000000000000
chr8,46889665,46899405,9740,-1,0,,0,0.00000000000000000000
chr8,47062944,47069054,6110,-1,0,,0,0.00000000000000000000
chr8,47372511,47377769,5258,-1,0,,0,0.00000000000000000000
chr8,43662085,43666941,4856,-1,0,,0,0.00000000000000000000
chr8,43631432,43635847,4415,-1,0,,0,0.00000000000000000000
chr8,47199498,47202855,3357,-1,0,,0,0.00000000000000000000
chr8,47405745,47408046,2301,-1,0,,0,0.00000000000000000000
chr8,47766892,47769782,2890,-1,0,,0,0.00000000000000000000
chr8,47111926,47114717,2791,-1,0,,0,0.00000000000000000000
chr8,47334316,47335971,1655,-1,0,,0,0.00000000000000000000
chr8,43766859,43768436,1577,-1,0,,0,0.00000000000000000000
chr8,47406560,47407770,1210,-1,0,,0,0.00000000000000000000
chr8,46991495,46992547,1052,-1,0,,0,0.00000000000000000000
chr8,47381177,47381773,596,-1,0,,0,0.00000000000000000000
chr8,47033514,47033945,431,-1,0,,0,0.00000000000000000000
chr8,47381304,47381651,347,-1,0,,0,0.00000000000000000000
chr8,43454361,43454521,160,-1,0,,0,0.00000000000000000000
chr8,43454401,43454499,98,-1,0,,0,0.00000000000000000000
chr8,47812132,47812576,444,-1,0,,0,0.00000000000000000000
chr8,47854423,47859024,4601,-1,0,,0,0.00000000000000000000
chr8,47880088,47880534,446,-1,0,,0,0.00000000000000000000
chr8,47880208,47880384,176,-1,0,,0,0.00000000000000000000
chr8,48066059,48072483,6424,-1,0,,0,0.00000000000000000000
chr8,48290724,48291782,1058,-1,0,23514,1,94.51795841209830000000
chr8,48458690,48460226,1536,-1,0,23514,1,65.10416666666670000000
chr8,48513986,48518845,4859,-1,0,23514,1,20.58036633052070000000
chr8,48646059,48647243,1184,-1,0,23514,1,84.45945945945950000000
chr8,48818952,48819925,973,-1,0,5591,1,102.77492291880800000000
chr8,48901660,48910790,9130,-1,0,,0,0.00000000000000000000
chr8,49027415,49028390,975,-1,0,,0,0.00000000000000000000
chr8,49093381,49093978,597,-1,0,,0,0.00000000000000000000
chr8,49391269,49393846,2577,-1,0,,0,0.00000000000000000000
chr8,49655120,49667288,12168,-1,0,,0,0.00000000000000000000
chr8,49769692,49769789,97,-1,0,,0,0.00000000000000000000
chr8,50008779,50009379,600,-1,0,,0,0.00000000000000000000
chr8,50009151,50009433,282,-1,0,,0,0.00000000000000000000
chr8,50009189,50009334,145,-1,0,,0,0.00000000000000000000
chr8,51662445,51869993,207548,-1,0,54212,1,0.48181625455316400000
chr8,50870676,50970069,99393,-1,0,54212,1,1.00610706991438000000
chr8,52040584,52076300,35716,-1,0,,0,0.00000000000000000000
chr8,51098333,51111787,13454,-1,0,54212,1,7.43273375947673000000
chr8,51031081,51038336,7255,-1,0,54212,1,13.78359751895240000000
chr8,50528985,50534586,5601,-1,0,,0,0.00000000000000000000
chr8,51033145,51038492,5347,-1,0,54212,1,18.70207593042830000000
chr8,50634946,50639794,4848,-1,0,,0,0.00000000000000000000
chr8,51224131,51228529,4398,-1,0,54212,1,22.73760800363800000000
chr8,51402373,51405360,2987,-1,0,54212,1,33.47840642785400000000
chr8,51992875,51995707,2832,-1,0,,0,0.00000000000000000000
chr8,50213894,50216573,2679,-1,0,,0,0.00000000000000000000
chr8,51031221,51033517,2296,-1,0,54212,1,43.55400696864110000000
chr8,50220146,50221310,1164,-1,0,,0,0.00000000000000000000
chr8,52023553,52024240,687,-1,0,,0,0.00000000000000000000
chr8,52060899,52061411,512,-1,0,,0,0.00000000000000000000
chr8,51557610,51557926,316,-1,0,54212,1,316.45569620253200000000
chr8,51374711,51375031,320,-1,0,54212,1,312.50000000000000000000
chr8,52061017,52061338,321,-1,0,,0,0.00000000000000000000
chr8,52023760,52024037,277,-1,0,,0,0.00000000000000000000
chr8,50189291,50189556,265,-1,0,,0,0.00000000000000000000
chr8,50639528,50639573,45,-1,0,,0,0.00000000000000000000
chr8,52446020,52448303,2283,-1,0,137902,1,43.80201489268510000000
chr8,52520173,52521183,1010,-1,0,137902,1,99.00990099009900000000
chr8,52737947,52738309,362,-1,0,115294,1,276.24309392265200000000
chr8,52877858,52917629,39771,-1,0,,0,0.00000000000000000000
chr8,53016531,53018639,2108,-1,0,,0,0.00000000000000000000
chr8,53365047,53367160,2113,-1,0,,0,0.00000000000000000000
chr8,53700545,53702025,1480,-1,0,,0,0.00000000000000000000
chr8,53700906,53701680,774,-1,0,,0,0.00000000000000000000
chr8,53739399,53740931,1532,-1,0,,0,0.00000000000000000000
chr8,53895702,53897188,1486,-1,0,,0,0.00000000000000000000
chr8,53954822,53990139,35317,-1,0,,0,0.00000000000000000000
chr8,53959780,53993481,33701,-1,0,,0,0.00000000000000000000
chr8,54122551,54123649,1098,-1,0,,0,0.00000000000000000000
chr8,54204766,54205319,553,-1,0,,0,0.00000000000000000000
chr8,54204885,54205201,316,-1,0,,0,0.00000000000000000000
chr8,54528430,54591163,62733,-1,0,,0,0.00000000000000000000
chr8,54756790,54757874,1084,-1,0,,0,0.00000000000000000000
chr8,54971746,54972284,538,-1,0,10434,1,185.87360594795500000000
chr8,54971848,54972163,315,-1,0,10434,1,317.46031746031700000000
chr8,55208842,55213148,4306,-1,0,,0,0.00000000000000000000
chr8,55208971,55211129,2158,-1,0,,0,0.00000000000000000000
chr8,55407144,55407218,74,-1,0,,0,0.00000000000000000000
chr8,55986031,56005874,19843,-1,0,,0,0.00000000000000000000
chr8,56377713,56393427,15714,-1,0,114786,1,6.36375206821942000000
chr8,56390257,56392285,2028,-1,0,114786,1,49.30966469428010000000
chr8,56168559,56169579,1020,-1,0,114786,1,98.03921568627450000000
chr8,56401104,56401627,523,-1,0,114786,1,191.20458891013400000000
chr8,56107696,56108054,358,-1,0,114786,1,279.32960893854700000000
chr8,56401221,56401545,324,-1,0,114786,1,308.64197530864200000000
chr8,56658267,56659030,763,-1,0,137695,1,131.06159895150700000000
chr8,56658597,56658734,137,-1,0,137695,1,729.92700729927000000000
chr8,56676248,56676637,389,-1,0,137695,1,257.06940874036000000000
chr8,56676277,56676407,130,-1,0,137695,1,769.23076923076900000000
chr8,56679460,56679891,431,-1,0,137695,1,232.01856148491900000000
chr8,56738471,56739957,1486,-1,0,96764,1,67.29475100942130000000
chr8,56967093,56967691,598,-1,0,,0,0.00000000000000000000
chr8,56967300,56967498,198,-1,0,,0,0.00000000000000000000
chr8,56988761,56997926,9165,-1,0,,0,0.00000000000000000000
chr8,56991382,56995675,4293,-1,0,,0,0.00000000000000000000
chr8,56988698,56989817,1119,-1,0,,0,0.00000000000000000000
chr8,57195095,57195154,59,-1,0,,0,0.00000000000000000000
chr8,57300200,57300318,118,-1,0,,0,0.00000000000000000000
chr8,57300202,57300317,115,-1,0,,0,0.00000000000000000000
chr8,57386020,57386426,406,-1,0,,0,0.00000000000000000000
chr8,57490280,57492041,1761,-1,0,,0,0.00000000000000000000
chr8,57595030,57595917,887,-1,0,,0,0.00000000000000000000
chr8,57917215,57934694,17479,-1,0,,0,0.00000000000000000000
chr8,57963863,57969333,5470,-1,0,,0,0.00000000000000000000
chr8,57779769,57780015,246,-1,0,,0,0.00000000000000000000
chr8,57779820,57779928,108,-1,0,,0,0.00000000000000000000
chr8,58071881,58077338,5457,-1,0,,0,0.00000000000000000000
chr8,58110179,58113304,3125,-1,0,,0,0.00000000000000000000
chr8,58116664,58128760,12096,-1,0,,0,0.00000000000000000000
chr8,58118580,58123229,4649,-1,0,,0,0.00000000000000000000
chr8,58122591,58127055,4464,-1,0,,0,0.00000000000000000000
chr8,58116908,58118209,1301,-1,0,,0,0.00000000000000000000
chr8,58118270,58119623,1353,-1,0,,0,0.00000000000000000000
chr8,58115057,58115714,657,-1,0,,0,0.00000000000000000000
chr8,58199351,58200192,841,-1,0,,0,0.00000000000000000000
chr8,58357073,58368522,11449,-1,0,,0,0.00000000000000000000
chr8,58412464,58413864,1400,-1,0,,0,0.00000000000000000000
chr8,58839755,58845704,5949,-1,0,,0,0.00000000000000000000
chr8,59075725,59076187,462,-1,0,,0,0.00000000000000000000
chr8,59075863,59075967,104,-1,0,,0,0.00000000000000000000
chr8,59078137,59079233,1096,-1,0,,0,0.00000000000000000000
chr8,59078400,59078895,495,-1,0,,0,0.00000000000000000000
chr8,59078474,59078773,299,-1,0,,0,0.00000000000000000000
chr8,59421828,59424473,2645,-1,0,,0,0.00000000000000000000
chr8,59433531,59434033,502,-1,0,,0,0.00000000000000000000
chr8,59651291,59652426,1135,-1,0,,0,0.00000000000000000000
chr8,60085595,60087752,2157,-1,0,,0,0.00000000000000000000
chr8,60326236,60329541,3305,-1,0,,0,0.00000000000000000000
chr8,60401493,60401987,494,-1,0,,0,0.00000000000000000000
chr8,60449654,60455296,5642,-1,0,,0,0.00000000000000000000
chr8,60452102,60454554,2452,-1,0,,0,0.00000000000000000000
chr8,60641362,60641491,129,-1,0,,0,0.00000000000000000000
chr8,60642175,60685792,43617,-1,0,,0,0.00000000000000000000
chr8,60644893,60652530,7637,-1,0,,0,0.00000000000000000000
chr8,60991274,61007957,16683,-1,0,,0,0.00000000000000000000
chr8,60998677,61009251,10574,-1,0,,0,0.00000000000000000000
chr8,61027287,61027370,83,-1,0,,0,0.00000000000000000000
chr8,61204985,61205303,318,-1,0,,0,0.00000000000000000000
chr8,61857919,61870483,12564,-1,0,,0,0.00000000000000000000
chr8,61856102,61867276,11174,-1,0,,0,0.00000000000000000000
chr8,61945825,61946165,340,-1,0,,0,0.00000000000000000000
chr8,61945872,61946021,149,-1,0,,0,0.00000000000000000000
chr8,61964929,61965288,359,-1,0,,0,0.00000000000000000000
chr8,62035359,62035892,533,-1,0,,0,0.00000000000000000000
chr8,62107418,62112693,5275,-1,0,,0,0.00000000000000000000
chr8,62512868,62515431,2563,-1,0,444,1,39.01677721420210000000
chr8,62517980,62873803,355823,-1,0,444,1,0.28103860627334400000
chr8,62930022,62930572,550,-1,0,,0,0.00000000000000000000
chr8,62930143,62930455,312,-1,0,,0,0.00000000000000000000
chr8,63034966,63040423,5457,-1,0,,0,0.00000000000000000000
chr8,63215269,63225490,10221,-1,0,286183,1,9.78377849525487000000
chr8,63217551,63224085,6534,-1,0,286183,1,15.30456075910620000000
chr8,63307273,63307613,340,-1,0,286183,1,294.11764705882400000000
chr8,63494375,63494534,159,-1,0,286183,1,628.93081761006300000000
chr8,63846739,63851167,4428,-1,0,286183,1,22.58355916892500000000
chr8,63904459,63905392,933,-1,0,,0,0.00000000000000000000
chr8,63961075,63965947,4872,-1,0,,0,0.00000000000000000000
chr8,64017410,64018329,919,-1,0,,0,0.00000000000000000000
chr8,64115266,64117075,1809,-1,0,253943,1,55.27915975677170000000
chr8,64144863,64145115,252,-1,0,,0,0.00000000000000000000
chr8,64154394,64156029,1635,-1,0,,0,0.00000000000000000000
chr8,64697507,64699313,1806,-1,0,,0,0.00000000000000000000
chr8,64769572,64770049,477,-1,0,,0,0.00000000000000000000
chr8,64835740,64850087,14347,-1,0,,0,0.00000000000000000000
chr8,65063358,65063608,250,-1,0,,0,0.00000000000000000000
chr8,65112818,65120052,7234,-1,0,,0,0.00000000000000000000
chr8,65225611,65227734,2123,-1,0,,0,0.00000000000000000000
chr8,65242388,65257867,15479,-1,0,,0,0.00000000000000000000
chr8,65244670,65256061,11391,-1,0,,0,0.00000000000000000000
chr8,65334637,65335200,563,-1,0,,0,0.00000000000000000000
chr8,66091877,66094745,2868,-1,0,,0,0.00000000000000000000
chr8,66311348,66311469,121,-1,0,,0,0.00000000000000000000
chr8,66759469,66760362,893,-1,0,,0,0.00000000000000000000
chr8,66775709,66776790,1081,-1,0,,0,0.00000000000000000000
chr8,66990191,67011544,21353,-1,0,85479,1,4.68318269095677000000
chr8,67120746,67121716,970,-1,0,,0,0.00000000000000000000
chr8,67126876,67129604,2728,-1,0,,0,0.00000000000000000000
chr8,67661525,67663025,1500,-1,0,23678;100533105,2,133.33333333333300000000
chr8,68084848,68085934,1086,-1,0,79848,1,92.08103130755060000000
chr8,68156509,68161985,5476,-1,0,10565,1,18.26150474799120000000
chr8,68547503,68565069,17566,-1,0,57094,1,5.69281566662871000000
chr8,68546041,68554020,7979,-1,0,57094,1,12.53289885950620000000
chr8,68545395,68550884,5489,-1,0,57094,1,18.21825469120060000000
chr8,68547463,68550339,2876,-1,0,57094,1,34.77051460361610000000
chr8,68727276,68727724,448,-1,0,,0,0.00000000000000000000
chr8,68727325,68727657,332,-1,0,,0,0.00000000000000000000
chr8,69097178,69098920,1742,-1,0,80243,1,57.40528128587830000000
chr8,69097916,69098338,422,-1,0,80243,1,236.96682464455000000000
chr8,69417556,69418117,561,-1,0,116328,1,178.25311942959000000000
chr8,69417666,69417988,322,-1,0,116328,1,310.55900621118000000000
chr8,69818343,69819212,869,-1,0,,0,0.00000000000000000000
chr8,70200592,70208379,7787,-1,0,,0,0.00000000000000000000
chr8,70319795,70325421,5626,-1,0,,0,0.00000000000000000000
chr8,70357607,70357924,317,-1,0,,0,0.00000000000000000000
chr8,70538294,70538603,309,-1,0,23213,1,323.62459546925600000000
chr8,70785134,70787245,2111,-1,0,,0,0.00000000000000000000
chr8,70897537,70898092,555,-1,0,,0,0.00000000000000000000
chr8,71451621,71452494,873,-1,0,,0,0.00000000000000000000
chr8,71583289,71584897,1608,-1,0,389668,1,62.18905472636820000000
chr8,71583555,71584642,1087,-1,0,389668,1,91.99632014719410000000
chr8,71611079,71632155,21076,-1,0,389668,1,4.74473334598596000000
chr8,71623819,71624206,387,-1,0,389668,1,258.39793281653700000000
chr8,71656991,71657460,469,-1,0,,0,0.00000000000000000000
chr8,72210736,72216496,5760,-1,0,2138,1,17.36111111111110000000
chr8,72214719,72217794,3075,-1,0,2138,1,32.52032520325200000000
chr8,72215555,72217649,2094,-1,0,2138,1,47.75549188156640000000
chr8,72214790,72216694,1904,-1,0,2138,1,52.52100840336130000000
chr8,72551304,72551867,563,-1,0,,0,0.00000000000000000000
chr8,72551418,72551752,334,-1,0,,0,0.00000000000000000000
chr8,72681565,72682087,522,-1,0,,0,0.00000000000000000000
chr8,73237732,73323096,85364,-1,0,,0,0.00000000000000000000
chr8,73787595,73793927,6332,-1,0,9312,1,15.79279848389130000000
chr8,73325636,73330784,5148,-1,0,,0,0.00000000000000000000
chr8,74345508,74348579,3071,-1,0,27067,1,32.56268316509280000000
chr8,74060597,74063039,2442,-1,0,,0,0.00000000000000000000
chr8,73710294,73712921,2627,-1,0,9312,1,38.06623524933380000000
chr8,72747906,72749463,1557,-1,0,,0,0.00000000000000000000
chr8,74087417,74087896,479,-1,0,,0,0.00000000000000000000
chr8,74419345,74419688,343,-1,0,27067,1,291.54518950437300000000
chr8,74534339,74534576,237,-1,0,27067,1,421.94092827004200000000
chr8,74586794,74595672,8878,-1,0,27067,1,11.26379815273710000000
chr8,74593791,74598315,4524,-1,0,27067,1,22.10433244916000000000
chr8,74607411,74607976,565,-1,0,27067,1,176.99115044247800000000
chr8,74607596,74607691,95,-1,0,27067,1,1052.63157894737000000000
chr8,74632684,74633104,420,-1,0,27067,1,238.09523809523800000000
chr8,74787761,74787858,97,-1,0,55284,1,1030.92783505155000000000
chr8,74811935,74812043,108,-1,0,,0,0.00000000000000000000
chr8,74833785,74837500,3715,-1,0,,0,0.00000000000000000000
chr8,74888284,74888339,55,-1,0,,0,0.00000000000000000000
chr8,74898797,74904162,5365,-1,0,23643,1,18.63932898415660000000
chr8,75099559,75127716,28157,-1,0,,0,0.00000000000000000000
chr8,75311127,75330295,19168,-1,0,,0,0.00000000000000000000
chr8,75315421,75324989,9568,-1,0,,0,0.00000000000000000000
chr8,75350087,75370281,20194,-1,0,,0,0.00000000000000000000
chr8,75362427,75367229,4802,-1,0,,0,0.00000000000000000000
chr8,75364540,75366865,2325,-1,0,,0,0.00000000000000000000
chr8,75876829,75877379,550,-1,0,,0,0.00000000000000000000
chr8,75870979,75871351,372,-1,0,,0,0.00000000000000000000
chr8,76109934,76109999,65,-1,0,,0,0.00000000000000000000
chr8,76126815,76127339,524,-1,0,,0,0.00000000000000000000
chr8,76126902,76127226,324,-1,0,,0,0.00000000000000000000
chr8,76137889,76138382,493,-1,0,,0,0.00000000000000000000
chr8,76138133,76138190,57,-1,0,,0,0.00000000000000000000
chr8,76248410,76257399,8989,-1,0,,0,0.00000000000000000000
chr8,76278752,76288766,10014,-1,0,,0,0.00000000000000000000
chr8,76379727,76380868,1141,-1,0,3174,1,87.64241893076250000000
chr8,76414046,76414151,105,-1,0,3174,1,952.38095238095300000000
chr8,76902118,76909965,7847,-1,0,,0,0.00000000000000000000
chr8,76770221,76770813,592,-1,0,,0,0.00000000000000000000
chr8,76840804,76841260,456,-1,0,,0,0.00000000000000000000
chr8,76615062,76615135,73,-1,0,,0,0.00000000000000000000
chr8,77182370,77183646,1276,-1,0,,0,0.00000000000000000000
chr8,77215604,77216267,663,-1,0,,0,0.00000000000000000000
chr8,77215851,77215980,129,-1,0,,0,0.00000000000000000000
chr8,77337354,77338473,1119,-1,0,,0,0.00000000000000000000
chr8,77832809,77835944,3135,-1,0,,0,0.00000000000000000000
chr8,78125112,78126242,1130,-1,0,,0,0.00000000000000000000
chr8,78243531,78271392,27861,-1,0,,0,0.00000000000000000000
chr8,78612455,78769272,156817,-1,0,,0,0.00000000000000000000
chr8,78720440,78803936,83496,-1,0,,0,0.00000000000000000000
chr8,78831602,78840348,8746,-1,0,,0,0.00000000000000000000
chr8,79079338,79079410,72,-1,0,,0,0.00000000000000000000
chr8,79151226,79151675,449,-1,0,,0,0.00000000000000000000
chr8,79151401,79151506,105,-1,0,,0,0.00000000000000000000
chr8,79178127,79188006,9879,-1,0,,0,0.00000000000000000000
chr8,79174445,79183413,8968,-1,0,,0,0.00000000000000000000
chr8,79180575,79187753,7178,-1,0,,0,0.00000000000000000000
chr8,79256454,79270949,14495,-1,0,,0,0.00000000000000000000
chr8,79545299,79548487,3188,-1,0,,0,0.00000000000000000000
chr8,79851187,79863467,12280,-1,0,,0,0.00000000000000000000
chr8,79919420,79919803,383,-1,0,,0,0.00000000000000000000
chr8,80434512,80445017,10505,-1,0,,0,0.00000000000000000000
chr8,80869832,80870878,1046,-1,0,28957,1,95.60229445506690000000
chr8,81251718,81252294,576,-1,0,,0,0.00000000000000000000
chr8,81990634,81994018,3384,-1,0,55824,1,29.55082742316780000000
chr8,81991081,81992524,1443,-1,0,55824,1,69.30006930006930000000
chr8,82043876,82046800,2924,-1,0,,0,0.00000000000000000000
chr8,82045018,82047178,2160,-1,0,,0,0.00000000000000000000
chr8,82045018,82046576,1558,-1,0,,0,0.00000000000000000000
chr8,82046121,82046774,653,-1,0,,0,0.00000000000000000000
chr8,82046288,82046579,291,-1,0,,0,0.00000000000000000000
chr8,82246675,82246792,117,-1,0,,0,0.00000000000000000000
chr8,82378455,82382552,4097,-1,0,,0,0.00000000000000000000
chr8,82623432,82624753,1321,-1,0,79752,1,75.70022710068130000000
chr8,82975093,82980660,5567,-1,0,,0,0.00000000000000000000
chr8,83002323,83005686,3363,-1,0,,0,0.00000000000000000000
chr8,83005149,83005709,560,-1,0,,0,0.00000000000000000000
chr8,83043729,83044687,958,-1,0,,0,0.00000000000000000000
chr8,83196486,83197723,1237,-1,0,,0,0.00000000000000000000
chr8,83224583,83225253,670,-1,0,,0,0.00000000000000000000
chr8,83267525,83296711,29186,-1,0,,0,0.00000000000000000000
chr8,83275236,83290147,14911,-1,0,,0,0.00000000000000000000
chr8,83738700,83773340,34640,-1,0,,0,0.00000000000000000000
chr8,83777903,83789090,11187,-1,0,,0,0.00000000000000000000
chr8,83570226,83570674,448,-1,0,,0,0.00000000000000000000
chr8,83709973,83710095,122,-1,0,,0,0.00000000000000000000
chr8,84020211,84127454,107243,-1,0,,0,0.00000000000000000000
chr8,84296729,84297324,595,-1,0,,0,0.00000000000000000000
chr8,84296942,84297122,180,-1,0,,0,0.00000000000000000000
chr8,84349766,84349839,73,-1,0,,0,0.00000000000000000000
chr8,84897924,84898490,566,-1,0,,0,0.00000000000000000000
chr8,84959371,84959555,184,-1,0,,0,0.00000000000000000000
chr8,85199387,85199819,432,-1,0,138046,1,231.48148148148100000000
chr8,85236036,85268680,32644,-1,0,138046,1,3.06335007964710000000
chr8,85251711,85268647,16936,-1,0,138046,1,5.90458195559754000000
chr8,85260963,85269220,8257,-1,0,138046,1,12.11093617536640000000
chr8,85736528,85740278,3750,-1,0,138046,1,26.66666666666670000000
chr8,85955631,85956033,402,-1,0,,0,0.00000000000000000000
chr8,86084337,86088246,3909,-1,0,,0,0.00000000000000000000
chr8,86278564,86291370,12806,-1,0,759,1,7.80883960643448000000
chr8,86342943,86349041,6098,-1,0,,0,0.00000000000000000000
chr8,86459964,86548731,88767,-1,0,,0,0.00000000000000000000
chr8,86840235,86912212,71977,-1,0,,0,0.00000000000000000000
chr8,86520697,86555610,34913,-1,0,,0,0.00000000000000000000
chr8,86536219,86546437,10218,-1,0,,0,0.00000000000000000000
chr8,86520620,86521971,1351,-1,0,,0,0.00000000000000000000
chr8,87099203,87100928,1725,-1,0,,0,0.00000000000000000000
chr8,87099784,87100834,1050,-1,0,,0,0.00000000000000000000
chr8,87157398,87157566,168,-1,0,245972,1,595.23809523809500000000
chr8,87187458,87196242,8784,-1,0,,0,0.00000000000000000000
chr8,87188237,87193947,5710,-1,0,,0,0.00000000000000000000
chr8,88243080,88246360,3280,-1,0,168975,1,30.48780487804880000000
chr8,88333358,88333411,53,-1,0,168975,1,1886.79245283019000000000
chr8,88522802,88529011,6209,-1,0,,0,0.00000000000000000000
chr8,88512273,88512827,554,-1,0,,0,0.00000000000000000000
chr8,89026790,89026868,78,-1,0,,0,0.00000000000000000000
chr8,89098109,89100364,2255,-1,0,4325,1,44.34589800443460000000
chr8,89221608,89222146,538,-1,0,4325,1,185.87360594795500000000
chr8,89221848,89221919,71,-1,0,4325,1,1408.45070422535000000000
chr8,89248743,89249253,510,-1,0,4325,1,196.07843137254900000000
chr8,89248980,89249106,126,-1,0,4325,1,793.65079365079400000000
chr8,89351899,89352059,160,-1,0,,0,0.00000000000000000000
chr8,89351932,89352037,105,-1,0,,0,0.00000000000000000000
chr8,89392108,89392634,526,-1,0,,0,0.00000000000000000000
chr8,89392215,89392523,308,-1,0,,0,0.00000000000000000000
chr8,89953087,90140752,187665,-1,0,,0,0.00000000000000000000
chr8,89844256,89996860,152604,-1,0,,0,0.00000000000000000000
chr8,89533414,89597526,64112,-1,0,,0,0.00000000000000000000
chr8,89668429,89719451,51022,-1,0,,0,0.00000000000000000000
chr8,89689921,89713172,23251,-1,0,,0,0.00000000000000000000
chr8,89926771,89929930,3159,-1,0,,0,0.00000000000000000000
chr8,89592347,89593202,855,-1,0,,0,0.00000000000000000000
chr8,89550576,89551162,586,-1,0,,0,0.00000000000000000000
chr8,89640549,89641085,536,-1,0,,0,0.00000000000000000000
chr8,89550832,89550930,98,-1,0,,0,0.00000000000000000000
chr8,90329675,90337688,8013,-1,0,,0,0.00000000000000000000
chr8,90421690,90592083,170393,-1,0,,0,0.00000000000000000000
chr8,90399322,90527117,127795,-1,0,,0,0.00000000000000000000
chr8,90737014,90740920,3906,-1,0,,0,0.00000000000000000000
chr8,90713645,90713988,343,-1,0,,0,0.00000000000000000000
chr8,90468252,90468442,190,-1,0,,0,0.00000000000000000000
chr8,91069114,91069569,455,-1,0,,0,0.00000000000000000000
chr8,91201456,91202682,1226,-1,0,,0,0.00000000000000000000
chr8,91225882,91227068,1186,-1,0,,0,0.00000000000000000000
chr8,91515413,91515683,270,-1,0,,0,0.00000000000000000000
chr8,91545306,91546011,705,-1,0,,0,0.00000000000000000000
chr8,92093303,92093947,644,-1,0,51633,1,155.27950310559000000000
chr8,92115423,92185615,70192,-1,0,100130742,1,1.42466377934807000000
chr8,92152749,92153295,546,-1,0,100130742,1,183.15018315018300000000
chr8,92152865,92153180,315,-1,0,100130742,1,317.46031746031700000000
chr8,92186989,92190065,3076,-1,0,100130742,1,32.50975292587780000000
chr8,92532383,92540947,8564,-1,0,,0,0.00000000000000000000
chr8,92541784,92544487,2703,-1,0,,0,0.00000000000000000000
chr8,92762454,92763716,1262,-1,0,,0,0.00000000000000000000
chr8,92840083,92840498,415,-1,0,,0,0.00000000000000000000
chr8,92840221,92840294,73,-1,0,,0,0.00000000000000000000
chr8,94281440,94315115,33675,-1,0,,0,0.00000000000000000000
chr8,94072358,94078834,6476,-1,0,,0,0.00000000000000000000
chr8,94237312,94243700,6388,-1,0,,0,0.00000000000000000000
chr8,94396628,94401240,4612,-1,0,,0,0.00000000000000000000
chr8,94072528,94076172,3644,-1,0,,0,0.00000000000000000000
chr8,94072341,94073677,1336,-1,0,,0,0.00000000000000000000
chr8,93351960,93352525,565,-1,0,,0,0.00000000000000000000
chr8,94618756,94619087,331,-1,0,,0,0.00000000000000000000
chr8,93583315,93583710,395,-1,0,,0,0.00000000000000000000
chr8,93352153,93352320,167,-1,0,,0,0.00000000000000000000
chr8,94618819,94619023,204,-1,0,,0,0.00000000000000000000
chr8,94417851,94417966,115,-1,0,,0,0.00000000000000000000
chr8,93583496,93583546,50,-1,0,,0,0.00000000000000000000
chr8,95329625,95330016,391,-1,0,,0,0.00000000000000000000
chr8,95558383,95560753,2370,-1,0,25962,1,42.19409282700420000000
chr8,95638341,95639843,1502,-1,0,,0,0.00000000000000000000
chr8,95646855,95648968,2113,-1,0,,0,0.00000000000000000000
chr8,95721343,95737580,16237,-1,0,286148,1,6.15877317238406000000
chr8,95725099,95728323,3224,-1,0,,0,0.00000000000000000000
chr8,95785665,95786656,991,-1,0,286148,1,100.90817356205900000000
chr8,96079390,96082273,2883,-1,0,,0,0.00000000000000000000
chr8,96086477,96086960,483,-1,0,,0,0.00000000000000000000
chr8,96086641,96086785,144,-1,0,,0,0.00000000000000000000
chr8,96344695,96345798,1103,-1,0,,0,0.00000000000000000000
chr8,96345045,96345612,567,-1,0,,0,0.00000000000000000000
chr8,96345214,96345419,205,-1,0,,0,0.00000000000000000000
chr8,96345261,96345377,116,-1,0,,0,0.00000000000000000000
chr8,96390893,96391185,292,-1,0,,0,0.00000000000000000000
chr8,96854586,96857500,2914,-1,0,,0,0.00000000000000000000
chr8,96836348,96836586,238,-1,0,,0,0.00000000000000000000
chr8,96875094,96879682,4588,-1,0,,0,0.00000000000000000000
chr8,96875399,96877705,2306,-1,0,,0,0.00000000000000000000
chr8,97077925,97079982,2057,-1,0,,0,0.00000000000000000000
chr8,97097995,97098530,535,-1,0,,0,0.00000000000000000000
chr8,97098088,97098440,352,-1,0,,0,0.00000000000000000000
chr8,97348219,97351779,3560,-1,0,,0,0.00000000000000000000
chr8,97415028,97415428,400,-1,0,,0,0.00000000000000000000
chr8,97427222,97430334,3112,-1,0,,0,0.00000000000000000000
chr8,97514679,97514786,107,-1,0,6383,1,934.57943925233600000000
chr8,97519106,97521786,2680,-1,0,6383,1,37.31343283582090000000
chr8,97520651,97521939,1288,-1,0,6383,1,77.63975155279500000000
chr8,97520835,97521782,947,-1,0,6383,1,105.59662090813100000000
chr8,97799871,97800323,452,-1,0,10404,1,221.23893805309700000000
chr8,97800063,97800133,70,-1,0,10404,1,1428.57142857143000000000
chr8,98200053,98200601,548,-1,0,,0,0.00000000000000000000
chr8,98119748,98120098,350,-1,0,10404,1,285.71428571428600000000
chr8,98200142,98200464,322,-1,0,,0,0.00000000000000000000
chr8,98562331,98567282,4951,-1,0,,0,0.00000000000000000000
chr8,98595294,98595864,570,-1,0,,0,0.00000000000000000000
chr8,98595404,98595746,342,-1,0,,0,0.00000000000000000000
chr8,98783357,98783900,543,-1,0,,0,0.00000000000000000000
chr8,98783448,98783780,332,-1,0,,0,0.00000000000000000000
chr8,98862077,98863326,1249,-1,0,55353,1,80.06405124099280000000
chr8,99067137,99076217,9080,-1,0,,0,0.00000000000000000000
chr8,99079887,99081618,1731,-1,0,203111,1,57.77007510109760000000
chr8,99256195,99257292,1097,-1,0,79815,1,91.15770282588880000000
chr8,99283762,99291275,7513,-1,0,79815,1,13.31026221216560000000
chr8,99356961,99359567,2606,-1,0,,0,0.00000000000000000000
chr8,99465137,99465472,335,-1,0,,0,0.00000000000000000000
chr8,99545492,99607092,61600,-1,0,6788,1,1.62337662337662000000
chr8,100026370,100027526,1156,-1,0,157680,1,86.50519031141870000000
chr8,100094614,100105592,10978,-1,0,157680,1,9.10912734560029000000
chr8,100636237,100643963,7726,-1,0,157680,1,12.94330830960390000000
chr8,100599572,100601933,2361,-1,0,157680,1,42.35493434985180000000
chr8,100605794,100607905,2111,-1,0,157680,1,47.37091425864520000000
chr8,100354681,100355577,896,-1,0,157680,1,111.60714285714300000000
chr8,100698324,100701511,3187,-1,0,157680,1,31.37747097583930000000
chr8,101376571,101377671,1100,-1,0,,0,0.00000000000000000000
chr8,101717331,101718873,1542,-1,0,26986,1,64.85084306095980000000
chr8,101979594,101998015,18421,-1,0,,0,0.00000000000000000000
chr8,101984891,101993341,8450,-1,0,,0,0.00000000000000000000
chr8,102017186,102017371,185,-1,0,,0,0.00000000000000000000
chr8,102386737,102405078,18341,-1,0,,0,0.00000000000000000000
chr8,102388031,102402935,14904,-1,0,,0,0.00000000000000000000
chr8,102617589,102625841,8252,-1,0,79977,1,12.11827435773150000000
chr8,102620914,102626999,6085,-1,0,79977,1,16.43385373870170000000
chr8,102620866,102625622,4756,-1,0,79977,1,21.02607232968880000000
chr8,103053936,103056722,2786,-1,0,83988,1,35.89375448671930000000
chr8,103120209,103120946,737,-1,0,83988,1,135.68521031207600000000
chr8,103288097,103288853,756,-1,0,51366,1,132.27513227513200000000
chr8,103396207,103409306,13099,-1,0,51366,1,7.63417054737003000000
chr8,103441465,103441877,412,-1,0,,0,0.00000000000000000000
chr8,103570928,103572520,1592,-1,0,4956,1,62.81407035175880000000
chr8,103719056,103728382,9326,-1,0,,0,0.00000000000000000000
chr8,103940000,103942112,2112,-1,0,,0,0.00000000000000000000
chr8,103994663,103996734,2071,-1,0,,0,0.00000000000000000000
chr8,104014162,104014507,345,-1,0,,0,0.00000000000000000000
chr8,104111772,104115574,3802,-1,0,,0,0.00000000000000000000
chr8,104132081,104135587,3506,-1,0,,0,0.00000000000000000000
chr8,104382853,104383302,449,-1,0,,0,0.00000000000000000000
chr8,104408525,104411508,2983,-1,0,81034,1,33.52329869259140000000
chr8,104459903,104460304,401,-1,0,,0,0.00000000000000000000
chr8,104906365,104912685,6320,-1,0,9699,1,15.82278481012660000000
chr8,104758543,104764277,5734,-1,0,9699,1,17.43983257760730000000
chr8,105267421,105267521,100,-1,0,,0,0.00000000000000000000
chr8,105904196,105913893,9697,-1,0,,0,0.00000000000000000000
chr8,106053319,106060855,7536,-1,0,,0,0.00000000000000000000
chr8,106181393,106181724,331,-1,0,,0,0.00000000000000000000
chr8,106374023,106374764,741,-1,0,23414,1,134.95276653171400000000
chr8,106579655,106580635,980,-1,0,23414,1,102.04081632653100000000
chr8,106670507,106670863,356,-1,0,23414,1,280.89887640449400000000
chr8,106703447,106703774,327,-1,0,23414,1,305.81039755351700000000
chr8,106796546,106797321,775,-1,0,23414,1,129.03225806451600000000
chr8,106797393,106797793,400,-1,0,23414,1,250.00000000000000000000
chr8,106923657,106971617,47960,-1,0,,0,0.00000000000000000000
chr8,107087450,107090803,3353,-1,0,,0,0.00000000000000000000
chr8,107234214,107235978,1764,-1,0,,0,0.00000000000000000000
chr8,107496279,107499542,3263,-1,0,55074,1,30.64664419246090000000
chr8,107510972,107511545,573,-1,0,55074,1,174.52006980802800000000
chr8,107511046,107511378,332,-1,0,55074,1,301.20481927710800000000
chr8,107532268,107532714,446,-1,0,55074,1,224.21524663677100000000
chr8,107728450,107729007,557,-1,0,55074,1,179.53321364452400000000
chr8,107728565,107728900,335,-1,0,55074,1,298.50746268656700000000
chr8,107783305,107787975,4670,-1,0,,0,0.00000000000000000000
chr8,107857920,107862945,5025,-1,0,,0,0.00000000000000000000
chr8,107946299,107958964,12665,-1,0,,0,0.00000000000000000000
chr8,107972077,107974019,1942,-1,0,,0,0.00000000000000000000
chr8,108111683,108112060,377,-1,0,,0,0.00000000000000000000
chr8,108120107,108120734,627,-1,0,,0,0.00000000000000000000
chr8,108120220,108120555,335,-1,0,,0,0.00000000000000000000
chr8,108121518,108122337,819,-1,0,,0,0.00000000000000000000
chr8,108135012,108136588,1576,-1,0,,0,0.00000000000000000000
chr8,108373434,108374019,585,-1,0,284,1,170.94017094017100000000
chr8,108373757,108373928,171,-1,0,284,1,584.79532163742700000000
chr8,108373810,108373900,90,-1,0,284,1,1111.11111111111000000000
chr8,108380296,108381475,1179,-1,0,284,1,84.81764206955050000000
chr8,108380513,108381237,724,-1,0,284,1,138.12154696132600000000
chr8,108380687,108381077,390,-1,0,284,1,256.41025641025600000000
chr8,108503877,108506192,2315,-1,0,284,1,43.19654427645790000000
chr8,108504793,108506382,1589,-1,0,284,1,62.93266205160480000000
chr8,108599376,108600139,763,-1,0,,0,0.00000000000000000000
chr8,108579361,108579766,405,-1,0,,0,0.00000000000000000000
chr8,108781334,108782574,1240,-1,0,,0,0.00000000000000000000
chr8,108781379,108782133,754,-1,0,,0,0.00000000000000000000
chr8,109103035,109111207,8172,-1,0,,0,0.00000000000000000000
chr8,109235973,109238093,2120,-1,0,3646,1,47.16981132075470000000
chr8,109277251,109284866,7615,-1,0,,0,0.00000000000000000000
chr8,109276649,109280105,3456,-1,0,,0,0.00000000000000000000
chr8,109532648,109535583,2935,-1,0,,0,0.00000000000000000000
chr8,109682946,109683642,696,-1,0,,0,0.00000000000000000000
chr8,109730083,109730584,501,-1,0,,0,0.00000000000000000000
chr8,109730175,109730500,325,-1,0,,0,0.00000000000000000000
chr8,110234480,110235222,742,-1,0,,0,0.00000000000000000000
chr8,110234721,110235045,324,-1,0,,0,0.00000000000000000000
chr8,110364540,110365932,1392,-1,0,,0,0.00000000000000000000
chr8,110510188,110510753,565,-1,0,93035,1,176.99115044247800000000
chr8,110510313,110510649,336,-1,0,93035,1,297.61904761904800000000
chr8,110740416,110740476,60,-1,0,,0,0.00000000000000000000
chr8,111029875,111031876,2001,-1,0,,0,0.00000000000000000000
chr8,111384182,111465275,81093,-1,0,,0,0.00000000000000000000
chr8,111428793,111468425,39632,-1,0,,0,0.00000000000000000000
chr8,111560054,111573069,13015,-1,0,,0,0.00000000000000000000
chr8,111494281,111500232,5951,-1,0,,0,0.00000000000000000000
chr8,111721402,111727877,6475,-1,0,,0,0.00000000000000000000
chr8,111938036,111943901,5865,-1,0,,0,0.00000000000000000000
chr8,111988033,111993824,5791,-1,0,,0,0.00000000000000000000
chr8,112006851,112129873,123022,-1,0,,0,0.00000000000000000000
chr8,112449223,112550601,101378,-1,0,,0,0.00000000000000000000
chr8,112294022,112301208,7186,-1,0,,0,0.00000000000000000000
chr8,113078917,113088772,9855,-1,0,,0,0.00000000000000000000
chr8,112798003,112803300,5297,-1,0,,0,0.00000000000000000000
chr8,112604166,112608780,4614,-1,0,,0,0.00000000000000000000
chr8,112294050,112297139,3089,-1,0,,0,0.00000000000000000000
chr8,112294176,112295256,1080,-1,0,,0,0.00000000000000000000
chr8,112168137,112168692,555,-1,0,,0,0.00000000000000000000
chr8,113085331,113085862,531,-1,0,,0,0.00000000000000000000
chr8,112168236,112168596,360,-1,0,,0,0.00000000000000000000
chr8,113085436,113085766,330,-1,0,,0,0.00000000000000000000
chr8,112553973,112554215,242,-1,0,,0,0.00000000000000000000
chr8,112995659,112995893,234,-1,0,,0,0.00000000000000000000
chr8,113225772,113226295,523,-1,0,,0,0.00000000000000000000
chr8,113225874,113226222,348,-1,0,,0,0.00000000000000000000
chr8,114048139,114066663,18524,-1,0,114788,1,5.39840207298640000000
chr8,114040462,114046762,6300,-1,0,114788,1,15.87301587301590000000
chr8,114056490,114058774,2284,-1,0,114788,1,43.78283712784590000000
chr8,114310868,114324588,13720,-1,0,114788,1,7.28862973760933000000
chr8,114862619,114862753,134,-1,0,,0,0.00000000000000000000
chr8,114912706,114913418,712,-1,0,,0,0.00000000000000000000
chr8,114934272,114934772,500,-1,0,,0,0.00000000000000000000
chr8,114934391,114934682,291,-1,0,,0,0.00000000000000000000
chr8,115027676,115200723,173047,-1,0,,0,0.00000000000000000000
chr8,115150475,115210157,59682,-1,0,,0,0.00000000000000000000
chr8,115151686,115177321,25635,-1,0,,0,0.00000000000000000000
chr8,115078600,115081240,2640,-1,0,,0,0.00000000000000000000
chr8,115079316,115080675,1359,-1,0,,0,0.00000000000000000000
chr8,115079961,115080682,721,-1,0,,0,0.00000000000000000000
chr8,115255997,115299235,43238,-1,0,,0,0.00000000000000000000
chr8,115311301,115376439,65138,-1,0,,0,0.00000000000000000000
chr8,115702828,115875176,172348,-1,0,,0,0.00000000000000000000
chr8,115634577,115657270,22693,-1,0,,0,0.00000000000000000000
chr8,115631916,115649272,17356,-1,0,,0,0.00000000000000000000
chr8,115635871,115651063,15192,-1,0,,0,0.00000000000000000000
chr8,115629585,115643058,13473,-1,0,,0,0.00000000000000000000
chr8,115635416,115643524,8108,-1,0,,0,0.00000000000000000000
chr8,115865151,115867548,2397,-1,0,,0,0.00000000000000000000
chr8,115740644,115740808,164,-1,0,,0,0.00000000000000000000
chr8,115618921,115618980,59,-1,0,,0,0.00000000000000000000
chr8,115997801,115998361,560,-1,0,,0,0.00000000000000000000
chr8,116104343,116104704,361,-1,0,,0,0.00000000000000000000
chr8,116487747,116489062,1315,-1,0,7227,1,76.04562737642590000000
chr8,116488130,116488661,531,-1,0,7227,1,188.32391713747600000000
chr8,116488236,116488560,324,-1,0,7227,1,308.64197530864200000000
chr8,116912200,116913803,1603,-1,0,,0,0.00000000000000000000
chr8,117241900,117243103,1203,-1,0,,0,0.00000000000000000000
chr8,117399715,117400073,358,-1,0,,0,0.00000000000000000000
chr8,117451975,117454464,2489,-1,0,,0,0.00000000000000000000
chr8,117630175,117633004,2829,-1,0,,0,0.00000000000000000000
chr8,117973659,117975332,1673,-1,0,169026,1,59.77286312014340000000
chr8,118005410,118008178,2768,-1,0,169026,1,36.12716763005780000000
chr8,118223487,118223847,360,-1,0,,0,0.00000000000000000000
chr8,118223507,118223803,296,-1,0,,0,0.00000000000000000000
chr8,118679611,118679716,105,-1,0,,0,0.00000000000000000000
chr8,118712719,118713195,476,-1,0,,0,0.00000000000000000000
chr8,118712802,118713105,303,-1,0,,0,0.00000000000000000000
chr8,118869383,118875760,6377,-1,0,2131,1,15.68135486906070000000
chr8,118873785,118875590,1805,-1,0,2131,1,55.40166204986150000000
chr8,118874284,118875296,1012,-1,0,2131,1,98.81422924901180000000
chr8,118874083,118874891,808,-1,0,2131,1,123.76237623762400000000
chr8,118910740,118930481,19741,-1,0,2131,1,5.06559951370245000000
chr8,119007652,119012680,5028,-1,0,2131,1,19.88862370723950000000
chr8,118980657,118981189,532,-1,0,2131,1,187.96992481203000000000
chr8,118980757,118981108,351,-1,0,2131,1,284.90028490028500000000
chr8,119165306,119165791,485,-1,0,,0,0.00000000000000000000
chr8,119165531,119165615,84,-1,0,,0,0.00000000000000000000
chr8,119246358,119249440,3082,-1,0,401474,1,32.44646333549640000000
chr8,119446944,119447453,509,-1,0,401474,1,196.46365422396900000000
chr8,119447046,119447370,324,-1,0,401474,1,308.64197530864200000000
chr8,119617813,119618233,420,-1,0,401474,1,238.09523809523800000000
chr8,119688015,119695263,7248,-1,0,,0,0.00000000000000000000
chr8,119932814,119933563,749,-1,0,,0,0.00000000000000000000
chr8,119959286,119959722,436,-1,0,4982,1,229.35779816513800000000
chr8,120019305,120028440,9135,-1,0,10584,1,10.94690749863160000000
chr8,120108667,120111900,3233,-1,0,10584,1,30.93102381688830000000
chr8,120156135,120165682,9547,-1,0,,0,0.00000000000000000000
chr8,120154532,120161211,6679,-1,0,,0,0.00000000000000000000
chr8,120306781,120321285,14504,-1,0,,0,0.00000000000000000000
chr8,120323942,120329704,5762,-1,0,,0,0.00000000000000000000
chr8,120325901,120328062,2161,-1,0,,0,0.00000000000000000000
chr8,120460783,120463128,2345,-1,0,,0,0.00000000000000000000
chr8,120645681,120646253,572,-1,0,5168,1,174.82517482517500000000
chr8,120785142,120786410,1268,-1,0,6873,1,78.86435331230280000000
chr8,121487307,121488892,1585,-1,0,27085,1,63.09148264984230000000
chr8,121534167,121534528,361,-1,0,27085,1,277.00831024930700000000
chr8,121534073,121534276,203,-1,0,27085,1,492.61083743842400000000
chr8,121872603,121874417,1814,-1,0,,0,0.00000000000000000000
chr8,121854655,121855163,508,-1,0,,0,0.00000000000000000000
chr8,121681557,121682126,569,-1,0,6641,1,175.74692442882200000000
chr8,121681685,121682019,334,-1,0,6641,1,299.40119760479000000000
chr8,121854757,121855077,320,-1,0,,0,0.00000000000000000000
chr8,121930605,121930716,111,-1,0,,0,0.00000000000000000000
chr8,122213279,122213588,309,-1,0,,0,0.00000000000000000000
chr8,122213396,122213508,112,-1,0,,0,0.00000000000000000000
chr8,122519213,122524513,5300,-1,0,,0,0.00000000000000000000
chr8,123025201,123029703,4502,-1,0,,0,0.00000000000000000000
chr8,123048405,123048739,334,-1,0,,0,0.00000000000000000000
chr8,123059296,123061950,2654,-1,0,,0,0.00000000000000000000
chr8,123059020,123061007,1987,-1,0,,0,0.00000000000000000000
chr8,123057969,123059889,1920,-1,0,,0,0.00000000000000000000
chr8,123113504,123115071,1567,-1,0,,0,0.00000000000000000000
chr8,124415826,124416989,1163,-1,0,,0,0.00000000000000000000
chr8,124654125,124654525,400,-1,0,,0,0.00000000000000000000
chr8,124895807,125011558,115751,-1,0,654463,1,0.86392342182788900000
chr8,125101552,125110692,9140,-1,0,654463,1,10.94091903719910000000
chr8,125224205,125224337,132,-1,0,,0,0.00000000000000000000
chr8,125369231,125377217,7986,-1,0,157378,1,12.52191334835960000000
chr8,125398145,125398217,72,-1,0,,0,0.00000000000000000000
chr8,125493227,125497741,4514,-1,0,11236,1,22.15330084182540000000
chr8,125492299,125495637,3338,-1,0,11236,1,29.95805871779510000000
chr8,125495016,125497653,2637,-1,0,11236,1,37.92188092529390000000
chr8,125813443,125813507,64,-1,0,,0,0.00000000000000000000
chr8,126108875,126112882,4007,-1,0,286053,1,24.95632642874970000000
chr8,126284784,126285291,507,-1,0,286053,1,197.23865877712000000000
chr8,126305706,126305910,204,-1,0,286053,1,490.19607843137300000000
chr8,126336791,126337114,323,-1,0,286053,1,309.59752321981400000000
chr8,126594996,126601273,6277,-1,0,,0,0.00000000000000000000
chr8,126947861,126955037,7176,-1,0,,0,0.00000000000000000000
chr8,127191899,127196185,4286,-1,0,,0,0.00000000000000000000
chr8,127220129,127225197,5068,-1,0,,0,0.00000000000000000000
chr8,127401182,127405129,3947,-1,0,,0,0.00000000000000000000
chr8,127192199,127194569,2370,-1,0,,0,0.00000000000000000000
chr8,127277244,127279618,2374,-1,0,,0,0.00000000000000000000
chr8,126765905,126766980,1075,-1,0,,0,0.00000000000000000000
chr8,127532863,127533857,994,-1,0,,0,0.00000000000000000000
chr8,127248874,127249356,482,-1,0,,0,0.00000000000000000000
chr8,126681344,126681746,402,-1,0,,0,0.00000000000000000000
chr8,126480360,126480742,382,-1,0,,0,0.00000000000000000000
chr8,126631685,126631888,203,-1,0,,0,0.00000000000000000000
chr8,126490255,126490417,162,-1,0,,0,0.00000000000000000000
chr8,127712500,127719319,6819,-1,0,,0,0.00000000000000000000
chr8,128001149,128001932,783,-1,0,,0,0.00000000000000000000
chr8,128012263,128012937,674,-1,0,,0,0.00000000000000000000
chr8,128248288,128250059,1771,-1,0,,0,0.00000000000000000000
chr8,128419982,128420675,693,-1,0,,0,0.00000000000000000000
chr8,128420203,128420373,170,-1,0,,0,0.00000000000000000000
chr8,128420278,128420384,106,-1,0,,0,0.00000000000000000000
chr8,128496755,128531490,34735,-1,0,,0,0.00000000000000000000
chr8,128611287,128611399,112,-1,0,,0,0.00000000000000000000
chr8,128634395,128667573,33178,-1,0,,0,0.00000000000000000000
chr8,128702867,128703628,761,-1,0,,0,0.00000000000000000000
chr8,128716451,128729925,13474,-1,0,,0,0.00000000000000000000
chr8,128722834,128725458,2624,-1,0,,0,0.00000000000000000000
chr8,128946784,128948053,1269,-1,0,,0,0.00000000000000000000
chr8,128950310,128959590,9280,-1,0,,0,0.00000000000000000000
chr8,129007024,129008326,1302,-1,0,,0,0.00000000000000000000
chr8,129471282,129484429,13147,-1,0,,0,0.00000000000000000000
chr8,129465060,129471418,6358,-1,0,,0,0.00000000000000000000
chr8,129749589,129772423,22834,-1,0,,0,0.00000000000000000000
chr8,129750865,129764867,14002,-1,0,,0,0.00000000000000000000
chr8,129762481,129765999,3518,-1,0,,0,0.00000000000000000000
chr8,129763068,129764533,1465,-1,0,,0,0.00000000000000000000
chr8,129859280,129862425,3145,-1,0,,0,0.00000000000000000000
chr8,130113957,130138732,24775,-1,0,,0,0.00000000000000000000
chr8,130139296,130146056,6760,-1,0,,0,0.00000000000000000000
chr8,130142788,130144369,1581,-1,0,,0,0.00000000000000000000
chr8,130435189,130442878,7689,-1,0,,0,0.00000000000000000000
chr8,131004130,131007248,3118,-1,0,,0,0.00000000000000000000
chr8,131061208,131062576,1368,-1,0,,0,0.00000000000000000000
chr8,131061403,131062013,610,-1,0,,0,0.00000000000000000000
chr8,131370202,131371248,1046,-1,0,50807,1,95.60229445506690000000
chr8,131465610,131470363,4753,-1,0,,0,0.00000000000000000000
chr8,131561041,131561675,634,-1,0,,0,0.00000000000000000000
chr8,131688718,131689046,328,-1,0,,0,0.00000000000000000000
chr8,131791800,131792233,433,-1,0,,0,0.00000000000000000000
chr8,131850557,131853613,3056,-1,0,114,1,32.72251308900520000000
chr8,131850727,131852727,2000,-1,0,114,1,50.00000000000000000000
chr8,132091529,132093580,2051,-1,0,,0,0.00000000000000000000
chr8,132168193,132168708,515,-1,0,,0,0.00000000000000000000
chr8,132168301,132168614,313,-1,0,,0,0.00000000000000000000
chr8,132277656,132280536,2880,-1,0,,0,0.00000000000000000000
chr8,132242725,132243373,648,-1,0,,0,0.00000000000000000000
chr8,132991085,132994576,3491,-1,0,23167,1,28.64508736751650000000
chr8,133060621,133061591,970,-1,0,729330,1,103.09278350515500000000
chr8,133578905,133579359,454,-1,0,,0,0.00000000000000000000
chr8,133758385,133759041,656,-1,0,137835,1,152.43902439024400000000
chr8,133758614,133758733,119,-1,0,137835,1,840.33613445378100000000
chr8,133764919,133765575,656,-1,0,137835,1,152.43902439024400000000
chr8,134166745,134181102,14357,-1,0,,0,0.00000000000000000000
chr8,134168208,134180503,12295,-1,0,,0,0.00000000000000000000
chr8,134329328,134329897,569,-1,0,,0,0.00000000000000000000
chr8,134329444,134329766,322,-1,0,,0,0.00000000000000000000
chr8,134359996,134360205,209,-1,0,,0,0.00000000000000000000
chr8,134626832,134645451,18619,-1,0,,0,0.00000000000000000000
chr8,134629663,134631633,1970,-1,0,,0,0.00000000000000000000
chr8,135059278,135068938,9660,-1,0,,0,0.00000000000000000000
chr8,135056507,135066706,10199,-1,0,,0,0.00000000000000000000
chr8,135059563,135068064,8501,-1,0,,0,0.00000000000000000000
chr8,135082690,135089251,6561,-1,0,,0,0.00000000000000000000
chr8,135475916,135479051,3135,-1,0,,0,0.00000000000000000000
chr8,135509628,135511863,2235,-1,0,57623,1,44.74272930648770000000
chr8,135408942,135410898,1956,-1,0,,0,0.00000000000000000000
chr8,135194269,135195975,1706,-1,0,,0,0.00000000000000000000
chr8,135476951,135478101,1150,-1,0,,0,0.00000000000000000000
chr8,135942494,135943123,629,-1,0,,0,0.00000000000000000000
chr8,136002608,136009387,6779,-1,0,,0,0.00000000000000000000
chr8,136073301,136076826,3525,-1,0,,0,0.00000000000000000000
chr8,136218530,136220219,1689,-1,0,,0,0.00000000000000000000
chr8,136469355,136470368,1013,-1,0,10656,1,98.71668311944720000000
chr8,136547282,136547809,527,-1,0,10656,1,189.75332068311200000000
chr8,136621755,136627582,5827,-1,0,10656,1,17.16148961729880000000
chr8,136623392,136624965,1573,-1,0,10656,1,63.57279084551810000000
chr8,136699689,136708073,8384,-1,0,,0,0.00000000000000000000
chr8,136847240,136847761,521,-1,0,,0,0.00000000000000000000
chr8,136847440,136847588,148,-1,0,,0,0.00000000000000000000
chr8,137158004,137164733,6729,-1,0,,0,0.00000000000000000000
chr8,137160249,137163921,3672,-1,0,,0,0.00000000000000000000
chr8,137680622,137863277,182655,-1,0,,0,0.00000000000000000000
chr8,137760747,137847302,86555,-1,0,,0,0.00000000000000000000
chr8,137815729,137853184,37455,-1,0,,0,0.00000000000000000000
chr8,137694261,137705873,11612,-1,0,,0,0.00000000000000000000
chr8,137716809,137717189,380,-1,0,,0,0.00000000000000000000
chr8,137965805,137965918,113,-1,0,,0,0.00000000000000000000
chr8,138165015,138297333,132318,-1,0,,0,0.00000000000000000000
chr8,138083509,138099445,15936,-1,0,,0,0.00000000000000000000
chr8,138125854,138127577,1723,-1,0,,0,0.00000000000000000000
chr8,138064472,138065021,549,-1,0,,0,0.00000000000000000000
chr8,138200059,138200534,475,-1,0,,0,0.00000000000000000000
chr8,138200161,138200407,246,-1,0,,0,0.00000000000000000000
chr8,138077963,138078072,109,-1,0,,0,0.00000000000000000000
chr8,138307847,138308011,164,-1,0,,0,0.00000000000000000000
chr8,138671581,138671628,47,-1,0,,0,0.00000000000000000000
chr8,138738140,138744179,6039,-1,0,,0,0.00000000000000000000
chr8,138742802,138744031,1229,-1,0,,0,0.00000000000000000000
chr8,138749630,138751433,1803,-1,0,,0,0.00000000000000000000
chr8,138742949,138743863,914,-1,0,,0,0.00000000000000000000
chr8,138743347,138743803,456,-1,0,,0,0.00000000000000000000
chr8,138799667,138802958,3291,-1,0,,0,0.00000000000000000000
chr8,138800898,138802455,1557,-1,0,,0,0.00000000000000000000
chr8,138817140,138819445,2305,-1,0,,0,0.00000000000000000000
chr8,138822658,138832086,9428,-1,0,,0,0.00000000000000000000
chr8,138821420,138825320,3900,-1,0,,0,0.00000000000000000000
chr8,138837191,138842785,5594,-1,0,,0,0.00000000000000000000
chr8,138860566,138861003,437,-1,0,,0,0.00000000000000000000
chr8,139071597,139071957,360,-1,0,,0,0.00000000000000000000
chr8,139071621,139071741,120,-1,0,,0,0.00000000000000000000
chr8,139425909,139432754,6845,-1,0,51059,1,14.60920379839300000000
chr8,139703964,139704463,499,-1,0,169044,1,200.40080160320600000000
chr8,139894476,139894926,450,-1,0,169044,1,222.22222222222200000000
chr8,139910575,139912357,1782,-1,0,169044,1,56.11672278338950000000
chr8,140013857,140014448,591,-1,0,,0,0.00000000000000000000
chr8,140013962,140014356,394,-1,0,,0,0.00000000000000000000
chr8,140014069,140014187,118,-1,0,,0,0.00000000000000000000
chr8,140161363,140161557,194,-1,0,,0,0.00000000000000000000
chr8,140257338,140259191,1853,-1,0,,0,0.00000000000000000000
chr8,140257721,140259153,1432,-1,0,,0,0.00000000000000000000
chr8,140422163,140422562,399,-1,0,,0,0.00000000000000000000
chr8,140475235,140475692,457,-1,0,,0,0.00000000000000000000
chr8,140475264,140475595,331,-1,0,,0,0.00000000000000000000
chr8,140480261,140481003,742,-1,0,,0,0.00000000000000000000
chr8,140689857,140690292,435,-1,0,51305,1,229.88505747126400000000
chr8,140689929,140690201,272,-1,0,51305,1,367.64705882352900000000
chr8,140759597,140760963,1366,-1,0,83696,1,73.20644216691070000000
chr8,140759836,140760671,835,-1,0,83696,1,119.76047904191600000000
chr8,140884788,140885789,1001,-1,0,83696,1,99.90009990009990000000
chr8,140884571,140884822,251,-1,0,83696,1,398.40637450199200000000
chr8,141040459,141042892,2433,-1,0,83696,1,41.10152075626800000000
chr8,140975697,140976129,432,-1,0,83696,1,231.48148148148100000000
chr8,141209454,141209864,410,-1,0,83696,1,243.90243902439000000000
chr8,141120401,141120709,308,-1,0,83696,1,324.67532467532500000000
chr8,141167264,141167561,297,-1,0,83696,1,336.70033670033700000000
chr8,141209616,141209686,70,-1,0,83696,1,1428.57142857143000000000
chr8,141344397,141348031,3634,-1,0,83696,1,27.51788662630710000000
chr8,142927618,142934316,6698,-1,0,,0,0.00000000000000000000
chr8,142640795,142644928,4133,-1,0,,0,0.00000000000000000000
chr8,141916775,141920457,3682,-1,0,5747,1,27.15915263443780000000
chr8,141631493,141633898,2405,-1,0,27161,1,41.58004158004160000000
chr8,142893745,142895396,1651,-1,0,,0,0.00000000000000000000
chr8,141851967,141853711,1744,-1,0,5747,1,57.33944954128440000000
chr8,142893982,142895079,1097,-1,0,,0,0.00000000000000000000
chr8,142502376,142503319,943,-1,0,389690,1,106.04453870625700000000
chr8,142345132,142345943,811,-1,0,,0,0.00000000000000000000
chr8,142439695,142440540,845,-1,0,11156,1,118.34319526627200000000
chr8,142357910,142358390,480,-1,0,,0,0.00000000000000000000
chr8,142561023,142561679,656,-1,0,,0,0.00000000000000000000
chr8,142447143,142447496,353,-1,0,389690,1,283.28611898017000000000
chr8,141499017,141499349,332,-1,0,,0,0.00000000000000000000
chr8,142262670,142263010,340,-1,0,57210,1,294.11764705882400000000
chr8,142681387,142681751,364,-1,0,,0,0.00000000000000000000
chr8,142345310,142345593,283,-1,0,,0,0.00000000000000000000
chr8,142447102,142447398,296,-1,0,389690,1,337.83783783783800000000
chr8,142358099,142358350,251,-1,0,,0,0.00000000000000000000
chr8,142894807,142895019,212,-1,0,,0,0.00000000000000000000
chr8,143237228,143870232,633004,-1,0,575;23237;51337;432355;137797;66004;203062;111188157;8629;57152;8581;8000;54742,13,2.05369950268877000000
chr8,143806776,143913129,106353,-1,0,111188157;51337;432355;57152;8581;137797;66004,7,6.58185476667325000000
chr8,143959950,143998012,38062,-1,0,1585;1584,2,5.25458462508539000000
chr8,143100387,143115742,15355,-1,0,,0,0.00000000000000000000
chr8,143729464,143739158,9694,-1,0,8629,1,10.31565917062100000000
chr8,144006489,144012732,6243,-1,0,,0,0.00000000000000000000
chr8,143063621,143066068,2447,-1,0,,0,0.00000000000000000000
chr8,143397459,143398775,1316,-1,0,203062,1,75.98784194528870000000
chr8,143132729,143133774,1045,-1,0,,0,0.00000000000000000000
chr8,143494783,143495714,931,-1,0,,0,0.00000000000000000000
chr8,143308116,143308765,649,-1,0,203062,1,154.08320493066300000000
chr8,143979417,143980154,737,-1,0,,0,0.00000000000000000000
chr8,143841349,143842134,785,-1,0,,0,0.00000000000000000000
chr8,143707339,143708042,703,-1,0,,0,0.00000000000000000000
chr8,143142181,143142667,486,-1,0,,0,0.00000000000000000000
chr8,143516406,143516789,383,-1,0,,0,0.00000000000000000000
chr8,143365040,143365536,496,-1,0,203062,1,201.61290322580600000000
chr8,143191588,143192013,425,-1,0,,0,0.00000000000000000000
chr8,143582806,143583272,466,-1,0,575,1,214.59227467811200000000
chr8,143177170,143177630,460,-1,0,,0,0.00000000000000000000
chr8,143308524,143308930,406,-1,0,203062,1,246.30541871921200000000
chr8,143308227,143308557,330,-1,0,203062,1,303.03030303030300000000
chr8,143065030,143065406,376,-1,0,,0,0.00000000000000000000
chr8,143564545,143564897,352,-1,0,575,1,284.09090909090900000000
chr8,143363687,143364013,326,-1,0,203062,1,306.74846625766900000000
chr8,143755582,143755877,295,-1,0,,0,0.00000000000000000000
chr8,143516540,143516804,264,-1,0,,0,0.00000000000000000000
chr8,143204045,143204251,206,-1,0,,0,0.00000000000000000000
chr8,143583673,143583843,170,-1,0,575,1,588.23529411764700000000
chr8,143308715,143308824,109,-1,0,203062,1,917.43119266055100000000
chr8,144056455,144057084,629,-1,0,,0,0.00000000000000000000
chr8,144058065,144058504,439,-1,0,,0,0.00000000000000000000
chr8,144058206,144058409,203,-1,0,,0,0.00000000000000000000
chr8,144058297,144058352,55,-1,0,,0,0.00000000000000000000
chr8,144066707,144068435,1728,-1,0,,0,0.00000000000000000000
chr8,144095911,144096369,458,-1,0,,0,0.00000000000000000000
chr8,144096897,144097114,217,-1,0,,0,0.00000000000000000000
chr8,144117438,144121875,4437,-1,0,,0,0.00000000000000000000
chr8,144153624,144155415,1791,-1,0,,0,0.00000000000000000000
chr8,144187532,144210559,23027,-1,0,,0,0.00000000000000000000
chr8,144223892,144224326,434,-1,0,,0,0.00000000000000000000
chr8,144248630,144249858,1228,-1,0,,0,0.00000000000000000000
chr8,144289101,144317800,28699,-1,0,338328,1,3.48444196661905000000
chr8,144316195,144317607,1412,-1,0,,0,0.00000000000000000000
chr8,144301695,144302265,570,-1,0,,0,0.00000000000000000000
chr8,144301988,144302152,164,-1,0,,0,0.00000000000000000000
chr8,144295495,144295552,57,-1,0,338328,1,1754.38596491228000000000
chr8,144325201,144427500,102299,-1,0,286128;79943;2738;116447,4,3.91010664815883000000
chr8,144386283,144388221,1938,-1,0,,0,0.00000000000000000000
chr8,144390069,144390559,490,-1,0,,0,0.00000000000000000000
chr8,144398506,144398942,436,-1,0,116447,1,229.35779816513800000000
chr8,144398592,144398790,198,-1,0,116447,1,505.05050505050500000000
chr8,144435963,144436742,779,-1,0,116447,1,128.36970474967900000000
chr8,144531906,144534803,2897,-1,0,23144,1,34.51846738004830000000
chr8,144455066,144455634,568,-1,0,114822,1,176.05633802816900000000
chr8,144700314,144714766,14452,-1,0,,0,0.00000000000000000000
chr8,144700927,144712073,11146,-1,0,,0,0.00000000000000000000
chr8,144699369,144707586,8217,-1,0,7264,1,12.16989168796400000000
chr8,144634013,144636240,2227,-1,0,79792,1,44.90345756623260000000
chr8,144705157,144707806,2649,-1,0,,0,0.00000000000000000000
chr8,144634088,144636226,2138,-1,0,79792,1,46.77268475210480000000
chr8,144679233,144681163,1930,-1,0,84948;1936,2,103.62694300518100000000
chr8,144723569,144723990,421,-1,0,9831,1,237.52969121140100000000
chr8,144709685,144710114,429,-1,0,,0,0.00000000000000000000
chr8,144824408,144828070,3662,-1,0,,0,0.00000000000000000000
chr8,145032973,145039093,6120,-1,0,5339,1,16.33986928104580000000
chr8,145181889,145182635,746,-1,0,,0,0.00000000000000000000
chr8,145234646,145235096,450,-1,0,727957,1,222.22222222222200000000
chr8,145234872,145234936,64,-1,0,727957,1,1562.50000000000000000000
chr8,145234823,145234878,55,-1,0,727957,1,1818.18181818182000000000
chr8,145318201,145778300,460099,-1,0,80728;3297;113655;83482;203054;84988;441381;79581;340393;9401;8694;8928;4796;642658;50626;29894;9684;55630;414919;26233;51160;90990;2875;23246,24,5.21626867261176000000
chr8,145603730,145607716,3986,-1,0,203054,1,25.08780732563970000000
chr8,145717930,145721068,3138,-1,0,84988,1,31.86743148502230000000
chr8,145645529,145647560,2031,-1,0,,0,0.00000000000000000000
chr8,145560219,145562289,2070,-1,0,,0,0.00000000000000000000
chr8,145525564,145527278,1714,-1,0,3297,1,58.34305717619600000000
chr8,145719954,145721055,1101,-1,0,84988,1,90.82652134423250000000
chr8,145756528,145757446,918,-1,0,80728,1,108.93246187363800000000
chr8,145502898,145503400,502,-1,0,,0,0.00000000000000000000
chr8,145505057,145505277,220,-1,0,,0,0.00000000000000000000
chr8,145573306,145573373,67,-1,0,,0,0.00000000000000000000
chr8,145781974,145783178,1204,-1,0,80728,1,83.05647840531560000000
chr8,145786480,145788245,1765,-1,0,80728,1,56.65722379603400000000
chr8,145849938,145850753,815,-1,0,80728,1,122.69938650306700000000
chr8,145845611,145845851,240,-1,0,80728,1,416.66666666666700000000
chr8,145861205,145861477,272,-1,0,80728,1,367.64705882352900000000
chr8,145874107,145880821,6714,-1,0,80728,1,14.89425081918380000000
chr8,145912242,145913429,1187,-1,0,,0,0.00000000000000000000
chr8,146042813,146043256,443,-1,0,,0,0.00000000000000000000
chr8,146042939,146043073,134,-1,0,,0,0.00000000000000000000
chr8,146057035,146057835,800,-1,0,7553,1,125.00000000000000000000
chr8,146221707,146297346,75639,-1,0,65265,1,1.32206930287286000000
chr8,146269593,146302462,32869,-1,0,65265,1,3.04238035839241000000
chr8,146219345,146238447,19102,-1,0,,0,0.00000000000000000000
chr8,146288043,146297127,9084,-1,0,,0,0.00000000000000000000
chr8,146297791,146303043,5252,-1,0,,0,0.00000000000000000000
chr8,146171967,146172809,842,-1,0,7564,1,118.76484560570100000000
chr8,146192868,146193180,312,-1,0,,0,0.00000000000000000000
chr9,10753219,11280652,527433,-1,0,,0,0.00000000000000000000
chr9,11885403,12255973,370570,-1,0,,0,0.00000000000000000000
chr9,11726633,12045647,319014,-1,0,,0,0.00000000000000000000
chr9,11260213,11627527,367314,-1,0,,0,0.00000000000000000000
chr9,11831610,12124551,292941,-1,0,,0,0.00000000000000000000
chr9,9312980,9607579,294599,-1,0,5789,1,0.33944446518827300000
chr9,12301188,12607154,305966,-1,0,,0,0.00000000000000000000
chr9,12061917,12292169,230252,-1,0,,0,0.00000000000000000000
chr9,11663944,11869049,205105,-1,0,,0,0.00000000000000000000
chr9,28531212,28718620,187408,-1,0,158038,1,0.53359515068727000000
chr9,11933674,12177660,243986,-1,0,,0,0.00000000000000000000
chr9,11839012,12021345,182333,-1,0,,0,0.00000000000000000000
chr9,643201,833691,190490,-1,0,23189,1,0.52496194025933100000
chr9,1516601,1699093,182492,-1,0,,0,0.00000000000000000000
chr9,11600469,11756536,156067,-1,0,,0,0.00000000000000000000
chr9,12262047,12436511,174464,-1,0,,0,0.00000000000000000000
chr9,25537670,25723237,185567,-1,0,286319,1,0.53888891882716200000
chr9,26257160,26431390,174230,-1,0,,0,0.00000000000000000000
chr9,11944899,12091383,146484,-1,0,,0,0.00000000000000000000
chr9,17766266,17912495,146229,-1,0,6456,1,0.68385887888175400000
chr9,28646540,28798700,152160,-1,0,158038,1,0.65720294426919000000
chr9,28190069,28350381,160312,-1,0,158038,1,0.62378362193722200000
chr9,9797553,9943464,145911,-1,0,5789,1,0.68534928826476400000
chr9,6525753,6686738,160985,-1,0,2731,1,0.62117588595210700000
chr9,202140,346318,144178,-1,0,81704;157983,2,1.38717418746272000000
chr9,11912154,11996833,84679,-1,0,,0,0.00000000000000000000
chr9,1386156,1531782,145626,-1,0,,0,0.00000000000000000000
chr9,11747663,11888065,140402,-1,0,,0,0.00000000000000000000
chr9,12340857,12483221,142364,-1,0,,0,0.00000000000000000000
chr9,12171952,12276847,104895,-1,0,,0,0.00000000000000000000
chr9,28507830,28644878,137048,-1,0,158038,1,0.72967135602124800000
chr9,24556778,24667179,110401,-1,0,,0,0.00000000000000000000
chr9,2259049,2350952,91903,-1,0,,0,0.00000000000000000000
chr9,8920894,9019184,98290,-1,0,5789,1,1.01739749720216000000
chr9,12007702,12121733,114031,-1,0,,0,0.00000000000000000000
chr9,12077952,12187463,109511,-1,0,,0,0.00000000000000000000
chr9,23928184,24049216,121032,-1,0,,0,0.00000000000000000000
chr9,24646647,24742440,95793,-1,0,,0,0.00000000000000000000
chr9,604710,706107,101397,-1,0,23189,1,0.98622247206524800000
chr9,28623896,28718657,94761,-1,0,158038,1,1.05528645750889000000
chr9,12011322,12087103,75781,-1,0,,0,0.00000000000000000000
chr9,8003429,8100814,97385,-1,0,,0,0.00000000000000000000
chr9,24287640,24351404,63764,-1,0,,0,0.00000000000000000000
chr9,25268638,25352649,84011,-1,0,,0,0.00000000000000000000
chr9,28750063,28845628,95565,-1,0,158038,1,1.04640820384032000000
chr9,11720691,11797195,76504,-1,0,,0,0.00000000000000000000
chr9,29411290,29505792,94502,-1,0,,0,0.00000000000000000000
chr9,4391190,4475675,84485,-1,0,,0,0.00000000000000000000
chr9,11635454,11723759,88305,-1,0,,0,0.00000000000000000000
chr9,20051032,20135627,84595,-1,0,,0,0.00000000000000000000
chr9,11964467,12015586,51119,-1,0,,0,0.00000000000000000000
chr9,28669365,28732910,63545,-1,0,158038,1,1.57368793768196000000
chr9,15296451,15379553,83102,-1,0,158219,1,1.20334047315347000000
chr9,6661562,6725750,64188,-1,0,23081,1,1.55792359942668000000
chr9,28281680,28350377,68697,-1,0,158038,1,1.45566764196399000000
chr9,7336443,7417689,81246,-1,0,,0,0.00000000000000000000
chr9,26707652,26788038,80386,-1,0,,0,0.00000000000000000000
chr9,17644175,17720255,76080,-1,0,6456,1,1.31440588853838000000
chr9,5162017,5224135,62118,-1,0,11172,1,1.60983933803406000000
chr9,11507979,11583826,75847,-1,0,,0,0.00000000000000000000
chr9,1686347,1759876,73529,-1,0,,0,0.00000000000000000000
chr9,11986043,12032009,45966,-1,0,,0,0.00000000000000000000
chr9,10254881,10325258,70377,-1,0,5789,1,1.42091876607414000000
chr9,22690901,22747922,57021,-1,0,,0,0.00000000000000000000
chr9,14755943,14813816,57873,-1,0,158326,1,1.72792148324780000000
chr9,12181410,12243172,61762,-1,0,,0,0.00000000000000000000
chr9,9952480,10019554,67074,-1,0,5789,1,1.49089065807914000000
chr9,19142751,19210226,67475,-1,0,,0,0.00000000000000000000
chr9,28585800,28636034,50234,-1,0,158038,1,1.99068360074850000000
chr9,25115134,25169239,54105,-1,0,,0,0.00000000000000000000
chr9,18182534,18246545,64011,-1,0,,0,0.00000000000000000000
chr9,22625743,22688212,62469,-1,0,,0,0.00000000000000000000
chr9,28675707,28711064,35357,-1,0,158038,1,2.82829425573437000000
chr9,12073841,12112447,38606,-1,0,,0,0.00000000000000000000
chr9,6646287,6700081,53794,-1,0,,0,0.00000000000000000000
chr9,22736206,22787133,50927,-1,0,,0,0.00000000000000000000
chr9,148734,197278,48544,-1,0,55871,1,2.05998681608438000000
chr9,11794463,11846796,52333,-1,0,,0,0.00000000000000000000
chr9,11626343,11682022,55679,-1,0,,0,0.00000000000000000000
chr9,11882983,11931663,48680,-1,0,,0,0.00000000000000000000
chr9,24702915,24756986,54071,-1,0,,0,0.00000000000000000000
chr9,12034610,12091353,56743,-1,0,,0,0.00000000000000000000
chr9,22509438,22565451,56013,-1,0,,0,0.00000000000000000000
chr9,12114505,12156986,42481,-1,0,,0,0.00000000000000000000
chr9,4202214,4257668,55454,-1,0,169792,1,1.80329642586648000000
chr9,209173,250012,40839,-1,0,81704;157983,2,4.89727956120375000000
chr9,12280483,12313035,32552,-1,0,,0,0.00000000000000000000
chr9,1232602,1285976,53374,-1,0,,0,0.00000000000000000000
chr9,11701758,11749880,48122,-1,0,,0,0.00000000000000000000
chr9,12347111,12390198,43087,-1,0,,0,0.00000000000000000000
chr9,22967617,23019251,51634,-1,0,,0,0.00000000000000000000
chr9,21174348,21215109,40761,-1,0,3441;3444;3446,3,7.35997644807537000000
chr9,12576648,12617438,40790,-1,0,,0,0.00000000000000000000
chr9,10546857,10595337,48480,-1,0,5789,1,2.06270627062706000000
chr9,575731,623371,47640,-1,0,23189,1,2.09907640638119000000
chr9,28550569,28591082,40513,-1,0,158038,1,2.46834349468072000000
chr9,12168899,12210311,41412,-1,0,,0,0.00000000000000000000
chr9,1723969,1770519,46550,-1,0,,0,0.00000000000000000000
chr9,9263980,9310461,46481,-1,0,5789,1,2.15141670790215000000
chr9,19283563,19321132,37569,-1,0,55667,1,2.66176901168517000000
chr9,28738699,28769692,30993,-1,0,158038,1,3.22653502403769000000
chr9,16941006,16982519,41513,-1,0,,0,0.00000000000000000000
chr9,9882950,9926888,43938,-1,0,5789,1,2.27593427101825000000
chr9,28772999,28816121,43122,-1,0,158038,1,2.31900190158156000000
chr9,7731365,7772771,41406,-1,0,,0,0.00000000000000000000
chr9,11912123,11953913,41790,-1,0,,0,0.00000000000000000000
chr9,28713407,28747201,33794,-1,0,158038,1,2.95910516659762000000
chr9,21199601,21235779,36178,-1,0,3451;3449;3444;3446,4,11.05644314224110000000
chr9,11812265,11852950,40685,-1,0,,0,0.00000000000000000000
chr9,12005070,12045499,40429,-1,0,,0,0.00000000000000000000
chr9,5310712,5339711,28999,-1,0,6013,1,3.44839477223353000000
chr9,4526442,4566030,39588,-1,0,6505,1,2.52601798524806000000
chr9,28538986,28568288,29302,-1,0,158038,1,3.41273633199099000000
chr9,13307070,13339147,32077,-1,0,,0,0.00000000000000000000
chr9,24635455,24673286,37831,-1,0,,0,0.00000000000000000000
chr9,6633752,6664780,31028,-1,0,2731,1,3.22289544927163000000
chr9,15598354,15629626,31272,-1,0,203238,1,3.19774878485546000000
chr9,1508197,1538267,30070,-1,0,,0,0.00000000000000000000
chr9,6220915,6251769,30854,-1,0,90865,1,3.24107084980878000000
chr9,4595490,4627113,31623,-1,0,55064,1,3.16225532049458000000
chr9,12048003,12075831,27828,-1,0,,0,0.00000000000000000000
chr9,28900877,28927862,26985,-1,0,158038,1,3.70576246062627000000
chr9,10658510,10689778,31268,-1,0,,0,0.00000000000000000000
chr9,1484160,1514596,30436,-1,0,,0,0.00000000000000000000
chr9,4416210,4446932,30722,-1,0,,0,0.00000000000000000000
chr9,12462702,12492904,30202,-1,0,,0,0.00000000000000000000
chr9,19111027,19132258,21231,-1,0,123,1,4.71009373086524000000
chr9,26339655,26362211,22556,-1,0,,0,0.00000000000000000000
chr9,9798311,9825316,27005,-1,0,5789,1,3.70301795963710000000
chr9,924525,953652,29127,-1,0,1761,1,3.43324063583617000000
chr9,29080574,29109652,29078,-1,0,158038,1,3.43902606781759000000
chr9,11908090,11932655,24565,-1,0,,0,0.00000000000000000000
chr9,8019345,8047823,28478,-1,0,,0,0.00000000000000000000
chr9,11595197,11623463,28266,-1,0,,0,0.00000000000000000000
chr9,4237191,4263631,26440,-1,0,169792,1,3.78214826021180000000
chr9,12148070,12175963,27893,-1,0,,0,0.00000000000000000000
chr9,11876459,11898773,22314,-1,0,,0,0.00000000000000000000
chr9,6689793,6712222,22429,-1,0,,0,0.00000000000000000000
chr9,10283551,10310158,26607,-1,0,5789,1,3.75840944112452000000
chr9,28080373,28102509,22136,-1,0,158038,1,4.51752800867365000000
chr9,504461,526928,22467,-1,0,23189,1,4.45097253749944000000
chr9,624417,645048,20631,-1,0,23189,1,4.84707479036402000000
chr9,24501617,24519236,17619,-1,0,,0,0.00000000000000000000
chr9,20004364,20028769,24405,-1,0,,0,0.00000000000000000000
chr9,9897931,9918165,20234,-1,0,5789,1,4.94217653454581000000
chr9,23360510,23377859,17349,-1,0,,0,0.00000000000000000000
chr9,22605626,22624194,18568,-1,0,,0,0.00000000000000000000
chr9,24504694,24524322,19628,-1,0,,0,0.00000000000000000000
chr9,28830565,28847464,16899,-1,0,158038,1,5.91750991182910000000
chr9,12108112,12130114,22002,-1,0,,0,0.00000000000000000000
chr9,29723380,29742389,19009,-1,0,,0,0.00000000000000000000
chr9,579584,594723,15139,-1,0,23189,1,6.60545610674417000000
chr9,27233226,27250671,17445,-1,0,,0,0.00000000000000000000
chr9,18302364,18320111,17747,-1,0,,0,0.00000000000000000000
chr9,590312,609095,18783,-1,0,23189,1,5.32396315817495000000
chr9,12168478,12187695,19217,-1,0,,0,0.00000000000000000000
chr9,5384897,5403795,18898,-1,0,55848,1,5.29156524499947000000
chr9,1501483,1519993,18510,-1,0,,0,0.00000000000000000000
chr9,17265404,17284897,19493,-1,0,54875,1,5.13004668342482000000
chr9,28699593,28718974,19381,-1,0,158038,1,5.15969248232805000000
chr9,26266719,26285990,19271,-1,0,,0,0.00000000000000000000
chr9,23077663,23096839,19176,-1,0,,0,0.00000000000000000000
chr9,6668526,6683674,15148,-1,0,,0,0.00000000000000000000
chr9,28809978,28829013,19035,-1,0,158038,1,5.25348043078539000000
chr9,28197079,28212231,15152,-1,0,158038,1,6.59978880675818000000
chr9,11934606,11953169,18563,-1,0,,0,0.00000000000000000000
chr9,21193328,21211520,18192,-1,0,3444;3446,2,10.99384344766930000000
chr9,515081,529697,14616,-1,0,23189,1,6.84181718664477000000
chr9,11992442,12009663,17221,-1,0,,0,0.00000000000000000000
chr9,26560064,26575272,15208,-1,0,,0,0.00000000000000000000
chr9,8003258,8018814,15556,-1,0,,0,0.00000000000000000000
chr9,20749987,20765602,15615,-1,0,54914,1,6.40409862311880000000
chr9,2281999,2298146,16147,-1,0,,0,0.00000000000000000000
chr9,4260409,4276351,15942,-1,0,169792,1,6.27273867770669000000
chr9,7829075,7844780,15705,-1,0,,0,0.00000000000000000000
chr9,7306139,7321488,15349,-1,0,,0,0.00000000000000000000
chr9,24494744,24509947,15203,-1,0,,0,0.00000000000000000000
chr9,15940990,15955766,14776,-1,0,203238,1,6.76773145641581000000
chr9,7225834,7234554,8720,-1,0,,0,0.00000000000000000000
chr9,3743607,3757758,14151,-1,0,,0,0.00000000000000000000
chr9,4008767,4022665,13898,-1,0,169792,1,7.19527989638797000000
chr9,16901098,16913939,12841,-1,0,,0,0.00000000000000000000
chr9,19142967,19157145,14178,-1,0,,0,0.00000000000000000000
chr9,22729406,22743413,14007,-1,0,,0,0.00000000000000000000
chr9,9939091,9951059,11968,-1,0,5789,1,8.35561497326203000000
chr9,514141,527934,13793,-1,0,23189,1,7.25005437540782000000
chr9,584087,596010,11923,-1,0,23189,1,8.38715088484442000000
chr9,6174336,6187106,12770,-1,0,,0,0.00000000000000000000
chr9,6700505,6710204,9699,-1,0,,0,0.00000000000000000000
chr9,11210214,11222778,12564,-1,0,,0,0.00000000000000000000
chr9,22496420,22505133,8713,-1,0,,0,0.00000000000000000000
chr9,21181065,21193206,12141,-1,0,3441,1,8.23655382587925000000
chr9,24504669,24516095,11426,-1,0,,0,0.00000000000000000000
chr9,8009424,8016985,7561,-1,0,,0,0.00000000000000000000
chr9,2144787,2155147,10360,-1,0,6595,1,9.65250965250965000000
chr9,23363174,23373410,10236,-1,0,,0,0.00000000000000000000
chr9,7505184,7516678,11494,-1,0,,0,0.00000000000000000000
chr9,6704243,6713562,9319,-1,0,,0,0.00000000000000000000
chr9,592715,602900,10185,-1,0,23189,1,9.81836033382425000000
chr9,3062903,3073643,10740,-1,0,,0,0.00000000000000000000
chr9,11962727,11973525,10798,-1,0,,0,0.00000000000000000000
chr9,15553700,15563224,9524,-1,0,203238,1,10.49979000419990000000
chr9,23363419,23371697,8278,-1,0,,0,0.00000000000000000000
chr9,4526802,4536848,10046,-1,0,6505,1,9.95421063109695000000
chr9,23290065,23299920,9855,-1,0,,0,0.00000000000000000000
chr9,28839934,28847401,7467,-1,0,158038,1,13.39225927413950000000
chr9,24142679,24150852,8173,-1,0,,0,0.00000000000000000000
chr9,5106727,5115646,8919,-1,0,3717,1,11.21201928467320000000
chr9,15815275,15821948,6673,-1,0,203238,1,14.98576352465160000000
chr9,24522683,24529132,6449,-1,0,,0,0.00000000000000000000
chr9,6055522,6064344,8822,-1,0,,0,0.00000000000000000000
chr9,15609033,15617666,8633,-1,0,203238,1,11.58345882080390000000
chr9,23005750,23014278,8528,-1,0,,0,0.00000000000000000000
chr9,23908611,23916260,7649,-1,0,,0,0.00000000000000000000
chr9,642254,648499,6245,-1,0,23189,1,16.01281024819860000000
chr9,4042875,4050747,7872,-1,0,169792,1,12.70325203252030000000
chr9,11152847,11161062,8215,-1,0,,0,0.00000000000000000000
chr9,26711593,26719758,8165,-1,0,,0,0.00000000000000000000
chr9,739601,747800,8199,-1,0,23189,1,12.19660934260280000000
chr9,6663077,6671186,8109,-1,0,,0,0.00000000000000000000
chr9,22496524,22504350,7826,-1,0,,0,0.00000000000000000000
chr9,319430,325871,6441,-1,0,81704,1,15.52553951249810000000
chr9,1446530,1452564,6034,-1,0,,0,0.00000000000000000000
chr9,8864935,8872493,7558,-1,0,5789,1,13.23101349563380000000
chr9,15310820,15318253,7433,-1,0,,0,0.00000000000000000000
chr9,9965216,9971891,6675,-1,0,5789,1,14.98127340823970000000
chr9,2144687,2150657,5970,-1,0,6595,1,16.75041876046900000000
chr9,6702904,6709047,6143,-1,0,,0,0.00000000000000000000
chr9,13571352,13576046,4694,-1,0,,0,0.00000000000000000000
chr9,26566776,26573179,6403,-1,0,,0,0.00000000000000000000
chr9,4452671,4458162,5491,-1,0,,0,0.00000000000000000000
chr9,24145475,24150462,4987,-1,0,,0,0.00000000000000000000
chr9,5202997,5209289,6292,-1,0,,0,0.00000000000000000000
chr9,29092539,29098016,5477,-1,0,158038,1,18.25817053131280000000
chr9,2191793,2197875,6082,-1,0,6595,1,16.44195988161790000000
chr9,28046003,28050948,4945,-1,0,158038,1,20.22244691607680000000
chr9,22090551,22096490,5939,-1,0,,0,0.00000000000000000000
chr9,642194,647885,5691,-1,0,23189,1,17.57160428747140000000
chr9,11934023,11939836,5813,-1,0,,0,0.00000000000000000000
chr9,17401659,17406972,5313,-1,0,54875,1,18.82175795219270000000
chr9,13896324,13901974,5650,-1,0,,0,0.00000000000000000000
chr9,24556003,24561311,5308,-1,0,,0,0.00000000000000000000
chr9,27619432,27624804,5372,-1,0,,0,0.00000000000000000000
chr9,8280895,8286242,5347,-1,0,,0,0.00000000000000000000
chr9,25156557,25161876,5319,-1,0,,0,0.00000000000000000000
chr9,11210749,11216089,5340,-1,0,,0,0.00000000000000000000
chr9,17909346,17912848,3502,-1,0,,0,0.00000000000000000000
chr9,9889867,9895067,5200,-1,0,5789,1,19.23076923076920000000
chr9,24624856,24629964,5108,-1,0,,0,0.00000000000000000000
chr9,26119541,26124673,5132,-1,0,,0,0.00000000000000000000
chr9,20799551,20804660,5109,-1,0,54914,1,19.57330201605010000000
chr9,11553044,11557526,4482,-1,0,,0,0.00000000000000000000
chr9,15605452,15610206,4754,-1,0,203238,1,21.03491796381990000000
chr9,22819810,22824789,4979,-1,0,,0,0.00000000000000000000
chr9,1355325,1360263,4938,-1,0,,0,0.00000000000000000000
chr9,17701540,17706214,4674,-1,0,6456,1,21.39495079161320000000
chr9,10447083,10451772,4689,-1,0,5789,1,21.32650885050120000000
chr9,12143084,12147673,4589,-1,0,,0,0.00000000000000000000
chr9,13963515,13968039,4524,-1,0,,0,0.00000000000000000000
chr9,14287277,14291408,4131,-1,0,4781,1,24.20721374969740000000
chr9,16955635,16960026,4391,-1,0,,0,0.00000000000000000000
chr9,15595660,15600030,4370,-1,0,203238,1,22.88329519450800000000
chr9,11137850,11142118,4268,-1,0,,0,0.00000000000000000000
chr9,11506439,11510142,3703,-1,0,,0,0.00000000000000000000
chr9,2147651,2151531,3880,-1,0,6595,1,25.77319587628870000000
chr9,12556624,12559879,3255,-1,0,,0,0.00000000000000000000
chr9,28845195,28849192,3997,-1,0,158038,1,25.01876407305480000000
chr9,4527213,4531199,3986,-1,0,6505,1,25.08780732563970000000
chr9,12907752,12911698,3946,-1,0,,0,0.00000000000000000000
chr9,13065766,13069711,3945,-1,0,,0,0.00000000000000000000
chr9,1446958,1450321,3363,-1,0,,0,0.00000000000000000000
chr9,10404465,10407452,2987,-1,0,5789,1,33.47840642785400000000
chr9,11691561,11694411,2850,-1,0,,0,0.00000000000000000000
chr9,19018559,19021968,3409,-1,0,158297,1,29.33411557641540000000
chr9,320108,322515,2407,-1,0,81704,1,41.54549231408390000000
chr9,18045772,18049102,3330,-1,0,,0,0.00000000000000000000
chr9,28661946,28665145,3199,-1,0,158038,1,31.25976867771180000000
chr9,125153,128236,3083,-1,0,55871,1,32.43593902043460000000
chr9,577303,580467,3164,-1,0,23189,1,31.60556257901390000000
chr9,6672236,6675369,3133,-1,0,,0,0.00000000000000000000
chr9,29094547,29097676,3129,-1,0,158038,1,31.95909236177690000000
chr9,8660178,8662277,2099,-1,0,5789,1,47.64173415912340000000
chr9,19671767,19673475,1708,-1,0,25769,1,58.54800936768150000000
chr9,6728647,6731276,2629,-1,0,23081,1,38.03727653100040000000
chr9,25218611,25221569,2958,-1,0,,0,0.00000000000000000000
chr9,22664980,22667374,2394,-1,0,,0,0.00000000000000000000
chr9,4501055,4503977,2922,-1,0,6505,1,34.22313483915130000000
chr9,28077542,28079205,1663,-1,0,158038,1,60.13229104028860000000
chr9,28047660,28050373,2713,-1,0,158038,1,36.85956505713230000000
chr9,6507958,6510741,2783,-1,0,,0,0.00000000000000000000
chr9,22192367,22195138,2771,-1,0,,0,0.00000000000000000000
chr9,18662859,18665509,2650,-1,0,92949,1,37.73584905660380000000
chr9,16882510,16885049,2539,-1,0,,0,0.00000000000000000000
chr9,10020070,10022636,2566,-1,0,5789,1,38.97116134060790000000
chr9,4376226,4377884,1658,-1,0,,0,0.00000000000000000000
chr9,28057572,28060055,2483,-1,0,158038,1,40.27386226339110000000
chr9,5641292,5643074,1782,-1,0,57589,1,56.11672278338950000000
chr9,21592303,21594698,2395,-1,0,,0,0.00000000000000000000
chr9,15157364,15159583,2219,-1,0,,0,0.00000000000000000000
chr9,11348445,11350749,2304,-1,0,,0,0.00000000000000000000
chr9,24876340,24878621,2281,-1,0,,0,0.00000000000000000000
chr9,9893753,9895975,2222,-1,0,5789,1,45.00450045004500000000
chr9,6708607,6710744,2137,-1,0,,0,0.00000000000000000000
chr9,6399559,6401689,2130,-1,0,,0,0.00000000000000000000
chr9,14686739,14688652,1913,-1,0,340481,1,52.27391531625720000000
chr9,2148808,2150655,1847,-1,0,6595,1,54.14185165132650000000
chr9,11784210,11785918,1708,-1,0,,0,0.00000000000000000000
chr9,10136557,10137722,1165,-1,0,5789,1,85.83690987124460000000
chr9,273724,275654,1930,-1,0,81704,1,51.81347150259070000000
chr9,12132972,12134908,1936,-1,0,,0,0.00000000000000000000
chr9,25722840,25724759,1919,-1,0,,0,0.00000000000000000000
chr9,4017820,4019713,1893,-1,0,169792,1,52.82620179609090000000
chr9,4734945,4736849,1904,-1,0,50808,1,52.52100840336130000000
chr9,15815299,15817182,1883,-1,0,203238,1,53.10674455655870000000
chr9,10360903,10362689,1786,-1,0,5789,1,55.99104143337070000000
chr9,2286280,2288062,1782,-1,0,,0,0.00000000000000000000
chr9,3779819,3781485,1666,-1,0,,0,0.00000000000000000000
chr9,17910030,17911782,1752,-1,0,,0,0.00000000000000000000
chr9,707241,708549,1308,-1,0,23189,1,76.45259938837920000000
chr9,28846313,28847967,1654,-1,0,158038,1,60.45949214026600000000
chr9,22666036,22667329,1293,-1,0,,0,0.00000000000000000000
chr9,4397083,4398734,1651,-1,0,,0,0.00000000000000000000
chr9,5750167,5751760,1593,-1,0,57589,1,62.77463904582550000000
chr9,1447333,1448456,1123,-1,0,,0,0.00000000000000000000
chr9,28584536,28585606,1070,-1,0,158038,1,93.45794392523360000000
chr9,634863,636453,1590,-1,0,23189,1,62.89308176100630000000
chr9,5750004,5751466,1462,-1,0,57589,1,68.39945280437760000000
chr9,320864,322398,1534,-1,0,81704,1,65.18904823989570000000
chr9,19272865,19274387,1522,-1,0,55667,1,65.70302233902760000000
chr9,493415,494904,1489,-1,0,23189,1,67.15916722632640000000
chr9,20212033,20213492,1459,-1,0,,0,0.00000000000000000000
chr9,26415431,26416889,1458,-1,0,,0,0.00000000000000000000
chr9,12185696,12187095,1399,-1,0,,0,0.00000000000000000000
chr9,23370987,23372430,1443,-1,0,,0,0.00000000000000000000
chr9,8640900,8641840,940,-1,0,5789,1,106.38297872340400000000
chr9,25776273,25777311,1038,-1,0,,0,0.00000000000000000000
chr9,12907642,12909001,1359,-1,0,,0,0.00000000000000000000
chr9,19358434,19359742,1308,-1,0,55667,1,76.45259938837920000000
chr9,4628170,4629430,1260,-1,0,55064,1,79.36507936507940000000
chr9,4376393,4377629,1236,-1,0,,0,0.00000000000000000000
chr9,15050604,15051821,1217,-1,0,,0,0.00000000000000000000
chr9,5641635,5642808,1173,-1,0,57589,1,85.25149190110830000000
chr9,29259557,29260753,1196,-1,0,,0,0.00000000000000000000
chr9,2141555,2142685,1130,-1,0,6595,1,88.49557522123890000000
chr9,20077965,20079129,1164,-1,0,,0,0.00000000000000000000
chr9,20087762,20088885,1123,-1,0,,0,0.00000000000000000000
chr9,6729127,6730095,968,-1,0,23081,1,103.30578512396700000000
chr9,25030789,25031846,1057,-1,0,,0,0.00000000000000000000
chr9,9516945,9517995,1050,-1,0,5789,1,95.23809523809520000000
chr9,9692155,9693216,1061,-1,0,5789,1,94.25070688030160000000
chr9,24497961,24498950,989,-1,0,,0,0.00000000000000000000
chr9,11511138,11512091,953,-1,0,,0,0.00000000000000000000
chr9,603732,604660,928,-1,0,23189,1,107.75862068965500000000
chr9,16289379,16290271,892,-1,0,,0,0.00000000000000000000
chr9,707095,707985,890,-1,0,23189,1,112.35955056179800000000
chr9,5133114,5133978,864,-1,0,,0,0.00000000000000000000
chr9,3835758,3836598,840,-1,0,169792,1,119.04761904761900000000
chr9,4208808,4209502,694,-1,0,169792,1,144.09221902017300000000
chr9,707538,708278,740,-1,0,23189,1,135.13513513513500000000
chr9,6701895,6702636,741,-1,0,,0,0.00000000000000000000
chr9,22653294,22653913,619,-1,0,,0,0.00000000000000000000
chr9,16332122,16332694,572,-1,0,,0,0.00000000000000000000
chr9,28584691,28585269,578,-1,0,158038,1,173.01038062283700000000
chr9,703262,704027,765,-1,0,23189,1,130.71895424836600000000
chr9,19547513,19548289,776,-1,0,25769,1,128.86597938144300000000
chr9,23857394,23858140,746,-1,0,,0,0.00000000000000000000
chr9,10404456,10405151,695,-1,0,5789,1,143.88489208633100000000
chr9,25593976,25594567,591,-1,0,,0,0.00000000000000000000
chr9,8640822,8641531,709,-1,0,5789,1,141.04372355430200000000
chr9,22999388,22999945,557,-1,0,,0,0.00000000000000000000
chr9,4376386,4377075,689,-1,0,,0,0.00000000000000000000
chr9,2000865,2001421,556,-1,0,,0,0.00000000000000000000
chr9,29591759,29592469,710,-1,0,,0,0.00000000000000000000
chr9,16389295,16389864,569,-1,0,,0,0.00000000000000000000
chr9,29624598,29625146,548,-1,0,,0,0.00000000000000000000
chr9,12897901,12898405,504,-1,0,,0,0.00000000000000000000
chr9,15602323,15602865,542,-1,0,203238,1,184.50184501845000000000
chr9,6999228,6999793,565,-1,0,23081,1,176.99115044247800000000
chr9,8081802,8082499,697,-1,0,,0,0.00000000000000000000
chr9,28409732,28410182,450,-1,0,158038,1,222.22222222222200000000
chr9,21917953,21918483,530,-1,0,,0,0.00000000000000000000
chr9,544881,545433,552,-1,0,23189,1,181.15942028985500000000
chr9,6888687,6889149,462,-1,0,23081,1,216.45021645021600000000
chr9,8510682,8511348,666,-1,0,5789,1,150.15015015015000000000
chr9,27709947,27710415,468,-1,0,,0,0.00000000000000000000
chr9,8921084,8921772,688,-1,0,5789,1,145.34883720930200000000
chr9,8781894,8782348,454,-1,0,5789,1,220.26431718061700000000
chr9,10498675,10499131,456,-1,0,5789,1,219.29824561403500000000
chr9,24356323,24356853,530,-1,0,,0,0.00000000000000000000
chr9,23074992,23075561,569,-1,0,,0,0.00000000000000000000
chr9,7371698,7372236,538,-1,0,,0,0.00000000000000000000
chr9,4537230,4537708,478,-1,0,6505,1,209.20502092050200000000
chr9,4346568,4347077,509,-1,0,,0,0.00000000000000000000
chr9,25776716,25777171,455,-1,0,,0,0.00000000000000000000
chr9,11433011,11433535,524,-1,0,,0,0.00000000000000000000
chr9,10908701,10909200,499,-1,0,,0,0.00000000000000000000
chr9,3780597,3781048,451,-1,0,,0,0.00000000000000000000
chr9,22991725,22992239,514,-1,0,,0,0.00000000000000000000
chr9,11408497,11408961,464,-1,0,,0,0.00000000000000000000
chr9,20973769,20974345,576,-1,0,54914,1,173.61111111111100000000
chr9,22123567,22124106,539,-1,0,,0,0.00000000000000000000
chr9,22057807,22058273,466,-1,0,,0,0.00000000000000000000
chr9,6729261,6729815,554,-1,0,23081,1,180.50541516245500000000
chr9,19278987,19279297,310,-1,0,55667,1,322.58064516129000000000
chr9,469305,469737,432,-1,0,,0,0.00000000000000000000
chr9,9950407,9950815,408,-1,0,5789,1,245.09803921568600000000
chr9,22666406,22666924,518,-1,0,,0,0.00000000000000000000
chr9,10828042,10828465,423,-1,0,,0,0.00000000000000000000
chr9,6276186,6276581,395,-1,0,,0,0.00000000000000000000
chr9,888494,888927,433,-1,0,1761,1,230.94688221709000000000
chr9,547407,547750,343,-1,0,23189,1,291.54518950437300000000
chr9,18286481,18286849,368,-1,0,,0,0.00000000000000000000
chr9,8069368,8069722,354,-1,0,,0,0.00000000000000000000
chr9,14632473,14632746,273,-1,0,340481,1,366.30036630036600000000
chr9,23328678,23329030,352,-1,0,,0,0.00000000000000000000
chr9,22653367,22653768,401,-1,0,,0,0.00000000000000000000
chr9,26512905,26513267,362,-1,0,,0,0.00000000000000000000
chr9,16332204,16332586,382,-1,0,,0,0.00000000000000000000
chr9,15394872,15395231,359,-1,0,,0,0.00000000000000000000
chr9,18508880,18509280,400,-1,0,92949,1,250.00000000000000000000
chr9,18751816,18752139,323,-1,0,92949,1,309.59752321981400000000
chr9,7367095,7367348,253,-1,0,,0,0.00000000000000000000
chr9,8848767,8849002,235,-1,0,5789,1,425.53191489361700000000
chr9,25594087,25594448,361,-1,0,,0,0.00000000000000000000
chr9,19473800,19474080,280,-1,0,,0,0.00000000000000000000
chr9,7194689,7194918,229,-1,0,,0,0.00000000000000000000
chr9,6888761,6889088,327,-1,0,23081,1,305.81039755351700000000
chr9,9134043,9134382,339,-1,0,5789,1,294.98525073746300000000
chr9,16389403,16389738,335,-1,0,,0,0.00000000000000000000
chr9,23075121,23075426,305,-1,0,,0,0.00000000000000000000
chr9,4346681,4346998,317,-1,0,,0,0.00000000000000000000
chr9,22999503,22999835,332,-1,0,,0,0.00000000000000000000
chr9,12897966,12898297,331,-1,0,,0,0.00000000000000000000
chr9,10498743,10499057,314,-1,0,5789,1,318.47133757961800000000
chr9,7371812,7372130,318,-1,0,,0,0.00000000000000000000
chr9,6999375,6999690,315,-1,0,23081,1,317.46031746031700000000
chr9,23115018,23115320,302,-1,0,,0,0.00000000000000000000
chr9,29624709,29625030,321,-1,0,,0,0.00000000000000000000
chr9,11433120,11433434,314,-1,0,,0,0.00000000000000000000
chr9,10908809,10909099,290,-1,0,,0,0.00000000000000000000
chr9,6276096,6276383,287,-1,0,,0,0.00000000000000000000
chr9,508544,508825,281,-1,0,23189,1,355.87188612099600000000
chr9,17277056,17277293,237,-1,0,54875,1,421.94092827004200000000
chr9,19279051,19279304,253,-1,0,55667,1,395.25691699604700000000
chr9,3656599,3656807,208,-1,0,,0,0.00000000000000000000
chr9,3393534,3393769,235,-1,0,5991,1,425.53191489361700000000
chr9,18286559,18286739,180,-1,0,,0,0.00000000000000000000
chr9,14632524,14632696,172,-1,0,340481,1,581.39534883720900000000
chr9,7367109,7367246,137,-1,0,,0,0.00000000000000000000
chr9,6217848,6217988,140,-1,0,90865,1,714.28571428571400000000
chr9,16847392,16847517,125,-1,0,54796,1,800.00000000000000000000
chr9,8782027,8782132,105,-1,0,5789,1,952.38095238095300000000
chr9,27788195,27788307,112,-1,0,,0,0.00000000000000000000
chr9,16332322,16332437,115,-1,0,,0,0.00000000000000000000
chr9,707562,707676,114,-1,0,23189,1,877.19298245614000000000
chr9,22058034,22058146,112,-1,0,,0,0.00000000000000000000
chr9,26814379,26814473,94,-1,0,,0,0.00000000000000000000
chr9,25776930,25777017,87,-1,0,,0,0.00000000000000000000
chr9,22057949,22058041,92,-1,0,,0,0.00000000000000000000
chr9,19122484,19122580,96,-1,0,123,1,1041.66666666667000000000
chr9,28584927,28585019,92,-1,0,158038,1,1086.95652173913000000000
chr9,27670564,27670640,76,-1,0,,0,0.00000000000000000000
chr9,4075063,4075148,85,-1,0,169792,1,1176.47058823529000000000
chr9,15602581,15602667,86,-1,0,203238,1,1162.79069767442000000000
chr9,18942025,18942107,82,-1,0,158297,1,1219.51219512195000000000
chr9,19473944,19474019,75,-1,0,,0,0.00000000000000000000
chr9,14388363,14388414,51,-1,0,4781,1,1960.78431372549000000000
chr9,19427991,19428042,51,-1,0,340485,1,1960.78431372549000000000
chr9,30700104,31002183,302079,-1,0,,0,0.00000000000000000000
chr9,30554963,30743640,188677,-1,0,,0,0.00000000000000000000
chr9,30423350,30565444,142094,-1,0,,0,0.00000000000000000000
chr9,30048247,30159171,110924,-1,0,,0,0.00000000000000000000
chr9,30515992,30616641,100649,-1,0,,0,0.00000000000000000000
chr9,30637203,30725507,88304,-1,0,,0,0.00000000000000000000
chr9,30587865,30671368,83503,-1,0,,0,0.00000000000000000000
chr9,29923569,30000103,76534,-1,0,,0,0.00000000000000000000
chr9,30419480,30487685,68205,-1,0,,0,0.00000000000000000000
chr9,30559856,30606578,46722,-1,0,,0,0.00000000000000000000
chr9,30540207,30578164,37957,-1,0,,0,0.00000000000000000000
chr9,30125938,30166897,40959,-1,0,,0,0.00000000000000000000
chr9,30507765,30521719,13954,-1,0,,0,0.00000000000000000000
chr9,29925137,29935500,10363,-1,0,,0,0.00000000000000000000
chr9,30018389,30023417,5028,-1,0,,0,0.00000000000000000000
chr9,30997476,31001470,3994,-1,0,,0,0.00000000000000000000
chr9,30908182,30909390,1208,-1,0,,0,0.00000000000000000000
chr9,30345663,30346212,549,-1,0,,0,0.00000000000000000000
chr9,30491282,30491617,335,-1,0,,0,0.00000000000000000000
chr9,30345776,30346094,318,-1,0,,0,0.00000000000000000000
chr9,31042917,31043141,224,-1,0,,0,0.00000000000000000000
chr9,30004910,30005002,92,-1,0,,0,0.00000000000000000000
chr9,29932800,29932891,91,-1,0,,0,0.00000000000000000000
chr9,31202914,31598403,395489,-1,0,,0,0.00000000000000000000
chr9,31174594,31250115,75521,-1,0,,0,0.00000000000000000000
chr9,31301894,31390075,88181,-1,0,,0,0.00000000000000000000
chr9,31291352,31292672,1320,-1,0,,0,0.00000000000000000000
chr9,31947104,31948444,1340,-1,0,,0,0.00000000000000000000
chr9,31239824,31240067,243,-1,0,,0,0.00000000000000000000
chr9,32107355,32107423,68,-1,0,,0,0.00000000000000000000
chr9,32315156,32315459,303,-1,0,,0,0.00000000000000000000
chr9,32712076,32730874,18798,-1,0,,0,0.00000000000000000000
chr9,32900493,32901167,674,-1,0,,0,0.00000000000000000000
chr9,32900701,32901034,333,-1,0,,0,0.00000000000000000000
chr9,33050726,33051245,519,-1,0,55234,1,192.67822736030800000000
chr9,33050826,33051138,312,-1,0,55234,1,320.51282051282000000000
chr9,33213067,33213929,862,-1,0,,0,0.00000000000000000000
chr9,33251833,33252417,584,-1,0,,0,0.00000000000000000000
chr9,33252086,33252250,164,-1,0,,0,0.00000000000000000000
chr9,33376718,33378937,2219,-1,0,,0,0.00000000000000000000
chr9,33423028,33424936,1908,-1,0,,0,0.00000000000000000000
chr9,33423361,33424654,1293,-1,0,,0,0.00000000000000000000
chr9,33442343,33446826,4483,-1,0,360,1,22.30649118893600000000
chr9,33488687,33492818,4131,-1,0,,0,0.00000000000000000000
chr9,33573367,33574182,815,-1,0,,0,0.00000000000000000000
chr9,33604175,33604595,420,-1,0,,0,0.00000000000000000000
chr9,33707455,33708551,1096,-1,0,,0,0.00000000000000000000
chr9,33792485,33806350,13865,-1,0,5646,1,7.21240533717995000000
chr9,33909642,33910413,771,-1,0,54926,1,129.70168612192000000000
chr9,34051192,34058516,7324,-1,0,,0,0.00000000000000000000
chr9,34055541,34059148,3607,-1,0,,0,0.00000000000000000000
chr9,34056364,34056574,210,-1,0,,0,0.00000000000000000000
chr9,34110850,34117047,6197,-1,0,25853,1,16.13684040664840000000
chr9,34135082,34135918,836,-1,0,,0,0.00000000000000000000
chr9,34181523,34182297,774,-1,0,51271,1,129.19896640826900000000
chr9,34726148,34835262,109114,-1,0,259308,1,0.91647267994941100000
chr9,34737001,34737791,790,-1,0,,0,0.00000000000000000000
chr9,34935412,34938803,3391,-1,0,,0,0.00000000000000000000
chr9,35364129,35364311,182,-1,0,10497,1,549.45054945054900000000
chr9,35372445,35374785,2340,-1,0,10497,1,42.73504273504270000000
chr9,35372881,35374198,1317,-1,0,10497,1,75.93014426727410000000
chr9,35662913,35664519,1606,-1,0,84904,1,62.26650062266500000000
chr9,35803005,35803510,505,-1,0,4882,1,198.01980198019800000000
chr9,35803106,35803415,309,-1,0,4882,1,323.62459546925600000000
chr9,35913244,35914414,1170,-1,0,,0,0.00000000000000000000
chr9,35913695,35914106,411,-1,0,,0,0.00000000000000000000
chr9,35913292,35913571,279,-1,0,,0,0.00000000000000000000
chr9,35980777,35982017,1240,-1,0,,0,0.00000000000000000000
chr9,35980982,35981815,833,-1,0,,0,0.00000000000000000000
chr9,36008801,36009196,395,-1,0,,0,0.00000000000000000000
chr9,36008977,36009041,64,-1,0,,0,0.00000000000000000000
chr9,36309258,36309677,419,-1,0,,0,0.00000000000000000000
chr9,36341797,36341858,61,-1,0,152006,1,1639.34426229508000000000
chr9,36362064,36364219,2155,-1,0,152006,1,46.40371229698380000000
chr9,36362810,36364087,1277,-1,0,152006,1,78.30853563038370000000
chr9,36423528,36424097,569,-1,0,,0,0.00000000000000000000
chr9,36423667,36424005,338,-1,0,,0,0.00000000000000000000
chr9,36456416,36457164,748,-1,0,,0,0.00000000000000000000
chr9,36474173,36475014,841,-1,0,,0,0.00000000000000000000
chr9,36487194,36488155,961,-1,0,,0,0.00000000000000000000
chr9,36588196,36588523,327,-1,0,9833,1,305.81039755351700000000
chr9,37057192,37102384,45192,-1,0,,0,0.00000000000000000000
chr9,38066826,38069867,3041,-1,0,6461,1,32.88391976323580000000
chr9,38067942,38069609,1667,-1,0,6461,1,59.98800239952010000000
chr9,38075797,38075957,160,-1,0,,0,0.00000000000000000000
chr9,38482765,38670538,187773,-1,0,253650,1,0.53255792898872600000
chr9,38489020,38498367,9347,-1,0,,0,0.00000000000000000000
chr9,38547130,38556634,9504,-1,0,,0,0.00000000000000000000
chr9,38555832,38565188,9356,-1,0,,0,0.00000000000000000000
chr9,38514210,38517728,3518,-1,0,,0,0.00000000000000000000
chr9,38668871,38669800,929,-1,0,,0,0.00000000000000000000
chr9,38678611,38678995,384,-1,0,,0,0.00000000000000000000
chr9,38764827,38764894,67,-1,0,,0,0.00000000000000000000
chr9,41870992,44348349,2477357,-1,0,728577;441430;389730;441425,4,0.16146239722413800000
chr9,39016395,40307796,1291401,-1,0,79937;647060,2,0.15487056305516300000
chr9,43466094,44505240,1039146,-1,0,728577;389730,2,0.19246573628729700000
chr9,40842268,41952997,1110729,-1,0,727905,1,0.09003096164771060000
chr9,44213942,44934574,720632,-1,0,,0,0.00000000000000000000
chr9,43087033,44104729,1017696,-1,0,728577;389730;441425,3,0.29478351098952900000
chr9,44283084,44838622,555538,-1,0,,0,0.00000000000000000000
chr9,43300322,43790610,490288,-1,0,728577;389730,2,0.40792350618412000000
chr9,45956039,46417167,461128,-1,0,,0,0.00000000000000000000
chr9,43571420,44205791,634371,-1,0,728577;389730,2,0.31527292388838700000
chr9,38791241,39365594,574353,-1,0,79937;647060,2,0.34821790780234500000
chr9,39537839,39986830,448991,-1,0,,0,0.00000000000000000000
chr9,39184449,39626755,442306,-1,0,79937;647060,2,0.45217564310680800000
chr9,41500521,41918876,418355,-1,0,727905,1,0.23903144458653500000
chr9,44520277,44851317,331040,-1,0,,0,0.00000000000000000000
chr9,43511043,43793672,282629,-1,0,728577;389730,2,0.70764146637464700000
chr9,44447658,44787261,339603,-1,0,,0,0.00000000000000000000
chr9,41439883,41697428,257545,-1,0,727905,1,0.38828165951581300000
chr9,45356392,45596531,240139,-1,0,,0,0.00000000000000000000
chr9,45130839,45300216,169377,-1,0,,0,0.00000000000000000000
chr9,43584760,43755000,170240,-1,0,728577;389730,2,1.17481203007519000000
chr9,43418998,43550325,131327,-1,0,,0,0.00000000000000000000
chr9,38774780,38961676,186896,-1,0,,0,0.00000000000000000000
chr9,44727855,44850315,122460,-1,0,,0,0.00000000000000000000
chr9,40476997,40626859,149862,-1,0,,0,0.00000000000000000000
chr9,43694044,43842079,148035,-1,0,728577,1,0.67551592528793900000
chr9,43316306,43446377,130071,-1,0,,0,0.00000000000000000000
chr9,41618343,41741997,123654,-1,0,,0,0.00000000000000000000
chr9,46342514,46426626,84112,-1,0,,0,0.00000000000000000000
chr9,41280707,41359527,78820,-1,0,,0,0.00000000000000000000
chr9,43589946,43694171,104225,-1,0,728577;389730,2,1.91892540177501000000
chr9,39151407,39280790,129383,-1,0,79937,1,0.77289906711082600000
chr9,39713727,39810148,96421,-1,0,,0,0.00000000000000000000
chr9,43313951,43398081,84130,-1,0,,0,0.00000000000000000000
chr9,44728485,44801258,72773,-1,0,,0,0.00000000000000000000
chr9,43689419,43754285,64866,-1,0,728577,1,1.54163968797213000000
chr9,43373245,43445792,72547,-1,0,,0,0.00000000000000000000
chr9,46353189,46414868,61679,-1,0,,0,0.00000000000000000000
chr9,39140766,39206559,65793,-1,0,79937,1,1.51991853236667000000
chr9,44728162,44778526,50364,-1,0,,0,0.00000000000000000000
chr9,44806424,44853268,46844,-1,0,,0,0.00000000000000000000
chr9,44429393,44467687,38294,-1,0,,0,0.00000000000000000000
chr9,45056501,45096100,39599,-1,0,,0,0.00000000000000000000
chr9,44252593,44277365,24772,-1,0,,0,0.00000000000000000000
chr9,44859249,44891402,32153,-1,0,,0,0.00000000000000000000
chr9,40134776,40158918,24142,-1,0,,0,0.00000000000000000000
chr9,43652222,43676158,23936,-1,0,,0,0.00000000000000000000
chr9,40594442,40620155,25713,-1,0,,0,0.00000000000000000000
chr9,43450143,43463490,13347,-1,0,,0,0.00000000000000000000
chr9,38774433,38791468,17035,-1,0,,0,0.00000000000000000000
chr9,45424104,45443275,19171,-1,0,,0,0.00000000000000000000
chr9,41970685,41985395,14710,-1,0,,0,0.00000000000000000000
chr9,38860174,38874595,14421,-1,0,,0,0.00000000000000000000
chr9,44779035,44790498,11463,-1,0,,0,0.00000000000000000000
chr9,41724760,41736716,11956,-1,0,,0,0.00000000000000000000
chr9,43465852,43477544,11692,-1,0,,0,0.00000000000000000000
chr9,44726698,44739390,12692,-1,0,,0,0.00000000000000000000
chr9,45224829,45235025,10196,-1,0,,0,0.00000000000000000000
chr9,43044257,43052233,7976,-1,0,,0,0.00000000000000000000
chr9,38859975,38869110,9135,-1,0,,0,0.00000000000000000000
chr9,44626043,44633517,7474,-1,0,,0,0.00000000000000000000
chr9,41096859,41103394,6535,-1,0,,0,0.00000000000000000000
chr9,43653000,43659823,6823,-1,0,,0,0.00000000000000000000
chr9,41727852,41734441,6589,-1,0,,0,0.00000000000000000000
chr9,44875054,44880906,5852,-1,0,,0,0.00000000000000000000
chr9,38868404,38874069,5665,-1,0,,0,0.00000000000000000000
chr9,40228724,40232541,3817,-1,0,,0,0.00000000000000000000
chr9,44727007,44730500,3493,-1,0,,0,0.00000000000000000000
chr9,43467980,43471012,3032,-1,0,,0,0.00000000000000000000
chr9,44877659,44880024,2365,-1,0,,0,0.00000000000000000000
chr9,40373626,40375383,1757,-1,0,,0,0.00000000000000000000
chr9,44143277,44144976,1699,-1,0,,0,0.00000000000000000000
chr9,45679411,45681102,1691,-1,0,,0,0.00000000000000000000
chr9,44511956,44513386,1430,-1,0,,0,0.00000000000000000000
chr9,43353045,43354455,1410,-1,0,,0,0.00000000000000000000
chr9,43468572,43469793,1221,-1,0,,0,0.00000000000000000000
chr9,41732582,41733639,1057,-1,0,,0,0.00000000000000000000
chr9,43658946,43659689,743,-1,0,,0,0.00000000000000000000
chr9,44893850,44894489,639,-1,0,,0,0.00000000000000000000
chr9,39012364,39012851,487,-1,0,,0,0.00000000000000000000
chr9,39012486,39012767,281,-1,0,,0,0.00000000000000000000
chr9,67037901,67260322,222421,-1,0,,0,0.00000000000000000000
chr9,65762376,65932841,170465,-1,0,,0,0.00000000000000000000
chr9,65607845,65687792,79947,-1,0,,0,0.00000000000000000000
chr9,67710948,67763913,52965,-1,0,,0,0.00000000000000000000
chr9,67557608,67612269,54661,-1,0,,0,0.00000000000000000000
chr9,67516332,67565655,49323,-1,0,,0,0.00000000000000000000
chr9,65594593,65629772,35179,-1,0,,0,0.00000000000000000000
chr9,68175488,68195876,20388,-1,0,,0,0.00000000000000000000
chr9,67557252,67569808,12556,-1,0,,0,0.00000000000000000000
chr9,65857937,65868335,10398,-1,0,,0,0.00000000000000000000
chr9,67557709,67565022,7313,-1,0,,0,0.00000000000000000000
chr9,66850357,66856384,6027,-1,0,,0,0.00000000000000000000
chr9,66501690,66506675,4985,-1,0,,0,0.00000000000000000000
chr9,68186051,68188547,2496,-1,0,,0,0.00000000000000000000
chr9,66532311,66533449,1138,-1,0,,0,0.00000000000000000000
chr9,66848325,66849371,1046,-1,0,,0,0.00000000000000000000
chr9,68831029,69927602,1096573,-1,0,653404;728747;644019,3,0.27357959752793500000
chr9,68821219,69522632,701413,-1,0,653404;728747;644019,3,0.42770806928300400000
chr9,69504001,69892021,388020,-1,0,,0,0.00000000000000000000
chr9,68744734,69176618,431884,-1,0,,0,0.00000000000000000000
chr9,69144788,69525369,380581,-1,0,653404;728747;644019,3,0.78826846321808000000
chr9,69736384,70100959,364575,-1,0,,0,0.00000000000000000000
chr9,69474206,69695993,221787,-1,0,,0,0.00000000000000000000
chr9,69821914,69963685,141771,-1,0,,0,0.00000000000000000000
chr9,68757019,68837844,80825,-1,0,,0,0.00000000000000000000
chr9,69960545,69993309,32764,-1,0,,0,0.00000000000000000000
chr9,69453010,69470661,17651,-1,0,,0,0.00000000000000000000
chr9,69354325,69375885,21560,-1,0,,0,0.00000000000000000000
chr9,68298426,68315577,17151,-1,0,,0,0.00000000000000000000
chr9,69505946,69522825,16879,-1,0,,0,0.00000000000000000000
chr9,68439965,68445356,5391,-1,0,,0,0.00000000000000000000
chr9,69784345,69787991,3646,-1,0,,0,0.00000000000000000000
chr9,68411455,68414092,2637,-1,0,,0,0.00000000000000000000
chr9,68999174,69001504,2330,-1,0,,0,0.00000000000000000000
chr9,68996415,68997758,1343,-1,0,,0,0.00000000000000000000
chr9,68422481,68423874,1393,-1,0,,0,0.00000000000000000000
chr9,68424475,68424725,250,-1,0,,0,0.00000000000000000000
chr9,68495493,68495721,228,-1,0,,0,0.00000000000000000000
chr9,71198597,71198709,112,-1,0,,0,0.00000000000000000000
chr9,71321698,71323100,1402,-1,0,8395,1,71.32667617689020000000
chr9,71665225,71665676,451,-1,0,2395,1,221.72949002217300000000
chr9,71665310,71665554,244,-1,0,2395,1,409.83606557377000000000
chr9,71671687,71671898,211,-1,0,2395,1,473.93364928910000000000
chr9,71703017,71703456,439,-1,0,2395,1,227.79043280182200000000
chr9,71736526,71745586,9060,-1,0,9414,1,11.03752759381900000000
chr9,71738132,71743376,5244,-1,0,9414,1,19.06941266209000000000
chr9,71738108,71743081,4973,-1,0,9414,1,20.10858636637840000000
chr9,71740194,71742844,2650,-1,0,9414,1,37.73584905660380000000
chr9,71777835,71778384,549,-1,0,9414,1,182.14936247723100000000
chr9,71777926,71778244,318,-1,0,9414,1,314.46540880503100000000
chr9,71804519,71804997,478,-1,0,9414,1,209.20502092050200000000
chr9,71895561,71898810,3249,-1,0,,0,0.00000000000000000000
chr9,71895451,71896522,1071,-1,0,,0,0.00000000000000000000
chr9,71895608,71896449,841,-1,0,,0,0.00000000000000000000
chr9,72093470,72123265,29795,-1,0,320,1,3.35626783017285000000
chr9,72100979,72115601,14622,-1,0,320,1,6.83900971139379000000
chr9,72151081,72153033,1952,-1,0,320,1,51.22950819672130000000
chr9,72422654,72423323,669,-1,0,,0,0.00000000000000000000
chr9,72653148,72653457,309,-1,0,,0,0.00000000000000000000
chr9,72761788,72763887,2099,-1,0,256691,1,47.64173415912340000000
chr9,72762248,72763460,1212,-1,0,256691,1,82.50825082508250000000
chr9,72801769,72820514,18745,-1,0,256691,1,5.33475593491598000000
chr9,73316717,73352708,35991,-1,0,80036,1,2.77847239587675000000
chr9,73463493,73464040,547,-1,0,80036,1,182.81535648994500000000
chr9,73463588,73463904,316,-1,0,80036,1,316.45569620253200000000
chr9,73501019,73514523,13504,-1,0,80036,1,7.40521327014218000000
chr9,73766023,73771877,5854,-1,0,,0,0.00000000000000000000
chr9,73896972,73897436,464,-1,0,,0,0.00000000000000000000
chr9,73897071,73897348,277,-1,0,,0,0.00000000000000000000
chr9,73897185,73897346,161,-1,0,,0,0.00000000000000000000
chr9,73906399,73950475,44076,-1,0,,0,0.00000000000000000000
chr9,73992390,73997932,5542,-1,0,,0,0.00000000000000000000
chr9,74255074,74261204,6130,-1,0,,0,0.00000000000000000000
chr9,74256666,74260001,3335,-1,0,,0,0.00000000000000000000
chr9,74269299,74269770,471,-1,0,,0,0.00000000000000000000
chr9,74269391,74269671,280,-1,0,,0,0.00000000000000000000
chr9,74375318,74375618,300,-1,0,23670,1,333.33333333333300000000
chr9,74448956,74449926,970,-1,0,,0,0.00000000000000000000
chr9,74679384,74690305,10921,-1,0,,0,0.00000000000000000000
chr9,74679928,74684403,4475,-1,0,,0,0.00000000000000000000
chr9,74684477,74689770,5293,-1,0,,0,0.00000000000000000000
chr9,74681463,74684836,3373,-1,0,,0,0.00000000000000000000
chr9,74705957,74707573,1616,-1,0,,0,0.00000000000000000000
chr9,74827121,74828627,1506,-1,0,9615,1,66.40106241699870000000
chr9,75669431,75669905,474,-1,0,,0,0.00000000000000000000
chr9,75669521,75669809,288,-1,0,,0,0.00000000000000000000
chr9,75804543,75809265,4722,-1,0,,0,0.00000000000000000000
chr9,75806433,75809062,2629,-1,0,,0,0.00000000000000000000
chr9,76066996,76080914,13918,-1,0,,0,0.00000000000000000000
chr9,76068012,76079163,11151,-1,0,,0,0.00000000000000000000
chr9,76017640,76027645,10005,-1,0,,0,0.00000000000000000000
chr9,76007168,76016194,9026,-1,0,,0,0.00000000000000000000
chr9,76060620,76062855,2235,-1,0,,0,0.00000000000000000000
chr9,76149039,76150070,1031,-1,0,,0,0.00000000000000000000
chr9,76236725,76242087,5362,-1,0,,0,0.00000000000000000000
chr9,76661205,76686859,25654,-1,0,,0,0.00000000000000000000
chr9,76701704,76704661,2957,-1,0,,0,0.00000000000000000000
chr9,76744740,76746890,2150,-1,0,,0,0.00000000000000000000
chr9,76789629,76790831,1202,-1,0,,0,0.00000000000000000000
chr9,76805818,76806330,512,-1,0,,0,0.00000000000000000000
chr9,77146736,77147412,676,-1,0,6096,1,147.92899408284000000000
chr9,77173623,77173689,66,-1,0,6096,1,1515.15151515152000000000
chr9,77319278,77319575,297,-1,0,,0,0.00000000000000000000
chr9,77524089,77524415,326,-1,0,,0,0.00000000000000000000
chr9,77524144,77524390,246,-1,0,,0,0.00000000000000000000
chr9,77661163,77661219,56,-1,0,,0,0.00000000000000000000
chr9,77897693,77898032,339,-1,0,,0,0.00000000000000000000
chr9,77963399,77968748,5349,-1,0,,0,0.00000000000000000000
chr9,77998451,77998877,426,-1,0,,0,0.00000000000000000000
chr9,78003972,78012116,8144,-1,0,,0,0.00000000000000000000
chr9,78136740,78137548,808,-1,0,,0,0.00000000000000000000
chr9,78644237,78652185,7948,-1,0,5125,1,12.58178158027180000000
chr9,78712153,78712371,218,-1,0,5125,1,458.71559633027500000000
chr9,78736618,78737146,528,-1,0,5125,1,189.39393939393900000000
chr9,78736722,78737052,330,-1,0,5125,1,303.03030303030300000000
chr9,78772330,78772703,373,-1,0,5125,1,268.09651474530800000000
chr9,78866197,78866935,738,-1,0,5125,1,135.50135501355000000000
chr9,78919026,78922083,3057,-1,0,5125,1,32.71180896303570000000
chr9,78919859,78922946,3087,-1,0,5125,1,32.39390994493030000000
chr9,79058666,79058988,322,-1,0,2650,1,310.55900621118000000000
chr9,79122332,79125225,2893,-1,0,,0,0.00000000000000000000
chr9,79124509,79124828,319,-1,0,,0,0.00000000000000000000
chr9,79149656,79160793,11137,-1,0,,0,0.00000000000000000000
chr9,79405940,79406721,781,-1,0,158471,1,128.04097311139600000000
chr9,79455939,79501088,45149,-1,0,158471,1,2.21488848036501000000
chr9,79452265,79453470,1205,-1,0,158471,1,82.98755186721990000000
chr9,79555728,79558107,2379,-1,0,,0,0.00000000000000000000
chr9,79673680,79673843,163,-1,0,,0,0.00000000000000000000
chr9,79702098,79702185,87,-1,0,,0,0.00000000000000000000
chr9,79831171,79833113,1942,-1,0,23230,1,51.49330587023690000000
chr9,80062274,80087031,24757,-1,0,9630,1,4.03926162297532000000
chr9,80166791,80168627,1836,-1,0,9630,1,54.46623093681920000000
chr9,80231683,80233599,1916,-1,0,9630,1,52.19206680584550000000
chr9,80645879,80647525,1646,-1,0,2776,1,60.75334143377880000000
chr9,80898458,80898886,428,-1,0,,0,0.00000000000000000000
chr9,80901898,80902844,946,-1,0,,0,0.00000000000000000000
chr9,81435006,81488344,53338,-1,0,,0,0.00000000000000000000
chr9,81437937,81465726,27789,-1,0,,0,0.00000000000000000000
chr9,81595183,81595966,783,-1,0,,0,0.00000000000000000000
chr9,81725637,81726275,638,-1,0,,0,0.00000000000000000000
chr9,81725757,81726094,337,-1,0,,0,0.00000000000000000000
chr9,81888705,81889098,393,-1,0,,0,0.00000000000000000000
chr9,81907365,81909735,2370,-1,0,,0,0.00000000000000000000
chr9,81995807,81996759,952,-1,0,,0,0.00000000000000000000
chr9,82028151,82033444,5293,-1,0,,0,0.00000000000000000000
chr9,82081343,82082600,1257,-1,0,,0,0.00000000000000000000
chr9,82093865,82094888,1023,-1,0,,0,0.00000000000000000000
chr9,82614602,82621429,6827,-1,0,,0,0.00000000000000000000
chr9,82774770,82776696,1926,-1,0,,0,0.00000000000000000000
chr9,82815670,82819236,3566,-1,0,,0,0.00000000000000000000
chr9,82907603,82909160,1557,-1,0,,0,0.00000000000000000000
chr9,82845159,82845497,338,-1,0,,0,0.00000000000000000000
chr9,82982118,82985532,3414,-1,0,,0,0.00000000000000000000
chr9,82982391,82984395,2004,-1,0,,0,0.00000000000000000000
chr9,83071495,83072269,774,-1,0,,0,0.00000000000000000000
chr9,83071631,83072067,436,-1,0,,0,0.00000000000000000000
chr9,83355470,83356087,617,-1,0,,0,0.00000000000000000000
chr9,83355776,83355857,81,-1,0,,0,0.00000000000000000000
chr9,83372963,83373236,273,-1,0,,0,0.00000000000000000000
chr9,83600594,83600715,121,-1,0,,0,0.00000000000000000000
chr9,83630315,83630868,553,-1,0,,0,0.00000000000000000000
chr9,83630415,83630744,329,-1,0,,0,0.00000000000000000000
chr9,83967818,83970771,2953,-1,0,,0,0.00000000000000000000
chr9,83917700,83917758,58,-1,0,,0,0.00000000000000000000
chr9,84003104,84003256,152,-1,0,,0,0.00000000000000000000
chr9,84322315,84327548,5233,-1,0,,0,0.00000000000000000000
chr9,84324309,84326931,2622,-1,0,,0,0.00000000000000000000
chr9,84421236,84423349,2113,-1,0,,0,0.00000000000000000000
chr9,84436779,84437188,409,-1,0,,0,0.00000000000000000000
chr9,84477058,84477465,407,-1,0,,0,0.00000000000000000000
chr9,84478799,84479163,364,-1,0,,0,0.00000000000000000000
chr9,84532536,84563573,31037,-1,0,389761;389762,2,6.44392177078970000000
chr9,84516574,84527389,10815,-1,0,,0,0.00000000000000000000
chr9,84690765,84691991,1226,-1,0,,0,0.00000000000000000000
chr9,84930637,84932451,1814,-1,0,,0,0.00000000000000000000
chr9,85033831,85034265,434,-1,0,,0,0.00000000000000000000
chr9,85376740,85384158,7418,-1,0,,0,0.00000000000000000000
chr9,85546671,85547185,514,-1,0,,0,0.00000000000000000000
chr9,85546870,85547017,147,-1,0,,0,0.00000000000000000000
chr9,85546871,85547004,133,-1,0,,0,0.00000000000000000000
chr9,85845949,85846398,449,-1,0,,0,0.00000000000000000000
chr9,86202254,86206536,4282,-1,0,,0,0.00000000000000000000
chr9,86398905,86399288,383,-1,0,80318,1,261.09660574412500000000
chr9,86632029,86635352,3323,-1,0,,0,0.00000000000000000000
chr9,87345251,87345799,548,-1,0,4915,1,182.48175182481800000000
chr9,87352451,87353498,1047,-1,0,4915,1,95.51098376313280000000
chr9,87352602,87353318,716,-1,0,4915,1,139.66480446927400000000
chr9,87503865,87504238,373,-1,0,4915,1,268.09651474530800000000
chr9,87641989,87642386,397,-1,0,,0,0.00000000000000000000
chr9,87772736,87775745,3009,-1,0,,0,0.00000000000000000000
chr9,87775189,87776220,1031,-1,0,,0,0.00000000000000000000
chr9,87901310,87901851,541,-1,0,,0,0.00000000000000000000
chr9,87901411,87901717,306,-1,0,,0,0.00000000000000000000
chr9,88018430,88019797,1367,-1,0,,0,0.00000000000000000000
chr9,88088059,88088327,268,-1,0,,0,0.00000000000000000000
chr9,88426165,88427629,1464,-1,0,,0,0.00000000000000000000
chr9,88473516,88476230,2714,-1,0,,0,0.00000000000000000000
chr9,88696047,88697247,1200,-1,0,51280,1,83.33333333333330000000
chr9,88722252,88724661,2409,-1,0,,0,0.00000000000000000000
chr9,89154575,89155912,1337,-1,0,,0,0.00000000000000000000
chr9,89154578,89155823,1245,-1,0,,0,0.00000000000000000000
chr9,89447186,89454666,7480,-1,0,,0,0.00000000000000000000
chr9,89457908,89458277,369,-1,0,,0,0.00000000000000000000
chr9,89560746,89562196,1450,-1,0,2619,1,68.96551724137930000000
chr9,89610266,89610494,228,-1,0,,0,0.00000000000000000000
chr9,89675324,89683011,7687,-1,0,,0,0.00000000000000000000
chr9,89799008,89799513,505,-1,0,,0,0.00000000000000000000
chr9,89799097,89799414,317,-1,0,,0,0.00000000000000000000
chr9,89874559,89879591,5032,-1,0,,0,0.00000000000000000000
chr9,90065583,90066376,793,-1,0,,0,0.00000000000000000000
chr9,90267802,90268111,309,-1,0,1612,1,323.62459546925600000000
chr9,90373428,90373847,419,-1,0,,0,0.00000000000000000000
chr9,90374733,90374979,246,-1,0,,0,0.00000000000000000000
chr9,90714335,90715744,1409,-1,0,,0,0.00000000000000000000
chr9,90714690,90715532,842,-1,0,,0,0.00000000000000000000
chr9,90715285,90715757,472,-1,0,,0,0.00000000000000000000
chr9,90715350,90715590,240,-1,0,,0,0.00000000000000000000
chr9,90715385,90715676,291,-1,0,,0,0.00000000000000000000
chr9,90816972,90822358,5386,-1,0,,0,0.00000000000000000000
chr9,90816927,90821469,4542,-1,0,,0,0.00000000000000000000
chr9,90832316,90832936,620,-1,0,,0,0.00000000000000000000
chr9,90858422,90861295,2873,-1,0,,0,0.00000000000000000000
chr9,90858964,90860965,2001,-1,0,,0,0.00000000000000000000
chr9,90907796,90909554,1758,-1,0,,0,0.00000000000000000000
chr9,90933757,90937054,3297,-1,0,,0,0.00000000000000000000
chr9,91003261,91004232,971,-1,0,10927,1,102.98661174047400000000
chr9,91009806,91014093,4287,-1,0,10927,1,23.32633543270350000000
chr9,91020170,91029471,9301,-1,0,10927,1,10.75153209332330000000
chr9,91055526,91057357,1831,-1,0,10927,1,54.61496450027310000000
chr9,91130844,91133690,2846,-1,0,,0,0.00000000000000000000
chr9,91155640,91155705,65,-1,0,158046,1,1538.46153846154000000000
chr9,91286628,91288762,2134,-1,0,,0,0.00000000000000000000
chr9,91291699,91292981,1282,-1,0,,0,0.00000000000000000000
chr9,91408389,91409238,849,-1,0,,0,0.00000000000000000000
chr9,91538464,91539040,576,-1,0,,0,0.00000000000000000000
chr9,91501997,91502061,64,-1,0,,0,0.00000000000000000000
chr9,91673346,91675056,1710,-1,0,53358,1,58.47953216374270000000
chr9,91868195,91869753,1558,-1,0,,0,0.00000000000000000000
chr9,92019531,92020255,724,-1,0,10507,1,138.12154696132600000000
chr9,92019594,92020125,531,-1,0,10507,1,188.32391713747600000000
chr9,92086451,92086989,538,-1,0,10507,1,185.87360594795500000000
chr9,92098585,92098649,64,-1,0,,0,0.00000000000000000000
chr9,92175354,92178742,3388,-1,0,,0,0.00000000000000000000
chr9,92176045,92177977,1932,-1,0,,0,0.00000000000000000000
chr9,92510214,92510934,720,-1,0,,0,0.00000000000000000000
chr9,92995345,92998596,3251,-1,0,,0,0.00000000000000000000
chr9,93172660,93175032,2372,-1,0,,0,0.00000000000000000000
chr9,93603341,93605009,1668,-1,0,6850,1,59.95203836930460000000
chr9,93665332,93665763,431,-1,0,,0,0.00000000000000000000
chr9,93761130,93765952,4822,-1,0,,0,0.00000000000000000000
chr9,93787609,93789390,1781,-1,0,,0,0.00000000000000000000
chr9,93883361,93883684,323,-1,0,,0,0.00000000000000000000
chr9,94017827,94019676,1849,-1,0,549,1,54.08328826392640000000
chr9,94061135,94064618,3483,-1,0,549,1,28.71088142405970000000
chr9,94148161,94148485,324,-1,0,,0,0.00000000000000000000
chr9,94214988,94216438,1450,-1,0,,0,0.00000000000000000000
chr9,94295188,94296811,1623,-1,0,,0,0.00000000000000000000
chr9,94395769,94403301,7532,-1,0,,0,0.00000000000000000000
chr9,94558414,94561390,2976,-1,0,4920,1,33.60215053763440000000
chr9,94402224,94403497,1273,-1,0,,0,0.00000000000000000000
chr9,94930333,94931557,1224,-1,0,,0,0.00000000000000000000
chr9,95069910,95140255,70345,-1,0,55035;401541,2,2.84313028644538000000
chr9,95321179,95337613,16434,-1,0,401541,1,6.08494584398199000000
chr9,95546812,95547546,734,-1,0,,0,0.00000000000000000000
chr9,95634430,95634875,445,-1,0,83744,1,224.71910112359600000000
chr9,95772747,95773155,408,-1,0,89846,1,245.09803921568600000000
chr9,95811759,95812654,895,-1,0,,0,0.00000000000000000000
chr9,96116993,96125078,8085,-1,0,,0,0.00000000000000000000
chr9,96195860,96200353,4493,-1,0,,0,0.00000000000000000000
chr9,96433542,96433846,304,-1,0,5253,1,328.94736842105300000000
chr9,96469026,96471606,2580,-1,0,,0,0.00000000000000000000
chr9,96470382,96472051,1669,-1,0,,0,0.00000000000000000000
chr9,96470301,96471456,1155,-1,0,,0,0.00000000000000000000
chr9,96470894,96471229,335,-1,0,,0,0.00000000000000000000
chr9,96499788,96503209,3421,-1,0,,0,0.00000000000000000000
chr9,96730255,96730692,437,-1,0,,0,0.00000000000000000000
chr9,96730345,96730597,252,-1,0,,0,0.00000000000000000000
chr9,97292784,97293286,502,-1,0,,0,0.00000000000000000000
chr9,97292922,97293247,325,-1,0,,0,0.00000000000000000000
chr9,97316154,97319348,3194,-1,0,,0,0.00000000000000000000
chr9,97376227,97376690,463,-1,0,2203,1,215.98272138228900000000
chr9,97423832,97423994,162,-1,0,,0,0.00000000000000000000
chr9,97462531,97465488,2957,-1,0,,0,0.00000000000000000000
chr9,97497501,97513250,15749,-1,0,84909,1,6.34960949901581000000
chr9,97498489,97505608,7119,-1,0,84909,1,14.04691670178400000000
chr9,98265992,98266381,389,-1,0,5727,1,257.06940874036000000000
chr9,98332761,98333859,1098,-1,0,,0,0.00000000000000000000
chr9,98336409,98337350,941,-1,0,,0,0.00000000000000000000
chr9,98336687,98337283,596,-1,0,,0,0.00000000000000000000
chr9,98336651,98336950,299,-1,0,,0,0.00000000000000000000
chr9,99062581,99062920,339,-1,0,3293,1,294.98525073746300000000
chr9,99248804,99249597,793,-1,0,22927,1,126.10340479192900000000
chr9,99395919,99396759,840,-1,0,,0,0.00000000000000000000
chr9,99396375,99396881,506,-1,0,,0,0.00000000000000000000
chr9,99659099,99689327,30228,-1,0,,0,0.00000000000000000000
chr9,99655981,99656296,315,-1,0,,0,0.00000000000000000000
chr9,99901285,99904238,2953,-1,0,,0,0.00000000000000000000
chr9,99913232,99918908,5676,-1,0,,0,0.00000000000000000000
chr9,100081038,100103367,22329,-1,0,100499483,1,4.47848089927896000000
chr9,100761042,100761431,389,-1,0,10541,1,257.06940874036000000000
chr9,100786542,100789318,2776,-1,0,,0,0.00000000000000000000
chr9,100806289,100814769,8480,-1,0,,0,0.00000000000000000000
chr9,100861334,100884564,23230,-1,0,9830;7464,2,8.60955660783470000000
chr9,100997266,100998121,855,-1,0,55357,1,116.95906432748500000000
chr9,101000297,101001799,1502,-1,0,55357,1,66.57789613848200000000
chr9,101000292,101001113,821,-1,0,55357,1,121.80267965895200000000
chr9,101189825,101190257,432,-1,0,9568,1,231.48148148148100000000
chr9,101209329,101209644,315,-1,0,9568,1,317.46031746031700000000
chr9,101276313,101276708,395,-1,0,9568,1,253.16455696202500000000
chr9,101308984,101311711,2727,-1,0,9568,1,36.67033370003670000000
chr9,101347165,101348625,1460,-1,0,9568,1,68.49315068493150000000
chr9,101347970,101348320,350,-1,0,9568,1,285.71428571428600000000
chr9,102043040,102043983,943,-1,0,,0,0.00000000000000000000
chr9,102186735,102190546,3811,-1,0,,0,0.00000000000000000000
chr9,104219444,104220588,1144,-1,0,,0,0.00000000000000000000
chr9,104219694,104220378,684,-1,0,,0,0.00000000000000000000
chr9,104443719,104445102,1383,-1,0,116443,1,72.30657989877080000000
chr9,104443951,104444743,792,-1,0,116443,1,126.26262626262600000000
chr9,104928855,104980014,51159,-1,0,,0,0.00000000000000000000
chr9,104946268,104980085,33817,-1,0,,0,0.00000000000000000000
chr9,104962043,104981056,19013,-1,0,,0,0.00000000000000000000
chr9,104710498,104727214,16716,-1,0,,0,0.00000000000000000000
chr9,104939329,104956306,16977,-1,0,,0,0.00000000000000000000
chr9,104713208,104723765,10557,-1,0,,0,0.00000000000000000000
chr9,104716645,104724461,7816,-1,0,,0,0.00000000000000000000
chr9,104496698,104498269,1571,-1,0,116443,1,63.65372374283890000000
chr9,104683955,104685367,1412,-1,0,,0,0.00000000000000000000
chr9,104569674,104570487,813,-1,0,,0,0.00000000000000000000
chr9,104791580,104792009,429,-1,0,,0,0.00000000000000000000
chr9,105162326,105162832,506,-1,0,,0,0.00000000000000000000
chr9,105162440,105162690,250,-1,0,,0,0.00000000000000000000
chr9,105259595,105315085,55490,-1,0,,0,0.00000000000000000000
chr9,105643527,105842674,199147,-1,0,1539,1,0.50214163406930600000
chr9,105373054,105544208,171154,-1,0,,0,0.00000000000000000000
chr9,105676714,105751860,75146,-1,0,,0,0.00000000000000000000
chr9,105763361,105824141,60780,-1,0,1539,1,1.64527805199079000000
chr9,105594938,105654257,59319,-1,0,,0,0.00000000000000000000
chr9,105493349,105540196,46847,-1,0,,0,0.00000000000000000000
chr9,105710692,105719888,9196,-1,0,,0,0.00000000000000000000
chr9,105853803,105859765,5962,-1,0,,0,0.00000000000000000000
chr9,105628705,105633393,4688,-1,0,,0,0.00000000000000000000
chr9,105774966,105778996,4030,-1,0,1539,1,24.81389578163770000000
chr9,105593939,105594470,531,-1,0,,0,0.00000000000000000000
chr9,105594090,105594429,339,-1,0,,0,0.00000000000000000000
chr9,105777030,105777269,239,-1,0,1539,1,418.41004184100400000000
chr9,105776976,105777059,83,-1,0,1539,1,1204.81927710843000000000
chr9,106132419,106132993,574,-1,0,,0,0.00000000000000000000
chr9,106225450,106230853,5403,-1,0,,0,0.00000000000000000000
chr9,106195740,106196082,342,-1,0,,0,0.00000000000000000000
chr9,106328653,106332041,3388,-1,0,,0,0.00000000000000000000
chr9,106399566,106428257,28691,-1,0,,0,0.00000000000000000000
chr9,106717454,106720760,3306,-1,0,,0,0.00000000000000000000
chr9,106567164,106569716,2552,-1,0,,0,0.00000000000000000000
chr9,106628297,106630297,2000,-1,0,,0,0.00000000000000000000
chr9,106568288,106569739,1451,-1,0,,0,0.00000000000000000000
chr9,106780285,106787443,7158,-1,0,,0,0.00000000000000000000
chr9,106811718,106852295,40577,-1,0,,0,0.00000000000000000000
chr9,107366881,107379639,12758,-1,0,392376;286362,2,15.67643831321520000000
chr9,107361183,107372090,10907,-1,0,392376;138799,2,18.33684789584670000000
chr9,107362715,107368622,5907,-1,0,392376,1,16.92906720839680000000
chr9,107363944,107366750,2806,-1,0,,0,0.00000000000000000000
chr9,107400962,107401311,349,-1,0,,0,0.00000000000000000000
chr9,107480028,107491357,11329,-1,0,,0,0.00000000000000000000
chr9,107530201,107535384,5183,-1,0,55335,1,19.29384526336100000000
chr9,107596210,107598288,2078,-1,0,19,1,48.12319538017320000000
chr9,107596187,107597106,919,-1,0,19,1,108.81392818280700000000
chr9,107624908,107625028,120,-1,0,19,1,833.33333333333300000000
chr9,107708676,107708760,84,-1,0,,0,0.00000000000000000000
chr9,107798515,107803529,5014,-1,0,,0,0.00000000000000000000
chr9,107821339,107822797,1458,-1,0,,0,0.00000000000000000000
chr9,107822352,107822732,380,-1,0,,0,0.00000000000000000000
chr9,107874961,107875637,676,-1,0,,0,0.00000000000000000000
chr9,107932007,107932596,589,-1,0,,0,0.00000000000000000000
chr9,108372299,108373442,1143,-1,0,2218,1,87.48906386701660000000
chr9,108464467,108465356,889,-1,0,55151,1,112.48593925759300000000
chr9,108491771,108494997,3226,-1,0,55151,1,30.99814011159330000000
chr9,108530862,108534643,3781,-1,0,55151,1,26.44802962179320000000
chr9,108960894,108972471,11577,-1,0,,0,0.00000000000000000000
chr9,109024115,109024427,312,-1,0,,0,0.00000000000000000000
chr9,109101508,109102009,501,-1,0,,0,0.00000000000000000000
chr9,109101710,109101886,176,-1,0,,0,0.00000000000000000000
chr9,109276442,109279864,3422,-1,0,,0,0.00000000000000000000
chr9,109675907,109676565,658,-1,0,58499,1,151.97568389057700000000
chr9,109739492,109742053,2561,-1,0,58499,1,39.04724716907460000000
chr9,110018195,110021041,2846,-1,0,,0,0.00000000000000000000
chr9,110033271,110035659,2388,-1,0,,0,0.00000000000000000000
chr9,110235506,110238422,2916,-1,0,,0,0.00000000000000000000
chr9,110326374,110327205,831,-1,0,,0,0.00000000000000000000
chr9,110427618,110431611,3993,-1,0,,0,0.00000000000000000000
chr9,110432788,110433254,466,-1,0,,0,0.00000000000000000000
chr9,110537396,110540731,3335,-1,0,,0,0.00000000000000000000
chr9,110658113,110662825,4712,-1,0,,0,0.00000000000000000000
chr9,110971860,110974092,2232,-1,0,,0,0.00000000000000000000
chr9,111663171,111663293,122,-1,0,8518,1,819.67213114754100000000
chr9,111770447,111771194,747,-1,0,8727,1,133.86880856760400000000
chr9,112118880,112124164,5284,-1,0,,0,0.00000000000000000000
chr9,112285953,112287269,1316,-1,0,,0,0.00000000000000000000
chr9,112286049,112286714,665,-1,0,,0,0.00000000000000000000
chr9,112300714,112301445,731,-1,0,,0,0.00000000000000000000
chr9,112421641,112423278,1637,-1,0,114299,1,61.08735491753210000000
chr9,112430124,112430627,503,-1,0,114299,1,198.80715705765400000000
chr9,112430200,112430515,315,-1,0,114299,1,317.46031746031700000000
chr9,112750602,112751092,490,-1,0,445815,1,204.08163265306100000000
chr9,112750852,112750930,78,-1,0,445815,1,1282.05128205128000000000
chr9,112829943,112831141,1198,-1,0,445815;11217,2,166.94490818030100000000
chr9,112830194,112830897,703,-1,0,445815;11217,2,284.49502133712700000000
chr9,112824009,112824321,312,-1,0,445815;11217,2,641.02564102564100000000
chr9,113024581,113036876,12295,-1,0,,0,0.00000000000000000000
chr9,113024224,113030194,5970,-1,0,,0,0.00000000000000000000
chr9,113025212,113029470,4258,-1,0,,0,0.00000000000000000000
chr9,113175123,113185507,10384,-1,0,79987,1,9.63020030816641000000
chr9,113437449,113439018,1569,-1,0,4593,1,63.73486297004460000000
chr9,113463842,113464214,372,-1,0,4593,1,268.81720430107500000000
chr9,113463940,113464195,255,-1,0,4593,1,392.15686274509800000000
chr9,113477159,113480115,2956,-1,0,4593,1,33.82949932341000000000
chr9,113876456,113878479,2023,-1,0,,0,0.00000000000000000000
chr9,114013939,114014631,692,-1,0,,0,0.00000000000000000000
chr9,114014159,114014350,191,-1,0,,0,0.00000000000000000000
chr9,114014196,114014293,97,-1,0,,0,0.00000000000000000000
chr9,114023889,114036305,12416,-1,0,,0,0.00000000000000000000
chr9,114165628,114169937,4309,-1,0,23392,1,23.20724065908560000000
chr9,114324774,114326019,1245,-1,0,158399;22949,2,160.64257028112500000000
chr9,114333198,114333911,713,-1,0,158399;22949,2,280.50490883590500000000
chr9,114553957,114554314,357,-1,0,,0,0.00000000000000000000
chr9,114631643,114632162,519,-1,0,,0,0.00000000000000000000
chr9,114653177,114653934,757,-1,0,,0,0.00000000000000000000
chr9,114674185,114674242,57,-1,0,7357,1,1754.38596491228000000000
chr9,114725851,114726859,1008,-1,0,,0,0.00000000000000000000
chr9,114902341,114902657,316,-1,0,64420,1,316.45569620253200000000
chr9,114970747,114972739,1992,-1,0,,0,0.00000000000000000000
chr9,114993236,114993613,377,-1,0,9991,1,265.25198938992000000000
chr9,115038649,115042012,3363,-1,0,9991,1,29.73535533749630000000
chr9,115095743,115320614,224871,-1,0,84263;9991;158405,3,1.33409821631068000000
chr9,115177845,115225308,47463,-1,0,84263,1,2.10690432547458000000
chr9,115197110,115200005,2895,-1,0,84263,1,34.54231433506040000000
chr9,115264407,115265066,659,-1,0,158405,1,151.74506828528100000000
chr9,115264647,115264732,85,-1,0,158405,1,1176.47058823529000000000
chr9,115444254,115445105,851,-1,0,,0,0.00000000000000000000
chr9,115656408,115664463,8055,-1,0,,0,0.00000000000000000000
chr9,115822122,115854786,32664,-1,0,,0,0.00000000000000000000
chr9,115777104,115820562,43458,-1,0,7539,1,2.30107229969166000000
chr9,115853664,115879894,26230,-1,0,,0,0.00000000000000000000
chr9,115854343,115867515,13172,-1,0,,0,0.00000000000000000000
chr9,115812322,115820168,7846,-1,0,7539,1,12.74534794799900000000
chr9,115777700,115782248,4548,-1,0,,0,0.00000000000000000000
chr9,115909490,115910184,694,-1,0,,0,0.00000000000000000000
chr9,115936970,115937547,577,-1,0,23307,1,173.31022530329300000000
chr9,115937078,115937398,320,-1,0,23307,1,312.50000000000000000000
chr9,116138539,116138828,289,-1,0,81932,1,346.02076124567500000000
chr9,116215820,116216083,263,-1,0,5998,1,380.22813688212900000000
chr9,116397682,116398528,846,-1,0,,0,0.00000000000000000000
chr9,116463147,116463353,206,-1,0,,0,0.00000000000000000000
chr9,116911879,116916115,4236,-1,0,,0,0.00000000000000000000
chr9,117087537,117094326,6789,-1,0,5004;5005,2,29.45941964943290000000
chr9,117081845,117085142,3297,-1,0,,0,0.00000000000000000000
chr9,117082001,117083383,1382,-1,0,,0,0.00000000000000000000
chr9,117206028,117213934,7906,-1,0,25861,1,12.64862130027830000000
chr9,117482748,117484329,1581,-1,0,,0,0.00000000000000000000
chr9,117700515,117702802,2287,-1,0,,0,0.00000000000000000000
chr9,117729993,117731632,1639,-1,0,,0,0.00000000000000000000
chr9,117811666,117813795,2129,-1,0,3371,1,46.97040864255520000000
chr9,117857143,117858419,1276,-1,0,3371,1,78.36990595611280000000
chr9,117857745,117857986,241,-1,0,3371,1,414.93775933610000000000
chr9,117985877,117990992,5115,-1,0,50514,1,19.55034213098730000000
chr9,118108959,118110649,1690,-1,0,50514,1,59.17159763313610000000
chr9,118109566,118110053,487,-1,0,50514,1,205.33880903490800000000
chr9,118157151,118171806,14655,-1,0,50514,1,6.82360968952576000000
chr9,118235411,118240909,5498,-1,0,,0,0.00000000000000000000
chr9,118254931,118261865,6934,-1,0,,0,0.00000000000000000000
chr9,118455384,118598371,142987,-1,0,,0,0.00000000000000000000
chr9,119016855,119020991,4136,-1,0,5069,1,24.17794970986460000000
chr9,119051204,119051747,543,-1,0,5069,1,184.16206261510100000000
chr9,119583027,119782444,199417,-1,0,23245,1,0.50146176103341200000
chr9,119321362,119484313,162951,-1,0,23245;22954,2,1.22736282686206000000
chr9,119607302,119690315,83013,-1,0,23245,1,1.20463060002650000000
chr9,119512951,119548967,36016,-1,0,23245,1,2.77654375832963000000
chr9,119698899,119700675,1776,-1,0,23245,1,56.30630630630630000000
chr9,119476999,119477495,496,-1,0,23245,1,201.61290322580600000000
chr9,119477081,119477383,302,-1,0,23245,1,331.12582781457000000000
chr9,119922482,119922907,425,-1,0,23245,1,235.29411764705900000000
chr9,120513856,120520545,6689,-1,0,,0,0.00000000000000000000
chr9,120596845,120597051,206,-1,0,,0,0.00000000000000000000
chr9,121033583,121034774,1191,-1,0,,0,0.00000000000000000000
chr9,121420864,121423633,2769,-1,0,,0,0.00000000000000000000
chr9,121422768,121424664,1896,-1,0,,0,0.00000000000000000000
chr9,121591007,121591818,811,-1,0,,0,0.00000000000000000000
chr9,121748798,121751659,2861,-1,0,,0,0.00000000000000000000
chr9,122291269,122304804,13535,-1,0,,0,0.00000000000000000000
chr9,122259503,122259925,422,-1,0,,0,0.00000000000000000000
chr9,122357004,122357321,317,-1,0,,0,0.00000000000000000000
chr9,122436281,122437235,954,-1,0,,0,0.00000000000000000000
chr9,122526465,122528741,2276,-1,0,,0,0.00000000000000000000
chr9,122531737,122532262,525,-1,0,,0,0.00000000000000000000
chr9,122531844,122532166,322,-1,0,,0,0.00000000000000000000
chr9,122596172,122597054,882,-1,0,,0,0.00000000000000000000
chr9,123108975,123113011,4036,-1,0,,0,0.00000000000000000000
chr9,123257019,123259730,2711,-1,0,55755,1,36.88675765400220000000
chr9,123839992,123840128,136,-1,0,,0,0.00000000000000000000
chr9,123854851,123855020,169,-1,0,11064,1,591.71597633136100000000
chr9,123852315,123852455,140,-1,0,11064,1,714.28571428571400000000
chr9,124333041,124338797,5756,-1,0,153090,1,17.37317581653930000000
chr9,124405185,124406094,909,-1,0,153090,1,110.01100110011000000000
chr9,124411437,124411972,535,-1,0,153090,1,186.91588785046700000000
chr9,124411475,124411789,314,-1,0,153090,1,318.47133757961800000000
chr9,124415231,124415743,512,-1,0,153090,1,195.31250000000000000000
chr9,124519797,124520139,342,-1,0,153090,1,292.39766081871300000000
chr9,124641855,124642291,436,-1,0,158135,1,229.35779816513800000000
chr9,124642008,124642144,136,-1,0,158135,1,735.29411764705900000000
chr9,124831359,124832269,910,-1,0,158135,1,109.89010989011000000000
chr9,125441265,125441432,167,-1,0,,0,0.00000000000000000000
chr9,125487052,125512983,25931,-1,0,254973;392390,2,7.71277621379816000000
chr9,126028612,126030913,2301,-1,0,55342,1,43.45936549326380000000
chr9,126029142,126030331,1189,-1,0,55342,1,84.10428931875520000000
chr9,126166842,126168741,1899,-1,0,57706,1,52.65929436545550000000
chr9,126180913,126185195,4282,-1,0,57706,1,23.35357309668380000000
chr9,126307033,126308587,1554,-1,0,57706,1,64.35006435006430000000
chr9,126616962,126617676,714,-1,0,57706,1,140.05602240896400000000
chr9,126675927,126681051,5124,-1,0,57706,1,19.51600312256050000000
chr9,126733957,126736352,2395,-1,0,,0,0.00000000000000000000
chr9,126810577,126816237,5660,-1,0,,0,0.00000000000000000000
chr9,126892198,126895780,3582,-1,0,,0,0.00000000000000000000
chr9,126907182,126915717,8535,-1,0,,0,0.00000000000000000000
chr9,126934311,126935538,1227,-1,0,,0,0.00000000000000000000
chr9,127056603,127058095,1492,-1,0,10783,1,67.02412868632710000000
chr9,127330677,127331332,655,-1,0,2649,1,152.67175572519100000000
chr9,127605327,127611731,6404,-1,0,,0,0.00000000000000000000
chr9,127609775,127610714,939,-1,0,,0,0.00000000000000000000
chr9,127696295,127698646,2351,-1,0,2800,1,42.53509145044660000000
chr9,127947749,127950401,2652,-1,0,5537,1,37.70739064856710000000
chr9,127957175,127961153,3978,-1,0,,0,0.00000000000000000000
chr9,128155512,128161685,6173,-1,0,,0,0.00000000000000000000
chr9,128154873,128155638,765,-1,0,,0,0.00000000000000000000
chr9,128208113,128209975,1862,-1,0,79109,1,53.70569280343720000000
chr9,128358729,128366548,7819,-1,0,79109,1,12.78935925310140000000
chr9,128508565,128510625,2060,-1,0,5090,1,48.54368932038830000000
chr9,128502555,128503853,1298,-1,0,,0,0.00000000000000000000
chr9,128661451,128661705,254,-1,0,5090,1,393.70078740157500000000
chr9,128907431,128912158,4727,-1,0,,0,0.00000000000000000000
chr9,128930500,128954251,23751,-1,0,,0,0.00000000000000000000
chr9,128975311,128985069,9758,-1,0,,0,0.00000000000000000000
chr9,128970944,128979014,8070,-1,0,,0,0.00000000000000000000
chr9,128975312,128976702,1390,-1,0,,0,0.00000000000000000000
chr9,128940599,128940938,339,-1,0,,0,0.00000000000000000000
chr9,129246819,129248695,1876,-1,0,89853,1,53.30490405117270000000
chr9,129334316,129337924,3608,-1,0,,0,0.00000000000000000000
chr9,129488023,129490891,2868,-1,0,,0,0.00000000000000000000
chr9,129520410,129523259,2849,-1,0,,0,0.00000000000000000000
chr9,129520659,129522485,1826,-1,0,,0,0.00000000000000000000
chr9,129670159,129670685,526,-1,0,,0,0.00000000000000000000
chr9,130033133,130034802,1669,-1,0,84253,1,59.91611743559020000000
chr9,130109655,130110233,578,-1,0,84253,1,173.01038062283700000000
chr9,130174609,130186894,12285,-1,0,7633,1,8.14000814000814000000
chr9,130181583,130186100,4517,-1,0,,0,0.00000000000000000000
chr9,130188597,130190250,1653,-1,0,7633,1,60.49606775559590000000
chr9,130232051,130233902,1851,-1,0,90678,1,54.02485143165860000000
chr9,130560149,130560851,702,-1,0,,0,0.00000000000000000000
chr9,130633110,130634063,953,-1,0,203,1,104.93179433368300000000
chr9,130723835,130724370,535,-1,0,399665,1,186.91588785046700000000
chr9,130765628,130767275,1647,-1,0,,0,0.00000000000000000000
chr9,130766980,130767492,512,-1,0,,0,0.00000000000000000000
chr9,130812949,130816239,3290,-1,0,,0,0.00000000000000000000
chr9,130880950,130881378,428,-1,0,,0,0.00000000000000000000
chr9,130881087,130881190,103,-1,0,,0,0.00000000000000000000
chr9,130900909,130902192,1283,-1,0,,0,0.00000000000000000000
chr9,130901287,130902001,714,-1,0,,0,0.00000000000000000000
chr9,131118978,131119129,151,-1,0,10999,1,662.25165562913900000000
chr9,131200098,131200346,248,-1,0,,0,0.00000000000000000000
chr9,131200158,131200269,111,-1,0,,0,0.00000000000000000000
chr9,131210257,131216872,6615,-1,0,,0,0.00000000000000000000
chr9,131226868,131227192,324,-1,0,4957,1,308.64197530864200000000
chr9,131226950,131227148,198,-1,0,4957,1,505.05050505050500000000
chr9,131383993,131385873,1880,-1,0,6709,1,53.19148936170210000000
chr9,131464246,131472775,8529,-1,0,29941,1,11.72470395122520000000
chr9,131411925,131415994,4069,-1,0,89891,1,24.57606291472110000000
chr9,131412056,131413976,1920,-1,0,89891,1,52.08333333333330000000
chr9,131420704,131422659,1955,-1,0,,0,0.00000000000000000000
chr9,131451091,131452579,1488,-1,0,6418,1,67.20430107526880000000
chr9,131412380,131413207,827,-1,0,89891,1,120.91898428053200000000
chr9,131451593,131452309,716,-1,0,6418,1,139.66480446927400000000
chr9,131556811,131557804,993,-1,0,54662,1,100.70493454179300000000
chr9,131561792,131575577,13785,-1,0,54662,1,7.25426187885383000000
chr9,131564188,131564483,295,-1,0,54662,1,338.98305084745800000000
chr9,131694898,131695031,133,-1,0,254295,1,751.87969924812000000000
chr9,131700123,131701952,1829,-1,0,254295,1,54.67468562055770000000
chr9,131700948,131702151,1203,-1,0,254295,1,83.12551953449710000000
chr9,131780649,131782348,1699,-1,0,56904,1,58.85815185403180000000
chr9,131996286,132007465,11179,-1,0,,0,0.00000000000000000000
chr9,132021801,132028100,6299,-1,0,,0,0.00000000000000000000
chr9,132026729,132028135,1406,-1,0,,0,0.00000000000000000000
chr9,132065066,132067424,2358,-1,0,,0,0.00000000000000000000
chr9,132123550,132124388,838,-1,0,,0,0.00000000000000000000
chr9,132120961,132121456,495,-1,0,,0,0.00000000000000000000
chr9,132188968,132211285,22317,-1,0,,0,0.00000000000000000000
chr9,132214632,132219519,4887,-1,0,,0,0.00000000000000000000
chr9,132325644,132327917,2273,-1,0,,0,0.00000000000000000000
chr9,132352797,132355176,2379,-1,0,,0,0.00000000000000000000
chr9,132373845,132374777,932,-1,0,375759;28989,2,214.59227467811200000000
chr9,132404715,132405437,722,-1,0,,0,0.00000000000000000000
chr9,132424324,132424893,569,-1,0,,0,0.00000000000000000000
chr9,132526304,132530531,4227,-1,0,,0,0.00000000000000000000
chr9,132494301,132494854,553,-1,0,,0,0.00000000000000000000
chr9,132721605,132723500,1895,-1,0,23048,1,52.77044854881270000000
chr9,132748941,132750705,1764,-1,0,23048,1,56.68934240362810000000
chr9,132900521,132901873,1352,-1,0,57720,1,73.96449704142010000000
chr9,132924914,132925233,319,-1,0,,0,0.00000000000000000000
chr9,133030731,133034798,4067,-1,0,256158,1,24.58814851241700000000
chr9,133030748,133032527,1779,-1,0,256158,1,56.21135469364810000000
chr9,133235980,133237106,1126,-1,0,256158,1,88.80994671403200000000
chr9,133040060,133040247,187,-1,0,256158,1,534.75935828877000000000
chr9,133382878,133387347,4469,-1,0,,0,0.00000000000000000000
chr9,133422790,133425983,3193,-1,0,,0,0.00000000000000000000
chr9,133440180,133440465,285,-1,0,,0,0.00000000000000000000
chr9,133525311,133526017,706,-1,0,,0,0.00000000000000000000
chr9,133754114,133853622,99508,-1,0,84929;347148;25,3,3.01483297825300000000
chr9,133785086,133792859,7773,-1,0,84929,1,12.86504567091210000000
chr9,133752154,133753221,1067,-1,0,25,1,93.72071227741330000000
chr9,133752467,133752987,520,-1,0,25,1,192.30769230769200000000
chr9,133871708,133872255,547,-1,0,,0,0.00000000000000000000
chr9,134137381,134138407,1026,-1,0,286336,1,97.46588693957110000000
chr9,134258557,134266519,7962,-1,0,,0,0.00000000000000000000
chr9,134260564,134265681,5117,-1,0,,0,0.00000000000000000000
chr9,134275621,134277287,1666,-1,0,,0,0.00000000000000000000
chr9,134421449,134433851,12402,-1,0,,0,0.00000000000000000000
chr9,134390888,134392019,1131,-1,0,10585,1,88.41732979664010000000
chr9,134657036,134663453,6417,-1,0,,0,0.00000000000000000000
chr9,134915380,134921088,5708,-1,0,9442,1,17.51927119831810000000
chr9,135296785,135297322,537,-1,0,389799,1,186.21973929236500000000
chr9,135296864,135297227,363,-1,0,389799,1,275.48209366391200000000
chr9,135297008,135297083,75,-1,0,389799,1,1333.33333333333000000000
chr9,135389281,135389535,254,-1,0,389799,1,393.70078740157500000000
chr9,135389289,135389499,210,-1,0,389799,1,476.19047619047600000000
chr9,135400158,135400533,375,-1,0,389799,1,266.66666666666700000000
chr9,135542197,135544063,1866,-1,0,64794,1,53.59056806002140000000
chr9,135591937,135592414,477,-1,0,,0,0.00000000000000000000
chr9,135591964,135592234,270,-1,0,,0,0.00000000000000000000
chr9,137147401,137189500,42099,-1,0,,0,0.00000000000000000000
chr9,135939794,135957480,17686,-1,0,1056,1,5.65418975460816000000
chr9,135952328,135965719,13391,-1,0,,0,0.00000000000000000000
chr9,135949231,135957263,8032,-1,0,,0,0.00000000000000000000
chr9,138210204,138219333,9129,-1,0,,0,0.00000000000000000000
chr9,136130001,136139000,8999,-1,0,28,1,11.11234581620180000000
chr9,135623684,135630278,6594,-1,0,158067,1,15.16530178950560000000
chr9,135951063,135957523,6460,-1,0,,0,0.00000000000000000000
chr9,136170868,136176744,5876,-1,0,,0,0.00000000000000000000
chr9,136127812,136133623,5811,-1,0,28,1,17.20874204095680000000
chr9,135622887,135627456,4569,-1,0,158067,1,21.88662727073760000000
chr9,138214060,138217603,3543,-1,0,,0,0.00000000000000000000
chr9,136258774,136262527,3753,-1,0,169436,1,26.64535038635760000000
chr9,136459583,136463279,3696,-1,0,,0,0.00000000000000000000
chr9,137356301,137358889,2588,-1,0,,0,0.00000000000000000000
chr9,136974265,136977594,3329,-1,0,,0,0.00000000000000000000
chr9,136533535,136536110,2575,-1,0,1757,1,38.83495145631070000000
chr9,137740305,137742852,2547,-1,0,,0,0.00000000000000000000
chr9,136877046,136879757,2711,-1,0,,0,0.00000000000000000000
chr9,138214113,138216419,2306,-1,0,,0,0.00000000000000000000
chr9,138194121,138196332,2211,-1,0,,0,0.00000000000000000000
chr9,137495638,137497712,2074,-1,0,,0,0.00000000000000000000
chr9,136692110,136693726,1616,-1,0,7410,1,61.88118811881190000000
chr9,137525461,137527473,2012,-1,0,,0,0.00000000000000000000
chr9,136856758,136858284,1526,-1,0,7410,1,65.53079947575360000000
chr9,138344242,138345904,1662,-1,0,,0,0.00000000000000000000
chr9,135894789,135896577,1788,-1,0,,0,0.00000000000000000000
chr9,137032529,137034316,1787,-1,0,,0,0.00000000000000000000
chr9,137545390,137547020,1630,-1,0,1289,1,61.34969325153370000000
chr9,137217729,137219331,1602,-1,0,6256,1,62.42197253433210000000
chr9,136533349,136534584,1235,-1,0,1757,1,80.97165991902830000000
chr9,136761999,136763531,1532,-1,0,7410,1,65.27415143603130000000
chr9,136932368,136933838,1470,-1,0,8019,1,68.02721088435370000000
chr9,136625173,136626267,1094,-1,0,,0,0.00000000000000000000
chr9,135758928,135760037,1109,-1,0,11092,1,90.17132551848510000000
chr9,136756194,136757458,1264,-1,0,7410,1,79.11392405063290000000
chr9,138338234,138339136,902,-1,0,,0,0.00000000000000000000
chr9,136065490,136066288,798,-1,0,,0,0.00000000000000000000
chr9,136692671,136693513,842,-1,0,7410,1,118.76484560570100000000
chr9,136293884,136294879,995,-1,0,11093,1,100.50251256281400000000
chr9,137153302,137154186,884,-1,0,,0,0.00000000000000000000
chr9,137154290,137155021,731,-1,0,,0,0.00000000000000000000
chr9,137690176,137690709,533,-1,0,1289,1,187.61726078799300000000
chr9,136682384,136683165,781,-1,0,7410,1,128.04097311139600000000
chr9,136533522,136534195,673,-1,0,1757,1,148.58841010401200000000
chr9,136379109,136379661,552,-1,0,,0,0.00000000000000000000
chr9,136414001,136414546,545,-1,0,9719,1,183.48623853211000000000
chr9,136625201,136625893,692,-1,0,,0,0.00000000000000000000
chr9,136863539,136864092,553,-1,0,,0,0.00000000000000000000
chr9,137870893,137871378,485,-1,0,,0,0.00000000000000000000
chr9,138069134,138069671,537,-1,0,,0,0.00000000000000000000
chr9,136692181,136692659,478,-1,0,7410,1,209.20502092050200000000
chr9,136760946,136761301,355,-1,0,7410,1,281.69014084507000000000
chr9,138177074,138177637,563,-1,0,,0,0.00000000000000000000
chr9,137514303,137514814,511,-1,0,,0,0.00000000000000000000
chr9,136583502,136583983,481,-1,0,1757,1,207.90020790020800000000
chr9,136377067,136377451,384,-1,0,,0,0.00000000000000000000
chr9,138172109,138172511,402,-1,0,,0,0.00000000000000000000
chr9,136060683,136061055,372,-1,0,,0,0.00000000000000000000
chr9,137146328,137146752,424,-1,0,,0,0.00000000000000000000
chr9,137314251,137314669,418,-1,0,6256,1,239.23444976076600000000
chr9,136065653,136065963,310,-1,0,,0,0.00000000000000000000
chr9,137416406,137416722,316,-1,0,,0,0.00000000000000000000
chr9,136547829,136548024,195,-1,0,1757,1,512.82051282051300000000
chr9,135688494,135688736,242,-1,0,158067,1,413.22314049586800000000
chr9,138054369,138054681,312,-1,0,,0,0.00000000000000000000
chr9,136130654,136130857,203,-1,0,28,1,492.61083743842400000000
chr9,136379218,136379560,342,-1,0,,0,0.00000000000000000000
chr9,136414110,136414435,325,-1,0,9719,1,307.69230769230800000000
chr9,136974778,136975083,305,-1,0,,0,0.00000000000000000000
chr9,138088135,138088361,226,-1,0,,0,0.00000000000000000000
chr9,138054345,138054602,257,-1,0,,0,0.00000000000000000000
chr9,138054196,138054425,229,-1,0,,0,0.00000000000000000000
chr9,136761038,136761267,229,-1,0,7410,1,436.68122270742400000000
chr9,137910290,137910540,250,-1,0,,0,0.00000000000000000000
chr9,137577090,137577310,220,-1,0,1289,1,454.54545454545500000000
chr9,137154519,137154754,235,-1,0,,0,0.00000000000000000000
chr9,135697449,135697673,224,-1,0,158067,1,446.42857142857100000000
chr9,136065815,136065983,168,-1,0,,0,0.00000000000000000000
chr9,136547800,136547959,159,-1,0,1757,1,628.93081761006300000000
chr9,136534203,136534288,85,-1,0,1757,1,1176.47058823529000000000
chr9,136154346,136154432,86,-1,0,,0,0.00000000000000000000
chr9,137690415,137690499,84,-1,0,1289,1,1190.47619047619000000000
chr9,138054344,138054412,68,-1,0,,0,0.00000000000000000000
chr9,137684670,137684740,70,-1,0,1289,1,1428.57142857143000000000
chr9,137684698,137684768,70,-1,0,1289,1,1428.57142857143000000000
chr9,138207944,138208005,61,-1,0,,0,0.00000000000000000000
chr9,136376803,136376866,63,-1,0,,0,0.00000000000000000000
chr9,138436401,138446600,10199,-1,0,29991,1,9.80488283165016000000
chr9,138440841,138441350,509,-1,0,29991,1,196.46365422396900000000
chr9,138469428,138472049,2621,-1,0,,0,0.00000000000000000000
chr9,138477150,138481439,4289,-1,0,,0,0.00000000000000000000
chr9,138479099,138480204,1105,-1,0,,0,0.00000000000000000000
chr9,138479149,138480159,1010,-1,0,,0,0.00000000000000000000
chr9,138562125,138562602,477,-1,0,,0,0.00000000000000000000
chr9,138562337,138562392,55,-1,0,,0,0.00000000000000000000
chr9,139054470,139059003,4533,-1,0,,0,0.00000000000000000000
chr9,138961269,138966259,4990,-1,0,138151,1,20.04008016032060000000
chr9,138688480,138691969,3489,-1,0,,0,0.00000000000000000000
chr9,138960145,138963200,3055,-1,0,138151,1,32.73322422258590000000
chr9,138728042,138730926,2884,-1,0,157922,1,34.67406380027740000000
chr9,139055767,139058373,2606,-1,0,,0,0.00000000000000000000
chr9,138797866,138799934,2068,-1,0,157922,1,48.35589941972920000000
chr9,139009980,139011258,1278,-1,0,90120,1,78.24726134585290000000
chr9,139427330,139428215,885,-1,0,4851,1,112.99435028248600000000
chr9,139246045,139247192,1147,-1,0,26086,1,87.18395815170010000000
chr9,138873331,138874134,803,-1,0,,0,0.00000000000000000000
chr9,139429964,139430503,539,-1,0,4851,1,185.52875695732800000000
chr9,139427519,139427786,267,-1,0,4851,1,374.53183520599300000000
chr9,139059507,139059861,354,-1,0,,0,0.00000000000000000000
chr9,139246536,139246811,275,-1,0,26086,1,363.63636363636400000000
chr9,139297824,139297920,96,-1,0,10807,1,1041.66666666667000000000
chr9,139474294,139476053,1759,-1,0,,0,0.00000000000000000000
chr9,139551101,139552280,1179,-1,0,,0,0.00000000000000000000
chr9,139612436,139612899,463,-1,0,138311,1,215.98272138228900000000
chr9,139526624,139526864,240,-1,0,,0,0.00000000000000000000
chr9,139492811,139492913,102,-1,0,,0,0.00000000000000000000
chr9,139612634,139612706,72,-1,0,138311,1,1388.88888888889000000000
chr9,139667278,139677287,10009,-1,0,,0,0.00000000000000000000
chr9,139667576,139674387,6811,-1,0,,0,0.00000000000000000000
chr9,139697268,139697574,306,-1,0,84960,1,326.79738562091500000000
chr9,139705077,139712255,7178,-1,0,55684,1,13.93145723042630000000
chr9,139996401,139998366,1965,-1,0,11253,1,50.89058524173030000000
chr9,139996511,139997213,702,-1,0,11253,1,142.45014245014200000000
chr9,139898324,139898518,194,-1,0,,0,0.00000000000000000000
chr9,140180085,140186300,6215,-1,0,,0,0.00000000000000000000
chr9,140253523,140255974,2451,-1,0,54932,1,40.79967360261120000000
chr9,140223027,140224470,1443,-1,0,54932,1,69.30006930006930000000
chr9,140236215,140236777,562,-1,0,54932,1,177.93594306049800000000
chr9,140039221,140039340,119,-1,0,2902,1,840.33613445378100000000
chr9,140365890,140367179,1289,-1,0,375775,1,77.57951900698220000000
chr9,140334417,140335797,1380,-1,0,377841,1,72.46376811594200000000
chr9,140345636,140346114,478,-1,0,26012,1,209.20502092050200000000
chr9,140459669,140462614,2945,-1,0,92715,1,33.95585738539900000000
chr9,140712984,140714162,1178,-1,0,79813,1,84.88964346349740000000
chr9,140735252,140737544,2292,-1,0,,0,0.00000000000000000000
chr9,140739550,140740935,1385,-1,0,,0,0.00000000000000000000
chr9,140773605,140777199,3594,-1,0,774,1,27.82415136338340000000
chr9,140772575,140773557,982,-1,0,774,1,101.83299389002000000000
chr9,140783359,140785442,2083,-1,0,774,1,48.00768122899660000000
chr9,140912376,140914340,1964,-1,0,774,1,50.91649694501020000000
chr9,140975558,140981942,6384,-1,0,774,1,15.66416040100250000000
chr9,141018589,141033862,15273,-1,0,774,1,6.54750212793819000000
chr9,141025318,141033148,7830,-1,0,,0,0.00000000000000000000
chrX,61805,67505,5700,-1,0,,0,0.00000000000000000000
chrX,166513,167749,1236,-1,0,,0,0.00000000000000000000
chrX,61442,61911,469,-1,0,,0,0.00000000000000000000
chrX,222872,223901,1029,-1,0,8225,1,97.18172983479110000000
chrX,286986,287551,565,-1,0,,0,0.00000000000000000000
chrX,351628,353347,1719,-1,0,,0,0.00000000000000000000
chrX,399277,399896,619,-1,0,,0,0.00000000000000000000
chrX,401139,401433,294,-1,0,,0,0.00000000000000000000
chrX,424374,424539,165,-1,0,,0,0.00000000000000000000
chrX,445495,446241,746,-1,0,,0,0.00000000000000000000
chrX,449646,450392,746,-1,0,,0,0.00000000000000000000
chrX,544865,545125,260,-1,0,,0,0.00000000000000000000
chrX,562384,562803,419,-1,0,,0,0.00000000000000000000
chrX,583496,584181,685,-1,0,,0,0.00000000000000000000
chrX,623868,624339,471,-1,0,,0,0.00000000000000000000
chrX,650677,650810,133,-1,0,,0,0.00000000000000000000
chrX,652885,653226,341,-1,0,,0,0.00000000000000000000
chrX,685385,686159,774,-1,0,,0,0.00000000000000000000
chrX,689274,690461,1187,-1,0,,0,0.00000000000000000000
chrX,691176,691734,558,-1,0,,0,0.00000000000000000000
chrX,691066,691443,377,-1,0,,0,0.00000000000000000000
chrX,724368,725392,1024,-1,0,,0,0.00000000000000000000
chrX,743689,746403,2714,-1,0,,0,0.00000000000000000000
chrX,770547,770689,142,-1,0,,0,0.00000000000000000000
chrX,780567,820245,39678,-1,0,,0,0.00000000000000000000
chrX,821809,825264,3455,-1,0,,0,0.00000000000000000000
chrX,826548,827004,456,-1,0,,0,0.00000000000000000000
chrX,793522,793983,461,-1,0,,0,0.00000000000000000000
chrX,793703,793842,139,-1,0,,0,0.00000000000000000000
chrX,826621,826762,141,-1,0,,0,0.00000000000000000000
chrX,878012,880598,2586,-1,0,,0,0.00000000000000000000
chrX,899459,899999,540,-1,0,,0,0.00000000000000000000
chrX,903260,910804,7544,-1,0,,0,0.00000000000000000000
chrX,902889,904171,1282,-1,0,,0,0.00000000000000000000
chrX,910117,910926,809,-1,0,,0,0.00000000000000000000
chrX,902891,903351,460,-1,0,,0,0.00000000000000000000
chrX,908404,908572,168,-1,0,,0,0.00000000000000000000
chrX,907907,908005,98,-1,0,,0,0.00000000000000000000
chrX,931234,933045,1811,-1,0,,0,0.00000000000000000000
chrX,938096,939043,947,-1,0,,0,0.00000000000000000000
chrX,931714,932157,443,-1,0,,0,0.00000000000000000000
chrX,981953,982464,511,-1,0,,0,0.00000000000000000000
chrX,1044408,1045478,1070,-1,0,,0,0.00000000000000000000
chrX,1106763,1107320,557,-1,0,,0,0.00000000000000000000
chrX,1116967,1196001,79034,-1,0,,0,0.00000000000000000000
chrX,1108319,1111042,2723,-1,0,,0,0.00000000000000000000
chrX,1227679,1229134,1455,-1,0,,0,0.00000000000000000000
chrX,1243069,1244113,1044,-1,0,,0,0.00000000000000000000
chrX,1256070,1256487,417,-1,0,,0,0.00000000000000000000
chrX,1257173,1257803,630,-1,0,,0,0.00000000000000000000
chrX,1260277,1260998,721,-1,0,,0,0.00000000000000000000
chrX,1370104,1370647,543,-1,0,,0,0.00000000000000000000
chrX,1387102,1387439,337,-1,0,,0,0.00000000000000000000
chrX,1387011,1387352,341,-1,0,,0,0.00000000000000000000
chrX,1390042,1390346,304,-1,0,1438,1,328.94736842105300000000
chrX,1406408,1406858,450,-1,0,1438,1,222.22222222222200000000
chrX,1406551,1406850,299,-1,0,1438,1,334.44816053511700000000
chrX,1412743,1413016,273,-1,0,1438,1,366.30036630036600000000
chrX,1433232,1433828,596,-1,0,,0,0.00000000000000000000
chrX,1433447,1433793,346,-1,0,,0,0.00000000000000000000
chrX,1437891,1438937,1046,-1,0,,0,0.00000000000000000000
chrX,1450479,1453610,3131,-1,0,,0,0.00000000000000000000
chrX,1464373,1467166,2793,-1,0,3563,1,35.80379520229140000000
chrX,1478965,1479357,392,-1,0,3563,1,255.10204081632700000000
chrX,1487617,1545079,57462,-1,0,293;3563;8623,3,5.22084159966587000000
chrX,1485897,1495937,10040,-1,0,3563,1,9.96015936254980000000
chrX,1483273,1487029,3756,-1,0,3563,1,26.62406815761450000000
chrX,1526961,1529166,2205,-1,0,8623,1,45.35147392290250000000
chrX,1543799,1544128,329,-1,0,8623,1,303.95136778115500000000
chrX,1521466,1521662,196,-1,0,,0,0.00000000000000000000
chrX,1562119,1562489,370,-1,0,8623,1,270.27027027027000000000
chrX,1592418,1593394,976,-1,0,286530,1,102.45901639344300000000
chrX,1593160,1593440,280,-1,0,286530,1,357.14285714285700000000
chrX,1614348,1614818,470,-1,0,286530,1,212.76595744680900000000
chrX,1614575,1614823,248,-1,0,286530,1,403.22580645161300000000
chrX,1666875,1667449,574,-1,0,,0,0.00000000000000000000
chrX,1700729,1701212,483,-1,0,,0,0.00000000000000000000
chrX,1715348,1715803,455,-1,0,8227;438,2,439.56043956044000000000
chrX,1722574,1722961,387,-1,0,438,1,258.39793281653700000000
chrX,1728236,1729880,1644,-1,0,438,1,60.82725060827250000000
chrX,1728465,1729406,941,-1,0,438,1,106.26992561105200000000
chrX,1730463,1730865,402,-1,0,438,1,248.75621890547300000000
chrX,1735058,1735791,733,-1,0,438,1,136.42564802182800000000
chrX,1755560,1761470,5910,-1,0,438,1,16.92047377326570000000
chrX,1755833,1759319,3486,-1,0,438,1,28.68617326448650000000
chrX,1755650,1756116,466,-1,0,438,1,214.59227467811200000000
chrX,1787729,1788040,311,-1,0,,0,0.00000000000000000000
chrX,1793129,1796179,3050,-1,0,,0,0.00000000000000000000
chrX,1813301,1813513,212,-1,0,,0,0.00000000000000000000
chrX,1815297,1818135,2838,-1,0,,0,0.00000000000000000000
chrX,1820523,1821522,999,-1,0,,0,0.00000000000000000000
chrX,1854659,1855032,373,-1,0,,0,0.00000000000000000000
chrX,1858513,1858848,335,-1,0,,0,0.00000000000000000000
chrX,1882480,1884100,1620,-1,0,,0,0.00000000000000000000
chrX,1892053,1892391,338,-1,0,,0,0.00000000000000000000
chrX,1910774,1914937,4163,-1,0,,0,0.00000000000000000000
chrX,1911075,1911675,600,-1,0,,0,0.00000000000000000000
chrX,1935536,1939671,4135,-1,0,,0,0.00000000000000000000
chrX,1938763,1939221,458,-1,0,,0,0.00000000000000000000
chrX,1944383,1945700,1317,-1,0,,0,0.00000000000000000000
chrX,1998248,1998482,234,-1,0,,0,0.00000000000000000000
chrX,2000017,2000642,625,-1,0,,0,0.00000000000000000000
chrX,2003464,2003810,346,-1,0,,0,0.00000000000000000000
chrX,2029707,2030275,568,-1,0,,0,0.00000000000000000000
chrX,2037186,2037530,344,-1,0,,0,0.00000000000000000000
chrX,2183950,2184498,548,-1,0,207063,1,182.48175182481800000000
chrX,2194061,2201250,7189,-1,0,207063,1,13.91014049241900000000
chrX,2201796,2202193,397,-1,0,207063,1,251.88916876574300000000
chrX,2292798,2294715,1917,-1,0,207063,1,52.16484089723530000000
chrX,2365874,2399200,33326,-1,0,207063,1,3.00066014523195000000
chrX,2370518,2381242,10724,-1,0,207063,1,9.32487877657591000000
chrX,2382217,2383205,988,-1,0,207063,1,101.21457489878500000000
chrX,2382451,2382552,101,-1,0,207063,1,990.09900990099000000000
chrX,2403619,2404093,474,-1,0,207063,1,210.97046413502100000000
chrX,2437643,2438038,395,-1,0,,0,0.00000000000000000000
chrX,2450212,2450664,452,-1,0,,0,0.00000000000000000000
chrX,2458455,2459477,1022,-1,0,,0,0.00000000000000000000
chrX,2515309,2516494,1185,-1,0,,0,0.00000000000000000000
chrX,2548210,2550460,2250,-1,0,,0,0.00000000000000000000
chrX,2549101,2550499,1398,-1,0,,0,0.00000000000000000000
chrX,2608684,2608878,194,-1,0,,0,0.00000000000000000000
chrX,2694446,2808557,114111,-1,0,7499;8908,2,1.75267940864597000000
chrX,3034380,3034582,202,-1,0,,0,0.00000000000000000000
chrX,3083206,3083730,524,-1,0,,0,0.00000000000000000000
chrX,3083355,3083553,198,-1,0,,0,0.00000000000000000000
chrX,3203846,3216938,13092,-1,0,,0,0.00000000000000000000
chrX,3294915,3295543,628,-1,0,,0,0.00000000000000000000
chrX,3606304,3606641,337,-1,0,5613,1,296.73590504451000000000
chrX,3609445,3609523,78,-1,0,5613,1,1282.05128205128000000000
chrX,3609473,3609528,55,-1,0,5613,1,1818.18181818182000000000
chrX,3733991,3858589,124598,-1,0,,0,0.00000000000000000000
chrX,3703334,3718828,15494,-1,0,,0,0.00000000000000000000
chrX,4037189,4037246,57,-1,0,,0,0.00000000000000000000
chrX,4157569,4159937,2368,-1,0,,0,0.00000000000000000000
chrX,4379955,4380008,53,-1,0,,0,0.00000000000000000000
chrX,4782546,4782649,103,-1,0,,0,0.00000000000000000000
chrX,4904615,4905127,512,-1,0,,0,0.00000000000000000000
chrX,4904699,4905024,325,-1,0,,0,0.00000000000000000000
chrX,5054141,5058577,4436,-1,0,,0,0.00000000000000000000
chrX,5055267,5057549,2282,-1,0,,0,0.00000000000000000000
chrX,5159475,5164203,4728,-1,0,,0,0.00000000000000000000
chrX,5361807,5363299,1492,-1,0,,0,0.00000000000000000000
chrX,5480636,5496445,15809,-1,0,,0,0.00000000000000000000
chrX,5570333,5570688,355,-1,0,,0,0.00000000000000000000
chrX,5587674,5587881,207,-1,0,,0,0.00000000000000000000
chrX,5653311,5654503,1192,-1,0,,0,0.00000000000000000000
chrX,6744995,6830091,85096,-1,0,,0,0.00000000000000000000
chrX,7858254,7858454,200,-1,0,,0,0.00000000000000000000
chrX,8171057,8179543,8486,-1,0,,0,0.00000000000000000000
chrX,8784893,8787530,2637,-1,0,,0,0.00000000000000000000
chrX,8786092,8788473,2381,-1,0,,0,0.00000000000000000000
chrX,9372324,9382675,10351,-1,0,,0,0.00000000000000000000
chrX,9378085,9382151,4066,-1,0,,0,0.00000000000000000000
chrX,9372860,9374607,1747,-1,0,,0,0.00000000000000000000
chrX,9698246,9698417,171,-1,0,4935,1,584.79532163742700000000
chrX,9759912,9760398,486,-1,0,357,1,205.76131687242800000000
chrX,9957886,9963456,5570,-1,0,,0,0.00000000000000000000
chrX,10528859,10531081,2222,-1,0,4281,1,45.00450045004500000000
chrX,10695501,10701500,5999,-1,0,4281,1,16.66944490748460000000
chrX,10735984,10793700,57716,-1,0,4281,1,1.73262180331277000000
chrX,11725325,11731480,6155,-1,0,,0,0.00000000000000000000
chrX,11953153,11959471,6318,-1,0,,0,0.00000000000000000000
chrX,12434249,12436813,2564,-1,0,9758,1,39.00156006240250000000
chrX,12639335,12642035,2700,-1,0,9758,1,37.03703703703700000000
chrX,13477784,13482299,4515,-1,0,,0,0.00000000000000000000
chrX,13899510,13901731,2221,-1,0,2824,1,45.02476361999100000000
chrX,14797766,14799392,1626,-1,0,,0,0.00000000000000000000
chrX,16395664,16396344,680,-1,0,,0,0.00000000000000000000
chrX,16427242,16428534,1292,-1,0,,0,0.00000000000000000000
chrX,16427629,16428238,609,-1,0,,0,0.00000000000000000000
chrX,16472177,16479250,7073,-1,0,,0,0.00000000000000000000
chrX,16541569,16542293,724,-1,0,,0,0.00000000000000000000
chrX,16541899,16542037,138,-1,0,,0,0.00000000000000000000
chrX,16555857,16556315,458,-1,0,,0,0.00000000000000000000
chrX,16596705,16602397,5692,-1,0,,0,0.00000000000000000000
chrX,17502753,17502830,77,-1,0,4810,1,1298.70129870130000000000
chrX,17520410,17521088,678,-1,0,4810,1,147.49262536873200000000
chrX,17520621,17520957,336,-1,0,4810,1,297.61904761904800000000
chrX,17637432,17638163,731,-1,0,4810,1,136.79890560875500000000
chrX,18278469,18281189,2720,-1,0,10389,1,36.76470588235290000000
chrX,19308058,19308490,432,-1,0,,0,0.00000000000000000000
chrX,19374799,19374936,137,-1,0,5160,1,729.92700729927000000000
chrX,19465887,19469190,3303,-1,0,389840,1,30.27550711474420000000
chrX,19470266,19470491,225,-1,0,389840,1,444.44444444444400000000
chrX,20886933,20887287,354,-1,0,,0,0.00000000000000000000
chrX,22533986,22534126,140,-1,0,,0,0.00000000000000000000
chrX,22672442,22673013,571,-1,0,,0,0.00000000000000000000
chrX,22672564,22672879,315,-1,0,,0,0.00000000000000000000
chrX,24111092,24116682,5590,-1,0,,0,0.00000000000000000000
chrX,24015795,24022242,6447,-1,0,80311,1,15.51109042965720000000
chrX,24101439,24101815,376,-1,0,,0,0.00000000000000000000
chrX,24292663,24293049,386,-1,0,,0,0.00000000000000000000
chrX,24823998,24824380,382,-1,0,5422,1,261.78010471204200000000
chrX,25947910,25948323,413,-1,0,,0,0.00000000000000000000
chrX,26363174,26366297,3123,-1,0,,0,0.00000000000000000000
chrX,26954761,26955154,393,-1,0,,0,0.00000000000000000000
chrX,27229001,27229366,365,-1,0,,0,0.00000000000000000000
chrX,27458480,27462625,4145,-1,0,,0,0.00000000000000000000
chrX,27462376,27462838,462,-1,0,,0,0.00000000000000000000
chrX,27462544,27462660,116,-1,0,,0,0.00000000000000000000
chrX,27645732,27645868,136,-1,0,,0,0.00000000000000000000
chrX,27714816,27716304,1488,-1,0,,0,0.00000000000000000000
chrX,29600095,29609040,8945,-1,0,11141,1,11.17942984907770000000
chrX,29736655,29738805,2150,-1,0,11141,1,46.51162790697670000000
chrX,30021149,30023366,2217,-1,0,,0,0.00000000000000000000
chrX,30242850,30243074,224,-1,0,,0,0.00000000000000000000
chrX,30347765,30348600,835,-1,0,,0,0.00000000000000000000
chrX,30806621,30825046,18425,-1,0,,0,0.00000000000000000000
chrX,30810905,30818345,7440,-1,0,,0,0.00000000000000000000
chrX,31546275,31546365,90,-1,0,1756,1,1111.11111111111000000000
chrX,31577449,31577913,464,-1,0,1756,1,215.51724137931000000000
chrX,32391262,32391580,318,-1,0,1756,1,314.46540880503100000000
chrX,32470236,32470796,560,-1,0,1756,1,178.57142857142900000000
chrX,32470436,32470604,168,-1,0,1756,1,595.23809523809500000000
chrX,32644438,32645660,1222,-1,0,1756,1,81.83306055646480000000
chrX,32701667,32702582,915,-1,0,1756,1,109.28961748633900000000
chrX,32839092,32839578,486,-1,0,1756,1,205.76131687242800000000
chrX,32919527,32921415,1888,-1,0,1756,1,52.96610169491530000000
chrX,32987059,32989258,2199,-1,0,1756,1,45.47521600727600000000
chrX,33208593,33208917,324,-1,0,1756,1,308.64197530864200000000
chrX,33709834,33710035,201,-1,0,,0,0.00000000000000000000
chrX,33712782,33713277,495,-1,0,,0,0.00000000000000000000
chrX,33836794,33842532,5738,-1,0,,0,0.00000000000000000000
chrX,34042691,34073969,31278,-1,0,,0,0.00000000000000000000
chrX,34153575,34156133,2558,-1,0,,0,0.00000000000000000000
chrX,34439249,34442271,3022,-1,0,,0,0.00000000000000000000
chrX,34377189,34377372,183,-1,0,,0,0.00000000000000000000
chrX,35441711,35445354,3643,-1,0,,0,0.00000000000000000000
chrX,35627586,35634395,6809,-1,0,,0,0.00000000000000000000
chrX,35630894,35634356,3462,-1,0,,0,0.00000000000000000000
chrX,35714098,35715974,1876,-1,0,,0,0.00000000000000000000
chrX,36743042,36743359,317,-1,0,,0,0.00000000000000000000
chrX,37002822,37003034,212,-1,0,,0,0.00000000000000000000
chrX,37031149,37034983,3834,-1,0,,0,0.00000000000000000000
chrX,37066039,37067996,1957,-1,0,,0,0.00000000000000000000
chrX,37850786,37854381,3595,-1,0,,0,0.00000000000000000000
chrX,38385992,38387805,1813,-1,0,,0,0.00000000000000000000
chrX,38386505,38387329,824,-1,0,,0,0.00000000000000000000
chrX,38583776,38589892,6116,-1,0,,0,0.00000000000000000000
chrX,39635829,39636131,302,-1,0,,0,0.00000000000000000000
chrX,39955223,39960780,5557,-1,0,54880,1,17.99532121648370000000
chrX,40092206,40094835,2629,-1,0,,0,0.00000000000000000000
chrX,40461257,40461772,515,-1,0,10159,1,194.17475728155300000000
chrX,40504993,40505456,463,-1,0,159013,1,215.98272138228900000000
chrX,41057623,41057695,72,-1,0,8239,1,1388.88888888889000000000
chrX,41343771,41345809,2038,-1,0,,0,0.00000000000000000000
chrX,42512287,42513870,1583,-1,0,,0,0.00000000000000000000
chrX,42995307,43000082,4775,-1,0,,0,0.00000000000000000000
chrX,43017644,43017874,230,-1,0,,0,0.00000000000000000000
chrX,43945016,43946994,1978,-1,0,,0,0.00000000000000000000
chrX,44379821,44381456,1635,-1,0,,0,0.00000000000000000000
chrX,44390389,44390789,400,-1,0,139341,1,250.00000000000000000000
chrX,44411744,44411881,137,-1,0,,0,0.00000000000000000000
chrX,44519510,44526704,7194,-1,0,,0,0.00000000000000000000
chrX,45346001,45351048,5047,-1,0,,0,0.00000000000000000000
chrX,45587451,45587935,484,-1,0,,0,0.00000000000000000000
chrX,45587537,45587858,321,-1,0,,0,0.00000000000000000000
chrX,45695700,45696017,317,-1,0,,0,0.00000000000000000000
chrX,46355282,46356798,1516,-1,0,,0,0.00000000000000000000
chrX,47093164,47093217,53,-1,0,8237,1,1886.79245283019000000000
chrX,47329041,47335776,6735,-1,0,7592,1,14.84780994803270000000
chrX,47364803,47381763,16960,-1,0,,0,0.00000000000000000000
chrX,47656618,47656855,237,-1,0,,0,0.00000000000000000000
chrX,47880294,47952112,71818,-1,0,57232,1,1.39240858837617000000
chrX,48051057,48266934,215877,-1,0,6756;6759;548313;10214;6758,5,2.31613372429671000000
chrX,48063107,48106234,43127,-1,0,,0,0.00000000000000000000
chrX,48091693,48093075,1382,-1,0,,0,0.00000000000000000000
chrX,48127599,48127762,163,-1,0,,0,0.00000000000000000000
chrX,48500503,48502929,2426,-1,0,,0,0.00000000000000000000
chrX,49293915,49369924,76009,-1,0,729422;645073;729442;2543;100008586;729447;729431;100132399,8,10.52506939967640000000
chrX,49173664,49242935,69271,-1,0,26748;729408;645037;645051;729396;2574;729428,7,10.10523884453810000000
chrX,49381973,49385362,3389,-1,0,,0,0.00000000000000000000
chrX,52526959,52551985,25026,-1,0,653067,1,3.99584432190522000000
chrX,52505209,52518151,12942,-1,0,,0,0.00000000000000000000
chrX,52232348,52245283,12935,-1,0,653220,1,7.73096250483185000000
chrX,52253963,52266345,12382,-1,0,,0,0.00000000000000000000
chrX,52887752,52890051,2299,-1,0,,0,0.00000000000000000000
chrX,55687361,55728676,41315,-1,0,,0,0.00000000000000000000
chrX,55172759,55185568,12809,-1,0,90736,1,7.80701069560465000000
chrX,53478339,53491566,13227,-1,0,,0,0.00000000000000000000
chrX,55701955,55710364,8409,-1,0,,0,0.00000000000000000000
chrX,53772503,53778253,5750,-1,0,,0,0.00000000000000000000
chrX,52961246,52961653,407,-1,0,,0,0.00000000000000000000
chrX,56659686,56672135,12449,-1,0,,0,0.00000000000000000000
chrX,56668274,56672966,4692,-1,0,,0,0.00000000000000000000
chrX,57195734,57196266,532,-1,0,,0,0.00000000000000000000
chrX,58504922,58526722,21800,-1,0,,0,0.00000000000000000000
chrX,61727148,61733841,6693,-1,0,,0,0.00000000000000000000
chrX,61726907,61730251,3344,-1,0,,0,0.00000000000000000000
chrX,61988350,62000143,11793,-1,0,,0,0.00000000000000000000
chrX,62577993,62587672,9679,-1,0,,0,0.00000000000000000000
chrX,63044266,63050912,6646,-1,0,,0,0.00000000000000000000
chrX,63728655,63734799,6144,-1,0,,0,0.00000000000000000000
chrX,64842874,64844544,1670,-1,0,,0,0.00000000000000000000
chrX,65020928,65044284,23356,-1,0,,0,0.00000000000000000000
chrX,66103777,66103901,124,-1,0,,0,0.00000000000000000000
chrX,66333798,66333972,174,-1,0,,0,0.00000000000000000000
chrX,66456721,66457704,983,-1,0,,0,0.00000000000000000000
chrX,66852757,66856500,3743,-1,0,367,1,26.71653753673520000000
chrX,67034890,67035850,960,-1,0,,0,0.00000000000000000000
chrX,67080350,67081971,1621,-1,0,,0,0.00000000000000000000
chrX,67098694,67129962,31268,-1,0,,0,0.00000000000000000000
chrX,67121797,67132695,10898,-1,0,,0,0.00000000000000000000
chrX,67123752,67130268,6516,-1,0,,0,0.00000000000000000000
chrX,67128184,67130218,2034,-1,0,,0,0.00000000000000000000
chrX,67545243,67547800,2557,-1,0,4983,1,39.10833007430580000000
chrX,69022885,69026243,3358,-1,0,1896,1,29.77963073257890000000
chrX,69303060,69303273,213,-1,0,,0,0.00000000000000000000
chrX,69446368,69446746,378,-1,0,,0,0.00000000000000000000
chrX,69731302,69735513,4211,-1,0,,0,0.00000000000000000000
chrX,70122988,70123930,942,-1,0,56159,1,106.15711252653900000000
chrX,70137957,70140291,2334,-1,0,,0,0.00000000000000000000
chrX,70141051,70141314,263,-1,0,,0,0.00000000000000000000
chrX,70959561,70961703,2142,-1,0,,0,0.00000000000000000000
chrX,71123115,71123637,522,-1,0,,0,0.00000000000000000000
chrX,71123230,71123555,325,-1,0,,0,0.00000000000000000000
chrX,71374960,71375516,556,-1,0,392490,1,179.85611510791400000000
chrX,71408932,71416235,7303,-1,0,5303,1,13.69300287553060000000
chrX,72400252,72400324,72,-1,0,,0,0.00000000000000000000
chrX,72815958,72830994,15036,-1,0,53344,1,6.65070497472732000000
chrX,73166080,73169557,3477,-1,0,,0,0.00000000000000000000
chrX,73172741,73176784,4043,-1,0,,0,0.00000000000000000000
chrX,74599733,74599806,73,-1,0,158866,1,1369.86301369863000000000
chrX,75253837,75254208,371,-1,0,,0,0.00000000000000000000
chrX,76030108,76030285,177,-1,0,,0,0.00000000000000000000
chrX,76129501,76148000,18499,-1,0,,0,0.00000000000000000000
chrX,76137628,76141022,3394,-1,0,,0,0.00000000000000000000
chrX,77121390,77123864,2474,-1,0,84061,1,40.42037186742120000000
chrX,77516074,77524106,8032,-1,0,,0,0.00000000000000000000
chrX,77696502,77697960,1458,-1,0,,0,0.00000000000000000000
chrX,77696851,77697450,599,-1,0,,0,0.00000000000000000000
chrX,78590426,78590497,71,-1,0,,0,0.00000000000000000000
chrX,78921840,78925888,4048,-1,0,,0,0.00000000000000000000
chrX,78922254,78924465,2211,-1,0,,0,0.00000000000000000000
chrX,78924454,78925107,653,-1,0,,0,0.00000000000000000000
chrX,78946417,78948864,2447,-1,0,,0,0.00000000000000000000
chrX,79072110,79072634,524,-1,0,,0,0.00000000000000000000
chrX,79072214,79072510,296,-1,0,,0,0.00000000000000000000
chrX,79222116,79222290,174,-1,0,,0,0.00000000000000000000
chrX,79238234,79238300,66,-1,0,,0,0.00000000000000000000
chrX,79981360,79981826,466,-1,0,254065,1,214.59227467811200000000
chrX,80416492,80417431,939,-1,0,79366,1,106.49627263045800000000
chrX,80748634,80780706,32072,-1,0,,0,0.00000000000000000000
chrX,80810629,80810796,167,-1,0,,0,0.00000000000000000000
chrX,81042498,81043079,581,-1,0,,0,0.00000000000000000000
chrX,81096550,81102862,6312,-1,0,,0,0.00000000000000000000
chrX,81173779,81175891,2112,-1,0,,0,0.00000000000000000000
chrX,81392584,81416387,23803,-1,0,,0,0.00000000000000000000
chrX,81981932,81988524,6592,-1,0,,0,0.00000000000000000000
chrX,82199080,82208310,9230,-1,0,,0,0.00000000000000000000
chrX,83796717,83796971,254,-1,0,,0,0.00000000000000000000
chrX,83856934,83864452,7518,-1,0,,0,0.00000000000000000000
chrX,84095745,84099642,3897,-1,0,,0,0.00000000000000000000
chrX,84343650,84344046,396,-1,0,139322,1,252.52525252525300000000
chrX,84342944,84343277,333,-1,0,139322,1,300.30030030030000000000
chrX,84343823,84343872,49,-1,0,139322,1,2040.81632653061000000000
chrX,84482564,84482660,96,-1,0,,0,0.00000000000000000000
chrX,84509277,84509719,442,-1,0,7552,1,226.24434389140300000000
chrX,85537681,85538144,463,-1,0,117154,1,215.98272138228900000000
chrX,85358204,85358262,58,-1,0,,0,0.00000000000000000000
chrX,85604877,85610077,5200,-1,0,117154,1,19.23076923076920000000
chrX,85878740,85879138,398,-1,0,117154,1,251.25628140703500000000
chrX,86089574,86090433,859,-1,0,,0,0.00000000000000000000
chrX,86137708,86137779,71,-1,0,,0,0.00000000000000000000
chrX,86278751,86280691,1940,-1,0,,0,0.00000000000000000000
chrX,86279050,86280136,1086,-1,0,,0,0.00000000000000000000
chrX,86286770,86287224,454,-1,0,,0,0.00000000000000000000
chrX,87550721,87550806,85,-1,0,,0,0.00000000000000000000
chrX,87658697,87660938,2241,-1,0,,0,0.00000000000000000000
chrX,87743054,87743425,371,-1,0,,0,0.00000000000000000000
chrX,87743057,87743353,296,-1,0,,0,0.00000000000000000000
chrX,88299413,88308493,9080,-1,0,,0,0.00000000000000000000
chrX,88456797,88463060,6263,-1,0,,0,0.00000000000000000000
chrX,88459514,88462128,2614,-1,0,,0,0.00000000000000000000
chrX,88557220,88559866,2646,-1,0,,0,0.00000000000000000000
chrX,88352495,88353080,585,-1,0,,0,0.00000000000000000000
chrX,88352734,88352920,186,-1,0,,0,0.00000000000000000000
chrX,89448555,89497327,48772,-1,0,,0,0.00000000000000000000
chrX,89578365,89580381,2016,-1,0,,0,0.00000000000000000000
chrX,89893287,89911738,18451,-1,0,,0,0.00000000000000000000
chrX,90283358,90284088,730,-1,0,,0,0.00000000000000000000
chrX,90969508,90979036,9528,-1,0,,0,0.00000000000000000000
chrX,91678138,91680098,1960,-1,0,27328,1,51.02040816326530000000
chrX,91750724,91751841,1117,-1,0,27328,1,89.52551477170990000000
chrX,91758455,91758612,157,-1,0,27328,1,636.94267515923600000000
chrX,91853345,91909992,56647,-1,0,27328,1,1.76531855173266000000
chrX,92125647,92125817,170,-1,0,,0,0.00000000000000000000
chrX,92795856,92801671,5815,-1,0,,0,0.00000000000000000000
chrX,93186836,93188004,1168,-1,0,,0,0.00000000000000000000
chrX,93245045,93248293,3248,-1,0,,0,0.00000000000000000000
chrX,93400910,93404717,3807,-1,0,,0,0.00000000000000000000
chrX,93422544,93429070,6526,-1,0,,0,0.00000000000000000000
chrX,94698234,94701915,3681,-1,0,,0,0.00000000000000000000
chrX,95050826,95051522,696,-1,0,,0,0.00000000000000000000
chrX,95312498,95319091,6593,-1,0,,0,0.00000000000000000000
chrX,96006653,96006969,316,-1,0,1730,1,316.45569620253200000000
chrX,96606631,96608791,2160,-1,0,1730,1,46.29629629629630000000
chrX,97063519,97064191,672,-1,0,,0,0.00000000000000000000
chrX,97371252,97371529,277,-1,0,,0,0.00000000000000000000
chrX,97371317,97371476,159,-1,0,,0,0.00000000000000000000
chrX,98785813,98787895,2082,-1,0,,0,0.00000000000000000000
chrX,100566242,100567596,1354,-1,0,,0,0.00000000000000000000
chrX,100678076,100680635,2559,-1,0,,0,0.00000000000000000000
chrX,101155231,101155309,78,-1,0,84460,1,1282.05128205128000000000
chrX,102778932,102809113,30181,-1,0,,0,0.00000000000000000000
chrX,102808820,102829946,21126,-1,0,,0,0.00000000000000000000
chrX,102856720,102858715,1995,-1,0,,0,0.00000000000000000000
chrX,105191060,105191558,498,-1,0,203447,1,200.80321285140600000000
chrX,105191155,105191458,303,-1,0,203447,1,330.03300330033000000000
chrX,105334134,105334598,464,-1,0,,0,0.00000000000000000000
chrX,105334340,105334417,77,-1,0,,0,0.00000000000000000000
chrX,105807049,105807818,769,-1,0,,0,0.00000000000000000000
chrX,108353209,108357376,4167,-1,0,,0,0.00000000000000000000
chrX,108455776,108455948,172,-1,0,,0,0.00000000000000000000
chrX,108455809,108455931,122,-1,0,,0,0.00000000000000000000
chrX,109938628,109942129,3501,-1,0,91851,1,28.56326763781780000000
chrX,111802225,111802357,132,-1,0,,0,0.00000000000000000000
chrX,112416382,112416471,89,-1,0,,0,0.00000000000000000000
chrX,112443809,112444464,655,-1,0,,0,0.00000000000000000000
chrX,112788552,112788680,128,-1,0,,0,0.00000000000000000000
chrX,112877003,112877371,368,-1,0,,0,0.00000000000000000000
chrX,113264216,113322500,58284,-1,0,,0,0.00000000000000000000
chrX,113348222,113355383,7161,-1,0,,0,0.00000000000000000000
chrX,114542202,114544575,2373,-1,0,,0,0.00000000000000000000
chrX,114542482,114544180,1698,-1,0,,0,0.00000000000000000000
chrX,114638094,114638168,74,-1,0,,0,0.00000000000000000000
chrX,114670491,114670787,296,-1,0,,0,0.00000000000000000000
chrX,114828512,114829229,717,-1,0,5358,1,139.47001394700100000000
chrX,114921426,114921576,150,-1,0,,0,0.00000000000000000000
chrX,114940052,114940384,332,-1,0,,0,0.00000000000000000000
chrX,114959618,115005812,46194,-1,0,,0,0.00000000000000000000
chrX,115134932,115155683,20751,-1,0,,0,0.00000000000000000000
chrX,115137864,115144782,6918,-1,0,,0,0.00000000000000000000
chrX,115138700,115141906,3206,-1,0,,0,0.00000000000000000000
chrX,115182233,115183338,1105,-1,0,,0,0.00000000000000000000
chrX,115247327,115247463,136,-1,0,,0,0.00000000000000000000
chrX,115247367,115247439,72,-1,0,,0,0.00000000000000000000
chrX,116454344,116454664,320,-1,0,,0,0.00000000000000000000
chrX,117376107,117378684,2577,-1,0,,0,0.00000000000000000000
chrX,117453683,117455268,1585,-1,0,,0,0.00000000000000000000
chrX,117454095,117454970,875,-1,0,,0,0.00000000000000000000
chrX,117628681,117629174,493,-1,0,,0,0.00000000000000000000
chrX,118343142,118343280,138,-1,0,,0,0.00000000000000000000
chrX,118411404,118468999,57595,-1,0,,0,0.00000000000000000000
chrX,118495798,118495938,140,-1,0,,0,0.00000000000000000000
chrX,118870654,118870910,256,-1,0,,0,0.00000000000000000000
chrX,118873966,118876561,2595,-1,0,,0,0.00000000000000000000
chrX,118874060,118875364,1304,-1,0,,0,0.00000000000000000000
chrX,119036582,119056774,20192,-1,0,158798,1,4.95245641838352000000
chrX,119375236,119375584,348,-1,0,,0,0.00000000000000000000
chrX,119597585,119597812,227,-1,0,3920,1,440.52863436123400000000
chrX,119643310,119643624,314,-1,0,,0,0.00000000000000000000
chrX,120006553,120123559,117006,-1,0,728042;255313;728075;653282;728072;643311;728082;100507170;728036;728062;728096;728049;728090,13,11.11054133976040000000
chrX,120481443,120481766,323,-1,0,,0,0.00000000000000000000
chrX,120588414,120589315,901,-1,0,,0,0.00000000000000000000
chrX,120975577,120978406,2829,-1,0,,0,0.00000000000000000000
chrX,122185451,122185883,432,-1,0,,0,0.00000000000000000000
chrX,122315509,122316278,769,-1,0,,0,0.00000000000000000000
chrX,122316009,122316576,567,-1,0,,0,0.00000000000000000000
chrX,122372554,122373423,869,-1,0,2892,1,115.07479861910200000000
chrX,122852699,122861500,8801,-1,0,57187,1,11.36234518804680000000
chrX,122950150,122954178,4028,-1,0,,0,0.00000000000000000000
chrX,122951100,122952879,1779,-1,0,,0,0.00000000000000000000
chrX,122972808,122973684,876,-1,0,,0,0.00000000000000000000
chrX,124115706,124116136,430,-1,0,,0,0.00000000000000000000
chrX,124991840,124994706,2866,-1,0,,0,0.00000000000000000000
chrX,125850331,125852899,2568,-1,0,,0,0.00000000000000000000
chrX,126054438,126250727,196289,-1,0,,0,0.00000000000000000000
chrX,126597630,126602450,4820,-1,0,,0,0.00000000000000000000
chrX,126330219,126331257,1038,-1,0,,0,0.00000000000000000000
chrX,127143378,127243126,99748,-1,0,139741,1,1.00252636644344000000
chrX,127815518,127816864,1346,-1,0,,0,0.00000000000000000000
chrX,127943444,127943542,98,-1,0,,0,0.00000000000000000000
chrX,128320441,128328844,8403,-1,0,,0,0.00000000000000000000
chrX,128375483,128378780,3297,-1,0,,0,0.00000000000000000000
chrX,128500447,128502487,2040,-1,0,,0,0.00000000000000000000
chrX,128500937,128502430,1493,-1,0,,0,0.00000000000000000000
chrX,129539678,129540249,571,-1,0,51634,1,175.13134851138400000000
chrX,129664312,129664737,425,-1,0,,0,0.00000000000000000000
chrX,129664503,129664584,81,-1,0,,0,0.00000000000000000000
chrX,129667611,129668881,1270,-1,0,,0,0.00000000000000000000
chrX,130005201,130017018,11817,-1,0,10495,1,8.46238470000846000000
chrX,130377774,130378654,880,-1,0,,0,0.00000000000000000000
chrX,131005330,131008690,3360,-1,0,,0,0.00000000000000000000
chrX,131089377,131089604,227,-1,0,,0,0.00000000000000000000
chrX,131744896,131745326,430,-1,0,,0,0.00000000000000000000
chrX,131939340,131941656,2316,-1,0,90161,1,43.17789291882560000000
chrX,132658709,132664210,5501,-1,0,,0,0.00000000000000000000
chrX,133347703,133352694,4991,-1,0,,0,0.00000000000000000000
chrX,133394273,133397162,2889,-1,0,,0,0.00000000000000000000
chrX,134161502,134162053,551,-1,0,,0,0.00000000000000000000
chrX,134564680,134573762,9082,-1,0,,0,0.00000000000000000000
chrX,134845150,134893664,48514,-1,0,441521;541466;441519,3,6.18378200107186000000
chrX,134927362,134971145,43783,-1,0,102723680;102723737;102723631,3,6.85197451065482000000
chrX,134951886,134969311,17425,-1,0,102723680;102723631,2,11.47776183644190000000
chrX,135157061,135159239,2178,-1,0,,0,0.00000000000000000000
chrX,135157890,135158366,476,-1,0,,0,0.00000000000000000000
chrX,135157967,135158308,341,-1,0,,0,0.00000000000000000000
chrX,135299190,135302144,2954,-1,0,79649,1,33.85240352065000000000
chrX,137271188,137271441,253,-1,0,,0,0.00000000000000000000
chrX,137364741,137365191,450,-1,0,,0,0.00000000000000000000
chrX,137990189,137990304,115,-1,0,2258,1,869.56521739130400000000
chrX,138125892,138134095,8203,-1,0,2258,1,12.19066195294400000000
chrX,138157137,138158459,1322,-1,0,2258,1,75.64296520423600000000
chrX,138157876,138158352,476,-1,0,2258,1,210.08403361344500000000
chrX,138157979,138158193,214,-1,0,2258,1,467.28971962616800000000
chrX,138384809,138385355,546,-1,0,,0,0.00000000000000000000
chrX,138384916,138385246,330,-1,0,,0,0.00000000000000000000
chrX,138586533,138586693,160,-1,0,,0,0.00000000000000000000
chrX,138586550,138586627,77,-1,0,,0,0.00000000000000000000
chrX,138941850,138942370,520,-1,0,,0,0.00000000000000000000
chrX,139045796,139045929,133,-1,0,347487,1,751.87969924812000000000
chrX,139494912,139512536,17624,-1,0,,0,0.00000000000000000000
chrX,139494364,139503014,8650,-1,0,,0,0.00000000000000000000
chrX,139806037,139806558,521,-1,0,,0,0.00000000000000000000
chrX,140082559,140103900,21341,-1,0,728695,1,4.68581603486247000000
chrX,140663181,140687690,24509,-1,0,728712;30014,2,8.16026765677914000000
chrX,140476097,140479515,3418,-1,0,,0,0.00000000000000000000
chrX,140477319,140479095,1776,-1,0,,0,0.00000000000000000000
chrX,141573456,141573654,198,-1,0,,0,0.00000000000000000000
chrX,142181943,142182130,187,-1,0,,0,0.00000000000000000000
chrX,142197942,142198062,120,-1,0,,0,0.00000000000000000000
chrX,142561950,142565458,3508,-1,0,,0,0.00000000000000000000
chrX,142601775,142800327,198552,-1,0,139067;494119;139065,3,1.51093919980660000000
chrX,143406908,143410134,3226,-1,0,,0,0.00000000000000000000
chrX,143502518,143566195,63677,-1,0,,0,0.00000000000000000000
chrX,143628131,143638014,9883,-1,0,,0,0.00000000000000000000
chrX,143843272,143843604,332,-1,0,,0,0.00000000000000000000
chrX,144421860,144424676,2816,-1,0,,0,0.00000000000000000000
chrX,144422359,144423953,1594,-1,0,,0,0.00000000000000000000
chrX,145052108,145055126,3018,-1,0,,0,0.00000000000000000000
chrX,145329789,145330328,539,-1,0,,0,0.00000000000000000000
chrX,145329893,145330203,310,-1,0,,0,0.00000000000000000000
chrX,145399246,145401037,1791,-1,0,,0,0.00000000000000000000
chrX,145943158,145943949,791,-1,0,,0,0.00000000000000000000
chrX,146179692,146185953,6261,-1,0,,0,0.00000000000000000000
chrX,146038212,146041728,3516,-1,0,,0,0.00000000000000000000
chrX,146360847,146368731,7884,-1,0,,0,0.00000000000000000000
chrX,146559073,146559513,440,-1,0,,0,0.00000000000000000000
chrX,146559247,146559357,110,-1,0,,0,0.00000000000000000000
chrX,146843674,146849812,6138,-1,0,,0,0.00000000000000000000
chrX,147097485,147097745,260,-1,0,158521,1,384.61538461538500000000
chrX,147381819,147382030,211,-1,0,,0,0.00000000000000000000
chrX,147509699,147511228,1529,-1,0,,0,0.00000000000000000000
chrX,148644193,148654494,10301,-1,0,,0,0.00000000000000000000
chrX,149551066,149551597,531,-1,0,10046,1,188.32391713747600000000
chrX,149551142,149551483,341,-1,0,10046,1,293.25513196480900000000
chrX,149927911,149928845,934,-1,0,8776,1,107.06638115631700000000
chrX,149938147,149938260,113,-1,0,83692,1,884.95575221238900000000
chrX,150268172,150270794,2622,-1,0,,0,0.00000000000000000000
chrX,150293940,150295715,1775,-1,0,,0,0.00000000000000000000
chrX,150707253,150712433,5180,-1,0,,0,0.00000000000000000000
chrX,150876914,150878553,1639,-1,0,,0,0.00000000000000000000
chrX,151079459,151089463,10004,-1,0,4103,1,9.99600159936026000000
chrX,151982542,151983051,509,-1,0,,0,0.00000000000000000000
chrX,151982768,151982850,82,-1,0,,0,0.00000000000000000000
chrX,152096512,152107906,11394,-1,0,7739,1,8.77654906090925000000
chrX,152102453,152107369,4916,-1,0,7739,1,20.34174125305130000000
chrX,152110405,152201301,90896,-1,0,114824;7739,2,2.20031684562577000000
chrX,152267775,152267859,84,-1,0,,0,0.00000000000000000000
chrX,153630775,153630975,200,-1,0,1774,1,500.00000000000000000000
chrX,154285275,154285869,594,-1,0,,0,0.00000000000000000000
chrX,154386753,154409105,22352,-1,0,,0,0.00000000000000000000
chrX,154485652,154487257,1605,-1,0,,0,0.00000000000000000000
chrX,154485937,154486944,1007,-1,0,,0,0.00000000000000000000
chrX,154783549,154810063,26514,-1,0,55217,1,3.77159236629705000000
chrX,154762279,154778260,15981,-1,0,55217,1,6.25743069895501000000
chrX,154790186,154803320,13134,-1,0,55217,1,7.61382670930410000000
chrX,154775527,154785643,10116,-1,0,55217,1,9.88533017002768000000
chrX,154771749,154778986,7237,-1,0,55217,1,13.81788033715630000000
chrX,154780665,154786311,5646,-1,0,55217,1,17.71165426850870000000
chrX,154793049,154797579,4530,-1,0,55217,1,22.07505518763800000000
chrX,154778187,154782568,4381,-1,0,55217,1,22.82583884957770000000
chrX,154790170,154790692,522,-1,0,55217,1,191.57088122605400000000
chrX,154917652,154922307,4655,-1,0,10251,1,21.48227712137490000000
chrX,155089222,155092947,3725,-1,0,,0,0.00000000000000000000
chrY,13462107,13486685,24578,-1,0,,0,0.00000000000000000000
chrY,13486858,13487184,326,-1,0,,0,0.00000000000000000000
chrY,13804146,13854680,50534,-1,0,,0,0.00000000000000000000
chrY,13832181,13863294,31113,-1,0,,0,0.00000000000000000000
chrY,13813811,13845577,31766,-1,0,,0,0.00000000000000000000
chrY,13803085,13828689,25604,-1,0,,0,0.00000000000000000000
chrY,13692472,13714574,22102,-1,0,,0,0.00000000000000000000
chrY,13851237,13867291,16054,-1,0,,0,0.00000000000000000000
chrY,13691401,13706393,14992,-1,0,,0,0.00000000000000000000
chrY,13688860,13694101,5241,-1,0,,0,0.00000000000000000000
chrY,13862328,13867411,5083,-1,0,,0,0.00000000000000000000
chrY,13847362,13851923,4561,-1,0,,0,0.00000000000000000000
chrY,13801247,13802182,935,-1,0,,0,0.00000000000000000000
chrY,22235104,22301313,66209,-1,0,,0,0.00000000000000000000
chrY,22259703,22269058,9355,-1,0,,0,0.00000000000000000000
chrY,22230680,22235250,4570,-1,0,,0,0.00000000000000000000
chrY,22340998,22345081,4083,-1,0,,0,0.00000000000000000000
chrY,24361866,24465171,103305,-1,0,,0,0.00000000000000000000
chrY,24510518,24516989,6471,-1,0,,0,0.00000000000000000000
chrY,25835055,27919242,2084187,-1,0,253175;57054;57135;442868;442867;9085,6,0.28788203745633200000
chrY,27041229,28175197,1133968,-1,0,57135;442868;9085,3,0.26455773002412800000
chrY,26466024,27017064,551040,-1,0,57135;442867;57054,3,0.54442508710801400000
chrY,25853189,26146959,293770,-1,0,,0,0.00000000000000000000
chrY,25706911,25887513,180602,-1,0,,0,0.00000000000000000000
chrY,25532092,25618330,86238,-1,0,,0,0.00000000000000000000
chrY,26149539,26204333,54794,-1,0,253175,1,1.82501733766471000000
chrY,27029684,27042724,13040,-1,0,57135,1,7.66871165644172000000
chrY,28349027,28417566,68539,-1,0,,0,0.00000000000000000000
chrY,28794223,28815019,20796,-1,0,,0,0.00000000000000000000
chrY,28810447,28816559,6112,-1,0,,0,0.00000000000000000000
chrY,58827278,58856131,28853,-1,0,,0,0.00000000000000000000
chrY,58984277,58990464,6187,-1,0,,0,0.00000000000000000000
chrY,59004482,59004670,188,-1,0,,0,0.00000000000000000000
chr11,67406887,67803817,396930,1,0,4728;81622;221;91703;347853;222,6,1.51160154183357000000
chr14,21024773,21852307,827534,1,0,440163;51222;6037;122651;84659;122665;3183;57096;55701;283;6039;390443;29986;390445;493901;122664;643382;341799;10876;64184;6038;6036;64745;11198;6035;57447,26,3.14186486597530000000
chr2,240455151,241051303,596152,1,0,389090;4705;150681,3,0.50322736483313000000
chrX,6444760,8133172,1688412,1,0,51481;412;8228;26609;8226,5,0.29613625110458800000
chr1,147574618,149804844,2230226,1,0,728945;284565;644591;645142;8370;2209;730262;653598;653604;440689;554282;200030;388692;644634,14,0.62773907218371600000
chr6,94545774,95263345,717571,1,0,,0,0.00000000000000000000
chr7,143333751,143875454,541703,1,0,285966;135948;346525;9747;340307;442361;392138;135946;135941;26211;393046,11,2.03063302215421000000
chr17,245925,2294257,2048332,1,0,10594;51031;50628;286753;63826;5345;400566;55178;146760;114826;9905;124641;1398;23293;727857;64359;6117;55720;29928;124935;727910;29;8578;359845;4641;83547;55275;4335;124997;5176;1801;79850;7531;5306;3090;51763,36,1.75752758830112000000
chr17,250465,2294257,2043792,1,0,10594;51031;50628;286753;63826;5345;400566;55178;146760;114826;9905;124641;1398;23293;727857;64359;6117;55720;29928;124935;727910;29;8578;359845;4641;83547;55275;4335;124997;5176;1801;79850;7531;5306;3090;51763,36,1.76143169167900000000
chrX,76083424,77195512,1112088,1,0,1349;84061;8823;546;538,5,0.44960470754113000000
chr8,101225936,101609188,383252,1,0,6674;169166;157567;25897,4,1.04369970672038000000
chr12,33522857,34852474,1329617,1,0,341359;84920,2,0.15041925607148500000
chr3,59701603,61021070,1319467,1,0,2272,1,0.07578817810525010000
chr7,152937071,153527288,590217,1,0,,0,0.00000000000000000000
chr11,134277860,134890401,612541,1,0,27087,1,0.16325437807428400000
chr4,20792405,21758389,965984,1,0,80333,1,0.10352138337695000000
chr2,106878050,111272647,4394597,1,0,5903;96626;10913;7851;653489;6819;344558;65124;100288695;285190;84620;27233;3987;442038;60482;9648;151011;84220;4867;729540;165055,21,0.47785951703876400000
chrX,105135018,105671756,536738,1,0,6906;139221;203447,3,0.55893191836613000000
chr15,32011762,32517201,505439,1,0,161725;1139,2,0.39569562301286600000
chr6,141050542,141895083,844541,1,0,,0,0.00000000000000000000
chrY,6138322,8875169,2736847,1,0,266;90665,2,0.07307679238189050000
chr3,93507072,94210250,703178,1,0,415117;200895;5627;63899;200894,5,0.71105751317589600000
chr16,15502424,16295923,793499,1,0,4629;123811;89927;4363;54820;255027;368;9665,8,1.00819282696008000000
chr16,16561092,18530550,1969458,1,0,64131;283820;101059953,3,0.15232617298769500000
chr11,91559302,92578156,1018854,1,0,120114,1,0.09814948952450500000
chr22,49388594,49999004,610410,1,0,,0,0.00000000000000000000
chr15,31985493,32517201,531708,1,0,161725;1139,2,0.37614630586713000000
chr3,65934948,68564614,2629666,1,0,26018;115286;84541;9223;407738;8801,6,0.22816585832573400000
chr4,188448741,189060617,611876,1,0,205860;132625;339976,3,0.49029541933332900000
chr10,127852114,128992247,1140133,1,0,1793;642938;118611;8038,4,0.35083626208521300000
chr4,188450817,189060617,609800,1,0,205860;132625;339976,3,0.49196457855034400000
chr10,127855582,128992247,1136665,1,0,1793;642938;118611;8038,4,0.35190667434996200000
chr4,188448845,189060793,611948,1,0,205860;132625;339976,3,0.49023773261780400000
chr10,127852114,128992247,1140133,1,0,1793;642938;118611;8038,4,0.35083626208521300000
chr22,22315076,22579822,264746,1,0,8940,1,0.37772053213268600000
chrX,143334645,143969176,634531,1,0,,0,0.00000000000000000000
chr17,453535,768138,314603,1,0,79850;64359;55178;51031;55275;50628,6,1.90716553879016000000
chr8,144444145,144714397,270252,1,0,65263;389692;23144;84948;7264;93100;79792;114822;642475;1936,10,3.70025013690926000000
chr19,33791094,33822164,31070,1,0,1050,1,3.21853878339234000000
chr20,21625021,21738107,113086,1,0,5075,1,0.88428275825478000000
chr16,82675959,83115072,439113,1,0,1012,1,0.22773181390667100000
chr7,65875060,66169886,294826,1,0,154881;27342,2,0.67836622278903500000
chr12,45187300,45438077,250777,1,0,440097;4753,2,0.79752130378782700000
chr7,98436870,98598685,161815,1,0,222865;8295,2,1.23597935914470000000
chr14,61316974,61430524,113550,1,0,4331,1,0.88066930867459300000
chr20,13448897,13560394,111497,1,0,55617,1,0.89688511798523700000
chr4,140046328,140166873,120545,1,0,1998,1,0.82956572234435300000
chr9,71807588,71944494,136906,1,0,9413;9414,2,1.46085635399471000000
chr7,42718291,43832155,1113864,1,0,64983;9263;644;23072;79020;55744;5683,7,0.62844296969827600000
chr15,20102541,22558756,2456215,1,0,283694;727832;100287399;390538;100996331,5,0.20356524164212000000
chr3,93575285,93801773,226488,1,0,415117;200895;5627;63899;200894,5,2.20762247889513000000
chr8,18034689,18142916,108227,1,0,9,1,0.92398384876232400000
chr4,89408139,89456066,47927,1,0,84992;51191;100996939,3,6.25951968618941000000
chr4,77038892,77110259,71367,1,0,53371;950,2,2.80241568231816000000
chr7,158858318,158920200,61882,1,0,7434,1,1.61597879835817000000
chr2,178561989,178640827,78838,1,0,50940,1,1.26842385651589000000
chr5,42493787,42732921,239134,1,0,2690,1,0.41817558356402700000
chr8,67503710,68074066,570356,1,0,56260;100533105;80124;10987;23678;286187;79848;100129654;157777;4603,10,1.75329092707011000000
chr2,95917180,96198986,281806,1,0,150696;653192;51011;30818,4,1.41941619411936000000
chr18,18694412,18844301,149889,1,0,80000,1,0.66716036533701600000
chrX,130837923,130960617,122694,1,0,,0,0.00000000000000000000
chr17,183517,271814,88297,1,0,400566;9501,2,2.26508261888852000000
chr22,38507492,38602718,95226,1,0,8398;23764,2,2.10026673387520000000
chr9,4296652,4681946,385294,1,0,403313;55064;55664;169792;6505,5,1.29771031991155000000
chr16,8783417,8822202,38785,1,0,18,1,2.57831635941730000000
chrX,149494461,149833711,339250,1,0,10046;4534,2,0.58953574060427400000
chr15,90109495,90200224,90729,1,0,90381;374654,2,2.20436685073130000000
chr10,17599015,18658923,1059908,1,0,8027;653567;221074;4360;783;9200,6,0.56608686791683800000
chr5,42493787,42684907,191120,1,0,2690,1,0.52323147760569300000
chr15,32098670,32426869,328199,1,0,161725;1139,2,0.60938637838628400000
chr7,135165201,137764119,2598918,1,0,389558;136319;767558;6718;100130880;26266;4850;9162;64764;5764;647087;1129;23165,13,0.50020816355113900000
chr5,127089561,127628461,538900,1,0,728586;6558;2201,3,0.55668955279272600000
chr8,28369082,28551316,182234,1,0,7976,1,0.54874502013894200000
chr18,352578,729030,376452,1,0,1068;55556;27098;7298;494514;7525;81035,7,1.85946681117380000000
chr17,78803771,79622146,818375,1,0,10458;22994;284184;57521;284186;57597;71;55666;79643;100130370;83882;25794;5148;124565;146705;80233;9625,17,2.07728730716359000000
chr2,142108066,142191289,83223,1,0,53353,1,1.20159090636002000000
chr22,46958506,47065824,107318,1,0,23151,1,0.93181013436702100000
chr2,113617118,113853070,235952,1,0,56300;27177;27178;26525;84639;27179,6,2.54289007933817000000
chr16,16294746,18191725,1896979,1,0,64131;408050;101059938;368,4,0.21086158571075400000
chr2,14463108,16952582,2489474,1,0,51594;10408;4613;1653;151354;81553,6,0.24101476858163600000
chr10,47069605,48174779,1105174,1,0,728113;195977;5540,3,0.27145046843302500000
chr14,29829325,30220298,390973,1,0,5587,1,0.25577213771795000000
chr20,635056,1284412,649356,1,0,400831;343637;83541;642636;55321;51378;9751;113278;85508;9491,10,1.53998731050456000000
chr8,145628115,146066584,438469,1,0,80728;113655;84988;441381;9401;8928;340385;80778;4796;50626;29894;7553;9684;55630;414919;6132;90987;51160;90990;2875,20,4.56132588620860000000
chr8,605814,1196586,590772,1,0,9228;157697,2,0.33854007976004300000
chr11,111612172,112101390,489218,1,0,85458;91893;5519;1410;56158;5805;1737;120379;3316;91894;55216;64776;6392;26521;83875;79796;3606,17,3.47493346524453000000
chr6,162976542,163911369,934827,1,0,135138;5071;9444,3,0.32091499282755000000
chr13,33733608,34074990,341382,1,0,90627,1,0.29292698501971400000
chr10,30182196,30668434,486238,1,0,57608;55149,2,0.41132120484207300000
chr8,7303187,8145250,842063,1,0,503614;504180;503841;140596;100133251;653423;245910;1673;100131608;245908;100132396;503618;392188;245909;414325;10407;645836,17,2.01885132110068000000
chr3,197270877,197276155,5278,1,0,622,1,18.94657067070860000000
chr3,124838473,125157344,318871,1,0,7707;84561,2,0.62721288546151900000
chr15,70393768,71207382,813614,1,0,55323;55075;54839;56906,4,0.49163362479013400000
chr8,134458521,135225555,767034,1,0,6482,1,0.13037231726364200000
chr8,145694399,145948476,254077,1,0,80728;113655;9684;84988;414919;441381;90987;9401;90990;2875;8928,11,4.32939620666176000000
chr11,48121336,48664555,543219,1,0,390113;119765;403253;256148;256144;5795;119764,7,1.28861472076639000000
chrX,6488721,8097511,1608790,1,0,412;8228;26609;8226,4,0.24863406659663500000
chr22,23250737,23633842,383105,1,0,27156;9609;613;2781,4,1.04410018141241000000
chr22,18889039,19010508,121469,1,0,5625;8214,2,1.64651063234241000000
chr22,16053473,17297403,1243930,1,0,81061;150160;23784;150165,4,0.32156150265690200000
chr2,45662883,46321319,658436,1,0,5581;55133,2,0.30375009871878200000
chr17,21196432,21199405,2973,1,0,5606,1,33.63605785401950000000
chr15,25420800,25491412,70612,1,0,,0,0.00000000000000000000
chr16,22369809,22436522,66713,1,0,1039,1,1.49895822403430000000
chr17,46816889,46990039,173150,1,0,516;10241;284076;65264,4,2.31013572047358000000
chr11,55621334,55694212,72878,1,0,390148;84767,2,2.74431241252504000000
chr10,135341135,135372492,31357,1,0,93426;1571,2,6.37816117613292000000
chr15,25420800,25491412,70612,1,0,,0,0.00000000000000000000
chr22,18894835,19010508,115673,1,0,5625;8214,2,1.72901195611768000000
chr1,247879926,248262713,382787,1,0,343171;81466;284532;26188;391192;26246;391189;284521;391190;391191;343172;25893,12,3.13490270045743000000
chr22,18889039,19010508,121469,1,0,5625;8214,2,1.64651063234241000000
chr15,24577665,24738239,160574,1,0,,0,0.00000000000000000000
chr10,135341135,135372492,31357,1,0,93426;1571,2,6.37816117613292000000
chr7,144904207,159088636,14184429,1,0,27153;57541;84626;140545;1804;168537;389602;26;22976;11194;155061;392843;57180;6469;3110;116988;168391;51422;349136;55303;155051;63917;113763;155435;55340;83590;28959;3361;64327;168544;136051;7988;10061;9690;55112;6604;285973;26157;55365;7434;285888;8427;54892;285971;10049;57488;54480;58508;65999;5799;474344;643641;8454;9601;155054;1020;6009;23145;2636;26047;2020;100289678;653857;3638;5919;51667;9311;2146;170575;6522;3757;4846;29803;64434;10922;202865;100527949;7516;155066;136371;155038,81,0.57104871828115200000
chr15,20481502,22558897,2077395,1,0,283694;727832;100287399;390538;100996331,5,0.24068605152125600000
chr1,1587442,1627948,40506,1,0,984;728661,2,4.93754011751346000000
chr10,46968072,47148546,180474,1,0,9721;83849;5540,3,1.66228930483061000000
chr15,102359333,102399819,40486,1,0,,0,0.00000000000000000000
chr16,75542203,75577557,35354,1,0,23563;79583,2,5.65706850709962000000
chr4,186511133,187333475,822342,1,0,8470;7098;285440;2160;25854;3818,6,0.72962344134192300000
chr10,135340935,135372634,31699,1,0,93426;1571,2,6.30934729802202000000
chr3,197188564,197769760,581196,1,0,9711;84223;84248;622;89782;6165;84859,7,1.20441296911885000000
chr4,45682,124006,78324,1,0,152687,1,1.27674786783106000000
chr15,22880074,23089331,209257,1,0,123606;23191;81614,3,1.43364379686223000000
chr5,35987090,58159777,22172687,1,0,115827;4338;10769;1601;100861519;345557;4724;2255;54622;112574;133688;729;10884;65056;167127;9631;3673;133396;54514;10468;202151;6414;348980;65250;253260;5562;10309;133584;389289;730;79668;4214;2533;6507;23548;133558;100129792;55100;166968;84674;133418;3977;92255;64417;735;2668;3672;10605;5734;6167;8611;493869;11082;3003;133686;7690;53918;56477;3670;9180;6502;8988;345651;153129;79722;26272;285636;5019;202309;166979;23530;3001;2690;54505;3572;133383;3157;345643;101928448;25836;375444;23517;167359,83,0.37433442324784500000
chr7,157732880,157801126,68246,1,0,5799,1,1.46528734284793000000
chr1,161482785,161677182,194397,1,0,2214;84824;2213;3310;2215;2212,6,3.08646738375592000000
chr1,145413188,145799743,386555,1,0,148738;128077;27246;84265;11126;10628;653519;8799;5174;10401;200035;284615;8515;148741;10623;9939,16,4.13912638563723000000
chr15,25420800,25491412,70612,1,0,,0,0.00000000000000000000
chr3,71803786,71804349,563,1,0,317649;2850,2,355.23978685612800000000
chr2,1538842,1540965,2123,1,0,7173,1,47.10315591144610000000
chr15,25420800,25491412,70612,1,0,,0,0.00000000000000000000
chr16,22633888,22781312,147424,1,0,,0,0.00000000000000000000
chr22,23056362,23103964,47602,1,0,,0,0.00000000000000000000
chr8,39222167,39416698,194531,1,0,,0,0.00000000000000000000
chr2,280199,500714,220515,1,0,285016,1,0.45348388998480800000
chr15,29769134,30302413,533279,1,0,23359;7082,2,0.37503820701734000000
chr2,236738874,236739163,289,1,0,116987,1,346.02076124567500000000
chr10,135190925,135222624,31699,1,0,92170;196743,2,6.30934729802202000000
chr2,236738874,236739163,289,1,0,116987,1,346.02076124567500000000
chr15,28725307,28873153,147846,1,0,,0,0.00000000000000000000
chr10,135190925,135222624,31699,1,0,92170;196743,2,6.30934729802202000000
chr19,49564186,49575220,11034,1,0,3743;4909,2,18.12579300344390000000
chr3,197700707,197769760,69053,1,0,89782,1,1.44816300522787000000
chr15,83283395,83467620,184225,1,0,64506;123722;8120,3,1.62844347944090000000
chr5,210412,214292,3880,1,0,133957,1,25.77319587628870000000
chr4,8383341,8694621,311280,1,0,8532;152992;27201;8310,4,1.28501670521717000000
chr10,135185212,135372492,187280,1,0,1892;1571;93426;92170;503542;196743,6,3.20375907731739000000
chr12,118577432,118699470,122038,1,0,5037;51347,2,1.63883380586375000000
chr19,17422794,17676339,253545,1,0,684;79709;199786;83483;376497;100130519;115861;79016;57719;84705;93343;25796,12,4.73288765307934000000
chrX,110157764,110403157,245393,1,0,5063,1,0.40750958666302600000
chr21,22619692,23107320,487628,1,0,4685,1,0.20507435996292300000
chr1,39202011,39406956,204945,1,0,26292;64121;54933;81025,4,1.95174315060138000000
chr2,233205430,233318361,112931,1,0,250;251;129563,3,2.65648936076011000000
chr17,71832402,72671896,839494,1,0,6169;10871;100130520;388419;100131439;94015;350383;55890;342510;146723;11314;124599;124602;326624;64446,15,1.78679061434626000000
chr22,47108120,47865939,757819,1,0,64781;25771,2,0.26391526208764900000
chr15,22784523,23132102,347579,1,0,123606;23191;114791;81614,4,1.15081751199008000000
chr5,110354254,111118014,763760,1,0,9315;134429;814;134430;85480,5,0.65465591285220500000
chrX,6308487,8097571,1789084,1,0,51481;412;8228;26609;8226,5,0.27947262397964500000
chr14,34402534,34993967,591433,1,0,171546;112399;55837,3,0.50724257861837300000
chr9,4856324,5132181,275857,1,0,10171;3717,2,0.72501332211979400000
chr7,153503760,153970629,466869,1,0,1804,1,0.21419284638731600000
chr7,74139331,76724692,2585361,1,0,84163;442590;5447;389524;7784;6369;7532;3092;729438;105375355;653361;3315;83862;10344;4191;81554;2969;113878;57414;51657;136853;222183;22932;375593;100101267,25,0.96698294744911800000
chr18,3066990,3389619,322629,1,0,8736;103910;10627,3,0.92986061389397700000
chr7,158599180,159124102,524922,1,0,55112;7434;57488,3,0.57151348200304000000
chr1,245132097,245685521,553424,1,0,55083;84288,2,0.36138656798404100000
chr1,146155983,147824178,1668195,1,0,9557;51205;51463;2703;5565;607;2702;2330;200030;149013,10,0.59945030407116700000
chr15,57670483,57748324,77841,1,0,84952,1,1.28467003250215000000
chr3,102481956,102606296,124340,1,0,,0,0.00000000000000000000
chr11,8302723,8556214,253491,1,0,65975,1,0.39449132316334700000
chr8,137715929,137822146,106217,1,0,,0,0.00000000000000000000
chrX,2044687,2289906,245219,1,0,207063,1,0.40779874316427400000
chr22,17393188,17454928,61740,1,0,128954,1,1.61969549724652000000
chrY,1487565,1634267,146702,1,0,286530;8623,2,1.36330793036223000000
chrX,1540629,1688757,148128,1,0,286530;8623,2,1.35018362497300000000
chr11,131948790,132297920,349130,1,0,4978;50863,2,0.57285251911895300000
chr17,8434800,8704376,269576,1,0,4628;388333;146849;162387,4,1.48381161527732000000
chr11,132497228,132976360,479132,1,0,4978,1,0.20871075194309700000
chr16,6660795,6685821,25026,1,0,54715,1,3.99584432190522000000
chr6,81462869,81619627,156758,1,0,,0,0.00000000000000000000
chr5,61138656,61306880,168224,1,0,,0,0.00000000000000000000
chrX,782586,794392,11806,1,0,,0,0.00000000000000000000
chr5,160491613,160592061,100448,1,0,,0,0.00000000000000000000
chr4,188106127,188287317,181190,1,0,,0,0.00000000000000000000
chr7,88194430,88392972,198542,1,0,219578,1,0.50367176718276200000
chr6,26827198,26904402,77204,1,0,,0,0.00000000000000000000
chr8,212774,312065,99291,1,0,,0,0.00000000000000000000
chr1,564512,771837,207325,1,0,81399,1,0.48233449897503900000
chr2,233209808,233275967,66159,1,0,250;251,2,3.02302029958131000000
chr1,247765200,248563858,798658,1,0,81466;127059;127062;391194;391192;127074;127066;343172;25893;391190;441933;81469;391196;391195;26245;343171;254879;284532;26188;127064;26246;391189;284521;391191;343169,25,3.13025099604587000000
chr13,19610928,19638789,27861,1,0,,0,0.00000000000000000000
chr21,37498670,37608312,109642,1,0,9980;874,2,1.82411849473742000000
chr2,120034296,120198515,164219,1,0,1622;6344;140738;130355,4,2.43577174382989000000
chr21,37498670,37608312,109642,1,0,9980;874,2,1.82411849473742000000
chr7,8197222,8492998,295776,1,0,30010;3382,2,0.67618738504814500000
chr7,5105398,5186715,81317,1,0,57786;100533952,2,2.45951031149698000000
chr5,180576812,180604344,27532,1,0,285659,1,3.63213714949877000000
chrY,9375519,9405900,30381,1,0,,0,0.00000000000000000000
chr5,36205604,36285317,79713,1,0,133686;202151,2,2.50900104123543000000
chrY,242096,352002,109906,1,0,28227,1,0.90986843302458500000
chrX,287576,402002,114426,1,0,28227,1,0.87392725429535200000
chr19,20830046,20971065,141019,1,0,199777,1,0.70912430239896800000
chrX,130477980,130869075,391095,1,0,347468,1,0.25569235096332100000
chrX,130477980,130834704,356724,1,0,347468,1,0.28032876958096500000
chr3,197646649,197717518,70869,1,0,84223;6165;89782,3,4.23316259577530000000
chr2,463452,589357,125905,1,0,,0,0.00000000000000000000
chrX,60701,2685539,2624838,1,0,28227;286530;8225;1438;3563;207063;4267;293;7499;9189;438;64109;6473;8227;55344;8623,16,0.60956142817194800000
chrX,154974465,155246643,272178,1,0,6845;3581;10251,3,1.10221987081983000000
chrX,88486559,92355334,3868775,1,0,140886;90316;27328,3,0.07754392540274380000
chrY,116314,59349649,59233335,1,0,1617;6845;286530;378948;83259;7258;159163;8287;9426;86614;57055;8227;8284;207063;100289087;378950;5940;442867;100533178;10251;28227;7404;728395;57135;378951;9081;438;9084;378949;9086;203611;9085;353515;728403;4267;442868;293;9189;3581;140032;57054;90665;90655;3563;6192;8653;353513;64591;728137;22829;159119;7544;6736;8225;9082;8623;442862;9087;266;6473;1438;9083;64109;55344;253175,65,0.10973550619765000000
chr2,98013445,98264410,250965,1,0,1329;57730,2,0.79692387384695100000
chr22,21979992,22055983,75991,1,0,29799;23753;23759;150223;164592,5,6.57972654656472000000
chr10,134659060,134814552,155492,1,0,54777,1,0.64311990327476700000
chr4,74784540,74983706,199166,1,0,5196;6374;2921;2920;5473,5,2.51046865428838000000
chrX,88486559,88645566,159007,1,0,,0,0.00000000000000000000
chr4,107296536,107396433,99897,1,0,,0,0.00000000000000000000
chr2,182824510,182993260,168750,1,0,151242,1,0.59259259259259300000
chr17,443990,751212,307222,1,0,79850;64359;55178;51031;55275;50628,6,1.95298513778310000000
chr2,117777724,117912243,134519,1,0,,0,0.00000000000000000000
chr3,163824229,164007275,183046,1,0,,0,0.00000000000000000000
chr5,115030145,115126139,95994,1,0,,0,0.00000000000000000000
chr19,366729,392837,26108,1,0,51298,1,3.83024360349318000000
chrY,1884967,2230738,345771,1,0,207063,1,0.28920875377055900000
chrX,1934967,2280738,345771,1,0,207063,1,0.28920875377055900000
chr13,43517133,43793529,276396,1,0,94240;55068;29103,3,1.08539920982938000000
chrY,236545,470629,234084,1,0,28227,1,0.42719707455443300000
chrX,286545,520629,234084,1,0,28227,1,0.42719707455443300000
chr12,38275960,38464866,188906,1,0,,0,0.00000000000000000000
chr7,4307635,4377494,69859,1,0,221935,1,1.43145478750054000000
chrX,152422722,152641604,218882,1,0,4100;10838,2,0.91373434087773300000
chrX,139932435,140226181,293746,1,0,728695,1,0.34043016755972800000
chrX,1927694,2172681,244987,1,0,207063,1,0.40818492409801300000
chrY,1885217,2120532,235315,1,0,207063,1,0.42496228459724200000
chr1,247765200,248563858,798658,1,0,81466;127059;127062;391194;391192;127074;127066;343172;25893;391190;441933;81469;391196;391195;26245;343171;254879;284532;26188;127064;26246;391189;284521;391191;343169,25,3.13025099604587000000
chr8,83674798,83998532,323734,1,0,,0,0.00000000000000000000
chr7,4457188,4572427,115239,1,0,,0,0.00000000000000000000
chr16,8765268,8969711,204443,1,0,18;5373;25880;23589,4,1.95653556247952000000
chr4,188706653,189236958,530305,1,0,205860;132625;339976,3,0.56571218449760000000
chr1,248250872,248429279,178407,1,0,127062;127059;284521;391194;26245,5,2.80258061623143000000
chr1,198868302,198997541,129239,1,0,,0,0.00000000000000000000
chrX,1738622,1910125,171503,1,0,438,1,0.58308017935546300000
chrX,750721,792182,41461,1,0,,0,0.00000000000000000000
chrY,700721,742186,41465,1,0,,0,0.00000000000000000000
chrY,1704406,1860125,155719,1,0,438,1,0.64218239264315800000
chrY,16699212,17206202,506990,1,0,22829,1,0.19724254916270500000
chr8,126828088,127346989,518901,1,0,,0,0.00000000000000000000
chr1,227609808,227736646,126838,1,0,,0,0.00000000000000000000
chrX,82913639,83015971,102332,1,0,,0,0.00000000000000000000
chrY,1711595,2007128,295533,1,0,438,1,0.33837168776414100000
chr9,101869328,101904711,35383,1,0,7046,1,2.82621597942515000000
chrX,1761595,2118475,356880,1,0,438,1,0.28020623178659500000
chrX,1738622,1755707,17085,1,0,438,1,5.85308750365818000000
chrX,1761595,1778736,17141,1,0,438,1,5.83396534624584000000
chrX,296482,520629,224147,1,0,28227,1,0.44613579481322500000
chr22,17393188,17454928,61740,1,0,128954,1,1.61969549724652000000
chr7,148204192,148387392,183200,1,0,202865,1,0.54585152838427900000
chr12,61544595,61768510,223915,1,0,,0,0.00000000000000000000
chr9,2359755,2582671,222916,1,0,,0,0.00000000000000000000
chrX,8140265,8149234,8969,1,0,,0,0.00000000000000000000
chrX,96555320,97197072,641752,1,0,1730,1,0.15582343335120100000
chr6,48626041,48701064,75023,1,0,,0,0.00000000000000000000
chrX,1559288,1610391,51103,1,0,286530;8623,2,3.91366455981058000000
chrY,1511009,1557451,46442,1,0,286530;8623,2,4.30644675078593000000
chr16,14910213,16292304,1382091,1,0,4629;100288332;123811;89927;4363;9284;54820;23420;368;255027;23042;54700;123803;9665,14,1.01295790219313000000
chr1,175443890,175752647,308757,1,0,7143,1,0.32387929666371900000
chrX,715356,777876,62520,1,0,,0,0.00000000000000000000
chr8,105412527,105428064,15537,1,0,1807,1,6.43624895410955000000
chr6,142220508,142352507,131999,1,0,,0,0.00000000000000000000
chr6,95607140,95674152,67012,1,0,,0,0.00000000000000000000
chr17,2499670,2528288,28618,1,0,5048,1,3.49430428401705000000
chr10,2711725,3100958,389233,1,0,,0,0.00000000000000000000
chrY,1511009,1557451,46442,1,0,286530;8623,2,4.30644675078593000000
chrX,1559288,1610391,51103,1,0,286530;8623,2,3.91366455981058000000
chrX,154974465,154993335,18870,1,0,10251,1,5.29941706412295000000
chr13,25225486,25308356,82870,1,0,479,1,1.20670930372873000000
chr7,66256145,66737759,481614,1,0,55253;55069;51119;27342,4,0.83054064042988800000
chr21,44842187,44941200,99013,1,0,150094,1,1.00996838798946000000
chrX,89030093,89162891,132798,1,0,,0,0.00000000000000000000
chrY,1753684,2267446,513762,1,0,207063,1,0.19464265554867800000
chrX,1701271,2317446,616175,1,0,207063;8227;438,3,0.48687467034527500000
chrX,89519808,90490241,970433,1,0,,0,0.00000000000000000000
chr16,12254805,12892529,637724,1,0,92017;55313,2,0.31361529439067700000
chr12,496919,654255,157336,1,0,84318;283358;5927,3,1.90674734326537000000
chr1,100140259,100516107,375848,1,0,64645;178;54873;23443;391059,5,1.33032502501011000000
chr5,37292628,37586235,293607,1,0,9631;55100,2,0.68118266935052600000
chrX,486881,537040,50159,1,0,,0,0.00000000000000000000
chrY,437541,487040,49499,1,0,,0,0.00000000000000000000
chr15,26296578,26382228,85650,1,0,,0,0.00000000000000000000
chrY,17997137,18105180,108043,1,0,,0,0.00000000000000000000
chr13,84772973,84875141,102168,1,0,,0,0.00000000000000000000
chr14,47992001,48401317,409316,1,0,161357,1,0.24431001964252600000
chrX,49370572,49428769,58197,1,0,2543,1,1.71830163066825000000
chr7,153342262,153605524,263262,1,0,1804,1,0.37984973144624000000
chr11,2022840,2029226,6386,1,0,,0,0.00000000000000000000
chr13,27339260,27563060,223800,1,0,,0,0.00000000000000000000
chr16,30332510,30372052,39542,1,0,10421;26000,2,5.05791310505286000000
chrY,1711595,1728736,17141,1,0,438,1,5.83396534624584000000
chr16,15491554,16292304,800750,1,0,4629;123811;89927;4363;54820;255027;368;9665,8,0.99906337808304700000
chrX,1738622,1778736,40114,1,0,438,1,2.49289524854166000000
chr2,230767776,230921792,154016,1,0,130888;151473;9320,3,1.94784957407023000000
chrY,2914358,3202183,287825,1,0,,0,0.00000000000000000000
chrX,88657070,88905494,248424,1,0,,0,0.00000000000000000000
chr16,3280988,3398760,117772,1,0,91151;10127;7752;4210;7627,5,4.24549128825188000000
chr22,17393188,17454928,61740,1,0,128954,1,1.61969549724652000000
chr7,91524496,91652622,128126,1,0,10142,1,0.78048171331345700000
chr1,100140259,100516107,375848,1,0,64645;178;54873;23443;391059,5,1.33032502501011000000
chr5,36205604,36285317,79713,1,0,133686;202151,2,2.50900104123543000000
chr16,74186155,74407359,221204,1,0,5713,1,0.45207139111408500000
chr3,64052,127981,63929,1,0,,0,0.00000000000000000000
chr5,125460708,125705960,245252,1,0,65983,1,0.40774387160961000000
chr7,29211786,29537004,325218,1,0,54504;1124,2,0.61497211101476500000
chr6,78889445,79045298,155853,1,0,,0,0.00000000000000000000
chr16,14910213,16420691,1510478,1,0,4629;100288332;123811;89927;4363;9284;54820;23420;408050;368;255027;23042;54700;123803;9665,15,0.99306312306435500000
chr5,2275100,2862058,586958,1,0,153571;153572,2,0.34073988258103600000
chr5,133955460,133968003,12543,1,0,51128,1,7.97257434425576000000
chr15,101790577,101887579,97002,1,0,6627;55829;5046;22856,4,4.12362631698316000000
chr1,100140259,100516107,375848,1,0,64645;178;54873;23443;391059,5,1.33032502501011000000
chr4,88916620,88940769,24149,1,0,5311,1,4.14095821773158000000
chr6,95440534,95543854,103320,1,0,,0,0.00000000000000000000
chrY,1704406,2267446,563040,1,0,207063;438,2,0.35521454958795100000
chrX,1701271,2317446,616175,1,0,207063;8227;438,3,0.48687467034527500000
chr14,97033547,97127710,94163,1,0,,0,0.00000000000000000000
chr4,117304752,117519245,214493,1,0,,0,0.00000000000000000000
chr8,119055563,119080218,24655,1,0,2131,1,4.05597241938755000000
chr2,34804005,34955646,151641,1,0,,0,0.00000000000000000000
chr7,143425314,143505904,80590,1,0,285966;340307,2,2.48169748107706000000
chrX,35726159,35959702,233543,1,0,139604;286464,2,0.85637334452327800000
chr2,230767776,230900153,132377,1,0,130888;151473;9320,3,2.26625471192126000000
chr22,16126719,16489138,362419,1,0,81061;23784,2,0.55184744729167100000
chr16,72768,114345,41577,1,0,79622;51728;64285,3,7.21552781585973000000
chr6,68785166,69096845,311679,1,0,,0,0.00000000000000000000
chrX,148094901,148606575,511674,1,0,3423,1,0.19543693836309800000
chr5,7099458,8136044,1036586,1,0,4552;79072;108;134121,4,0.38588211687211700000
chr13,72004962,72083283,78321,1,0,1602,1,1.27679677225776000000
chr13,115007800,115038148,30348,1,0,8881,1,3.29511005667589000000
chr8,22213996,22366453,152457,1,0,23516;55124;5533,3,1.96776796080206000000
chr4,189469131,189836679,367548,1,0,,0,0.00000000000000000000
chr4,188002248,188414222,411974,1,0,,0,0.00000000000000000000
chr7,6585669,6777328,191659,1,0,7559;55146;54753;100131017;392862;79034,6,3.13056000500890000000
chrX,99312040,99544613,232573,1,0,,0,0.00000000000000000000
chrX,82912766,83015971,103205,1,0,,0,0.00000000000000000000
chr17,34154963,34405071,250108,1,0,201299;6362;8148;6359;6360;6352;256957;6368;57151;6358,10,3.99827274617365000000
chr2,241552722,241553670,948,1,0,2859,1,105.48523206751100000000
chr3,88349508,88490474,140966,1,0,,0,0.00000000000000000000
chr16,83911777,83945555,33778,1,0,23417,1,2.96050683877080000000
chrX,62854940,62957121,102181,1,0,23229,1,0.97865552304244400000
chrX,152351523,152511002,159479,1,0,4100,1,0.62704180487713100000
chr2,7111210,7466937,355727,1,0,9781,1,0.28111445012608000000
chrX,148892554,149084864,192310,1,0,4107,1,0.51999376007487900000
chr8,186785,213435,26650,1,0,169270,1,3.75234521575985000000
chr19,54753548,54835792,82244,1,0,10288;10990,2,2.43178833714314000000
chr1,175443890,175752647,308757,1,0,7143,1,0.32387929666371900000
chr1,90576266,90667296,91030,1,0,,0,0.00000000000000000000
chr11,96492005,97824206,1332201,1,0,,0,0.00000000000000000000
chr3,10071211,10083523,12312,1,0,2177,1,8.12215724496426000000
chr1,161523634,161619000,95366,1,0,2215,1,1.04859174129145000000
chrX,48317660,48324310,6650,1,0,92745,1,15.03759398496240000000
chr19,59088682,59095427,6745,1,0,,0,0.00000000000000000000
chr8,87196197,87312908,116711,1,0,157724,1,0.85681726658155600000
chr2,75285148,75863747,578599,1,0,84141;6869,2,0.34566254003204300000
chr1,834103,874551,40448,1,0,148398,1,2.47231012658228000000
chr4,128972121,129261363,289242,1,0,55132;10424,2,0.69146251235989200000
chr9,94423345,94446118,22773,1,0,,0,0.00000000000000000000
chrX,43085419,43376898,291479,1,0,,0,0.00000000000000000000
chr17,4115582,4323496,207914,1,0,51479;7326,2,0.96193618515347700000
chr22,43528151,43685565,157414,1,0,80274;23170;706;27349,4,2.54107004459578000000
chr18,77992215,78012819,20604,1,0,84552,1,4.85342651912250000000
chr17,26005959,26062031,56072,1,0,,0,0.00000000000000000000
chr13,67345415,67369860,24445,1,0,5101,1,4.09081611781550000000
chr5,180576812,180604344,27532,1,0,285659,1,3.63213714949877000000
chr6,14725703,15017416,291713,1,0,,0,0.00000000000000000000
chr12,85737485,86265014,527529,1,0,9182,1,0.18956303824055200000
chr6,146604590,147129749,525159,1,0,2911;79747;10981,3,0.57125556260104100000
chr6,139898910,140222599,323689,1,0,,0,0.00000000000000000000
chr17,80294081,80367443,73362,1,0,2837;79701;400629,3,4.08931054224258000000
chr6,141057205,141970570,913365,1,0,,0,0.00000000000000000000
chr19,45837573,45896151,58578,1,0,10848;147700;2068,3,5.12137662603708000000
chr12,133678891,133758902,80011,1,0,7699;101060200;7556;10795,4,4.99931259451825000000
chr16,29683449,29687288,3839,1,0,,0,0.00000000000000000000
chr10,134303254,134410981,107727,1,0,3632,1,0.92827239225078200000
chr3,11206972,11422874,215902,1,0,10533;3269,2,0.92634621263351000000
chr13,71782121,71867564,85443,1,0,,0,0.00000000000000000000
chr2,140719425,140833508,114083,1,0,,0,0.00000000000000000000
chr6,78874201,79045298,171097,1,0,,0,0.00000000000000000000
chrX,2700078,2799426,99348,1,0,7499;8908,2,2.01312557877360000000
chr7,122225549,122317305,91756,1,0,93664,1,1.08984698548324000000
chr13,43517133,43793529,276396,1,0,94240;55068;29103,3,1.08539920982938000000
chr9,71589103,71801885,212782,1,0,5568;9414;8395;2395,4,1.87985825868730000000
chrX,154852133,154929305,77172,1,0,10251,1,1.29580676929456000000
chr3,10469155,10793098,323943,1,0,491,1,0.30869628298805700000
chrX,82912766,83015971,103205,1,0,,0,0.00000000000000000000
chr14,79843155,79928267,85112,1,0,9369,1,1.17492245511796000000
chr13,92973377,93036288,62911,1,0,2262,1,1.58954713802038000000
chr5,37239322,37314628,75306,1,0,65250;9631,2,2.65583087668977000000
chr9,6567772,7013402,445630,1,0,2731;23081,2,0.44880281848170000000
chr17,48420724,48772051,351327,1,0,55379;80221;91369;84073;51264;55316;64132;8913;8714;55040;64847;146956;1101,13,3.70025645623593000000
chr1,231741756,231813980,72224,1,0,27185,1,1.38458130261409000000
chr3,12879082,13123209,244127,1,0,9922;6161,2,0.81924572046516800000
chr1,14030188,14035625,5437,1,0,7799,1,18.39249586168840000000
chr8,11666795,11852988,186193,1,0,1508;2222;613210;613211;613209,5,2.68538559451752000000
chr8,6161309,6302530,141221,1,0,79648,1,0.70810998364265900000
chr2,230767776,230900153,132377,1,0,130888;151473;9320,3,2.26625471192126000000
chr16,35020750,35057514,36764,1,0,,0,0.00000000000000000000
chr2,34002712,34998703,995991,1,0,,0,0.00000000000000000000
chr9,33715124,33838466,123342,1,0,54926;5646,2,1.62150767783885000000
chr4,129786343,129914928,128585,1,0,132320;79960,2,1.55539137535482000000
chr1,144869720,144896237,26517,1,0,9659,1,3.77116566730776000000
chrX,143094492,143467197,372705,1,0,,0,0.00000000000000000000
chr8,70730742,70907804,177062,1,0,81796,1,0.56477392099942400000
chr5,31197778,31468054,270276,1,0,1004;29102,2,0.73998431233257900000
chrX,52154859,52480468,325609,1,0,653220,1,0.30711681802407200000
chr9,204090,396926,192836,1,0,81704;157983,2,1.03715073948848000000
chr11,2159092,2161583,2491,1,0,3481,1,40.14452027298270000000
chr6,144328434,144329895,1461,1,0,5325,1,68.44626967830250000000
chr9,127265976,127269155,3179,1,0,2516,1,31.45643284051590000000
chrX,1803684,2057128,253444,1,0,,0,0.00000000000000000000
chrY,1753684,2007128,253444,1,0,,0,0.00000000000000000000
chrX,8434014,8873829,439815,1,0,171482;425054;3730,3,0.68210497595580000000
chrX,82913639,83015971,102332,1,0,,0,0.00000000000000000000
chr6,167211557,167289655,78098,1,0,6196,1,1.28044252093524000000
chrX,23532153,23914781,382628,1,0,23597;10549;6303;79135,4,1.04540180018190000000
chr22,44064744,44599582,534838,1,0,150379;29780;64800;80339;64098;25813;25830,7,1.30880752676511000000
chr6,30864134,30992213,128079,1,0,135656;100507679;2968;394263;389376;780;57176,7,5.46537683773296000000
chrY,373610,381993,8383,1,0,,0,0.00000000000000000000
chr9,239429,500607,261178,1,0,81704;23189,2,0.76576128157808100000
chrX,423610,431993,8383,1,0,,0,0.00000000000000000000
chr19,58267716,58358451,90735,1,0,54807;284309;79818;100293516,4,4.40844216674932000000
chr20,9769132,9968856,199724,1,0,57144,1,0.50069095351585200000
chr2,40924077,41368021,443944,1,0,,0,0.00000000000000000000
chr13,20600603,20681228,80625,1,0,7750,1,1.24031007751938000000
chr19,54739877,54891255,151378,1,0,11025;3903;10990;23547;10288,5,3.30298986642709000000
chr4,129786343,129914928,128585,1,0,132320;79960,2,1.55539137535482000000
chr3,64052,283756,219704,1,0,10752,1,0.45515784874194400000
chr15,90849174,90995930,146756,1,0,8826;342132,2,1.36280629071384000000
chr15,96873119,96874735,1616,1,0,7026,1,61.88118811881190000000
chr22,19747566,19747938,372,1,0,6899,1,268.81720430107500000000
chr2,182824510,182993260,168750,1,0,151242,1,0.59259259259259300000
chrY,9757164,10045811,288647,1,0,,0,0.00000000000000000000
chr13,92980728,93046459,65731,1,0,2262,1,1.52135217781564000000
chr10,134514334,134591710,77376,1,0,3632,1,1.29239040529363000000
chr5,17602354,17674866,72512,1,0,,0,0.00000000000000000000
chrX,109063395,109154411,91016,1,0,,0,0.00000000000000000000
chrY,2308083,2581992,273909,1,0,207063;9189;4267,3,1.09525426327722000000
chr16,54514200,54751763,237563,1,0,,0,0.00000000000000000000
chr2,109232445,109496339,263894,1,0,5903;3987;165055,3,1.13682008685305000000
chr22,17059296,17547398,488102,1,0,150160;128954;150165,3,0.61462563152783600000
chrX,1936244,1939699,3455,1,0,,0,0.00000000000000000000
chrY,1886244,1888320,2076,1,0,,0,0.00000000000000000000
chr9,71589103,71801885,212782,1,0,5568;9414;8395;2395,4,1.87985825868730000000
chr5,180638764,180652349,13585,1,0,90933,1,7.36105999263894000000
chr1,90576266,90667296,91030,1,0,,0,0.00000000000000000000
chr4,176703599,176838591,134992,1,0,2823,1,0.74078463908972400000
chr9,29873485,30096629,223144,1,0,,0,0.00000000000000000000
chr12,27306290,27760067,453777,1,0,341346;23012;8496;56938,4,0.88149024741227500000
chr13,20419350,20447972,28622,1,0,9205,1,3.49381594577598000000
chr8,53714184,53925985,211801,1,0,2831,1,0.47214130244899700000
chrX,152351523,152435012,83489,1,0,,0,0.00000000000000000000
chr7,159006918,159098464,91546,1,0,,0,0.00000000000000000000
chr8,132480039,132565943,85904,1,0,,0,0.00000000000000000000
chr17,26005959,26062031,56072,1,0,,0,0.00000000000000000000
chr4,10166341,10902206,735865,1,0,116449;85460,2,0.27178898303357300000
chr5,6576955,6674551,97596,1,0,6715;54888,2,2.04926431411123000000
chr18,54401487,54689740,288253,1,0,23335,1,0.34691746486593400000
chrY,9445465,9648990,203525,1,0,,0,0.00000000000000000000
chr11,1113172,1301367,188195,1,0,54472;4586;727897,3,1.59409123515503000000
chrX,74511245,74606854,95609,1,0,158866;139596,2,2.09185327741112000000
chr4,64573,374625,310052,1,0,654254;152687;7700;255403,4,1.29010617573826000000
chr20,57464092,57465940,1848,1,0,2778,1,54.11255411255410000000
chr22,19747566,19749385,1819,1,0,6899,1,54.97526113249040000000
chr15,96873119,96874735,1616,1,0,7026,1,61.88118811881190000000
chrX,1738622,1778736,40114,1,0,438,1,2.49289524854166000000
chrY,1704406,1728736,24330,1,0,438,1,4.11015207562680000000
chr7,151615371,151894650,279279,1,0,58508;168391;63917,3,1.07419462258172000000
chr2,96080680,96432355,351675,1,0,653192;129868,2,0.56870690268003100000
chrX,1754280,2383230,628950,1,0,207063;438,2,0.31799030129581100000
chr5,175559327,175628957,69630,1,0,,0,0.00000000000000000000
chrX,72360234,72572821,212587,1,0,4674,1,0.47039564978103100000
chr16,77595486,77982903,387417,1,0,283927;57687,2,0.51623960745140300000
chr5,56786887,56921586,134699,1,0,,0,0.00000000000000000000
chr6,81500098,81619627,119529,1,0,,0,0.00000000000000000000
chr1,231741756,231813980,72224,1,0,27185,1,1.38458130261409000000
chr13,92980728,93046459,65731,1,0,2262,1,1.52135217781564000000
chr10,92087640,92548814,461174,1,0,3363,1,0.21683789632546500000
chrX,2118264,2331766,213502,1,0,207063,1,0.46837968730972100000
chr16,70791913,71313979,522066,1,0,55697;54768,2,0.38309332536499200000
chr15,84416357,84816747,400390,1,0,57188,1,0.24975648742476100000
chr22,49399602,49982343,582741,1,0,,0,0.00000000000000000000
chrX,154156799,154310067,153268,1,0,79184;100272147;65991;4515;2157,5,3.26225957146958000000
chrX,130834645,131152554,317909,1,0,,0,0.00000000000000000000
chr17,26005959,26062031,56072,1,0,,0,0.00000000000000000000
chr4,48609701,49083302,473601,1,0,132299;54940;80157;285527,4,0.84459281124828700000
chrX,168992,414716,245724,1,0,55344;28227;8225,3,1.22088196513161000000
chr7,146226394,146254734,28340,1,0,26047,1,3.52858151023289000000
chr15,32899499,33136596,237097,1,0,342184;9824;643699;26585;6447,5,2.10884152899446000000
chrX,82912766,83015971,103205,1,0,,0,0.00000000000000000000
chr7,88192836,89855485,1662649,1,0,219557;219578;26872;261729,4,0.24057994200820500000
chr8,127810481,127976373,165892,1,0,,0,0.00000000000000000000
chr4,188002248,188414222,411974,1,0,,0,0.00000000000000000000
chr4,189469131,189836679,367548,1,0,,0,0.00000000000000000000
chr3,163824229,164007275,183046,1,0,,0,0.00000000000000000000
chr12,133678891,133758902,80011,1,0,7699;101060200;7556;10795,4,4.99931259451825000000
chr5,6576955,6674551,97596,1,0,6715;54888,2,2.04926431411123000000
chrY,1704406,1728736,24330,1,0,438,1,4.11015207562680000000
chrX,1738622,1778736,40114,1,0,438,1,2.49289524854166000000
chrY,236545,315787,79242,1,0,28227,1,1.26195704298226000000
chrX,286545,365795,79250,1,0,28227,1,1.26182965299685000000
chrX,1540629,1607726,67097,1,0,286530;8623,2,2.98075919936808000000
chrX,89391534,89616145,224611,1,0,,0,0.00000000000000000000
chr6,34842567,35017013,174446,1,0,23294;6882;54887,3,1.71972988775896000000
chr4,189469131,189836679,367548,1,0,,0,0.00000000000000000000
chr4,188002248,188414222,411974,1,0,,0,0.00000000000000000000
chr6,167491590,167568770,77180,1,0,1235,1,1.29567245400363000000
chr1,834103,870515,36412,1,0,148398,1,2.74634735801384000000
chrY,1711595,1728736,17141,1,0,438,1,5.83396534624584000000
chrX,1738622,1778736,40114,1,0,438,1,2.49289524854166000000
chr2,117777724,117912243,134519,1,0,,0,0.00000000000000000000
chrX,65953240,66448509,495269,1,0,,0,0.00000000000000000000
chr8,68021227,68120504,99277,1,0,10565;79848,2,2.01456530717084000000
chr2,56238735,56767716,528981,1,0,114800,1,0.18904270663785700000
chr4,152169749,152275302,105553,1,0,345062,1,0.94739135789603300000
chr8,120743779,120910595,166816,1,0,79075;6873;64798,3,1.79838864377518000000
chr8,11666795,11852988,186193,1,0,1508;2222;613210;613211;613209,5,2.68538559451752000000
chr1,90164304,90307190,142886,1,0,55144;84230,2,1.39971725711406000000
chr1,147697754,147749442,51688,1,0,,0,0.00000000000000000000
chr15,100974695,101055808,81113,1,0,204219,1,1.23284800216981000000
chrY,5940528,6123541,183013,1,0,64591,1,0.54640927147251800000
chrX,92211522,92355334,143812,1,0,,0,0.00000000000000000000
chr10,129207259,129356315,149056,1,0,1793;594857,2,1.34177758694719000000
chr8,86841197,86917752,76555,1,0,,0,0.00000000000000000000
chr20,5547774,5827735,279961,1,0,149840;56261,2,0.71438521794107000000
chr5,98753332,98892151,138819,1,0,,0,0.00000000000000000000
chrX,84903807,84992522,88715,1,0,,0,0.00000000000000000000
chr13,25559350,25705980,146630,1,0,5042,1,0.68198867898792900000
chr6,167623337,167828546,205209,1,0,83887;54346;6953,3,1.46192418461179000000
chr5,144839995,144978563,138568,1,0,,0,0.00000000000000000000
chr4,163122601,163271172,148571,1,0,,0,0.00000000000000000000
chr19,45858168,45874127,15959,1,0,2068,1,6.26605677047434000000
chr16,8894358,9154380,260022,1,0,23589;5373;7874,3,1.15374852897063000000
chr15,59626716,59776410,149694,1,0,145773;4643,2,1.33605889347602000000
chrX,91586912,91842304,255392,1,0,27328,1,0.39155494298960000000
chrY,5338764,5559815,221051,1,0,83259,1,0.45238429140786500000
chr14,50084386,50085416,1030,1,0,6166,1,97.08737864077670000000
chrX,187588,288196,100608,1,0,55344;8225,2,1.98791348600509000000
chr8,87196197,87312908,116711,1,0,157724,1,0.85681726658155600000
chr18,66774674,66872820,98146,1,0,,0,0.00000000000000000000
chr12,11690861,11838829,147968,1,0,2120,1,0.67582179930795800000
chrX,2700078,2799426,99348,1,0,7499;8908,2,2.01312557877360000000
chr10,68186860,68292630,105770,1,0,29119,1,0.94544766947149500000
chr15,82133360,82303455,170095,1,0,,0,0.00000000000000000000
chr1,834103,863486,29383,1,0,148398,1,3.40332845522921000000
chr12,133678891,133758902,80011,1,0,7699;101060200;7556;10795,4,4.99931259451825000000
chr15,96873119,96874233,1114,1,0,7026,1,89.76660682226210000000
chr22,19513751,19515864,2113,1,0,,0,0.00000000000000000000
chr22,19747566,19749385,1819,1,0,6899,1,54.97526113249040000000
chr11,46477323,46813489,336166,1,0,9776;79797;2147;55626;9793;392;283254,7,2.08230457571557000000
chr7,148667560,148859002,191442,1,0,136051;9601;155054;57541,4,2.08940566855758000000
chr5,919451,1248468,329017,1,0,348932;85409;340024;10723,4,1.21574265159551000000
chrY,116314,455713,339399,1,0,55344;28227;8225,3,0.88391539161871400000
chr7,76643094,76691820,48726,1,0,,0,0.00000000000000000000
chrX,168992,506573,337581,1,0,55344;28227;8225,3,0.88867560674327100000
chr5,159186941,159267825,80884,1,0,,0,0.00000000000000000000
chr14,56604414,57166717,562303,1,0,54916;57161,2,0.35568012263850600000
chr14,53309610,53731754,422144,1,0,10979;80821,2,0.47377198302001200000
chr17,36373339,36668359,295020,1,0,84311;57636;30837;440435,4,1.35584028201478000000
chr13,52927345,53035150,107805,1,0,51028;55901;26586,3,2.78280228189787000000
chrX,1540629,1620153,79524,1,0,286530;8623,2,2.51496403601428000000
chrX,2700078,2799426,99348,1,0,7499;8908,2,2.01312557877360000000
chr9,30288006,30379350,91344,1,0,,0,0.00000000000000000000
chr15,57670483,57748324,77841,1,0,84952,1,1.28467003250215000000
chr14,83878911,84180662,301751,1,0,,0,0.00000000000000000000
chrY,16183094,16268982,85888,1,0,,0,0.00000000000000000000
chrX,8139236,8540060,400824,1,0,425054;3730;51480,3,0.74845817615711600000
chr10,6717557,6833130,115573,1,0,,0,0.00000000000000000000
chr9,450056,753199,303143,1,0,81704;23189,2,0.65975463725040700000
chr16,34197127,34202356,5229,1,0,,0,0.00000000000000000000
chr3,115046831,115134846,88015,1,0,,0,0.00000000000000000000
chr2,101217928,101312046,94118,1,0,,0,0.00000000000000000000
chr6,147187517,147293795,106278,1,0,,0,0.00000000000000000000
chr1,238279058,238650969,371911,1,0,,0,0.00000000000000000000
chr7,70324801,70594595,269794,1,0,,0,0.00000000000000000000
chr2,133861655,134189758,328103,1,0,344148,1,0.30478233969210900000
chr13,34427867,34673127,245260,1,0,5983,1,0.40773057163826100000
chr22,17393188,17454928,61740,1,0,128954,1,1.61969549724652000000
chr13,64221268,64303187,81919,1,0,,0,0.00000000000000000000
chrX,153867964,153877403,9439,1,0,,0,0.00000000000000000000
chrX,153786801,153792952,6151,1,0,8517,1,16.25751910258490000000
chr3,138440909,138605254,164345,1,0,5291,1,0.60847607167848100000
chrX,154560225,154693287,133062,1,0,474383;83740;474384;1193;474381,5,3.75764681126092000000
chr8,79064827,79147991,83164,1,0,,0,0.00000000000000000000
chr18,1652653,2233823,581170,1,0,,0,0.00000000000000000000
chr18,192777,533571,340794,1,0,9984;9097;81035,3,0.88029718833078100000
chr8,36307120,36383673,76553,1,0,,0,0.00000000000000000000
chr17,80917680,80965240,47560,1,0,146712,1,2.10260723296888000000
chr22,25124344,25241118,116774,1,0,440822;129049,2,1.71271002106633000000
chr7,158734124,158862223,128099,1,0,7434;55112,2,1.56129243788008000000
chr8,2133976,2392318,258342,1,0,,0,0.00000000000000000000
chr16,76873190,77213902,340712,1,0,,0,0.00000000000000000000
chrX,82913639,83015971,102332,1,0,,0,0.00000000000000000000
chr9,10420881,12065755,1644874,1,0,5789,1,0.06079493018918170000
chrX,2700078,2799426,99348,1,0,7499;8908,2,2.01312557877360000000
chr16,76873190,77213902,340712,1,0,,0,0.00000000000000000000
chr18,29307070,29437858,130788,1,0,22878;147407,2,1.52919228063737000000
chr8,6644159,6918105,273946,1,0,389610;1671;1670;728358;1669;1672;1667;1668,8,2.92028355953363000000
chr5,102503919,102589065,85146,1,0,23262,1,1.17445329199258000000
chr4,8649762,8732736,82974,1,0,,0,0.00000000000000000000
chr13,25144372,25308356,163984,1,0,479,1,0.60981559176505000000
chr12,61271591,62158216,886625,1,0,338811,1,0.11278725504018000000
chr6,78874201,78956677,82476,1,0,,0,0.00000000000000000000
chr5,120308868,120399521,90653,1,0,,0,0.00000000000000000000
chr22,19747566,19749385,1819,1,0,6899,1,54.97526113249040000000
chr7,24993182,25067093,73911,1,0,26031,1,1.35297858234904000000
chr8,105412527,105428064,15537,1,0,1807,1,6.43624895410955000000
chrX,58039454,58271489,232035,1,0,,0,0.00000000000000000000
chr6,158872999,158943409,70410,1,0,56995,1,1.42025280499929000000
chr2,45433372,45961602,528230,1,0,5581;55133,2,0.37862294833689900000
chr17,29015464,29096481,81017,1,0,,0,0.00000000000000000000
chr3,2262738,2376688,113950,1,0,152330,1,0.87757788503729700000
chr13,28714980,28836186,121206,1,0,255967,1,0.82504166460406200000
chrX,114237574,114383325,145751,1,0,57631;3598,2,1.37220327819363000000
chr21,37498670,37608312,109642,1,0,9980;874,2,1.82411849473742000000
chr6,118704346,119121565,417219,1,0,5350;387119,2,0.47936455434675800000
chr2,117803186,117912243,109057,1,0,,0,0.00000000000000000000
chr4,125712544,126108643,396099,1,0,,0,0.00000000000000000000
chr15,102226122,102263300,37178,1,0,123283,1,2.68976276292431000000
chr12,122070676,122160641,89965,1,0,84876;144404;283385,3,3.33463013394098000000
chr15,102040846,102151210,110364,1,0,,0,0.00000000000000000000
chrX,1936244,1938320,2076,1,0,,0,0.00000000000000000000
chr7,129491036,129573092,82056,1,0,7328,1,1.21867992590426000000
chr3,157290403,157488127,197724,1,0,152078,1,0.50575549756225800000
chr2,189743,202591,12848,1,0,,0,0.00000000000000000000
chr1,199024396,199134376,109980,1,0,,0,0.00000000000000000000
chr7,83560356,83671411,111055,1,0,10371,1,0.90045472963846700000
chr7,111274617,111351905,77288,1,0,,0,0.00000000000000000000
chr5,44417832,44737104,319272,1,0,,0,0.00000000000000000000
chr20,59830238,59948890,118652,1,0,1002,1,0.84280079560395100000
chrX,110415298,110449836,34538,1,0,5063,1,2.89536163066767000000
chr17,17234564,17253404,18840,1,0,56953,1,5.30785562632696000000
chr4,113570677,113908087,337410,1,0,51574;287,2,0.59275065943510900000
chr16,14474582,14674912,200330,1,0,5073,1,0.49917635900763700000
chr4,190167770,190435172,267402,1,0,,0,0.00000000000000000000
chrX,652203,877796,225593,1,0,,0,0.00000000000000000000
chrY,602203,801864,199661,1,0,,0,0.00000000000000000000
chr2,137009302,137221396,212094,1,0,,0,0.00000000000000000000
chr2,133855802,134330741,474939,1,0,344148,1,0.21055335527299300000
chr21,35213510,35346033,132523,1,0,539;6453,2,1.50917199278616000000
chrY,9375519,9648990,273471,1,0,,0,0.00000000000000000000
chr4,190167770,190435172,267402,1,0,,0,0.00000000000000000000
chrX,77082384,77142497,60113,1,0,84061,1,1.66353367823932000000
chrX,65768031,65892281,124250,1,0,60401,1,0.80482897384305800000
chr4,9827799,9962048,134249,1,0,56606,1,0.74488450565739800000
chr22,48637217,48810052,172835,1,0,,0,0.00000000000000000000
chrX,90778670,90966470,187800,1,0,,0,0.00000000000000000000
chrY,4658668,4815765,157097,1,0,,0,0.00000000000000000000
chr2,7111210,7466937,355727,1,0,9781,1,0.28111445012608000000
chr9,10126124,12065755,1939631,1,0,5789,1,0.05155619806035270000
chrX,100150954,100474404,323450,1,0,79979;402415;2491;392509;59353,5,1.54583397743082000000
chr22,16889716,16969088,79372,1,0,,0,0.00000000000000000000
chr8,53345338,53487445,142107,1,0,389658,1,0.70369510298577800000
chr18,77730343,77801715,71372,1,0,440498;10907;79863,3,4.20332903659699000000
chrX,89463330,89485366,22036,1,0,,0,0.00000000000000000000
chr21,47877705,47959961,82256,1,0,23181,1,1.21571678661739000000
chr22,18569089,18641784,72695,1,0,51807;11274;55670,3,4.12683128138111000000
chr13,21986349,22066227,79878,1,0,253832,1,1.25190916147124000000
chrX,76118,599086,522968,1,0,55344;6473;28227;8225,4,0.76486515427330200000
chr22,39288109,39371389,83280,1,0,200315,1,1.20076849183477000000
chr7,57195134,57557599,362465,1,0,90827;441234,2,0.55177741299159900000
chr17,80363250,80478880,115630,1,0,79701;284004;79415;26502;3607,5,4.32413733460175000000
chr1,208821264,208980541,159277,1,0,,0,0.00000000000000000000
chr2,230767776,230900153,132377,1,0,130888;151473;9320,3,2.26625471192126000000
chr5,49568829,49588118,19289,1,0,,0,0.00000000000000000000
chrX,115944559,116042727,98168,1,0,,0,0.00000000000000000000
chr11,107759802,107833558,73756,1,0,54734,1,1.35582189923532000000
chr15,75545182,75673385,128203,1,0,54939;4123;25942;79661;653643;653641,6,4.68007768928964000000
chrX,61762462,62148402,385940,1,0,,0,0.00000000000000000000
chr8,43052822,43806324,753502,1,0,340441;138050,2,0.26542729813590400000
chr21,37498670,37578479,79809,1,0,9980;874,2,2.50598303449486000000
chr11,32957517,33053161,95644,1,0,79832;91614,2,2.09108778386517000000
chr2,41412673,41627736,215063,1,0,,0,0.00000000000000000000
chr7,97084398,97302005,217607,1,0,,0,0.00000000000000000000
chr2,130175725,130402732,227007,1,0,,0,0.00000000000000000000
chr12,131534039,132135146,601107,1,0,283383,1,0.16635973295935700000
chr8,11666795,11852988,186193,1,0,1508;2222;613210;613211;613209,5,2.68538559451752000000
chr1,153628027,153724899,96872,1,0,65123;23557;4881;3608,4,4.12916012882980000000
chr4,63994090,64103077,108987,1,0,,0,0.00000000000000000000
chr5,180576812,180604344,27532,1,0,285659,1,3.63213714949877000000
chr4,42844910,42968445,123535,1,0,389207,1,0.80948718986522000000
chrX,134766956,134910208,143252,1,0,441521;541466;441519,3,2.09421159913998000000
chr7,142458736,142460851,2115,1,0,5644,1,47.28132387706860000000
chr15,29031708,29212485,180777,1,0,,0,0.00000000000000000000
chr15,52579301,52796054,216753,1,0,55930;4644,2,0.92270925892605900000
chr12,116404558,116662086,257528,1,0,23389,1,0.38830729085769300000
chr1,30447090,30547034,99944,1,0,,0,0.00000000000000000000
chr1,100140259,100516107,375848,1,0,64645;178;54873;23443;391059,5,1.33032502501011000000
chr12,38360515,39029265,668750,1,0,144245,1,0.14953271028037400000
chr2,117777724,117912243,134519,1,0,,0,0.00000000000000000000
chr20,8117936,8558204,440268,1,0,23236,1,0.22713438178564000000
chr4,135455421,135557334,101913,1,0,,0,0.00000000000000000000
chrX,118983041,119001599,18558,1,0,65109,1,5.38851169307037000000
chr16,46605000,48321896,1716896,1,0,94160;85320;23594;83752;5257;79801;91807;388272;84706;81533;81831;55737;10294,13,0.75718039997763400000
chr10,42856843,42902551,45708,1,0,,0,0.00000000000000000000
chrX,130608954,130955457,346503,1,0,347468,1,0.28859778991812500000
chr13,59717837,59851187,133350,1,0,,0,0.00000000000000000000
chr14,73449201,73559156,109955,1,0,53349;58517,2,1.81892592424174000000
chr8,87196197,87312908,116711,1,0,157724,1,0.85681726658155600000
chr15,90849174,90943403,94229,1,0,8826;342132,2,2.12248883040253000000
chr2,855260,1829424,974164,1,0,7837;7173;54221;23040,4,0.41060848070756100000
chr5,591010,685537,94527,1,0,11076;55722,2,2.11579760280132000000
chrY,19209024,19538933,329909,1,0,,0,0.00000000000000000000
chr12,84108111,84426182,318071,1,0,,0,0.00000000000000000000
chr17,1053878,1159220,105342,1,0,29,1,0.94928898255206900000
chrX,1761595,2118475,356880,1,0,438,1,0.28020623178659500000
chr12,132184549,132302364,117815,1,0,6433,1,0.84878835462377500000
chr12,25944374,26207945,263571,1,0,11228,1,0.37940441095568200000
chr1,121149862,121164799,14937,1,0,,0,0.00000000000000000000
chr19,367928,392837,24909,1,0,51298,1,4.01461319201895000000
chr5,176594879,176635288,40409,1,0,64324,1,2.47469623103764000000
chr5,27427652,27535546,107894,1,0,,0,0.00000000000000000000
chr1,74688319,74844913,156594,1,0,100526835;51086,2,1.27718814258528000000
chr1,834103,864487,30384,1,0,148398,1,3.29120589784097000000
chr15,54849644,55025213,175569,1,0,440279,1,0.56957663368818000000
chr6,69852183,69922659,70476,1,0,577,1,1.41892275384528000000
chr17,36157856,36249799,91943,1,0,,0,0.00000000000000000000
chr7,153487687,153651332,163645,1,0,1804,1,0.61107885972684800000
chr13,43517133,43703834,186701,1,0,94240;29103,2,1.07123154134150000000
chr8,56735453,56854809,119356,1,0,96764;4067,2,1.67565937196287000000
chr22,49456297,49562692,106395,1,0,,0,0.00000000000000000000
chrX,153867964,153877403,9439,1,0,,0,0.00000000000000000000
chrX,153784454,153792952,8498,1,0,8517,1,11.76747469992940000000
chrX,8268156,8391934,123778,1,0,,0,0.00000000000000000000
chrX,148892554,149084864,192310,1,0,4107,1,0.51999376007487900000
chrY,1161392,1651330,489938,1,0,8623;293;1438;286530;3563;64109,6,1.22464475096849000000
chrX,1210459,1701330,490871,1,0,8623;293;1438;286530;3563;64109,6,1.22231706497226000000
chr8,51774576,51858863,84287,1,0,,0,0.00000000000000000000
chr12,244335,303088,58753,1,0,6539;440073,2,3.40408149371096000000
chr10,116829,201591,84762,1,0,10771,1,1.17977395531016000000
chrX,61931700,62148402,216702,1,0,,0,0.00000000000000000000
chrX,8268774,8391934,123160,1,0,,0,0.00000000000000000000
chrX,86141688,86691735,550047,1,0,,0,0.00000000000000000000
chr14,46063966,46270426,206460,1,0,,0,0.00000000000000000000
chr8,47217581,48028942,811361,1,0,,0,0.00000000000000000000
chr4,188573678,189036080,462402,1,0,205860;132625,2,0.43252408077819700000
chr7,6023196,7847938,1824742,1,0,5395;84132;5879;729852;54468;79034;9265;84792;221955;54753;6119;7559;7965;55146;221960;392862;100310846;728194;56913;100131017;27102;340267;11014,23,1.26045216255230000000
chr12,133169461,133311775,142314,1,0,192111;5426;5827;23141;22953;100507055,6,4.21602934356423000000
chr18,77730343,77801715,71372,1,0,440498;10907;79863,3,4.20332903659699000000
chr3,2087185,2153276,66091,1,0,152330,1,1.51306531902982000000
chrX,148651675,148718265,66590,1,0,100130086;728269;84548,3,4.50518095810182000000
chr16,15491554,16292304,800750,1,0,4629;123811;89927;4363;54820;255027;368;9665,8,0.99906337808304700000
chrY,1886244,1888320,2076,1,0,,0,0.00000000000000000000
chrX,154974465,155229888,255423,1,0,6845;3581;10251,3,1.17452226306950000000
chrX,134824559,134910208,85649,1,0,441521;541466;441519,3,3.50266786535745000000
chrX,352512,596201,243689,1,0,6473,1,0.41035910525300700000
chr7,110776968,110990982,214014,1,0,83943,1,0.46725915127047800000
chrY,302512,532923,230411,1,0,,0,0.00000000000000000000
chr3,96223784,96427734,203950,1,0,,0,0.00000000000000000000
chr13,20026166,20261437,235271,1,0,54737;93492,2,0.85008352070590900000
chr2,213048768,213167834,119066,1,0,2066,1,0.83987032402197100000
chr18,72391162,72589415,198253,1,0,55628,1,0.50440598629024500000
chr18,70927557,71091988,164431,1,0,,0,0.00000000000000000000
chr17,80917680,80965240,47560,1,0,146712,1,2.10260723296888000000
chr3,166102691,166398983,296292,1,0,,0,0.00000000000000000000
chr5,120991134,121092609,101475,1,0,,0,0.00000000000000000000
chr3,194688306,194808400,120094,1,0,152002,1,0.83268106649791000000
chr8,87196197,87312908,116711,1,0,157724,1,0.85681726658155600000
chr3,166058627,166362895,304268,1,0,,0,0.00000000000000000000
chrX,380444,392235,11791,1,0,,0,0.00000000000000000000
chrY,330444,342238,11794,1,0,,0,0.00000000000000000000
chr20,187617,222425,34808,1,0,140881,1,2.87290278096989000000
chr15,102226122,102265946,39824,1,0,123283,1,2.51104861390117000000
chr18,18520522,18703951,183429,1,0,6093,1,0.54517006580202700000
chr15,102040846,102144149,103303,1,0,,0,0.00000000000000000000
chr20,758267,956262,197995,1,0,343637;51378;83541,3,1.51518977751963000000
chr1,120935938,121350692,414754,1,0,2210;653464,2,0.48221355309412300000
chrX,47330209,47334862,4653,1,0,7592,1,21.49151085321300000000
chrX,61931700,62148402,216702,1,0,,0,0.00000000000000000000
chr16,8822807,8969711,146904,1,0,18;25880;5373;23589,4,2.72286663399227000000
chrX,63322292,63366314,44022,1,0,,0,0.00000000000000000000
chr17,10078561,10237885,159324,1,0,8522;8735,2,1.25530365795486000000
chr4,129786343,129914928,128585,1,0,132320;79960,2,1.55539137535482000000
chr15,85142549,86038866,896317,1,0,23478;57538;9154;5151;4828;100133220;54993;11214;9640;84942,10,1.11567670812893000000
chrX,92586664,92849576,262912,1,0,,0,0.00000000000000000000
chrX,113578080,113785254,207174,1,0,,0,0.00000000000000000000
chrX,187588,288196,100608,1,0,55344;8225,2,1.98791348600509000000
chr3,11758208,11870394,112186,1,0,9686;132001,2,1.78275364127431000000
chr3,159720,258637,98917,1,0,10752,1,1.01094857304609000000
chr8,51774576,51858863,84287,1,0,,0,0.00000000000000000000
chr4,135766634,135862995,96361,1,0,,0,0.00000000000000000000
chr6,162336827,162437271,100444,1,0,5071,1,0.99557962645852400000
chr1,161523634,161619000,95366,1,0,2215,1,1.04859174129145000000
chr8,106503371,106512522,9151,1,0,23414,1,10.92776745710850000000
chr15,30389992,30888835,498843,1,0,89832;101059918,2,0.40092774680610900000
chr19,45837573,45896151,58578,1,0,10848;147700;2068,3,5.12137662603708000000
chr8,12885177,13604161,718984,1,0,157773;10395;57604,3,0.41725546048312600000
chr1,196743096,196877502,134406,1,0,10877;3078;10878,3,2.23204321235659000000
chr7,153342262,153605524,263262,1,0,1804,1,0.37984973144624000000
chr22,17393188,17454928,61740,1,0,128954,1,1.61969549724652000000
chr4,188002248,188414222,411974,1,0,,0,0.00000000000000000000
chr4,189469131,189836679,367548,1,0,,0,0.00000000000000000000
chr18,77730343,77801715,71372,1,0,440498;10907;79863,3,4.20332903659699000000
chrX,122992956,123056117,63161,1,0,331,1,1.58325548993841000000
chr4,189247603,189470098,222495,1,0,,0,0.00000000000000000000
chr3,66795911,66930585,134674,1,0,,0,0.00000000000000000000
chr1,247829835,248267428,437593,1,0,343171;441933;81466;284532;26188;391192;26246;391189;343172;284521;391190;391191;343169;25893,14,3.19931991599500000000
chr3,1161258,1313330,152072,1,0,27255,1,0.65758325003945500000
chrX,2700078,2799426,99348,1,0,7499;8908,2,2.01312557877360000000
chr2,16082232,16083512,1280,1,0,10408;4613,2,156.25000000000000000000
chr15,102114275,102465347,351072,1,0,100128108;26682;390648;390649;123283;80213,6,1.70905113480995000000
chr1,16360871,16382760,21889,1,0,1188,1,4.56850472840239000000
chrX,1723434,2057128,333694,1,0,438,1,0.29967575083759400000
chr3,197637285,197766818,129533,1,0,84223;6165;89782,3,2.31601213590359000000
chrX,115944559,116042727,98168,1,0,,0,0.00000000000000000000
chr14,41400163,41517133,116970,1,0,,0,0.00000000000000000000
chr22,19747566,19749315,1749,1,0,6899,1,57.17552887364210000000
chr19,20830046,20967557,137511,1,0,199777,1,0.72721455010871900000
chr11,51287092,51446972,159880,1,0,81318,1,0.62546910182637000000
chr11,54826613,55183752,357139,1,0,81327;79097;81328,3,0.84000907209797900000
chrX,148838672,149029213,190541,1,0,4108;4107;100506164,3,1.57446428852583000000
chr17,18950617,19207522,256905,1,0,388436;400581;79999;22905,4,1.55699577664896000000
chr3,163824229,164007275,183046,1,0,,0,0.00000000000000000000
chr16,75850491,76014274,163783,1,0,,0,0.00000000000000000000
chr3,10071211,10083523,12312,1,0,2177,1,8.12215724496426000000
chr5,99119333,99308622,189289,1,0,,0,0.00000000000000000000
chr5,98358158,98653155,294997,1,0,,0,0.00000000000000000000
chr5,120308868,120399521,90653,1,0,,0,0.00000000000000000000
chr10,81654864,81962208,307344,1,0,6441;80195;219348;311,4,1.30147326773908000000
chr10,88209231,88861030,651799,1,0,6623;657;23063;54537;94233;79812;11155;10974;119385;643161;2746,11,1.68763683282730000000
chr12,132081068,132192448,111380,1,0,,0,0.00000000000000000000
chr4,79926983,80118958,191975,1,0,,0,0.00000000000000000000
chrY,16183094,16287285,104191,1,0,,0,0.00000000000000000000
chr7,153487687,153823119,335432,1,0,1804,1,0.29812301748193400000
chr8,86467089,86548194,81105,1,0,,0,0.00000000000000000000
chr10,88622655,88906967,284312,1,0,6623;657;54537;79812;2746;10974;643161;119385,8,2.81381018036523000000
chr1,238434659,238554725,120066,1,0,,0,0.00000000000000000000
chr8,42914053,43529734,615681,1,0,84197;2339;138050;340441,4,0.64968709445313400000
chrX,1401142,1766175,365033,1,0,8227;3563;293;1438;286530;8623;438,7,1.91763484397301000000
chr3,197213771,197322923,109152,1,0,622,1,0.91615362063910900000
chr12,112184121,112303042,118921,1,0,8550;217;80724,3,2.52268312577257000000
chr22,33863037,33921502,58465,1,0,9215,1,1.71042504062259000000
chr4,125456671,125670184,213513,1,0,57182,1,0.46835555680450400000
chr20,47108414,47211863,103449,1,0,,0,0.00000000000000000000
chr12,7771475,7941164,169689,1,0,170482;339;360030;9573;359787,5,2.94656695484091000000
chr21,37498670,37608312,109642,1,0,9980;874,2,1.82411849473742000000
chrY,16183094,16287285,104191,1,0,,0,0.00000000000000000000
chrX,8138491,8540060,401569,1,0,425054;3730;51480,3,0.74706961941783400000
chr15,92693959,93172926,478967,1,0,400451;145858;28232;8128,4,0.83513060398733100000
chr16,74202828,74341227,138399,1,0,5713,1,0.72254857332784200000
chrX,148892554,149084864,192310,1,0,4107,1,0.51999376007487900000
chr4,145434648,145549131,114483,1,0,,0,0.00000000000000000000
chr16,7004304,7046177,41873,1,0,54715,1,2.38817376352303000000
chr17,19141662,19190890,49228,1,0,22905,1,2.03136426423986000000
chr13,67345415,67369860,24445,1,0,5101,1,4.09081611781550000000
chrY,1704406,2007128,302722,1,0,438,1,0.33033608393179200000
chrX,1723434,2057128,333694,1,0,438,1,0.29967575083759400000
chr3,34452148,34592821,140673,1,0,,0,0.00000000000000000000
chr16,6660795,6685821,25026,1,0,54715,1,3.99584432190522000000
chrX,106791395,107064293,272898,1,0,1831;84443;5631,3,1.09931183079392000000
chrY,16183094,16287285,104191,1,0,,0,0.00000000000000000000
chr9,28718355,28932451,214096,1,0,158038,1,0.46708018832673200000
chr9,71833406,71945284,111878,1,0,9413;9414,2,1.78766155991348000000
chr6,168790739,168948843,158104,1,0,64094,1,0.63249506653848100000
chr8,47038362,47355732,317370,1,0,,0,0.00000000000000000000
chr7,64387325,64500614,113289,1,0,51351;109504726;2086;10793,4,3.53079292782177000000
chr1,101493240,101609152,115912,1,0,,0,0.00000000000000000000
chr2,112216442,112476717,260275,1,0,,0,0.00000000000000000000
chr7,8197222,8492998,295776,1,0,30010;3382,2,0.67618738504814500000
chr8,43527889,43529734,1845,1,0,,0,0.00000000000000000000
chr8,145777874,145905479,127605,1,0,80728,1,0.78366835155362200000
chr16,8854129,9154380,300251,1,0,18;5373;25880;23589;7874,5,1.66527338793210000000
chrX,126163153,126317726,154573,1,0,,0,0.00000000000000000000
chr2,117777724,117912243,134519,1,0,,0,0.00000000000000000000
chr5,6973253,7193121,219868,1,0,,0,0.00000000000000000000
chr8,6139436,6302530,163094,1,0,79648,1,0.61314334065017700000
chr1,120840,759117,638277,1,0,729759;81399,2,0.31334357966838800000
chr3,10047958,10083523,35565,1,0,55831;2177;401052,3,8.43525938422606000000
chr10,1528470,1899616,371146,1,0,105,1,0.26943574765725600000
chr10,3233364,3862202,628838,1,0,1316,1,0.15902346868350800000
chr4,74784540,74983706,199166,1,0,5196;6374;2921;2920;5473,5,2.51046865428838000000
chr1,242151604,242240220,88616,1,0,440738,1,1.12846438566399000000
chrX,2118416,2477760,359344,1,0,207063;9189,2,0.55656974932098500000
chr2,241553701,241575534,21833,1,0,2859,1,4.58022259881830000000
chr17,26005959,26062031,56072,1,0,,0,0.00000000000000000000
chr13,20415685,20447972,32287,1,0,9205,1,3.09722179205253000000
chr1,181635018,181905049,270031,1,0,777,1,0.37032785124670900000
chr8,47887883,47929212,41329,1,0,,0,0.00000000000000000000
chr21,18706962,19051366,344404,1,0,10950;1525,2,0.58071334827702300000
chr4,111387355,111444643,57288,1,0,2028,1,1.74556626169529000000
chrX,151720571,151898338,177767,1,0,266740;55879,2,1.12506820726007000000
chr9,140999851,141087916,88065,1,0,774,1,1.13552489638335000000
chr17,80254374,80367443,113069,1,0,79701;2837;924;6398;400629,5,4.42207855380343000000
chr8,42970277,43806324,836047,1,0,84197;340441;138050,3,0.35883150109981900000
chr19,54739877,54835792,95915,1,0,11025;10990;10288,3,3.12776937913778000000
chr3,2173453,2191117,17664,1,0,152330,1,5.66123188405797000000
chr6,100288688,100633593,344905,1,0,84539,1,0.28993490961279200000
chr8,36259847,36429253,169406,1,0,,0,0.00000000000000000000
chrX,61762462,62148402,385940,1,0,,0,0.00000000000000000000
chr4,74784540,74983706,199166,1,0,5196;6374;2921;2920;5473,5,2.51046865428838000000
chr4,189316513,189727994,411481,1,0,,0,0.00000000000000000000
chrX,52568838,52693961,125123,1,0,280658,1,0.79921357384333800000
chr13,114740192,114844116,103924,1,0,22821,1,0.96224163812016500000
chr8,9313730,9420235,106505,1,0,8658,1,0.93892305525562200000
chrX,166314,182196,15882,1,0,,0,0.00000000000000000000
chr6,78133548,78277655,144107,1,0,3351,1,0.69392881678197400000
chr9,9231882,9302279,70397,1,0,5789,1,1.42051507876756000000
chrX,1997225,2226786,229561,1,0,207063,1,0.43561406336442200000
chrY,1934403,2176774,242371,1,0,207063,1,0.41259061521386600000
chr8,132480039,132565943,85904,1,0,,0,0.00000000000000000000
chrX,61931700,62148402,216702,1,0,,0,0.00000000000000000000
chr21,35734654,35905170,170516,1,0,101928147;9992;3753;54065;1827,5,2.93227615003871000000
chr16,77598605,77851468,252863,1,0,283927;57687,2,0.79094213071900600000
chr7,57211802,57557599,345797,1,0,441234,1,0.28918700856282700000
chr14,28103607,28212480,108873,1,0,,0,0.00000000000000000000
chr1,249172848,249203359,30511,1,0,267002,1,3.27750647307528000000
chr8,132480039,132565943,85904,1,0,,0,0.00000000000000000000
chr7,72645480,72649323,3843,1,0,,0,0.00000000000000000000
chr1,228894718,229082601,187883,1,0,,0,0.00000000000000000000
chr15,101790577,101887579,97002,1,0,6627;55829;5046;22856,4,4.12362631698316000000
chr10,42856843,42902551,45708,1,0,,0,0.00000000000000000000
chr12,39319012,39524854,205842,1,0,,0,0.00000000000000000000
chrX,154235454,154310067,74613,1,0,79184;100272147;65991;4515;2157,5,6.70124509133797000000
chr2,242768430,243087748,319318,1,0,285093;5133,2,0.62633487620491200000
chr4,189247603,189414175,166572,1,0,,0,0.00000000000000000000
chr4,190226001,190552451,326450,1,0,,0,0.00000000000000000000
chrY,9184291,9354439,170148,1,0,728403;728137;7258,3,1.76317088652232000000
chr16,35036206,35149159,112953,1,0,,0,0.00000000000000000000
chr2,2717230,3307688,590458,1,0,7260,1,0.16936005609205100000
chrX,125082256,125153764,71508,1,0,,0,0.00000000000000000000
chr12,133678891,133758902,80011,1,0,7699;101060200;7556;10795,4,4.99931259451825000000
chr9,6755750,6861679,105929,1,0,23081,1,0.94402854742327400000
chr3,68841962,69098027,256065,1,0,285203;7110;151647,3,1.17157752914299000000
chrX,1776938,1973261,196323,1,0,,0,0.00000000000000000000
chrY,1728677,1923181,194504,1,0,,0,0.00000000000000000000
chr6,81500098,81619627,119529,1,0,,0,0.00000000000000000000
chrY,2078811,2205389,126578,1,0,207063,1,0.79002670290255800000
chrX,2118264,2255389,137125,1,0,207063,1,0.72926162260711000000
chr13,50360885,50427707,66822,1,0,3839,1,1.49651312442010000000
chr4,129786343,129914928,128585,1,0,132320;79960,2,1.55539137535482000000
chr22,49207576,49664800,457224,1,0,,0,0.00000000000000000000
chr7,6870220,7170468,300248,1,0,,0,0.00000000000000000000
chrX,1860853,2057128,196275,1,0,,0,0.00000000000000000000
chr1,193359380,193462558,103178,1,0,,0,0.00000000000000000000
chr16,6660795,6685821,25026,1,0,54715,1,3.99584432190522000000
chr3,81329178,81523998,194820,1,0,,0,0.00000000000000000000
chr7,54222095,54368204,146109,1,0,,0,0.00000000000000000000
chr9,789688,973884,184196,1,0,1761,1,0.54289995439640400000
chr1,229151474,229318534,167060,1,0,,0,0.00000000000000000000
chr3,10071211,10083523,12312,1,0,2177,1,8.12215724496426000000
chrX,99325082,99544613,219531,1,0,,0,0.00000000000000000000
chr1,248513776,248861875,348099,1,0,401993;254879;403244;127077;343173;127069;403239;127074;343563;391211;26696;127068;401994;401992,14,4.02184436036875000000
chr7,146226394,146254734,28340,1,0,26047,1,3.52858151023289000000
chr5,180663457,180696832,33375,1,0,84851;10399,2,5.99250936329588000000
chrX,38488591,38621617,133026,1,0,7102,1,0.75173274397486200000
chr5,138530541,138673050,142509,1,0,64374;9782,2,1.40342013486868000000
chr1,144005360,144058352,52992,1,0,,0,0.00000000000000000000
chrX,89737026,89794034,57008,1,0,,0,0.00000000000000000000
chr12,27306290,27763895,457605,1,0,341346;23012;8496;56938,4,0.87411632302968700000
chr4,111387355,111452044,64689,1,0,2028,1,1.54585787382708000000
chr9,5547309,5632242,84933,1,0,80380;57589,2,2.35479731082147000000
chr2,230643557,230900153,256596,1,0,130888;151473;9320,3,1.16915306551934000000
chrX,1819261,2336571,517310,1,0,207063,1,0.19330768784674600000
chr1,90548381,90667296,118915,1,0,,0,0.00000000000000000000
chr2,86305963,86480790,174827,1,0,10989;25885;55037;65055;51318,5,2.85997014191172000000
chr2,223112740,223124295,11555,1,0,5077,1,8.65426222414539000000
chr8,11666795,11852988,186193,1,0,1508;2222;613210;613211;613209,5,2.68538559451752000000
chr9,141006412,141018976,12564,1,0,774,1,7.95924864692773000000
chr11,16901973,17001257,99284,1,0,144100,1,1.00721163530881000000
chr16,8822352,8969711,147359,1,0,18;25880;5373;23589,4,2.71445924578750000000
chr18,20037456,20330430,292974,1,0,,0,0.00000000000000000000
chr3,166058627,166349282,290655,1,0,,0,0.00000000000000000000
chr18,25796875,25992442,195567,1,0,,0,0.00000000000000000000
chr5,29507620,29629628,122008,1,0,,0,0.00000000000000000000
chr5,37292628,37565960,273332,1,0,9631;55100,2,0.73171088639456800000
chr8,86842154,86917752,75598,1,0,,0,0.00000000000000000000
chr4,164572966,164906180,333214,1,0,55016,1,0.30010743846297000000
chr16,15048660,15255670,207010,1,0,23042;54700;123803,3,1.44920535239843000000
chrX,2700078,2799426,99348,1,0,7499;8908,2,2.01312557877360000000
chrX,63788140,63903407,115267,1,0,,0,0.00000000000000000000
chr5,36205604,36285317,79713,1,0,133686;202151,2,2.50900104123543000000
chr17,73938568,73954983,16415,1,0,51,1,6.09198903441974000000
chrX,1723434,2057128,333694,1,0,438,1,0.29967575083759400000
chrX,93307552,93755214,447662,1,0,,0,0.00000000000000000000
chr6,167814714,168192844,378130,1,0,,0,0.00000000000000000000
chrX,115965435,116042727,77292,1,0,,0,0.00000000000000000000
chr4,190226001,190713599,487598,1,0,,0,0.00000000000000000000
chr13,43464212,43849544,385332,1,0,94240;55068;29103,3,0.77854940674535200000
chrX,2700078,2799426,99348,1,0,7499;8908,2,2.01312557877360000000
chr5,119524862,119692158,167296,1,0,,0,0.00000000000000000000
chr4,185713439,185983396,269957,1,0,2180;391723,2,0.74085872935319300000
chr15,31010724,31276928,266204,1,0,22909;54893,2,0.75130351159261300000
chr3,98898996,99034352,135356,1,0,,0,0.00000000000000000000
chr16,85223916,85333250,109334,1,0,,0,0.00000000000000000000
chr19,45837573,45873303,35730,1,0,147700;2068,2,5.59753708368318000000
chrY,119791,59349649,59229858,1,0,1617;6845;286530;378948;83259;7258;159163;8287;9426;86614;57055;8227;8284;207063;100289087;378950;5940;442867;100533178;10251;28227;7404;728395;57135;378951;9081;438;9084;378949;9086;203611;9085;353515;728403;4267;442868;293;9189;3581;140032;57054;90665;90655;3563;6192;8653;353513;64591;728137;22829;159119;7544;6736;8225;9082;8623;442862;9087;266;6473;1438;9083;64109;55344;253175,65,0.10974194805599600000
chr16,61483827,61566045,82218,1,0,,0,0.00000000000000000000
chr10,103288311,103315915,27604,1,0,8945,1,3.62266338211853000000
chrX,1738622,1766175,27553,1,0,438,1,3.62936885275651000000
chrY,1704406,1728736,24330,1,0,438,1,4.11015207562680000000
chr10,82027373,82221974,194601,1,0,84293;4143;84332;143241;81619,5,2.56935986968207000000
chr11,22872216,23238291,366075,1,0,100500938,1,0.27316806665300800000
chrY,18383977,18418326,34349,1,0,,0,0.00000000000000000000
chr5,16135592,16248427,112835,1,0,441061,1,0.88624983382815600000
chrX,8268156,8571311,303155,1,0,425054;3730,2,0.65972852171331500000
chr15,57670483,57748324,77841,1,0,84952,1,1.28467003250215000000
chr1,216447522,216561804,114282,1,0,7399,1,0.87502843842424900000
chr16,29683449,29687288,3839,1,0,,0,0.00000000000000000000
chrX,380444,734995,354551,1,0,6473,1,0.28204687054894800000
chr6,129302409,129338693,36284,1,0,3908,1,2.75603571822291000000
chr5,149235805,149266698,30893,1,0,5145,1,3.23697925096300000000
chr13,92992513,93046459,53946,1,0,2262,1,1.85370555740926000000
chr4,9827799,9962048,134249,1,0,56606,1,0.74488450565739800000
chrX,2700078,2799426,99348,1,0,7499;8908,2,2.01312557877360000000
chr6,43723987,44146874,422887,1,0,55362;7422;64928;221416;11131,5,1.18234894901002000000
chrX,35914492,36024696,110204,1,0,286464,1,0.90740807956154000000
chr13,43517133,43703834,186701,1,0,94240;29103,2,1.07123154134150000000
chrY,9375519,9648990,273471,1,0,,0,0.00000000000000000000
chrX,1610332,1890242,279910,1,0,286530;8227;438,3,1.07177306991533000000
chrY,1557392,1840394,283002,1,0,286530;8227;438,3,1.06006317976551000000
chr5,61116372,61306880,190508,1,0,,0,0.00000000000000000000
chr6,81462869,81619627,156758,1,0,,0,0.00000000000000000000
chr22,17345958,17385998,40040,1,0,,0,0.00000000000000000000
chr3,2769987,3049098,279111,1,0,152330,1,0.35828039740461700000
chr3,1636926,1771199,134273,1,0,,0,0.00000000000000000000
chr13,64221268,64287675,66407,1,0,,0,0.00000000000000000000
chr17,20432849,20812664,379815,1,0,339184;256223,2,0.52657214696628600000
chr16,77982844,79188147,1205303,1,0,51741;57687;10143,3,0.24890006911125300000
chr2,76291317,77347812,1056495,1,0,80059,1,0.09465260129011490000
chr3,81329178,81534119,204941,1,0,,0,0.00000000000000000000
chr10,103288311,103315915,27604,1,0,8945,1,3.62266338211853000000
chr16,15130754,16150915,1020161,1,0,4629;100288332;123811;89927;4363;54820;255027;23042;54700;123803;9665,11,1.07826117642215000000
chr2,36351331,36570247,218916,1,0,,0,0.00000000000000000000
chr6,119975943,120608299,632356,1,0,,0,0.00000000000000000000
chr16,8822352,8969711,147359,1,0,18;25880;5373;23589,4,2.71445924578750000000
chr2,233209808,233275967,66159,1,0,250;251,2,3.02302029958131000000
chr3,8405032,8478357,73325,1,0,,0,0.00000000000000000000
chr9,130627904,130644464,16560,1,0,203,1,6.03864734299517000000
chr5,180328403,180430548,102145,1,0,79908;10917,2,1.95800088110040000000
chrX,3459660,3518173,58513,1,0,,0,0.00000000000000000000
chr10,35070381,35213175,142794,1,0,56288,1,0.70030953681527200000
chr8,110068192,110168342,100150,1,0,7201,1,0.99850224663005500000
chr8,9313730,9410688,96958,1,0,,0,0.00000000000000000000
chr4,74784540,74983706,199166,1,0,5196;6374;2921;2920;5473,5,2.51046865428838000000
chr9,21396592,21675886,279294,1,0,3445;338376;3439,3,1.07413693097596000000
chr9,105976857,106046901,70044,1,0,,0,0.00000000000000000000
chr12,112184121,112303042,118921,1,0,8550;217;80724,3,2.52268312577257000000
chr9,30288006,30379350,91344,1,0,,0,0.00000000000000000000
chr16,34956837,35149159,192322,1,0,,0,0.00000000000000000000
chr8,43359455,43541984,182529,1,0,,0,0.00000000000000000000
chr1,24470628,24735930,265302,1,0,90529;57822;163702,3,1.13078680145645000000
chr15,90849174,90943403,94229,1,0,8826;342132,2,2.12248883040253000000
chrX,8268156,8573235,305079,1,0,425054;3730,2,0.65556790208437800000
chr3,87750591,87806840,56249,1,0,,0,0.00000000000000000000
chrX,8497180,8926396,429216,1,0,171482;3730,2,0.46596585402221700000
chr2,131477993,131508700,30707,1,0,344561,1,3.25658644608721000000
chr12,106335497,106457122,121625,1,0,,0,0.00000000000000000000
chr6,167551089,168071102,520013,1,0,83887;1235;6953;54346;2853;401285,6,1.15381730841344000000
chr1,19207207,19410467,203260,1,0,126917;23352;8659,3,1.47594214306799000000
chr5,159124838,159204023,79185,1,0,,0,0.00000000000000000000
chr8,144933854,145076898,143044,1,0,83481;84875;5339;2907,4,2.79634238416152000000
chr1,175443890,175752647,308757,1,0,7143,1,0.32387929666371900000
chr2,233209808,233275967,66159,1,0,250;251,2,3.02302029958131000000
chr14,82807472,82900728,93256,1,0,,0,0.00000000000000000000
chr15,84416357,84753474,337117,1,0,57188,1,0.29663291972816600000
chr12,38403897,39029265,625368,1,0,144245,1,0.15990584743702900000
chrY,393302,581797,188495,1,0,6473,1,0.53051805087668100000
chrX,443302,624771,181469,1,0,6473,1,0.55105830747951400000
chrY,279956,294955,14999,1,0,28227,1,6.66711114074272000000
chrX,329946,344955,15009,1,0,28227,1,6.66266906522753000000
chr22,51168854,51170255,1401,1,0,85358,1,71.37758743754460000000
chr22,19136178,19137005,827,1,0,2928,1,120.91898428053200000000
chr20,57464389,57466014,1625,1,0,2778,1,61.53846153846150000000
chr15,96873119,96874735,1616,1,0,7026,1,61.88118811881190000000
chr19,37207122,37330280,123158,1,0,728485;342892;163081;388536,4,3.24786047191413000000
chr10,42856843,42969821,112978,1,0,,0,0.00000000000000000000
chr3,141832523,142083953,251430,1,0,256356;54464;7029,3,1.19317503877819000000
chrY,3150141,3445311,295170,1,0,,0,0.00000000000000000000
chrX,88852095,89182658,330563,1,0,90316,1,0.30251419547862300000
chr1,16360871,16387929,27058,1,0,348487;1188,2,7.39152930741370000000
chr12,84108111,84426182,318071,1,0,,0,0.00000000000000000000
chrX,130869016,130955457,86441,1,0,,0,0.00000000000000000000
chrX,1365848,1778736,412888,1,0,8227;3563;293;1438;286530;8623;438,7,1.69537501695375000000
chrY,1321226,1728736,407510,1,0,8227;293;1438;286530;3563;438;8623,7,1.71774925768693000000
chr3,89430426,89554162,123736,1,0,2042,1,0.80817223766729200000
chr20,62893059,62952205,59146,1,0,55251,1,1.69073141040814000000
chr9,27328584,27407237,78653,1,0,79817,1,1.27140732076335000000
chr5,36205604,36285317,79713,1,0,133686;202151,2,2.50900104123543000000
chr9,32030487,32117000,86513,1,0,,0,0.00000000000000000000
chr16,34197202,35036265,839063,1,0,,0,0.00000000000000000000
chr14,63785235,63859721,74486,1,0,122876;5529,2,2.68506833498913000000
chrX,1559288,1610391,51103,1,0,286530;8623,2,3.91366455981058000000
chr3,170422902,170593366,170464,1,0,200916,1,0.58663412802703200000
chrX,42557923,42691353,133430,1,0,,0,0.00000000000000000000
chr2,45433372,45961602,528230,1,0,5581;55133,2,0.37862294833689900000
chrX,96555320,97197072,641752,1,0,1730,1,0.15582343335120100000
chr15,30491415,30730576,239161,1,0,89832;101059918,2,0.83625674754663200000
chr5,120991134,121092609,101475,1,0,,0,0.00000000000000000000
chr22,17059296,17547398,488102,1,0,150160;128954;150165,3,0.61462563152783600000
chr4,129786343,129914928,128585,1,0,132320;79960,2,1.55539137535482000000
chr1,216447522,216561804,114282,1,0,7399,1,0.87502843842424900000
chrY,1704406,1981454,277048,1,0,438,1,0.36094828332996400000
chrX,1746694,1984462,237768,1,0,438,1,0.42057804246155900000
chr11,49806446,49998015,191569,1,0,283092,1,0.52200512609033800000
chr2,50937464,50949412,11948,1,0,9378,1,8.36960160696351000000
chr3,141832523,142083953,251430,1,0,256356;54464;7029,3,1.19317503877819000000
chr2,3726845,3969703,242858,1,0,55821;728597,2,0.82352650520057000000
chr2,127935788,128100790,165002,1,0,10746;339761;2071,3,1.81815977988146000000
chr8,56735453,56854809,119356,1,0,96764;4067,2,1.67565937196287000000
chr1,16370213,16387929,17716,1,0,348487;1188,2,11.28923007450890000000
chr21,35213510,35379344,165834,1,0,539;6453,2,1.20602530241084000000
chr6,164695215,164975304,280089,1,0,,0,0.00000000000000000000
chr12,133678891,133758902,80011,1,0,7699;101060200;7556;10795,4,4.99931259451825000000
chrX,77082384,77142497,60113,1,0,84061,1,1.66353367823932000000
chr1,16367106,16387929,20823,1,0,348487;1188,2,9.60476396292561000000
chr16,15130754,15180006,49252,1,0,23042;54700;123803,3,6.09112320311865000000
chr4,63607544,64134877,527333,1,0,,0,0.00000000000000000000
chr4,117675779,117824237,148458,1,0,,0,0.00000000000000000000
chr4,74784540,74983706,199166,1,0,5196;6374;2921;2920;5473,5,2.51046865428838000000
chr7,57369653,57557599,187946,1,0,441234,1,0.53206772157960300000
chr10,17083133,17200167,117034,1,0,1787;8029,2,1.70890510449955000000
chr1,231741756,231813980,72224,1,0,27185,1,1.38458130261409000000
chr19,45837573,45896151,58578,1,0,10848;147700;2068,3,5.12137662603708000000
chr8,128280456,128340814,60358,1,0,,0,0.00000000000000000000
chr7,16926251,17412348,486097,1,0,196,1,0.20572025747947400000
chr5,319944,686145,366201,1,0,57491;6550;11076;55722;11336,5,1.36537038402407000000
chrY,15703884,16095908,392024,1,0,9087,1,0.25508642328020700000
chr5,120308868,120399521,90653,1,0,,0,0.00000000000000000000
chr10,103288311,103315915,27604,1,0,8945,1,3.62266338211853000000
chrX,90782539,90895787,113248,1,0,,0,0.00000000000000000000
chrY,4658668,4724893,66225,1,0,,0,0.00000000000000000000
chr15,34233686,34392791,159105,1,0,1133;57099;56851,3,1.88554728009805000000
chr12,52700478,52780478,80000,1,0,3891;3890;3889;3892,4,5.00000000000000000000
chr6,118889951,118989529,99578,1,0,387119,1,1.00423788386993000000
chr16,29683449,29687288,3839,1,0,,0,0.00000000000000000000
chr16,18253315,18780881,527566,1,0,283820;101059953,2,0.37909948707839400000
chr8,43527889,43529734,1845,1,0,,0,0.00000000000000000000
chrX,2700078,2799426,99348,1,0,7499;8908,2,2.01312557877360000000
chr8,6139436,6302530,163094,1,0,79648,1,0.61314334065017700000
chr19,12990440,13203100,212660,1,0,5886;4784;811;256126;10661;2193;199699;2639;90480;1777,10,4.70234176619957000000
chr9,121060261,121608296,548035,1,0,,0,0.00000000000000000000
chr6,162981819,163199666,217847,1,0,135138;5071,2,0.91807553007385900000
chr2,211438663,211453416,14753,1,0,1373,1,6.77828238324409000000
chr19,20830046,20967557,137511,1,0,199777,1,0.72721455010871900000
chr16,8832856,8969711,136855,1,0,18;25880;5373;23589,4,2.92280150524277000000
chr4,190167770,190435172,267402,1,0,,0,0.00000000000000000000
chr7,65199758,65286704,86946,1,0,,0,0.00000000000000000000
chr16,8854129,8942008,87879,1,0,18;25880;5373,3,3.41378486327792000000
chr1,68507835,68582131,74296,1,0,9077;79971,2,2.69193496285130000000
chrX,1746694,1984462,237768,1,0,438,1,0.42057804246155900000
chr5,175547762,175628957,81195,1,0,,0,0.00000000000000000000
chr12,112184121,112303042,118921,1,0,8550;217;80724,3,2.52268312577257000000
chr14,63785235,63859721,74486,1,0,122876;5529,2,2.68506833498913000000
chrX,115944559,116042727,98168,1,0,,0,0.00000000000000000000
chr8,8072696,8353799,281103,1,0,157285,1,0.35574148977421100000
chr1,752671,867623,114952,1,0,148398,1,0.86992831790660500000
chr3,1865713,2088468,222755,1,0,,0,0.00000000000000000000
chr6,118739885,119031639,291754,1,0,5350;387119,2,0.68550902472631000000
chrX,63788140,63903407,115267,1,0,,0,0.00000000000000000000
chrX,426501,715415,288914,1,0,6473,1,0.34612376001163000000
chrX,1559288,1610391,51103,1,0,286530;8623,2,3.91366455981058000000
chrY,1511009,1557451,46442,1,0,286530;8623,2,4.30644675078593000000
chrY,9375519,9648990,273471,1,0,,0,0.00000000000000000000
chr6,94785275,94898111,112836,1,0,,0,0.00000000000000000000
chr13,20415685,20447972,32287,1,0,9205,1,3.09722179205253000000
chrX,115944559,116042727,98168,1,0,,0,0.00000000000000000000
chrX,46317572,46336973,19401,1,0,55634,1,5.15437348590279000000
chr1,151333091,151388406,55315,1,0,8991;23126;5692,3,5.42348368435325000000
chr2,156830734,157075170,244436,1,0,,0,0.00000000000000000000
chr4,129786343,129914928,128585,1,0,132320;79960,2,1.55539137535482000000
chr13,58823878,59645367,821489,1,0,,0,0.00000000000000000000
chr3,21260236,21330426,70190,1,0,,0,0.00000000000000000000
chr3,21260236,21330426,70190,1,0,,0,0.00000000000000000000
chr20,29833379,29850641,17262,1,0,245929,1,5.79307148650214000000
chr7,57316016,57557599,241583,1,0,441234,1,0.41393641108852900000
chrX,2700078,2799426,99348,1,0,7499;8908,2,2.01312557877360000000
chrX,127048508,127256947,208439,1,0,139741,1,0.47975666741828500000
chrX,115944559,116042727,98168,1,0,,0,0.00000000000000000000
chr13,20415685,20447972,32287,1,0,9205,1,3.09722179205253000000
chr10,68754191,68909060,154869,1,0,347731;29119,2,1.29141403379631000000
chr4,160381912,160503530,121618,1,0,,0,0.00000000000000000000
chr2,109210529,109496339,285810,1,0,5903;3987;165055,3,1.04964836779679000000
chr5,45802679,45908506,105827,1,0,,0,0.00000000000000000000
chr5,129435793,129876144,440351,1,0,337876,1,0.22709157013382500000
chr7,19392313,19509034,116721,1,0,,0,0.00000000000000000000
chr7,143425314,143505904,80590,1,0,285966;340307,2,2.48169748107706000000
chr8,43191260,43541984,350724,1,0,340441,1,0.28512448535030400000
chr12,126587932,126748896,160964,1,0,,0,0.00000000000000000000
chr7,8197222,8492998,295776,1,0,30010;3382,2,0.67618738504814500000
chr5,76172136,76545409,373273,1,0,1393;55109;84327;170591;8622,5,1.33950218740707000000
chr21,46505589,46580795,75206,1,0,104,1,1.32968114246204000000
chr7,153342262,153605524,263262,1,0,1804,1,0.37984973144624000000
chr1,12868208,12992728,124520,1,0,400735;343069;440560;65122;441871;343071,6,4.81850305171860000000
chrX,11788461,11950046,161585,1,0,10943,1,0.61886932574187000000
chrX,8268156,8391934,123778,1,0,,0,0.00000000000000000000
chr17,36180419,36249799,69380,1,0,,0,0.00000000000000000000
chr4,63636515,64134877,498362,1,0,,0,0.00000000000000000000
chr19,55545221,55616657,71436,1,0,54776;112724;51206;54869,4,5.59941766056330000000
chrY,234863,356537,121674,1,0,28227,1,0.82186827095353200000
chrX,286545,406537,119992,1,0,28227,1,0.83338889259284000000
chr22,44064744,44599582,534838,1,0,150379;29780;64800;80339;64098;25813;25830,7,1.30880752676511000000
chrX,786660,794392,7732,1,0,,0,0.00000000000000000000
chr10,56555650,57258021,702371,1,0,65217,1,0.14237489873585300000
chrX,83973512,84380991,407479,1,0,139322;340562,2,0.49082283995003400000
chr3,64052,283756,219704,1,0,10752,1,0.45515784874194400000
chrY,1711595,1981454,269859,1,0,438,1,0.37056388706695000000
chrX,1761595,1936303,174708,1,0,438,1,0.57238363440712500000
chrX,82912766,83015971,103205,1,0,,0,0.00000000000000000000
chr12,38444942,38464866,19924,1,0,,0,0.00000000000000000000
chr13,20415685,20447972,32287,1,0,9205,1,3.09722179205253000000
chr4,9827799,9962048,134249,1,0,56606,1,0.74488450565739800000
chr10,116829,238717,121888,1,0,10771,1,0.82042530847991600000
chrX,38488591,38621617,133026,1,0,7102,1,0.75173274397486200000
chr1,46208142,46472480,264338,1,0,23139;3652,2,0.75660707124968800000
chr5,49559609,50053527,493918,1,0,79668;133418,2,0.40492551395170900000
chr13,63864288,64739336,875048,1,0,,0,0.00000000000000000000
chr18,18520522,18672140,151618,1,0,6093,1,0.65955229590154200000
chr15,36401900,36700115,298215,1,0,,0,0.00000000000000000000
chr7,122366615,122992258,625643,1,0,50833;6561;93664,3,0.47950668352399100000
chr12,51235760,51398791,163031,1,0,613227;25840;4891;283471,4,2.45352110948225000000
chr1,175443890,175752647,308757,1,0,7143,1,0.32387929666371900000
chrY,17592969,17887454,294485,1,0,,0,0.00000000000000000000
chr3,121035699,121539211,503512,1,0,2804;503582;9657;10721;3059;9515;51725,7,1.39023498943421000000
chrX,166314,416347,250033,1,0,55344;28227;8225,3,1.19984162090604000000
chrX,8268774,8391934,123160,1,0,,0,0.00000000000000000000
chr16,52911795,52975994,64199,1,0,,0,0.00000000000000000000
chr8,79967114,80270024,302910,1,0,,0,0.00000000000000000000
chr8,86841197,86849547,8350,1,0,,0,0.00000000000000000000
chr16,88365744,88615885,250141,1,0,161882;84627,2,0.79954905433335600000
chr13,92223552,92255876,32324,1,0,2262,1,3.09367652518253000000
chrY,427652,995040,567388,1,0,6473,1,0.17624623714283700000
chrX,479089,1045040,565951,1,0,6473,1,0.17669374203773800000
chr4,188852926,189499535,646609,1,0,205860;132625;339976,3,0.46395889942762900000
chr4,188476290,188573737,97447,1,0,,0,0.00000000000000000000
chr3,64052,225996,161944,1,0,,0,0.00000000000000000000
chrX,38488591,38621617,133026,1,0,7102,1,0.75173274397486200000
chr9,70984484,71228980,244496,1,0,5239;169693,2,0.81800929258556400000
chrX,154974465,155198505,224040,1,0,6845;10251,2,0.89269773254775900000
chrX,1559288,1597975,38687,1,0,286530;8623,2,5.16969524646522000000
chr19,20851419,20967557,116138,1,0,,0,0.00000000000000000000
chr2,708194,883933,175739,1,0,,0,0.00000000000000000000
chr8,47080242,47355732,275490,1,0,,0,0.00000000000000000000
chr12,18311218,18437170,125952,1,0,5288,1,0.79395325203252000000
chr2,116841156,116925718,84562,1,0,,0,0.00000000000000000000
chr2,96330709,96546650,215941,1,0,400986,1,0.46308945499002000000
chr6,100288688,100633593,344905,1,0,84539,1,0.28993490961279200000
chr15,96873119,96873907,788,1,0,7026,1,126.90355329949200000000
chr3,2026068,2169067,142999,1,0,152330,1,0.69930558954957700000
chr17,58424409,58574053,149644,1,0,10513;124773;84669,3,2.00475795888910000000
chrX,2700078,2799426,99348,1,0,7499;8908,2,2.01312557877360000000
chr22,21053355,21468352,414997,1,0,80764;9342;3053;8216;400891;1399;6545;150209;9127;5297,10,2.40965597341668000000
chr13,64344318,64470499,126181,1,0,,0,0.00000000000000000000
chr7,17461190,17584187,122997,1,0,,0,0.00000000000000000000
chr18,325229,533571,208342,1,0,81035,1,0.47998003283063400000
chr2,211492772,211980459,487687,1,0,1373,1,0.20504955022381200000
chr13,19610928,19638891,27963,1,0,,0,0.00000000000000000000
chr21,33181456,33637302,455846,1,0,30811,1,0.21937233188401300000
chr6,167211557,167289655,78098,1,0,6196,1,1.28044252093524000000
chr16,59575898,59860339,284441,1,0,,0,0.00000000000000000000
chr6,167623337,167828546,205209,1,0,83887;54346;6953,3,1.46192418461179000000
chr16,74186155,74356768,170613,1,0,5713,1,0.58612180783410400000
chrX,130674304,130955457,281153,1,0,347468,1,0.35567822502338600000
chr16,74186155,74356768,170613,1,0,5713,1,0.58612180783410400000
chrX,1803684,2048824,245140,1,0,,0,0.00000000000000000000
chr5,115231272,115393671,162399,1,0,206338;1176;644100,3,1.84730201540650000000
chr2,163545,280252,116707,1,0,52;26751;285016,3,2.57053989906347000000
chr19,58290342,58358451,68109,1,0,54807;79818;100293516,3,4.40470422411135000000
chr10,82409974,82668675,258701,1,0,,0,0.00000000000000000000
chr13,92973377,93046459,73082,1,0,2262,1,1.36832598998385000000
chr19,45837573,45896151,58578,1,0,10848;147700;2068,3,5.12137662603708000000
chr15,57670483,57748324,77841,1,0,84952,1,1.28467003250215000000
chr19,58290342,58358451,68109,1,0,54807;79818;100293516,3,4.40470422411135000000
chr1,248513776,248687076,173300,1,0,401993;254879;127074;343173;391211;26696;401992,7,4.03923831506059000000
chr1,161523634,161619000,95366,1,0,2215,1,1.04859174129145000000
chr10,9222989,9385606,162617,1,0,,0,0.00000000000000000000
chr19,28174101,28174564,463,1,0,,0,0.00000000000000000000
chr18,61838330,61970956,132626,1,0,,0,0.00000000000000000000
chr22,33863037,33895756,32719,1,0,9215,1,3.05632812738776000000
chr13,20415685,20445336,29651,1,0,9205,1,3.37256753566490000000
chr15,75529209,75537271,8062,1,0,,0,0.00000000000000000000
chr1,90576266,90667296,91030,1,0,,0,0.00000000000000000000
chrX,8268156,8391934,123778,1,0,,0,0.00000000000000000000
chr6,58149339,58704227,554888,1,0,,0,0.00000000000000000000
chr10,48284621,48327473,42852,1,0,,0,0.00000000000000000000
chrX,148892554,149084864,192310,1,0,4107,1,0.51999376007487900000
chrY,469455,511450,41995,1,0,,0,0.00000000000000000000
chrX,519455,561446,41991,1,0,,0,0.00000000000000000000
chr5,61647333,61941546,294213,1,0,100130733;27292;3796;51194,4,1.35955923089734000000
chr5,115424545,115508287,83742,1,0,51397,1,1.19414391822502000000
chr7,152947401,153526670,579269,1,0,,0,0.00000000000000000000
chr2,70737358,70858475,121117,1,0,7039,1,0.82564792721087900000
chr16,18546682,18780881,234199,1,0,283820,1,0.42698730566740300000
chr2,126487927,127245581,757654,1,0,,0,0.00000000000000000000
chr16,10409140,10560811,151671,1,0,80063,1,0.65932182157432900000
chr7,88192836,88627630,434794,1,0,219557;219578,2,0.45998794831575400000
chr4,32406344,32599288,192944,1,0,,0,0.00000000000000000000
chr3,64895736,65438487,542751,1,0,9223,1,0.18424655136517500000
chr1,16364214,16382506,18292,1,0,1188,1,5.46687076317516000000
chr20,29652449,29981746,329297,1,0,245930;245932;245929;117285,4,1.21470891019353000000
chr12,5612383,5762506,150123,1,0,57101,1,0.66612044789938900000
chr11,33000276,33076547,76271,1,0,79832;55346;91614,3,3.93334294817165000000
chr7,24993182,25067093,73911,1,0,26031,1,1.35297858234904000000
chr1,90576266,90667296,91030,1,0,,0,0.00000000000000000000
chr7,72196138,72408640,212502,1,0,9883;441250,2,0.94116761254011700000
chr13,92223552,92255876,32324,1,0,2262,1,3.09367652518253000000
chrX,76191622,76438941,247319,1,0,,0,0.00000000000000000000
chrX,38488591,38582578,93987,1,0,7102,1,1.06397693298009000000
chr13,20415685,20447972,32287,1,0,9205,1,3.09722179205253000000
chr19,20851419,20967557,116138,1,0,,0,0.00000000000000000000
chr10,92087640,92595326,507686,1,0,3363,1,0.19697214419936700000
chrX,116473801,116870373,396572,1,0,,0,0.00000000000000000000
chr12,112184121,112303042,118921,1,0,8550;217;80724,3,2.52268312577257000000
chr11,55356087,55450895,94808,1,0,219432;219429;219431;81300,4,4.21905324445195000000
chrX,2700078,2799426,99348,1,0,7499;8908,2,2.01312557877360000000
chr17,47511555,47592355,80800,1,0,4804,1,1.23762376237624000000
chr22,49399602,49982343,582741,1,0,,0,0.00000000000000000000
chr20,52281040,52489416,208376,1,0,,0,0.00000000000000000000
chrX,2700078,2799426,99348,1,0,7499;8908,2,2.01312557877360000000
chr4,168919854,168998444,78590,1,0,,0,0.00000000000000000000
chr4,160734870,160832837,97967,1,0,,0,0.00000000000000000000
chrX,87680088,87877291,197203,1,0,,0,0.00000000000000000000
chr5,6576955,6674551,97596,1,0,6715;54888,2,2.04926431411123000000
chr22,49399602,49982343,582741,1,0,,0,0.00000000000000000000
chr18,59569012,59701493,132481,1,0,,0,0.00000000000000000000
chrX,1497120,1506550,9430,1,0,293;3563,2,21.20890774125130000000
chr17,26005959,26062031,56072,1,0,,0,0.00000000000000000000
chr6,78926545,79152883,226338,1,0,,0,0.00000000000000000000
chr16,18253315,18776374,523059,1,0,283820;101059953,2,0.38236604283646800000
chrX,48013112,48204099,190987,1,0,6756;6758,2,1.04719169367549000000
chr15,86305093,86698180,393087,1,0,64410;123624,2,0.50879321880398000000
chrX,143094492,143467197,372705,1,0,,0,0.00000000000000000000
chr20,62893059,62952205,59146,1,0,55251,1,1.69073141040814000000
chr5,123713498,124108782,395284,1,0,57507,1,0.25298266562775100000
chr6,169211921,169493437,281516,1,0,,0,0.00000000000000000000
chr4,2010718,2011107,389,1,0,7469,1,257.06940874036000000000
chr3,10071211,10083523,12312,1,0,2177,1,8.12215724496426000000
chr6,114465769,114549104,83335,1,0,,0,0.00000000000000000000
chr6,113968286,114082624,114338,1,0,,0,0.00000000000000000000
chr1,100144699,100516107,371408,1,0,64645;178;54873;23443;391059,5,1.34622840649636000000
chr20,47571096,47715417,144321,1,0,1434;10564,2,1.38579971036786000000
chr1,46248686,46427190,178504,1,0,23139,1,0.56021153587594700000
chr5,162687465,162847205,159740,1,0,,0,0.00000000000000000000
chr22,19746215,19749385,3170,1,0,6899,1,31.54574132492110000000
chrX,329874,432599,102725,1,0,28227,1,0.97347286444390400000
chrX,2700078,2799426,99348,1,0,7499;8908,2,2.01312557877360000000
chr11,87084121,87379617,295496,1,0,,0,0.00000000000000000000
chr13,84667051,85069434,402383,1,0,,0,0.00000000000000000000
chr6,118682241,119031639,349398,1,0,5350;387119,2,0.57241312199840900000
chr3,64052,159779,95727,1,0,,0,0.00000000000000000000
chr6,78926545,79152883,226338,1,0,,0,0.00000000000000000000
chr15,62446362,62573696,127334,1,0,388125,1,0.78533620242826000000
chrY,16183094,16268982,85888,1,0,,0,0.00000000000000000000
chr2,238023079,238514186,491107,1,0,1293;79083;51052;64284,4,0.81448645610834300000
chr9,6755750,6848760,93010,1,0,23081,1,1.07515320933233000000
chr19,11919754,12042483,122729,1,0,126070;90594;90592;7620,4,3.25921338884860000000
chr7,65217272,65371595,154323,1,0,154807,1,0.64799155019018600000
chr9,519607,614309,94702,1,0,23189,1,1.05594390825959000000
chr4,189031157,189123650,92493,1,0,339976,1,1.08116289881396000000
chr2,112216442,112476717,260275,1,0,,0,0.00000000000000000000
chr7,153342262,153605524,263262,1,0,1804,1,0.37984973144624000000
chr10,11634783,11812218,177435,1,0,9712;79746,2,1.12717333107899000000
chrX,1837209,2317446,480237,1,0,207063,1,0.20823051951432300000
chrY,16287226,16494880,207654,1,0,,0,0.00000000000000000000
chr7,16758342,16964733,206391,1,0,27075;155465;10551,3,1.45355175371019000000
chr5,16497,86366,69869,1,0,,0,0.00000000000000000000
chr1,249189688,249212666,22978,1,0,267002,1,4.35198885890852000000
chr14,63785235,63859721,74486,1,0,122876;5529,2,2.68506833498913000000
chr1,145394735,145746786,352051,1,0,148738;128077;10401;200035;27246;84265;284615;5174;11126;8515;148741;10628;10623;8799;9939,15,4.26074631232407000000
chr15,102040846,102144149,103303,1,0,,0,0.00000000000000000000
chrY,3712190,4556596,844406,1,0,,0,0.00000000000000000000
chrX,89519808,90490241,970433,1,0,,0,0.00000000000000000000
chr22,17059296,17547398,488102,1,0,150160;128954;150165,3,0.61462563152783600000
chrX,77254,344955,267701,1,0,55344;28227;8225,3,1.12065326614394000000
chrX,486881,537040,50159,1,0,,0,0.00000000000000000000
chr8,13378452,14615245,1236793,1,0,157773;10395;137868,3,0.24256282174947600000
chr22,18074882,18086794,11912,1,0,529,1,8.39489590329080000000
chrX,115944559,116042727,98168,1,0,,0,0.00000000000000000000
chr18,47868468,47953161,84693,1,0,220134,1,1.18073512568925000000
chr5,180576812,180604344,27532,1,0,285659,1,3.63213714949877000000
chrX,119800177,120142937,342760,1,0,728042;255313;728075;653282;728072;643311;100507170;728036;728062;728082;728096;728049;728090,13,3.79274127669506000000
chr2,117777724,117912243,134519,1,0,,0,0.00000000000000000000
chr21,37498670,37608312,109642,1,0,9980;874,2,1.82411849473742000000
chrX,115944559,116042727,98168,1,0,,0,0.00000000000000000000
chrY,1978363,2120532,142169,1,0,207063,1,0.70338822106085000000
chrX,2028363,2172681,144318,1,0,207063,1,0.69291425878961700000
chr10,11962567,11991850,29283,1,0,26019,1,3.41495065396305000000
chr5,98358158,98653155,294997,1,0,,0,0.00000000000000000000
chr5,99119333,99308622,189289,1,0,,0,0.00000000000000000000
chr2,159838721,160088693,249972,1,0,85461,1,0.40004480501816200000
chr2,162967252,163259921,292669,1,0,25801;2641;64135;2191;90134,5,1.70841462539593000000
chr21,48056541,48080956,24415,1,0,3275,1,4.09584271963957000000
chr15,90849174,90995930,146756,1,0,8826;342132,2,1.36280629071384000000
chr3,64052,127981,63929,1,0,,0,0.00000000000000000000
chr21,35213510,35346033,132523,1,0,539;6453,2,1.50917199278616000000
chr5,71913,116846,44933,1,0,,0,0.00000000000000000000
chr5,105623195,105865950,242755,1,0,,0,0.00000000000000000000
chrY,1490627,1787268,296641,1,0,8227;286530;8623;438,4,1.34843126877269000000
chrX,1458838,1837268,378430,1,0,8227;8623;293;286530;3563;438,6,1.58549797849008000000
chr1,28385632,28471715,86083,1,0,2140,1,1.16166955147939000000
chr19,45837573,45896151,58578,1,0,10848;147700;2068,3,5.12137662603708000000
chr16,15929179,16292304,363125,1,0,4363;4629;123811;368,4,1.10154905335628000000
chrY,1704406,2267446,563040,1,0,207063;438,2,0.35521454958795100000
chrX,1701271,2317446,616175,1,0,207063;8227;438,3,0.48687467034527500000
chrX,140184762,140309511,124749,1,0,23641,1,0.80160963214134000000
chr12,112184121,112303042,118921,1,0,8550;217;80724,3,2.52268312577257000000
chr1,120935938,121121120,185182,1,0,2210;653464,2,1.08001857631951000000
chrX,1936244,1938320,2076,1,0,,0,0.00000000000000000000
chr3,1603704,1771199,167495,1,0,,0,0.00000000000000000000
chr3,2769928,3049098,279170,1,0,152330,1,0.35820467815309700000
chr10,16893345,17009042,115697,1,0,8029,1,0.86432664632618000000
chr10,134659060,134814552,155492,1,0,54777,1,0.64311990327476700000
chr19,27776270,28518804,742534,1,0,,0,0.00000000000000000000
chr1,22908190,22937846,29656,1,0,2046,1,3.37199892096035000000
chrX,2700078,2799426,99348,1,0,7499;8908,2,2.01312557877360000000
chr8,143192740,143443790,251050,1,0,203062,1,0.39832702648874700000
chr4,129786343,129914928,128585,1,0,132320;79960,2,1.55539137535482000000
chr4,188476290,188573737,97447,1,0,,0,0.00000000000000000000
chr4,188852926,189499535,646609,1,0,205860;132625;339976,3,0.46395889942762900000
chrY,9375519,9837326,461807,1,0,,0,0.00000000000000000000
chr4,152745962,152924077,178115,1,0,,0,0.00000000000000000000
chr2,68137713,68259328,121615,1,0,,0,0.00000000000000000000
chr3,197717459,197844960,127501,1,0,89782,1,0.78430757405824300000
chr4,116321341,116423594,102253,1,0,,0,0.00000000000000000000
chrX,28437620,30357636,1920016,1,0,11141;4113;4112;190;4115;4114,6,0.31249739585503500000
chr16,6660795,6685821,25026,1,0,54715,1,3.99584432190522000000
chr11,50034727,50781155,746428,1,0,,0,0.00000000000000000000
chr14,49555768,49822908,267140,1,0,,0,0.00000000000000000000
chr3,64052,127981,63929,1,0,,0,0.00000000000000000000
chr14,46063966,46270426,206460,1,0,,0,0.00000000000000000000
chr1,48915804,49162461,246657,1,0,54558;84871,2,0.81084258707435800000
chr3,21260236,21330426,70190,1,0,,0,0.00000000000000000000
chr8,590409,860041,269632,1,0,9228;157697,2,0.74175172086399200000
chr10,35070381,35239426,169045,1,0,56288,1,0.59155846076488500000
chr8,56735453,56854809,119356,1,0,96764;4067,2,1.67565937196287000000
chr9,23755025,24465012,709987,1,0,1993,1,0.14084764932315700000
chr7,131639998,131755072,115074,1,0,,0,0.00000000000000000000
chr18,69014843,69249272,234429,1,0,,0,0.00000000000000000000
chr18,72843117,73133080,289963,1,0,10194;284274;284273,3,1.03461476119367000000
chr5,61116372,61306880,190508,1,0,,0,0.00000000000000000000
chr6,81496760,81612534,115774,1,0,,0,0.00000000000000000000
chr12,69731038,69911867,180829,1,0,8089;10818;4069,3,1.65902593057529000000
chr1,175443890,175752647,308757,1,0,7143,1,0.32387929666371900000
chr2,80126963,80974757,847794,1,0,347730;1496,2,0.23590636404598300000
chr20,57463388,57466014,2626,1,0,2778,1,38.08073115003810000000
chr22,19747566,19749315,1749,1,0,6899,1,57.17552887364210000000
chr5,404078,676907,272829,1,0,57491;6550;11076;55722;11336,5,1.83264975497473000000
chr1,199134317,199182491,48174,1,0,,0,0.00000000000000000000
chrX,63322292,63366314,44022,1,0,,0,0.00000000000000000000
chrY,266361,470629,204268,1,0,28227,1,0.48955294025495900000
chrX,329946,520629,190683,1,0,28227,1,0.52443059947661800000
chr1,90576266,90667296,91030,1,0,,0,0.00000000000000000000
chr4,22887695,23014921,127226,1,0,,0,0.00000000000000000000
chr15,91814884,91978824,163940,1,0,9899,1,0.60997926070513600000
chr4,156692808,156907011,214203,1,0,51802;2983;6999;1519,4,1.86738747823326000000
chrX,77082384,77142497,60113,1,0,84061,1,1.66353367823932000000
chr8,90100164,90889083,788919,1,0,8767,1,0.12675572523922000000
chrX,63788140,63903407,115267,1,0,,0,0.00000000000000000000
chr7,112637573,112710211,72638,1,0,,0,0.00000000000000000000
chr19,260928,270671,9743,1,0,,0,0.00000000000000000000
chr2,203173443,203277598,104155,1,0,659,1,0.96010753204358900000
chr10,92095401,92595326,499925,1,0,3363,1,0.20003000450067500000
chr8,56735453,56854809,119356,1,0,96764;4067,2,1.67565937196287000000
chr4,190322774,190469515,146741,1,0,,0,0.00000000000000000000
chr7,49094913,49413830,318917,1,0,,0,0.00000000000000000000
chr8,9313730,9420235,106505,1,0,8658,1,0.93892305525562200000
chrY,59036507,59280593,244086,1,0,10251;6845,2,0.81938333210425800000
chrX,154974465,155184567,210102,1,0,6845;10251,2,0.95191859192201900000
chrX,8464322,8511283,46961,1,0,3730,1,2.12942654543132000000
chrY,286971,28784530,28497559,1,0,353515;728403;1617;4267;442868;293;286530;9189;140032;378948;57054;90665;83259;90655;3563;6192;7258;159163;8287;8653;353513;64591;728137;22829;159119;9426;7544;6736;86614;57055;8227;9082;253175;8623;442862;8284;207063;100289087;9087;378950;266;6473;1438;5940;442867;100533178;28227;7404;728395;57135;378951;9081;438;64109;9084;9083;378949;9086;203611;9085,60,0.21054434872825400000
chrX,88486559,92355334,3868775,1,0,140886;90316;27328,3,0.07754392540274380000
chrX,305572,2760690,2455118,1,0,28227;207063;4267;293;7499;286530;9189;438;64109;6473;8227;1438;3563;8623;8908,15,0.61096859702873800000
chr9,130630087,130644464,14377,1,0,203,1,6.95555400987689000000
chr4,23210472,23293229,82757,1,0,,0,0.00000000000000000000
chr1,120023163,120139759,116596,1,0,3283,1,0.85766235548389300000
chr5,102503919,102589065,85146,1,0,23262,1,1.17445329199258000000
chr12,112184121,112303042,118921,1,0,8550;217;80724,3,2.52268312577257000000
chr2,117777724,117912243,134519,1,0,,0,0.00000000000000000000
chr6,95607140,95672450,65310,1,0,,0,0.00000000000000000000
chr22,44298455,44505376,206921,1,0,80339;25813;29780,3,1.44982867857781000000
chr4,39902415,40119663,217248,1,0,55728;23244,2,0.92060686404477800000
chr18,61838330,61946349,108019,1,0,,0,0.00000000000000000000
chrX,114237574,114383325,145751,1,0,57631;3598,2,1.37220327819363000000
chr20,29833379,29976790,143411,1,0,245930;245932;245929;117285,4,2.78918632461945000000
chrX,8435932,8593514,157582,1,0,3730,1,0.63459024507875300000
chr1,15422198,15527584,105386,1,0,55092;727684;23254,3,2.84667792685936000000
chr16,15078280,15154825,76545,1,0,23042;54700;123803,3,3.91926317852244000000
chrX,46317572,46336621,19049,1,0,55634,1,5.24961940259331000000
chr7,53348798,53437746,88948,1,0,,0,0.00000000000000000000
chr15,57670483,57748324,77841,1,0,84952,1,1.28467003250215000000
chr12,47964338,48041956,77618,1,0,,0,0.00000000000000000000
chr8,42890077,43541984,651907,1,0,340441;84197;2339;138050,4,0.61358445299713000000
chr22,42816846,42939017,122171,1,0,27341;150372,2,1.63704970901441000000
chr16,8822352,8969711,147359,1,0,18;25880;5373;23589,4,2.71445924578750000000
chr15,96873119,96874735,1616,1,0,7026,1,61.88118811881190000000
chr21,48056541,48095807,39266,1,0,3275,1,2.54673254214842000000
chr13,20415685,20447972,32287,1,0,9205,1,3.09722179205253000000
chr8,43316022,43541984,225962,1,0,,0,0.00000000000000000000
chr16,89565597,89660365,94768,1,0,6687;27132;6137,3,3.16562552760425000000
chrX,46317572,46336973,19401,1,0,55634,1,5.15437348590279000000
chr6,48626041,48701064,75023,1,0,,0,0.00000000000000000000
chr2,203218575,203277598,59023,1,0,659,1,1.69425478203412000000
chr14,63785235,63859721,74486,1,0,122876;5529,2,2.68506833498913000000
chr11,218253,309441,91188,1,0,80162;23410;387733;5719;171389;10581,6,6.57981313330701000000
chrX,2700078,2799426,99348,1,0,7499;8908,2,2.01312557877360000000
chr14,23860066,23881731,21665,1,0,4624,1,4.61573967228248000000
chr1,771778,846621,74843,1,0,,0,0.00000000000000000000
chr15,96873119,96874735,1616,1,0,7026,1,61.88118811881190000000
chr20,57464551,57466014,1463,1,0,2778,1,68.35269993164730000000
chr22,19747566,19749385,1819,1,0,6899,1,54.97526113249040000000
chr9,6755750,6848760,93010,1,0,23081,1,1.07515320933233000000
chrX,25030786,25032481,1695,1,0,170302,1,58.99705014749260000000
chr9,25564190,25703022,138832,1,0,286319,1,0.72029503284545300000
chr17,810138,971540,161402,1,0,29;64359;29928,3,1.85871302710004000000
chr8,146128755,146174180,45425,1,0,7564,1,2.20143093010457000000
chr1,175443890,175752647,308757,1,0,7143,1,0.32387929666371900000
chr18,1997931,2091568,93637,1,0,,0,0.00000000000000000000
chr2,102692159,102825601,133442,1,0,8808;3554,2,1.49877849552615000000
chr5,337286,413413,76127,1,0,57491,1,1.31359438832477000000
chr21,47045443,47308984,263541,1,0,54039,1,0.37944760018365300000
chrX,115944559,116042727,98168,1,0,,0,0.00000000000000000000
chr3,7189141,7385512,196371,1,0,2917,1,0.50924016275315600000
chr16,15130754,15180006,49252,1,0,23042;54700;123803,3,6.09112320311865000000
chr18,1997931,2091568,93637,1,0,,0,0.00000000000000000000
chr19,20830046,20967557,137511,1,0,199777,1,0.72721455010871900000
chrX,8435932,8642281,206349,1,0,3730,1,0.48461586923125400000
chr16,34197202,34285873,88671,1,0,,0,0.00000000000000000000
chr18,44558149,44568902,10753,1,0,51224;83473,2,18.59946061564210000000
chr19,45837573,45896151,58578,1,0,10848;147700;2068,3,5.12137662603708000000
chr1,231741756,231813980,72224,1,0,27185,1,1.38458130261409000000
chr1,175443890,175752647,308757,1,0,7143,1,0.32387929666371900000
chr15,98060861,98119250,58389,1,0,,0,0.00000000000000000000
chr9,113199081,113328888,129807,1,0,79987,1,0.77037447903425800000
chr5,9739230,10047896,308666,1,0,,0,0.00000000000000000000
chr8,118243309,118340421,97112,1,0,,0,0.00000000000000000000
chrX,149116288,149494461,378173,1,0,,0,0.00000000000000000000
chr22,33844423,33895756,51333,1,0,9215,1,1.94806459782206000000
chrX,1936244,1939699,3455,1,0,,0,0.00000000000000000000
chrX,528586,539691,11105,1,0,,0,0.00000000000000000000
chrY,474439,489697,15258,1,0,,0,0.00000000000000000000
chr13,62466824,62657166,190342,1,0,,0,0.00000000000000000000
chr7,146226394,146254734,28340,1,0,26047,1,3.52858151023289000000
chrX,48110692,48204099,93407,1,0,6756,1,1.07058357510679000000
chr22,49399602,49982343,582741,1,0,,0,0.00000000000000000000
chr7,8197222,8492998,295776,1,0,30010;3382,2,0.67618738504814500000
chr16,6660795,6685821,25026,1,0,54715,1,3.99584432190522000000
chr2,230404318,230479500,75182,1,0,92737,1,1.33010561038546000000
chr13,58967636,59056435,88799,1,0,,0,0.00000000000000000000
chr19,45837573,45896151,58578,1,0,10848;147700;2068,3,5.12137662603708000000
chr20,62893059,62952205,59146,1,0,55251,1,1.69073141040814000000
chr2,61246086,61391564,145478,1,0,84542;339804;5194,3,2.06216747549458000000
chr4,152169749,152288914,119165,1,0,345062,1,0.83917257584022200000
chr6,27695254,27828270,133016,1,0,8340;8357;8330;8363;8362;8331;8329;8341;8342,9,6.76610332591568000000
chr18,61074518,61179009,104491,1,0,5268;9525,2,1.91404044367457000000
chr5,175559327,175628957,69630,1,0,,0,0.00000000000000000000
chr4,190159530,190435172,275642,1,0,,0,0.00000000000000000000
chrX,42557923,42691353,133430,1,0,,0,0.00000000000000000000
chr18,77930817,77961810,30993,1,0,84552,1,3.22653502403769000000
chr10,6716343,6833130,116787,1,0,,0,0.00000000000000000000
chr19,20830046,20971065,141019,1,0,199777,1,0.70912430239896800000
chrX,53559743,53622769,63026,1,0,10075,1,1.58664678069368000000
chr7,152916608,153696770,780162,1,0,1804,1,0.12817850651531300000
chr8,56735453,56854809,119356,1,0,96764;4067,2,1.67565937196287000000
chr21,37498670,37608312,109642,1,0,9980;874,2,1.82411849473742000000
chr10,134659060,134814552,155492,1,0,54777,1,0.64311990327476700000
chr9,71031677,71346435,314758,1,0,5239;169693;8395,3,0.95311318536780600000
chrX,8448259,8797517,349258,1,0,171482;3730,2,0.57264257368478300000
chr16,82806531,83636091,829560,1,0,1012,1,0.12054583152514600000
chr8,11391786,11419675,27889,1,0,640,1,3.58564308508731000000
chr8,60958891,61250319,291428,1,0,767,1,0.34313792772142700000
chr9,94671695,94807498,135803,1,0,10558;4920,2,1.47272151572498000000
chr14,20203449,20435917,232468,1,0,441669;390429;390431;79317;79544;441670,6,2.58100039575339000000
chrX,9641242,9844439,203197,1,0,4935;6907;357,3,1.47639974999631000000
chr11,3243558,4127305,883747,1,0,391;116534;6786;57053;417;6240;27315;116969;4928;7748,10,1.13154556677420000000
chr15,32021733,32510863,489130,1,0,161725;1139,2,0.40888925234600200000
chr22,20860931,21133619,272688,1,0,51586;5297;3053,3,1.10015842281289000000
chr22,19532378,19950235,417857,1,0,5413;10587;1312;6899;54584;2812;79680,7,1.67521424793650000000
chr5,10611853,10642084,30231,1,0,651746,1,3.30786278985148000000
chrX,47871771,47917780,46009,1,0,57232,1,2.17348779586603000000
chr18,363234,825147,461913,1,0,1068;55556;27098;7298;494514;7525;81035,7,1.51543688963073000000
chr9,80523119,81372421,849302,1,0,29968;2776;84131,3,0.35323124165491200000
chr3,141882992,142048481,165489,1,0,256356;54464,2,1.20853954039241000000
chr1,109351734,109766687,414953,1,0,127003;6884;56900;6814;22911;254268;29899;23155;57535;6301,10,2.40991148395119000000
chr14,43196971,44463951,1266980,1,0,,0,0.00000000000000000000
chr15,32065000,32509926,444926,1,0,161725;1139,2,0.44951295271573200000
chrX,330851,733497,402646,1,0,28227;6473,2,0.49671423533327000000
chr10,35116017,35281156,165139,1,0,,0,0.00000000000000000000
chr18,74872752,75902765,1030013,1,0,2587,1,0.09708615328156050000
chr4,111390285,111717046,326761,1,0,2028;5308,2,0.61206814766756100000
chr13,23566962,24910743,1343781,1,0,6445;4285;55504;221178;338872;387911;542767;26278,8,0.59533510296692700000
chr4,182624551,183358303,733752,1,0,55714,1,0.13628582954458700000
chr19,32441409,32697988,256579,1,0,,0,0.00000000000000000000
chrY,24504646,28492225,3987579,1,0,1617;57135;442868;9085;378951;9081;9083;57055;57054;442867;253175,11,0.27585660371869800000
chrX,28780730,29029211,248481,1,0,11141,1,0.40244525738386400000
chr5,15151684,15851427,699743,1,0,23194,1,0.14290961110007500000
chr6,141062795,141895511,832716,1,0,,0,0.00000000000000000000
chr1,119491287,120082183,590896,1,0,6913;10352;51179;3284;3283,5,0.84617259213127200000
chr10,135341135,135372492,31357,1,0,93426;1571,2,6.37816117613292000000
chr14,61112856,61606518,493662,1,0,145389;4331;57570;51804;6495,5,1.01283874391790000000
chr8,143008635,143586286,577651,1,0,575;203062,2,0.34622981696560700000
chr7,10341321,11351968,1010647,1,0,9678;4697,2,0.19789303287893800000
chr15,24384453,24723200,338747,1,0,,0,0.00000000000000000000
chrY,16017052,16134958,117906,1,0,9084,1,0.84813325869760700000
chr16,22629047,22709775,80728,1,0,,0,0.00000000000000000000
chr15,32011762,32575866,564104,1,0,161725;1139,2,0.35454455206841300000
chr2,241471968,241610707,138739,1,0,285193;2859;51281;11132;57140,5,3.60388931735129000000
chr5,20345847,20896013,550166,1,0,1016,1,0.18176332234271100000
chr8,7268849,7691931,423082,1,0,100131608;503614;504180;503841;503618;245908;100289462;100133251;245909;55894;10407;245910,12,2.83632960040843000000
chr10,46699489,47655117,955628,1,0,728113;9721;83849;5540,4,0.41857291749509200000
chr4,37152,59583,22431,1,0,152687,1,4.45811600017832000000
chr22,20414264,20477153,62889,1,0,85376,1,1.59010319769753000000
chr14,107148769,107287476,138707,1,0,,0,0.00000000000000000000
chr12,61562890,61752791,189901,1,0,,0,0.00000000000000000000
chr6,265940,289145,23205,1,0,,0,0.00000000000000000000
chr17,34468470,34856085,387615,1,0,6349;9326;9560;414060;414062;414059;101060321;729877;80179,9,2.32189156766379000000
chr20,57464565,57465903,1338,1,0,2778,1,74.73841554559040000000
chr4,21321832,21457649,135817,1,0,80333,1,0.73628485388427100000
chrX,90778600,90801834,23234,1,0,,0,0.00000000000000000000
chr9,138157689,138283588,125899,1,0,157927,1,0.79428748441210800000
chr5,710524,820446,109922,1,0,79844,1,0.90973599461436300000
chr8,7239521,7410327,170806,1,0,100131608;503614;504180;503841;503618;100289462;55894;10407,8,4.68367621746309000000
chr17,18950648,19088725,138077,1,0,400581;79999,2,1.44846715962832000000
chr6,31975361,32007810,32449,1,0,1589;721,2,6.16351813615212000000
chr22,18661749,18847965,186216,1,0,,0,0.00000000000000000000
chr22,20414264,20708912,294648,1,0,85376,1,0.33938801553039600000
chr6,259345,293593,34248,1,0,56940,1,2.91987853305303000000
chr17,44208007,44351123,143116,1,0,284058,1,0.69873389418373900000
chr4,59583,127263,67680,1,0,152687;255403,2,2.95508274231678000000
chr3,141841034,142048481,207447,1,0,256356;54464;7029,3,1.44615251124384000000
chr19,37553808,37683194,129386,1,0,92285;199704;147923,3,2.31864343901195000000
chr7,64478282,65315249,836967,1,0,168374,1,0.11947902366521000000
chr15,93900718,94798487,897769,1,0,,0,0.00000000000000000000
chr21,15372452,15725877,353425,1,0,149998;54033,2,0.56589092452429800000
chr10,34398684,34835648,436964,1,0,56288,1,0.22885180472533200000
chr1,2723344,4087443,1364099,1,0,57470;388588;1677;9731;127262;27237;339448;148870;140625;63976;1953;7161;49856,13,0.95301000880434600000
chr15,32021733,32510863,489130,1,0,161725;1139,2,0.40888925234600200000
chr22,22323131,22603966,280835,1,0,7441;8940,2,0.71216194562643500000
chr14,43196971,44463951,1266980,1,0,,0,0.00000000000000000000
chrX,6552712,8115153,1562441,1,0,412;8228;26609;8226,4,0.25600966692502300000
chr19,11077733,11244471,166738,1,0,6597;3949,2,1.19948661972676000000
chr6,112486337,113465821,979484,1,0,442247;3910,2,0.20418914448832200000
chr2,106950797,107551591,600794,1,0,84620;653489,2,0.33289280518780100000
chr21,18819200,19036035,216835,1,0,10950;1525,2,0.92236032005903100000
chr12,84471915,84677126,205211,1,0,,0,0.00000000000000000000
chr3,100360722,100432996,72274,1,0,84873;10342,2,2.76724686609292000000
chr4,131950228,132330751,380523,1,0,,0,0.00000000000000000000
chr7,4115793,5070221,954428,1,0,56903;221938;221937;55698;221935;9907,6,0.62864878230730900000
chr6,169369767,169786473,416706,1,0,7058,1,0.23997734613852500000
chr4,187258761,187534546,275785,1,0,4543;2195,2,0.72520260347734700000
chr1,175448847,175726866,278019,1,0,7143,1,0.35968764724713100000
chr15,36009009,36422443,413434,1,0,,0,0.00000000000000000000
chr15,90109495,90200165,90670,1,0,90381;374654,2,2.20580125730672000000
chr1,117604148,117980389,376241,1,0,79679;8458;80263;10905,4,1.06314835437924000000
chr10,135188349,135403639,215290,1,0,1571;93426;92170;503542;196743,5,2.32244879000418000000
chr22,18706023,19010479,304456,1,0,5625;8214,2,0.65690937278293100000
chr4,144930239,145059852,129613,1,0,2993;2994,2,1.54305509478216000000
chr19,52288794,52528914,240120,1,0,84765;80110;284370;65251;2359;79898;59348,7,2.91520906213560000000
chr5,14893164,15133455,240291,1,0,,0,0.00000000000000000000
chr1,144035447,144860388,824941,1,0,400818;9659,2,0.24244158067061800000
chr16,46500741,46862370,361629,1,0,79801;91807;388272;55737;23594,5,1.38263247693078000000
chrX,103220412,103269195,48783,1,0,158983;286527,2,4.09978886087367000000
chr11,9308115,9389390,81275,1,0,440026,1,1.23039064903107000000
chrY,15938804,16057257,118453,1,0,,0,0.00000000000000000000
chr4,157152567,157518737,366170,1,0,,0,0.00000000000000000000
chr3,82280767,83049742,768975,1,0,,0,0.00000000000000000000
chr22,25664618,25892253,227635,1,0,91355,1,0.43929975618863500000
chr6,139898804,139989067,90263,1,0,,0,0.00000000000000000000
chr9,114805946,115449137,643191,1,0,9991;64420;158405;58493;84263,5,0.77737406151516400000
chr16,20494958,20717903,222945,1,0,123876;348158;116285,3,1.34562336002153000000
chr21,24131296,24398515,267219,1,0,,0,0.00000000000000000000
chr18,74687042,74726694,39652,1,0,4155,1,2.52194088570564000000
chr4,5812904,5948849,135945,1,0,2121;1400,2,1.47118319908787000000
chr4,8224466,9628003,1403537,1,0,728373;100287205;100287327;100287478;728393;644414;152992;728419;8532;100288520;100287404;728379;94031;728369;100287178;100287441;100287513;728386;100287144;3166;100287238;8310;54436;100287364;728405;27201;728400,27,1.92371130935629000000
chrX,95689452,96205714,516262,1,0,1730;29935,2,0.38740019602449900000
chr4,116731827,117064917,333090,1,0,,0,0.00000000000000000000
chr12,132827801,133297838,470037,1,0,192111;5426;5827;22953;100507055;50614;57666,7,1.48924446373371000000
chrX,53406928,53467212,60284,1,0,158787;8243;3028,3,4.97644482781501000000
chrX,53684651,53777802,93151,1,0,10075,1,1.07352578072162000000
chr2,241644933,241725893,80960,1,0,547,1,1.23517786561265000000
chr2,238017965,238531976,514011,1,0,1293;79083;51052;64284,4,0.77819346278581600000
chr10,58932453,59165200,232747,1,0,,0,0.00000000000000000000
chr11,46442535,46809121,366586,1,0,9776;79797;2147;55626;9793;392;283254,7,1.90951100151124000000
chrX,6413935,8498137,2084202,1,0,51481;412;8228;3730;8226;51480;425054;26609,8,0.38383995409274100000
chr21,35726628,35905109,178481,1,0,101928147;9992;3753;54065;1827,5,2.80141863839849000000
chrX,524439,1452793,928354,1,0,6473;1438;64109,3,0.32315259049888300000
chr19,18023395,18710943,687548,1,0,9244;5143;55049;27106;23031;10437;9518;23770;170463;8178;80726;25804;5296;51477;84769;5864;3594;3727;115098;54858;3780;7311;79036;126364,24,3.49066537899899000000
chr1,53929421,54049969,120548,1,0,148979;63948,2,1.65909015495902000000
chr5,126212740,126702661,489921,1,0,115123;84466;401207,3,0.61234362274734100000
chr22,34152134,34173393,21259,1,0,9215,1,4.70389011712686000000
chr1,55264346,55548023,283677,1,0,55001;1718;255738;163747;7809;199964;23358,7,2.46759518748436000000
chr18,46778032,46787156,9124,1,0,54808,1,10.96010521701010000000
chr1,46082964,46561090,478126,1,0,23139;8503;51249;149483;3652;110117499;4678;60313,8,1.67319911487767000000
chr2,41248166,41524212,276046,1,0,,0,0.00000000000000000000
chrX,77059047,77145622,86575,1,0,84061,1,1.15506786023679000000
chrX,104223143,104333663,110520,1,0,26280,1,0.90481360839667000000
chr3,100340054,100442497,102443,1,0,84873;10342,2,1.95230518434642000000
chrX,37262976,38292813,1029837,1,0,6103;8406;1536;5009;7504;347404;6990;25763;5638;94122,10,0.97102745385920300000
chr10,68211551,68322678,111127,1,0,29119,1,0.89987131840146900000
chr4,8199982,8724314,524332,1,0,8532;54436;94031;27201;152992;8310,6,1.14431314510654000000
chrY,16134899,16287170,152271,1,0,353513,1,0.65672386731551000000
chr19,40012415,40146196,133781,1,0,163126;29124;126272,3,2.24247090394002000000
chrX,2628850,2822187,193337,1,0,4267;414;7499;8908,4,2.06892627898436000000
chr3,155312579,155551284,238705,1,0,9197;23007;285315,3,1.25678138287845000000
chr16,57988573,60642356,2653783,1,0,64785;2806;1258;4324;23019;55238;57567;79650;79918;374739;729159;1459;29105;29070;221191;65009,16,0.60291289830404400000
chr11,133917521,133982959,65438,1,0,83700,1,1.52816406369388000000
chr1,12324182,13186871,862689,1,0,93190;400735;440563;65122;440561;391003;343066;440560;441871;9249;126767;55187;343069;390999;65121;343071,16,1.85466604999021000000
chr7,154780490,155097362,316872,1,0,3361;3638;22976,3,0.94675452548663200000
chr7,152253626,152647162,393536,1,0,57180;7516,2,0.50821271751504300000
chr15,82680085,85075449,2395364,1,0,646;64506;6218;123722;83640;123207;53346;100505679;9455;6457;440295;123720;647042;50810;8120;53339;57188;643707,18,0.75145155391831900000
chr10,35370276,35495670,125394,1,0,1390;8453,2,1.59497264621912000000
chr7,105198376,105420973,222597,1,0,60561;222255,2,0.89848470554410000000
chr11,894571,1019937,125366,1,0,161;4588;66005,3,2.39299331557201000000
chr21,45393541,45817713,424172,1,0,7109;755;5211;56894;7226;8209;29947;326;5822;23308,10,2.35753420782136000000
chrX,742815,1259140,516325,1,0,,0,0.00000000000000000000
chr15,85834072,86169135,335063,1,0,11214,1,0.29845133601740600000
chr4,69375140,69483277,108137,1,0,7367,1,0.92475285979821900000
chr17,57264063,57456368,192305,1,0,388403;55181;284161;55771,4,2.08002912040769000000
chrX,8401014,8587270,186256,1,0,425054;3730,2,1.07379091143373000000
chr5,45615357,45972966,357609,1,0,348980,1,0.27963502037141100000
chr13,51462273,52010268,547995,1,0,220108;79621;647174;26512,4,0.72993366727798600000
chr8,53455738,53694689,238951,1,0,389658;9821,2,0.83699168448761500000
chr6,140825147,142191983,1366836,1,0,,0,0.00000000000000000000
chr1,194287956,194481053,193097,1,0,,0,0.00000000000000000000
chr15,90372221,90581720,209499,1,0,374655;10239;348110;100526783,4,1.90931698957990000000
chr9,71450033,71712303,262270,1,0,5568;8395;2395,3,1.14385938155336000000
chr11,64414216,64502074,87858,1,0,9379;10235,2,2.27640055544174000000
chr21,47609029,47714744,105715,1,0,8888;54059;4047,3,2.83781866338741000000
chr12,120984455,121117998,133543,1,0,9478;51367;9921,3,2.24646742996638000000
chr7,71986491,72365810,379319,1,0,9883;441250,2,0.52726069614229700000
chr9,140658500,140688253,29753,1,0,79813,1,3.36100561287937000000
chr4,16833244,17805581,972337,1,0,51056;27146;645104;5860;54876;80306;9079,7,0.71991500889095000000
chr18,46278798,46645188,366390,1,0,54808;4092;9811,3,0.81879963972815900000
chr9,163161,478844,315683,1,0,81704;23189;157983;55871,4,1.26709388848940000000
chr17,54350432,54523853,173421,1,0,162282,1,0.57663143448602000000
chrX,124738242,125756852,1018610,1,0,340578;139170,2,0.19634600092282600000
chr7,9436795,10676383,1239588,1,0,,0,0.00000000000000000000
chr5,179225480,179555654,330174,1,0,51149;255426;55819;23061;8878;11282,6,1.81722364571408000000
chr9,46587,369380,322793,1,0,81704;2298;157983;55871,4,1.23918424501151000000
chr10,1531338,3611077,2079739,1,0,10531;5214;105,3,0.14424886968989900000
chr11,3808849,4139722,330873,1,0,6240;27315;6786;4928;391,5,1.51115382639260000000
chr9,123287327,123499880,212553,1,0,55755;1955,2,0.94094178863624600000
chr9,16454000,16492000,38000,1,0,54796,1,2.63157894736842000000
chr7,153481189,154115889,634700,1,0,1804,1,0.15755475027572100000
chr1,54791253,55196363,405110,1,0,26027;374977;23648;338094;7268,5,1.23423267754437000000
chr7,32226519,32371664,145145,1,0,5137,1,0.68896620620758600000
chr16,89446348,89689881,243533,1,0,6687;27132;1800;29123;6137,5,2.05310984548295000000
chr7,66540119,66888001,347882,1,0,55253,1,0.28745379180296800000
chr19,2806441,2940906,134465,1,0,7064;115196;148254;80032;58492;126295,6,4.46212769122076000000
chrX,961572,1327588,366016,1,0,64109,1,0.27321210001748600000
chr2,33992197,34388501,396304,1,0,,0,0.00000000000000000000
chr2,37008840,37573211,564371,1,0,5610;55471;5212;10153;54497;100505876;23683;25797;253635;6801;391365,11,1.94907250726915000000
chr8,6677848,7044046,366198,1,0,389610;1671;1670;728358;1669;1672;1667;1668,8,2.18461051125347000000
chr1,120546331,121149971,603640,1,0,4853;653820;2210;653464,4,0.66264661056258700000
chr10,37280363,46111592,8831229,1,0,6387;219749;221002;7587;643236;53828;220979;220992;9790;83937;8187;11067;55454;220972;91074;5979;3185;100288485;7570;100130539;57209;7580;93550;7581;79290;7582;240,27,0.30573321108534300000
chr2,110862507,111368862,506355,1,0,729540;7851;100288695;4867,4,0.78995961331476900000
chr15,93194688,93562523,367835,1,0,400451;1106,2,0.54372204928840400000
chr6,99231557,99848079,616522,1,0,51805;26235;84553;5454;25957,5,0.81100106727740500000
chr10,87268974,88271999,1003025,1,0,23063;2894,2,0.19939682460556800000
chr16,13176127,13347675,171548,1,0,729993,1,0.58292722736493600000
chr22,23257051,23648009,390958,1,0,27156;9609;613;2781,4,1.02312780400964000000
chrX,40114981,41049323,934342,1,0,9282;100873985;10159;159013;8239;347411,6,0.64216314796937300000
chr10,79384197,80103167,718970,1,0,3778;9231;11128;6229,4,0.55635144720920200000
chr21,22782651,24339651,1557000,1,0,4685,1,0.06422607578676940000
chr10,61471843,61624154,152311,1,0,8030;100507027,2,1.31310279625240000000
chr2,132097797,132209108,111311,1,0,150786,1,0.89838380753025300000
chr14,21360244,21407595,47351,1,0,6037,1,2.11188781651919000000
chr16,34482042,34682448,200406,1,0,,0,0.00000000000000000000
chr3,162514534,162619141,104607,1,0,,0,0.00000000000000000000
chr12,8003414,8118036,114622,1,0,144195;6515,2,1.74486573258188000000
chr16,34482042,34682448,200406,1,0,,0,0.00000000000000000000
chr3,162514534,162619141,104607,1,0,,0,0.00000000000000000000
chr4,69375140,69483277,108137,1,0,7367,1,0.92475285979821900000
chr1,161482985,161640943,157958,1,0,2214;2213;3310;2215;2212,5,3.16539839704225000000
chr6,168343841,168581212,237371,1,0,3834;4301;100128124;79981,4,1.68512581570622000000
chr3,80252522,83487019,3234497,1,0,2632,1,0.03091670822387530000
chr4,95881091,96636651,755560,1,0,8633;658,2,0.26470432526867500000
chr2,203173060,203372116,199056,1,0,659,1,0.50237119202636400000
chr3,127548478,127969914,421436,1,0,60678;166348;29927;8607,4,0.94913581184331700000
chr1,40182104,40311934,129830,1,0,10450;64064;54802;656,4,3.08095201417238000000
chr1,145610762,145831329,220567,1,0,27246;10623;653519;11126;5174,5,2.26688489211895000000
chr6,90337936,90642027,304091,1,0,22881;60468;84694;23195;57226;9994,6,1.97309358054004000000
chr3,186412847,186503515,90668,1,0,1974;3827,2,2.20584991397185000000
chr1,109241217,109749844,508627,1,0,127003;55119;6884;56900;6814;254268;29899;22911;23155;57535;163479,11,2.16268503245011000000
chr11,13626250,14091611,465361,1,0,10418;84188,2,0.42977387447594500000
chr2,131013337,131537733,524396,1,0,344561;84317;26469;55997;92856;205147;653269;653781;653275,9,1.71626023081793000000
chr11,662317,1157708,495391,1,0,64787;283229;4583;4588;10522;66005;101927423;79751;6181;283232;977;6888;5441;7106;101927503;347862;51286;161;57104;4586;55367,21,4.23907580073114000000
chr6,16701067,17067145,366078,1,0,6310,1,0.27316582804757500000
chr15,71996536,72407049,410513,1,0,79875;10002;4649;123228,4,0.97439057959187600000
chr16,11992742,12362738,369996,1,0,92017;2935;608,3,0.81081957642785300000
chr13,46245177,46468188,223011,1,0,283514;220082,2,0.89681674894960300000
chr12,831883,1707369,875486,1,0,144699;5893;65125;23085,4,0.45688908788946900000
chr12,831883,1707369,875486,1,0,144699;5893;65125;23085,4,0.45688908788946900000
chr3,18689098,19037936,348838,1,0,,0,0.00000000000000000000
chr6,91361405,94507563,3146158,1,0,2045,1,0.03178479911053420000
chr4,151678774,152025340,346566,1,0,6189;987,2,0.57709065517102100000
chr10,34944133,35183460,239327,1,0,56288,1,0.41783835505396400000
chr18,6825021,8055865,1230844,1,0,79822;5797;339291;284217,4,0.32498025744936000000
chr6,162729381,163289067,559686,1,0,135138;5071,2,0.35734322459379000000
chr2,32633569,33322587,689018,1,0,57448;4052;55622,3,0.43540226815554900000
chrX,2460295,2878460,418165,1,0,7499;414;415;4267;8908,5,1.19570026185836000000
chr15,100193258,100923775,730517,1,0,4205;145748;170691,3,0.41066806111288300000
chr15,31972705,32445200,472495,1,0,161725;1139,2,0.42328490248574100000
chr17,65369042,65657496,288454,1,0,26207,1,0.34667572645898500000
chr4,77112592,77216105,103513,1,0,100129583;950;100631383,3,2.89818670118729000000
chr15,34428049,35199258,771209,1,0,440270;9990;70;256646;254531;23015;79768;55505;51234;9716;57369,11,1.42633190224699000000
chr8,17628293,17817397,189104,1,0,2267;57509;5108,3,1.58642863186395000000
chr4,68345,134807,66462,1,0,152687;255403,2,3.00923836177064000000
chr16,21801890,22441961,640071,1,0,730094;440345;29904;7385;1039;146177;55718;255762,8,1.24986134350720000000
chr12,121121986,121208680,86694,1,0,9761;121665;35;84747,4,4.61392945301866000000
chrX,30162186,30549304,387118,1,0,4113;4112;190;4115;4114,5,1.29159584416121000000
chrX,74494014,74649810,155796,1,0,158866;139596,2,1.28373000590516000000
chr16,71810610,72349058,538448,1,0,9785;3240;3250;83449;55565;1723;342371;342372;54957;164;9798,11,2.04290850741390000000
chr9,70984481,71129883,145402,1,0,5239,1,0.68774844912724700000
chr9,18611611,18708803,97192,1,0,92949,1,1.02889126677093000000
chr6,163349004,163631933,282929,1,0,135138,1,0.35344556408144800000
chrY,6150576,6296410,145834,1,0,,0,0.00000000000000000000
chrY,9387430,10073965,686535,1,0,,0,0.00000000000000000000
chr16,31223119,31789768,566649,1,0,51327;1339;493829;7041;79798;6524;3687;3684;283933;3681;124411;260434;64755,13,2.29418917178006000000
chr16,84094791,84444874,350083,1,0,123872;9013;93107;83693;9914;8720;58189;161931,8,2.28517237340859000000
chr2,46949149,47212671,263522,1,0,9655;90411;57217,3,1.13842487534248000000
chr2,46524403,46636967,112564,1,0,2034,1,0.88838349738815300000
chr16,83300948,84011504,710556,1,0,3281;23417;54550;29948;1012,5,0.70367430575493000000
chr2,46236748,46371231,134483,1,0,5581,1,0.74358840894388100000
chr1,174794375,174961850,167475,1,0,9910,1,0.59710404537990700000
chr6,45678713,45879492,200779,1,0,53405,1,0.49806005608156200000
chrX,5119276,5678751,559475,1,0,,0,0.00000000000000000000
chr4,65638122,65816302,178180,1,0,,0,0.00000000000000000000
chr3,68178657,68333063,154406,1,0,407738,1,0.64764322629949600000
chr13,113526007,113715020,189013,1,0,23263;23250,2,1.05812827689101000000
chrY,24874301,28660436,3786135,1,0,1617;57135;442868;9085;9083;57055;57054;442867;253175,9,0.23770943191407600000
chr20,3897014,4135849,238835,1,0,54498;80025;11237,3,1.25609730567128000000
chr18,9073584,9142999,69415,1,0,4729;23253,2,2.88122163797450000000
chrX,187510,537202,349692,1,0,55344;28227;8225,3,0.85789780721320500000
chr15,85829604,86206005,376401,1,0,11214,1,0.26567410819843700000
chr9,33284109,33524283,240174,1,0,364;4799;360;65083,4,1.66545920874033000000
chr20,8095586,8575564,479978,1,0,23236,1,0.20834288238210900000
chr2,75685119,76159739,474620,1,0,84141;6936;9801,3,0.63208461506046900000
chr20,8095586,8575564,479978,1,0,23236,1,0.20834288238210900000
chr1,145632334,145747269,114935,1,0,11126;27246;5174,3,2.61017096619829000000
chr6,170180782,170271275,90493,1,0,55780,1,1.10505784977844000000
chr4,157986126,158293264,307138,1,0,2743;2891,2,0.65117308831860600000
chrY,2142818,2635674,492856,1,0,207063;9189;4267,3,0.60869706364536500000
chr16,14910205,16276086,1365881,1,0,4629;100288332;123811;89927;4363;9284;54820;23420;368;255027;23042;54700;123803;9665,14,1.02497948210715000000
chr10,123450317,123952655,502338,1,0,11101;54780;10579,3,0.59720745792673500000
chr5,94683072,94972724,289652,1,0,285601;153642;153643;9652,4,1.38096750583459000000
chr16,48286660,48635502,348842,1,0,83752;6477;9683,3,0.85998818949553100000
chrX,154939018,155229003,289985,1,0,6845;3581;10251,3,1.03453626911737000000
chrX,74017030,75668478,1651448,1,0,340533;158866;51260;57692;22;139599;139596,7,0.42387044581482400000
chrX,148781402,149584246,802844,1,0,541578;4110;4108;10046;4107;100506164,6,0.74734319494198100000
chr7,104558907,104902117,343210,1,0,55904;6733,2,0.58273360333323600000
chr6,52666317,52747842,81525,1,0,2938;221357,2,2.45323520392518000000
chr8,2355745,5346663,2990918,1,0,64478,1,0.03343455086364790000
chr21,32375488,32454267,78779,1,0,728299,1,1.26937381789563000000
chr5,128535922,128932317,396395,1,0,171019,1,0.25227361596387400000
chr20,41590912,41860649,269737,1,0,11122,1,0.37073149030351800000
chr2,110706145,111202777,496632,1,0,7851;4867,2,0.40271267256238000000
chr10,51731294,52459018,727724,1,0,414189;100652748;259230;387680;56624,5,0.68707367078727700000
chr10,48775606,51126733,2351127,1,0,143162;5599;6572;644168;26095;267004;118461;282966;58504;8505;57705;474354;170371;1103;2074;170370;196740;644054;55753,19,0.80812308310014700000
chr8,27110281,28196125,1085844,1,0,81551;5368;2053;286133;157570;55140;51435;1191;1135;55246;389643;55872;2185;23087,14,1.28931964444248000000
chr15,22770421,23288350,517929,1,0,123606;23191;114791;81614,4,0.77230662890087300000
chr4,186942179,187133082,190903,1,0,7098;285440;25854,3,1.57147870908262000000
chr22,51104116,51165386,61270,1,0,85358,1,1.63212012404113000000
chr10,134847698,135427386,579688,1,0,10844;85442;27287;8433;93426;84435;50632;92170;118471;282969;196743;503542;101;1892;1571;118472,16,2.76010543602766000000
chr6,65348960,65928829,579869,1,0,346007,1,0.17245274363692500000
chrX,124508,207573,83065,1,0,55344,1,1.20387648227292000000
chr22,45185898,47145455,1959557,1,0,553158;150383;7380;23779;2192;10343;7477;23313;25814;27127;10762;55020;55687;23151;51512;55267;9620;55007;64781;5465;112885;26150,22,1.12270273332187000000
chr18,50078622,50305963,227341,1,0,1630,1,0.43986786369374600000
chr8,53161037,53607735,446698,1,0,389658;9705;9821,3,0.67159467917922200000
chrX,130672870,130960617,287747,1,0,347468,1,0.34752751549103900000
chrX,6451676,8131781,1680105,1,0,51481;412;8228;26609;8226,5,0.29760044759107300000
chr9,130154141,130247895,93754,1,0,6136;29988;90678;84253;7633,5,5.33310578748640000000
chr4,82299006,82543148,244142,1,0,153020,1,0.40959769314579200000
chr1,21471859,21725650,253791,1,0,1889;8672,2,0.78805000965361300000
chrX,1446824,1626199,179375,1,0,293;286530;3563;8623,4,2.22996515679442000000
chr10,124640823,124839535,198712,1,0,118670;118672;36;80007;64376,5,2.51620435605298000000
chr8,20690353,21360646,670293,1,0,,0,0.00000000000000000000
chr1,89121944,89363123,241179,1,0,2959;5586,2,0.82925959557009500000
chr17,2454772,3136279,681507,1,0,23277;4991;8386;8390;26189;23108;5048;8383,8,1.17386908718472000000
chr21,23327717,24165264,837547,1,0,,0,0.00000000000000000000
chrX,29868880,30068733,199853,1,0,11141,1,0.50036777031117900000
chr4,25881912,26156768,274856,1,0,389203,1,0.36382687661903000000
chr21,33129177,33674071,544894,1,0,56246;54069;30811,3,0.55056579811853300000
chr4,42844991,42968619,123628,1,0,389207,1,0.80887824764616400000
chr10,70110253,70595491,485238,1,0,1763;8034;55680;55749;219736;80312,6,1.23650662149296000000
chr3,10645496,10946701,301205,1,0,6538,1,0.33199980080012000000
chr21,47483799,47786494,302695,1,0,54058;10841;54059;8888;1292;5116;84221;4047,8,2.64292439584400000000
chr6,1369777,1612769,242992,1,0,2296;2295,2,0.82307236452228900000
chr12,121895610,122102984,207374,1,0,84678;84876;283385,3,1.44666158727709000000
chr2,238216063,238525319,309256,1,0,1293;79083;51052;64284,4,1.29342680497711000000
chrX,64525365,64773018,247653,1,0,81887;340554,2,0.80758157583392900000
chr6,109962702,110146566,183864,1,0,221264;9896,2,1.08776051864422000000
chr7,16930369,17395389,465020,1,0,196,1,0.21504451421444200000
chr5,1266618,1673099,406481,1,0,7015;81037;79888;6531,4,0.98405583532809600000
chr8,127669242,128116500,447258,1,0,,0,0.00000000000000000000
chr2,96766560,97715083,948523,1,0,81562;51239;56910;55683;23397;10865;54910;9391;26504;93082;51252;90342;1844;151;26505;200539;23020;150771;431705;55654,20,2.10854138486890000000
chr3,68857600,68953606,96006,1,0,151647,1,1.04160156656876000000
chrX,18194165,18493834,299669,1,0,6792;139105;10389,3,1.00110455202240000000
chr21,35736323,35883613,147290,1,0,101928147;9992;54065;3753,4,2.71573087107068000000
chr21,35736323,35883613,147290,1,0,101928147;9992;54065;3753,4,2.71573087107068000000
chr20,1344531,14420556,13076025,1,0,140733;57593;54498;10326;5786;80332;9762;64773;22903;84515;551;5621;23236;5020;343641;56265;117532;146;1059;8760;8195;51605;63926;6628;11237;9770;5332;388780;3704;64601;64096;83959;23767;54976;650;182;57144;56261;116835;128646;64949;80025;80343;9962;149840;55317;55968;24141;128653;56255;55612;6616;55304;55617;54363;10528;23627;8455;54675;22888;29058;7053;164312;140885;128674;2797;60493;6614;3420;25876;1114;5173;140862;65992;128710;2280;25943;5111;79133;57506;140901;55423;100288797;284759;79175;994;51575,87,0.66533981083700900000
chr16,73175016,73307327,132311,1,0,388289,1,0.75579505861190700000
chr5,17721569,18454004,732435,1,0,,0,0.00000000000000000000
chr5,17721569,18439865,718296,1,0,,0,0.00000000000000000000
chr9,94681802,94802318,120516,1,0,10558;4920,2,1.65953068472236000000
chr11,21079942,21429653,349711,1,0,4745,1,0.28595039904378200000
chrX,76889184,77041032,151848,1,0,546,1,0.65855329013223800000
chr7,2535724,3360622,824898,1,0,84433;221927;2768;3955;155185;221935;80727;23288,8,0.96981687432870500000
chr7,29212013,29528298,316285,1,0,54504;1124,2,0.63234108478113100000
chr7,7010835,7537675,526840,1,0,340267;56913,2,0.37962189659099500000
chrX,138012748,138645536,632788,1,0,2258;2158,2,0.31606161937331300000
chr4,3975715,4485131,509416,1,0,55646;27065;53407;166793;133060;85013,6,1.17781930681408000000
chr20,35332959,35578534,245575,1,0,140710;25939;57446;79980;140711,5,2.03603787030439000000
chr18,44177387,44310237,132850,1,0,125336;29906,2,1.50545728264960000000
chr1,16362640,16380691,18051,1,0,1188,1,5.53985928757410000000
chrX,40380579,40463348,82769,1,0,10159,1,1.20818180719835000000
chrX,6448501,8135568,1687067,1,0,51481;412;8228;26609;8226,5,0.29637234324422200000
chr2,112898465,113434193,535728,1,0,6574;150465;129804;84172;84269;376940;727851;84524,8,1.49329510497865000000
chr3,82389573,84790582,2401009,-1,0,,0,0.00000000000000000000
chr5,117002559,117632350,629791,-1,0,,0,0.00000000000000000000
chr19,23624528,24061180,436652,-1,0,148213;171392,2,0.45803065141119200000
chr15,100825736,100862053,36317,-1,0,170691,1,2.75353140402566000000
chr1,49729012,50309484,580472,-1,0,84871,1,0.17227359803745900000
chrY,59044874,59336737,291863,-1,0,10251;6845;3581,3,1.02787951881533000000
chr6,47864876,49250897,1386021,-1,0,442213,1,0.07214897898372390000
chr2,52946947,53055889,108942,-1,0,,0,0.00000000000000000000
chrY,6414449,9168675,2754226,-1,0,266;90665,2,0.07261568222796530000
chr15,48242181,48706771,464590,-1,0,399697;50804;2200;6557;1854;283652,6,1.29146128844788000000
chr3,178223239,178397892,174653,-1,0,10242,1,0.57256388381533700000
chr3,144875793,145885243,1009450,-1,0,5352,1,0.09906384664916540000
chr8,3623048,3659817,36769,-1,0,64478,1,2.71968234110256000000
chr1,194164188,195076676,912488,-1,0,,0,0.00000000000000000000
chr4,189143425,189917440,774015,-1,0,,0,0.00000000000000000000
chr2,50962705,51036621,73916,-1,0,9378,1,1.35288706098815000000
chr2,111399243,111435995,36752,-1,0,699,1,2.72094035698737000000
chr17,44165726,44351152,185426,-1,0,284058,1,0.53929869597575300000
chr12,785452,1549198,763746,-1,0,5893;65125;23085,3,0.39280074789262400000
chr1,49918430,49993072,74642,-1,0,84871,1,1.33972830310013000000
chr8,61567793,61604466,36673,-1,0,55636,1,2.72680173424590000000
chrX,5083331,5529070,445739,-1,0,,0,0.00000000000000000000
chr21,45477723,45484313,6590,-1,0,7109,1,15.17450682852810000000
chr2,51037133,51382842,345709,-1,0,9378,1,0.28926062092684900000
chr9,28562011,28777389,215378,-1,0,158038,1,0.46429997492780100000
chr3,158173841,158295574,121733,-1,0,4291;51319,2,1.64293987661522000000
chr6,162541365,162748305,206940,-1,0,5071,1,0.48323185464385800000
chr2,133482386,133557942,75556,-1,0,344148,1,1.32352162634337000000
chr2,108540378,109098421,558043,-1,0,6819;9648;27233;442038;60482,5,0.89598830197672900000
chr12,101555548,101582879,27331,-1,0,160728,1,3.65884892612784000000
chr4,99437193,99460166,22973,-1,0,10098,1,4.35293605536935000000
chr17,44171888,44345038,173150,-1,0,284058,1,0.57753393011839400000
chr17,44221743,44345038,123295,-1,0,284058,1,0.81106289792773400000
chr17,44221743,44345038,123295,-1,0,284058,1,0.81106289792773400000
chr17,44171888,44297143,125255,-1,0,284058,1,0.79837132250209600000
chr17,44197448,44297143,99695,-1,0,284058,1,1.00305933095943000000
chr9,98643183,98718241,75058,-1,0,375748,1,1.33230301899864000000
chr17,44231946,44297143,65197,-1,0,284058,1,1.53381290550179000000
chr17,4008948,4098100,89152,-1,0,23140;51479;124936,3,3.36503948312994000000
chr20,60024734,60078775,54041,-1,0,1002,1,1.85044688292223000000
chr17,44231946,44345038,113092,-1,0,284058,1,0.88423584338414700000
chr17,44221743,44345038,123295,-1,0,284058,1,0.81106289792773400000
chr4,86883886,86905002,21116,-1,0,83478,1,4.73574540632696000000
chr17,44221743,44345038,123295,-1,0,284058,1,0.81106289792773400000
chr13,41726952,41766715,39763,-1,0,84078,1,2.51490078716395000000
chr16,6727475,6858879,131404,-1,0,54715,1,0.76101184134425100000
chr3,79577722,79658416,80694,-1,0,6091,1,1.23924951049644000000
chr7,2268188,2340711,72523,-1,0,8379;29960;29886;4521,4,5.51549163713581000000
chr16,54873802,55104462,230660,-1,0,643911;10265,2,0.86707708315269200000
chr13,75933943,76019945,86002,-1,0,9882,1,1.16276365665915000000
chr1,28743173,28764436,21263,-1,0,65979,1,4.70300522033579000000
chr6,5233599,5359994,126395,-1,0,10667;57128,2,1.58234107361842000000
chr16,78403602,78455851,52249,-1,0,51741,1,1.91391222798522000000
chr2,98168165,98431587,263422,-1,0,23505;7535;1329;57730;10120,5,1.89809507178596000000
chr1,91122197,91726392,604195,-1,0,84146;164045;343472,3,0.49652843866632500000
chr2,28791353,28848332,56979,-1,0,151056,1,1.75503255585391000000
chr13,48557360,48703792,146432,-1,0,55270;29079;8803,3,2.04873251748252000000
chr5,79768532,79820363,51831,-1,0,167555;9765,2,3.85869460361560000000
chr21,47561659,47584853,23194,-1,0,84221;10841,2,8.62291972061740000000
chr10,106400805,106452836,52031,-1,0,22986,1,1.92193115642598000000
chr2,51316018,51920657,604639,-1,0,,0,0.00000000000000000000
chr5,21001561,21451776,450215,-1,0,,0,0.00000000000000000000
chr21,45873298,46544207,670909,-1,0,386678;386674;386675;754;386683;386672;54084;3689;104;386684;353332;7327;6612;386679;386682;386676;386677;386680;353333;386681;81543;85395;386685;353323,24,3.57723625707808000000
chr7,112644693,113086495,441802,-1,0,54329,1,0.22634573858878000000
chr12,21032465,21377322,344857,-1,0,338821;28234;10599,3,0.86992579532965800000
chr11,39604912,40710347,1105435,-1,0,57689,1,0.09046212576949350000
chr1,222694279,224070013,1375734,-1,0,64853;9015;400823;164127;7159;55061;824;7100;375056;148362;388743;84976;79802,13,0.94495011390283300000
chr5,22047479,22434758,387279,-1,0,1010,1,0.25821178013783300000
chr10,48621478,49262377,640899,-1,0,26095;644054,2,0.31206165089975200000
chr7,3956852,4176001,219149,-1,0,221935,1,0.45631054670566600000
chr7,145781605,145868689,87084,-1,0,26047,1,1.14831656791144000000
chr17,15183668,15185073,1405,-1,0,,0,0.00000000000000000000
chr1,1627899,1663760,35861,-1,0,728642;9906,2,5.57708931708541000000
chr15,24384453,24470140,85687,-1,0,,0,0.00000000000000000000
chr7,950215,974690,24475,-1,0,11033,1,4.08580183861083000000
chr17,15183247,15185073,1826,-1,0,,0,0.00000000000000000000
chr17,2550896,2561022,10126,-1,0,5048,1,9.87556784515110000000
chr15,25420800,25491412,70612,-1,0,,0,0.00000000000000000000
chr15,22880274,23217514,337240,-1,0,123606;23191;81614,3,0.88957419048748700000
chr8,7053245,8130630,1077385,-1,0,401447;503614;504180;503841;140596;100133251;653423;100131980;645402;55894;245910;1673;100131608;245908;100132396;503618;392188;100289462;245909;414325;10407;645836,22,2.04198127874437000000
chr22,20754222,21505558,751336,-1,0,80764;9342;91179;8216;7625;400891;1399;84861;6545;150209;5297;51586;9127;3053,14,1.86334742378909000000
chr1,1627899,1663760,35861,-1,0,728642;9906,2,5.57708931708541000000
chr15,32462642,32514980,52338,-1,0,,0,0.00000000000000000000
chr1,1627899,1663760,35861,-1,0,728642;9906,2,5.57708931708541000000
chr19,1638078,1648193,10115,-1,0,6929,1,9.88630746416213000000
chr17,15183668,15185073,1405,-1,0,,0,0.00000000000000000000
chr12,132681054,132902831,221777,-1,0,50614,1,0.45090338493171100000
chr4,3573014,3636893,63879,-1,0,,0,0.00000000000000000000
chr16,96766,114341,17575,-1,0,79622;51728;64285,3,17.06970128022760000000
chr6,31958992,31980751,21759,-1,0,720,1,4.59579943931247000000
chrX,140076285,140616013,539728,-1,0,728695;64663;23641,3,0.55583553197166000000
chrX,140076285,140616013,539728,-1,0,728695;64663;23641,3,0.55583553197166000000
chr6,161818357,161856319,37962,-1,0,5071,1,2.63421316052895000000
chr14,20306922,21190399,883477,-1,0,122651;390433;81127;57820;91875;390442;122742;10038;390431;90809;283;338879;390443;7011;390436;390437;493901;4860;328;122748;79317;341799;122740;55644;390439;6038;79544;123103,28,3.16929586169193000000
chr3,61031840,161136447,100104607,-1,0,7634;6314;29970;83850;54763;131450;1360;22989;80111;170506;653659;26984;5922;10051;56941;7707;56667;403274;55076;80145;3592;389161;56203;29114;286676;8997;56925;51208;8706;401097;79825;151742;4071;9861;25976;91653;11343;55573;64091;253461;339122;131544;8723;81050;4154;8930;151987;58477;8545;116931;54554;100505385;9666;8856;644974;253559;3693;64770;4638;116064;9197;5357;55096;199221;415117;30849;257144;79310;54625;6565;64747;57092;401089;523;8801;79691;214;91775;10342;5067;10721;29927;26341;55764;6578;285335;7220;1356;4710;57018;151636;200959;84129;92369;25978;79295;942;51319;344805;55347;51068;57501;56999;4690;10954;132243;9435;55840;8833;56650;285313;348801;5217;23129;2850;64805;5948;201633;403278;64332;8971;84925;868;8618;55279;6184;257068;51714;80325;165721;84692;344752;64422;285203;6010;185;9039;83939;51365;152185;28990;389136;286827;7348;317649;285195;60675;151871;7018;114112;57088;402135;287015;84107;7555;100534599;4171;28976;13;55;79669;54464;483;55773;5918;256076;254887;27031;6092;56983;131873;545;5361;7110;11073;131870;9657;79413;3059;57560;23350;26355;7545;152118;339855;9626;54762;55179;3840;79598;8607;2272;5627;6478;57337;9223;55081;344807;7372;389158;131368;55079;4311;2992;2932;8702;4291;26577;131601;84873;200894;51725;131076;54437;165679;389170;25890;3836;2632;57514;285237;166336;4345;27086;5352;66000;10063;6747;285282;56954;152405;152078;92370;2960;151888;165631;25871;54931;56945;50852;961;7029;131890;55254;29909;53836;403277;152015;84343;131566;344758;79876;5947;8419;729627;57493;5449;727936;57650;57047;1371;55186;3081;84100;90288;1295;79674;23429;11222;9616;25847;56670;79858;9276;1475;116441;55167;50939;84561;1814;5291;80254;63899;645840;9934;26084;347736;54847;11148;64084;201562;141;2815;349565;7881;55032;9515;5912;152065;10274;53833;2624;200810;57415;344838;200895;25852;22820;28999;205717;5523;166348;57461;80218;89876;5096;3355;114885;23024;2804;26018;84541;100288801;152404;407738;84864;51421;22808;51560;6596;23150;11259;6259;90102;79663;56987;2047;10402;165829;25937;27032;115286;4045;83666;10840;5359;84319;51554;51146;80117;132203;166012;205428;57577;79364;7200;348807;26137;132204;11342;131669;55211;151647;23023;10225;151887;53829;84666;7104;55164;9868;941;2596;503582;5806;55779;23317;2838;4286;27136;51163;6091;8403;5028;846;389151;11167;285315;100131827;285311;403273;285220;668;27230;7401;51122;654502;25945;80321;80723;131831;60678;7879;9819;84303;111;2042;10550;6152;131034;389152;26339;27107;1359;85476;256356;50512;6474;54946;23007;5793;29083;51300,423,0.42255797477932300000
chr2,35020439,35081849,61410,-1,0,,0,0.00000000000000000000
chr17,1945546,1946427,881,-1,0,124641;1801,2,227.01475595913700000000
chr17,15183668,15185073,1405,-1,0,,0,0.00000000000000000000
chr17,15183668,15185073,1405,-1,0,,0,0.00000000000000000000
chr12,133712947,133718574,5627,-1,0,7556,1,17.77145903678690000000
chr17,15183668,15185073,1405,-1,0,,0,0.00000000000000000000
chr19,1627899,1663760,35861,-1,0,6929,1,2.78854465854271000000
chr17,15183668,15185073,1405,-1,0,,0,0.00000000000000000000
chr6,161818357,161856319,37962,-1,0,5071,1,2.63421316052895000000
chr1,1616882,1663760,46878,-1,0,728642;728661;9906,3,6.39959042621272000000
chr6,163927624,163943848,16224,-1,0,9444,1,6.16370808678501000000
chr9,140986162,141025921,39759,-1,0,774,1,2.51515380165497000000
chr1,144679875,144959577,279702,-1,0,400818;9659,2,0.71504672830369500000
chr15,101101453,101122230,20777,-1,0,55180,1,4.81301439091303000000
chr4,173074684,173429697,355013,-1,0,442117,1,0.28167982580919600000
chr4,1398891,1496353,97462,-1,0,54729,1,1.02604091851183000000
chr12,66157326,66185124,27798,-1,0,,0,0.00000000000000000000
chr12,83169841,83212430,42589,-1,0,160335,1,2.34802413768814000000
chr6,259328,350924,91596,-1,0,56940,1,1.09175073147299000000
chr22,18894635,19010649,116014,-1,0,5625;8214,2,1.72392987053287000000
chr1,161482785,161641084,158299,-1,0,2214;2213;3310;2215;2212,5,3.15857964990303000000
chr15,25420600,25430735,10135,-1,0,,0,0.00000000000000000000
chr1,196745864,197161354,415490,-1,0,360023;2165;259266;3080;10877;81494;3078;10878,8,1.92543743531734000000
chr1,1627899,1663760,35861,-1,0,728642;9906,2,5.57708931708541000000
chr19,53603069,53626176,23107,-1,0,90338;55786,2,8.65538581382265000000
chr14,107151892,107282075,130183,-1,0,,0,0.00000000000000000000
chr15,30938015,30971730,33715,-1,0,,0,0.00000000000000000000
chr15,20848910,22174118,1325208,-1,0,100996331;100287399,2,0.15091970468032200000
chr14,19520707,20052757,532050,-1,0,641455;404785,2,0.37590452025185600000
chr15,25420800,25430579,9779,-1,0,,0,0.00000000000000000000
chr6,161818357,161856319,37962,-1,0,5071,1,2.63421316052895000000
chr16,86602294,86602546,252,-1,0,2303,1,396.82539682539700000000
chr20,62575587,62582936,7349,-1,0,54963,1,13.60729350932100000000
chr15,32462642,32514980,52338,-1,0,,0,0.00000000000000000000
chr8,7273808,7752727,478919,-1,0,503614;504180;503841;140596;100133251;653423;55894;245910;1673;100131608;245908;503618;100289462;245909;414325;10407,16,3.34085722220250000000
chrX,48754234,49069163,314929,-1,0,27238;10245;90060;7355;56850;11152;778;79917;5355;10084;55593;4007;11040;6855;11230;3750;7030,17,5.39804209837773000000
chr6,31958792,32013753,54961,-1,0,7148;1589;721;720,4,7.27788795691490000000
chr15,28709009,28759022,50013,-1,0,,0,0.00000000000000000000
chrX,153230860,153253367,22507,-1,0,3054;8269,2,8.88612431687919000000
chr22,16437771,16439957,2186,-1,0,,0,0.00000000000000000000
chr6,32066771,32121731,54960,-1,0,7148;9374;63943;80863;1388,5,9.09752547307133000000
chr5,177324420,177343068,18648,-1,0,,0,0.00000000000000000000
chr6,242223,295924,53701,-1,0,56940,1,1.86216271577810000000
chr15,102310395,102377105,66710,-1,0,390648;390649,2,2.99805126667666000000
chr1,196746064,196797163,51099,-1,0,3078;10878,2,3.91397091919607000000
chr22,23046186,23087153,40967,-1,0,,0,0.00000000000000000000
chr4,11881248,12165095,283847,-1,0,,0,0.00000000000000000000
chr3,130665807,131157799,491992,-1,0,28990;79858;131870;27032,4,0.81302134994064900000
chr20,57556968,57575495,18527,-1,0,51497;1522,2,10.79505586441410000000
chrX,155033683,155190057,156374,-1,0,6845,1,0.63949249875299000000
chr4,88219679,88233498,13819,-1,0,345275,1,7.23641363340329000000
chr16,83003268,83179357,176089,-1,0,1012,1,0.56789464418561100000
chr9,19389757,19565588,175831,-1,0,340485;25769,2,1.13745585249473000000
chr5,118078599,118195445,116846,-1,0,285605,1,0.85582732827824700000
chr22,28231898,28367786,135888,-1,0,23760,1,0.73590015306723200000
chr12,27458545,27768451,309906,-1,0,56938;23012;8496;341346,4,1.29071395842610000000
chr13,73428166,73592902,164736,-1,0,10464,1,0.60703185703185700000
chr16,60082591,61797644,1715053,-1,0,729159;1006,2,0.11661447197258600000
chr22,21075575,21440514,364939,-1,0,80764;9342;3053;8216;400891;1399;6545;150209;9127;5297,10,2.74018397595215000000
chr15,24406896,25108865,701969,-1,0,6638;23742,2,0.28491286652259600000
chr3,63270241,63534765,264524,-1,0,132204,1,0.37803753156613400000
chr2,51021452,51066637,45185,-1,0,9378,1,2.21312382427797000000
chr10,19462004,19810734,348730,-1,0,340895,1,0.28675479597396300000
chr2,203246538,203286160,39622,-1,0,659,1,2.52385038614911000000
chr2,189244840,189374285,129445,-1,0,51454,1,0.77252887326663800000
chr21,29198023,29329092,131069,-1,0,,0,0.00000000000000000000
chr16,6316743,6568152,251409,-1,0,54715,1,0.39775823458985200000
chrX,479089,484163,5074,-1,0,,0,0.00000000000000000000
chrY,429089,434147,5058,-1,0,,0,0.00000000000000000000
chr1,189244138,189341108,96970,-1,0,,0,0.00000000000000000000
chr16,7008323,7088076,79753,-1,0,54715,1,1.25387132772435000000
chr2,35846921,36007779,160858,-1,0,,0,0.00000000000000000000
chr8,115331133,115487026,155893,-1,0,,0,0.00000000000000000000
chr4,126522524,126624150,101626,-1,0,,0,0.00000000000000000000
chr1,79651539,79771035,119496,-1,0,,0,0.00000000000000000000
chr2,35524271,35620532,96261,-1,0,,0,0.00000000000000000000
chr5,97442253,97546487,104234,-1,0,,0,0.00000000000000000000
chr13,114740192,114844116,103924,-1,0,22821,1,0.96224163812016500000
chr16,7109560,7180461,70901,-1,0,54715,1,1.41041734249164000000
chr5,99715194,99832593,117399,-1,0,,0,0.00000000000000000000
chr2,35524271,35620532,96261,-1,0,,0,0.00000000000000000000
chrX,91201773,91243705,41932,-1,0,27328,1,2.38481350758371000000
chr6,4269714,4437920,168206,-1,0,,0,0.00000000000000000000
chr16,63004697,63307109,302412,-1,0,,0,0.00000000000000000000
chr2,35817290,36088730,271440,-1,0,,0,0.00000000000000000000
chrY,59299634,59313099,13465,-1,0,,0,0.00000000000000000000
chrX,155197020,155208553,11533,-1,0,,0,0.00000000000000000000
chr16,76735357,76840089,104732,-1,0,,0,0.00000000000000000000
chrX,342639,356367,13728,-1,0,28227,1,7.28438228438228000000
chrY,292639,306367,13728,-1,0,28227,1,7.28438228438228000000
chrY,732030,744392,12362,-1,0,,0,0.00000000000000000000
chrX,782028,794392,12364,-1,0,,0,0.00000000000000000000
chr1,242442100,242638837,196737,-1,0,200150,1,0.50829279698277400000
chr12,38403897,38405785,1888,-1,0,,0,0.00000000000000000000
chr5,175559327,175628957,69630,-1,0,,0,0.00000000000000000000
chr2,142074124,142216536,142412,-1,0,53353,1,0.70218801786366300000
chrX,126557495,126707575,150080,-1,0,,0,0.00000000000000000000
chr5,93520144,93561041,40897,-1,0,285600,1,2.44516712717314000000
chrX,33917222,34026301,109079,-1,0,,0,0.00000000000000000000
chr11,97758331,97918311,159980,-1,0,,0,0.00000000000000000000
chr6,4269714,4437920,168206,-1,0,,0,0.00000000000000000000
chr20,12376473,12548992,172519,-1,0,,0,0.00000000000000000000
chr4,23120186,23239001,118815,-1,0,,0,0.00000000000000000000
chr10,7632262,7641664,9402,-1,0,80760,1,10.63603488619440000000
chr7,84204503,84299116,94613,-1,0,,0,0.00000000000000000000
chr7,25953808,26041273,87465,-1,0,,0,0.00000000000000000000
chr14,48786761,48906345,119584,-1,0,,0,0.00000000000000000000
chr2,202113196,202122631,9435,-1,0,841,1,10.59883412824590000000
chr20,11019229,11622705,603476,-1,0,,0,0.00000000000000000000
chr2,66082862,66235097,152235,-1,0,,0,0.00000000000000000000
chr2,194402229,194501525,99296,-1,0,,0,0.00000000000000000000
chr5,104389572,104583291,193719,-1,0,,0,0.00000000000000000000
chr9,1711423,1908017,196594,-1,0,,0,0.00000000000000000000
chr6,94744299,95206208,461909,-1,0,,0,0.00000000000000000000
chr21,36679995,36780711,100716,-1,0,,0,0.00000000000000000000
chr11,38910017,39041736,131719,-1,0,,0,0.00000000000000000000
chr9,104690471,104977041,286570,-1,0,,0,0.00000000000000000000
chr7,10205622,10490542,284920,-1,0,,0,0.00000000000000000000
chrX,89463330,89494332,31002,-1,0,,0,0.00000000000000000000
chr2,35052570,35167948,115378,-1,0,,0,0.00000000000000000000
chr19,20592432,20725676,133244,-1,0,100129842,1,0.75050283690072400000
chr8,112009082,112275531,266449,-1,0,,0,0.00000000000000000000
chr20,3879345,3884942,5597,-1,0,80025,1,17.86671431123820000000
chr2,28706379,28840081,133702,-1,0,151056,1,0.74793196810818100000
chr12,85942216,86030621,88405,-1,0,,0,0.00000000000000000000
chr15,83635511,83734732,99221,-1,0,53339;123207;83640,3,3.02355348162183000000
chr2,36351331,36570247,218916,-1,0,,0,0.00000000000000000000
chr9,30622930,30697915,74985,-1,0,,0,0.00000000000000000000
chr9,91353811,91492404,138593,-1,0,,0,0.00000000000000000000
chr1,79651539,79771035,119496,-1,0,,0,0.00000000000000000000
chr5,99607172,99811883,204711,-1,0,,0,0.00000000000000000000
chr1,69218062,69314344,96282,-1,0,,0,0.00000000000000000000
chr11,40652227,40741565,89338,-1,0,57689,1,1.11934451185386000000
chr12,80589346,80827208,237862,-1,0,283310,1,0.42041183543399100000
chr2,233209808,233275967,66159,-1,0,250;251,2,3.02302029958131000000
chrX,140184762,140307851,123089,-1,0,23641,1,0.81242028125990100000
chr11,84046530,84454687,408157,-1,0,1740,1,0.24500376080772800000
chr1,189425480,189504629,79149,-1,0,,0,0.00000000000000000000
chr14,67054417,67119226,64809,-1,0,10243,1,1.54299557160271000000
chrX,22906961,22992475,85514,-1,0,,0,0.00000000000000000000
chr7,10528758,10649848,121090,-1,0,,0,0.00000000000000000000
chr4,97159957,97235516,75559,-1,0,,0,0.00000000000000000000
chr3,270637,283756,13119,-1,0,10752,1,7.62253220519857000000
chr3,162598836,162725339,126503,-1,0,,0,0.00000000000000000000
chr14,40436270,40591801,155531,-1,0,,0,0.00000000000000000000
chrX,382626,396223,13597,-1,0,,0,0.00000000000000000000
chr3,165406538,166102750,696212,-1,0,590,1,0.14363441020838500000
chr9,6635112,6706559,71447,-1,0,2731,1,1.39963889316556000000
chr16,6784321,6889361,105040,-1,0,54715,1,0.95201827875095200000
chrX,120483907,120655432,171525,-1,0,,0,0.00000000000000000000
chr1,242966184,243148763,182579,-1,0,,0,0.00000000000000000000
chr3,191259260,191539285,280025,-1,0,,0,0.00000000000000000000
chr7,69943505,70115654,172149,-1,0,26053,1,0.58089213413961200000
chr3,270637,283756,13119,-1,0,10752,1,7.62253220519857000000
chr8,5853446,5935408,81962,-1,0,,0,0.00000000000000000000
chr3,285408,312115,26707,-1,0,10752,1,3.74433669075523000000
chr3,7215669,7332446,116777,-1,0,2917,1,0.85633301078123300000
chr13,68620630,68921300,300670,-1,0,,0,0.00000000000000000000
chr3,175105886,175719996,614110,-1,0,254827,1,0.16283727670938400000
chr13,81649832,81758192,108360,-1,0,,0,0.00000000000000000000
chrX,33917222,34008805,91583,-1,0,,0,0.00000000000000000000
chr10,61804291,61906778,102487,-1,0,288,1,0.97573350766438700000
chr11,134449880,134720418,270538,-1,0,,0,0.00000000000000000000
chr1,190705582,191034402,328820,-1,0,,0,0.00000000000000000000
chrX,33917222,34026301,109079,-1,0,,0,0.00000000000000000000
chr5,104583232,104680919,97687,-1,0,,0,0.00000000000000000000
chr2,76525544,76672691,147147,-1,0,,0,0.00000000000000000000
chr2,83380184,83915440,535256,-1,0,,0,0.00000000000000000000
chr5,100996579,101264434,267855,-1,0,,0,0.00000000000000000000
chr14,42885053,43092431,207378,-1,0,,0,0.00000000000000000000
chr16,6858772,7062073,203301,-1,0,54715,1,0.49188149591000500000
chr2,116774561,116925718,151157,-1,0,,0,0.00000000000000000000
chrY,59051190,59329155,277965,-1,0,10251;6845,2,0.71951504685841700000
chr18,56942198,56945597,3399,-1,0,,0,0.00000000000000000000
chr2,139858120,139965764,107644,-1,0,,0,0.00000000000000000000
chr13,20867199,21099089,231890,-1,0,51084,1,0.43123894950191900000
chr7,146008197,146088577,80380,-1,0,26047,1,1.24409056979348000000
chr4,124976381,125106907,130526,-1,0,,0,0.00000000000000000000
chr2,51312796,51446893,134097,-1,0,,0,0.00000000000000000000
chr16,46500511,46553796,53285,-1,0,,0,0.00000000000000000000
chr6,101022044,101143425,121381,-1,0,10973,1,0.82385216796698000000
chr12,21011584,21403480,391896,-1,0,338821;28234;10599,3,0.76550921673096900000
chr8,3958667,4018316,59649,-1,0,64478,1,1.67647403979949000000
chrX,65737969,66016757,278788,-1,0,60401,1,0.35869549621934900000
chr2,78697373,78787969,90596,-1,0,,0,0.00000000000000000000
chrX,144342110,144451995,109885,-1,0,,0,0.00000000000000000000
chr7,152620338,152947460,327122,-1,0,,0,0.00000000000000000000
chr17,80827139,80908435,81296,-1,0,146712;6904,2,2.46014564062193000000
chr20,3879345,3884942,5597,-1,0,80025,1,17.86671431123820000000
chr2,241804689,241812236,7547,-1,0,189,1,13.25029813170800000000
chr8,111765419,112016388,250969,-1,0,,0,0.00000000000000000000
chr2,35524271,35620532,96261,-1,0,,0,0.00000000000000000000
chr21,44934425,45037459,103034,-1,0,11077,1,0.97055340955412800000
chr9,2265287,2359814,94527,-1,0,,0,0.00000000000000000000
chr8,6112045,6313678,201633,-1,0,79648,1,0.49595056364781600000
chr1,189331211,189512900,181689,-1,0,,0,0.00000000000000000000
chrX,125354276,125583482,229206,-1,0,,0,0.00000000000000000000
chr12,78779555,79199297,419742,-1,0,,0,0.00000000000000000000
chr8,50164098,50491058,326960,-1,0,,0,0.00000000000000000000
chr2,78697373,78787969,90596,-1,0,,0,0.00000000000000000000
chr1,208521272,209489818,968546,-1,0,,0,0.00000000000000000000
chr20,58988237,59246389,258152,-1,0,,0,0.00000000000000000000
chrX,1710156,1726212,16056,-1,0,8227;438,2,12.45640259093170000000
chr4,135778650,136060752,282102,-1,0,,0,0.00000000000000000000
chr12,31281831,31393706,111875,-1,0,,0,0.00000000000000000000
chr5,104247563,104680919,433356,-1,0,,0,0.00000000000000000000
chrX,1754280,1765140,10860,-1,0,438,1,9.20810313075506000000
chr14,27129267,27377616,248349,-1,0,,0,0.00000000000000000000
chr10,2246027,2544945,298918,-1,0,,0,0.00000000000000000000
chr4,71162796,71251505,88709,-1,0,85438;26952;10879,3,3.38184400680878000000
chr13,84151397,84348713,197316,-1,0,,0,0.00000000000000000000
chr11,56112807,56211112,98305,-1,0,219479;219417;219477;390157,4,4.06896902497330000000
chr13,63998155,64160007,161852,-1,0,,0,0.00000000000000000000
chr9,30208371,30379350,170979,-1,0,,0,0.00000000000000000000
chr2,50992226,51021493,29267,-1,0,9378,1,3.41681757610961000000
chr10,68242417,68381086,138669,-1,0,29119,1,0.72114171155773800000
chr2,34955587,35099153,143566,-1,0,,0,0.00000000000000000000
chr2,52952581,53037456,84875,-1,0,,0,0.00000000000000000000
chr8,19024160,19449144,424984,-1,0,63898;55790,2,0.47060595222408400000
chr1,46208142,46472480,264338,-1,0,23139;3652,2,0.75660707124968800000
chr13,55154006,55462933,308927,-1,0,,0,0.00000000000000000000
chr2,35958486,36180245,221759,-1,0,,0,0.00000000000000000000
chr3,4181339,4273264,91925,-1,0,,0,0.00000000000000000000
chr13,93455528,93473555,18027,-1,0,2262,1,5.54723470350030000000
chr6,2005479,2071509,66030,-1,0,2762,1,1.51446312282296000000
chr2,141255280,141402754,147474,-1,0,53353,1,0.67808562865318600000
chrX,36621072,36902232,281160,-1,0,,0,0.00000000000000000000
chr13,85927273,86029553,102280,-1,0,,0,0.00000000000000000000
chr18,72660465,72692202,31737,-1,0,55628,1,3.15089643003434000000
chr8,50349468,50774515,425047,-1,0,,0,0.00000000000000000000
chr3,8080376,8296624,216248,-1,0,,0,0.00000000000000000000
chr2,186747236,186892306,145070,-1,0,,0,0.00000000000000000000
chrX,382626,396223,13597,-1,0,,0,0.00000000000000000000
chrY,332626,346223,13597,-1,0,,0,0.00000000000000000000
chrX,2372585,2394058,21473,-1,0,207063,1,4.65701113025660000000
chr14,27838974,28065369,226395,-1,0,,0,0.00000000000000000000
chr8,738801,1369613,630812,-1,0,9228,1,0.15852583654083900000
chr14,48786761,48906345,119584,-1,0,,0,0.00000000000000000000
chr5,103836159,104051058,214899,-1,0,,0,0.00000000000000000000
chr4,92675421,92787401,111980,-1,0,,0,0.00000000000000000000
chr19,28294781,28318379,23598,-1,0,,0,0.00000000000000000000
chr4,34240386,34678685,438299,-1,0,,0,0.00000000000000000000
chr4,18888625,19053253,164628,-1,0,,0,0.00000000000000000000
chr2,127514576,127733432,218856,-1,0,101929926,1,0.45692144606499200000
chr2,122820672,122908462,87790,-1,0,,0,0.00000000000000000000
chr12,21164055,21403480,239425,-1,0,10599;338821,2,0.83533465594653900000
chrX,47330209,47334862,4653,-1,0,7592,1,21.49151085321300000000
chr11,89602535,89708311,105776,-1,0,642446;399939;120146;729384,4,3.78157616094388000000
chr6,103486372,103663043,176671,-1,0,,0,0.00000000000000000000
chr8,5669352,5905074,235722,-1,0,,0,0.00000000000000000000
chr3,1771140,1922648,151508,-1,0,,0,0.00000000000000000000
chr6,103601949,103735899,133950,-1,0,,0,0.00000000000000000000
chr1,49772229,49929572,157343,-1,0,84871,1,0.63555417145980400000
chr5,90224,113852,23628,-1,0,,0,0.00000000000000000000
chr2,1151167,1589921,438754,-1,0,7173;54221,2,0.45583630006792000000
chrX,33917222,34026301,109079,-1,0,,0,0.00000000000000000000
chr3,22769259,22842392,73133,-1,0,,0,0.00000000000000000000
chr19,28292428,28318379,25951,-1,0,,0,0.00000000000000000000
chr4,190028032,190791091,763059,-1,0,,0,0.00000000000000000000
chr4,127470707,127723033,252326,-1,0,,0,0.00000000000000000000
chr1,121149862,121164799,14937,-1,0,,0,0.00000000000000000000
chr3,6164734,6274546,109812,-1,0,,0,0.00000000000000000000
chr5,99607172,99811883,204711,-1,0,,0,0.00000000000000000000
chrX,91201773,91247720,45947,-1,0,27328,1,2.17642065858489000000
chrX,56268736,56269242,506,-1,0,11279,1,197.62845849802400000000
chr14,67192024,67235083,43059,-1,0,10243,1,2.32239485357300000000
chr1,38275538,38452010,176472,-1,0,3633;4520;10946,3,1.69998640010880000000
chr7,143425314,143505904,80590,-1,0,285966;340307,2,2.48169748107706000000
chr13,19450809,19800774,349965,-1,0,7278,1,0.28574286000028600000
chrX,782028,794392,12364,-1,0,,0,0.00000000000000000000
chrX,31531775,31547623,15848,-1,0,1756,1,6.30994447248864000000
chr7,111351846,111465431,113585,-1,0,9732,1,0.88039793986882100000
chr2,126840772,127034841,194069,-1,0,,0,0.00000000000000000000
chrX,31531775,31547623,15848,-1,0,1756,1,6.30994447248864000000
chrY,9184291,9354439,170148,-1,0,728403;728137;7258,3,1.76317088652232000000
chr12,113525014,113724072,199058,-1,0,8437;84934;115811;1840;387885;53373;79039,7,3.51656301178551000000
chr17,6776515,6862369,85854,-1,0,,0,0.00000000000000000000
chr16,7036002,7139903,103901,-1,0,54715,1,0.96245464432488600000
chrX,60701,182196,121495,-1,0,,0,0.00000000000000000000
chr5,17602354,17674866,72512,-1,0,,0,0.00000000000000000000
chr10,81465465,81603655,138190,-1,0,729262,1,0.72364136334032900000
chr8,76990438,77202750,212312,-1,0,,0,0.00000000000000000000
chr9,26023506,26126404,102898,-1,0,,0,0.00000000000000000000
chr8,8702526,8705204,2678,-1,0,9258,1,37.34129947722180000000
chr3,189364075,189393792,29717,-1,0,8626,1,3.36507722852239000000
chr2,44549973,44604671,54698,-1,0,79823;9581,2,3.65644082050532000000
chr2,81453176,81756212,303036,-1,0,,0,0.00000000000000000000
chr3,82285440,82436069,150629,-1,0,,0,0.00000000000000000000
chr11,81630902,81732815,101913,-1,0,,0,0.00000000000000000000
chr1,30277745,30374893,97148,-1,0,,0,0.00000000000000000000
chr7,53911128,54081475,170347,-1,0,,0,0.00000000000000000000
chr7,117918583,118024960,106377,-1,0,,0,0.00000000000000000000
chr2,16082134,16083204,1070,-1,0,10408;4613,2,186.91588785046700000000
chr12,29908605,30083690,175085,-1,0,83857,1,0.57115115515321100000
chr4,134387947,134486893,98946,-1,0,,0,0.00000000000000000000
chr9,102275323,102350657,75334,-1,0,,0,0.00000000000000000000
chr2,220862954,221073135,210181,-1,0,,0,0.00000000000000000000
chr4,75024967,75116988,92021,-1,0,441024,1,1.08670846871910000000
chr4,178020754,178105170,84416,-1,0,,0,0.00000000000000000000
chr7,84204503,84299116,94613,-1,0,,0,0.00000000000000000000
chr14,62881085,62932209,51124,-1,0,,0,0.00000000000000000000
chr1,144005360,144058352,52992,-1,0,,0,0.00000000000000000000
chrX,33917222,34026301,109079,-1,0,,0,0.00000000000000000000
chr5,104247563,104332313,84750,-1,0,,0,0.00000000000000000000
chrX,655248,794392,139144,-1,0,,0,0.00000000000000000000
chrY,605248,744392,139144,-1,0,,0,0.00000000000000000000
chr4,190479546,190653134,173588,-1,0,,0,0.00000000000000000000
chr3,169307864,169382600,74736,-1,0,2122,1,1.33804324555770000000
chr2,16082232,16083204,972,-1,0,10408;4613,2,205.76131687242800000000
chr6,92014250,92103380,89130,-1,0,,0,0.00000000000000000000
chr2,51973026,52074070,101044,-1,0,,0,0.00000000000000000000
chrY,759132,769259,10127,-1,0,,0,0.00000000000000000000
chrX,782028,794392,12364,-1,0,,0,0.00000000000000000000
chrY,732030,744392,12362,-1,0,,0,0.00000000000000000000
chrX,809125,819108,9983,-1,0,,0,0.00000000000000000000
chr19,55384085,55493006,108921,-1,0,2204;199713;9437;55655,4,3.67238640849790000000
chr6,4269714,4437920,168206,-1,0,,0,0.00000000000000000000
chr4,102046941,102124290,77349,-1,0,5530,1,1.29284153641288000000
chr8,16470617,16570635,100018,-1,0,,0,0.00000000000000000000
chr11,4815122,4901807,86685,-1,0,119694;119695;119692,3,3.46080636788372000000
chr2,194402229,194501525,99296,-1,0,,0,0.00000000000000000000
chr3,1740781,1922648,181867,-1,0,,0,0.00000000000000000000
chr16,76735357,76840089,104732,-1,0,,0,0.00000000000000000000
chrX,1407459,1726212,318753,-1,0,8227;3563;293;1438;286530;8623;438,7,2.19605776259361000000
chrX,2700078,2799426,99348,-1,0,7499;8908,2,2.01312557877360000000
chr1,182790120,182981637,191517,-1,0,81626;80896;1660,3,1.56644057707671000000
chr4,75024967,75116988,92021,-1,0,441024,1,1.08670846871910000000
chr9,105014163,105165894,151731,-1,0,,0,0.00000000000000000000
chr8,6175454,6290790,115336,-1,0,79648,1,0.86703197613928000000
chr4,11692012,11792251,100239,-1,0,,0,0.00000000000000000000
chr16,18253315,18780881,527566,-1,0,283820;101059953,2,0.37909948707839400000
chr8,9941521,9982102,40581,-1,0,4482,1,2.46420738769375000000
chr1,102658576,102849833,191257,-1,0,,0,0.00000000000000000000
chr7,8946075,9041105,95030,-1,0,,0,0.00000000000000000000
chr1,88734338,88822203,87865,-1,0,,0,0.00000000000000000000
chr1,247829835,248550699,720864,-1,0,81466;127059;127062;391194;391192;127074;127066;391196;343172;391190;441933;25893;391195;26245;343171;284532;26188;127064;26246;391189;284521;391191;343169,23,3.19061570559773000000
chr1,196779887,196877502,97615,-1,0,10877;3078,2,2.04886544076218000000
chr11,71150762,71158544,7782,-1,0,1717,1,12.85016705217170000000
chr1,73495423,73579157,83734,-1,0,,0,0.00000000000000000000
chr5,117785331,117968177,182846,-1,0,,0,0.00000000000000000000
chr5,176573512,176598013,24501,-1,0,64324,1,4.08146606260969000000
chr12,5246984,5386430,139446,-1,0,,0,0.00000000000000000000
chr2,193664509,193789874,125365,-1,0,,0,0.00000000000000000000
chr3,165707464,165806307,98843,-1,0,,0,0.00000000000000000000
chrX,782028,794392,12364,-1,0,,0,0.00000000000000000000
chrY,732030,744392,12362,-1,0,,0,0.00000000000000000000
chr8,3999274,4076567,77293,-1,0,64478,1,1.29377822053744000000
chr16,3704629,3716083,11454,-1,0,1773;10131,2,17.46114894360050000000
chr9,10686685,11278542,591857,-1,0,,0,0.00000000000000000000
chr3,165707464,165806307,98843,-1,0,,0,0.00000000000000000000
chr3,885854,993931,108077,-1,0,,0,0.00000000000000000000
chr5,118905072,119081165,176093,-1,0,340069,1,0.56788174430556600000
chr18,70824286,70941272,116986,-1,0,,0,0.00000000000000000000
chr1,189331211,189512900,181689,-1,0,,0,0.00000000000000000000
chr3,61783512,61870914,87402,-1,0,5793,1,1.14413857806458000000
chr13,71617058,71867564,250506,-1,0,,0,0.00000000000000000000
chr6,4269714,4437920,168206,-1,0,,0,0.00000000000000000000
chr1,151410262,151422498,12236,-1,0,23126,1,8.17260542661000000000
chr5,97442253,97546487,104234,-1,0,,0,0.00000000000000000000
chr4,8258559,8403088,144529,-1,0,94031;8310,2,1.38380532626670000000
chr17,6776515,6862369,85854,-1,0,,0,0.00000000000000000000
chr10,5204184,5302462,98278,-1,0,1109,1,1.01752172408881000000
chr1,196743096,196824400,81304,-1,0,3078;10878,2,2.45990357177999000000
chr1,196743096,196877502,134406,-1,0,10877;3078;10878,3,2.23204321235659000000
chr9,6610913,6667926,57013,-1,0,2731,1,1.75398593303282000000
chr20,121604,184104,62500,-1,0,140850;81623;245939,3,4.80000000000000000000
chr11,90570698,90730509,159811,-1,0,,0,0.00000000000000000000
chr7,142329274,142468630,139356,-1,0,100463482;5644,2,1.43517322540831000000
chrY,237668,274744,37076,-1,0,28227,1,2.69716258496062000000
chrX,219634,324744,105110,-1,0,55344;28227;8225,3,2.85415279231282000000
chr15,30419801,30943969,524168,-1,0,728498;89832;101059918;89839,4,0.76311411608491900000
chr15,32635898,32914190,278292,-1,0,653125;728047;9824;643699,4,1.43733919767726000000
chr7,118866634,119031806,165172,-1,0,,0,0.00000000000000000000
chr16,18253315,18780881,527566,-1,0,283820;101059953,2,0.37909948707839400000
chr9,33608851,33634647,25796,-1,0,,0,0.00000000000000000000
chr16,6889302,7053888,164586,-1,0,54715,1,0.60758509229217500000
chr3,75704935,75793433,88498,-1,0,100131827;100288801,2,2.25993807769667000000
chr2,34804005,34908689,104684,-1,0,,0,0.00000000000000000000
chrX,89368555,89530394,161839,-1,0,,0,0.00000000000000000000
chrX,162434,182196,19762,-1,0,,0,0.00000000000000000000
chr8,50429947,50559017,129070,-1,0,,0,0.00000000000000000000
chrX,46391082,46396390,5308,-1,0,641339,1,18.83948756593820000000
chr10,84137793,84181073,43280,-1,0,10718,1,2.31053604436229000000
chr12,7951317,8118098,166781,-1,0,144195;6515,2,1.19917736432807000000
chr10,19436504,19821969,385465,-1,0,340895,1,0.25942692592064100000
chr1,102579167,102743245,164078,-1,0,,0,0.00000000000000000000
chr5,176569493,176590112,20619,-1,0,64324,1,4.84989572724186000000
chr15,32539611,32861612,322001,-1,0,653125;728047,2,0.62111608349042400000
chr15,30389992,30888835,498843,-1,0,89832;101059918,2,0.40092774680610900000
chr2,202086789,202091919,5130,-1,0,843,1,19.49317738791420000000
chr1,12910476,13038697,128221,-1,0,400735;65122;441871;440561;391003;343071,6,4.67942068771886000000
chr4,143084,185308,42224,-1,0,255403,1,2.36832133383858000000
chr11,96908203,97224190,315987,-1,0,,0,0.00000000000000000000
chr9,26301033,26414323,113290,-1,0,,0,0.00000000000000000000
chr5,97442253,97546487,104234,-1,0,,0,0.00000000000000000000
chr5,20656601,20959045,302444,-1,0,,0,0.00000000000000000000
chr5,28825646,28926146,100500,-1,0,,0,0.00000000000000000000
chr3,104077791,104265097,187306,-1,0,,0,0.00000000000000000000
chr16,50557061,50610337,53276,-1,0,85407,1,1.87701779412869000000
chr2,78341062,78490557,149495,-1,0,,0,0.00000000000000000000
chr15,96873119,96874735,1616,-1,0,7026,1,61.88118811881190000000
chr22,51168854,51170255,1401,-1,0,85358,1,71.37758743754460000000
chrX,52480409,52693961,213552,-1,0,653067;280658,2,0.93654004645238600000
chr15,53861312,53989306,127994,-1,0,256764,1,0.78128662281044400000
chrY,1886244,1888320,2076,-1,0,,0,0.00000000000000000000
chrX,1936244,1938320,2076,-1,0,,0,0.00000000000000000000
chr6,4269714,4437920,168206,-1,0,,0,0.00000000000000000000
chrX,7329199,7492698,163499,-1,0,,0,0.00000000000000000000
chr12,21164055,21403480,239425,-1,0,10599;338821,2,0.83533465594653900000
chr8,265051,360426,95375,-1,0,26260,1,1.04849279161206000000
chr3,2492142,2504470,12328,-1,0,152330,1,8.11161583387411000000
chr13,94798735,94849206,50471,-1,0,10082,1,1.98133581660756000000
chr3,26046380,26153920,107540,-1,0,,0,0.00000000000000000000
chrX,371328,374900,3572,-1,0,,0,0.00000000000000000000
chr19,20592432,20725676,133244,-1,0,100129842,1,0.75050283690072400000
chr18,37110075,37308510,198435,-1,0,,0,0.00000000000000000000
chrX,89463330,89494332,31002,-1,0,,0,0.00000000000000000000
chr10,56943166,57196388,253222,-1,0,,0,0.00000000000000000000
chr19,20592432,20725676,133244,-1,0,100129842,1,0.75050283690072400000
chr22,51168854,51170255,1401,-1,0,85358,1,71.37758743754460000000
chr6,144328656,144329895,1239,-1,0,5325,1,80.71025020177560000000
chr1,215049041,215120930,71889,-1,0,,0,0.00000000000000000000
chr5,17602354,17674866,72512,-1,0,,0,0.00000000000000000000
chr8,11700767,11711998,11231,-1,0,1508,1,8.90392663164456000000
chr19,27969140,28518804,549664,-1,0,,0,0.00000000000000000000
chr2,158002381,158144346,141965,-1,0,11227,1,0.70439897157750100000
chr14,41874044,41992372,118328,-1,0,,0,0.00000000000000000000
chr21,38251569,38381712,130143,-1,0,3141;53820,2,1.53677109026225000000
chr4,63539104,64007755,468651,-1,0,,0,0.00000000000000000000
chr6,68237501,68417019,179518,-1,0,,0,0.00000000000000000000
chr8,43527889,43529734,1845,-1,0,,0,0.00000000000000000000
chr9,30622930,30697915,74985,-1,0,,0,0.00000000000000000000
chr15,23085242,23087420,2178,-1,0,123606,1,45.91368227731860000000
chr2,16082232,16083204,972,-1,0,10408;4613,2,205.76131687242800000000
chr21,24526609,24606655,80046,-1,0,,0,0.00000000000000000000
chr13,64285807,64348178,62371,-1,0,,0,0.00000000000000000000
chrX,1936244,1938320,2076,-1,0,,0,0.00000000000000000000
chr2,52420769,52572939,152170,-1,0,,0,0.00000000000000000000
chrX,7329199,7492698,163499,-1,0,,0,0.00000000000000000000
chr5,62429292,62530908,101616,-1,0,,0,0.00000000000000000000
chr2,139858120,139965764,107644,-1,0,,0,0.00000000000000000000
chr4,131666992,131836346,169354,-1,0,,0,0.00000000000000000000
chr21,14420616,15217786,797170,-1,0,317754,1,0.12544375729141800000
chr1,248250872,248429279,178407,-1,0,127062;127059;284521;391194;26245,5,2.80258061623143000000
chr13,57764575,57939624,175049,-1,0,,0,0.00000000000000000000
chr16,18546682,18780881,234199,-1,0,283820,1,0.42698730566740300000
chr19,28294781,28318379,23598,-1,0,,0,0.00000000000000000000
chr4,189753346,190896768,1143422,-1,0,2483,1,0.08745677448920870000
chr15,102096960,102179042,82082,-1,0,80213,1,1.21829390122073000000
chr19,28294781,28318379,23598,-1,0,,0,0.00000000000000000000
chr7,53472052,53583154,111102,-1,0,,0,0.00000000000000000000
chr14,48786761,48906345,119584,-1,0,,0,0.00000000000000000000
chr3,26046380,26153920,107540,-1,0,,0,0.00000000000000000000
chr7,61300305,61302764,2459,-1,0,,0,0.00000000000000000000
chr16,75980360,76168150,187790,-1,0,,0,0.00000000000000000000
chr4,98332099,98548304,216205,-1,0,285555,1,0.46252399343215900000
chr2,16082134,16083204,1070,-1,0,10408;4613,2,186.91588785046700000000
chr15,102156548,102215911,59363,-1,0,80213;123283,2,3.36910196587100000000
chr1,210625275,210673397,48122,-1,0,55733,1,2.07805161880221000000
chr8,3893966,4018316,124350,-1,0,64478,1,0.80418174507438700000
chr16,78843872,78974960,131088,-1,0,51741,1,0.76284633223483500000
chr6,162654003,162939109,285106,-1,0,5071,1,0.35074673980905300000
chr1,196743096,196877502,134406,-1,0,10877;3078;10878,3,2.23204321235659000000
chr7,5186656,5276568,89912,-1,0,26100,1,1.11219859418098000000
chr5,106039108,106137896,98788,-1,0,,0,0.00000000000000000000
chr3,86555418,86723787,168369,-1,0,,0,0.00000000000000000000
chr10,20825574,21066042,240468,-1,0,,0,0.00000000000000000000
chr2,44505731,44575625,69894,-1,0,9581;6519,2,2.86147594929465000000
chr7,30508916,30625286,116370,-1,0,10392;79017,2,1.71865601099940000000
chr1,188574454,188669568,95114,-1,0,,0,0.00000000000000000000
chr20,15098519,15185229,86710,-1,0,140733,1,1.15326951908661000000
chr14,45845549,45979614,134065,-1,0,,0,0.00000000000000000000
chr4,143084,185308,42224,-1,0,255403,1,2.36832133383858000000
chr16,62617503,62721696,104193,-1,0,,0,0.00000000000000000000
chr16,29678526,29683762,5236,-1,0,6693,1,19.09854851031320000000
chr21,23927095,24028241,101146,-1,0,,0,0.00000000000000000000
chr18,61194916,61347708,152792,-1,0,5275;89777;6318;6317,4,2.61793811194303000000
chr5,119908733,120143114,234381,-1,0,51334,1,0.42665574427961300000
chr21,24140072,24200907,60835,-1,0,,0,0.00000000000000000000
chr1,115573205,115575335,2130,-1,0,7252,1,46.94835680751170000000
chr14,47081416,47182100,100684,-1,0,140801,1,0.99320646776051800000
chr22,19747566,19749385,1819,-1,0,6899,1,54.97526113249040000000
chr21,31952724,32054574,101850,-1,0,337985;337979;337975;100288287;337976;337966;337967;337968,8,7.85468826705940000000
chr20,748906,926472,177566,-1,0,51378;83541;113278,3,1.68951263192278000000
chrX,116020081,116121427,101346,-1,0,,0,0.00000000000000000000
chr3,2689619,2705402,15783,-1,0,152330,1,6.33593106507001000000
chr1,213378427,213717361,338934,-1,0,26750,1,0.29504269267763000000
chr9,29910845,29984315,73470,-1,0,,0,0.00000000000000000000
chr8,186785,438570,251785,-1,0,26260;169270,2,0.79432849454892100000
chr22,33970915,34014565,43650,-1,0,9215,1,2.29095074455899000000
chr1,145632658,145814295,181637,-1,0,653519;11126;27246;5174,4,2.20219448680610000000
chrX,91201773,91247720,45947,-1,0,27328,1,2.17642065858489000000
chr2,161561776,161860800,299024,-1,0,,0,0.00000000000000000000
chr13,67233859,67348682,114823,-1,0,5101,1,0.87090565479041700000
chr2,53294481,53489507,195026,-1,0,,0,0.00000000000000000000
chr2,53294481,53489507,195026,-1,0,,0,0.00000000000000000000
chr17,6776515,6862369,85854,-1,0,,0,0.00000000000000000000
chr8,62936236,63033744,97508,-1,0,,0,0.00000000000000000000
chr19,23621129,24054892,433763,-1,0,148213;171392,2,0.46108128171374700000
chr1,2458264,2462338,4074,-1,0,388585,1,24.54590083456060000000
chr11,2903601,2907123,3522,-1,0,1028,1,28.39295854628050000000
chr2,83613015,84015831,402816,-1,0,,0,0.00000000000000000000
chr4,168867405,168976858,109453,-1,0,,0,0.00000000000000000000
chrX,782028,822052,40024,-1,0,,0,0.00000000000000000000
chr4,168868936,168976858,107922,-1,0,,0,0.00000000000000000000
chr8,4631756,4757580,125824,-1,0,64478,1,0.79476093591047800000
chr17,6776515,6862369,85854,-1,0,,0,0.00000000000000000000
chr20,29970368,29986558,16190,-1,0,245932,1,6.17665225447807000000
chr14,43668961,44059062,390101,-1,0,,0,0.00000000000000000000
chr13,47452862,47475396,22534,-1,0,3356,1,4.43773852844590000000
chr21,24526609,24606655,80046,-1,0,,0,0.00000000000000000000
chr2,35817290,36088730,271440,-1,0,,0,0.00000000000000000000
chr15,45099078,45203633,104555,-1,0,,0,0.00000000000000000000
chr16,6178861,6266770,87909,-1,0,54715,1,1.13753995609096000000
chr2,186747236,186892306,145070,-1,0,,0,0.00000000000000000000
chr9,104690471,104907640,217169,-1,0,,0,0.00000000000000000000
chr2,185122593,185416379,293786,-1,0,,0,0.00000000000000000000
chr16,80179067,80471397,292330,-1,0,,0,0.00000000000000000000
chr2,127514576,127733432,218856,-1,0,101929926,1,0.45692144606499200000
chr7,42142524,42239868,97344,-1,0,2737,1,1.02728468113083000000
chr16,76735357,76840089,104732,-1,0,,0,0.00000000000000000000
chr8,137567691,137766215,198524,-1,0,,0,0.00000000000000000000
chr20,14502932,14630023,127091,-1,0,140733,1,0.78683777765538100000
chr10,57033094,57258021,224927,-1,0,,0,0.00000000000000000000
chr21,47937308,48040938,103630,-1,0,23181;6285,2,1.92994306667953000000
chr13,67254477,67356244,101767,-1,0,5101,1,0.98263680760953900000
chr6,117439367,117664387,225020,-1,0,6098;245806,2,0.88880988356590500000
chr4,143084,185308,42224,-1,0,255403,1,2.36832133383858000000
chrX,782028,794392,12364,-1,0,,0,0.00000000000000000000
chrY,732030,744392,12362,-1,0,,0,0.00000000000000000000
chrX,126557495,126699149,141654,-1,0,,0,0.00000000000000000000
chr13,92507952,92617929,109977,-1,0,2262,1,0.90928103148840200000
chr14,87158017,87254780,96763,-1,0,,0,0.00000000000000000000
chr2,52952581,53037456,84875,-1,0,,0,0.00000000000000000000
chr8,14437050,14572671,135621,-1,0,137868,1,0.73734893563681100000
chr13,20808567,21099089,290522,-1,0,51084,1,0.34420801178568200000
chr11,97758331,97872583,114252,-1,0,,0,0.00000000000000000000
chrX,154974465,155246643,272178,-1,0,6845;3581;10251,3,1.10221987081983000000
chrY,59036507,59337911,301404,-1,0,10251;6845;3581,3,0.99534180037424900000
chr6,95015988,95103542,87554,-1,0,,0,0.00000000000000000000
chr11,508114,547818,39704,-1,0,115399;3265,2,5.03727584122507000000
chr8,542299,590468,48169,-1,0,157697,1,2.07602399883743000000
chr22,34791377,34878531,87154,-1,0,,0,0.00000000000000000000
chr15,85899494,86572331,672837,-1,0,64410;11214,2,0.29724881360567300000
chr8,16430385,16512603,82218,-1,0,,0,0.00000000000000000000
chr16,13755523,13932295,176772,-1,0,,0,0.00000000000000000000
chr20,3879345,3884942,5597,-1,0,80025,1,17.86671431123820000000
chr13,66375502,66487689,112187,-1,0,,0,0.00000000000000000000
chr8,34963310,35474395,511085,-1,0,137970,1,0.19566216969780000000
chr3,83008400,83100150,91750,-1,0,,0,0.00000000000000000000
chr16,62979960,63147254,167294,-1,0,,0,0.00000000000000000000
chrX,782028,794392,12364,-1,0,,0,0.00000000000000000000
chr13,55373026,55462933,89907,-1,0,,0,0.00000000000000000000
chr5,12428102,12699741,271639,-1,0,,0,0.00000000000000000000
chr9,32690580,32707932,17352,-1,0,,0,0.00000000000000000000
chr17,50741245,50847412,106167,-1,0,,0,0.00000000000000000000
chr9,137095603,137105078,9475,-1,0,,0,0.00000000000000000000
chr19,28294781,28318379,23598,-1,0,,0,0.00000000000000000000
chr8,542299,590468,48169,-1,0,157697,1,2.07602399883743000000
chr16,46500511,46629934,129423,-1,0,79801,1,0.77266019177426000000
chrX,90230634,90281847,51213,-1,0,,0,0.00000000000000000000
chr9,26301033,26414323,113290,-1,0,,0,0.00000000000000000000
chr15,87274642,87378782,104140,-1,0,123624,1,0.96024582293067000000
chr3,192192274,192284766,92492,-1,0,2257,1,1.08117458807248000000
chr19,45858168,45896151,37983,-1,0,10848;2068,2,5.26551351920596000000
chr7,20143667,20210379,66712,-1,0,346389,1,1.49898069312867000000
chr5,104583232,104680919,97687,-1,0,,0,0.00000000000000000000
chrX,782028,794392,12364,-1,0,,0,0.00000000000000000000
chrY,732030,744392,12362,-1,0,,0,0.00000000000000000000
chr16,7041435,7062073,20638,-1,0,54715,1,4.84543075879446000000
chr7,146254675,146376928,122253,-1,0,26047,1,0.81797583699377500000
chr15,99398696,99467653,68957,-1,0,3480,1,1.45017909711849000000
chr4,73020654,73107456,86802,-1,0,,0,0.00000000000000000000
chr14,38966392,39074569,108177,-1,0,,0,0.00000000000000000000
chr8,5820740,5912426,91686,-1,0,,0,0.00000000000000000000
chr5,140184692,140200587,15895,-1,0,56147;56144;56145;56146,4,25.16514627241270000000
chr3,28967485,29117293,149808,-1,0,,0,0.00000000000000000000
chr4,168868936,168976858,107922,-1,0,,0,0.00000000000000000000
chr9,11318956,11659349,340393,-1,0,,0,0.00000000000000000000
chr2,55504105,55597394,93289,-1,0,55704,1,1.07193774185595000000
chrX,479089,484163,5074,-1,0,,0,0.00000000000000000000
chrY,429089,434147,5058,-1,0,,0,0.00000000000000000000
chr17,6776515,6862369,85854,-1,0,,0,0.00000000000000000000
chr8,118911474,118928788,17314,-1,0,2131,1,5.77567286588888000000
chr11,134691349,134716265,24916,-1,0,,0,0.00000000000000000000
chr14,27438600,27806980,368380,-1,0,,0,0.00000000000000000000
chr9,120708954,120866386,157432,-1,0,,0,0.00000000000000000000
chr18,34414636,34526135,111499,-1,0,57536,1,0.89686903021551800000
chr15,45099078,45203633,104555,-1,0,,0,0.00000000000000000000
chr14,40990358,41234681,244323,-1,0,,0,0.00000000000000000000
chr13,55373026,55462933,89907,-1,0,,0,0.00000000000000000000
chr2,52420769,52572939,152170,-1,0,,0,0.00000000000000000000
chrX,126557495,126699149,141654,-1,0,,0,0.00000000000000000000
chrX,89463330,89494332,31002,-1,0,,0,0.00000000000000000000
chr8,8103647,8353799,250152,-1,0,157285,1,0.39975694777575200000
chr7,20143667,20210379,66712,-1,0,346389,1,1.49898069312867000000
chr7,84204503,84299116,94613,-1,0,,0,0.00000000000000000000
chr18,46875891,46886242,10351,-1,0,54808,1,9.66090232827746000000
chr19,59042670,59095427,52757,-1,0,84878;9040;10155;27243;7593,5,9.47741531929412000000
chr6,93101173,93211211,110038,-1,0,,0,0.00000000000000000000
chr4,168868936,168976858,107922,-1,0,,0,0.00000000000000000000
chr2,76159680,76247784,88104,-1,0,,0,0.00000000000000000000
chr6,163000212,163084514,84302,-1,0,5071,1,1.18621147778226000000
chr14,27511523,27613745,102222,-1,0,,0,0.00000000000000000000
chr4,79926983,80147066,220083,-1,0,,0,0.00000000000000000000
chrX,91201773,91247720,45947,-1,0,27328,1,2.17642065858489000000
chr2,35052570,35167948,115378,-1,0,,0,0.00000000000000000000
chr11,4815122,4901807,86685,-1,0,119694;119695;119692,3,3.46080636788372000000
chr2,40247241,40469669,222428,-1,0,6546,1,0.44958368550722000000
chr18,72660465,72692202,31737,-1,0,55628,1,3.15089643003434000000
chr16,7132617,7164569,31952,-1,0,54715,1,3.12969454181272000000
chr11,40863579,41168119,304540,-1,0,57689,1,0.32836409010310600000
chr9,26301033,26414323,113290,-1,0,,0,0.00000000000000000000
chr17,6776515,6862369,85854,-1,0,,0,0.00000000000000000000
chr3,41690010,41810371,120361,-1,0,54986,1,0.83083390799345300000
chr3,41690010,41810371,120361,-1,0,54986,1,0.83083390799345300000
chr1,1274259,1361776,87517,-1,0,643965;54587;54998;1855;55052;81669;441869,7,7.99844601620257000000
chr14,43668961,43788953,119992,-1,0,,0,0.00000000000000000000
chr13,94798735,94849206,50471,-1,0,10082,1,1.98133581660756000000
chrX,70890723,71077517,186794,-1,0,101059915;100130361;100132994,3,1.60604730344658000000
chr13,67098815,67169848,71033,-1,0,5101,1,1.40779637633213000000
chr6,162736237,162939109,202872,-1,0,5071,1,0.49292164517528300000
chr6,62248884,62325349,76465,-1,0,100463487,1,1.30778787680638000000
chr13,55159710,55462933,303223,-1,0,,0,0.00000000000000000000
chr3,176862053,176983587,121534,-1,0,79718,1,0.82281501472838900000
chrX,70890723,71077517,186794,-1,0,101059915;100130361;100132994,3,1.60604730344658000000
chr11,98309391,98446528,137137,-1,0,,0,0.00000000000000000000
chr20,121604,184104,62500,-1,0,140850;81623;245939,3,4.80000000000000000000
chr4,97562818,98548304,985486,-1,0,285555,1,0.10147277586896200000
chrX,89463330,89494332,31002,-1,0,,0,0.00000000000000000000
chrX,7959981,8235812,275831,-1,0,51480,1,0.36254083116111000000
chr21,29198023,29329092,131069,-1,0,,0,0.00000000000000000000
chr15,23403580,23569459,165879,-1,0,,0,0.00000000000000000000
chr4,18735923,18895193,159270,-1,0,,0,0.00000000000000000000
chr9,30288006,30364532,76526,-1,0,,0,0.00000000000000000000
chr15,96873119,96873907,788,-1,0,7026,1,126.90355329949200000000
chr11,4815122,4901807,86685,-1,0,119694;119695;119692,3,3.46080636788372000000
chr2,202086789,202091919,5130,-1,0,843,1,19.49317738791420000000
chr8,16470617,16570635,100018,-1,0,,0,0.00000000000000000000
chr1,105300320,105601794,301474,-1,0,,0,0.00000000000000000000
chr1,169177190,169296202,119012,-1,0,29922,1,0.84025140321984300000
chr3,93585301,93591594,6293,-1,0,,0,0.00000000000000000000
chr2,52952581,53037456,84875,-1,0,,0,0.00000000000000000000
chr18,37110075,37308510,198435,-1,0,,0,0.00000000000000000000
chr1,190657503,191034402,376899,-1,0,,0,0.00000000000000000000
chr16,84233560,84333096,99536,-1,0,93107;58189,2,2.00932325992606000000
chr6,92014250,92103380,89130,-1,0,,0,0.00000000000000000000
chr3,6718956,6836992,118036,-1,0,,0,0.00000000000000000000
chr4,127525057,127660299,135242,-1,0,,0,0.00000000000000000000
chr13,56175955,56259742,83787,-1,0,,0,0.00000000000000000000
chr8,5602486,5739644,137158,-1,0,,0,0.00000000000000000000
chr3,195501431,195644579,143148,-1,0,10188;4585,2,1.39715539162266000000
chr18,68541379,68873779,332400,-1,0,,0,0.00000000000000000000
chr7,126648093,126834280,186187,-1,0,2918,1,0.53709442657113500000
chr1,231834554,231885282,50728,-1,0,27185,1,1.97129790253903000000
chr8,6021756,6175513,153757,-1,0,,0,0.00000000000000000000
chr2,132092632,132252367,159735,-1,0,150786;113457;653784,3,1.87811062071556000000
chr8,146222563,146238409,15846,-1,0,,0,0.00000000000000000000
chr2,202086789,202091919,5130,-1,0,843,1,19.49317738791420000000
chrX,47330209,47335088,4879,-1,0,7592,1,20.49600327936050000000
chr4,59727946,59816832,88886,-1,0,,0,0.00000000000000000000
chr4,127525057,127660299,135242,-1,0,,0,0.00000000000000000000
chrX,133747671,133823385,75714,-1,0,10761,1,1.32075970098000000000
chr7,53487378,53583154,95776,-1,0,,0,0.00000000000000000000
chr1,169177190,169296202,119012,-1,0,29922,1,0.84025140321984300000
chrX,782028,794392,12364,-1,0,,0,0.00000000000000000000
chr18,46875891,46886242,10351,-1,0,54808,1,9.66090232827746000000
chr14,46463663,46542707,79044,-1,0,,0,0.00000000000000000000
chr8,146222563,146238409,15846,-1,0,,0,0.00000000000000000000
chr8,6021756,6175513,153757,-1,0,,0,0.00000000000000000000
chr8,137567691,137766215,198524,-1,0,,0,0.00000000000000000000
chr18,41251066,41372178,121112,-1,0,,0,0.00000000000000000000
chr7,53487378,53583154,95776,-1,0,,0,0.00000000000000000000
chr7,53472052,53583154,111102,-1,0,,0,0.00000000000000000000
chr15,46286618,46571837,285219,-1,0,,0,0.00000000000000000000
chr19,55314502,55493006,178504,-1,0,2204;3811;3805;3812;9437;55655;3809;199713,8,4.48169228700757000000
chr3,159785321,159904050,118729,-1,0,,0,0.00000000000000000000
chr22,51168854,51170255,1401,-1,0,85358,1,71.37758743754460000000
chr4,168867405,168976858,109453,-1,0,,0,0.00000000000000000000
chr15,96873119,96874735,1616,-1,0,7026,1,61.88118811881190000000
chr22,19747566,19747938,372,-1,0,6899,1,268.81720430107500000000
chr13,60439172,60639916,200744,-1,0,81624,1,0.49814689355597200000
chrY,10701,59349649,59338948,-1,0,1617;6845;286530;378948;83259;7258;159163;8287;9426;86614;57055;8227;8284;207063;100289087;378950;5940;442867;100533178;10251;28227;7404;728395;57135;378951;9081;438;9084;378949;9086;203611;9085;353515;728403;4267;442868;293;9189;3581;140032;57054;90665;90655;3563;6192;8653;353513;64591;728137;22829;159119;7544;6736;8225;9082;8623;442862;9087;266;6473;1438;9083;64109;55344;253175,65,0.10954019609515200000
chr1,246009766,246560364,550598,-1,0,64754,1,0.18162071057286800000
chrX,22992416,23070279,77863,-1,0,168400,1,1.28430705213002000000
chr2,42162973,42310474,147501,-1,0,400950;91461,2,1.35592301069145000000
chr4,187979617,188414222,434605,-1,0,,0,0.00000000000000000000
chr16,7132617,7164569,31952,-1,0,54715,1,3.12969454181272000000
chr9,204090,229285,25195,-1,0,81704;157983,2,7.93808295296686000000
chr15,102156548,102215911,59363,-1,0,80213;123283,2,3.36910196587100000000
chr9,26301033,26406018,104985,-1,0,,0,0.00000000000000000000
chr13,67271602,67330823,59221,-1,0,5101,1,1.68859019604532000000
chr5,84113145,84299787,186642,-1,0,,0,0.00000000000000000000
chr15,60354266,60541896,187630,-1,0,,0,0.00000000000000000000
chr11,16554116,16643582,89466,-1,0,,0,0.00000000000000000000
chrX,29856318,29908496,52178,-1,0,11141,1,1.91651653953774000000
chr9,30647689,30747608,99919,-1,0,,0,0.00000000000000000000
chr5,150183004,150310301,127297,-1,0,345611;91975,2,1.57112893469603000000
chr11,106068064,106230083,162019,-1,0,,0,0.00000000000000000000
chr5,17602354,17821556,219202,-1,0,,0,0.00000000000000000000
chr6,56589369,56627465,38096,-1,0,667,1,2.62494750104998000000
chr7,14976430,15057240,80810,-1,0,,0,0.00000000000000000000
chr4,18735923,18895193,159270,-1,0,,0,0.00000000000000000000
chr2,44505731,44575625,69894,-1,0,9581;6519,2,2.86147594929465000000
chr6,48796685,48878140,81455,-1,0,,0,0.00000000000000000000
chr10,90301165,90407102,105937,-1,0,55328;142910,2,1.88791451523075000000
chr2,184520165,184911507,391342,-1,0,,0,0.00000000000000000000
chr5,83780980,83911168,130188,-1,0,,0,0.00000000000000000000
chr6,93371331,93609181,237850,-1,0,,0,0.00000000000000000000
chr7,53472052,53583154,111102,-1,0,,0,0.00000000000000000000
chrX,782028,794392,12364,-1,0,,0,0.00000000000000000000
chr2,210118099,210196075,77976,-1,0,,0,0.00000000000000000000
chrY,732030,744392,12362,-1,0,,0,0.00000000000000000000
chr7,61968456,62030760,62304,-1,0,,0,0.00000000000000000000
chr22,51168854,51170255,1401,-1,0,85358,1,71.37758743754460000000
chr22,19747566,19747938,372,-1,0,6899,1,268.81720430107500000000
chr10,67476611,67638051,161440,-1,0,,0,0.00000000000000000000
chr14,20465946,20471628,5682,-1,0,,0,0.00000000000000000000
chr6,4404102,4495002,90900,-1,0,,0,0.00000000000000000000
chrX,154974465,155246643,272178,-1,0,6845;3581;10251,3,1.10221987081983000000
chrY,59036507,59349649,313142,-1,0,10251;6845;3581,3,0.95803181943016300000
chr11,81718390,81942189,223799,-1,0,,0,0.00000000000000000000
chr16,6303187,6392807,89620,-1,0,54715,1,1.11582236108012000000
chr12,18362991,18464124,101133,-1,0,5288,1,0.98879693077432700000
chr3,3629909,3820952,191043,-1,0,,0,0.00000000000000000000
chrY,429089,434147,5058,-1,0,,0,0.00000000000000000000
chrX,479089,484163,5074,-1,0,,0,0.00000000000000000000
chr1,189100028,189244197,144169,-1,0,,0,0.00000000000000000000
chr7,70185835,70257770,71935,-1,0,26053,1,1.39014387989157000000
chr12,90747019,91340245,593226,-1,0,,0,0.00000000000000000000
chr6,162981819,163129645,147826,-1,0,5071,1,0.67647098615940400000
chr9,11318956,11429135,110179,-1,0,,0,0.00000000000000000000
chr11,100288780,100713152,424372,-1,0,143872,1,0.23564231381900800000
chr13,20808567,21099089,290522,-1,0,51084,1,0.34420801178568200000
chr8,16430385,16512603,82218,-1,0,,0,0.00000000000000000000
chr11,16453038,16486523,33485,-1,0,55553,1,2.98641182619083000000
chr13,81649832,81758192,108360,-1,0,,0,0.00000000000000000000
chr4,124976381,125106907,130526,-1,0,,0,0.00000000000000000000
chr9,11277720,11375512,97792,-1,0,,0,0.00000000000000000000
chr12,87308274,87484349,176075,-1,0,,0,0.00000000000000000000
chr2,44582018,44757211,175193,-1,0,79823;9581,2,1.14159812321269000000
chr8,34665743,35006053,340310,-1,0,,0,0.00000000000000000000
chr4,64452821,65088519,635698,-1,0,,0,0.00000000000000000000
chr1,174468247,174553410,85163,-1,0,9910,1,1.17421885090943000000
chrX,6091148,6138615,47467,-1,0,57502,1,2.10672677860408000000
chrX,6592473,7843259,1250786,-1,0,412;26609;8226,3,0.23984918283383400000
chr11,40453589,40652286,198697,-1,0,57689,1,0.50327886178452600000
chr11,25278543,25428709,150166,-1,0,,0,0.00000000000000000000
chr4,168867405,168976858,109453,-1,0,,0,0.00000000000000000000
chr18,76613366,76751562,138196,-1,0,27164,1,0.72360994529508800000
chr7,6291956,6390173,98217,-1,0,9265;84792,2,2.03630736023295000000
chr2,110521667,110649116,127449,-1,0,84220,1,0.78462757652080500000
chr11,25541784,25624738,82954,-1,0,,0,0.00000000000000000000
chr8,90992035,90994732,2697,-1,0,4683,1,37.07823507601040000000
chr8,5669352,5739644,70292,-1,0,,0,0.00000000000000000000
chr8,16430385,16512603,82218,-1,0,,0,0.00000000000000000000
chrX,91366261,91521343,155082,-1,0,27328,1,0.64482015965747200000
chr11,21859486,22027939,168453,-1,0,,0,0.00000000000000000000
chr14,40517281,40640890,123609,-1,0,,0,0.00000000000000000000
chr7,145572800,145654673,81873,-1,0,,0,0.00000000000000000000
chr11,81630902,81732815,101913,-1,0,,0,0.00000000000000000000
chr4,168867405,168976858,109453,-1,0,,0,0.00000000000000000000
chr2,1151167,1577713,426546,-1,0,7173;54221,2,0.46888260586197000000
chr20,29519925,29891894,371969,-1,0,245930;245929,2,0.53767921520341700000
chrX,33478088,33603625,125537,-1,0,,0,0.00000000000000000000
chr10,67476611,67638051,161440,-1,0,,0,0.00000000000000000000
chr17,6776515,6862369,85854,-1,0,,0,0.00000000000000000000
chr12,73241449,73357964,116515,-1,0,,0,0.00000000000000000000
chr5,150179222,150310301,131079,-1,0,345611;91975,2,1.52579741987656000000
chr2,52375958,52519432,143474,-1,0,,0,0.00000000000000000000
chr12,85942216,86030621,88405,-1,0,,0,0.00000000000000000000
chr1,196743096,196824400,81304,-1,0,3078;10878,2,2.45990357177999000000
chrX,152954241,152992166,37925,-1,0,215;6535;10134,3,7.91034937376401000000
chr17,20777330,22032735,1255405,-1,0,23326;25979;339184;339263;256302;5606;100462977;8834;3768,9,0.71690012386441000000
chr6,140826170,140897440,71270,-1,0,,0,0.00000000000000000000
chr14,48786761,48906345,119584,-1,0,,0,0.00000000000000000000
chr1,196779887,196877502,97615,-1,0,10877;3078,2,2.04886544076218000000
chr2,44505731,44575625,69894,-1,0,9581;6519,2,2.86147594929465000000
chr15,30930422,32539670,1609248,-1,0,51621;22909;161725;283710;54893;89839;4308;1139,8,0.49712660820457700000
chr13,76142077,76278418,136341,-1,0,7347;4008,2,1.46691017375551000000
chr18,27743891,27958321,214430,-1,0,,0,0.00000000000000000000
chr6,74312538,74322292,9754,-1,0,26503,1,10.25220422390810000000
chrX,89463330,89494332,31002,-1,0,,0,0.00000000000000000000
chr14,40436270,40591801,155531,-1,0,,0,0.00000000000000000000
chr1,106099165,106309967,210802,-1,0,,0,0.00000000000000000000
chr4,97053327,98357092,1303765,-1,0,,0,0.00000000000000000000
chr18,37110075,37308510,198435,-1,0,,0,0.00000000000000000000
chr15,46157952,46444998,287046,-1,0,,0,0.00000000000000000000
chrX,47330209,47335088,4879,-1,0,7592,1,20.49600327936050000000
chr19,28294781,28318379,23598,-1,0,,0,0.00000000000000000000
chr13,67288065,67341897,53832,-1,0,5101,1,1.85763114875910000000
chr14,104075191,104227246,152055,-1,0,79038;23368;7517;3831,4,2.63062707572918000000
chr14,48443616,48624687,181071,-1,0,,0,0.00000000000000000000
chr5,73982720,73992951,10231,-1,0,3074,1,9.77421561919656000000
chr1,189331211,189512900,181689,-1,0,,0,0.00000000000000000000
chr18,68974188,69210878,236690,-1,0,,0,0.00000000000000000000
chr8,112579802,112709410,129608,-1,0,,0,0.00000000000000000000
chr14,87158017,87254780,96763,-1,0,,0,0.00000000000000000000
chr6,121297072,121432489,135417,-1,0,221322,1,0.73845972071453400000
chr7,13111179,13218730,107551,-1,0,,0,0.00000000000000000000
chr6,92014250,92103380,89130,-1,0,,0,0.00000000000000000000
chr10,107249417,107379733,130316,-1,0,,0,0.00000000000000000000
chr1,145632658,145814295,181637,-1,0,653519;11126;27246;5174,4,2.20219448680610000000
chrX,89368555,89494332,125777,-1,0,,0,0.00000000000000000000
chr3,96891459,97321030,429571,-1,0,285220,1,0.23279038855043800000
chr4,135645739,136165987,520248,-1,0,,0,0.00000000000000000000
chr2,53512649,53614338,101689,-1,0,,0,0.00000000000000000000
chr9,71908395,72035625,127230,-1,0,9413,1,0.78597814980743500000
chr16,90012639,90074257,61618,-1,0,92806;79007;54849,3,4.86870719594924000000
chr17,52607545,52729868,122323,-1,0,,0,0.00000000000000000000
chr12,73353152,73441737,88585,-1,0,,0,0.00000000000000000000
chrX,166314,187647,21333,-1,0,,0,0.00000000000000000000
chr3,165707464,165806307,98843,-1,0,,0,0.00000000000000000000
chr6,140957217,141057264,100047,-1,0,,0,0.00000000000000000000
chr1,103739979,103916529,176550,-1,0,,0,0.00000000000000000000
chrX,755414,1370142,614728,-1,0,64109,1,0.16267357270207300000
chr3,195521763,195644579,122816,-1,0,10188;4585,2,1.62845231891610000000
chr2,136094199,136281426,187227,-1,0,84083,1,0.53411099894780100000
chr1,73495423,73579157,83734,-1,0,,0,0.00000000000000000000
chr16,6858772,6977874,119102,-1,0,54715,1,0.83961646319961000000
chr2,795291,1071839,276548,-1,0,54221,1,0.36160087941333900000
chr3,4181339,4273264,91925,-1,0,,0,0.00000000000000000000
chr18,155520,625162,469642,-1,0,1068;27098;9984;9097;81035,5,1.06464072634049000000
chrX,91002429,91425500,423071,-1,0,27328,1,0.23636694550087300000
chrX,90459969,90507886,47917,-1,0,,0,0.00000000000000000000
chrX,90740551,90966470,225919,-1,0,,0,0.00000000000000000000
chrY,4556537,6487615,1931078,-1,0,83259;64591,2,0.10356909456790500000
chrX,91545378,92355334,809956,-1,0,27328,1,0.12346349678254100000
chr17,6776515,6862369,85854,-1,0,,0,0.00000000000000000000
chr2,14334309,14603118,268809,-1,0,,0,0.00000000000000000000
chr1,79651539,79771035,119496,-1,0,,0,0.00000000000000000000
chr13,56066331,56187347,121016,-1,0,,0,0.00000000000000000000
chr4,135645739,136165987,520248,-1,0,,0,0.00000000000000000000
chr11,40697678,40816787,119109,-1,0,57689,1,0.83956711919334400000
chr22,17345958,17366019,20061,-1,0,,0,0.00000000000000000000
chr19,28385390,28399540,14150,-1,0,,0,0.00000000000000000000
chr8,16430385,16512603,82218,-1,0,,0,0.00000000000000000000
chr11,126026082,126161912,135830,-1,0,6734;84881;79607;55572;114609,5,3.68107192814548000000
chr5,97442253,97546487,104234,-1,0,,0,0.00000000000000000000
chr9,6610913,6667926,57013,-1,0,2731,1,1.75398593303282000000
chr19,28294781,28318379,23598,-1,0,,0,0.00000000000000000000
chr16,6218528,6453034,234506,-1,0,54715,1,0.42642832166341200000
chr4,143084,185308,42224,-1,0,255403,1,2.36832133383858000000
chr7,42131478,42150731,19253,-1,0,2737,1,5.19399574092349000000
chr1,237231905,237351300,119395,-1,0,6262,1,0.83755601155827300000
chr14,48786761,48906345,119584,-1,0,,0,0.00000000000000000000
chr4,127525057,127660299,135242,-1,0,,0,0.00000000000000000000
chr3,65727382,65874503,147121,-1,0,9223,1,0.67971261750531900000
chr7,117918583,118024960,106377,-1,0,,0,0.00000000000000000000
chr13,66375502,66487689,112187,-1,0,,0,0.00000000000000000000
chr10,7632262,7641664,9402,-1,0,80760,1,10.63603488619440000000
chr14,48786761,48906345,119584,-1,0,,0,0.00000000000000000000
chr7,75176883,75282176,105293,-1,0,3092,1,0.94973075133199700000
chr13,20808567,21099089,290522,-1,0,51084,1,0.34420801178568200000
chr9,877524,897039,19515,-1,0,1761,1,5.12426338713810000000
chr15,45099078,45203633,104555,-1,0,,0,0.00000000000000000000
chr2,35524271,35599310,75039,-1,0,,0,0.00000000000000000000
chr16,18599938,18719513,119575,-1,0,,0,0.00000000000000000000
chr11,21859486,22027939,168453,-1,0,,0,0.00000000000000000000
chr11,4815122,4901807,86685,-1,0,119694;119695;119692,3,3.46080636788372000000
chr10,57497068,57672159,175091,-1,0,,0,0.00000000000000000000
chr13,92400608,92522659,122051,-1,0,2262,1,0.81932962450123300000
chr5,103836159,104051058,214899,-1,0,,0,0.00000000000000000000
chr13,64285807,64348178,62371,-1,0,,0,0.00000000000000000000
chr4,178020754,178136996,116242,-1,0,,0,0.00000000000000000000
chr1,246229082,246453476,224394,-1,0,64754,1,0.44564471420804500000
chr7,95820801,95925037,104236,-1,0,10165,1,0.95936144901953300000
chr2,88936312,88975303,38991,-1,0,,0,0.00000000000000000000
chr1,225217624,225307001,89377,-1,0,127602,1,1.11885608154223000000
chr2,35524271,35620532,96261,-1,0,,0,0.00000000000000000000
chr8,111765419,112016388,250969,-1,0,,0,0.00000000000000000000
chr3,26046380,26153920,107540,-1,0,,0,0.00000000000000000000
chr2,81555240,81648288,93048,-1,0,,0,0.00000000000000000000
chr4,59911067,60009374,98307,-1,0,,0,0.00000000000000000000
chr5,17602354,17745107,142753,-1,0,,0,0.00000000000000000000
chr15,46157952,46406047,248095,-1,0,,0,0.00000000000000000000
chr20,14177842,14396223,218381,-1,0,140733;23767,2,0.91583058965752500000
chr15,53989247,54142099,152852,-1,0,256764,1,0.65422761887315800000
chr15,46286618,46571837,285219,-1,0,,0,0.00000000000000000000
chr17,41215216,41393770,178554,-1,0,672;4077;113277,3,1.68016398400484000000
chr2,75742,210454,134712,-1,0,,0,0.00000000000000000000
chr2,127514576,127733432,218856,-1,0,101929926,1,0.45692144606499200000
chr14,46490600,46751255,260655,-1,0,,0,0.00000000000000000000
chr21,29198023,29371511,173488,-1,0,,0,0.00000000000000000000
chr2,186747236,186892306,145070,-1,0,,0,0.00000000000000000000
chrX,782028,794392,12364,-1,0,,0,0.00000000000000000000
chr5,45802038,46115173,313135,-1,0,,0,0.00000000000000000000
chr12,5246984,5386430,139446,-1,0,,0,0.00000000000000000000
chr13,95763882,95944917,181035,-1,0,10257,1,0.55237937415416900000
chr9,29412979,29504360,91381,-1,0,,0,0.00000000000000000000
chr4,75024967,75116988,92021,-1,0,441024,1,1.08670846871910000000
chr1,49772229,49929572,157343,-1,0,84871,1,0.63555417145980400000
chr5,99654513,99811883,157370,-1,0,,0,0.00000000000000000000
chr12,21164055,21403480,239425,-1,0,10599;338821,2,0.83533465594653900000
chr1,121149862,121156409,6547,-1,0,,0,0.00000000000000000000
chr8,146222563,146238409,15846,-1,0,,0,0.00000000000000000000
chr1,147721680,147825519,103839,-1,0,,0,0.00000000000000000000
chr8,78725104,78943154,218050,-1,0,,0,0.00000000000000000000
chr13,20827162,21099089,271927,-1,0,51084,1,0.36774575529462000000
chr19,23372237,23413495,41258,-1,0,,0,0.00000000000000000000
chr19,23621129,24054892,433763,-1,0,148213;171392,2,0.46108128171374700000
chr14,48764424,48860331,95907,-1,0,,0,0.00000000000000000000
chr2,40452307,40518040,65733,-1,0,6546,1,1.52130588897510000000
chr2,186778525,186892306,113781,-1,0,,0,0.00000000000000000000
chr2,52952581,53037456,84875,-1,0,,0,0.00000000000000000000
chr5,21001306,21600959,599653,-1,0,,0,0.00000000000000000000
chr14,46409452,46464447,54995,-1,0,,0,0.00000000000000000000
chr2,127514576,127733432,218856,-1,0,101929926,1,0.45692144606499200000
chr5,120027276,120143114,115838,-1,0,,0,0.00000000000000000000
chr17,52607545,52729868,122323,-1,0,,0,0.00000000000000000000
chr9,81280456,81467931,187475,-1,0,,0,0.00000000000000000000
chr5,21001306,21600959,599653,-1,0,,0,0.00000000000000000000
chr14,20465946,20471628,5682,-1,0,,0,0.00000000000000000000
chrX,89145286,89199423,54137,-1,0,90316,1,1.84716552450265000000
chr16,10354749,10428535,73786,-1,0,,0,0.00000000000000000000
chr9,11318956,11659349,340393,-1,0,,0,0.00000000000000000000
chr5,27427652,27565118,137466,-1,0,,0,0.00000000000000000000
chr15,102156548,102215911,59363,-1,0,80213;123283,2,3.36910196587100000000
chr19,33212950,33305465,92515,-1,0,91646,1,1.08090579905961000000
chr14,27838974,27934717,95743,-1,0,,0,0.00000000000000000000
chrX,153867964,153874139,6175,-1,0,,0,0.00000000000000000000
chrX,153786801,153792952,6151,-1,0,8517,1,16.25751910258490000000
chr7,152620338,152947460,327122,-1,0,,0,0.00000000000000000000
chr2,222696924,222811763,114839,-1,0,,0,0.00000000000000000000
chrX,33917222,34026301,109079,-1,0,,0,0.00000000000000000000
chr16,80889406,80981685,92279,-1,0,,0,0.00000000000000000000
chr7,90303558,90538508,234950,-1,0,5218,1,0.42562247286656700000
chr17,18824091,18837120,13029,-1,0,5636,1,7.67518612326349000000
chr1,115573205,115575171,1966,-1,0,7252,1,50.86469989827060000000
chr15,95023188,95137134,113946,-1,0,55784,1,0.87760869183648400000
chr1,167411374,167533888,122514,-1,0,8804;919,2,1.63246649362522000000
chr15,45099078,45203633,104555,-1,0,,0,0.00000000000000000000
chr3,197294940,197305136,10196,-1,0,622,1,9.80776775205963000000
chr6,95090521,95440593,350072,-1,0,,0,0.00000000000000000000
chrX,782028,794392,12364,-1,0,,0,0.00000000000000000000
chrY,732030,744392,12362,-1,0,,0,0.00000000000000000000
chr1,81127752,81190248,62496,-1,0,,0,0.00000000000000000000
chr3,285408,312115,26707,-1,0,10752,1,3.74433669075523000000
chr21,37060647,37123160,62513,-1,0,,0,0.00000000000000000000
chr17,54675306,54675810,504,-1,0,,0,0.00000000000000000000
chr17,20432849,20524000,91151,-1,0,256223,1,1.09708066834154000000
chr15,99284734,99337828,53094,-1,0,3480,1,1.88345199080875000000
chr18,34569051,34645383,76332,-1,0,57536,1,1.31006655138081000000
chr10,19436504,19546122,109618,-1,0,340895,1,0.91225893557627400000
chr16,78307944,78431561,123617,-1,0,51741,1,0.80895022529263800000
chr14,45845549,45979614,134065,-1,0,,0,0.00000000000000000000
chr4,98802889,99023334,220445,-1,0,285555,1,0.45362788904261800000
chr14,43901102,44131231,230129,-1,0,,0,0.00000000000000000000
chr19,55314502,55493006,178504,-1,0,2204;3811;3805;3812;9437;55655;3809;199713,8,4.48169228700757000000
chr22,50296839,50301360,4521,-1,0,79087,1,22.11900022119000000000
chrX,782028,794392,12364,-1,0,,0,0.00000000000000000000
chr7,40429079,40497426,68347,-1,0,79783,1,1.46312200974439000000
chr1,79964463,80091048,126585,-1,0,,0,0.00000000000000000000
chr7,117918583,118024960,106377,-1,0,,0,0.00000000000000000000
chrX,22992416,23070279,77863,-1,0,168400,1,1.28430705213002000000
chr1,238724105,238865550,141445,-1,0,,0,0.00000000000000000000
chr16,6819616,7080140,260524,-1,0,54715,1,0.38384179576545700000
chr2,16082134,16083512,1378,-1,0,10408;4613,2,145.13788098693800000000
chr13,81549680,81682754,133074,-1,0,,0,0.00000000000000000000
chr9,108487686,108739861,252175,-1,0,55151,1,0.39655001487062600000
chr19,28294781,28318379,23598,-1,0,,0,0.00000000000000000000
chr9,38648128,38815471,167343,-1,0,,0,0.00000000000000000000
chr16,6977815,7053888,76073,-1,0,54715,1,1.31452683606536000000
chr2,1240452,1263263,22811,-1,0,54221,1,4.38384989697953000000
chr17,6114341,6336546,222205,-1,0,23746,1,0.45003487770302200000
chr13,55543319,56586739,1043420,-1,0,,0,0.00000000000000000000
chr16,21574908,21739885,164977,-1,0,51108;10261;146183,3,1.81843529704141000000
chr3,162514534,162619141,104607,-1,0,,0,0.00000000000000000000
chr8,39237438,39380654,143216,-1,0,,0,0.00000000000000000000
chr2,141967747,142216427,248680,-1,0,53353,1,0.40212321055171300000
chrX,23164422,23652290,487868,-1,0,139411,1,0.20497347643215000000
chr16,32573808,33609925,1036117,-1,0,653550;24150;729355,3,0.28954259026731500000
chr6,29854870,29896710,41840,-1,0,,0,0.00000000000000000000
chr6,96550697,96652208,101511,-1,0,10690,1,0.98511491365467800000
chr1,196837584,196883398,45814,-1,0,10877,1,2.18273890077269000000
chr8,39237438,39380654,143216,-1,0,,0,0.00000000000000000000
chr15,34735949,34785082,49133,-1,0,,0,0.00000000000000000000
chr5,115561128,115630004,68876,-1,0,51397,1,1.45188454614089000000
chr7,2740652,4713749,1973097,-1,0,84433;2768;155185;221935,4,0.20272698199835100000
chr4,75024734,75117648,92914,-1,0,441024,1,1.07626407215274000000
chr11,40228417,40349357,120940,-1,0,57689,1,0.82685629237638500000
chr4,189258917,189793808,534891,-1,0,,0,0.00000000000000000000
chr3,76273872,86006395,9732523,-1,0,6092;2632;6091;253559,4,0.04109931206943980000
chr3,104827119,113812572,8985453,-1,0,10225;151887;205717;84666;257144;131450;868;22989;80218;523;79691;214;79669;57650;55779;257068;254887;29114;27136;285335;90102;84692;4345;56987;64422;79413;25945;91653;9626;152185;54847;54762;11148;55347;344805;9666;151888;57577;151871;25871;50852;55032;961;29083;55211;55081;344807,47,0.52306767393919900000
chr10,27858797,27934526,75729,-1,0,,0,0.00000000000000000000
chr12,60007765,61428728,1420963,-1,0,9194,1,0.07037480919629860000
chr9,28562011,28777389,215378,-1,0,158038,1,0.46429997492780100000
chr16,6749349,6977951,228602,-1,0,54715,1,0.43744149220041800000
chr1,59828149,60073594,245445,-1,0,55277,1,0.40742325164497100000
chr6,44981957,45103874,121917,-1,0,8464,1,0.82023015658193700000
chr1,246372358,246385329,12971,-1,0,64754,1,7.70950582067689000000
chr19,36584295,36605983,21688,-1,0,284403;5438;728361;1155,4,18.44337882700110000000
chr12,21011274,21377322,366048,-1,0,338821;28234;10599,3,0.81956464725937600000
chr9,30196476,30277855,81379,-1,0,,0,0.00000000000000000000
chr2,110852960,110961923,108963,-1,0,7851;4867,2,1.83548544001175000000
chr22,18968891,19010508,41617,-1,0,,0,0.00000000000000000000
chr15,24384453,24487834,103381,-1,0,,0,0.00000000000000000000
chr15,30938215,30971589,33374,-1,0,,0,0.00000000000000000000
chr1,55472368,55474479,2111,-1,0,7809,1,47.37091425864520000000
chr2,148879622,149002494,122872,-1,0,55777,1,0.81385506868936800000
chrX,99037621,99385822,348201,-1,0,,0,0.00000000000000000000
chr22,18661749,18818399,156650,-1,0,,0,0.00000000000000000000
chr10,79282573,79374307,91734,-1,0,3778,1,1.09010835677066000000
chr3,2146820,2366114,219294,-1,0,152330,1,0.45600882833091600000
chr8,7113683,8046302,932619,-1,0,401447;503614;504180;503841;140596;100133251;653423;100131980;645402;55894;245910;1673;100131608;245908;100132396;503618;392188;100289462;245909;414325;10407;645836,22,2.35894829507012000000
chr10,81489155,81551689,62534,-1,0,,0,0.00000000000000000000
chr19,22281322,22407059,125737,-1,0,163223,1,0.79531084724464600000
chr5,69134911,69925316,790405,-1,0,6607;728492,2,0.25303483657112500000
chr17,44254385,44485801,231416,-1,0,100506084;9884;284058,3,1.29636671621668000000
chr8,7371660,7752557,380897,-1,0,100131608;140596;245908;100133251;653423;245909;414325;245910;1673,9,2.36284349837358000000
chr12,104305168,104496882,191714,-1,0,7184;83468;728568;29915;6996,5,2.60805157682798000000
chrX,153629281,153629556,275,-1,0,6134,1,363.63636363636400000000
chr1,12971732,12992696,20964,-1,0,441871,1,4.77008204541118000000
chr16,223749,225662,1913,-1,0,,0,0.00000000000000000000
chr17,44254385,44628121,373736,-1,0,474170;100506084;51326;9884;284058,5,1.33784275531391000000
chr1,149091159,149275102,183943,-1,0,,0,0.00000000000000000000
chr2,242975955,243068370,92415,-1,0,,0,0.00000000000000000000
chrX,77170236,77170272,36,-1,0,538,1,2777.77777777778000000000
chr15,30390043,30819487,429444,-1,0,89832;101059918,2,0.46571846387421900000
chr15,30509355,30653907,144552,-1,0,89832,1,0.69179257291493700000
chr4,187698868,188602499,903631,-1,0,,0,0.00000000000000000000
chr3,76631976,76724726,92750,-1,0,6092,1,1.07816711590296000000
chrX,6552712,8115153,1562441,-1,0,412;8228;26609;8226,4,0.25600966692502300000
chr3,1301800,1922518,620718,-1,0,27255,1,0.16110375403967700000
chr16,84750595,85171856,421261,-1,0,55625;83716;9100;9764;339145,5,1.18691262661390000000
chr1,192944023,193151891,207868,-1,0,8707;51022;79577;51377;6738,5,2.40537264032944000000
chr3,89083192,90181487,1098295,-1,0,2042,1,0.09105021874815050000
chr6,135608920,135659557,50637,-1,0,54806,1,1.97484053162707000000
chr14,40975458,41211029,235571,-1,0,,0,0.00000000000000000000
chr22,25654099,25924056,269957,-1,0,91355,1,0.37042936467659700000
chr2,81458418,81756921,298503,-1,0,,0,0.00000000000000000000
chr11,132081893,132460922,379029,-1,0,4978;50863,2,0.52766411013405300000
chr5,61659115,61811351,152236,-1,0,27292;3796;51194,3,1.97062455660947000000
chr9,90561099,90725018,163919,-1,0,23552,1,0.61005740640194300000
chr5,99419627,99715207,295580,-1,0,,0,0.00000000000000000000
chr10,113029622,113295416,265794,-1,0,,0,0.00000000000000000000
chr7,52085028,52647552,562524,-1,0,,0,0.00000000000000000000
chr2,226734391,226951039,216648,-1,0,,0,0.00000000000000000000
chr7,142825873,142881366,55493,-1,0,5304;259285,2,3.60405816949886000000
chr3,85532187,85629504,97317,-1,0,253559,1,1.02756969491456000000
chr15,43851548,43949572,98024,-1,0,117155;9677;161497;1159,4,4.08063331429038000000
chr8,977218,1319861,342643,-1,0,9228,1,0.29184895065709800000
chr12,88001647,88127917,126270,-1,0,,0,0.00000000000000000000
chr2,106866475,108533926,1667451,-1,0,285190;84620;653489,3,0.17991533184483400000
chr6,57270030,58086843,816813,-1,0,5558,1,0.12242704266460000000
chr1,80540392,81189800,649408,-1,0,,0,0.00000000000000000000
chr7,111054068,111197513,143445,-1,0,83943,1,0.69713130468123700000
chr1,247666509,247981718,315209,-1,0,441933;284532;26188;81470;148823;81472;343169;81469,8,2.53799859775577000000
chr4,188106143,190469337,2363194,-1,0,205860;132625;339976,3,0.12694683551160000000
chr15,25332916,25333874,958,-1,0,,0,0.00000000000000000000
chr3,85489737,85615627,125890,-1,0,253559,1,0.79434426880610100000
chr9,129616292,129644627,28335,-1,0,403341,1,3.52920416446091000000
chr9,18344603,18681851,337248,-1,0,92949,1,0.29651769617610800000
chr15,102248605,102254510,5905,-1,0,123283,1,16.93480101608810000000
chr4,129620084,129662695,42611,-1,0,,0,0.00000000000000000000
chr1,78884981,79187290,302309,-1,0,10561;10964;5737,3,0.99236211955317300000
chr8,126153667,126179399,25732,-1,0,286053,1,3.88621172081455000000
chr10,53582649,54440259,857610,-1,0,22943;5592,2,0.23320623593474900000
chr5,111215480,111331633,116153,-1,0,9315,1,0.86093342401832100000
chr20,32998470,33055367,56897,-1,0,83737,1,1.75756191011828000000
chr18,53277008,53428347,151339,-1,0,6925,1,0.66076820911992300000
chr12,81928741,82026348,97607,-1,0,8499,1,1.02451668425420000000
chr3,61891,2048351,1986460,-1,0,27255;10752,2,0.10068161453037100000
chr12,20996056,21415634,419578,-1,0,338821;28234;10599,3,0.71500412319044400000
chr7,88555213,89510096,954883,-1,0,219578,1,0.10472487205238800000
chr21,46000000,48108188,2108188,-1,0,386674;386675;386683;54084;6573;6285;3689;104;353332;4047;54039;54058;386676;386680;353333;23181;386681;23275;386678;754;3275;54059;8888;1292;5116;84221;80781;386684;7327;6612;10841;1291;85395;386685;353323,35,1.66019349317993000000
chrX,29538963,29637296,98333,-1,0,11141,1,1.01695259983932000000
chr19,52914232,53448225,533993,-1,0,7576;55762;84436;90333;147660;162967;147658;388559;81856;55769;162966;388558;100529240,13,2.43448884161403000000
chr4,4979855,5433170,453315,-1,0,55351;54360,2,0.44119431300530500000
chr8,6412601,6528016,115415,-1,0,285;79648,2,1.73287700905428000000
chr13,22447784,23758240,1310456,-1,0,6445,1,0.07630931523072890000
chr4,92898474,93184275,285801,-1,0,,0,0.00000000000000000000
chr15,20481702,22765687,2283985,-1,0,283694;727832;100287399;390538;283767;100996331,6,0.26269874802155000000
chr3,17255852,17508525,252673,-1,0,9779,1,0.39576844379890200000
chr10,96401357,96521598,120241,-1,0,1562,1,0.83166307665438600000
chr19,6948884,7052996,104112,-1,0,653656;125997;284428,3,2.88151221761180000000
chr2,242883573,243068343,184770,-1,0,,0,0.00000000000000000000
chr22,18640300,18946597,306297,-1,0,11274;5625;8214,3,0.97944152244390200000
chr2,55797774,55870262,72488,-1,0,57223;87178,2,2.75907736452930000000
chr9,29022549,29219996,197447,-1,0,158038,1,0.50646502605762600000
chr14,87998062,88365609,367547,-1,0,,0,0.00000000000000000000
chr17,44159863,44787179,627316,-1,0,474170;100506084;51326;4905;9884;284058,6,0.95645575754484200000
chr4,75392078,75971503,579425,-1,0,25849;685,2,0.34516978038572700000
chr11,97251159,97457606,206447,-1,0,,0,0.00000000000000000000
chr4,168429688,168893776,464088,-1,0,,0,0.00000000000000000000
chr2,158792429,159068465,276036,-1,0,130940;151531,2,0.72454317552783000000
chr16,84208364,84363351,154987,-1,0,123872;9013;93107;58189;161931,5,3.22607702581507000000
chr4,189149858,189914227,764369,-1,0,,0,0.00000000000000000000
chr12,86485523,86569157,83634,-1,0,25834,1,1.19568596503814000000
chr4,123990547,124085066,94519,-1,0,166378,1,1.05798834096848000000
chr3,191922306,192043306,121000,-1,0,2257,1,0.82644628099173600000
chr17,13980154,14654104,673950,-1,0,1352;9953;146822,3,0.44513687959047400000
chr17,44210763,44345038,134275,-1,0,284058,1,0.74474027183019900000
chr9,1724106,2826755,1102649,-1,0,6595;7436;169522;9933,4,0.36276276494151800000
chr16,88755312,89249208,493896,-1,0,353;863;1013;51693;100129697;197322;348180;2588;9780;115992;81620;390748,12,2.42966130521405000000
chr15,69238677,70247802,1009125,-1,0,9493;26035;79400;54852;6176;246777,6,0.59457450761798600000
chrX,1224766,1653837,429071,-1,0,8623;293;1438;286530;3563;64109,6,1.39836996674210000000
chr3,158388766,158484175,95409,-1,0,5918;85476;56925,3,3.14435745055498000000
chr6,136807060,136914281,107221,-1,0,4217;9053,2,1.86530623665140000000
chr4,39286836,39406206,119370,-1,0,57728;5981,2,1.67546284661138000000
chrX,102738759,102797210,58451,-1,0,142684,1,1.71083471625806000000
chrX,47871771,47969339,97568,-1,0,57232,1,1.02492620531322000000
chr11,903084,984692,81608,-1,0,161;66005,2,2.45074012351730000000
chr5,710494,773103,62609,-1,0,,0,0.00000000000000000000
chr2,90017337,90258320,240983,-1,0,,0,0.00000000000000000000
chr4,69375140,69483277,108137,-1,0,7367,1,0.92475285979821900000
chr15,20408283,22558756,2150473,-1,0,283694;727832;100287399;390538;100996331,5,0.23250698799752400000
chr12,8003414,8118036,114622,-1,0,144195;6515,2,1.74486573258188000000
chr8,39237438,39380654,143216,-1,0,,0,0.00000000000000000000
chr14,19434575,20414232,979657,-1,0,441669;390429;79317;441670;390431;79334;641455;79544;404785,9,0.91868888804959300000
chr22,25664618,25892253,227635,-1,0,91355,1,0.43929975618863500000
chr4,69375140,69483277,108137,-1,0,7367,1,0.92475285979821900000
chrY,24216880,24892396,675516,-1,0,159163;378951;442862;9081,4,0.59213993450932300000
chr7,16900200,16964718,64518,-1,0,155465,1,1.54995505130351000000
chr17,10237826,10298714,60888,-1,0,8735;4626,2,3.28471948495598000000
chr1,196659800,197761930,1102130,-1,0,163486;360023;10878;2165;3080;10877;81494;3078;259266;3075;23418,11,0.99806737862139700000
chr2,15198910,15654867,455957,-1,0,51594,1,0.21931892700408200000
chr9,22398465,22754960,356495,-1,0,63951,1,0.28050884304127700000
chr15,100901315,100971201,69886,-1,0,204219,1,1.43090175428555000000
chr4,39286836,39370055,83219,-1,0,57728;5981,2,2.40329732392843000000
chr3,191261701,191479976,218275,-1,0,,0,0.00000000000000000000
chr18,38991546,40057737,1066191,-1,0,5289,1,0.09379182529209120000
chr4,93834537,93956119,121582,-1,0,2895,1,0.82249017124245400000
chr11,120569545,120624320,54775,-1,0,2900,1,1.82565038795071000000
chr1,22308664,22382971,74307,-1,0,23436;998;10136,3,4.03730469538536000000
chr7,143425361,143858276,432915,-1,0,285966;135948;346525;9747;340307;442361;392138;135946;135941;26211;393046,11,2.54091449822713000000
chr1,196659800,197761930,1102130,-1,0,163486;360023;10878;2165;3080;10877;81494;3078;259266;3075;23418,11,0.99806737862139700000
chr2,110873835,110980295,106460,-1,0,7851;4867,2,1.87863986473793000000
chrX,61091,169113,108022,-1,0,,0,0.00000000000000000000
chr7,153527304,153789777,262473,-1,0,1804,1,0.38099156865658600000
chr6,115325706,115549597,223891,-1,0,,0,0.00000000000000000000
chrX,93964876,94425947,461071,-1,0,,0,0.00000000000000000000
chrX,168566,387397,218831,-1,0,55344;28227;8225,3,1.37092093898945000000
chr2,111392197,111452046,59849,-1,0,699,1,1.67087169376264000000
chr2,218903828,218931257,27429,-1,0,,0,0.00000000000000000000
chr16,85767286,85789871,22585,-1,0,404550,1,4.42771751162276000000
chr16,89681377,90111263,429886,-1,0,5119;2622;2175;9605;79007;124044;124045;84501;22980;92822;92806;10381;1800;4157;8558;54849,16,3.72191697333712000000
chr8,1981529,2179550,198021,-1,0,9172,1,0.50499694476848400000
chr6,5125949,5150841,24892,-1,0,57128,1,4.01735497348546000000
chr8,467165,495888,28723,-1,0,157695,1,3.48153048079936000000
chr5,96502439,97054481,552042,-1,0,55781,1,0.18114563746961300000
chr8,15944306,16021468,77162,-1,0,4481,1,1.29597470257381000000
chr19,14754246,14858711,104465,-1,0,30817;84658;84449,3,2.87177523572488000000
chr2,201707304,201743206,35902,-1,0,53938;1195,2,5.57072029413403000000
chr7,9472814,9686245,213431,-1,0,,0,0.00000000000000000000
chr3,160500185,160749923,249738,-1,0,151742,1,0.40041963978249200000
chr4,93332364,93456255,123891,-1,0,2895,1,0.80716113357709600000
chr2,54006956,54107591,100635,-1,0,27248;51130;10936;23198;100302652,5,4.96845034033885000000
chr17,44210763,44345038,134275,-1,0,284058,1,0.74474027183019900000
chr14,42160061,42278123,118062,-1,0,145581,1,0.84701258660703700000
chr3,178486527,178598062,111535,-1,0,10242,1,0.89657954902048700000
chr6,110708011,110795304,87293,-1,0,8528;85413,2,2.29113445522550000000
chr4,190309240,190916678,607438,-1,0,2483,1,0.16462585481975100000
chr7,145807668,145873632,65964,-1,0,26047,1,1.51597841246741000000
chr12,3195623,3259131,63508,-1,0,10867,1,1.57460477420168000000
chr5,180460562,180567613,107051,-1,0,153579;26693,2,1.86826839543769000000
chr22,23025613,23654436,628823,-1,0,2781;100423062;613;27156;9609,5,0.79513631021766100000
chr7,111030974,111172342,141368,-1,0,83943,1,0.70737366306377700000
chr4,134068963,134208021,139058,-1,0,57575,1,0.71912439413769800000
chr1,526704,528024,1320,-1,0,,0,0.00000000000000000000
chr1,17577336,17668089,90753,-1,0,51702;23569,2,2.20378389695107000000
chrY,59050958,59310245,259287,-1,0,10251;6845,2,0.77134603740256900000
chr7,35654766,36286910,632144,-1,0,80820;64224;989,3,0.47457541319699300000
chr16,21596412,21776157,179745,-1,0,51108;10261;146183,3,1.66903112743053000000
chr8,11702093,11825646,123553,-1,0,1508,1,0.80936925853682200000
chr10,103427594,103436241,8647,-1,0,6468,1,11.56470452179950000000
chr21,45477723,45484313,6590,-1,0,7109,1,15.17450682852810000000
chr4,189374502,190957460,1582958,-1,0,2483;448831,2,0.12634574006385500000
chr10,107154256,107530680,376424,-1,0,,0,0.00000000000000000000
chr18,63620373,63974115,353742,-1,0,,0,0.00000000000000000000
chr7,2740652,4713749,1973097,-1,0,84433;2768;155185;221935,4,0.20272698199835100000
chr10,79282543,79374336,91793,-1,0,3778,1,1.08940768903947000000
chr13,100830013,101118107,288094,-1,0,5095,1,0.34710892972432600000
chr14,48492352,49520380,1028028,-1,0,,0,0.00000000000000000000
chr7,119366606,119474785,108179,-1,0,,0,0.00000000000000000000
chr20,14629123,14700099,70976,-1,0,140733,1,1.40892696122633000000
chr3,41390195,41754496,364301,-1,0,54986,1,0.27449828575820500000
chr1,145413388,145609227,195839,-1,0,148738;128077;10401;200035;84265;284615;8515;148741;10628;10623;8799;9939,12,6.12748226859819000000
chr5,20924403,23704256,2779853,-1,0,1010;56979,2,0.07194625039525470000
chr8,82519009,85022186,2503177,-1,0,347051;92421;79752;64089;3612,5,0.19974616257659800000
chr14,90306711,90544449,237738,-1,0,55775;56659;90141,3,1.26189334477450000000
chrX,114242518,114837553,595035,-1,0,5358;57631;3598;139804;51213,5,0.84028670582402700000
chr3,60555136,60629638,74502,-1,0,2272,1,1.34224584574911000000
chr1,238284223,238465082,180859,-1,0,,0,0.00000000000000000000
chr8,19262288,19416428,154140,-1,0,55790,1,0.64876086674451800000
chr2,110427195,111044815,617620,-1,0,96626;7851;84220;4867,4,0.64764742074414700000
chr1,105501351,105735292,233941,-1,0,,0,0.00000000000000000000
chr3,99701075,99765927,64852,-1,0,84319;11259,2,3.08394498242151000000
chr2,66995702,67333103,337401,-1,0,,0,0.00000000000000000000
chr3,46799984,46849230,49246,-1,0,,0,0.00000000000000000000
chr2,110895981,110980401,84420,-1,0,4867,1,1.18455342335939000000
chr10,34880111,34885774,5663,-1,0,56288,1,17.65848490199540000000
chr2,110895981,110980401,84420,-1,0,4867,1,1.18455342335939000000
chr16,6785607,6881150,95543,-1,0,54715,1,1.04664915273751000000
chr7,110795245,110859969,64724,-1,0,83943,1,1.54502193931154000000
chr16,21405327,21816543,411216,-1,0,23117;51108;10261;146183,4,0.97272479670051700000